segmentnr	original	analyzed
MBaasaucadiipikaaHK-0	Muktabodha E-text in UTF-8	muktabodha etext in utf
MBaasaucadiipikaaHK-1	###########################################################################MUKTABODHA INDOLOGICAL RESEARCH INSTITUTEwww.muktabodha.org©2011 Muktabodha Indological Research Institute  All Rights Reserved.E-texts may be viewed only online or downloaded for private study.E-texts may not, under any circumstances, be copied, republished,reproduced, distributed or sold, either in original or altered form, withoutthe express permission of Muktabodha Indological Research Institute in writing.Data-entered by the staff of Muktabodha under the direction of Mark S. G. Dyczkowski.Catalog number : M00237	muktabodha indological research muktabodha indological research institute all rights reserved texts may be viewed only online or downloaded for private studye texts may not under any circumstances be copied republished reproduced distributed or sold either in original or altered form withoutthe express permission of muktabodha indological research institute in writing data entered by the staff of muktabodha under the direction of mark s g dyczkowskicatalog number  /
MBaasaucadiipikaaHK-2	Uniform title: āśaucyadiipikaa	uniform title 
MBaasaucadiipikaaHK-3	Author : vedajñāna	veda jñāna 
MBaasaucadiipikaaHK-4	Description: E-text created from IFP/EFEO transcript T00370 pages 326 to 400	description etext created from ifpefeo transcript pages 
MBaasaucadiipikaaHK-5	Copied from a manuscript belonging to Sundaradiksitar Tirunelveli	copied from a manuscript belonging to sundaradiksitar tirunelveli 
MBaasaucadiipikaaHK-6	This is another of the works by vedajñāna who lived in Vyaaghrapura in	this is another of the works by vedajñāna 
MBaasaucadiipikaaHK-7	Tamil Nadu. As its name suggests it deals with matters of purity and	tamil nadu as its name suggests it deals with matters of purity and 
MBaasaucadiipikaaHK-8	impurity as prescribed by the Siddhaantaagamas.	impuriti as prescribed by the siddhaanta agamas 
MBaasaucadiipikaaHK-9	Notes: Data entered by the staff of Muktabodha under the supervision of Mark S. G. Dyczkowski.	notes data entered by the staff muktabodha under the supervision of mark s g dyczkowski 
MBaasaucadiipikaaHK-10	Revision 0: Sept. 18, 2011	revision 
MBaasaucadiipikaaHK-11	Publication country : India	publication country india 
MBaasaucadiipikaaHK-12	āśaucyadīpikā	āśaucyadīpikā 
MBaasaucadiipikaaHK-13	anukūlasmṛtisnehāmāptoktimayavartikām | śaivavargaparigrāhyāṃ	anukūla smṛti snehām āpta ukti maya vartikām śaiva varga parigrāhyām 
MBaasaucadiipikaaHK-14	karomyāśaucadīpikām ||	karomi āśauca dīpikām 
MBaasaucadiipikaaHK-15	mahatāpadakhilatantra bṛndaprabhava śaiva tantra dīkṣāpavinita	mahā tāpada khila tantra bṛnda prabhava śaiva tantra 
MBaasaucadiipikaaHK-16	kalebarāṇāmanavarataśivapūjana dhunaddharāṇāmamṛta *	kalebarāṇām anavarata śiva pūjana dhunat dharāṇām amṛta 
MBaasaucadiipikaaHK-17	tpairaṇayurīṇa śivapūjane viśiṣye sūtakaniṣiddha parivarjana	śiva pūjane viśiṣye sūtaka niṣiddha parivarjana 
MBaasaucadiipikaaHK-18	parijñātahetubhūtāśauca prakāśa saṃpādikā kāpi dīpikā	parijñāta hetu bhūta āśauca prakāśa saṃpādikā kā api dīpikā 
MBaasaucadiipikaaHK-19	pravartate | asyāstvāptokti varavacana paṃktinatinirmalākāvartīkā	pravartate 
MBaasaucadiipikaaHK-20	tasyāsttvanukūlasmṛti * * saṃhati snehatayā gṛhyate | atra	saṃhati sneha tayā gṛhyate atra 
MBaasaucadiipikaaHK-21	siddhāntaḥ parokṣārthaika sādhanāyovakti	siddhāntaḥ parokṣa artha eka sādhanāya uvakti 
MBaasaucadiipikaaHK-22	soyamāptasyāttasmādāptavaraḥ śiva iti |	saḥ uyam āptasya āt tasmāt āpta varaḥ śivaḥ iti 
MBaasaucadiipikaaHK-23	p. 327)	p 
MBaasaucadiipikaaHK-24	pauṣkare -	pauṣkare 
MBaasaucadiipikaaHK-25	āptoktirāgamassopi sacedānīṃ vicāryate | āyurvedātsugaṇitā	āpta uktiḥ āgamaḥ saḥ api sacā idānīm vicāryate āyurvedāt su gaṇitā 
MBaasaucadiipikaaHK-26	mantravādācca sāsvayāt | rasopadiṣṭadāṭopādāptassan	mantravādāt ca sa āsvayāt 
MBaasaucadiipikaaHK-27	parigṛhyate |	parigṛhyate 
MBaasaucadiipikaaHK-28	seyaṃ āptoktirapi caturvidhā -	sā iyam āpta uktiḥ api caturvidhā 
MBaasaucadiipikaaHK-29	śaiva pāśupata somalākula bhedāt | tāsvapi	śaiva pāśupata somalākula bhedāt tāsu api 
MBaasaucadiipikaaHK-30	śaivatantrameśreṣṭham | tadanuṣṭhāvañca na tantra sāṃkaryeṇa	śaiva tantram eśreṣṭham na tantra sāṃkaryeṇa 
MBaasaucadiipikaaHK-31	kartavyam |	kartavyam 
MBaasaucadiipikaaHK-32	taduktaṃ makuṭe -	tat uktam makuṭe 
MBaasaucadiipikaaHK-33	śaivaṃ pāśupataṃ somaṃ lākūlañca caturvidham | teṣu	śaivam pāśupatam somam lākūlam ca caturvidham teṣu 
MBaasaucadiipikaaHK-34	śreṣṭhatamaṃ śaivaṃ mūrdhvasrotassamudbhavam ||	śreṣṭhatamam śaivam mūrdhva srotaḥ samudbhavam 
MBaasaucadiipikaaHK-35	vedasāramidaṃ tantrantasmādvaidika ācaret | vedāntārthamayaṃ	veda sāram idam tantram tasmāt vaidikaḥ ācaret vedānta artha mayam 
MBaasaucadiipikaaHK-36	jñānaṃ siddhāntaṃ paramaṃ śubham ||	jñānam siddhāntam paramam śubham 
MBaasaucadiipikaaHK-37	ūrdhvasrotodbhavācchreṣṭhamaṣṭāviṃśati samkhyakam |	ūrdhvasrota udbhavāt śreṣṭham aṣṭāviṃśati samkhyakam 
MBaasaucadiipikaaHK-38	jñāyateneneti karaṇavyutpatyā jñānapādaṃ tantraviśeṣa jñāna	jñāyate enena iti karaṇa vyutpatyā 
MBaasaucadiipikaaHK-39	sādhanamityarthaḥ | vedasārārthadaṃ jñeyamanyattvanyārtha	sādhanam iti arthaḥ veda sāra artha dam jñeyam anyat tu anya artha 
MBaasaucadiipikaaHK-40	sādhakamiti kāmikā -	sādhakam iti kāmikā 
MBaasaucadiipikaaHK-41	siddhāntaṃ vedasāratvādanyadvedabahiṣkṛtam |	siddhāntam veda sāra tvāt anyat veda bahiṣkṛtam 
MBaasaucadiipikaaHK-42	siddhāntavihitācāro vaidikācāra ucyate ||	siddhānta vihita ācāraḥ vaidika ācāraḥ ucyate 
MBaasaucadiipikaaHK-43	tasmāt śaivatantrasya ūrdhvasrotodbhavatvād	tasmāt śaiva tantrasya ūrdhva srota udbhava tvāt 
MBaasaucadiipikaaHK-44	vedāntasiddhāntajñānahetutvāditaratantrāṇāmanyārtha-	vedānta siddhānta jñāna hetu tvāt itara tantrāṇām anyārtha 
MBaasaucadiipikaaHK-45	bodhakatvāñcaitadanuṣṭhāturvaidikatvameva	bodhaka tvāt ca etat anuṣṭhātuḥ vaidika tvam eva 
MBaasaucadiipikaaHK-46	tasmādetattantrānuṣṭhāna tantrāntarāsāṃkaryeṇānuṣṭheyam |	tasmāt etat tantra anuṣṭhāna tantra antara asāṃkaryeṇa anuṣṭheyam 
MBaasaucadiipikaaHK-47	p. 328)	p 
MBaasaucadiipikaaHK-48	tantrāntarasāṃkaryeṇa tadanuṣṭhāne kāmikādiṣu doṣa śrūyate	tantra antara sāṃkaryeṇa tad anuṣṭhāne kāmika ādiṣu śrūyate 
MBaasaucadiipikaaHK-49	śaivabhedamidaṃ jñeyaṃ saṃkaranna samācaret |	śaiva bhedam idam jñeyam saṃkaran na samācaret 
MBaasaucadiipikaaHK-50	tantrasaṃkaradoṣeṇa rājarāṣṭraṃ vinaśyati ||	tantra saṃkara doṣeṇa rāja rāṣṭram vinaśyati 
MBaasaucadiipikaaHK-51	aṣṭāviṃśatisaṃkhyānāmeteṣāṃ	aṣṭāviṃśati saṃkhyānām eteṣām 
MBaasaucadiipikaaHK-52	kāmikāditantrāṇāmanyonyasāṃkaryaṃ na doṣāvaham | taduktaṃ	                                                                                
MBaasaucadiipikaaHK-53	vīratantre -	vīratantre 
MBaasaucadiipikaaHK-54	aṣṭāviṃśatibhedena śaivamevaṃ vidhīyate | eteṣāṃ	aṣṭāviṃśati bhedena śaivam evam vidhīyate eteṣām 
MBaasaucadiipikaaHK-55	saṃkarañcaiva na doṣāya prakalpayet ||	saṃkaran ca eva na doṣāya prakalpayet 
MBaasaucadiipikaaHK-56	nanvevaṃ tarhi tasya siddhāntasya pramāṇatayā	nanu evam tarhi tasya siddhāntasya pramāṇa tayā 
MBaasaucadiipikaaHK-57	śivadivyajanapraṇīta pūrtivacanānāntatra	śiva divya jana praṇīta pūrti vacanānām tatra 
MBaasaucadiipikaaHK-58	saṃgrāhyatvamupapannamiti cenna tadviruddhasmṛtivacanapurāṇādīnā	saṃgrāhya tvam upapannam iti ced na tad viruddha smṛti vacana purāṇa ādīnām 
MBaasaucadiipikaaHK-59	tyājyatvepi tadavirodhivacanānāṃ grāhyatvasya sammatatvāt |	tyājya tve pi tad avirodhi vacanānām grāhya tvasya sammata tvāt 
MBaasaucadiipikaaHK-60	taduktaṃ kāmike -	tat uktam kāmike 
MBaasaucadiipikaaHK-61	kartavyañcedanuṣṭheyaṃ śaiva karmāvirodhiyat |	kartavyam ced anuṣṭheyam śaiva karma avirodhi yat 
MBaasaucadiipikaaHK-62	viruddhañcetparityajyaṃ na tu śaivaṃ parityajet ||	viruddham ced parityajyam na tu śaivam parityajet 
MBaasaucadiipikaaHK-63	saṃgrāhyaṃ vaidikaṃ sarvaṃ śaiva vākyāvirodhi yat |	saṃgrāhyam vaidikam sarvam śaiva vākya avirodhi yat 
MBaasaucadiipikaaHK-64	śaivavaidikamevoktaṃ vaidikaṃ śaivamevavā ||	śaiva vaidikam eva uktam vaidikam śaivam eva vā 
MBaasaucadiipikaaHK-65	vaidikāntarbahirbhūtaṃ śaivaṃ śaivāttadapyatha | tathāpi	vaidika antar bahis bhūtam śaivam śaivāt tat api atha tathā api 
MBaasaucadiipikaaHK-66	vaidikācchreṣṭhaṃ śaivaṃ tasmāt parannahi ||	vaidikāt śreṣṭham śaivam tasmāt parat nahi 
MBaasaucadiipikaaHK-67	asyāśca dīpikāyā āśau ca padārtha prakāśadvārā ācārya	asyāḥ ca dīpikāyāḥ āśau ca padārtha prakāśa dvārā ācārya 
MBaasaucadiipikaaHK-68	pādasiddhasūtakaniṣiddha parivarjana jñānopabṛṃhitasādhyo	           
MBaasaucadiipikaaHK-69	mokṣaḥ phalaṃ tatkāminaśśaivāstvadhikāriṇaste ca	mokṣaḥ phalam tad kāminaḥ śaivāḥ tu adhikāriṇaḥ te ca 
MBaasaucadiipikaaHK-70	śaivāssaptatviyāḥ |	śaivāḥ saptatviyāḥ 
MBaasaucadiipikaaHK-71	p. 329)	p 
MBaasaucadiipikaaHK-72	yathā vīratantre -	yathā vīratantre 
MBaasaucadiipikaaHK-73	śaivāssaptavidhā jñeyāsteṣāṃ bhedaṃ śṛṇuṣvahya |	śaivāḥ saptavidhāḥ jñeyāḥ teṣām bhedam śṛṇuṣva ahya 
MBaasaucadiipikaaHK-74	anādiśaivaḥ prathamaḥ ādiśaivo dvitīyakaḥ ||	anādiśaivaḥ prathamaḥ ādiśaivaḥ dvitīyakaḥ 
MBaasaucadiipikaaHK-75	tṛtīyastu mahāśaiva caturthaṃ ścānuśaivakaḥ | pañcamo	tṛtīyaḥ tu mahāśaiva caturtham 
MBaasaucadiipikaaHK-76	vāntaraśaiva ṣaṣṭhaḥ pravara ucyate ||	vāntaraśā eva ṣaṣṭhaḥ pravaraḥ ucyate 
MBaasaucadiipikaaHK-77	saptamaścāntyaśaivaśca śaivānāṃ bheda ucyate |	saptamaḥ ca antyaśaivaḥ ca śaivānām bhedaḥ ucyate 
MBaasaucadiipikaaHK-78	anādiśaivassaśivaścādiśaivaśśivadvijaḥ ||	anādiśaivaḥ sa śivaḥ ca ādiśaivaḥ śiva dvijaḥ 
MBaasaucadiipikaaHK-79	vipraścaiva mahāśaiva kṣatriyo vaiśya eva ca | anuśaiva	vipraḥ ca eva mahāśā eva kṣatriyaḥ vaiśyaḥ eva ca anuśā eva 
MBaasaucadiipikaaHK-80	samākhyātaśśūdraścāvāntarasmṛtaḥ ||	samākhyātaḥ śūdraḥ ca avāntara smṛtaḥ 
MBaasaucadiipikaaHK-81	svarṇāṃṣaṣṭhamadhyāstu kulālaḥ pāśvastathā | pravaraśaiva	kulālaḥ pāśvaḥ tathā 
MBaasaucadiipikaaHK-82	samākhyātaḥ procyante sakalaṃ mayā |	samākhyātaḥ procyante sakalam mayā 
MBaasaucadiipikaaHK-83	anyāsāmeva jātīnāmantyaśaivamihocyate |	anyāsām eva jātīnām antyaśaivam iha ucyate 
MBaasaucadiipikaaHK-84	ityetaścānādi śaivaḥ paraśśiva ādiśaivaśśiva dvijaḥ - satu	iti etaḥ ca anādi śaivaḥ paraḥ śivaḥ ādiśaivaḥ śiva dvijaḥ satu 
MBaasaucadiipikaaHK-85	śiva sṛṣṭyaiva brahmamukhājjātaḥ | mahāśaivo vipraḥ sa tu	śiva sṛṣṭyā eva brahma mukhāt jātaḥ mahāśaivaḥ vipraḥ sa tu 
MBaasaucadiipikaaHK-86	śivasṛṣṭiṃ vinā brahmamukhamātrajātaḥ | taduktaṃ suprabhede -	śiva sṛṣṭim vinā brahma mukha mātra jātaḥ tat uktam suprabhede 
MBaasaucadiipikaaHK-87	śivasṛṣṭya samudbhūtā brahmavaktra catuṣṭayāt | ye bhūmau	                    
MBaasaucadiipikaaHK-88	brāhmaṇā jātāste śiva brāhmaṇāḥ smṛtāḥ ||	brāhmaṇāḥ jātāḥ te śiva brāhmaṇāḥ smṛtāḥ 
MBaasaucadiipikaaHK-89	śivasṛṣṭiṃ vinā yasmāt jāyante kevalaṃ mukhāt |	śiva sṛṣṭim vinā yasmāt jāyante kevalam mukhāt 
MBaasaucadiipikaaHK-90	p. 330)	p 
MBaasaucadiipikaaHK-91	sāmānyabrāhmaṇāḥ proktā dīkṣayā prāpayecchivam | ācārya iti	sāmānya brāhmaṇāḥ proktāḥ dīkṣayā prāpayet śivam ācāryaḥ iti 
MBaasaucadiipikaaHK-92	śeṣaḥ | kāmikepi -	śeṣaḥ kāmike pi 
MBaasaucadiipikaaHK-93	śivasṛṣṭiṃ vināye tu jāyante brahmaṇo mukhāt | te sāmānyā na	śiva sṛṣṭim vināye tu jāyante brahmaṇaḥ mukhāt te sāmānyāḥ na 
MBaasaucadiipikaaHK-94	teṣāṃ tu parārthe cādhikāritā ||	teṣām tu parārthe ca adhikāri tā 
MBaasaucadiipikaaHK-95	yadi mohena kurvīran rājarāṣṭrasya nāśanamiti kṣatriya	yadi mohena kurvīran rāja rāṣṭrasya nāśanam iti kṣatriya 
MBaasaucadiipikaaHK-96	vaiśyāvanuśaivau - avāntaraśaiaśśūdraḥ	vaiśyau anuśaivau 
MBaasaucadiipikaaHK-97	svarṇāṃbaṣṭhāntaralika kulālapāraśaivāstu pravaraśaivāḥ	svarṇa aṃbaṣṭha antaralika kulāla pāraśaivāḥ tu pravara śaivāḥ 
MBaasaucadiipikaaHK-98	tatonyājātayontyajaśaiva iti atrānādiśaiva vyatiriktānāṃ	iti atra anādiśā eva vyatiriktānām 
MBaasaucadiipikaaHK-99	śaivānāmadhikāraḥ | athāśaucannirūpyate -	śaivānām adhikāraḥ 
MBaasaucadiipikaaHK-100	āśaucannām karmaṇaḥ kriyānārhatvalakṣaṇam | purusasthaṃ	karmaṇaḥ kriyā anārha tva lakṣaṇam 
MBaasaucadiipikaaHK-101	kiñcidaprayatyaṃ - tantrividhaṃ kālāpanoya snānāpanoya	kiñcid aprayatyam tat trividham kāla apanoya snāna apanoya 
MBaasaucadiipikaaHK-102	kālasnānāpanoya tribhedāt | tatra kālāpanodhaṃ antaraśava	tri bhedāt tatra 
MBaasaucadiipikaaHK-103	grāmāśaucaṃ - tatra tu yāvat grāmāt pretanirgamanaṃ	grāma āśaucam tatra tu yāvat grāmāt preta nirgamanam 
MBaasaucadiipikaaHK-104	tāvadevāśaucaṃ grāmasya na tatra snānāpekṣāsnānāpanodyaṃ	tāvat eva āśaucam grāmasya na tatra snāna apekṣā snāna apanodyam 
MBaasaucadiipikaaHK-105	bandhumātra maraṇāśaucaṃ - na tatra kālāpekṣā	bandhu mātra maraṇa āśaucam na tatra kāla apekṣā 
MBaasaucadiipikaaHK-106	kālasnānāpanodyaṃ pūrṇāśaucādi - tatra kālāpagame aghānte	kāla snāna apanodyam pūrṇa āśauca ādi tatra kāla apagame agha ante 
MBaasaucadiipikaaHK-107	saṃbhave snānasya vihīnatvāt asya ca nimittāni jananamaraṇa dahana	saṃbhave snānasya vihīna tvāt asya ca nimittāni janana maraṇa dahana 
MBaasaucadiipikaaHK-108	manugamanaṃ nirharaṇaṃ rodanaṃ sūtakāntarbhojanaṃ saṃparkaṃ	manu gamanam nirharaṇam rodanam sūtaka antar bhojanam saṃparkam 
MBaasaucadiipikaaHK-109	vapanākaraṇaṃ sapiṇḍastyakaraṇamiti daśavidhāni | atra	vapanākaraṇam sapiṇḍastyakaraṇam iti daśavidhāni atra 
MBaasaucadiipikaaHK-110	saṃgrahaślokaḥ -	saṃgraha ślokaḥ 
MBaasaucadiipikaaHK-111	p. 331)	p 
MBaasaucadiipikaaHK-112	janimṛti dahanānuyāna rodairnavasaptanirharaṇāśavatvamokṣaiḥ |	rodaiḥ nava sapta nirharaṇa a śava tva mokṣaiḥ 
MBaasaucadiipikaaHK-113	aviyutimṛtikāntabhojanābhyāmaśucivapurgrahaṇakriyāsvanahvīm? ||	a viyuti mṛti kānta bhojanābhyām aśuci vapuḥ grahaṇa kriyāsu anahvīm 
MBaasaucadiipikaaHK-114	atra kramo na vivakṣitaḥ | jananañca garbhasrāva pātāpaprasava	atra kramaḥ na vivakṣitaḥ 
MBaasaucadiipikaaHK-115	sukhaprasava bhedena catuṣṭayam | tatra	sukhaprasava bhedena catuṣṭayam tatra 
MBaasaucadiipikaaHK-116	srāvaścaturthamāsaparyantaṃ garbhanissaraṇam |	srāvaḥ caturtha māsa paryantam garbha nissaraṇam 
MBaasaucadiipikaaHK-117	pañcamaṣaṣṭhayoḥ pātaḥ | ata ūrdhvaṃ śavaprasavaḥ |	pañcama ṣaṣṭhayoḥ pātaḥ atas ūrdhvam śava prasavaḥ 
MBaasaucadiipikaaHK-118	daśamamāsādiṣu sukhaprasavaḥ | tatra mātussruve pāte ca	daśama māsa ādiṣu sukha prasavaḥ tatra mātuḥ sruve pāte ca 
MBaasaucadiipikaaHK-119	māsasaṃkhya dinamāśaucam | tathā kāmike -	māsa saṃkhya dinam āśaucam tathā kāmike 
MBaasaucadiipikaaHK-120	māsasaṃkhyādinammātusstrī puṃsorgarbhanāśane |	māsa saṃkhyā dinam mātuḥ strī puṃsoḥ garbhanāśane 
MBaasaucadiipikaaHK-121	prāyaścittasamuccaye viśeṣa uktaḥ | māturgarbha vināśetu	prāyaścitta samuccaye viśeṣaḥ uktaḥ māturgarbha vināśe tu 
MBaasaucadiipikaaHK-122	trimāsā tridinaṃ smṛtam | ūrdhvaṃ ṣaṇmāsa paryantaṃ catvāri	tri māsā tri dinam smṛtam ūrdhvam ṣaṣ māsa paryantam catvāri 
MBaasaucadiipikaaHK-123	pañcaṣaḍgukra māditi | asmin pakṣe trimāsaparyantaṃ tridinaṃ	asmin pakṣe tri māsa paryantam tri dinam 
MBaasaucadiipikaaHK-124	ṣāṇmāsaparyantammāsasaṃkhyā dināni | ata ūrdhvaṃ sūtikā	ṣāṇmāsa paryantam māsa saṃkhyā dināni atas ūrdhvam sūtikā 
MBaasaucadiipikaaHK-125	vihitāśaucaṃ bhavati | tatrai tadūrdhvaṃ sūtikāśaucamiti | tatra	vihita āśaucam bhavati tatrai tad ūrdhvam sūtikā āśaucam iti tatra 
MBaasaucadiipikaaHK-126	strī janmani -	strī janmani 
MBaasaucadiipikaaHK-127	catvāriṃśaddinānisyurjananyāstrī prasūtake | triṃśatpuṃ	catvāriṃśat dināni syuḥ jananyā a strī prasūtake triṃśat puṃ
MBaasaucadiipikaaHK-128	prasave jñeyaṃ pikastu yamalodbhava iti ||	prasave jñeyam pikaḥ tu yamalodbhavaḥ iti 
MBaasaucadiipikaaHK-129	yamalaṃ janmani tu śuklasya vāyunā bhede satirūpadvayaṃ bhavati |	yamalam janmani tu śuklasya vāyunā bhede sati rūpa dvayam bhavati 
MBaasaucadiipikaaHK-130	suprabhede -	suprabhede 
MBaasaucadiipikaaHK-131	garbhāśayāte? kāle vāyunā bhidyate yadā | śuklaṃ rūpadvayaṃ	kāle vāyunā bhidyate yadā śuklam rūpa dvayam 
MBaasaucadiipikaaHK-132	gatvā vardhateti śanistadeti ||	gatvā vardhata iti śaniḥ tadā iti 
MBaasaucadiipikaaHK-133	p. 332)	p 
MBaasaucadiipikaaHK-134	śaivapurāṇe ca -	śaivapurāṇe ca 
MBaasaucadiipikaaHK-135	vāyunā bahuśo bhinno yathāsvaṃ bahupatyateti | srāve pāte	vāyunā bahuśas bhinnaḥ yathāsvam srāve pāte 
MBaasaucadiipikaaHK-136	pitusnānaṃ pāta eva jñātīnāṃ snānam ||	pitu snānam pātaḥ eva jñātīnām snānam 
MBaasaucadiipikaaHK-137	yathā prāyaścittasamuccaye -	yathā prāyaścitta samuccaye 
MBaasaucadiipikaaHK-138	snānaṃ sarvatra tatpituḥ ārabhya pañcamamāsāt jñātīnāṃ	snānam sarvatra tad pituḥ ārabhya pañcama māsāt jñātīnām 
MBaasaucadiipikaaHK-139	snānamiṣyata iti | ava prasavastrividhaḥ | mṛtajāta jātamṛta	snānam iṣyate iti prasavaḥ trividhaḥ mṛta jāta jāta mṛta 
MBaasaucadiipikaaHK-140	sujātabhedāt | tatrādyayoḥ jñātīnāṃ sadvyaśśuddhiḥ |	sujāta bhedāt tatra ādyayoḥ jñātīnām 
MBaasaucadiipikaaHK-141	taduktaṃ kiraṇe -	tat uktam kiraṇe 
MBaasaucadiipikaaHK-142	patanātpūrṇa garbhasya śudirjñānātkṣaṇātmiketi |	patanāt pūrṇa garbhasya śudiḥ jñānāt kṣaṇa ātmikā iti 
MBaasaucadiipikaaHK-143	kāmike -	kāmike 
MBaasaucadiipikaaHK-144	pūrṇagarbhasya nāśe tu śuddhirjñānāt kṣaṇātmiketi |	pūrṇagarbhasya nāśe tu śuddhiḥ jñānāt kṣaṇa ātmikā iti 
MBaasaucadiipikaaHK-145	jñānaratnāvalyāmapi -	jñānaratnāvalyām api 
MBaasaucadiipikaaHK-146	srāvaṇātpūrṇagarbhasya śuddhirjñānātkṣaṇātmiketi |	srāvaṇāt pūrṇa garbhasya śuddhiḥ jñānāt kṣaṇa ātmikā iti 
MBaasaucadiipikaaHK-147	pitustu daśāhamāśaucam | yathā kāmike -	pituḥ tu daśa aham āśaucam yathā kāmike 
MBaasaucadiipikaaHK-148	pitrordaśāhameva syāt sarvadāśaucamagrajā iti | sujāte tu	pitroḥ daśa aham eva syāt sarvadā āśaucam agrajāḥ iti sujāte tu 
MBaasaucadiipikaaHK-149	pitrādi jñātīnāṃ pūrṇamāśaucam ||	pitṛ ādi jñātīnām pūrṇam āśaucam 
MBaasaucadiipikaaHK-150	sukhaprasavopi pūrvavantrividhaḥ - tatrādyayośśākhā śaucanna	sukha prasavaḥ api pūrvavat trividhaḥ 
MBaasaucadiipikaaHK-151	kartavyaṃ jananāśaucamevānuṣṭheyaṃ tathā cāvaprasavavat	kartavyam janana āśaucam eva anuṣṭheyam tathā 
MBaasaucadiipikaaHK-152	jñātīnāṃ prasavaśuddhiḥ | yathā jñānaratnāvalyām -	jñātīnām prasava śuddhiḥ yathā jñānaratnāvalyām 
MBaasaucadiipikaaHK-153	yadi jīvañjāto yadimṛto mṛtobā jāyate yadi |	yadi jīvan jātaḥ yadi mṛtaḥ mṛtaḥ u bā jāyate yadi 
MBaasaucadiipikaaHK-154	śāvāśaucannakartavyaṃ sūtyāśaucaṃ na samācarediti ||	sūtyāśaucam na samācaret iti 
MBaasaucadiipikaaHK-155	ata evā dandaśāhammaraṇepi jñātīnāṃ śiṣṭāhaṃ	atas eva jñātīnām śiṣṭā aham 
MBaasaucadiipikaaHK-156	sūtyāśaucamasti |	sūtyāśaucam asti 
MBaasaucadiipikaaHK-157	p. 333)	p 
MBaasaucadiipikaaHK-158	yathā saṃgrahe -	yathā saṃgrahe 
MBaasaucadiipikaaHK-159	antardaśāhe jātasya mṛtauśiṣṭāhamiṣyate |	antar daśa ahe jātasya mṛtauśiṣṭāham iṣyate 
MBaasaucadiipikaaHK-160	pitustvantardaśāhe antyadine tatprabhāte vā śiśumaraṇe dvyahaṃ	pituḥ tu antar daśa ahe antya dine tad prabhāte vā śiśu maraṇe dvi aham 
MBaasaucadiipikaaHK-161	tryahaṃ krameṇāśaucaṃ bhavati | pitustu dvyaha mantyāhe prabhāte	tri aham krameṇa āśaucam bhavati pituḥ tu prabhāte 
MBaasaucadiipikaaHK-162	tryahaṃ bhavediti | nanva ca prasave mṛta janmani sadyaśśuddhi |	tri aham bhavet iti 
MBaasaucadiipikaaHK-163	sukhaprasave mṛtañjanmani sūtyāśauca pūrṇamityatra	sukha prasave mṛtañjanmani sūti āśauca pūrṇam iti atra 
MBaasaucadiipikaaHK-164	kiliyāmakamiti ceducyate | jīvañjāta iti vacanameva niyāmakaṃ na	kiliyāmakam iti ced ucyate jīvan jātaḥ iti vacanam eva niyāmakam na 
MBaasaucadiipikaaHK-165	catasyāvaprasavepi prasaktiriti vācyam | pūrṇagarbhanāśe	prasaktiḥ iti vācyam pūrṇagarbhanāśe 
MBaasaucadiipikaaHK-166	sadyaśśaucaṃ vidhāyakakāmikādi vacanāvirodhiyat | na ca tarhi	sadyas śaucam vidhāyaka kāmika ādi vacana avirodhi yat na ca tarhi 
MBaasaucadiipikaaHK-167	aprasavepi daśāhamardhamaraṇe śiṣṭāhavidhirnasyāditi vācyam |	aprasave api daśa aham ardha maraṇe śiṣṭa aha vidhiḥ nasyāt iti vācyam 
MBaasaucadiipikaaHK-168	prabalamṛtajanananimittāgatānuvarti mānasyāśaucasya	prabala mṛta janana nimitta āgata anuvarti mānasya āśaucasya 
MBaasaucadiipikaaHK-169	nivartayitumaśakyatvāt pūrṇagarbhanāśaviṣaya	nivartayitum aśakya tvāt pūrṇagarbha nāśa viṣaya 
MBaasaucadiipikaaHK-170	kāmikādivacanasyāvaprasavadaśāhamardhamaraṇa viṣayatayā	kāmika ādi vacanasya avaprasava daśa aham ardha maraṇa viṣaya tayā 
MBaasaucadiipikaaHK-171	vaktumaśakyatvāccetyalamati prasaṃgena - sujātamapi dvividham -	vaktum aśakya tvāt ca iti alam ati prasaṃgena sujātam api dvividham 
MBaasaucadiipikaaHK-172	strījanana puṃjananañca prathame jātāyāḥ kanyakāyā yat	prathame jātāyāḥ kanyakāyāḥ yat 
MBaasaucadiipikaaHK-173	mātṛpitṛ tadbhrātṛ tatsuta pitāmahānā daśātramāśaucam |	mātṛ pitṛ tad bhrātṛ tad suta pitāmaha ānā daśa atram āśaucam 
MBaasaucadiipikaaHK-174	tathā kāmike -	tathā kāmike 
MBaasaucadiipikaaHK-175	bhātṛpitṛpitṛvyonye bāndhavā jñātaya smṛtāḥ | jñātīnāṃ	bhātṛ pitṛ pitṛvyaḥ nye bāndhavāḥ jñātayaḥ smṛtāḥ jñātīnām 
MBaasaucadiipikaaHK-176	strīṣu jātāsu nāśaucaṃ pravīdhīyate ||	strīṣu jātāsu na āśaucam pravīdhīyate 
MBaasaucadiipikaaHK-177	ti | smṛtāvapi -	ti smṛtau api 
MBaasaucadiipikaaHK-178	kanyakā janane bhrātṛ pitṛtatbhrātṛ tatsutāḥ |	kanyakāḥ janane bhrātṛ pitṛ tad bhrātṛ tad sutāḥ 
MBaasaucadiipikaaHK-179	p. 334)	p 
MBaasaucadiipikaaHK-180	pitāmahaśca tadbhrātā śudhyanta daśarātrata iti |	pitāmahaḥ ca tad bhrātā śudhyanta daśa rātrataḥ iti 
MBaasaucadiipikaaHK-181	puṃjanane tu āśaucinastrividhāḥ -	pum janane tu āśaucinaḥ trividhāḥ 
MBaasaucadiipikaaHK-182	pūrṇāśaucinastryahāśaucina pakṣiṇyāśaucinaśceti saptapuruṣa	pūrṇa āśaucinaḥ tri aha āśaucinaḥ pakṣiṇī āśaucinaḥ ca iti sapta puruṣa 
MBaasaucadiipikaaHK-183	paryantaṃ sapiṇḍāḥ pūrṇāśaucinaḥ | tataḥ pañcapuruṣa	paryantam sapiṇḍāḥ pūrṇa āśaucinaḥ tatas 
MBaasaucadiipikaaHK-184	paryantaṃ samānodakāstryahāśaucinastataḥ paraṃyāvat bāndhava	paryantam samānodakāḥ tri aha āśaucinaḥ tatas paraṃyāvat bāndhava 
MBaasaucadiipikaaHK-185	parijñānaṃ pakṣiṇyāśaucinaḥ | yathā kāmike -	parijñānam pakṣiṇī āśaucinaḥ yathā kāmike 
MBaasaucadiipikaaHK-186	āsaptapuruṣādgrāhyantapu * mṛtasūtayoḥ | tatopi tryahamāśaucaṃ	ā sapta puruṣāt mṛta sūtayoḥ tatas api tri aham āśaucam 
MBaasaucadiipikaaHK-187	paritaḥ pañcapūruṣāt ||	paritas pañca pūruṣāt 
MBaasaucadiipikaaHK-188	tadūrdhvaṃ pakṣiṇī grāhyā vijñātaṃ yadibāndhavaḥ iti	tad ūrdhvam pakṣiṇī grāhyā vijñātam yadibāndhavaḥ iti 
MBaasaucadiipikaaHK-189	pūrṇāśaucitvañca brāhmaṇānāndaśāhaṃ kṣatriyāṇāṃ	pūrṇa āśauci tvam ca brāhmaṇānām daśa aham kṣatriyāṇām 
MBaasaucadiipikaaHK-190	dvādaśāhaṃ vaiśyānāṃ pañcadaśāhaṃ śūdrāṇāmmāsamānaṃ	dvādaśa aham vaiśyānām pañcadaśa aham śūdrāṇām māsa mānam 
MBaasaucadiipikaaHK-191	tathā kāmike -	tathā kāmike 
MBaasaucadiipikaaHK-192	vipre śuddhidaṃ daśāhaṃ syāt kṣatriye dvādaśāhikā |	vipre śuddhi dam daśa aham syāt kṣatriye dvādaśāhikā 
MBaasaucadiipikaaHK-193	daśapañcāhikā śuddhi vaiśye śūdre ca māsiketi ||	daśapañcāhikā śuddhi vaiśye śūdre ca māsikā iti 
MBaasaucadiipikaaHK-194	svāyaṃbhuve ca -	svāyaṃbhuve ca 
MBaasaucadiipikaaHK-195	brahmaṇāndaśāhañca kṣatriye dvādaśāhaṃ bhavet | vaiśya	brahmaṇān daśa ahar ca kṣatriye dvādaśa aham bhavet vaiśya 
MBaasaucadiipikaaHK-196	pañcadaśañcai śūdrāṇāṃ triṃśati smṛtā ||	śūdrāṇām triṃśati smṛtā 
MBaasaucadiipikaaHK-197	suprabhede ca -	suprabhede ca 
MBaasaucadiipikaaHK-198	daśāhāśśuddhirviprasya dvādaśāhānnṛpasya tu | vaiśyasya	daśa ahāt śuddhiḥ viprasya dvādaśa ahāt nṛpasya tu vaiśyasya 
MBaasaucadiipikaaHK-199	pakṣataśśuddhiṃ māsācchūdrasya cocyata iti ||	pakṣatas śuddhim māsāt śūdrasya ca ucyate iti 
MBaasaucadiipikaaHK-200	p. 335)	p 
MBaasaucadiipikaaHK-201	ṣaṭsahasrikālottare -	ṣaṭsahasrikālottare 
MBaasaucadiipikaaHK-202	nādhikārīhyanuṣṭhāne yaddaśāhaṃ bhavedvijaḥ | dvadaśāhiṃ	na adhikārī hi anuṣṭhāne yat daśa aham bhavet vijaḥ dvadaśa ahim 
MBaasaucadiipikaaHK-203	nṛpañcaiva vaiśyaḥ pañcadaśāhataḥ ||	nṛpaṃ ca eva vaiśyaḥ pañcadaśa ahataḥ 
MBaasaucadiipikaaHK-204	nvartita japadhyāna śūdrosanathakṣata iti asya ca	iti asya ca 
MBaasaucadiipikaaHK-205	varṇaprayuktāśaucasyā śramavaśena saṃkoco bhavati | yathā	varṇa prayukta āśaucasya ā śrama vaśena saṃkocaḥ bhavati yathā 
MBaasaucadiipikaaHK-206	brahmacārī vānaprastha sanyāsināṃ sadyaśśaucaṃ gṛhasthasya na	brahmacārī vānaprastha sanyāsinām sadyaśśaucam gṛhasthasya na 
MBaasaucadiipikaaHK-207	kadāpi saṃkocaḥ | tatsaṃkocaka pramāṇābhāvāccaturṇāmapi	kadāpi saṃkocaḥ tad saṃkocaka pramāṇa abhāvāt caturṇām api 
MBaasaucadiipikaaHK-208	varṇānāṃ śaivāvalaṃbanetra śivāśramasvīkāresati	varṇānām śaiva avalaṃbana itra śiva āśrama svīkāre sati 
MBaasaucadiipikaaHK-209	samayaviśeṣa nirvāṇābhiṣekarūpa caturvidhena prativarṇaṃ	caturvidhena 
MBaasaucadiipikaaHK-210	samadhiputra sādhakācārya nāmānaḥ krameṇa janā bhavanti |	samadhiputra sādhakācārya nāmānaḥ krameṇa janāḥ bhavanti 
MBaasaucadiipikaaHK-211	samayīdīkṣitaścaiva sādhakontyogurustathā caturthasaṃsthitā	samayī dīkṣitaḥ ca eva sādhakaḥ untyaḥ guruḥ tathā caturtha saṃsthitā 
MBaasaucadiipikaaHK-212	varṇāsvaniyogavaśagā iti | tatra caturṣvapi varṇeṣu	varṇāsu aniyoga vaśagāḥ iti tatra caturṣu api varṇeṣu 
MBaasaucadiipikaaHK-213	sādhakācāryayo sadyaśścaucaṃ samadhiputrakayostu ādiśaiva	sādhaka ācāryayoḥ sadyas ścaucam samadhiputrakayoḥ tu ādiśā eva 
MBaasaucadiipikaaHK-214	mahāśaivānuśaiveṣu varṇoktāśaucasya na kadāpi saṃkocaḥ |	mahāśaiva anuśaiveṣu varṇa ukta āśaucasya na kadāpi saṃkocaḥ 
MBaasaucadiipikaaHK-215	avāntaraśaivānāntu samadhiputrakayo stvasasya saṃkocaḥ |	avāntaraśaivānām tu samadhi putrakayoḥ saṃkocaḥ 
MBaasaucadiipikaaHK-216	putrakasyāpi sarvavarṇeṣu pūjākāle sadyaśśaucaṃ | tatra	putrakasya api sarva varṇeṣu pūjā kāle sadyaśśaucam tatra 
MBaasaucadiipikaaHK-217	samayino dvividhāḥ | sandhyopāstamātra parāśśiva	samayinaḥ dvividhāḥ 
MBaasaucadiipikaaHK-218	karmaṇyapiratāśceti tatra prathamānāṃ samayināṃ	karmaṇi apiratāḥ ca iti tatra prathamānām samayinām 
MBaasaucadiipikaaHK-219	nityasnānajapadhyāna mātravatāṃ snānānuṣṭhāna japaparāṇāṃ	nitya snāna japa dhyāna mātravatām snāna anuṣṭhāna japa parāṇām 
MBaasaucadiipikaaHK-220	devālaya karmarahitānāmavāntara śaivānāṃ	devālaya karma rahitānām avāntara śaivānām 
MBaasaucadiipikaaHK-221	pañcaviṃśatirātramāśaucaṃ -	pañcaviṃśati rātram āśaucam 
MBaasaucadiipikaaHK-222	p. 336)	p 
MBaasaucadiipikaaHK-223	devālaye vidhivat sammārjanālepanādiśivakaiṅkaryagatāñcaryā	devālaye vidhivat sammārjana ālepana ādi śiva kaiṅkarya gatā āñcaryā 
MBaasaucadiipikaaHK-224	pādaprokta dāsamārgānuṣṭhāna vatāmavāntara	pāda prokta dāsa mārga anuṣṭhāna vatām avāntara 
MBaasaucadiipikaaHK-225	śaivānāndvitīyānāṃ samayināṃ viṃśatirātramāśaucaṃ tathā	samayinām viṃśati rātram āśaucam tathā 
MBaasaucadiipikaaHK-226	kāmike -	kāmike 
MBaasaucadiipikaaHK-227	śivakarmaratāye tu śūdrabhasmādi saṃyutāḥ |	tu śūdra bhasma ādi saṃyutāḥ 
MBaasaucadiipikaaHK-228	dinairviṃśatibhiśśuddhāḥ pañcaviṃśatibhiḥ parā | iti	dinaiḥ viṃśatibhiḥ śuddhāḥ pañcaviṃśatibhiḥ parāḥ iti 
MBaasaucadiipikaaHK-229	atra -	atra 
MBaasaucadiipikaaHK-230	kriyāmūrtermaheśasya ālase susamāhitāḥ | śanaissammārjanaṃ	kriyā mūrteḥ maheśasya ālase su samāhitāḥ śanais sammārjanam 
MBaasaucadiipikaaHK-231	kurvan mārjanyāmṛdu sūkṣmayā ||	kurvan mārjanyā amṛdu sūkṣmayā 
MBaasaucadiipikaaHK-232	viśuddhaṃ gomayaṃ grāhya lepayecchaṃkarālaye | ātmāna *	viśuddham gomayam grāhya lepayet śaṃkara ālaye 
MBaasaucadiipikaaHK-233	modbhavaiḥ puṣpai samādāya śiasya tu ||	ma udbhavaiḥ puṣpaiḥ samādāya śiasya tu 
MBaasaucadiipikaaHK-234	mālāṃ gṛhītvā yo dadyāt śubhāvanti samanvitāḥ |	mālām gṛhītvā yaḥ dadyāt śubha avanti samanvitāḥ 
MBaasaucadiipikaaHK-235	stotragānādikaṃ sarvaṃ yaḥ kuryāddāgamārga iti	stotra gāna ādikam sarvam yaḥ kuryāt dāga mārge iti 
MBaasaucadiipikaaHK-236	śivajñānabodhasaṃgrahe dāsamārgaśśivakarmaśabdenoktaḥ | para	                            
MBaasaucadiipikaaHK-237	ityanena dāsamārga rahitā anye uktāḥ | viśeṣa dīkṣā	ityanena dāsamārga rahitāḥ anye uktāḥ viśeṣa dīkṣā 
MBaasaucadiipikaaHK-238	saṃskāravatāṃ putrakāṇāṃ bhasmarudrākṣadhāriṇā	saṃskāravatām putrakāṇām bhasma rudrākṣa dhāriṇā 
MBaasaucadiipikaaHK-239	maheśvarapūjāvatā mavāntaraśaivānāṃ sūtake mṛtake ca |	maheśvara pūjāvatā m avāntaraśaivānām sūtake mṛtake ca 
MBaasaucadiipikaaHK-240	pañcadaśāhamāśaucam | taduktaṃ kāmike -	pañcadaśa aham āśaucam tat uktam kāmike 
MBaasaucadiipikaaHK-241	ye ca maheśvarāśśūdrā bhasmarudrākṣadhāriṇaḥ | teṣāṃ	ye ca maheśvarāḥ śūdrāḥ bhasma rudra akṣa dhāriṇaḥ teṣām 
MBaasaucadiipikaaHK-242	pañcadaśāhena śuddhiḥ syānmṛtasūtake ||	pañcadaśa ahena śuddhiḥ syāt mṛta sūtake 
MBaasaucadiipikaaHK-243	māheśvarā maheśvarapūjāvanta ityarthaḥ | svāyaṃbhuve ca -	māheśvarāḥ maheśvara pūjāvantaḥ iti arthaḥ svāyaṃbhuve ca 
MBaasaucadiipikaaHK-244	liṃgārcanaśivabhaktānāṃ āśaucaṃ pakṣamācaret |	liṃga arcana śiva bhaktānām āśaucam pakṣam ācaret 
MBaasaucadiipikaaHK-245	p. 337)	p 
MBaasaucadiipikaaHK-246	iti | jñānaratnāvalyāṃ ca -	iti jñānaratnāvalyām ca 
MBaasaucadiipikaaHK-247	amadyapā kulīnaśca nityaṃ dharmaparāyaṇaḥ | dīkṣitaśca	a madyapā kulīnaḥ ca nityam dharma parāyaṇaḥ dīkṣitaḥ ca 
MBaasaucadiipikaaHK-248	bhavecchūdraḥ pakṣaikammāsamanyatheti |	bhavet śūdraḥ pakṣa ekam māsam anyathā iti 
MBaasaucadiipikaaHK-249	pravaraśaivāntya śaivayostu cintyau -	pravara śaiva antya śaivayoḥ tu cintyau 
MBaasaucadiipikaaHK-250	samayaviśeṣayorasaṃbhavatorapi samayi viśeṣyo svasvajātyuktāśau	samaya viśeṣayoḥ asaṃbhavatoḥ api samayi sva sva jāti ukta āśau 
MBaasaucadiipikaaHK-251	casyāvāntara śaivatvanna saṃkocaḥ | tatsaṃkoce pramāṇābhāvāt	saṃkocaḥ tad saṃkoce pramāṇa abhāvāt 
MBaasaucadiipikaaHK-252	| nanu kramāśaucaṃ guṇāśaucaṃ nirasyandūrataḥ kalāvityādi	nanu krama āśaucam guṇa āśaucam nirasyan dūratas kalau ityādi 
MBaasaucadiipikaaHK-253	smṛtibhiravāntaraśaivasyāpi samayiputrakatvālaṃbanāśaucasya	smṛtibhiḥ avāntaraśaivasya api samayi putraka tva ālaṃbana āśaucasya 
MBaasaucadiipikaaHK-254	guṇāśaucatayā nirasyatvame veti ca kāmikādiḥ pramāṇaḥ yathā -	guṇa āśauca tayā nirasya tvam e vā iti ca kāmika ādiḥ pramāṇaḥ yathā 
MBaasaucadiipikaaHK-255	śivāgamavidāṃ tadvat śivāśramaniṣeviṇāmiti |	śiva āgama vidām tadvat śiva āśrama niṣeviṇām iti 
MBaasaucadiipikaaHK-256	śivadharmepi-	śivadharme pi 
MBaasaucadiipikaaHK-257	sarveṣāmeva varṇānāṃ śivāśrama niṣeviṇām |	sarveṣām eva varṇānām śiva āśrama niṣeviṇām 
MBaasaucadiipikaaHK-258	śivadharmaśśivoktaḥ dharmakāmārthamuktaye ||	śiva dharmaḥ śiva uktaḥ dharma kāma artha muktaye 
MBaasaucadiipikaaHK-259	brāhmaṇaḥ kṣatriyo vaiśya strīśūdro vā śivāśramī |	brāhmaṇaḥ kṣatriyaḥ vaiśya strī śūdraḥ vā śiva āśramī 
MBaasaucadiipikaaHK-260	brahmacārī gṛhastho vā vānaprasthoya bhikṣuka iti | nanu -	brahmacārī gṛhasthaḥ vā bhikṣukaḥ iti nanu 
MBaasaucadiipikaaHK-261	nirvāṇa dīkṣitānāntu sūtakaṃ naiva vidyate |	nirvāṇa dīkṣitānām tu sūtakam na eva vidyate 
MBaasaucadiipikaaHK-262	śivavratadharasyāsya na mṛtirna ca sūtakam ||	śiva vrata dharasya asya na mṛtiḥ na ca sūtakam 
MBaasaucadiipikaaHK-263	samayasthasya nāśaucaṃ nityakarmaṇi sarvadā | kāmyakarmanyā śau	samayasthasya na āśaucam nityakarmaṇi sarvadā 
MBaasaucadiipikaaHK-264	caṃ taccasnānāntivartata || iti	iti 
MBaasaucadiipikaaHK-265	p. 338)	p 
MBaasaucadiipikaaHK-266	kālottarādiṣu nirvāṇadīkṣitānāṃ sūtakābhāvaḥ pratīyate	kālottara ādiṣu nirvāṇa dīkṣitānām sūtaka abhāvaḥ pratīyate 
MBaasaucadiipikaaHK-267	teṣveva puraḥ kartavyantasmāllaukikairapi dīkṣitai	teṣu eva puras kartavyam tasmāt laukikaiḥ api 
MBaasaucadiipikaaHK-268	rityādibhisteṣāmeva sūtakasadbhāvaśca pratīyate | tathā ca	r ityādibhiḥ teṣām eva sūtaka sadbhāvaḥ ca pratīyate tathā ca 
MBaasaucadiipikaaHK-269	sarvavarṇeṣvapi sādhākā cāryayossadyaśśauca	sarva varṇeṣu api ca āryayoḥ sadyas śauca 
MBaasaucadiipikaaHK-270	varṇanamanupantamiti ceducyate | ubhayavidhavacanānāmapi	varṇanam anupantam iti ced ucyate ubhayavidha vacanānām api 
MBaasaucadiipikaaHK-271	śivapranītatayā prāmāṇyastha sadbhavena	         
MBaasaucadiipikaaHK-272	nirvānadīkṣāyāntaratamya kalpanayā parasparavirodhaḥ |	kalpanayā paraspara virodhaḥ 
MBaasaucadiipikaaHK-273	pariharaṇīyaḥ | atraiva bālaratnāvalī	pariharaṇīyaḥ atra eva bālaratnāvalī 
MBaasaucadiipikaaHK-274	kārajñānaśaṃkarācāryairvipratipattimudbhāvya ācāryāṇāṃ	kāra jñāna śaṃkara ācāryaiḥ vipratipattim udbhāvya ācāryāṇām 
MBaasaucadiipikaaHK-275	punardāhetadandapi daśarātrakam | sarveṣameva varṇānāṃ sūtake	daśa rātrakam sarveṣam eva varṇānām sūtake 
MBaasaucadiipikaaHK-276	mṛtake tathā ||	mṛtake tathā 
MBaasaucadiipikaaHK-277	daśāhenaiva śuddhisyāditi śātātapobravīt | mantravarjantu	daśa ahena eva śuddhiḥ syāt iti śātātapaḥ bravīt mantra varjan tu 
MBaasaucadiipikaaHK-278	śūdrāṇāṃ dvādaśāhe sa piṇḍanam ||	śūdrāṇām dvādaśa ahe sa piṇḍanam 
MBaasaucadiipikaaHK-279	kartavyaṃ sarvadāytnātathaiva prajāpatiḥ |	kartavyam sarvadā āytnā tathā eva prajāpatiḥ 
MBaasaucadiipikaaHK-280	āṃgira ṛṣiḥ -	āṃgiraḥ ṛṣiḥ 
MBaasaucadiipikaaHK-281	śiṣyaśca dāsamṛtakau svasvapiṇḍātyayātike | gurusvāmi	śiṣyaḥ ca dāsa mṛtakau sva sva piṇḍa atyayātike guru svāmī 
MBaasaucadiipikaaHK-282	samāśaucamiti tatkulavāsinaḥ ||	sama āśaucam iti tad kula vāsinaḥ 
MBaasaucadiipikaaHK-283	nirvāṇa dīkṣāyāṃ śivamalākadharma bhajanābhyāṃ vā	nirvāṇa dīkṣāyām śiva malāka dharma bhajanābhyām vā 
MBaasaucadiipikaaHK-284	lokadhamiṇyāmapi sadāśivalokāya stanalokadharma bhajanābhyāṃ vā	loka dhamiṇyām api sadāśiva lokāya stana loka dharma bhajanābhyām vā 
MBaasaucadiipikaaHK-285	sūtake pṛthak pākasahita tadrahitābhyāṃ vā bhedaṃ parikalpya	sūtake pṛthak pāka sahita tad rahitābhyām vā bhedam parikalpya 
MBaasaucadiipikaaHK-286	sūtakā bhāvābhāva vacanānāṃ paraspara virodhaḥ parihṛtaḥ |	sūtakā bhāva abhāva vacanānām paraspara virodhaḥ parihṛtaḥ 
MBaasaucadiipikaaHK-287	tathā ca śivadharmiṇyā dīkṣitānāṃ sadāśivādilokaḥ |	tathā ca śiva dharmiṇyā dīkṣitānām sadāśiva ādi lokaḥ 
MBaasaucadiipikaaHK-288	lokadharmiṇyā dīkṣitānāñca pṛthak pākavatāṃ sadyaśścaucam |	loka dharmiṇyāḥ dīkṣitānām ca pṛthak pākavatām sadyas ścaucam 
MBaasaucadiipikaaHK-289	p. 339)	p 
MBaasaucadiipikaaHK-290	pṛthak pākarahitānāṃ nirvāṇadīkṣitānāntu sūtakamatasthitam |	pṛthak pāka rahitānām nirvāṇa dīkṣitānām tu sūtaka mata sthitam 
MBaasaucadiipikaaHK-291	śivadharmiṇī dīkṣādyavalaṃbanenaiva	śiva dharmiṇī dīkṣā ādi avalaṃbanena eva 
MBaasaucadiipikaaHK-292	samayāssadyaśśaucamuktamiti nānupapannam | nanu tarhi yeṣāṃ	samayāḥ sadyas śaucam uktam iti na anupapannam nanu tarhi yeṣām 
MBaasaucadiipikaaHK-293	sūtakamasti teṣāṃ nirvāṇa dīkṣitānāṃ kiyaddinamāśaucamiti	sūtakam asti teṣām nirvāṇa dīkṣitānām kiyat dinam āśaucam iti 
MBaasaucadiipikaaHK-294	ceducyate | ādiśaiva mahāśaivānuśaivāvāntaraśaiveṣu	ced ucyate ādiśaiva mahāśaiva anuśaiva avāntaraśaiveṣu 
MBaasaucadiipikaaHK-295	sarveṣvapi teṣāntridinamevāśaucam | uktaṃ prāyaścitta samuccaye	sarveṣu api teṣām tri dinam eva āśaucam uktam prāyaścitta samuccaye 
MBaasaucadiipikaaHK-296	nahānirna pṛthakpākastasyāśuddhiśśivātmike |	na hāniḥ na pṛthakpākaḥ tasya aśuddhiḥ śiva ātmike 
MBaasaucadiipikaaHK-297	kālottarepi -	kāla uttare pi 
MBaasaucadiipikaaHK-298	ahanyahavikartavya mantaryāgaṇṭinatrayam | caturthehani nityantu	caturthe hani 
MBaasaucadiipikaaHK-299	kartavyantena pūrvavat ||	kartavya antena pūrvavat 
MBaasaucadiipikaaHK-300	na cātrāntaryāgaḥ pratipādyante tena sūtakaṃ vidhīyata iti	na ca atra antaryāgaḥ pratipādyante tena sūtakam vidhīyate iti 
MBaasaucadiipikaaHK-301	vācyam | antaryāgavidhānasya svavinābhūtasya sūtake gamakatvāt na	vācyam antaryāga vidhānasya sva vinābhūtasya sūtake gamaka tvāt na 
MBaasaucadiipikaaHK-302	ca sūtake samayināṃ bahiryāgasyaiva vihitatayāntaryāga	ca sūtake samayinām bahis yāgasya eva vihita tayā antaryāga 
MBaasaucadiipikaaHK-303	vidhānamupapannamiti vācyam | antaryāgavidhāna manucitaṃ tatra	vidhānam upapannam iti vācyam antaryāga vidhāna manucitam tatra 
MBaasaucadiipikaaHK-304	bahulamupalaṃbhena nirmātumaśakyatvāt tarhi ubhayavidhavacanānāṃ	bahulam upalaṃbhena nirmātum aśakya tvāt tarhi ubhayavidha vacanānām 
MBaasaucadiipikaaHK-305	parasparavirodhādapramāṇyāditi cenna | bhaktijñānavairāgya	paraspara virodhāt apramāṇyāt iti ced na 
MBaasaucadiipikaaHK-306	dāḍharyādāḍhayābhyāṃ vyavasthopapatteḥ | uktañca kāmike -	dāḍharya a dāḍhayābhyām vyavasthā upapatteḥ uktam ca kāmike 
MBaasaucadiipikaaHK-307	bhaktijñānavairāgya meteṣvanyatamantu vā | yasya samyak bhavettena	bhakti jñāna vairāgya m eteṣu anyatamantu vā yasya samyak bhavet tena 
MBaasaucadiipikaaHK-308	kāryaṃ samayinārcanamiti ||	kāryam samayinā arcanam iti 
MBaasaucadiipikaaHK-309	p. 340)	p 
MBaasaucadiipikaaHK-310	mandaṃ mandataraṃ vāpi yasyetatritayaṃ bhavet |	mandam mandataram vā api yasya ita tritayam bhavet 
MBaasaucadiipikaaHK-311	antaryāgaśca tenāpi kartavya iti - tasmādādi caturṣvapi śaiveṣu	antaryāgaḥ ca tena api kartavyaḥ iti tasmādādi caturṣu api śaiveṣu 
MBaasaucadiipikaaHK-312	pṛthak pākarahitānāṃ nirvāṇa dīkṣitānāṃ trirātramāśaucam	pṛthak pāka rahitānām nirvāṇa dīkṣitānām tri rātram āśaucam 
MBaasaucadiipikaaHK-313	avāntaraśaiveṣu samayanaśca sandhyopāstimātrataḥ	avāntaraśaiveṣu samayanaḥ ca sandhyā upāsti mātrataḥ 
MBaasaucadiipikaaHK-314	pañcaviṃśaddinaṃ śivakarmaratasya samayinaḥ viṃśaddinamāśaucam	pañcaviṃśat dinam śivakarma ratasya samayinaḥ viṃśat dinam āśaucam 
MBaasaucadiipikaaHK-315	| putrakasya pañcadaśadinaṃ bhavatīti niravadhaṃ | evaṃ	putrakasya pañcadaśa dinam bhavati iti niravadham evam 
MBaasaucadiipikaaHK-316	rudrakanyānāmapi nakrādi pañcācāryāṇāmapi pañcadaśāhaṃ	rudra kanyānām api nakra ādi pañca ācāryāṇām api pañcadaśa aham 
MBaasaucadiipikaaHK-317	taduktaṃ kāmike -	tat uktam kāmike 
MBaasaucadiipikaaHK-318	tathaiva rudrakanyāyāṃ pañcācaryopi sammatamiti |	tathā eva rudrakanyāyām pañcācaryaḥ upi sammatam iti 
MBaasaucadiipikaaHK-319	candrajñāne tu -	candra jñāne tu 
MBaasaucadiipikaaHK-320	rudrakanyānāñcaturdaśāhamuktam - tadyathā -	rudra kanyānām caturdaśa aham uktam tat yathā 
MBaasaucadiipikaaHK-321	janmāśaucaṃ mṛtāśaucaṃ caturddaśāhena śudhyati |	janma āśaucam mṛta āśaucam caturddaśa ahena śudhyati 
MBaasaucadiipikaaHK-322	pañcācāryāḥ -	pañca ācāryāḥ 
MBaasaucadiipikaaHK-323	nartako madarkaścaiva gāyako vaṃśakastathetyādinoktāḥ	nartakaḥ madarkaḥ ca eva gāyakaḥ vaṃśakaḥ tathā ityādinā uktāḥ 
MBaasaucadiipikaaHK-324	āgamavihita drāviḍagānavatāṃ pañcadaśāhamāśaucaṃ muktaṃ	āgama vihita drāviḍa gānavatām pañcadaśa aham āśaucam muktam 
MBaasaucadiipikaaHK-325	kāmike -	kāmike 
MBaasaucadiipikaaHK-326	śivajñānavidāṃ tadvacchivāśrama niṣeviṇāmiti |	śiva jñāna vidām tadvat śiva āśrama niṣeviṇām iti 
MBaasaucadiipikaaHK-327	devadāsīnāntu viṃśatidinaiśśuddhiḥ | tathaiva kāmike -	devadāsīnām tu viṃśati dinaiḥ śuddhiḥ tathā eva kāmike 
MBaasaucadiipikaaHK-328	dinairviṃśatibhiśśuddhirddevadāsyāḥ prakīrtyata iti	dinaiḥ viṃśatibhiḥ śuddhiḥ devadāsyāḥ prakīrtyate iti 
MBaasaucadiipikaaHK-329	candrajñāne tu devadāsyā āśaucaṃ pakṣāntamityuktam |	candra jñāne tu devadāsyāḥ āśaucam pakṣa antam iti uktam 
MBaasaucadiipikaaHK-330	janmāśaucaṃ mṛtāśaucaṃ pakṣāhena viśuddhayati |	janma āśaucam mṛta āśaucam pakṣa ahena 
MBaasaucadiipikaaHK-331	p. 341)	p 
MBaasaucadiipikaaHK-332	svāyaṃbhuvepi -	svāyaṃbhuve pi 
MBaasaucadiipikaaHK-333	rudrakanyādināṃ viśeṣataḥ pradarśitaḥ -	rudra kanyā ādinām viśeṣataḥ pradarśitaḥ 
MBaasaucadiipikaaHK-334	rudrasyagaṇikānāñca āśaucañca tayodaśa | tapasvī	āśaucam ca tayodaśa tapasvī 
MBaasaucadiipikaaHK-335	devadāsīnāṃ pakṣamekamāśaucam ||	deva dāsīnām pakṣam ekam āśaucam 
MBaasaucadiipikaaHK-336	viṣṇudāsakadāsīnāndaśapañcakameva ceti |	viṣṇudāsaka dāsīnām daśa pañcakam eva ca iti 
MBaasaucadiipikaaHK-337	atra rudrakanyānāṃ devadāsīnāñca svarūpakarma cāśaucañca	atra rudra kanyānām deva dāsīnām ca sva rūpa karma ca āśaucam ca 
MBaasaucadiipikaaHK-338	vistareṇa kāraṇe pradarśitam -	vistareṇa kāraṇe pradarśitam 
MBaasaucadiipikaaHK-339	datta kritābhibhūtā bhaktāmṛtālaṃkāradāsikā | rudrakanyā ca	                 
MBaasaucadiipikaaHK-340	saptaitā mamakarma niyojitāḥ ||	sapta etāḥ mama karma niyojitāḥ 
MBaasaucadiipikaaHK-341	yā svadāmakṛṣyādi viṣaye bhaktimajjane | sā dattā iti vikhyātā	yā sva dāma kṛṣi ādi viṣaye bhakti majjane sā dattā iti vikhyātā 
MBaasaucadiipikaaHK-342	krītāyā lakṣaṇaṃ śṛṇu ||	krītāyāḥ lakṣaṇam śṛṇu 
MBaasaucadiipikaaHK-343	dāsyarthaṃ mama bhaktena dravyalobhena vā punaḥ | vittaṃ gṛhītvā	dāsī artham mama bhaktena dravya lobhena vā punar vittam gṛhītvā 
MBaasaucadiipikaaHK-344	yā dattā sā vikrīteti kīrtitā ||	yā dattā sā vikrītā iti kīrtitā 
MBaasaucadiipikaaHK-345	kuḍumbamaraṇārthāya gāyantī mamamandiram | jīvanāya bhaveddāsī	kuḍumba maraṇa arthāya gāyantī mama mandiram jīvanāya bhavet dāsī 
MBaasaucadiipikaaHK-346	cihnitābhibhūtakocyate ||	cihnitā abhibhūtakā ucyate 
MBaasaucadiipikaaHK-347	yā bhaktā svayamevāhaṃ dāsīsyamiti śāṃbhave | ālayerpita	yā bhaktā svayam eva aham dāsīsyam iti śāṃbhave 
MBaasaucadiipikaaHK-348	cihnā syāt sā hi bhaktābhidhīyate ||	cihnā syāt sā hi bhaktā abhidhīyate 
MBaasaucadiipikaaHK-349	yā pūrvaṃ mamagehe tu dāsī kanyātra niṣṭhitā | āmṛtā	yā pūrvam mama gehe tu dāsī kanyā atra niṣṭhitā 
MBaasaucadiipikaaHK-350	kutracit kṣobhā kālārcānyātra deśikaiḥ ||	kutracid kṣobhā kāla arcā anyā atra deśikaiḥ 
MBaasaucadiipikaaHK-351	āsaktairarpitā dāsī samṛtā kathyatedhunā | kāritārā	āsaktaiḥ arpitā dāsī samṛtā kathyate idhunā kāri tārā 
MBaasaucadiipikaaHK-352	naṭairgāna nṛtayorati śikṣitāḥ ||	naṭaiḥ gāna nṛtayoḥ ati śikṣitāḥ 
MBaasaucadiipikaaHK-353	p. 342)	p 
MBaasaucadiipikaaHK-354	rājanāṭakaśālāyāṃ śikṣayantī tathāparā | sā	rāja nāṭaka śālāyām śikṣayantī tathā aparā sā 
MBaasaucadiipikaaHK-355	śiṣyālaṃkṛtā vastu bhūṣaṇairati sundarī ||	śiṣya alaṃkṛtā vastu bhūṣaṇaiḥ ati sundarī 
MBaasaucadiipikaaHK-356	toṣaṇārthammameśasya mandire bhūbhṛtā punaḥ | bihitākṛtacinhā	toṣaṇa artham mama īśasya mandire bhūbhṛtā punar bihitā a kṛta cinhā 
MBaasaucadiipikaaHK-357	syāt sāhyalaṃ kāradāsikā ||	syāt sā ahi alam kāra dāsikā 
MBaasaucadiipikaaHK-358	ṛṣibhāryāvarārohā mamasaṃparkataḥ punaḥ | taistyaktā mamagehe	ṛṣi bhāryā varārohāḥ mama saṃparkataḥ punar taiḥ tyaktāḥ mama gehe 
MBaasaucadiipikaaHK-359	tu tā smṛtā rudrakanyakāḥ ||	tu tāḥ smṛtāḥ rudra kanyakāḥ 
MBaasaucadiipikaaHK-360	evaṃ proktā bahuvidhā dṛśyante mamamandire | dāsyaḥ puṇyādhike	evam proktāḥ bahuvidhāḥ dṛśyante mama mandire dāsyaḥ puṇya adhike 
MBaasaucadiipikaaHK-361	loke mamakarmaparāyaṇāḥ ||	loke mama karma parāyaṇāḥ 
MBaasaucadiipikaaHK-362	yāḥ paraṃparāyā māsa stāsāṃ puṇyāvadhiḥ kutaḥ | yāstu	yāḥ paraṃparāyāḥ māsaḥ stāsām puṇya avadhiḥ kutas yāḥ tu 
MBaasaucadiipikaaHK-363	saṃkarajātīyā śuddhāstāścavarāṃganāḥ ||	saṃkara jātīyā śuddhāḥ tāḥ ca vara aṃganāḥ 
MBaasaucadiipikaaHK-364	mamamandirakarmāṇi vidadhyuḥ cihnitāḥ punaḥ | āsāṃ	mama mandira karmāṇi vidadhyuḥ cihnitāḥ punar āsām 
MBaasaucadiipikaaHK-365	lakṣaṇabhedanmamadīkṣā vidhānataḥ ||	vidhānataḥ 
MBaasaucadiipikaaHK-366	tathivā cārabhedaśca tāsāṃ karmānurūpataḥ |	tathivā cāra bhedaḥ ca tāsām karma anurūpataḥ 
MBaasaucadiipikaaHK-367	rudragaṇikastāsāṃ jananādi na vidyate ||	rudra gaṇikaḥ tāsām janana ādi na vidyate 
MBaasaucadiipikaaHK-368	ārātra gītanṛttāni karmatāsāṃ vidhīyate |	ārāt atra gīta nṛttāni karma tāsām vidhīyate 
MBaasaucadiipikaaHK-369	anyāsāndevadāsīnāntattatkarmāṇime śṛṇu ||	anyāsān deva dāsīnām tad tad karmāṇi ime śṛṇu 
MBaasaucadiipikaaHK-370	mārjana prokṣaṇālepa cūrṇakarmāṇi deśikaḥ | taṇḍulānayanaṃ	mārjana prokṣaṇa ālepa cūrṇakarmāṇi deśikaḥ taṇḍulānayanam 
MBaasaucadiipikaaHK-371	pātraśodhanaṃ gānanṛttayoḥ ||	pātra śodhanam gāna nṛttayoḥ 
MBaasaucadiipikaaHK-372	sevanaṃ veṇuvīṇādi vādanañcaiva mādikam | śaṃkayā	sevanam veṇu vīṇā ādi vādanam ca eva mādikam śaṃkayā 
MBaasaucadiipikaaHK-373	vābhimānena vaṃśanenānyatopi vā ||	vā abhimānena vaṃśanena anyatas api vā 
MBaasaucadiipikaaHK-374	p. 343)	p 
MBaasaucadiipikaaHK-375	vidadhyussarvakarmāṇi rudrakanyāviśeṣataḥ | yāśca	vidadhyuḥ sarva karmāṇi rudra kanyā viśeṣataḥ yāḥ ca 
MBaasaucadiipikaaHK-376	saṃkarajātīyā mamadāsya iti smṛtāḥ ||	saṃkara jātīyāḥ mamadāsyaḥ iti smṛtāḥ 
MBaasaucadiipikaaHK-377	dhautavastrā kariṣyanti sarvakarmaṇi tastriyaḥ | yābha * * tra	dhauta vastrā kariṣyanti sarvakarmaṇi tastriyaḥ 
MBaasaucadiipikaaHK-378	sarvāsumamadasīti viśrutā ||	viśrutā 
MBaasaucadiipikaaHK-379	tatputrī pautrikādīnāṃ vihitaṃ karmacchṛṇu | māṃgalya	tad putrī pautrika ādīnām vihitam karma śṛṇu māṃgalya 
MBaasaucadiipikaaHK-380	sūtradhāraṇaṃ kartavyaṃ śivasannidhau ||	sūtra dhāraṇam kartavyam śiva sannidhau 
MBaasaucadiipikaaHK-381	pāraṃparyāgatānāñca narānāmaviśeṣataḥ | brāhmaṇī tulyatnā	pāraṃparya āgatānām ca narānām aviśeṣataḥ brāhmaṇī tulya tnā 
MBaasaucadiipikaaHK-382	vastra dhāraṇādiṣu kalpyate ||	vastra dhāraṇā ādiṣu kalpyate 
MBaasaucadiipikaaHK-383	tripuṇḍra dhāraṇañcaiva śivadīkṣā purassaram ||	tripuṇḍra dhāraṇañca eva śiva dīkṣā purassaram 
MBaasaucadiipikaaHK-384	sūtake mṛtakenyonya māśaucañcārdhamāsakam | tasyāṃ	sūtake mṛtake nyonyam mā āśaucam ca ardha māsakam tasyām 
MBaasaucadiipikaaHK-385	triṇetramekāhaṃ pakṣī * harati kramaḥ ||	trinetram eka aham pakṣī harati kramaḥ 
MBaasaucadiipikaaHK-386	sarvatra mṛtake sūtepya * ñca daśāhikam | na vṛddhabāla	sarvatra mṛtake daśa āhikam na vṛddha bāla 
MBaasaucadiipikaaHK-387	niyāmakeneva strī puṃsayoḥ kramaḥ ||	niyāmakena iva strī puṃsayoḥ kramaḥ 
MBaasaucadiipikaaHK-388	asti caikakula jñānaṃ yāvattāvadadhaṃ bhavet | tāsāṃ tu	asti ca ekakula jñānam yāvat tāvat adham bhavet tāsām tu 
MBaasaucadiipikaaHK-389	putrikābhāve gṛhītvā * * lotabhavām ||	putrikā abhāve gṛhītvā lota bhavām 
MBaasaucadiipikaaHK-390	putrikā * da vidhinā tayā karmāṇi kārayet | rudrakanyādi	putrikā da vidhinā tayā karmāṇi kārayet rudrakanyā ādi 
MBaasaucadiipikaaHK-391	dāsīnā nartānāñcaiva deśikaḥ ||	dāsīnām nartānām ca eva deśikaḥ 
MBaasaucadiipikaaHK-392	kuladvayaṃ bhavettāsāṃ pūrvañcāparameva ca |	kula dvayam bhavet tāsām pūrvam ca aparam eva ca 
MBaasaucadiipikaaHK-393	samānavaṃśajātīnāṃ madhañcoma * to bhavet ||	samāna vaṃśa jātīnām taḥ bhavet 
MBaasaucadiipikaaHK-394	p. 344)	p 
MBaasaucadiipikaaHK-395	gotra sūtramrāntarañcaiva dattānāmagra janmanām | pūrvatra	gotra sūtramrāntarañca eva dattānām agra janmanām pūrvatra 
MBaasaucadiipikaaHK-396	pitṝṇāñca pūrṇamāśaucamiṣyate ||	pitṝṇām ca pūrṇam āśaucam iṣyate 
MBaasaucadiipikaaHK-397	āsāntu gotrasūtrañca neṣyate deśikottamaḥ | anuṣṭheyaṃ tataḥ	gotra sūtram ca na iṣyate deśika uttamaḥ anuṣṭheyam tatas 
MBaasaucadiipikaaHK-398	pūrvā parayorvaṃśajantvadham ||	pūrvā parayoḥ vaṃśa jantu adham 
MBaasaucadiipikaaHK-399	paratravaṃśadattānāmapi pañcadasśānhikam ||	paratra vaṃśa dattānām api pañcadasśa ānhikam 
MBaasaucadiipikaaHK-400	mātṛbandhu subandhūnā manyonyaṃ sūtakemṛtau | adhaṃ	mātṛ bandhu subandhūnām manyonyam sūtakemṛtau 
MBaasaucadiipikaaHK-401	pañcadaśāhaṃ syāt pāraśaivādināmapi ||	pañcadaśa aham syāt pāraśaiva ādinām api 
MBaasaucadiipikaaHK-402	yathā bījaka saṃbandha mātranaśca tapasvinām | āśaucayoni	yathā bījaka saṃbandha mātranaḥ ca tapasvinām āśauca yoni 
MBaasaucadiipikaaHK-403	saṃbandhādardhamāsaṃ vidhīyate ||	saṃbandhāt ardha māsam vidhīyate 
MBaasaucadiipikaaHK-404	rudrakanyādidāsīnā pāraśaiva tapasvinām | adhaṃ pañcadaśāhaṃ	tapasvinām 
MBaasaucadiipikaaHK-405	syādajñānamubhayatra ca ||	syāt ajñānam ubhayatra ca 
MBaasaucadiipikaaHK-406	dattānāmubhayaprāptarvidyate deśikottamam | tasmāttu devadāsīnā	dattānām ubhaya prāptar vidyate deśika uttamam tasmāt tu deva dāsīnā 
MBaasaucadiipikaaHK-407	māśaucañcāthamāsikam ||	mā āśaucam ca atha māsikam 
MBaasaucadiipikaaHK-408	yāstu karmandire dāsyavargabhedena kalpitāḥ | tadabhinna kūlāyāṃ	yāḥ tu karmandire dāsya varga bhedena kalpitāḥ 
MBaasaucadiipikaaHK-409	tasmādadhasaṃbandhavarjitāḥ ||	tasmāt adhas saṃbandha varjitāḥ 
MBaasaucadiipikaaHK-410	tāsāntu putrikādīnāṃ yonyonyamiṣyate | na ca sūtake bhūtake	tāsām tu putrikā ādīnām yaḥ nyonyam iṣyate na ca sūtake bhūtake 
MBaasaucadiipikaaHK-411	tāsāmubhayorvaṃśayorapi ||	tāsām ubhayoḥ vaṃśayoḥ api 
MBaasaucadiipikaaHK-412	saṃbandhādekatasthāne sāṃnidhyaṃ * * * * dā | sānnidhyāt	saṃbandhāt ekata sthāne sāṃnidhyam              
MBaasaucadiipikaaHK-413	sparśanādīnāṃ bhayeccāvarjanīyatā ||	sparśana ādīnām bhayet ca avarjanīya tā 
MBaasaucadiipikaaHK-414	p. 345)	p 
MBaasaucadiipikaaHK-415	tataḥ * * ni saṃbandhā dvyadāśaucaṃ vidhīyate | tattupūrṇaṃ	tatas saṃbandhāḥ dvi ad āśaucam vidhīyate 
MBaasaucadiipikaaHK-416	bhavedyāvadubhayorvaṃśayormṛtau ||	bhavet yāvat ubhayoḥ vaṃśayoḥ mṛtau 
MBaasaucadiipikaaHK-417	tasmādanyatra kā dānadharmataḥ sādhakānubhūtiketthāasthānīkā	tasmāt anyatra kā dāna dharmataḥ sādhaka anubhūtikā itthā asthānīkā 
MBaasaucadiipikaaHK-418	nanumodya ca | tayā karmāṇi kurvīta gṛhītrī jananī saha ||	nanumodya ca tayā karmāṇi kurvīta gṛhītrī jananī saha 
MBaasaucadiipikaaHK-419	yadā brāhmaṇena catuṣṭaya varṇe * * vāhaḥ kṛtaḥ | tadā	yadā brāhmaṇena catuṣṭaya varṇe            
MBaasaucadiipikaaHK-420	brāhmaṇīmaraṇe putrajanane ca bhartustryaham ||	brāhmaṇī maraṇe putra janane ca bhartuḥ tri aham 
MBaasaucadiipikaaHK-421	śūdrā maraṇe ca tatputrajanane ca bharturekadinam |	śūdrā maraṇe ca tad putra janane ca bhartuḥ eka dinam 
MBaasaucadiipikaaHK-422	brāhmaṇīkṣatriyā vaiśyā śūdrāsutānāṃ tattanmātṛmaraṇe ca	brāhmaṇī kṣatriyā vaiśyā śūdrā sutānām tad tad mātṛ maraṇe ca 
MBaasaucadiipikaaHK-423	tattatputrajananamaraṇeṣu tattanmātṛ jātyuktamāśauca vati |	tad tad putra janana maraṇeṣu tat tat mātṛ jāti uktam āśauca vati 
MBaasaucadiipikaaHK-424	krītāṃ hitvā varāsuñca yāvadvaṃśadvayaṃ smṛtiḥ |	krītām hitvā vara asuḥ ca yāvat vaṃśa dvayam smṛtiḥ 
MBaasaucadiipikaaHK-425	adhamevaṃ bhavettāsā mardhamāsamiti smṛtam |	adham evam bhavet tāsām ardha māsam iti smṛtam 
MBaasaucadiipikaaHK-426	adhasaṃkocanāttāsāṃ sthānanāśaṃ bhaveddhruvam ||	adha saṃkocanāt tāsām sthāna nāśam bhavet dhruvam 
MBaasaucadiipikaaHK-427	tasmātparīkṣya kartavyaṃ rājarāṣṭrābhivṛddhaye | mohādvā	tasmāt parīkṣya kartavyam rāja rāṣṭra abhivṛddhaye mohāt vā 
MBaasaucadiipikaaHK-428	ḍaṃbhavṛtyā vā svajātyukta madhantuyaḥ ||	ḍaṃbha vṛtyā vā sva jāti ukta 
MBaasaucadiipikaaHK-429	kṛtvā tu gṛhaṃ gacchet sthānanāśaṃ bhaveddhruvam |	kṛtvā tu gṛham gacchet sthāna nāśam bhavet dhruvam 
MBaasaucadiipikaaHK-430	taddoṣaśamanārthāya prāyaścittāni kārayet ||	tad doṣa śamana arthāya prāyaścittāni kārayet 
MBaasaucadiipikaaHK-431	tasmāt sarvaprayatnena āśaucaṃ samyagācaret |	tasmāt sarva prayatnena āśaucam samyak ācaret 
MBaasaucadiipikaaHK-432	kāmike -	kāmike 
MBaasaucadiipikaaHK-433	udvāhitāścatasrastu brāhmaṇena striyo yadā | krameṇa sūtakaṃ	udvāhitāḥ catasraḥ tu brāhmaṇena striyaḥ yadā krameṇa sūtakam 
MBaasaucadiipikaaHK-434	grāhyaṃ daśaṣaṭtryeka vāsaram |	grāhyam vāsaram 
MBaasaucadiipikaaHK-435	p. 345b)	p 
MBaasaucadiipikaaHK-436	sūtakaṃ tatsutādīnāṃ mātṛpakṣe yathāmatamiti |	sūtakam tad suta ādīnām mātṛ pakṣe yathāmatam iti 
MBaasaucadiipikaaHK-437	kiraṇepyevameva ślokaḥ | brāhmaṇena vidhinoddhānāṃ kṣatriyā	kiraṇe api evam eva ślokaḥ brāhmaṇena kṣatriyā 
MBaasaucadiipikaaHK-438	vaiśyā śūdrāṇāṃ bhartṛmaraṇe ekādaśadvādaśatrayodaśa	vaiśyā śūdrāṇām bhartṛ maraṇe ekādaśa dvādaśa trayodaśa 
MBaasaucadiipikaaHK-439	dinairviśuddhirbhavati | tathā kṣatriyo dvāyoścaturdaśa	dinaiḥ viśuddhiḥ bhavati tathā kṣatriyaḥ dvāyoḥ caturdaśa 
MBaasaucadiipikaaHK-440	pañcadaśadinaiśśuddhiḥ |	pañcadaśa dinaiḥ śuddhiḥ 
MBaasaucadiipikaaHK-441	vaiśyoḍhāyāśśūdrāyā aṣṭādaśadinaiśśuddhiḥ |	vaiśya ūḍhāyāḥ śūdrāyāḥ aṣṭādaśa dinaiḥ śuddhiḥ 
MBaasaucadiipikaaHK-442	vidhimantareṇa brāhmaṇādiparigṛhīta kṣatriyādīnāṃ tisṝṇāṃ	vidhim antareṇa brāhmaṇa ādi parigṛhīta kṣatriya ādīnām tisṝṇām 
MBaasaucadiipikaaHK-443	strīṇāṃ bhartṛmaraṇe svabhartṛjātyuktāśaucadinādupari	strīṇām bhartṛ maraṇe sva bhartṛ jāti ukta āśauca dināt upari 
MBaasaucadiipikaaHK-444	ekadvitri catudinābhyā senāśaucaṃ bhavati | taduktaṃ kāmike -	bhavati tat uktam kāmike 
MBaasaucadiipikaaHK-445	viprasyavidhinoḍhāsu raktāsu tisṛṣvatha |	raktāsu tisṛṣu atha 
MBaasaucadiipikaaHK-446	ekadvidvitridinābhyāsājjādīnāṃ brāhmaṇāditaḥ ||	eka dvi dvi tri dina abhyāsāt ja ādīnām brāhmaṇa āditaḥ 
MBaasaucadiipikaaHK-447	anyāyajānāmaśuci dvitrivedadināddhitaḥ |	anyāya jānām aśuci dvi tri veda dināt hitaḥ 
MBaasaucadiipikaaHK-448	atra vedaśabdo na bhūtasaṃvyeyā catussaṃkhyā vacanaḥ |	atra veda śabdaḥ na catur saṃkhyā vacanaḥ 
MBaasaucadiipikaaHK-449	anulomajātānāṃ savarṇāṃṣaṣṭha pāraśava	anuloma jātānām pāraśava 
MBaasaucadiipikaaHK-450	matgurapyugrapūttyakanāmnāṃ ṣaṇṇāmapi dvitripakṣyāśaucam |	matguḥ api ugra pūttyaka nāmnām ṣaṇṇām api dvi tri pakṣi āśaucam 
MBaasaucadiipikaaHK-451	pitṛpakṣyāśaucadinādupari ekadvitridinābhyāsena bhavati |	pitṛ pakṣi āśauca dināt upari eka dvi tri dina abhyāsena bhavati 
MBaasaucadiipikaaHK-452	taduktaṃ svāyaṃbhuve -	tat uktam svāyaṃbhuve 
MBaasaucadiipikaaHK-453	viprasya nṛpakanyāyāṃ jātassavarṇa nāmakaḥ |	viprasya nṛpa kanyāyām jātaḥ savarṇaḥ nāmakaḥ 
MBaasaucadiipikaaHK-454	ekādaśāhamāśaucaṃ dvijavatkarma cācaret ||	ekādaśa aham āśaucam dvija vat karma ca ācaret 
MBaasaucadiipikaaHK-455	viprasya vaiśyakanyāyāṃ sañjātombaṣṭha ucyate | sūtakaṃ	viprasya vaiśya kanyāyām sañjāta umbaṣṭhaḥ ucyate sūtakam 
MBaasaucadiipikaaHK-456	pretakañcaiva āśaucañcādaśakramāt ||	pretakam ca eva āśaucam ca ādaśa kramāt 
MBaasaucadiipikaaHK-457	itareṣāmapi svasvamātṝṇāmuktanyāyena viditavyaḥ |	itareṣām api sva sva mātṝṇām ukta nyāyena viditavyaḥ 
MBaasaucadiipikaaHK-458	p. 346)	p 
MBaasaucadiipikaaHK-459	anulobhānāṃ svarūpantu suprabhedekathitam |	anulobhānām svarūpan tu suprabhede kathitam 
MBaasaucadiipikaaHK-460	savarṇaṃ prathamaṃ vidyādaṃbaṣṭhakaṃ dvitīyakam |	savarṇam prathamam vidyāt aṃbaṣṭhakam dvitīyakam 
MBaasaucadiipikaaHK-461	pāraśavantṛtīyantu jāyante brāhmaṇodbhavāḥ ||	jāyante brāhmaṇa udbhavāḥ 
MBaasaucadiipikaaHK-462	maddharatyugranāmā ca jāyate tau nṛpasya tu | vaiśyasya cūcuko	mat harati ugranāmā ca jāyate tau nṛpasya tu vaiśyasya cūcukaḥ 
MBaasaucadiipikaaHK-463	jñeyassasvalulomaṇṣaḍeva tu ||	jñeyaḥ sa svalu lomaṇ ṣaṣ eva tu 
MBaasaucadiipikaaHK-464	iti saṃprāpyavidhinā viprorājakanyāṃ samantrakam | tatra	iti saṃprāpya vidhinā vipraḥ rāja kanyām sa mantrakam tatra 
MBaasaucadiipikaaHK-465	jātassavarṇastu anulomeṣu pūjitaḥ ||	jātaḥ savarṇaḥ tu anulomeṣu pūjitaḥ 
MBaasaucadiipikaaHK-466	pītastrī viprasaṃyāgādaṃṣaṣṭho nāmajāyate | śūdrastrī	pīta strī vipra saṃyāgāt aṃṣaṣṭhaḥ nāma jāyate śūdra strī 
MBaasaucadiipikaaHK-467	viprasaṃyogājjātaḥ pāraśavasmṛtaḥ ||	vipra saṃyogāt jātaḥ pāraśava smṛtaḥ 
MBaasaucadiipikaaHK-468	raktasya pītakanyāyāṃ jāto madguriti smṛtaḥ | kṛṣṇāyāṃ	raktasya pīta kanyāyām jātaḥ madguḥ iti smṛtaḥ kṛṣṇāyām 
MBaasaucadiipikaaHK-469	raktasaṃyogājjātaścogra iti smṛtaḥ ||	rakta saṃyogāt jātaḥ ca ugraḥ iti smṛtaḥ 
MBaasaucadiipikaaHK-470	kṛṣṇāyāṃ pītasaṃyogājjātaśūcuka evecati |	kṛṣṇāyām pīta saṃyogāt jātaḥ śūcukaḥ 
MBaasaucadiipikaaHK-471	uktaṃ kāmike -	uktam kāmike 
MBaasaucadiipikaaHK-472	sūtakaṃ dāsadāsyostu adhiṣṭhātṛkulocitamiti ca | trayodaśa	sūtakam dāsa dāsyoḥ tu adhiṣṭhātṛ kula ucitam iti ca trayodaśa 
MBaasaucadiipikaaHK-473	dinaiśśuddhao mṛtako brāhmaṇa smṛtaḥ |	dinaiḥ śuddhaḥ mṛtakaḥ brāhmaṇa smṛtaḥ 
MBaasaucadiipikaaHK-474	karakolakagopālau triṃśaddinaśucīmatau |	                   
MBaasaucadiipikaaHK-475	bhaṭṭācāryaścālayaścāpi catustriṃśaddinaiśśuciḥ ||	bhaṭṭācāryaḥ ca ālayaḥ ca api catustriṃśat dinaiḥ śuciḥ 
MBaasaucadiipikaaHK-476	pañcatriṃśaddinaiśśuddhau kuṃbhakārakajalpinau | *	pañcatriṃśat dinaiḥ śuddhau kuṃbhakāraka jalpinau 
MBaasaucadiipikaaHK-477	sūcitāṃbūlājakatailaṣṣaṭtriṃśatā śuciḥ ||	sūcita āṃbū lājaka tailaḥ ṣaṭtriṃśatā śuciḥ 
MBaasaucadiipikaaHK-478	dvatādi tailavikriyāntānā meteṣāmāśaucañca candra jñāne	dvata ādi taila vikriyā antānām eteṣām āśaucam ca candra jñāne 
MBaasaucadiipikaaHK-479	spaṣṭamuktam |	spaṣṭam uktam 
MBaasaucadiipikaaHK-480	p. 347)	p 
MBaasaucadiipikaaHK-481	dūtāśaucamatha śṛṇu | triṃśaddinaijjanmāśaucam |	dūta āśaucam atha śṛṇu 
MBaasaucadiipikaaHK-482	mṛtāśaucaṃ trayodāśāhena śuddhiḥ | karakolasya janmāśaucaṃ	mṛta āśaucam trayodāśa ahena śuddhiḥ karakolasya janma āśaucam 
MBaasaucadiipikaaHK-483	mṛtāśaucaṃ triṃśaddinaiśśudhyati | gopālasya mantrāśaucaṃ	mṛtāśaucam triṃśat dinaiḥ śudhyati gopālasya mantra āśaucam 
MBaasaucadiipikaaHK-484	mṛtāśaucaṃ triṃśaddinaiśśudhyati bhaṭṭāryasya	mṛta āśaucam triṃśat dinaiḥ śudhyati bhaṭṭāryasya 
MBaasaucadiipikaaHK-485	jananamaraṇāśaucaṃ triṃśaddinam | (anyeṣāṃ sarvāśaucam |	janana maraṇa āśaucam triṃśat dinam anyeṣām sarva āśaucam 
MBaasaucadiipikaaHK-486	uktaṃkāmike -	uktaṃkāmike 
MBaasaucadiipikaaHK-487	pratilomiṣu nāśaucaṃ te nityā śucayo yataḥ | iti	pratilomiṣu na āśaucam te nityā śucayaḥ yatas iti 
MBaasaucadiipikaaHK-488	jananestikrāntaṃ jananāśaucaṃ nāsti | pituṣṣaṭtriṃśaddinam |	jananeḥ atikrāntam janana āśaucam na asti pituḥ ṣaṭtriṃśat dinam 
MBaasaucadiipikaaHK-489	rajakasya ṣaṭtriṃśaddinam | tailavikrayasya ca ṣaṭtriṃśaddinaṃ	rajakasya ṣaṭtriṃśat dinam taila vikrayasya ca ṣaṭtriṃśat dinam 
MBaasaucadiipikaaHK-490	anyeṣāṃ sarvāśaucaṃ) kulālasya ṣaṭtriṃśaddinaṃ	anyeṣām sarva āśaucam kulālasya ṣaṭtriṃśat dinam 
MBaasaucadiipikaaHK-491	kuṃbhakārasya pañcatriṃśaddinam | jilpinaḥ pañcatriṃśaddinaṃ	kuṃbhakārasya pañcatriṃśat dinam jilpinaḥ pañcatriṃśat dinam 
MBaasaucadiipikaaHK-492	sūcakasya ṣaṭtriṃśaddinam | tāṃbūlakasya ṣaṭtriṃśaddinam |	sūcakasya ṣaṭtriṃśat dinam tāṃbūlakasya ṣaṭtriṃśat dinam 
MBaasaucadiipikaaHK-493	rajakasya ṣaṭtriṃśaddinam | tailavikrayasya ca ṣaṭtriṃśaddinam |	rajakasya ṣaṭtriṃśat dinam taila vikrayasya ca ṣaṭtriṃśat dinam 
MBaasaucadiipikaaHK-494	anyeṣāṃ sarvāśaucaṃ uktaṃ kāmike -	anyeṣām sarva āśaucam uktam kāmike 
MBaasaucadiipikaaHK-495	pratilomiṣu nāśaucaṃ tenityā śucayo yataḥ | iti	pratilomiṣu na āśaucam śucayaḥ yatas iti 
MBaasaucadiipikaaHK-496	jananestikrāntaṃ jananāśaucaṃ nāsti | pitusnānaṃ mātṛṃ tathā	jananeḥ atikrāntam janana āśaucam na asti pitu snānam mātṛm tathā 
MBaasaucadiipikaaHK-497	ca saṃgrahe -	ca saṃgrahe 
MBaasaucadiipikaaHK-498	pitu snānantadanyeṣāṃ na ca tatsūtakātyaye iti | maraṇandvividham	pitu snānam tat anyeṣām na ca tat sūtakātyaye iti maraṇan dvividham 
MBaasaucadiipikaaHK-499	- sumaraṇandurmaraṇañca | ādyaṃ dvividham | strīmaraṇaṃ	sumaraṇam durmaraṇam ca ādyam dvividham strī maraṇam 
MBaasaucadiipikaaHK-500	puṃsaraṇamiti | puṃmaraṇo nāma prāk sadyaḥ |	puṃsaraṇam iti puṃmaraṇaḥ nāma prāk sadyas 
MBaasaucadiipikaaHK-501	p. 348)	p 
MBaasaucadiipikaaHK-502	dantu janmanaḥ prāgekāhaṃ cūḍā ca * tha vañciṃ? sapātitu |	janmanaḥ prāk eka aham cūḍā 
MBaasaucadiipikaaHK-503	daśadina kṣatriyā maraṇe tatputrajanane ca ṣaṭdinam |	kṣatriyā maraṇe tad putra janane ca ṣaṣ dinam 
MBaasaucadiipikaaHK-504	vaiśyāmmaraṇe tatputrajanane bhartukaraṇātprāgdinam |	vaiśyām maraṇe tad putra janane bhartu karaṇāt prāk dinam 
MBaasaucadiipikaaHK-505	upanayanātprāk tatopi kañci dadhikam | upanayanātparaṃ	upanayanāt prāk tatas api kañcid dadhikam upanayanāt param 
MBaasaucadiipikaaHK-506	pūrṇāśaucam | tathā jñānaratnāvalyām |	pūrṇāśaucam tathā jñānaratnāvalyām 
MBaasaucadiipikaaHK-507	ānāmakaraṇātpadya ekāhandantajanmanaḥ | cūḍāyāstridinaṃ	ā nāma karaṇāt padye eka ahan dantajanmanaḥ cūḍāyāḥ tri dinam 
MBaasaucadiipikaaHK-508	proktaṃ tatotyadhikamāvratam ||	proktam 
MBaasaucadiipikaaHK-509	tadurdhvaṃ pūrvacchuddhi sarvavarṇeṣvayaṃ vidhiḥ |	tad ūrdhvam sarva varṇeṣu ayam vidhiḥ 
MBaasaucadiipikaaHK-510	kāmike -	kāmike 
MBaasaucadiipikaaHK-511	nāmnaḥ prākdantajananā tatopanayanāvadhi | snānamekadinaṃ	nāmnaḥ prāk danta jananā tata upanayana avadhi snānam eka dinam 
MBaasaucadiipikaaHK-512	proktaṃ tridinañca krameṇa tu ||	proktam tri dinam ca krameṇa tu 
MBaasaucadiipikaaHK-513	tadūrdhvaṃ daśāhaṃ syāt jñātīnāmiti | kāmike tu nivṛtta	tad ūrdhvam daśa aham syāt jñātīnām iti kāmike tu nivṛtta 
MBaasaucadiipikaaHK-514	cūḍakṣatriyāderviśeṣa uktaḥ |	cūḍa kṣatriya ādeḥ viśeṣaḥ uktaḥ 
MBaasaucadiipikaaHK-515	yadā nivṛtta cūḍaḥ syāt kṣatriyo ṣaṭdinaiśśuciḥ | vaiśyastu	yadā nivṛtta cūḍaḥ syāt kṣatriyaḥ ṣaṭdinaiḥ śuciḥ vaiśyaḥ tu 
MBaasaucadiipikaaHK-516	navabhiśśuddhaśśudro dvādaśabhirdinaiḥ ||	navabhiḥ śuddhaḥ śudraḥ dvādaśabhiḥ dinaiḥ 
MBaasaucadiipikaaHK-517	jñānaratnāvalyāṃ sūcitaṃ tatopyadhikamāvṛtāditi tasmāccūḍā	jñānaratnāvalyām sūcitam tatas api adhikam āvṛtāt iti tasmāt cūḍā 
MBaasaucadiipikaaHK-518	karaṇānantaramupanayanātpūrvaṃ brāhmaṇasyāpi caturdinaṃ	karaṇa anantaram upanayanāt pūrvam brāhmaṇasya api catur dinam 
MBaasaucadiipikaaHK-519	pañcadinaṃ vā āśaucaṃ bhavati brāhmaṇasya	pañca dinam vā āśaucam bhavati brāhmaṇasya 
MBaasaucadiipikaaHK-520	mauñjībandhanamupanayanaṃ kṣatriyasya dhanurgrahaṇa vaiśyasya	mauñjībandhanam upanayanam kṣatriyasya dhanuḥ grahaṇa vaiśyasya 
MBaasaucadiipikaaHK-521	vratodagrahaṇaṃ tadvayamātrataḥ pūrṇāśaucaṃ tathā ca kāmike -	vrata uda grahaṇam tad dvaya mātrataḥ pūrṇāśaucam tathā ca kāmike 
MBaasaucadiipikaaHK-522	p. 349)	p 
MBaasaucadiipikaaHK-523	āmauñjī bandhanādvipraḥ kṣatriyasya dhanurgrahāt |	āmauñjī bandhanāt vipraḥ kṣatriyasya dhanuḥ grahāt 
MBaasaucadiipikaaHK-524	tridinaṃ kathyate strīṣu kṣaurādaṣṭama varṇācca	tri dinam kathyate strīṣu kṣaurāt aṣṭama varṇāt ca 
MBaasaucadiipikaaHK-525	vivāhātpūrvavatkramāditi | dattānuḍhāyāḥ kanyāyāmaraṇe pa *	vivāhāt pūrvavat kramāt iti datta anuḍhāyāḥ kanyāyāḥ maraṇe 
MBaasaucadiipikaaHK-526	trirātraṃ parato jñātyordattānūḍhāmṛtāvadhamiti | tadūrdhvaṃ	tri rātram paratas jñātyoḥ datta anūḍhā mṛtā vadham iti tad ūrdhvam 
MBaasaucadiipikaaHK-527	tu kanyāyāṃ sāpiṇḍayaṃ nāstyeva | bhartṛkula eva	tu kanyāyām sāpiṇḍayam na asti eva bhartṛ kule eva 
MBaasaucadiipikaaHK-528	sarvamanuṣṭheyaṃ tathā ca candrajñāne -	sarvam anuṣṭheyam tathā ca candra jñāne 
MBaasaucadiipikaaHK-529	anyagotrapraviṣṭānāṃ dāyamāśauca miṣyate | jñātitvañca	anya gotra praviṣṭānām dāyam āśaucam iṣyate jñāti tvam ca 
MBaasaucadiipikaaHK-530	nivartante tatkule sarvamucyate ||	nivartante tad kule sarvam ucyate 
MBaasaucadiipikaaHK-531	tasyāśca striyo bharturyadyadāśaucaṃ tattastha api bhavati | tathā	tasyāḥ ca striyaḥ bhartuḥ yat yat āśaucam tat tastha api bhavati tathā 
MBaasaucadiipikaaHK-532	ca candrajñāne -	ca candra jñāne 
MBaasaucadiipikaaHK-533	yadyadbharturāśaucaṃ bhāryayāstanna saṃśaya iti atra	yat yat bhartuḥ āśaucam bhāryayāḥ tat na saṃśayaḥ iti atra 
MBaasaucadiipikaaHK-534	upanayanātpūrvakālīna puṃmaraṇeṣvapi vivāhātpūrvakālīna	upanayanāt pūrva kālīna pum maraṇeṣu api vivāhāt pūrva kālīna 
MBaasaucadiipikaaHK-535	strīmaraneṣu ca sarvatramātṛpitrossasrvadā daśāhamāśaucam kṛte	strī maraneṣu ca sarvatra mātṛ pitroḥ sasrvadā daśa aham āśaucam kṛte 
MBaasaucadiipikaaHK-536	nāmakaraṇe bhrātṝṇāñca daśāhaṃ - tathā ca kāmike -	nāmakaraṇe bhrātṝṇām ca daśa aham tathā ca kāmike 
MBaasaucadiipikaaHK-537	bhrātṝṇāñca daśāhaṃ syāt kṛtenā na tu sarvadā |	bhrātṝṇām ca daśa aham syāt kṛtenāḥ na tu sarvadā 
MBaasaucadiipikaaHK-538	pitrorddaśāhamevaṃ syāt sarvadāśaucamagrajāḥ ||	pitroḥ ddaśa aham evam syāt sarvadā āśaucam agrajāḥ 
MBaasaucadiipikaaHK-539	atra sapiṇḍānā tridināśau ca viṣaye	atra tri dina āśau ca viṣaye 
MBaasaucadiipikaaHK-540	samānodakavargāṇāmekadināśaucaṃ bhavati ekadināśauca viṣaye	samānodaka vargāṇām eka dina āśaucam bhavati eka dina āśauca viṣaye 
MBaasaucadiipikaaHK-541	snānam | tathā ca kāmike -	snānam tathā ca kāmike 
MBaasaucadiipikaaHK-542	p. 350)	p 
MBaasaucadiipikaaHK-543	tridinañca sapiṇḍānāṃ yatratatraika vāsaram | samānodaka	tri dinam ca sapiṇḍānām yatra tatra eka vāsaram 
MBaasaucadiipikaaHK-544	vargāṇā māśaucaṃ vihitaṃ vidhau ||	vargāṇām āśaucam vihitam vidhau 
MBaasaucadiipikaaHK-545	ūrdhvadantodbhavātpūrvaṃ snānanteṣāṃ prakīrtitam |	ūrdhva danta udbhavāt pūrvam snānam teṣām prakīrtitam 
MBaasaucadiipikaaHK-546	dantodbhavāditi ekāha viṣayañca | kanyābālamaraṇa viṣayāśauca	danta udbhavāt iti eka aha viṣayaḥ ca kanyā bāla maraṇa viṣaya āśauca 
MBaasaucadiipikaaHK-547	sarvavarṇa sādhāraṇaḥ | tathā ca jñānaratnāvalyām -	sarva varṇa sādhāraṇaḥ tathā ca jñānaratnāvalyām 
MBaasaucadiipikaaHK-548	sarvavarṇeṣvayaṃ vidhiriti smṛtau ca |	sarva varṇeṣu ayam vidhiḥ iti smṛtau ca 
MBaasaucadiipikaaHK-549	vayovasthāśritāśaucaṃ varṇānāṃ tulyamucyata iti	vayaḥ vasthā āśrita āśaucam varṇānām tulyam ucyate iti 
MBaasaucadiipikaaHK-550	upanayanātpūrva kālīnamaraṇeṣu sa piṇḍānāmāśaucaṃ nāsti	upanayanāt pūrva kālīna maraṇeṣu sa piṇḍānām āśaucam na asti 
MBaasaucadiipikaaHK-551	mātuḥ pituśca sodarāṇāñca trirātraṃ	mātuḥ pituḥ ca sodarāṇām ca tri rātram 
MBaasaucadiipikaaHK-552	triṣumāseṣūktamāśaucaṃ bhavati | tathā ca saṃgrahakāraḥ -	triṣu māseṣu uktam āśaucam bhavati tathā ca saṃgraha kāraḥ 
MBaasaucadiipikaaHK-553	pitrorbhrātṛbhavennānyeṣvanupetātvadhamiti smṛtau tu	pitroḥ bhrātṛ bhavet na anyeṣu smṛtau tu 
MBaasaucadiipikaaHK-554	bālāsaṃskāranibandhana māśauca muktam | yathā ca saṃgrahakāraḥ	yathā ca saṃgraha kāraḥ 
MBaasaucadiipikaaHK-555	dāhehaḥ khanane sadyodantotpatterataḥ param | khananehastryahandāhye	dāha ihar khanane sadyas danta utpatteḥ atas param khanana ihar tri ahan dāhye 
MBaasaucadiipikaaHK-556	tyāge ca tryahamiṣyate || iti	tyāge ca tri aham iṣyate iti 
MBaasaucadiipikaaHK-557	saṃskārahyadāpikālastatraivoktaḥ | caulāparaṃ bhavedadāho	caula aparam 
MBaasaucadiipikaaHK-558	nāmnaḥ prāk khananaṃ smṛtam |	nāmnaḥ prāk khananam smṛtam 
MBaasaucadiipikaaHK-559	dāhovā khananandantāt parantyāgassavātha tat | iti |	iti 
MBaasaucadiipikaaHK-560	dahanakhananavidhisvarūpaṃ sarvaṃ suprabhede caryāpādedraṣṭavyam	dahana khanana vidhi svarūpam sarvam suprabhede 
MBaasaucadiipikaaHK-561	| upanayādūrdhvapareṇa tu āśaucinaḥ pañcavidhāḥ -	upanayāt ūrdhva pareṇa tu āśaucinaḥ pañcavidhāḥ 
MBaasaucadiipikaaHK-562	pūrṇāśaucinaḥ stryahāśaucinaḥ pakṣiṇyāśaucina	pūrṇa āśaucinaḥ strī aha āśaucinaḥ 
MBaasaucadiipikaaHK-563	aharāśaucinaḥ sadyaśśaucinaśceti |	ahar āśaucinaḥ sadyaśśaucinaḥ ca iti 
MBaasaucadiipikaaHK-564	p. 351)	p 
MBaasaucadiipikaaHK-565	jananavatpitrādi saṃpiṇḍāḥ pūrṇāśaucinaḥ |	jananavat pitṛ ādi saṃpiṇḍāḥ pūrṇāśaucinaḥ 
MBaasaucadiipikaaHK-566	pūrṇāśaucityañca brāhmaṇasya daśāhādinā pūrvamevoktaṃ	pūrṇa āśā aucityam ca brāhmaṇasya daśa aha ādinā pūrvam eva uktam 
MBaasaucadiipikaaHK-567	kāmike -	kāmike 
MBaasaucadiipikaaHK-568	āsaptapuruṣā grāhyantatpuṃsāṃmṛta sūtayoriti | tataḥ pañca	ā sapta puruṣā grāhyam tat puṃsām mṛta sūtayoḥ iti tatas pañca 
MBaasaucadiipikaaHK-569	puruṣaparyantaṃ samānodakārastryahāśaucinaḥ |	puruṣa paryantam samānoda kāraḥ tri aha āśaucinaḥ 
MBaasaucadiipikaaHK-570	śiṣyasaṃbandhināñca tridinamāśaucam | tathā ca kāmike -	śiṣya saṃbandhinām ca tri dinam āśaucam tathā ca kāmike 
MBaasaucadiipikaaHK-571	tatopi tryahamāśaucaṃ parataḥ pañcapūruṣāt | śiśyeka	tatas api tri aham āśaucam paratas pañca pūruṣāt śiśyeka 
MBaasaucadiipikaaHK-572	gurusaṃbandhāt gurusaṃbandhinaśca ye ||	guru saṃbandhāt guru saṃbandhinaḥ ca ye 
MBaasaucadiipikaaHK-573	tyajeyustridinaṃ karma nityādanyajjapādikamiti |	tyajeyuḥ tri dinam karma nityāt anyat japa ādikam iti 
MBaasaucadiipikaaHK-574	mātāmahī mātāmahamātula mātubhāgineya	mātāmahī mātāmaha mātula mātu bhāgineya 
MBaasaucadiipikaaHK-575	mātṛsvasṛsvaputrīdaulyā ityaṣṭau janāssannidhau	mātṛ svasṛ sva putrī daulyāḥ iti aṣṭau janāḥ sannidhau 
MBaasaucadiipikaaHK-576	tryahāśaucinaḥ | strī mṛtau mātā pitṛsvaputrīdauhitrasvastrīya	tri aha āśaucinaḥ strī mṛtau mātā pitṛ sva putrī dauhitra sva strī ya 
MBaasaucadiipikaaHK-577	bhartṛsvastrīya naptṛstriyāśca ṣaṭjanasaṃnidhau	naptṛ striyāḥ ca ṣaṣ jana saṃnidhau 
MBaasaucadiipikaaHK-578	tryahāśaucinaḥ | taduktaṃ saṃgrahe -	tri aha āśaucinaḥ tat uktam saṃgrahe 
MBaasaucadiipikaaHK-579	bhāgineye ca dauhitrye mṛte ca tryahamiṣyate iti aditaḥ	bhāgineye ca dauhitrye mṛte ca tri aham iṣyate iti aditaḥ 
MBaasaucadiipikaaHK-580	pratipāditorthoyaṃ saṃgrahaślokassukhabodhārthamucyate	pratipādita ūrthaḥ yam saṃgraha ślokaḥ sukha bodha artham ucyate 
MBaasaucadiipikaaHK-581	puṃmṛtau mātṛpitarau putrī dauhitra * * taḥ |	pum mṛtau mātṛ pitarau putrī dauhitra 
MBaasaucadiipikaaHK-582	bhartṛ svasuta ṣaṣṭhaste pratyakṣe tryahādhina ityakṣe pratyakṣa	bhartṛ sva suta ṣaṣṭhaḥ te pratyakṣe tri aha ādhinaḥ iti akṣe pratyakṣa 
MBaasaucadiipikaaHK-583	ityarthaḥ | vijñāyamānabāndhavāḥ pakṣiṇyāśaucinaḥ |	iti arthaḥ vijñāyamāna bāndhavāḥ pakṣiṇī āśaucinaḥ 
MBaasaucadiipikaaHK-584	taduktaṃ kāmike - yāvadvijñānamiti |	tat uktam kāmike yāvat vijñānam iti 
MBaasaucadiipikaaHK-585	strīmṛtāvaṣṭatriṃśajjanāḥ puṃ mṛtau ṣaḍviṃśatijanāśca	strī mṛtau aṣṭatriṃśat janāḥ pum mṛtau ṣaḍviṃśati janāḥ ca 
MBaasaucadiipikaaHK-586	yonisaṃbandhāḥ pakṣiṇyāśaucinaḥ tathāhi strī mṛtau	yoni saṃbandhāḥ pakṣiṇī āśaucinaḥ tathā hi strī mṛtau 
MBaasaucadiipikaaHK-587	janakajanakakoṭau catvāraḥ |	janaka janaka koṭau catvāraḥ 
MBaasaucadiipikaaHK-588	p. 352)	p 
MBaasaucadiipikaaHK-589	janakakoṭāvaṣṭau svātmakoṭau pañcadaśasvajanyakoṭau	janaka koṭau aṣṭau sva ātma koṭau pañcadaśa sva janya koṭau 
MBaasaucadiipikaaHK-590	sapasvajanyakoṭau saptasvajanyakoṭau catvāraḥ | puṃ mṛtau	sapa sva janya koṭau sapta sva janya koṭau catvāraḥ mṛtau 
MBaasaucadiipikaaHK-591	janakakoṭau dvau janakakoṭau catvāraḥ | svātmakoṭau catvāraḥ |	janaka koṭau dvau janaka koṭau catvāraḥ sva ātma koṭau catvāraḥ 
MBaasaucadiipikaaHK-592	svajanyakoṭau dvau āhatya sapiṇḍānetān dvādaśapūrvokta	sva janya koṭau dvau āhatya sapiṇḍān etān dvādaśa pūrva ukta 
MBaasaucadiipikaaHK-593	ṣaḍviṃśati janāḥ pakṣiṇyāśaucinaḥ uktaṃ saṃgrahe -	ṣaḍviṃśati janāḥ pakṣiṇī āśaucinaḥ uktam saṃgrahe 
MBaasaucadiipikaaHK-594	mātṛsvasṛsutāputravityādi tatpratipāditārtha saṃgrahaśloka	mātṛ svasṛ sutā putra vityādi tad pratipādita artha saṃgraha śloka 
MBaasaucadiipikaaHK-595	sukhabodhārthamucyate -	sukha bodha artham ucyate 
MBaasaucadiipikaaHK-596	mātā pitā pitṛvyo mātulastathā | mātṛ svasāmātulāni	mātā pitā pitṛvyaḥ mātulaḥ tathā mātṛ svasā mātulāni 
MBaasaucadiipikaaHK-597	pitṛstrī pitṛṣyasā? |	pitṛ strī pitṛṣyasā 
MBaasaucadiipikaaHK-598	mātṛṣvasurmātulasya pitṛṣyasya pitṛṣvasuḥ | strī	mātṛṣvasuḥ mātulasya pitṛṣyasya pitṛṣvasuḥ strī 
MBaasaucadiipikaaHK-599	putrasnuṣāsvasyāḥ svasābhrātā tadaṃganā ||	putra snuṣā svasyāḥ svasā bhrātā tad aṃganā 
MBaasaucadiipikaaHK-600	svasubhrātusnuṣā putrī putrasya duhitāpi ca | svapautrī ca	svasu bhrātu snuṣā putrī putrasya duhitā api ca sva pautrī ca 
MBaasaucadiipikaaHK-601	svadauhitrī svadauhitraṃ tadaṃganā ||	sva dauhitrī sva dauhitram tad aṃganā 
MBaasaucadiipikaaHK-602	aṣṭatriṃśajjanāhyetestrīmṛtau pakṣiṇī juṣaḥ |	aṣṭatriṃśat janāḥ hi ete strīm ṛtau pakṣiṇī juṣaḥ 
MBaasaucadiipikaaHK-603	sapiṇḍādvādaśaiteṣu muktvānye puṃmṛtau tathā iti kāmike ca -	sapiṇḍāḥ dvādaśā eteṣu muktvā anye pum mṛtau tathā iti kāmike ca 
MBaasaucadiipikaaHK-604	ūḍhāmaraṇe mātāpitrossodarīmṛtau | bhrātṛrbhāgineyamṛtau	ūḍhā maraṇe mātā pitroḥ sodarī mṛtau bhrātṛḥ bhāgineya mṛtau 
MBaasaucadiipikaaHK-605	mātulasya pakṣiṇī pratipāditā ||	mātulasya pakṣiṇī pratipāditā 
MBaasaucadiipikaaHK-606	yathā -	yathā 
MBaasaucadiipikaaHK-607	pakṣiṇī syātpradātāyāḥ pitrossodarī mṛtau | tatsutānāñca	pakṣiṇī syāt pradātāyāḥ pitroḥ sodarī mṛtau tad sutānām ca 
MBaasaucadiipikaaHK-608	prāyeṇa pakṣiṇī dvijasattamāḥ ||	prāyeṇa pakṣiṇī dvijasattamāḥ 
MBaasaucadiipikaaHK-609	iti pradattāyā ūḍhāyā ityarthaḥ | pakṣiṇīnāndinadvayaṃ	iti pradattāyāḥ ūḍhāyāḥ iti arthaḥ 
MBaasaucadiipikaaHK-610	rātrirvā rātridvayaṃ dinaṃ vā bhavati |	rātriḥ vā rātri dvayam dinam vā bhavati 
MBaasaucadiipikaaHK-611	p. 353)	p 
MBaasaucadiipikaaHK-612	taduktaṃ kāmike -	tat uktam kāmike 
MBaasaucadiipikaaHK-613	divasadvayamadhyastha rātrirvā rātrimadhyagam | dinaṃ vā	rātriḥ vā rātri madhya gam dinam vā 
MBaasaucadiipikaaHK-614	pakṣiṇītyuktā jñātvevaṃ karmakārayet ||	pakṣiṇī iti uktā jñātvā evam karma kārayet 
MBaasaucadiipikaaHK-615	aharāśocinastu pūrvoktā eva pakṣiṇyā śaucinaḥ | parokṣe	aharāśocinaḥ tu pūrva uktāḥ eva pakṣiṇyā śaucinaḥ parokṣe 
MBaasaucadiipikaaHK-616	aharāśaucinaḥ | taduktaṃ saṃgrahe yathāhi -	ahar āśaucinaḥ tat uktam saṃgrahe yathā hi 
MBaasaucadiipikaaHK-617	yonisabandheṣvaharvidhirasanni * * ti |	yoni sabandheṣu ahar vidhiḥ asat i ti 
MBaasaucadiipikaaHK-618	śiṣyagurusaṃbandhivyatiriktāśśaiva mārgasthā dīkṣitā api	śiṣya guru saṃbandhi vyatiriktāḥ śaiva mārga sthāḥ dīkṣitāḥ api 
MBaasaucadiipikaaHK-619	dināśaucinaḥ | taduktaṃ kāmike -	dina āśaucinaḥ tat uktam kāmike 
MBaasaucadiipikaaHK-620	tebhyonyaiva śaivamārgasthā gṛhiṇogṛhiṇopi vā | dinamekaṃ	śaiva mārga sthā vā dinam ekam 
MBaasaucadiipikaaHK-621	kṣayeyukteśāvāśaucāya vivakṣitāḥ ||	kṣaye yukta īśau āśaucāya vivakṣitāḥ 
MBaasaucadiipikaaHK-622	ityayañca tryahapakṣiṇyaharvidhi - varṇasādhāraṇaḥ | uktaṃ	iti ayam ca varṇa sādhāraṇaḥ uktam 
MBaasaucadiipikaaHK-623	saṃgrahe sadyaśśaucinastu mātuḥ pituśca gurvādessodake	saṃgrahe sadyas śaucinaḥ tu mātuḥ pituḥ ca guru ādeḥ sa udake 
MBaasaucadiipikaaHK-624	srāvemātṛsandhau vayasyadham | savarṇasamaṃhiti	srāve mātṛ sandhau vayasi adham savarṇa samam hiti 
MBaasaucadiipikaaHK-625	vijñāneśvaraghoṣitamiti bāndhavāḥ | ātmabāndhavānāṃ	vijñāneśvara ghoṣitam iti bāndhavāḥ ātma bāndhavānām 
MBaasaucadiipikaaHK-626	pakṣiṇyā vihitatvāt uktaṃ saṃgrahe bandhaustānamiti	pakṣiṇyāḥ vihita tvāt uktam saṃgrahe bandhauḥ tānam iti 
MBaasaucadiipikaaHK-627	bāndhavānāṃ trayāṇāṃ svarūpaṃ vijñāneśvare pradarśitam |	bāndhavānām trayāṇām svarūpam vijñāneśvare pradarśitam 
MBaasaucadiipikaaHK-628	tadyathā -	tat yathā 
MBaasaucadiipikaaHK-629	ātmapitṛṣvasuḥ putrāḥ pitṛmātṛsvasussutāḥ |	ātma pitṛṣvasuḥ putrāḥ pitṛ mātṛ svasuḥ sutāḥ 
MBaasaucadiipikaaHK-630	piturmātulaputrāśca vijñeyāḥ pitṛbāndhavāḥ ||	pituḥ mātula putrāḥ ca vijñeyāḥ pitṛ bāndhavāḥ 
MBaasaucadiipikaaHK-631	mātṛpitṛṣvasuḥ putrā mātṛmātuṣvasussutāḥ | māturmātula	mātṛ pitṛṣvasuḥ putrāḥ mātṛ mātuṣvasuḥ sutāḥ 
MBaasaucadiipikaaHK-632	putrāśca vijñeyāmātma bāndhavāḥ ||	putrāḥ ca vijñeyām ātma bāndhavāḥ 
MBaasaucadiipikaaHK-633	ityatra sadyaśśauce ca snānānāntamevāgham | uktaṃ girismṛtau -	iti atra sadyaśśauce ca snāna anāntam eva agham uktam girismṛtau 
MBaasaucadiipikaaHK-634	p. 354)	p 
MBaasaucadiipikaaHK-635	sadyaśśaucantu vānyasyā dāśaucaṃ saṃsthitasya tu |	sadyaḥśaucam tu vā anyasyāḥ dā āśaucam saṃsthitasya tu 
MBaasaucadiipikaaHK-636	yāvatsthānaṃ na kurvanti sacelaṃ bāndhavā iti ||	yāvat sthānam na kurvanti sa celam bāndhavāḥ iti 
MBaasaucadiipikaaHK-637	syāladīnāmmaraṇe tatsaṃbandhināṃ snānādeva viśuddhiḥ |	syāla dīnām maraṇe tad saṃbandhinām snānāt eva viśuddhiḥ 
MBaasaucadiipikaaHK-638	taduktaṃ jñānaratnāvalyām -	tat uktam jñānaratnāvalyām 
MBaasaucadiipikaaHK-639	syālake tatsute mitre dauhitre bhaginī patau | jamātrādau mṛtevāpi	syālake tad sute mitre dauhitre bhaginī patau jamātṛ ādau mṛtā iva api 
MBaasaucadiipikaaHK-640	snānādeva viśudhyati | iti	snānāt eva viśudhyati iti 
MBaasaucadiipikaaHK-641	a * * dauhitrapadaṃ bhinnadauhitrī padadīkṣā saṃskāra	          
MBaasaucadiipikaaHK-642	saṃskṛtānānniṣidhyatītyarthaḥ | yātrābhṛgupatanādimaraṇaṃ	saṃskṛta anān niṣidhyati iti arthaḥ yātrā bhṛgu patana ādi maraṇam 
MBaasaucadiipikaaHK-643	sadācāryānumatyā kṛtavatāmapimaraṇe sadyaśśaucantatraiva |	sat ācārya anumatyā kṛtavatām api maraṇe sadyaśśaucam tatra eva 
MBaasaucadiipikaaHK-644	tīrthayātrā bhṛgormātā sanyāso vahniveśanam | mahāpatha	tīrtha yātrā bhṛgoḥ mātā sa nyāsaḥ vahniveśanam mahāpatha 
MBaasaucadiipikaaHK-645	pravṛttiścamaukhya ca neśanādikam ||	ca na īśana ādikam 
MBaasaucadiipikaaHK-646	ityadipaśujātīnāṃ dīkṣito na samācaret |	iti adi paśu jātīnām dīkṣitaḥ na samācaret 
MBaasaucadiipikaaHK-647	atyantaṃ kliṣṭadehaścet doṣakṣayapīḍitaḥ | satāmācārya	atyantam kliṣṭa dehaḥ ced doṣa kṣaya pīḍitaḥ satām ācārya 
MBaasaucadiipikaaHK-648	viprāṇāṃ gṛhītvā saṃmatintataḥ ||	viprāṇām gṛhītvā saṃmatim tatas 
MBaasaucadiipikaaHK-649	tatkālocitamālocya kāryaṃ niṣkṛtipūrvakam |	tad kāla ucitam ālocya kāryam niṣkṛti pūrvakam 
MBaasaucadiipikaaHK-650	tadāpi sūtakaṃ nāsti snānadeva pariśudhyati | brahmacāriṇo	tadā api sūtakam na asti pariśudhyati 
MBaasaucadiipikaaHK-651	bhautikasya naiṣṭhikasya vānaprasthasya yateśca sapiṇḍamaraṇe	bhautikasya naiṣṭhikasya vānaprasthasya yateḥ ca sapiṇḍa maraṇe 
MBaasaucadiipikaaHK-652	cāśaucaṃ nāsti | taduktaṃprodvīte -	ca āśaucam na asti tat uktam prodvīte 
MBaasaucadiipikaaHK-653	brahmacārī jaṭādhārī sanyāsyāśauca varjitaḥ |	brahmacārī jaṭā dhārī sanyāsī āśauca varjitaḥ 
MBaasaucadiipikaaHK-654	vānprasthayatiścāpi āśaucaṃ varjayetsadā ||	vān prastha yatiḥ ca api āśaucam varjayet sadā 
MBaasaucadiipikaaHK-655	p. 355)	p 
MBaasaucadiipikaaHK-656	kūrmapurāṇe ca -	kūrmapurāṇe ca 
MBaasaucadiipikaaHK-657	naiṣṭhikānāṃ vānaprasthānāṃ yatīnāṃ brahmacāriṇām |	naiṣṭhikānām vānaprasthānām yatīnām brahmacāriṇām 
MBaasaucadiipikaaHK-658	nāśaucaṃ kathyate sadbhiriti | patitasyāpi maraṇe	na āśaucam kathyate sadbhiḥ iti patitasya api maraṇe 
MBaasaucadiipikaaHK-659	sapiṇḍānānnāśaucam | tatraiva patite ca tathāmṛte |	sapiṇḍa an anna āśaucam tatra eva patite ca tathā amṛte 
MBaasaucadiipikaaHK-660	patitānāṃ na cāghaṃ syānnāntyeṣṭirnāsti sañcayaḥ |	patitānām na ca agham syāt na antyeṣṭiḥ na asti sañcayaḥ 
MBaasaucadiipikaaHK-661	nacāśrupātaḥ piṇḍo vā kāryaṃ śrāddhādikaṃ tvacāditi ||	na ca aśru pātaḥ piṇḍaḥ vā kāryam śrāddha ādikam tvacāt iti 
MBaasaucadiipikaaHK-662	śivadharmiṇīdikṣitasyāpi nāśaucam | uktaṃ kāmike -	śivadharmiṇī dikṣitasya api na āśaucam uktam kāmike 
MBaasaucadiipikaaHK-663	śivavratadharasyāsya na mṛtanna ca sūtakam | pūrvāgrānapekṣatvā	śiva vrata dharasya asya na ca sūtakam 
MBaasaucadiipikaaHK-664	dasta saṃhārahetutaḥ ||	dasta saṃhāra hetutaḥ 
MBaasaucadiipikaaHK-665	suprabhede ca -	suprabhede ca 
MBaasaucadiipikaaHK-666	samyak jñanisvadharmastho na tyajet jñānināntataḥ | śudhyate	samyak na tyajet jñāninā antatas śudhyate 
MBaasaucadiipikaaHK-667	tatkṣaṇāt jñānī ajñānī coktabhāk bhavediti ||	tad kṣaṇāt jñānī ajñānī ca ukta bhāj bhavet iti 
MBaasaucadiipikaaHK-668	lokadharmiṇyāmapi pṛthak pākabhujānnirvāṇa dīkṣitānāṃ	loka dharmiṇyām api pṛthak pākabhujān nirvāṇa dīkṣitānām 
MBaasaucadiipikaaHK-669	sūtakaṃ nāstīti pūrvamevoktam | yathā prāyaścitta samuccaye -	sūtakam na asti iti pūrvam eva uktam yathā prāyaścitta samuccaye 
MBaasaucadiipikaaHK-670	nirvāṇa dīkṣitānāntu pṛthak pākabhujāmapi | āśauci	nirvāṇa dīkṣitānām tu pṛthak pākabhujām api āśauci 
MBaasaucadiipikaaHK-671	yogantyajatāṃ nasyātāṃ mṛtasūtake ||	mṛta sūtake 
MBaasaucadiipikaaHK-672	atra brahmacaryādīnā māśaucā bhavapādanepi sadyaśśauca	atra brahmacarya ādīnām 
MBaasaucadiipikaaHK-673	vidhessnānamātraṃ kartavyam | taduktaṃ saṃgrahe -	vidheḥ snāna mātram kartavyam tat uktam saṃgrahe 
MBaasaucadiipikaaHK-674	āghorāśramiṇornāśe varṇoktamanyathā mṛtau | sadyarāśau	āghoḥ āśramiṇoḥ nāśe varṇa uktam anyathā mṛtau sadyarāśau 
MBaasaucadiipikaaHK-675	gṛhiṇyevaṃ sadyonyeṣu sadāmitha || iti	gṛhiṇī evam sadyas nyeṣu iti 
MBaasaucadiipikaaHK-676	p. 356)	p 
MBaasaucadiipikaaHK-677	prāyaścittasamuccaye -	prāyaścitta samuccaye 
MBaasaucadiipikaaHK-678	astasaṃsārabījatvāt satkriyāḍhyataḥ |	asta saṃsāra bīja tvāt satkriyā āḍhyataḥ 
MBaasaucadiipikaaHK-679	kṣaṇamātraṃ bhavettacca snānādeva nivartata iti dānādau	kṣaṇa mātram bhavet tat ca snānāt eva nivartate iti dāna ādau 
MBaasaucadiipikaaHK-680	sadyaśśaucamuktam | jñānaratnāvalyām -	sadyas śaucam uktam jñānaratnāvalyām 
MBaasaucadiipikaaHK-681	dāne yajñe vivāhe ca saṃkrame deśaviplave | āpadyapi ca	dāne yajñe vivāhe ca saṃkrame deśa viplave āpadi api ca 
MBaasaucadiipikaaHK-682	kāṣṭhāṃ vā sadyaśśaucaṃ vihīyate iti |	kāṣṭhām vā sadyas śaucam vihīyate iti 
MBaasaucadiipikaaHK-683	kūrme tu -	kūrme tu 
MBaasaucadiipikaaHK-684	kāmyavrateṣu dānārcanarahitatayā vratakaraṇaṃ prakārāntara	                   
MBaasaucadiipikaaHK-685	viṣayeṇa uktam |	viṣayeṇa uktam 
MBaasaucadiipikaaHK-686	kāmyopavāse prakāntetvantarāmṛtasūtake | tatra kāmyavrataṃ	                                      
MBaasaucadiipikaaHK-687	kuryāddānārcana vivarjanamiti ||	kuryāt dāna arcana vivarjanam iti 
MBaasaucadiipikaaHK-688	tatraiva rogiṇassūtikādinimitta snānaprāptau satyāṃ tasya	tatra eva snāna prāptau satyām tasya 
MBaasaucadiipikaaHK-689	śuddhiviśeṣaḥ pradarśitaḥ -	śuddhi viśeṣaḥ pradarśitaḥ 
MBaasaucadiipikaaHK-690	āturo snānamāpanne daśakṛtvobhyanāturaḥ |	āturaḥ snānam āpanne daśa kṛtvas abhyanāturaḥ 
MBaasaucadiipikaaHK-691	sṛṣṭvāsṛṣṭvā bahisnāyā tadāsau śuddhimāpnuyāditi |	sṛṣṭvā a sṛṣṭvā bahisnāyā tadā asau śuddhim āpnuyāt iti 
MBaasaucadiipikaaHK-692	mahākarmādi pravṛttānāṃ vratacāndrāyaṇādi pravṛttānāñca	mahākarma ādi pravṛttānām vrata cāndrāyaṇa ādi pravṛttānām ca 
MBaasaucadiipikaaHK-693	sadyaśśaucaṃ yathā prāyaścittasamucaye -	sadyaśśaucam yathā prāyaścitta samucaye 
MBaasaucadiipikaaHK-694	mahākarmapravṛttānāṃ yajñaśeṣakṛtau tathā | vivāhe voḍhuḥ	mahā karma pravṛttānām yajña śeṣa kṛtau tathā vivāhe voḍhuḥ 
MBaasaucadiipikaaHK-695	prakrānte kanyādānodyatasya ca ||	prakrānte kanyā dāna udyatasya ca 
MBaasaucadiipikaaHK-696	devotsavapratiṣṭhāyāṃ ācāryayajamānayoḥ |	deva utsava pratiṣṭhāyām ācārya yajamānayoḥ 
MBaasaucadiipikaaHK-697	paricārakamartyānāṃ sadyaśśaucaṃ vidhīyate ||	paricāraka martyānām sadyas śaucam vidhīyate 
MBaasaucadiipikaaHK-698	p. 357)	p 
MBaasaucadiipikaaHK-699	vrate cāndrāyaṇādīnāṃ homapārāyaṇādiṣu |	vrate cāndrāyaṇa ādīnām homa pārāyaṇa ādiṣu 
MBaasaucadiipikaaHK-700	śrāddhe ca tīrthayātrāyāṃ sadyassyāditi -	śrāddhe ca tīrtha yātrāyām sadyas syāt iti 
MBaasaucadiipikaaHK-701	rājasevakamartyānāṃ yuddhe maraṇassadyaśśaucaṃ prāyaścitta	rāja sevaka martyānām yuddhe maraṇaḥ sadyas śaucam prāyaścitta 
MBaasaucadiipikaaHK-702	samuccaye -	samuccaye 
MBaasaucadiipikaaHK-703	rājasevakamartyānāṃ mṛtau yuddhe ca bāndhavāḥ |	rāja sevaka martyānām mṛtau yuddhe ca bāndhavāḥ 
MBaasaucadiipikaaHK-704	sadyaśśuddhastadānī tadūrdhvadehikamiṣyate ||	sadyas śuddhaḥ tadānī tat ūrdhvadehikam iṣyate 
MBaasaucadiipikaaHK-705	ūrdhvadehikamapi tadānīmeva kartavyam | na tu durmṛtavat kālāntara	ūrdhvadehikam api tadānīm eva kartavyam na tu durmṛta vat kāla antara 
MBaasaucadiipikaaHK-706	ityarthaḥ | abhiṣikta kṣatriyasya śivabhaktānāntriṇāñca	iti arthaḥ kṣatriyasya 
MBaasaucadiipikaaHK-707	nāśaucam | kāmike -	na āśaucam kāmike 
MBaasaucadiipikaaHK-708	rājānassarvadāpūtā abhiṣekeṇa saṃyutāḥ | mahānto	rājānaḥ sarvadā pūtāḥ abhiṣekeṇa saṃyutāḥ 
MBaasaucadiipikaaHK-709	mantriṇaścāpi yadibhaktā maheśvarā || iti	mantriṇaḥ ca api yadi bhaktāḥ maheśvarāḥ iti 
MBaasaucadiipikaaHK-710	candrajñāne ca -	candra jñāne ca 
MBaasaucadiipikaaHK-711	pratiṣṭhācotsave caiva aṣṭabandhana karmaṇi | dīkṣāyāñca	ca eva aṣṭabandhana karmaṇi dīkṣāyāñca 
MBaasaucadiipikaaHK-712	viśeṣeṇa aṃkuraṃ kārayedbudhaḥ ||	viśeṣeṇa aṃkuram kārayet budhaḥ 
MBaasaucadiipikaaHK-713	mahotsavāraṃbhakāle tu naimitte kṛtadeśikaḥ | naimitte kṛtamadhye	mahā utsava āraṃbha kāle tu naimitte kṛta deśikaḥ naimitte kṛta madhye 
MBaasaucadiipikaaHK-714	tu sūtakānāṃ praveśanam ||	tu sūtakānām praveśanam 
MBaasaucadiipikaaHK-715	jyeṣṭhapatnī supatnī ca mātṛpatnī tathaiva ca | ekāṃ patnīṃ	jyeṣṭha patnī su patnī ca mātṛ patnī tathā eva ca ekām patnīm 
MBaasaucadiipikaaHK-716	prasūtañca dīkṣitānānna vidyate ||	prasūtam ca vidyate 
MBaasaucadiipikaaHK-717	āśaucaṃ na camekramaṃ padmapatramivāṃbhasi | yatīnāṃ	āśaucam na padma patram iva aṃbhasi yatīnām 
MBaasaucadiipikaaHK-718	pathikānāñca yogināṃ brahmacāriṇām ||	pathikānām ca yoginām brahmacāriṇām 
MBaasaucadiipikaaHK-719	tathā ca śivabhaktānā māśaucaṃ na ca vidyate |	tathā ca śiva bhaktānām āśaucam na ca vidyate 
MBaasaucadiipikaaHK-720	p. 358)	p 
MBaasaucadiipikaaHK-721	ārabdha kriyāṇāmāśaucaṃ nāstītyuktam | yathā -	ārabdha kriyāṇām āśaucam na asti iti uktam yathā 
MBaasaucadiipikaaHK-722	yaḥ kriyāñcaiva cārabhya kriyāpūrteradhodbhavaḥ |	yaḥ kriyān ca eva ca ārabhya kriyā pūrteḥ adhas udbhavaḥ 
MBaasaucadiipikaaHK-723	kartāraścetpurāteṣāṃ nirddoṣamiti kathyate ||	kartāraḥ ced purā teṣām nirddoṣam iti kathyate 
MBaasaucadiipikaaHK-724	sahasrepi -	sahasre pi 
MBaasaucadiipikaaHK-725	kṛcchrādāvṛtasavaśrāddhadānahomatatvodhvaye |	kṛcchrāt āvṛta sava śrāddha dāna homa tatva udhvaye 
MBaasaucadiipikaaHK-726	prārabdhe tatpravṛttānā sadyaśśaucamadhāgata mityāśaucamadhye	prārabdhe tad pravṛttānām sadyaśśaucam adha āgatam iti āśauca madhye 
MBaasaucadiipikaaHK-727	kṛcchrādi samāptiścecchiṣṭāhamaghaṃ bhavati |	kṛcchra ādi samāptiḥ ced śiṣṭa aham agham bhavati 
MBaasaucadiipikaaHK-728	tadbahiścettirātramityādi vakṣyamāṇāti krāntāśauca	tad bahis ced tirātram ityādi vakṣyamāṇa ati krānta āśauca 
MBaasaucadiipikaaHK-729	vidhirbhavati | yathā saṃgrahe -	vidhiḥ bhavati yathā saṃgrahe 
MBaasaucadiipikaaHK-730	kṛcchrādīnāṃ samāptiścedadhe śiṣṭohamiṣyate |	kṛcchra ādīnām samāptiḥ ced adhe śiṣṭaḥ ūham iṣyate 
MBaasaucadiipikaaHK-731	tadbahiścettrirātrādirityāha bhagavānmanuriti ||	tad bahis ced trirātra ādiḥ iti āha bhagavān manuḥ iti 
MBaasaucadiipikaaHK-732	durmaraṇamapi dvividham -	durmaraṇam api dvividham 
MBaasaucadiipikaaHK-733	buddhipūrvakṛtaṃ pramādakṛtañceti | tatra prathame sapiṇḍānāṃ	buddhi pūrva kṛtam pramāda kṛtam ca iti tatra prathame sapiṇḍānām 
MBaasaucadiipikaaHK-734	sadyaśśaucam | tadā tūṣṇīmeva tasya saṃskāraḥ | kālagrahe -	sadyaśśaucam tadā tūṣṇīm eva tasya saṃskāraḥ kālagrahe 
MBaasaucadiipikaaHK-735	pramādāddumṛtau sadyaśśaucañca samācarediti - atra maraṇasya	pramādāt du mṛtau sadyas śaucam ca samācaret iti atra maraṇasya 
MBaasaucadiipikaaHK-736	buddhipūrvatvannāma maraṇasādhana pravṛttireva buddhipūrvatvam |	buddhi pūrva tvat nāma maraṇa sādhana pravṛttiḥ eva buddhi pūrva tvam 
MBaasaucadiipikaaHK-737	nanu maraṇasya kotyakāmanīyatvāt tādṛśī ca pravṛtti aśanau	nanu maraṇasya kotya kāmanīya tvāt tādṛśī ca pravṛtti aśanau 
MBaasaucadiipikaaHK-738	nirjjagamiṣyati vā | sarpe prasarpati vā | kuḍaye? vipadiṣyati vā	nirjjagamiṣyati vā sarpe prasarpati vā kuḍaye vipadiṣyati vā 
MBaasaucadiipikaaHK-739	| diyakṣatyagnau jṛṃbhati vā kūlaṃ kaṣāyāṃ	diyakṣati agnau jṛṃbhati vā kūlam kaṣāyām 
MBaasaucadiipikaaHK-740	nadyādipravahatyāṃ vā saṃbhavati | evaṃ bahuvidha manyadatyūhyam	nadī ādi pravahatyām vā saṃbhavati evam 
MBaasaucadiipikaaHK-741	p. 359)	p 
MBaasaucadiipikaaHK-742	durmaraṇaviṣayañca bahuvidhāḥ | tathāhi -	durmaraṇa viṣayam ca bahuvidhāḥ tathā hi 
MBaasaucadiipikaaHK-743	ye krodhena sarpādiviṣeṇa vā śastreṇa vā viṣa bhakṣaṇena vā	ye krodhena sarpa ādi viṣeṇa vā śastreṇa vā viṣa bhakṣaṇena vā 
MBaasaucadiipikaaHK-744	girivṛkṣādāvārūhya patanena vā prāṇān parityajanti te	giri vṛkṣa ādau ārūhya patanena vā prāṇān parityajanti te 
MBaasaucadiipikaaHK-745	durmaraṇaviṣayāḥ | taduktaṃ sārdhatriśatikāyām -	durmaraṇa viṣayāḥ tat uktam sārdhatriśatikāyām 
MBaasaucadiipikaaHK-746	krodhātprā * ścadviṣādvahne jastrācca viṣabhakṣaṇāt |	krodhāt prā ścat viṣāt vahne jastrāt ca viṣa bhakṣaṇāt 
MBaasaucadiipikaaHK-747	girivṛkṣātprāṇahāni ṣāṇmāsātparivatsarāt ||	giri vṛkṣāt prāṇa hāni ṣāṇmāsāt parivatsarāt 
MBaasaucadiipikaaHK-748	punassaṣkāraṃ kṛtvā darbhāṇāñcaiva pūrvavaditi |	punar saṣkāram kṛtvā darbhāṇām ca eva pūrvavat iti 
MBaasaucadiipikaaHK-749	etādṛśānāmmṛtānāmāśaucannāsti | pramādāddurmṛtānā	etādṛśānām mṛtānām āśaucam na asti 
MBaasaucadiipikaaHK-750	māśaucodakā nādikamanuṣṭheyamiti kūrmapurāṇe pradarśitam |	mā āśauca udakāḥ na ādikam anuṣṭheyam iti kūrmapurāṇe pradarśitam 
MBaasaucadiipikaaHK-751	yathā -	yathā 
MBaasaucadiipikaaHK-752	viṣādyupahatānāñca vidyutā pārthivairapi | sadyaśśaucaṃ	viṣa ādi upahatānām ca vidyutā pārthivaiḥ api sadyas śaucam 
MBaasaucadiipikaaHK-753	samākhyātaṃ saṃghātamaraṇepi ca ||	samākhyātam saṃghāta maraṇe api ca 
MBaasaucadiipikaaHK-754	atha kaścipramādena bhriyategni viṣādibhiḥ | tasyāśaucaṃ	atha kaścid pramādena bhriyate igni viṣa ādibhiḥ tasya āśaucam 
MBaasaucadiipikaaHK-755	vidhātavyam kāryañcaivodakādikamiti | eṣāṃ maraṇe	vidhātavyam kāryam ca eva udaka ādikam iti eṣām maraṇe 
MBaasaucadiipikaaHK-756	sapiṇḍānāṃ bhasmānta dīkṣenoktaṃ yathā -	sapiṇḍānām bhasma anta dīkṣena uktam yathā 
MBaasaucadiipikaaHK-757	kriyā hīnasya mūrkhasya kataryasya tathaiva ca | ṛṇagrastasya	kriyā hīnasya mūrkhasya tathā eva ca ṛṇa grastasya 
MBaasaucadiipikaaHK-758	ḍaṃbhasya bhasmāntaṃ sūtakaṃ bhavediti ||	ḍaṃbhasya bhasma antam sūtakam bhavet iti 
MBaasaucadiipikaaHK-759	āśaucinaḥ - dravyāṣyapyaśucīni tathā smṛtiḥ -	āśaucinaḥ dravyāṣi api aśucīni tathā smṛtiḥ 
MBaasaucadiipikaaHK-760	dravyāṇi svasyasaṃbandhādadhe santyaśucīni vai |	dravyāṇi santi aśucīni vai 
MBaasaucadiipikaaHK-761	iti | tacchudhyaiva teṣāṃ śuciḥ - tatraiva -	iti tat śudhya eva teṣām śuciḥ tatra eva 
MBaasaucadiipikaaHK-762	svāmiśudhyaiva śudhyanti vāriṇā prokṣitānyapi |	svāmi śudhya eva śudhyanti vāriṇā prokṣitāni api 
MBaasaucadiipikaaHK-763	p. 360)	p 
MBaasaucadiipikaaHK-764	iti mṛta sūtakā praśaṃsakalpitānāntat pūrvaṃ vā	iti pūrvam vā 
MBaasaucadiipikaaHK-765	saṃkalpitānāṃ dravyāṇāmāśaucaṃ nāsti | tathā ca	saṃkalpitānām dravyāṇām āśaucam na asti tathā ca 
MBaasaucadiipikaaHK-766	jñānaratnāvalyām -	jñānaratnāvalyām 
MBaasaucadiipikaaHK-767	sarveṣāṃ vṛddhiśāvādau nāsti sūtakam |	sarveṣām vṛddhi śāva ādau na asti sūtakam 
MBaasaucadiipikaaHK-768	saṃkalpitānandravyairdāna pūjādikaṃ kārayet ||	saṃkalpita ānanda dravyaiḥ dāna pūjā ādikam kārayet 
MBaasaucadiipikaaHK-769	tathā ca pūrvarogā ca pūrvasaṃkalpitairapi iti |	tathā ca pūrva rogā ca pūrva saṃkalpitaiḥ api iti 
MBaasaucadiipikaaHK-770	hiraṇyādīn kāniciddravyāṇi svata evāśaucepi śuddhāni |	hiraṇya ādīn kānicid dravyāṇi svatas eva āśauce pi śuddhāni 
MBaasaucadiipikaaHK-771	taduktaṃ kūrmapurāṇe -	tat uktam kūrmapurāṇe 
MBaasaucadiipikaaHK-772	hiraṇya yonyagocchādya tilāṃ na śuddhasarpiṣāṃ | tilānikṣu ca	na śuddha sarpiṣām tilān ikṣu ca 
MBaasaucadiipikaaHK-773	śākañca lavaṇaṃ kāṣṭhakaiva ca ||	śākam ca lavaṇam kāṣṭhakā eva ca 
MBaasaucadiipikaaHK-774	toyandadhighṛtantailamauṣadhaṃ kṣiramave ca | āśaucināṃ	toyan dadhi ghṛtan tailam auṣadham ca āśaucinām 
MBaasaucadiipikaaHK-775	tṛṇādgrāhyaṃ śuṣkānaṃ caivanityaśaḥ ||	tṛṇāt grāhyam ca eva nityaśas 
MBaasaucadiipikaaHK-776	putrajanmadine dravyāṇāmāśaucaṃ nāsti devatāsāṃnidhyena	putra janma dine dravyāṇām āśaucam na asti devatā sāṃnidhyena 
MBaasaucadiipikaaHK-777	puṇyadinatvāt taduktaṃ ādityapurāṇe -	puṇya dina tvāt tat uktam ādityapurāṇe 
MBaasaucadiipikaaHK-778	devāścapitaraścaiva putro jāto dvijātmanām | āyānti	devāḥ ca pitaraḥ ca eva putraḥ jātaḥ dvijātmanām āyānti 
MBaasaucadiipikaaHK-779	tadahastasmāt * saṃpūrṇañca sarvadā ||	tat ahar tasmāt saṃpūrṇam ca sarvadā 
MBaasaucadiipikaaHK-780	tatra dadyāt suvarṇyantu bhūmiṃgāṃ turagaṃ tathā | chatraṃ	tatra dadyāt bhūmiṃgām turagam tathā chatram 
MBaasaucadiipikaaHK-781	cāgavastraṃ mālyaṃ śayanañcāsanaṃ gṛhamiti ||	cāga vastram mālyam śayanam ca āsanam gṛham iti 
MBaasaucadiipikaaHK-782	tatra sa piṇḍānāṃ api pratigrahedhikārosti | pituśca	tatra sa piṇḍānām api pratigraha idhikāraḥ asti pituḥ ca 
MBaasaucadiipikaaHK-783	dānādhikāraḥ taduktaṃ trilocācāryavayeṇa -	dāna adhikāraḥ tat uktam triloca ācārya vayeṇa 
MBaasaucadiipikaaHK-784	prasūtau karvanā nābhiḥ prāgdāne yogyatā pituḥ |	prasūtau karvanā nābhiḥ prāk dāne yogya tā pituḥ 
MBaasaucadiipikaaHK-785	p. 361)	p 
MBaasaucadiipikaaHK-786	āśaucanānta nyeṣānniṣaddhaḥ pratigraha iti |	pratigrahaḥ iti 
MBaasaucadiipikaaHK-787	nābhikartanātpūrvamityetatprakārāntaram | yāvacchuvāvasthānañca	na abhikartanāt pūrvam iti etat prakāra antaram 
MBaasaucadiipikaaHK-788	grāmasyāpyāśauca masti | bahiśśavaragamanānantarameva	grāmasya api āśaucam bahis śavara gamana anantaram eva 
MBaasaucadiipikaaHK-789	śivapūjādi kartavyam | taduktaṃ kāraṇe -	śiva pūjā ādi kartavyam tat uktam kāraṇe 
MBaasaucadiipikaaHK-790	śāmo dvādaśa daṇḍārintā vāstau yadimṛtastutam | parityajya	dvādaśa vāstau parityajya 
MBaasaucadiipikaaHK-791	śivaṃ pūjya nityanaimittikaṃ caret ||	śivam pūjya nityanaimittikam caret 
MBaasaucadiipikaaHK-792	grāmādbahirgate prete śivapūjāṃ samācarediti |	grāmāt bahis gate prete śiva pūjām samācaret iti 
MBaasaucadiipikaaHK-793	ekādaśadhanurantara vīthyantare mṛtasyāvasthāne itaravīthiṣu	ekādaśa dhanuḥ antara vīthi antare mṛtasya avasthāne itara vīthiṣu 
MBaasaucadiipikaaHK-794	śivapūjādikaṃ kartavyaṃ | tadāhamanuḥ -	śiva pūjā ādikam kartavyam tadā aha manuḥ 
MBaasaucadiipikaaHK-795	nādyādantaśśave grāme nādhīyānnā juheti ca | tāni vīthyantare	na adyāt antar śave grāme na adhīyāt na ā juheti ca tāni vīthi antare 
MBaasaucadiipikaaHK-796	kuryā dhanurekādaśāntara iti ||	kuryāḥ dhanuḥ ekādaśa antare iti 
MBaasaucadiipikaaHK-797	antaśśavetyagnihotrādikaṃ śrotakarma kuryādeva |	antar śava iti agnihotra ādikam śrota karma kuryāt eva 
MBaasaucadiipikaaHK-798	stryantare śrutismṛtyorvirodhe tu śrutireva balīyasī |	strī antare śruti smṛtyoḥ virodhe tu śrutiḥ eva balīyasī 
MBaasaucadiipikaaHK-799	tasmādantaśśavegrāme juhuyācchrauta pāvakamiti ||	tasmāt antar śavegrāme juhuyāt śrauta pāvakam iti 
MBaasaucadiipikaaHK-800	kuṭikapattanakharvaṭarājadhānīṣu antaraśavadoṣo nāstyeva |	kuṭika pattana kharvaṭa rājadhānīṣu antara śava doṣaḥ na asti eva 
MBaasaucadiipikaaHK-801	tathā smṛtiḥ -	tathā smṛtiḥ 
MBaasaucadiipikaaHK-802	kuṭike pattane caiva kharvaṭe rājadhāniṣu | karmaṇaivārcanaṃ	kuṭike pattane ca eva kharvaṭe rājadhāniṣu karmaṇā eva arcanam 
MBaasaucadiipikaaHK-803	kuryāduktadoṣo na vidyate ||	kuryāt ukta doṣaḥ na vidyate 
MBaasaucadiipikaaHK-804	iti kaṭikādi svarūpañca suprabhedevarṇitam |	iti kaṭikā ādi svarūpam ca 
MBaasaucadiipikaaHK-805	viprāṇāñca sajātyānāṃ vā sogrāma iti smṛtaḥ |	viprāṇām ca sajātyānām vā saḥ grāmaḥ iti smṛtaḥ 
MBaasaucadiipikaaHK-806	śūdrairadhiṣṭhitaṃ yattat kheṭakaṃ parikīrtitam ||	śūdraiḥ adhiṣṭhitam yat tat kheṭakam parikīrtitam 
MBaasaucadiipikaaHK-807	p. 362)	p 
MBaasaucadiipikaaHK-808	teṣāṃ sīmāntare yeṣāṃ vāsaṃ kuṭikamucyate | caturaṃga	teṣām sīmā antare yeṣām vāsam kuṭikam ucyate caturaṃga 
MBaasaucadiipikaaHK-809	samākīrṇa nṛpabhṛtyaissamākulam ||	samākīrṇa nṛpa bhṛtyaiḥ samākulam 
MBaasaucadiipikaaHK-810	rājaveśma samāyuktaṃ rājadhānī prakīrtyate |	rāja veśma samāyuktam rājadhānī prakīrtyate 
MBaasaucadiipikaaHK-811	dīpāntaragatadravya krayavikrakairyutam ||	dīpa antara gata dravya kraya vikrakaiḥ yutam 
MBaasaucadiipikaaHK-812	pattanaṃ tvābdhitīre tu tayorante tu kharvaṭamiti |	pattanam tu ābdhi tīre tu tayoḥ ante tu kharvaṭam iti 
MBaasaucadiipikaaHK-813	ayañca daśāhavidhirāhitāgnerddahadinādiḥ | anāhitāgnermaraṇa	ayam ca daśa aha vidhiḥ āhitāgneḥ ddaha dina ādiḥ anāhitāgneḥ maraṇa 
MBaasaucadiipikaaHK-814	dinādi samākulam taduktaṃ kāmike -	dina ādi samākulam tat uktam kāmike 
MBaasaucadiipikaaHK-815	kṛtakṛtyāni kāryasya mṛtasya dahanāditaḥ |	kṛtakṛtyāni kāryasya mṛtasya dahanāt itas 
MBaasaucadiipikaaHK-816	anāhitāgnerāśaucaṃ maraṇāhātprakīrtitamiti ||	anāhitāgneḥ āśaucam maraṇa ahāt prakīrtitam iti 
MBaasaucadiipikaaHK-817	ādimadinavadvāśauca viṣayodaya māśritya pravartanīyam |	ādima dina vat vā āśauca viṣaya udayam āśritya pravartanīyam 
MBaasaucadiipikaaHK-818	taduktaṃ jñānaratnāvalyām -	tat uktam jñānaratnāvalyām 
MBaasaucadiipikaaHK-819	rātrau striyo rajo yoge janmamṛtyośca saṃbhave | pūrvameva dinaṃ	rātrau striyaḥ rajaḥ yoge janma mṛtyoḥ ca saṃbhave pūrvam eva dinam 
MBaasaucadiipikaaHK-820	grāhyaṃ yāvannodayate raviriti ||	grāhyam yāvat na udayate raviḥ iti 
MBaasaucadiipikaaHK-821	sūtakamadhye sūtakasaṃbhave mṛtakamadhye mṛtakasaṃbhave	sūtaka madhye sūtaka saṃbhave mṛtaka madhye mṛtaka saṃbhave 
MBaasaucadiipikaaHK-822	pūrveṇaivottarasya śuddhiḥ | taduktaṃ kāmike -	pūrveṇa eva uttarasya śuddhiḥ tat uktam kāmike 
MBaasaucadiipikaaHK-823	sūtake sūtakaṃ bhūyo yadyapi syadvijottamāḥ | prākroṣeṇaiva	sūtake sūtakam bhūyaḥ yadi api sya dvijottamāḥ prākroṣeṇa eva 
MBaasaucadiipikaaHK-824	śuddhissyāt mṛtake mṛtakaṃ tathā ||	śuddhiḥ syāt mṛtake mṛtakam tathā 
MBaasaucadiipikaaHK-825	suprabhede ca -	suprabhede ca 
MBaasaucadiipikaaHK-826	sūtake sūtakaṃ vāpi pretake pretakantu vā | prāptāśaucadinaṃ	sūtake sūtakam vā api pretake pretakam tu vā prāpta āśauca dinam 
MBaasaucadiipikaaHK-827	sarvaṃ pūrvāśaucādvinaśyati |	sarvam pūrva āśaucāt vinaśyati 
MBaasaucadiipikaaHK-828	p. 363)	p 
MBaasaucadiipikaaHK-829	candrajñāne ca -	candra jñāne ca 
MBaasaucadiipikaaHK-830	sūtakaṃ sūkenaiva śāvaṃ śāvena śudhyatī ti |	sūtakam sūkena eva śāvam śāvena śudhyati iti 
MBaasaucadiipikaaHK-831	śāvāśaucamadhye sūtakasaṃbhave śāvāśaucena naśyati |	śāva āśauca madhye sūtaka saṃbhave śāva āśaucena naśyati 
MBaasaucadiipikaaHK-832	sūtakamadhyeśāvāśaucasaṃbhave sūtakena śāvāśaucaṃ naśyati |	sūtaka madhye śāva āśauca saṃbhave sūtakena śāva āśaucam naśyati 
MBaasaucadiipikaaHK-833	uktaṃ candrajñānakāmikayoḥ -	uktam candra jñāna kāmikayoḥ 
MBaasaucadiipikaaHK-834	śāvāśauce samutpanne sūtakantu yadā bhavet |śāvena śudhyatīti	śāva āśauce samutpanne sūtakam tu yadā bhavet śāvena śudhyati iti 
MBaasaucadiipikaaHK-835	| na sūtiśśāvaśodhinīti | jñānaratnāvalyāmapi -	na sūtiḥ śāva śodhinī iti jñānaratnāvalyām api 
MBaasaucadiipikaaHK-836	śāvenāśudhyate vṛddhirnavṛddhayā śudhyate śavaḥ |	śāvena a śudhyate vṛddhiḥ na vṛddhayā śudhyate śavaḥ 
MBaasaucadiipikaaHK-837	dirghāśaucenālpāśaucaṃ naśyati | alpāśauca madhye	dirghāśaucena alpa āśaucam naśyati alpa āśauca madhye 
MBaasaucadiipikaaHK-838	dīrghāśaucamāgataṃ cenna naśyatīti | taduktaṃ kāmike -	dīrgha āśaucam āgatam ced na naśyati iti tat uktam kāmike 
MBaasaucadiipikaaHK-839	mṛtake mṛtakañcetsyā sūtake sūtakantathā | tatrādhikena	mṛtake mṛtakam ced syā sūtake sūtakam tathā tatra adhikena 
MBaasaucadiipikaaHK-840	śuddhisyānna ca nyūnadinaiśśuciriti ||	śuddhi syāt na ca nyūna dinaiḥ śuciḥ iti 
MBaasaucadiipikaaHK-841	pūrvasyāntadinevāśaucāntaraṃ samutpannaṃ cet	pūrvasya anta dinā iva āśauca antaram samutpannam ced 
MBaasaucadiipikaaHK-842	pūrvāśaucādinādupari dvidinamāśaucam | pūrvasyāntadine	pūrva āśaucāt dināt upari dvi dinam āśaucam pūrvasya anta dine 
MBaasaucadiipikaaHK-843	tadbhavati cet tadupari tridina māśauca manuṣṭheyam | taduktaṃ	tat bhavati ced tad upari tri dina m āśauca manuṣṭheyam tat uktam 
MBaasaucadiipikaaHK-844	candrajñāne pūrvasyāntadine yadi dvidivasācchudhyet prabhāte	candra jñāne pūrvasya anta dine yadi dvi divasāt śudhyet prabhāte 
MBaasaucadiipikaaHK-845	tryahamabhūditi sapiṇḍānāṃ daśāhātparataḥ	tri aham abhūt iti sapiṇḍānām daśa ahāt paratas 
MBaasaucadiipikaaHK-846	atikrāntadaśāhāśaucaṃ māsatrayamadhye śravaṇe	atikrānta daśa aha āśaucam māsa traya madhye śravaṇe 
MBaasaucadiipikaaHK-847	trirātramanuṣṭheyam | tadūrdhvamabdaparyantaṃ tat śravaṇe	tri rātram anuṣṭheyam tad ūrdhvam abda paryantam tat śravaṇe 
MBaasaucadiipikaaHK-848	ekadinamanuṣṭheyam |	eka dinam anuṣṭheyam 
MBaasaucadiipikaaHK-849	p. 364)	p 
MBaasaucadiipikaaHK-850	ataūrdhvaṃ snānameva tathā kāmike -	atas ūrdhvam snānam eva tathā kāmike 
MBaasaucadiipikaaHK-851	atikrānte daśāhe tu trirātramaśucirbhavet | trike taddinaikaṃ	atikrānte daśa ahe tu tri rātram aśuciḥ bhavet trike tad dina ekam 
MBaasaucadiipikaaHK-852	syāt snānamevordhvamabdata iti |	syāt snānam eva ūrdhvam abdataḥ iti 
MBaasaucadiipikaaHK-853	kūrmapurāṇe ca -	kūrmapurāṇe ca 
MBaasaucadiipikaaHK-854	atīte daśakebhyoktaṃ sapiṇḍānāṃ trirātrakam | tathā ca maraṇe	atīte daśakebhyaḥ uktam sapiṇḍānām tri rātrakam tathā ca maraṇe 
MBaasaucadiipikaaHK-855	snānamūrdhvaṃ sāṃvatsarāditi ||	snānam ūrdhvam sāṃvatsarāt iti 
MBaasaucadiipikaaHK-856	tridināśaucinamaharāśaucināñcāti krāntāśauca viṣaye dinaṃ	tri dina āśaucinam ahar āśaucinām ca ati krānta āśauca viṣaye dinam 
MBaasaucadiipikaaHK-857	sadyaḥ krameṇa bhavati | pakṣiṇāśaucināntu daśāhamadhye	sadyas krameṇa bhavati pakṣiṇā āśaucinām tu daśa aha madhye 
MBaasaucadiipikaaHK-858	tacchravaṇe ekakālaḥ | daśāhātparata śravaṇe snānamātrataḥ |	tad śravaṇe eka kālaḥ daśa ahāt parata śravaṇe snāna mātrataḥ 
MBaasaucadiipikaaHK-859	satyāśaucedinaṃ sadyassūtakāmaraṇāśaucinoḥ |	sati āśauce dinam sadyas sūtaka āmaraṇa āśaucinoḥ 
MBaasaucadiipikaaHK-860	pakṣiṇyadhiṣvadhānta sruksekakālonyathāplava iti daśāhamadhye	sruc seka kālaḥ anyathā plavaḥ iti daśa aha madhye 
MBaasaucadiipikaaHK-861	maraṇa śravaṇe sapiṇḍānāṃ sarveṣāmapi śiṣṭohamevāśaucam	maraṇa śravaṇe sapiṇḍānām sarveṣām api 
MBaasaucadiipikaaHK-862	bhavati uktaṃ saṃgrahe -	bhavati uktam saṃgrahe 
MBaasaucadiipikaaHK-863	śiṣṭāhamapi sarveṣāṃ eva jñā * * * daśā |	śiṣṭā aham api sarveṣām eva jñā 
MBaasaucadiipikaaHK-864	hamadhye asthisañcanayāt pūrvaṃ mātā pitrormaraṇaśravaṇe	ha madhye asthisañcanayāt pūrvam mātā pitroḥ maraṇa śravaṇe 
MBaasaucadiipikaaHK-865	putrasya śiṣṭāhantadūrdhvaśravaṇe śravaṇadinamārabhya	putrasya śiṣṭa ahan tat ūrdhva śravaṇe śravaṇa dinam ārabhya 
MBaasaucadiipikaaHK-866	daśāhantadapi saṃgrahe - prāksañcayanātsutasyāsthiṃ	daśa ahan tat api saṃgrahe prāk sañcayanāt sutasya asthim 
MBaasaucadiipikaaHK-867	tadūrdhvandaśātṛkamiti | daśātparaṃ saṃvatsarādyathā ataurdhva	tat ūrdhvan daśātṛkam iti daśāt param saṃvatsarāt yathā 
MBaasaucadiipikaaHK-868	daśāhike tu tau dehike mātā pitrormaraṇe mātṛkamiti |	daśāhike tu tau dehike mātā pitroḥ maraṇe mātṛkam iti 
MBaasaucadiipikaaHK-869	saṃpatnyāṣṭā maraṇe te daśāhamāśaucam |	saṃ patnyā aṣṭā maraṇe te daśa aham āśaucam 
MBaasaucadiipikaaHK-870	vatsarātparamakṛtaurdhvadehike śrutemātāpitrorviṣayedaśāhaṃ	vatsarāt param akṛta aurdhvadehike 
MBaasaucadiipikaaHK-871	mātṛsapatnyāviye tryaham |	tri aham 
MBaasaucadiipikaaHK-872	p. 365)	p 
MBaasaucadiipikaaHK-873	kṛtaurdhva dehike tu mātāpitrostryahaṃ dinantasya bhavati tathā	tu mātā pitroḥ tri aham dina antasya bhavati tathā 
MBaasaucadiipikaaHK-874	prāyaścittasamuccaye -	prāyaścitta samuccaye 
MBaasaucadiipikaaHK-875	pitarau cenmṛtau syātāṃ dūrasthopi putrakaḥ | śrutvā	pitarau ced mṛtau syātām dūra sthaḥ api putrakaḥ śrutvā 
MBaasaucadiipikaaHK-876	taddinamārabhya daśāhaṃ sūtakaṃ bhavet ||	tad dinam ārabhya daśa aham sūtakam bhavet 
MBaasaucadiipikaaHK-877	atītebdepikartavyaṃ pretakāryaṃ yathāvidhi |	pretakāryam yathāvidhi 
MBaasaucadiipikaaHK-878	pitṛpatnyāmatītāyāḥ mātṛvajija dvijottamāḥ ||	pitṛ patnyām atītāyāḥ dvijottamāḥ 
MBaasaucadiipikaaHK-879	saṃvatsarepyatītepi trirātrimaśucirbhavet |	saṃvatsare api atīte pi tri rātrim aśuciḥ bhavet 
MBaasaucadiipikaaHK-880	saṃgrahepi spaṣṭamuktam -	saṃgrahe api spaṣṭam uktam 
MBaasaucadiipikaaHK-881	daśarātraṃ sadāpitroḥ parokṣamaraṇaśrutau | tryahaṃ	daśa rātram sadā pitroḥ parokṣa maraṇa śrutau tri aham 
MBaasaucadiipikaaHK-882	mātṛsapatnābhyāṃ daśāhaṃ vatsarādadhaḥ ||	mātṛ sapatnābhyām daśa aham vatsarāt adhas 
MBaasaucadiipikaaHK-883	kṛtaudhve dehike abde dinaṃ tasyāstryahaṃ tayoriti | atra	kṛtaudhve dehike abde dinam tasyāḥ tri aham tayoḥ iti atra 
MBaasaucadiipikaaHK-884	jananamaraṇanimittāśaucayepi svādhyāya sakarmaṇāñca * * * gaḥ |	svādhyāya sa karmaṇām ca     
MBaasaucadiipikaaHK-885	atra marīciḥ -	atra marīciḥ 
MBaasaucadiipikaaHK-886	sūtake karmaṇāntyāgassandhyādīnāṃ vidhīyate |	sūtake karmaṇā an tyāgaḥ sandhyā ādīnām vidhīyate 
MBaasaucadiipikaaHK-887	yathā smṛtyantare - (sūtake caturṇāṃ samayādīnāṃ krameṇaika	yathā smṛti antare sūtake caturṇām samaya ādīnām krameṇa eka 
MBaasaucadiipikaaHK-888	dvitri caturddinānyevānadhyāya dināni - yathā tatraiva) dānaṃ	dvi tri catur dināni eva anadhyāya dināni yathā tatra eva dānam 
MBaasaucadiipikaaHK-889	dānaṃ pratigrahaṃ homa svādhyāyo devatārcanam | vaiśvadevādikaṃ	dānam pratigraham homa svādhyāyaḥ devatā arcanam vaiśvadeva ādikam 
MBaasaucadiipikaaHK-890	sarvaṃ sūtake vinivartate ||	sarvam sūtake vinivartate 
MBaasaucadiipikaaHK-891	adivadevatābhayaḥ - mataṃge ca - na * * * vṛttena na kāraṇa	mataṃge ca na    vṛttena na 
MBaasaucadiipikaaHK-892	jñānamuttamam | puṇyakāleṣunādhyeyantrābhotpatriṣu suvrata |	jñānam uttamam suvrata 
MBaasaucadiipikaaHK-893	p. 366)	p 
MBaasaucadiipikaaHK-894	sūtake caturṇāṃ samayādīnāṃ krameṇaika dvitri	sūtake caturṇām samaya ādīnām krameṇa eka dvi tri 
MBaasaucadiipikaaHK-895	caturdinānyevānadhyāyadināni - yathā tatraiva -	catur dināni eva anadhyāya dināni yathā tatra eva 
MBaasaucadiipikaaHK-896	ekaṃ dvetrīṇi catvāri dvitvaṃ nānāntavastinām | prakartavyaṃ	ekam dve trīṇi catvāri dvi tvam nānā anta vastinām prakartavyam 
MBaasaucadiipikaaHK-897	pratiṣṭhāyācārya yajamānayoḥ ||	pratiṣṭhāya ācārya yajamānayoḥ 
MBaasaucadiipikaaHK-898	paricārakamartyānāṃ sadyaśśaucaṃ vidhīyate | vrate	paricāraka martyānām sadyas śaucam vidhīyate vrate 
MBaasaucadiipikaaHK-899	cāndrāyaṇādīnāṃ hemapārāyaṇādiṣu ||	cāndrāyaṇa ādīnām hema pārāyaṇa ādiṣu 
MBaasaucadiipikaaHK-900	śrāddhe ca tīrthayātrāyāṃ sadyassyāditi | anadhyāya	śrāddhe ca tīrtha yātrāyām sadyas syāt iti anadhyāya 
MBaasaucadiipikaaHK-901	vṛttānāṃ yathākramaṃ * * deyepi ||	vṛttānām yathākramam 
MBaasaucadiipikaaHK-902	ekavṛdhyā caturṇāṃ syuranadhyayadināni tu |	eka vṛdhyā caturṇām syuḥ anadhyaya dināni tu 
MBaasaucadiipikaaHK-903	sūtakepi śaiveśavārcana manuṣṭheyam | yathā aṃśumati -	sūtake api śaiva īśava arcana manuṣṭheyam yathā aṃśumati 
MBaasaucadiipikaaHK-904	prajālopo na kartavyassūtike pretakepi ca | śivamantreṇa kartavyaṃ	prajā lopaḥ na kartavyaḥ sūtike pretake pi ca śiva mantreṇa kartavyam 
MBaasaucadiipikaaHK-905	snānamātreṇa śudhyati ||	snāna mātreṇa śudhyati 
MBaasaucadiipikaaHK-906	athāśaucaṃ na bhavettatra padmapatramivāṃbhasi |	atha āśaucam na bhavet tatra padma patram iva aṃbhasi 
MBaasaucadiipikaaHK-907	mataṃge ca -	mataṃge ca 
MBaasaucadiipikaaHK-908	devāgni gurukāryāṇāṃ vicchedo naiva vidyate |	deva agni guru kāryāṇām vicchedaḥ na eva vidyate 
MBaasaucadiipikaaHK-909	kālottarepi -	kāla uttare pi 
MBaasaucadiipikaaHK-910	eka kālaṃ trikālaṃ vā catuṣkālamathāpi vā | apūjya	eka kālam tri kālam vā catuṣkālam atha api vā a pūjya 
MBaasaucadiipikaaHK-911	parameśānaṃ bhukte yastupramādataḥ ||	parameśānam bhukte yaḥ tu pramādataḥ 
MBaasaucadiipikaaHK-912	prāyaścitaṃ prakartavyaṃ anyathā narakaṃ vrajet | pūjālopo	prāyaścitam prakartavyam anyathā narakam vrajet 
MBaasaucadiipikaaHK-913	kartavyassūtake mṛtakepi ca ||	kartavyaḥ sūtake mṛtake api ca 
MBaasaucadiipikaaHK-914	p. 366)	p 
MBaasaucadiipikaaHK-915	jalabudbudavaccaiva tasmālliṃgaṃ sadārcayet | iti	jala budbuda vat ca eva tasmāt liṃgam sadā arcayet iti 
MBaasaucadiipikaaHK-916	ayaṣṭvā tu kramān bhuṃkte ajāpi mūtaretasi |	a yaṣṭvā tu kramāt bhuṃkte ajā api mūta retasi 
MBaasaucadiipikaaHK-917	ahomīmalamaśnīyāddātā ca viṣamaśnute ||	ahomīm alam aśnīyāt dātā ca viṣam aśnute 
MBaasaucadiipikaaHK-918	tathā skande -	tathā skande 
MBaasaucadiipikaaHK-919	akṛtvā pūjanaṃ śaṃbho yo bhuṃkte parameṣṭhinaḥ | krūra	a kṛtvā pūjanam śaṃbho yaḥ bhuṃkte parameṣṭhinaḥ krūra 
MBaasaucadiipikaaHK-920	pañcamalañcaiva sośnātyevaṃ na saṃśayaḥ ||	pañca malam ca eva saḥ uśnāti evam na saṃśayaḥ 
MBaasaucadiipikaaHK-921	brahmakaivarte ca -	brahmakaivarte ca 
MBaasaucadiipikaaHK-922	īśānārcanavarjita bhojyamannaṃ kīḍaṃmalaṃ tatkuṇapaṃ vadanti	bhojyam annam kīḍaṃmalam tat kuṇapam vadanti 
MBaasaucadiipikaaHK-923	| bahiṣkṛtassarvajanaissapāpī prayāti ghorāṃ narakāṃ naśeṣāt	bahiṣkṛtaḥ sarva janaiḥ sa pāpī prayāti ghorām narakām 
MBaasaucadiipikaaHK-924	śivadharme -	śivadharme 
MBaasaucadiipikaaHK-925	arcayitvā mahādevaṃ āpannopi sadābudhaḥ | varaṃ	arcayitvā mahādevam āpannaḥ api sadā budhaḥ varam 
MBaasaucadiipikaaHK-926	prāṇaparityāgaśśiracchedopime varam ||	prāṇa parityāgaḥ śira chedaḥ u pi me varam 
MBaasaucadiipikaaHK-927	natvanabhyarcya bhuñjīyāt bhagavantaṃ trilocanam | evaṃ nirvahate	natu an abhyarcya bhuñjīyāt bhagavantam trilocanam evam nirvahate 
MBaasaucadiipikaaHK-928	yastu yāvajjīvaṃ śivārcanam ||	yaḥ tu yāvajjīvam śiva arcanam 
MBaasaucadiipikaaHK-929	manuṣyacarmaṇābaddha sa rudro nātra saṃśayaḥ | idaṃ	sa rudraḥ na atra saṃśayaḥ idam 
MBaasaucadiipikaaHK-930	śivārcanaṃ bhaktijñānavairāgyānyatamadārvyavatāṃ bahireva	śiva arcanam bhakti jñāna vairāgya anyatama dārvyavatām bahis eva 
MBaasaucadiipikaaHK-931	kāryaṃ tadrahitānāmantareva kāryam | yathā kāmike -	kāryam tad rahitānām antar eva kāryam yathā kāmike 
MBaasaucadiipikaaHK-932	bhaktijñānañca vairāgyameteṣvanyatamantu vā | yasya sadya * ve * *	bhakti jñānam ca vairāgyam eteṣu anyataman tu vā 
MBaasaucadiipikaaHK-933	kāryaṃ samayinārcanam ||	kāryam samayinā arcanam 
MBaasaucadiipikaaHK-934	mandaṃ mandataraṃvāpi yasyaitantritayaṃ bhavet |	mandam mandataram vā api yasya etat tritayam bhavet 
MBaasaucadiipikaaHK-935	antaryāgaṃ stutenāpi kartavya iti | aṃśumati -	antaryāgam stutena api kartavyaḥ iti aṃśumati 
MBaasaucadiipikaaHK-936	p. 367)	p 
MBaasaucadiipikaaHK-937	antaryāgaṃ kurvatastu liṃgārcanaṃ guruṇā svajātinā anyena vā	antaryāgam kurvataḥ tu liṃga arcanam guruṇā sva jātinā anyena vā 
MBaasaucadiipikaaHK-938	kārayitavyamityuktaṃ tadyathā -	kārayitavyam iti uktam tat yathā 
MBaasaucadiipikaaHK-939	svakarmānuṣṭhitañcaiva janahīnaṃ tu bhasmakam | mānasañca	sva karma anuṣṭhitam ca eva jana hīnam tu bhasmakam mānasam ca 
MBaasaucadiipikaaHK-940	yajeddhīmān sarvandānasaṃkalpanam ||	yajet dhīmān 
MBaasaucadiipikaaHK-941	talliṃgamarcayitvā na tu guruṇā svajātinā | anenaivārcanaṃ	tat liṃgam arcayitvā na tu guruṇā sva jātinā anena eva arcanam 
MBaasaucadiipikaaHK-942	kuryāt antepuṣpāñjalitrayam ||	kuryāt ante puṣpa añjali trayam 
MBaasaucadiipikaaHK-943	āśaucānte ca kartavyaṃ pūrvamārge yajettataḥ |	āśauca ante ca kartavyam pūrva mārge yajet tatas 
MBaasaucadiipikaaHK-944	atra puṣpāñjali dānānmanasārtita dakṛduccālitamagnya	atra puṣpa añjali dānāt manasā ārtita 
MBaasaucadiipikaaHK-945	sannidhāveva kartavyannavoparitasya pūjāmaṇṭapapraveśe	sannidhau eva kartavyam nava upari tasya pūjā maṇṭapa praveśe 
MBaasaucadiipikaaHK-946	yogyatvādanena dṛḍhammātāpi ātmārthapūjanameva kāryam | yathā	yogya tvāt anena ātma artha pūjanam eva kāryam yathā 
MBaasaucadiipikaaHK-947	kiraṇe -	kiraṇe 
MBaasaucadiipikaaHK-948	ātmārthaṃ pūjayennityaṃ sūtakaṃ pretakaṃ nahi |	ātma artham pūjayet nityam sūtakam pretakam nahi 
MBaasaucadiipikaaHK-949	parārthamarcanannityaṃ pūjanaṃ naiva kārayet ||	para artham arcanat nityam pūjanam na eva kārayet 
MBaasaucadiipikaaHK-950	svakarmāṇi sadākuryāt devakarmāṇi naiva hi |	sva karmāṇi sadā kuryāt deva karmāṇi na eva hi 
MBaasaucadiipikaaHK-951	aṃśumati ca -	aṃśumati ca 
MBaasaucadiipikaaHK-952	iti jñātvā tu yatnena pūjayansadāśivaḥ | sūtake pretakeśauce	iti jñātvā tu yatnena pūjayan sadāśivaḥ sūtake pretaka īśauce 
MBaasaucadiipikaaHK-953	ātmārthañca viśeṣataḥ ||	ātma artham ca viśeṣataḥ 
MBaasaucadiipikaaHK-954	sūtakarahitenāpi pṛthak pākbhujā nirvāṇadīkṣitena paramārtha	sūtaka rahitena api pṛthak pākbhujā nirvāṇa dīkṣitena paramārtha 
MBaasaucadiipikaaHK-955	pūjanaṃ vikalpena kartavyam | yathā kāmike pṛthakpākabhujo yadi	pūjanam vikalpena kartavyam yathā kāmike pṛthakpāka bhujaḥ yadi 
MBaasaucadiipikaaHK-956	svārthe vāthaparārthe vā vidhāna midamīritam |	sva arthe vā atha para arthe vā vidhāna m idam īritam 
MBaasaucadiipikaaHK-957	parityajetparārthaṃ vā loke saṃvaraṇāya ca |	parityajet para artham vā loke saṃvaraṇāya ca 
MBaasaucadiipikaaHK-958	p. 368)	p 
MBaasaucadiipikaaHK-959	tasya japapradakṣiṇāderapi na parityāgaḥ | uktaṃ kālottare -	tasya japa pradakṣiṇa ādeḥ api na parityāgaḥ uktam kālottare 
MBaasaucadiipikaaHK-960	japapradakṣiṇādīni kartavyāni prayatnataḥ |	japa pradakṣiṇa ādīni kartavyāni prayatnataḥ 
MBaasaucadiipikaaHK-961	āśaucināṃ sarveṣāmapi bāhyaprakārapraveśanena doṣaḥ |	āśaucinām sarveṣām api bāhya prakāra praveśanena doṣaḥ 
MBaasaucadiipikaaHK-962	taduktaṃ kāmike -	tat uktam kāmike 
MBaasaucadiipikaaHK-963	eteṣāmapi sarveṣā prakārasya praveśanam | agramaṇṭapa bāhye tu	eteṣām api sarveṣām prakārasya praveśanam 
MBaasaucadiipikaaHK-964	na doṣāya prakalpate ||	na doṣāya prakalpate 
MBaasaucadiipikaaHK-965	iti tatraiva ye dīkṣitānāṃ āśaucināṃ viśeṣāḥ pradarśitāḥ	iti tatra eva ye dīkṣitānām āśaucinām viśeṣāḥ pradarśitāḥ 
MBaasaucadiipikaaHK-966	yathā -	yathā 
MBaasaucadiipikaaHK-967	āśaucānāntrivarṇānā mantarmantarmaṇṭapaveśanam |	antarmantar maṇṭapa veśanam 
MBaasaucadiipikaaHK-968	dīkṣitānāṃ na doṣāya bhavedeva mūnīśvaraḥ ||	dīkṣitānām na doṣāya bhavet eva mūnīśvaraḥ 
MBaasaucadiipikaaHK-969	tatonyeṣāṃ praveśe tu pañcagavyena secayet |	tatas nyeṣām praveśe tu pañcagavyena secayet 
MBaasaucadiipikaaHK-970	tadbahirveśanteṣānnadoṣāya prakalpata || iti	tat bahis veśanta eṣa anna doṣāya prakalpate iti 
MBaasaucadiipikaaHK-971	sūtakibhiḥ pretakibhirgā pūrvāṇāṃ sparśane	sūtakibhiḥ pretakibhiḥ gā pūrvāṇām sparśane 
MBaasaucadiipikaaHK-972	tatpuṣpāṇāntatpuṣpa spṛṣṭabhāsānāmapi parityāga eva	parityāgaḥ eva 
MBaasaucadiipikaaHK-973	taduktaṃ kālottare -	tat uktam kālottare 
MBaasaucadiipikaaHK-974	sūtakī puṣpsasaṃsparśe puṣpabhāṇḍāni varjayet | aghorāstreṇa	sūtakī puṣpa sasaṃsparśe puṣpa bhāṇḍāni varjayet aghorāstreṇa 
MBaasaucadiipikaaHK-975	mantreṇa lakṣahomaṃ samācaret ||	mantreṇa lakṣa homam samācaret 
MBaasaucadiipikaaHK-976	pratake sparsane doṣo lakṣa * * mantathaiva ceti |	sparsane doṣaḥ ca iti 
MBaasaucadiipikaaHK-977	rudrākṣāṇānddhāraṇaṃ varjyaṃ skandakālottare -	varjyam skandakālottare 
MBaasaucadiipikaaHK-978	rudrākṣaṃ dhārayet strī tu dīkṣāsaṃskāra saṃyutā | sūtake	rudrākṣam dhārayet strī tu dīkṣā saṃskāra saṃyutā sūtake 
MBaasaucadiipikaaHK-979	mṛtake vāpi rudrākṣaṃ naiva dhārayediti |	mṛtake vā api rudrākṣam na eva dhārayet iti 
MBaasaucadiipikaaHK-980	p. 369)	p 
MBaasaucadiipikaaHK-981	rajasvalā caṇḍālaspṛṣṭāpi varjayediti - brahmakaivartepi -	rajasvalā caṇḍāla spṛṣṭā api varjayet iti brahmakaivarte pi 
MBaasaucadiipikaaHK-982	kecitsūtakaśavayorjalamalotsarge ca saṃge	kecid sūtaka śavayoḥ jala mala utsarge ca saṃge 
MBaasaucadiipikaaHK-983	striyāśśuddhācakṣamalikādīntadadhate svāyukṣaya syāditi	striyāḥ śuddhā cakṣamalikā ādīn tat dadhate sva āyu kṣaya syāt iti 
MBaasaucadiipikaaHK-984	keṣāñcinmate mantrapurassaraṃ kaṇṭhayorbhujayorvā bhūtānāṃ	keṣāñcid mate mantra purassaram kaṇṭhayoḥ bhujayoḥ vā bhūtānām 
MBaasaucadiipikaaHK-985	rudrākṣāṇāṃ varjyannāsti mahatyāmālāyā eva varjanam |	rudrākṣāṇām eva varjanam 
MBaasaucadiipikaaHK-986	taduktaṃ tatraiva - anye pāpaharaṃ sadā dhṛtimati procye	tat uktam tatra eva anye pāpa haram sadā dhṛtimati procye 
MBaasaucadiipikaaHK-987	bhujekaṇṭhayorakṣaṃ mantrapurassarantu mahatirmālā na dhāryā	bhuje kaṇṭhayoḥ akṣam mantra puras sarantu mahatiḥ mālā na dhāryā 
MBaasaucadiipikaaHK-988	śucāviti - rajasvalānāryastu viṃśatidinādūrdhvaṃ punaścarajaḥ	śucau iti rajasvalā anāryaḥ tu viṃśati dināt ūrdhvam punar carajaḥ 
MBaasaucadiipikaaHK-989	prādurbhāve trirātramaśuddhiḥ | taduktaṃ prāyaścitta samuccaye -	prādurbhāve tri rātram aśuddhiḥ tat uktam prāyaścitta samuccaye 
MBaasaucadiipikaaHK-990	rajasvalā tu yā nārī punareva rajasvalā | sā	rajasvalā tu yā nārī punar eva rajasvalā sā 
MBaasaucadiipikaaHK-991	viṃśatidinādūrdhvaṃ trirātramaśucirbhavediti ||	viṃśati dināt ūrdhvam tri rātram aśuciḥ bhavet iti 
MBaasaucadiipikaaHK-992	suprabhede tu -	suprabhede tu 
MBaasaucadiipikaaHK-993	dinatrayepi pratyekaṃ śuddhiviśeṣo darśitaḥ |	dina traye api pratyekam śuddhi viśeṣaḥ darśitaḥ 
MBaasaucadiipikaaHK-994	tadyathā -	tat yathā 
MBaasaucadiipikaaHK-995	prathamehani caṇḍālī dvitīye brahma dhātakī | trtīye rajakī	prathamehani caṇḍālī dvitīye brahma dhātakī trtīye rajakī 
MBaasaucadiipikaaHK-996	proktā caturthehani śudhyati ||	proktā caturthehani śudhyati 
MBaasaucadiipikaaHK-997	tasyāśca tasmin dinatrayepi snānādi parivarjanīyam |	tasyāḥ ca tasmin dina traye pi snāna ādi parivarjanīyam 
MBaasaucadiipikaaHK-998	ekabhuktamañjalitaḥ aravarvapātrato pātrodakapānaṃ ca kartavyamiti	eka bhuktam añjalitaḥ pātra udaka pānam ca kartavyam iti 
MBaasaucadiipikaaHK-999	tatraiva -	tatra eva 
MBaasaucadiipikaaHK-1000	trirātramalaviddhā sā snānādi parivarjitā | ekabhuktā na	tri rātra mala viddhā sā snāna ādi parivarjitā eka bhuktā na 
MBaasaucadiipikaaHK-1001	kharveṇa vāri sāñjalinā pibet ||	kharveṇa vāri sa añjalinā pibet 
MBaasaucadiipikaaHK-1002	p. 370)	p 
MBaasaucadiipikaaHK-1003	iti caturthehani dantadhāvana pūrvakaṃ snānaṃ kṛtvā pañcagavyaṃ	iti caturthehani dantadhāvana pūrvakam snānam kṛtvā pañcagavyam 
MBaasaucadiipikaaHK-1004	ghṛtaṃ vāpiprāśya śivaṃ pūjayet pūrvadinatrayepi	ghṛtam vā apiprāśya śivam pūjayet pūrva dina traye pi 
MBaasaucadiipikaaHK-1005	antāśśivārcanaṃ kartavyaṃ tathā ca jñānaratnāvalyām -	kartavyam tathā ca jñānaratnāvalyām 
MBaasaucadiipikaaHK-1006	snāyāt saṃskṛtya dantādimalānmṛttikayā muhuḥ | pañcagavyaṃ	snāyāt saṃskṛtya danta ādi malān mṛttikayā muhur pañcagavyam 
MBaasaucadiipikaaHK-1007	ghṛtaṃ vāpi prāśya saṃpūjayecchivam ||	ghṛtam vā api prāśya saṃpūjayet śivam 
MBaasaucadiipikaaHK-1008	antaryāgaḥ prakartavyastadāpūrvadinatraye |	antaryāgaḥ prakartavyaḥ tadā pūrva dina traye 
MBaasaucadiipikaaHK-1009	antaryāgakaraṇe caturthehani aghoramantrasya sahasrajapaṃ kṛtvā	antaryāga karaṇe caturthe hani aghora mantrasya sahasra japam kṛtvā 
MBaasaucadiipikaaHK-1010	pañcagavyaṃ prāśyaśivaṃ pūjayet | prāyaścitta samuccaye -	pañcagavyam prāśya śivam pūjayet prāyaścitta samuccaye 
MBaasaucadiipikaaHK-1011	yadvānte ghoramantrasya sahasraṃ parivartayediti | atra	yat vā ante ghora mantrasya sahasram parivartayet iti atra 
MBaasaucadiipikaaHK-1012	rajasvalānāṃ sajātīyānāṃ vijātīyānāṃ anyonya sparśane	rajasvalānām sajātīyānām vijātīyānām anyonya sparśane 
MBaasaucadiipikaaHK-1013	śuddhiveśeṣāḥ parāśareṇa pradarśitāḥ - tadyathā -	śuddhi veśeṣāḥ parāśareṇa pradarśitāḥ tat yathā 
MBaasaucadiipikaaHK-1014	spṛṣṭvā rajasvalānyonyaṃ brahmaṇīkṣatriyāntayā |	spṛṣṭvā rajasvalā anyonyam brahmaṇī kṣatriya antayā 
MBaasaucadiipikaaHK-1015	arddhakṛcchrañcaretpūrvā pādamekaṃ tathāparā ||	arddha kṛcchran caret pūrvā pādam ekam tathā aparā 
MBaasaucadiipikaaHK-1016	spṛṣṭvā rajasvalānyonyaṃ brāhmaṇī śūdrajāntathā |	spṛṣṭvā rajasvalā anyonyam brāhmaṇī śūdrajān tathā 
MBaasaucadiipikaaHK-1017	kṛcchreṇa śudhyatī pūrvā śūdrāsnānena śudhyati ||	kṛcchreṇa śudhyatī pūrvā śūdrā snānena śudhyati 
MBaasaucadiipikaaHK-1018	vyāsaḥ -	vyāsaḥ 
MBaasaucadiipikaaHK-1019	rajasvalā yadānyonyaṃ svagotre caikabhatṛke | kāmama kāmatovāpi	rajasvalā yadā anyonyam sva gotre ca ekabhatṛke 
MBaasaucadiipikaaHK-1020	spṛṣṭvā snānena śudhyati ||	spṛṣṭvā snānena śudhyati 
MBaasaucadiipikaaHK-1021	rajasvalā sparśe kāmato akāmato vā sandehena vā śivārcane	rajasvalā sparśe kāmatas akāmatas vā sandehena vā śiva arcane 
MBaasaucadiipikaaHK-1022	svajātīśvaramantrasya sahasraṃ sahasrārthaṃ vāṣṭottaraśataṃ	sva jāti īśvara mantrasya sahasram sahasra artham vā aṣṭottaraśatam 
MBaasaucadiipikaaHK-1023	krameṇa kartavyam | hīnajātīya rajasvalāsparśe hīnasya	krameṇa kartavyam hīna jātīya rajasvalā sparśe hīnasya 
MBaasaucadiipikaaHK-1024	pūrvoktasaṃkhyardha japaḥ kartavyaḥ taduktaṃ prāyaścittasamuccaye	pūrva ukta saṃkhyardha japaḥ kartavyaḥ tat uktam prāyaścittasamuccaye 
MBaasaucadiipikaaHK-1025	p. 371)	p 
MBaasaucadiipikaaHK-1026	svajātyudakyā saṃspṛṣṭaṃ kāmyaṃ yadiśivaṃ yajet |	sva jāti udakyā saṃspṛṣṭam kāmyam yadiśivam yajet 
MBaasaucadiipikaaHK-1027	sajatīśvaramantrasya sahasraṃ prajapettadā ||	sajati īśvara mantrasya sahasram prajapet tadā 
MBaasaucadiipikaaHK-1028	ajñānatorcane tasya tadarthaṃ jāyate śuciḥ |	ajñāna tā ūrcane tasya tad artham jāyate śuciḥ 
MBaasaucadiipikaaHK-1029	japedaṣṭottaraśataṃ sandehe sampuasthite ||	japet aṣṭottaraśatam sandehe 
MBaasaucadiipikaaHK-1030	hīnajātīya saṃsparśe kramādvitri caturguṇam | utkṛṣṭajāti	hīna jātīya saṃsparśe kramādvi tri caturguṇam utkṛṣṭa jāti 
MBaasaucadiipikaaHK-1031	saṃsparśe hīnastasyardhamācaret || iti |	saṃsparśe hīnaḥ tasya ardham ācaret iti 
MBaasaucadiipikaaHK-1032	sakāmā kāmayorbheda ṣaṭsahasrikāyāṃ pradarśitaḥ -	sa kāmā kāmayoḥ bheda ṣaṭsahasrikāyām pradarśitaḥ 
MBaasaucadiipikaaHK-1033	yathā -	yathā 
MBaasaucadiipikaaHK-1034	daivādrogāttathā mohādrājacorabhayādibhiḥ |	daivāt rogāt tathā mohāt rāja cora bhaya ādibhiḥ 
MBaasaucadiipikaaHK-1035	ebhirdoṣairakāmitvaṃ śeṣaṃ jñeyantu kāmata || iti	ebhiḥ doṣaiḥ akāmi tvam śeṣam jñeyantu kāmatas iti 
MBaasaucadiipikaaHK-1036	rajasvalā spṛṣṭasyodakasya sparśane snānācchuddhiḥ |	rajasvalā spṛṣṭasya udakasya sparśane snānāt śuddhiḥ 
MBaasaucadiipikaaHK-1037	udakyādyudakaspṛṣṭo snānaṃ kṛtvā viśudhyatīti |	udakyā ādi udaka spṛṣṭaḥ snānam kṛtvā viśudhyati iti 
MBaasaucadiipikaaHK-1038	nanu strīṇāṃ bhartṛśuśrūṣaṇaika dharmatayā svatantryā	nanu strīṇām bhartṛ śuśrūṣaṇa eka dharma tayā svatantryā 
MBaasaucadiipikaaHK-1039	bhāvāddīkṣā saṃskārādhikārabhāvena kathaṃ śivapūjā	bhāvāt dīkṣā saṃskāra adhikāra bhāvena katham śiva pūjā 
MBaasaucadiipikaaHK-1040	prasaktiriti cenna | tāsāṃ bharktyādhanumatyā śivasaṃskāre	prasaktiḥ iti ced na tāsām bharktyā a dhanumatyā śiva saṃskāre 
MBaasaucadiipikaaHK-1041	adhikārapradarśanāt |	adhikāra pradarśanāt 
MBaasaucadiipikaaHK-1042	nādhikārassvatonāryā śivasaṃskārakarmaṇi | yogādbhartura * va	na adhikāraḥ svatas nāryā śiva saṃskāra karmaṇi yogāt bhartuḥ 
MBaasaucadiipikaaHK-1043	bhaktiyuktā yadīśvare ||	bhakti yuktāḥ yadi īśvare 
MBaasaucadiipikaaHK-1044	tathaiva bhartṛhīnāyāḥ putradārābhyanujñayā | adhikāro	tathā eva bhartṛ hīnāyāḥ putra dāra abhyanujñayā adhikāraḥ 
MBaasaucadiipikaaHK-1045	bhavatyeva kanyāyāḥ pituranujñayeti ||	bhavati eva kanyāyāḥ pituḥ anujñayā iti 
MBaasaucadiipikaaHK-1046	p. 372)	p 
MBaasaucadiipikaaHK-1047	jananamaraṇa nimittāśaucasya uttaraprabandhena pratipāditasyānte	janana maraṇa nimitta āśaucasya uttara prabandhena pratipāditasya ante 
MBaasaucadiipikaaHK-1048	saṃbhavakālasnāna mudakasparśanañca brāhmaṇeva kartavyam |	saṃbhava kāla snānam udaka sparśanam ca brāhmaṇa iva kartavyam 
MBaasaucadiipikaaHK-1049	kṣatriyeṇa snānaṃ vāhanādi sparśanañca kartavyam |	kṣatriyeṇa snānam vāhana ādi sparśanañca kartavyam 
MBaasaucadiipikaaHK-1050	vaiśyānāmapi snānaṃ vṛtodasparśanañca kartavyam | śūdreṇāpi	vaiśyānām api snānam vṛta uda sparśanam ca kartavyam śūdreṇa api 
MBaasaucadiipikaaHK-1051	snānaṃ yaṣṭisparśanañca kartavyam | uttarasaṃgrahe -	snānam yaṣṭi sparśanam ca kartavyam uttara saṃgrahe 
MBaasaucadiipikaaHK-1052	aghānte sumakhe snātvā vipraspṛṣṭo buśudhyati |	agha ante su makhe snātvā vipra spṛṣṭaḥ 
MBaasaucadiipikaaHK-1053	nṛpādīnvāhanādīnānyathā abravīnmanuriti |	nṛpa ādīn vāhana ādīn ānyathā abravīt manuḥ iti 
MBaasaucadiipikaaHK-1054	atra bāhyasmatayassanti dīkṣitānāṃ śaivānāntu aghānte kartavya	atra bāhya smatayaḥ santi dīkṣitānām śaivānām tu agha ante 
MBaasaucadiipikaaHK-1055	viśeṣosti | antaryāgaṃ bahiryāgaṃ vā sūtakamadhye kṛtavatāṃ	viśeṣaḥ asti antaryāgam bahis yāgam vā sūtaka madhye kṛtavatām 
MBaasaucadiipikaaHK-1056	putrakādīnā māśaucināmāśaucānte snānamekāhaṃ	putraka ādīnām āśaucinām āśauca ante snānam eka aham 
MBaasaucadiipikaaHK-1057	naktabhojanamaghorajapasāhasraṃ daśāṃśahomaśca kartavya uktaṃ	naktabhojanam aghora japa sāhasram daśa aṃśa homaḥ ca kartavyaḥ uktam 
MBaasaucadiipikaaHK-1058	samuccaye -	samuccaye 
MBaasaucadiipikaaHK-1059	āśaucināṃ samayīnāṃ sandhyopāsti ramantrakā | na kāryo	āśaucinām sandhyā upāsti na kāryā 
MBaasaucadiipikaaHK-1060	liṃgasaṃsparśaḥ kāryamantaśśivārcanam ||	liṃga saṃsparśaḥ kāryam antar śiva arcanam 
MBaasaucadiipikaaHK-1061	bhaktivairāgyayuktānāṃ liṃgārcāhita cetasām | nāśaucaṃ	bhakti vairāgya yuktānām liṃga arcā hita cetasām na āśaucam 
MBaasaucadiipikaaHK-1062	samayasthānāṃ pūjākāle manīṣiṇām ||	samaya sthānām pūjā kāle manīṣiṇām 
MBaasaucadiipikaaHK-1063	tadante tena kartavyaṃ ekāhaṃ nakta bhojanam | aghora japasāhasraṃ	tad ante tena kartavyam eka aham nakta bhojanam aghora japa sāhasram 
MBaasaucadiipikaaHK-1064	gaḍḍhuka snānahomayugiti ||	gaḍḍhuka snāna homa yuj iti 
MBaasaucadiipikaaHK-1065	pretakasūtaka saṃbandhe śivārcanaṃ parityaktavatāṃ	pretaka sūtaka saṃbandhe śiva arcanam parityaktavatām 
MBaasaucadiipikaaHK-1066	putrakādīnāṃ yāvadāśauca vāsarantāvaddinamāśaucānte	putraka ādīnām yāvat āśauca vāsaran tāvat dinam āśauca ante 
MBaasaucadiipikaaHK-1067	trikālasnāna pūjāghorasahasra japagnihomapurassarannakta	                    
MBaasaucadiipikaaHK-1068	yāvadbhojanañca kartavyam |	yāvat bhojanam ca kartavyam 
MBaasaucadiipikaaHK-1069	p. 373)	p 
MBaasaucadiipikaaHK-1070	yathā tatraiva -	yathā tatra eva 
MBaasaucadiipikaaHK-1071	pretasūtaka saṃbandhi nityāhāniṃ karoti yaḥ | tasya	preta sūtaka saṃbandhi nityā hānim karoti yaḥ tasya 
MBaasaucadiipikaaHK-1072	tāvatikāśuddhiryā yadāśauca vāsaram ||	tāvatikā aśuddhiḥ yā yat āśauca vāsaram 
MBaasaucadiipikaaHK-1073	trikālasnāna pūjāgni japahomapurassaram | kāryaṃ ghorasahasreṇa	                                       
MBaasaucadiipikaaHK-1074	naktaṃ yāvadbhojanamiti ||	naktam yāvadbhojanam iti 
MBaasaucadiipikaaHK-1075	maraṇavaddahanamapi puruṣaśuciṃ karoti | tathā smṛtyantare -	maraṇa vat dahanam api puruṣa śucim karoti tathā smṛti antare 
MBaasaucadiipikaaHK-1076	mṛtāśauca nimitte dve hananammaraṇantathā | jñātīnāṃ	mṛtāśauca nimitte dve hananam maraṇantathā jñātīnām 
MBaasaucadiipikaaHK-1077	maraṇādeva dahanaṃ dāhakasya tviti ||	maraṇāt eva dahanam dāhakasya tu iti 
MBaasaucadiipikaaHK-1078	atra sapiṇḍavyatiriktasyāpi dāhakasya maraṇāśaucaṃ bhavati |	atra sapiṇḍa vyatiriktasya api dāhakasya maraṇa āśaucam bhavati 
MBaasaucadiipikaaHK-1079	ubhayorapi maraṇadahanayormṛtāśauca nimittakatvatulyatvāt | asya	ubhayoḥ api maraṇa dahanayoḥ mṛta āśauca nimittaka tva tulya tvāt asya 
MBaasaucadiipikaaHK-1080	vadāhāśaucapyasya maraṇāśaucādapi prabalatayā tannaśyatvaṃ	maraṇa āśaucāt api prabala tayā tad naśya tvam 
MBaasaucadiipikaaHK-1081	nāsti - uktaṃ kāmike -	na asti uktam kāmike 
MBaasaucadiipikaaHK-1082	sūtakādviguṇaṃ śāvaṃ śāvādviguṇamārtavam |	sūtakāt dviguṇam śāvam śāvāt dviguṇam ārtavam 
MBaasaucadiipikaaHK-1083	ārtavāddviguṇā sūtiḥ tasmādapi ca dahaka iti ||	ārtavāt dviguṇā sūtiḥ tasmāt api ca dahakaḥ iti 
MBaasaucadiipikaaHK-1084	pitṛdāhāśaucaṃ vinā dāhāśaucaṃ dāhāśaucamadhye naśyati |	pitṛ dāha āśaucam vinā dāha āśaucam dāha āśauca madhye naśyati 
MBaasaucadiipikaaHK-1085	ubhayorattulyasaṃkhyatayā nimittaikyena ca samatvāt | uktaṃ	ubhayoḥ a t tulya saṃkhya tayā nimitta aikyena ca sama tvāt 
MBaasaucadiipikaaHK-1086	prāyaścittassamuccaye - sannipāte tulya saṃkhyāśaucayośśudhyate	prāyaścitta ssamuccaye sannipāte tulya saṃkhyā śaucayoḥ śudhyate 
MBaasaucadiipikaaHK-1087	samamiti | taccaghridvividham | prathamadanaṃ punardahanamiti |	samam iti 
MBaasaucadiipikaaHK-1088	sākṣāccaritasya dahanaṃ prathama dahanam |	sākṣāccaritasya dahanam dahanam 
MBaasaucadiipikaaHK-1089	p. 374)	p 
MBaasaucadiipikaaHK-1090	atra sapiṇḍānāmāśaucaṃ na vaiṣamyam | asthitvākṛtervā	atra sapiṇḍānām āśaucam na vaiṣamyam a sthitvā ākṛteḥ vā 
MBaasaucadiipikaaHK-1091	dahanaṃ punardahanam | uktaṃ smṛtau -	dahanam punar dahanam uktam smṛtau 
MBaasaucadiipikaaHK-1092	asnāpalāśabṛndairvā yadhvā tu pratirūpakam |	asnā palāśa bṛndaiḥ vā yadhvā tu pratirūpakam 
MBaasaucadiipikaaHK-1093	kṣīraprakṣālanaṃ kṛtvā tadasthipretavaddahet ||	kṣīra prakṣālanam kṛtvā tat asthi preta vat dahet 
MBaasaucadiipikaaHK-1094	ākṛtidahanaṃ suprabhedepi varṇitam | yathā -	ākṛti dahanam suprabhede api varṇitam yathā 
MBaasaucadiipikaaHK-1095	vācāyuktasya maraṇaṃ śastreṇaiva kramāditaḥ |	vācā yuktasya maraṇam śastreṇa eva kramāt itas 
MBaasaucadiipikaaHK-1096	vasūrikṣayakuṣṭhādhai rātmaghātakakāraṇam ||	              
MBaasaucadiipikaaHK-1097	jalena śṛṃgiṇāvāpi vahninā vā viśeṣataḥ | etaistu maraṇaṃ	jalena vahninā vā viśeṣataḥ etaiḥ tu maraṇam 
MBaasaucadiipikaaHK-1098	yeṣāṃ teṣāmākṛtirucyate ||	yeṣām teṣām ākṛtiḥ ucyate 
MBaasaucadiipikaaHK-1099	sarpeṇa paśunāgaiddeśāntaraṃ gate | dvādaśāntādatikrānte	sarpeṇa paśunā agait deśa antaram gate dvādaśāntāt atikrānte 
MBaasaucadiipikaaHK-1100	cākṛterdahanaṃ smṛtam ||	ca ākṛteḥ dahanam smṛtam 
MBaasaucadiipikaaHK-1101	śastrādimaraṇaṃ yetra kāryaṃ saṃvatsaropari | amantreṇa	śastra ādi maraṇam kāryam saṃvatsara upari amantreṇa 
MBaasaucadiipikaaHK-1102	daheddehaṃ khanitvā vāya bhūtale ||	dahet deham khanitvā bhū tale 
MBaasaucadiipikaaHK-1103	sudarbhairāvṛtaṃ kṛtvā sūtreṇāveṣṭya cākṛtiḥ | plāśa	sudarbhaiḥ āvṛtam kṛtvā sūtreṇa āveṣṭya ca ākṛtiḥ 
MBaasaucadiipikaaHK-1104	patrairāveṣṭaya sūtreṇa parikalpya vai ||	patraiḥ āveṣṭaya sūtreṇa parikalpya vai 
MBaasaucadiipikaaHK-1105	mṛtavatsarvakarmāṇi kārayettu vicakṣaṇaḥ |	mṛta vat sarva karmāṇi kārayet tu vicakṣaṇaḥ 
MBaasaucadiipikaaHK-1106	ākṛterdahanaṃ proktamiti | jñānaratnāvalyāṃ tu ākṛteḥ	ākṛteḥ dahanam proktam iti jñānaratnāvalyām tu ākṛteḥ 
MBaasaucadiipikaaHK-1107	karaṇaṃ kuśena vā piṣṭhena vā * mayenavetyuktam | yathā -	karaṇam kuśena vā piṣṭhena vā mayena vā iti uktam yathā 
MBaasaucadiipikaaHK-1108	deśāntare vipannasya mṛttikāmadhyadeśakam | kauśīntatpratimāṃ	deśa antare vipannasya mṛttikā madhya deśakam kauśīn tad pratimām 
MBaasaucadiipikaaHK-1109	kṛtvā vaiṣṭīṃ vā gomayodbhavām ||	kṛtvā vaiṣṭīm vā gomaya udbhavām 
MBaasaucadiipikaaHK-1110	p. 375)	p 
MBaasaucadiipikaaHK-1111	pañcagavyaplutāntasyāntalliṃga mupakārayediti |	pañcagavya pluta antasya anta liṃgam upakārayet iti 
MBaasaucadiipikaaHK-1112	svāyaṃbhuve -	svāyaṃbhuve 
MBaasaucadiipikaaHK-1113	deśāntare mṛtasyāsya antyeṣṭirdīkṣitasya ca | mṛtasya	deśa antare mṛtasya asya antyeṣṭiḥ dīkṣitasya ca mṛtasya 
MBaasaucadiipikaaHK-1114	prakṛtiṃ kṛtvā kartavyā ca kuśairapi ||	prakṛtim kṛtvā kartavyā ca kuśaiḥ api 
MBaasaucadiipikaaHK-1115	kūrme ca -	kūrme ca 
MBaasaucadiipikaaHK-1116	dehābhāve palāśaistu kṛtapratikṛtiṃ punaḥ | dāhaḥ	deha abhāve palāśaiḥ tu kṛta pratikṛtim punar dāhaḥ 
MBaasaucadiipikaaHK-1117	kāryonyathānyāyaṃ sapiṇḍaiśraddhayānvitaiḥ ||	kāryaḥ anyathānyāyam sapiṇḍaiḥ śraddhayā anvitaiḥ 
MBaasaucadiipikaaHK-1118	durmṛtānāṃ punarddahanapūrvakāle buddhitatvayonyaṣṭaka	durmṛtānām punar ddahana pūrva kāle 
MBaasaucadiipikaaHK-1119	madhyavartipiśācatva nivṛtyarthamaghora mantralakṣajapa	madhya varti piśāca tva nivṛti artham aghora mantra lakṣa japa 
MBaasaucadiipikaaHK-1120	rudrabalipūrvaka mākrtidahanantatraivoktam | yathā -	rudra bali pūrvaka tatra eva uktam yathā 
MBaasaucadiipikaaHK-1121	atha pramādataścorasarpavahnihatātmanām | hastivyāghranadīvega	atha pramādataḥ cora sarpa vahni hata ātmanām 
MBaasaucadiipikaaHK-1122	saṃgrāhahatajīvinām ||	saṃgrāha hata jīvinām 
MBaasaucadiipikaaHK-1123	uddhṛtyātmaviyuktānāṃ anyeṣāmātmaghātinām | apidehaṃ	uddhṛtya ātma viyuktānām anyeṣām ātma ghātinām apideham 
MBaasaucadiipikaaHK-1124	dahetpūrvantūṣṇīmeva śivāgninā ||	dahet pūrvan tu uṣṇīm eva śiva agninā 
MBaasaucadiipikaaHK-1125	japatvālakṣamaghorasya dadyādrudrabaliṃ yathā | snātvācamaya	japatvā alakṣam aghorasya dadyāt rudra balim yathā snātvā ācamaya 
MBaasaucadiipikaaHK-1126	tathāgamya bhojayecca tapodhanān ||	tathā āgamya bhojayet ca tapodhanān 
MBaasaucadiipikaaHK-1127	mahāvratadharānaṣṭau yadvā pāśupatādikān |	mahāvrata dharān aṣṭau yat vā pāśupata ādikān 
MBaasaucadiipikaaHK-1128	vastrairddakṣiṇayā caitān toṣayitvā visarjayet ||	vastraiḥ ddakṣiṇayā ca etān toṣayitvā visarjayet 
MBaasaucadiipikaaHK-1129	darbhaiḥ puttalikāṃ kṛtvā taddehapratiyātikām | śeṣaṃ	darbhaiḥ puttalikām kṛtvā tad deha pratiyātikām śeṣam 
MBaasaucadiipikaaHK-1130	pūrvavadāpādya yojayedamale pade || iti	pūrva vat āpādya yojayet amale pade iti 
MBaasaucadiipikaaHK-1131	p. 376)	p 
MBaasaucadiipikaaHK-1132	brāhmapurāṇe -	brāhmapurāṇe 
MBaasaucadiipikaaHK-1133	abdāntevātha ṣāṇmāse punaḥ kṛtvā saṃskṛtim |	abda antevāsī atha ṣāṇmāse punar kṛtvā saṃskṛtim 
MBaasaucadiipikaaHK-1134	trirātramavirdatvā piṇḍaṃ kuryātkriyādikam ||	tri rātram aviḥ da tvā piṇḍam kuryāt kriyā ādikam 
MBaasaucadiipikaaHK-1135	deśāntaragatasya dvādaśāntātyaye ākṛtidahanapūrvakaṃ	deśa antara gatasya dvādaśānta atyaye ākṛti dahana pūrvakam 
MBaasaucadiipikaaHK-1136	aurdhvadehikaṃ tasya kartuḥ patnyā api vaidhavyaṃ kāryam | evaṃ	aurdhvadehikam tasya kartuḥ patnyāḥ api vaidhavyam kāryam evam 
MBaasaucadiipikaaHK-1137	kṛtenantara deśāntaragataḥ patiḥ punarāgataścettena tasyāḥ	deśa antara gataḥ patiḥ punar āgataḥ ced tena tasyāḥ 
MBaasaucadiipikaaHK-1138	patnyāḥ dvāhapūrvaṃ māṃgalya muttarīyeṇa	patnyāḥ dvāha pūrvam māṃgalyam uttarīyeṇa 
MBaasaucadiipikaaHK-1139	kaṇṭhesamāropaṇīyam | taduktaṃ suprabhede - deśāddeśāntaraṃ	kaṇṭhesamāropaṇīyam tat uktam suprabhede deśāt deśa antaram 
MBaasaucadiipikaaHK-1140	gate -	gate 
MBaasaucadiipikaaHK-1141	dvādaśabdetvatikrānte ākṛterdahanaṃ smṛtam | tasya patnyāsti	dvādaśa abde tu atikrānte ākṛteḥ dahanam smṛtam tasya patnyā asti 
MBaasaucadiipikaaHK-1142	cettatra vaidhavyaṃ kārayetkramāt ||	ced tatra vaidhavyam kārayet kramāt 
MBaasaucadiipikaaHK-1143	balikarmāṇi cānyāni tvācaiva samantrakam | paścāttadāgate sāpi	bali karmāṇi ca anyāni tvācā eva sa mantrakam paścāt tad āgate sā api 
MBaasaucadiipikaaHK-1144	māṃgalyābharaṇaṃ tathā ||	māṃgalya ābharaṇam tathā 
MBaasaucadiipikaaHK-1145	māṃgalyamuttariyeṇa patnyāḥ kaṇṭhetiropayet |	māṃgalyam uttariyeṇa patnyāḥ kaṇṭhe atiropayet 
MBaasaucadiipikaaHK-1146	iti | asya punarvivāha vidhiḥ kālādarśe pradarśitaḥ -	iti asya punarvivāha vidhiḥ kālādarśe pradarśitaḥ 
MBaasaucadiipikaaHK-1147	kāmike tu -	kāmike tu 
MBaasaucadiipikaaHK-1148	tithivāranakṣatradoṣe dahājanmamaraṇa saṃbhave ca yathā -	tithi vāra nakṣatra doṣe dahā janma maraṇa saṃbhave ca yathā 
MBaasaucadiipikaaHK-1149	bhadre tripādanakṣatre śukrāṃgārabṛhaspatau | dahanaṃ maraṇaṃ	bhadre tripāda nakṣatre śukra aṃgāra bṛhaspatau dahanam maraṇam 
MBaasaucadiipikaaHK-1150	yeṣāstatkulakṣayakāraṇam ||	yeṣāḥ tat kula kṣaya kāraṇam 
MBaasaucadiipikaaHK-1151	tadarthameva kartavyaṃ punardahanamādarāditi |	tad artham eva kartavyam punar dahanam ādarāt iti 
MBaasaucadiipikaaHK-1152	bhadrā nāmadvitīyā saptamīdvādaśyaḥ | tripādanakṣatrāṇi	bhadrā nāma dvitīyā saptamī dvādaśyaḥ tripāda nakṣatrāṇi 
MBaasaucadiipikaaHK-1153	kṛttiko phalgunyuttarāṣāḍha punarvasu viśākha	kṛttiko phalgunī uttarāṣāḍha punarvasu viśākha 
MBaasaucadiipikaaHK-1154	pūrvābhādrapadanakṣatrāṇi ṣaṭ anyeṣāmapi smṛtiṣu	pūrvābhādrapada nakṣatrāṇi ṣaḍ anyeṣām api smṛtiṣu 
MBaasaucadiipikaaHK-1155	punardahanamuktam |	punar dahanam uktam 
MBaasaucadiipikaaHK-1156	p. 377)	p 
MBaasaucadiipikaaHK-1157	mantravatsaṃskṛtasyāpi asamāptodakasyārvā * * rādinādūrdhvaṃ	mantravat saṃskṛtasya api a samāpta udakasya arvā 
MBaasaucadiipikaaHK-1158	pūnarddāho vidhīyata iti -	pūnarddāhaḥ vidhīyate iti 
MBaasaucadiipikaaHK-1159	amantrapūrvandagdhānāmaṃgavaikalyaśoṣaṇam | anubhāva	anubhāva 
MBaasaucadiipikaaHK-1160	mṛtānāñca punardahanamiṣyata iti ||	mṛtānām ca punar dahanam iṣyate iti 
MBaasaucadiipikaaHK-1161	idañca punardahanaṃ dvividham - aṃdhamadhyaka bāhyakamiti | tatra	idam ca punar dahanam dvividham tatra 
MBaasaucadiipikaaHK-1162	prathame * ṣṭātme sarveṣāmāśaucaṃ yathāha saṃgrahe -	prathame sarveṣām āśaucam yathā āha saṃgrahe 
MBaasaucadiipikaaHK-1163	rajā yajvā punardāhe śiṣṭāhamiti | adhabāhyakamapi dvividham -	rajā yajvā punar dāhe śiṣṭā aham iti 
MBaasaucadiipikaaHK-1164	yajvapunardahanamayajva punardahanamiti | tatrādye daśāhaṃ yathā	yajva punardahanam ayajva punardahanam iti tatra ādye daśa aham yathā 
MBaasaucadiipikaaHK-1165	prāyaścittasamuccaye -	prāyaścitta samuccaye 
MBaasaucadiipikaaHK-1166	āhitāgneḥ punardāhaṃ tadāpi daśarātrakamiti | dvitīye tryahaṃ	āhitāgneḥ punar dāham tadā api daśa rātrakam iti dvitīye tri aham 
MBaasaucadiipikaaHK-1167	yathā tatraiva kālāddāhe punastryahamiti | saṃgrahe tu - asthidāhe	yathā tatra eva kālāt dāhe punar tri aham iti saṃgrahe tu asthi dāhe 
MBaasaucadiipikaaHK-1168	prāgadhagrahaṇāgrahaṇa vikalpena pūrṇa stryahāśauca vikalpa	vikalpena pūrṇa strī aha āśauca vikalpa 
MBaasaucadiipikaaHK-1169	uktaḥ yathāpūrvaṃ prākcedadhāgrahaḥ | asthidāha iti	uktaḥ yathāpūrvam asthi dāhaḥ iti 
MBaasaucadiipikaaHK-1170	sarvatrapunardahane sutānāndaśarātraṃ yathā tatraiva sutānantu	sarvatra punar dahane sutānān daśa rātram yathā tatra eva 
MBaasaucadiipikaaHK-1171	daśarātramiheṣyata iti | adhunā sāmānya matyānāmanugamana	daśa rātram iha iṣyate iti 
MBaasaucadiipikaaHK-1172	nirhāṇa vdhānamucyate | śaivānāmanugamana	nirhāṇa vdhānam ucyate śaivānām anugamana 
MBaasaucadiipikaaHK-1173	nirharaṇayorviśeṣamanantaraṃ vakṣyāmaḥ | anugamane tu taddinameva	nirharaṇayoḥ viśeṣam anantaram vakṣyāmaḥ anugamane tu tat dinam eva 
MBaasaucadiipikaaHK-1174	karmānarhatvaṃ snānāgnisparśana ghṛtaprāśana punasnāna	karma anarha tvam snāna agni sparśana ghṛta prāśana punar snāna 
MBaasaucadiipikaaHK-1175	prāṇāyāmaissajātīyāvānugamane vijātīyāpi śuddhiḥ |	prāṇāyāmaiḥ sajātīya avānugamane vijātīyā api śuddhiḥ 
MBaasaucadiipikaaHK-1176	p. 378)	p 
MBaasaucadiipikaaHK-1177	uktaṃ prāyaścittasamuccaye -	uktam prāyaścittasamuccaye 
MBaasaucadiipikaaHK-1178	anugamyecchayā pretaṃ jñātimajñātimeva vā |	anugamya icchayā pretam jñātim ajñātim eva vā 
MBaasaucadiipikaaHK-1179	snātvā sacelaṃ spṛṣṭvāgniṃ ghṛtaṃ prāśyaviśudhyatīti |	snātvā sa celam spṛṣṭvā agnim ghṛtam prāśya viśudhyati iti 
MBaasaucadiipikaaHK-1180	viprasya śūdrānugamanetryahaṃ vaiśyabhūpayo pretānugamanedvyahaṃ	viprasya śūdra anugamane tri aham preta anugamane dvi aham 
MBaasaucadiipikaaHK-1181	teṣāmadhikasahasragāyatrījapa nadīsnānābhyāṃ śuddhiḥ |	teṣām adhika sahasra gāyatrī japa nadī snānābhyām śuddhiḥ 
MBaasaucadiipikaaHK-1182	sadrasyadvijādi pretānugamane snānena śuddhiḥ |	sat rasya dvija ādi preta anugamane snānena śuddhiḥ 
MBaasaucadiipikaaHK-1183	vaiśyanṛpayorvāgre pretānugamane	vaiśya nṛpayoḥ vā agre preta anugamane 
MBaasaucadiipikaaHK-1184	snānāgnisparśanajyāpānaiśśuddhiḥ | brāhmaṇasya vaiśyabhūpa	snāna agni sparśana jyā apānaiḥ śuddhiḥ brāhmaṇasya vaiśya bhūpa 
MBaasaucadiipikaaHK-1185	pretānugamane krameṇa pakṣisaharaṣṭottaraśata gāyatrī	preta anugamane krameṇa gāyatrī 
MBaasaucadiipikaaHK-1186	japasnānābhyāṃ śuddhiḥ | śūdrasya śūdrapretānugamane	japa snānābhyām śuddhiḥ śūdrasya śūdra preta anugamane 
MBaasaucadiipikaaHK-1187	śavasparśane ca dinamanyathaikakālaḥ | uktaṃ saṃgrahe -	śava sparśane ca dinam anyathā eka kālaḥ uktam saṃgrahe 
MBaasaucadiipikaaHK-1188	snānāgni sparśanajyāśa punasnānasusaṃyamaiḥ |	snāna agni punar snāna susaṃyamaiḥ 
MBaasaucadiipikaaHK-1189	dvijātayoviśudhyanti sajatīya śavānugāḥ ||	dvijātayaḥ viśudhyanti śava anugāḥ 
MBaasaucadiipikaaHK-1190	tryahaṃ śūdrānuge vipredvayahaṃ viṭbhūpayostataḥ | nadī	tri aham śūdra anuge vipre dvi aham viṣ bhūpayoḥ tatas nadī 
MBaasaucadiipikaaHK-1191	snānañcagāyatryā sahasraṃ sāṣṭakaṃ japaḥ ||	snānam ca gāyatryā sahasram sa aṣṭakam japaḥ 
MBaasaucadiipikaaHK-1192	dvijapretān śūdraśśudhyet snānena vaṇik nṛpau |	dvija pretān śūdraḥ śudhyet snānena vaṇij nṛpau 
MBaasaucadiipikaaHK-1193	svāgrapretānugausnānavahnisparśajyāpānata iti ||	sva agra preta anugau snāna vahni sparśa jyā apānataḥ iti 
MBaasaucadiipikaaHK-1194	brāhmaṇasyaviṭ bhūpapretānugamane sati pakṣiṇyaharnadīsnānaṃ	brāhmaṇasya viś bhūpa preta anugamane sati pakṣiṇī ahar nadī snānam 
MBaasaucadiipikaaHK-1195	gāyatryaṣṭaśataṃ japaḥ | śūdrapretānuge rudre śavasparśā	gāyatrī aṣṭaśatam japaḥ śūdra preta anuge rudre śava sparśā 
MBaasaucadiipikaaHK-1196	haranyathā ekakāla iti | prāyaścittasamuccaye tu viprasya kṣatriyā	eka kāle iti prāyaścitta samuccaye tu viprasya kṣatriyā 
MBaasaucadiipikaaHK-1197	yanugamane ekadvitridināni |	eka dvi tri dināni 
MBaasaucadiipikaaHK-1198	p. 379)	p 
MBaasaucadiipikaaHK-1199	kṣatriyavaiśyayośśūdra śavagamane dinapakṣiṇāvityuktam | yathā	kṣatriya vaiśyayoḥ śūdra śava gamane dina pakṣiṇau iti uktam yathā 
MBaasaucadiipikaaHK-1200	kṣatrādīnāmanugamekadvitrirātrairviśudhyati | kṣatriya vaiśyau	kṣatra ādīnām anugam eka dvi tri rātraiḥ viśudhyati kṣatriya vaiśyau 
MBaasaucadiipikaaHK-1201	śūdraśavaṃ gatvāhaḥ pakṣiṇī manuriti ||	śūdra śavam gatvā ahar pakṣiṇī manuḥ iti 
MBaasaucadiipikaaHK-1202	nirharaṇañca pretālaṃ karaṇavahana dahanādirūpam | tatra	nirharaṇam ca pretālam karaṇa vahana dahana ādi rūpam tatra 
MBaasaucadiipikaaHK-1203	nirharaṇe kṛte sodakānāṃ tryahāśaucināmapa * śāhaṃ	nirharaṇe kṛte sa udakānām tri aha āśaucinām apa śa aham 
MBaasaucadiipikaaHK-1204	anupanītamṛtau sapiṇḍānāṃ pitryahāśaucināndaśāham |	an upanīta mṛtau sapiṇḍānām pitrya ha āśaucinām daśa aham 
MBaasaucadiipikaaHK-1205	yonibandhūnāṃ pakṣiṇyāśaucināmapi tryaham | vijātīyānāntu	yonibandhūnām pakṣiṇī āśaucinām api tri aham vijātīyānām tu 
MBaasaucadiipikaaHK-1206	śavajātyuktamāśaucaṃ bhavati | uktaṃ saṃgrahe -	śava jāti uktam āśaucam bhavati uktam saṃgrahe 
MBaasaucadiipikaaHK-1207	daśāhaṃ sodakaṃ jñātyostrirātraṃ yoni bandhuṣu |	daśa aham sa udakam jñātyoḥ tri rātram bandhuṣu 
MBaasaucadiipikaaHK-1208	vijātīṣuśavoktaṃsyā pretanirharaṇe kṛta iti ||	preta nirharaṇe kṛte iti 
MBaasaucadiipikaaHK-1209	mṛtasaṃbandharahitasya sajātīyamātrasya pretanirharaṇe kṛte	mṛta saṃbandha rahitasya sajātīya mātrasya preta nirharaṇe kṛte 
MBaasaucadiipikaaHK-1210	ekakālamāśaucaṃ rātrau vā sūryadarśanam | ahanyā nakṣatra	eka kālam āśaucam rātrau vā sūrya darśanam 
MBaasaucadiipikaaHK-1211	darśanam | grāmānbahirvāsañcāgni sparśanam | pañcagavya	darśanam grāmān bahis vāsam ca agni sparśanam 
MBaasaucadiipikaaHK-1212	ghṛtayoranyatara prāśanañca kartavyam | uktaṃ kāmike -	ghṛtayoḥ anyatara prāśanam ca kartavyam uktam kāmike 
MBaasaucadiipikaaHK-1213	pretasparśakṛtoyastu vāhako grāmabāhyataḥ |	preta sparśa kṛta yaḥ tu vāhakaḥ grāma bāhyatas 
MBaasaucadiipikaaHK-1214	nakṣatradarśanādvāpi vaseyussūrya darśanāt ||	nakṣatra darśanāt vā api vaseyuḥ sūrya darśanāt 
MBaasaucadiipikaaHK-1215	spṛṣtvāntegniṃ pibeyuste pañcagavyaṃ dhṛtantu veti |	spṛṣtvā antar agnim pibeyuḥ te pañcagavyam vā iti 
MBaasaucadiipikaaHK-1216	dṛṣṭvārthaṃ pretanirharaṇe sapiṇḍebhyopi dviguṇaṃ	dṛṣṭvā artham preta nirharaṇe sapiṇḍebhyaḥ api dviguṇam 
MBaasaucadiipikaaHK-1217	svajātīyānāṃ bhavati | sajātīyānāntu śavajātyuktamāśaucam |	sva jātīyānām bhavati sajātīyānām tu śava jāti uktam āśaucam 
MBaasaucadiipikaaHK-1218	p. 380)	p 
MBaasaucadiipikaaHK-1219	yathāha gautamaḥ -	yathā āha gautamaḥ 
MBaasaucadiipikaaHK-1220	dṛṣṭvārthaṃ pretanirhāre jñātibhyo dviguṇantvadham |	dṛṣṭvā artham preta nirhāre jñātibhyaḥ 
MBaasaucadiipikaaHK-1221	vijātīnāṃ sajātestu śavajātyuktamiti ||	vijātīnām sajāteḥ tu śava jāti uktam iti 
MBaasaucadiipikaaHK-1222	yatīndraśavanirharaṇe sadyaśśuddhimahāphalā vāptiśca bhavati	yati indra śava nirharaṇe sadyas śuddhi mahā phalā vāptiḥ ca bhavati 
MBaasaucadiipikaaHK-1223	taduktaṃ saṃgrahe - yathā -	tat uktam saṃgrahe yathā 
MBaasaucadiipikaaHK-1224	jñānaratnāvalyāmapi -	jñānaratnāvalyām api 
MBaasaucadiipikaaHK-1225	asahāyamanāthañca gatāsuṃ śivayoginam | nītvā saṃskārayedyastu	asahāyam anātham ca gatāsum śiva yoginam nītvā saṃskārayet yaḥ tu 
MBaasaucadiipikaaHK-1226	soniṣṭhaiḥ prayujyate ||	soniṣṭhaiḥ prayujyate 
MBaasaucadiipikaaHK-1227	idaṃ sarvaṃ sāmānyamartyānāṃ bhavati | uktaṃ kāmike -	idam sarvam sāmānya martyānām bhavati uktam kāmike 
MBaasaucadiipikaaHK-1228	idaṃ sāmānya manuṣyāṇāṃ parikīrtitamiti |	idam sāmānya manuṣyāṇām parikīrtitam iti 
MBaasaucadiipikaaHK-1229	śaivānāntu śaivapretasya vahane dahane vā dīkṣitānā maghora	śaivānām tu śaiva pretasya vahane dahane vā dīkṣitānām maghora 
MBaasaucadiipikaaHK-1230	dviguṇaśatajapācchuddhiḥ | prāyaścittasamuccaye -	dviguṇa śata japāt śuddhiḥ prāyaścitta samuccaye 
MBaasaucadiipikaaHK-1231	kuryuste dviguṇaṃ japyaṃ śivapretāya dīkṣitaiḥ |	kuryuḥ te dviguṇam japyam śiva pretāya dīkṣitaiḥ 
MBaasaucadiipikaaHK-1232	skandhoyaiśraddhayā dattaṃ tadvāhakā api ||	dattam tat vāhakāḥ api 
MBaasaucadiipikaaHK-1233	sādhakācāryaputrākāṇāṃ mṛtānāṃ snapanādikarmaṇi kṛte	sādhaka ācārya putrākāṇām mṛtānām snapana ādi karmaṇi kṛte 
MBaasaucadiipikaaHK-1234	snāna saṃhitāśśatajapācchuddhiḥ | uktaṃ brahmaśaṃbhau -	snāna saṃhitāḥ śata japāt śuddhiḥ uktam brahmaśaṃbhau 
MBaasaucadiipikaaHK-1235	sādhakācāryaputrāṇāṃ sapatanādikam | kṛtvā snātvāśataṃ	sādhaka ācārya putrāṇām sa patana ādikam kṛtvā snātvā śatam 
MBaasaucadiipikaaHK-1236	japtvā saṃhitāṃ pūjayecchivam ||	japtvā saṃhitām pūjayet śivam 
MBaasaucadiipikaaHK-1237	p. 381)	p 
MBaasaucadiipikaaHK-1238	anugantṝṇāndīkṣitānāmaghoraśatajapācchuddhiḥ |	anugantṝṇām dīkṣitānām aghora śata japāt śuddhiḥ 
MBaasaucadiipikaaHK-1239	vāhakānāndāhakaṃ nāmantyeṣṭi guruṇāñcāghoraśata	vāhakānām dāhakam 
MBaasaucadiipikaaHK-1240	dvayajapācchuddhiriti - tatraivoktam -	dvaya japāt śuddhiḥ iti tatra eva uktam 
MBaasaucadiipikaaHK-1241	skandhandatvāthavā dāhaṃ kṛtvā snātvāśatadvayam |	dāham kṛtvā snātvā śata dvayam 
MBaasaucadiipikaaHK-1242	japedaghorantathāntyeṣṭiguruṇāmapyanugāśśatam ||	japet aghoram tathā antyeṣṭi guruṇām api anugāḥ śatam 
MBaasaucadiipikaaHK-1243	dīkṣitasya dīkṣitaśavavahane phalamapyuktam - jñānaratnāvalyām	dīkṣitasya dīkṣita śava vahane phalam api uktam jñānaratnāvalyām 
MBaasaucadiipikaaHK-1244	vratasthamavratasthaṃ vā brāhmaṇaṃ śivadīkṣitam | vipannaṃ	vrata stham avrata stham vā brāhmaṇam śiva dīkṣitam vipannam 
MBaasaucadiipikaaHK-1245	yovahettasya nākāle maraṇaṃ bhavet ||	yaḥ vahet tasya na akāle maraṇam bhavet 
MBaasaucadiipikaaHK-1246	atra vā śabdena brāhmaṇopi yojanīyaḥ | tathā ca vratasthasyā	atra vā śabdena brāhmaṇaḥ api yojanīyaḥ tathā ca vratasthasya ā 
MBaasaucadiipikaaHK-1247	vratasthasya vā brāhmaṇasya vaditarasya vā śivadīkṣita mātrasya	vratasthasya vā brāhmaṇasya vaditarasya vā śiva dīkṣita mātrasya 
MBaasaucadiipikaaHK-1248	pretasya vahane akālamaraṇannāstītyarthaḥ | dīkṣārahitahīna va	pretasya vahane akāla maraṇat na asti iti arthaḥ 
MBaasaucadiipikaaHK-1249	śatajapābhyāṃ śuddhiḥ | yathā tatraiva -	śata japābhyām śuddhiḥ yathā tatra eva 
MBaasaucadiipikaaHK-1250	nottamenānugantavyo hīnavarṇo vrato rataḥ | anugamyāṃbhasi	na uttamena anugantavyaḥ hīna varṇaḥ vrataḥ rataḥ anugamya aṃbhasi 
MBaasaucadiipikaaHK-1251	snātvā svajātīśaṃ śataṃ japet ||	snātvā sva jāti īśam śatam japet 
MBaasaucadiipikaaHK-1252	dīkṣārahitānāṃ sapiṇḍānāṃ dīkṣitaśavasparśo na kartavyaḥ	dīkṣā rahitānām sapiṇḍānām dīkṣita śava sparśaḥ na kartavyaḥ 
MBaasaucadiipikaaHK-1253	tatraiva - adīkṣitā ssapiṇḍān na sparśeyuḥ ca dīkṣitāniti |	tatra eva a dīkṣitāḥ ssapiṇḍān na sparśeyuḥ ca dīkṣitān iti 
MBaasaucadiipikaaHK-1254	dīkṣitānāmadīkṣita śavasparśanāt snānaṃ grāmāt	dīkṣitānām a dīkṣita śava sparśanāt snānam grāmāt 
MBaasaucadiipikaaHK-1255	bahirātriḥśanakṣatra darśanaṃ vāsaḥ | agnisparśa	bahis rātriḥśa nakṣatra darśanam vāsaḥ agni sparśa 
MBaasaucadiipikaaHK-1256	ghṛtaprāśana saṃhitāśatadvaya japataddinopavāsāśca kartavyam |	kartavyam 
MBaasaucadiipikaaHK-1257	yathā tatraiva -	yathā tatra eva 
MBaasaucadiipikaaHK-1258	p. 382)	p 
MBaasaucadiipikaaHK-1259	dīkṣitodīkṣitaśavaṃ sparśanādikaroti yaḥ | sa snātvā	dīkṣita udīkṣita śavam sparśana ādi karoti yaḥ sa snātvā 
MBaasaucadiipikaaHK-1260	bāhyetat grāmādyāvannakṣatra darśanam ||	bāhya etat grāma āt yāvat nakṣatra darśanam 
MBaasaucadiipikaaHK-1261	uṣitvā spṛśetprāśya ghṛtaṃ snātvātha saṃhitām |	uṣitvā spṛśet prāśya ghṛtam snātvā atha saṃhitām 
MBaasaucadiipikaaHK-1262	japechatadvayantatra samayī sopavāsakamiti ||	japet śata dvayam tatra samayī sa upavāsakam iti 
MBaasaucadiipikaaHK-1263	sasnehamanuṣa * sthisparśe aghoraśatañjapet |	sa sneha manuṣaḥ sthi sparśe aghora śatam japet 
MBaasaucadiipikaaHK-1264	nisnehasparśe snānādityadarśanapūrvakācamanaṃ vā kartavyam |	nisneha sparśe snāna āditya darśana pūrvaka ācamanam vā kartavyam 
MBaasaucadiipikaaHK-1265	yathā tatraiva -	yathā tatra eva 
MBaasaucadiipikaaHK-1266	nāraṃ spṛṣṭvā sthirasneha snissnehaṃ snātvāghoraṃ śatañjapet	nāram spṛṣṭvā sthira sneha snis sneham snātvā aghoram śatañjapet 
MBaasaucadiipikaaHK-1267	| asnehasparśane snāyāt arkaṃ vācamyadarśayet | rodo nāma	a sneha sparśane snāyāt arkam vā ācamya darśayet rodaḥ nāma 
MBaasaucadiipikaaHK-1268	āturavyañjanam | * * sya śa * va sparśa * * tarodedinantadrahite tu	ātura vyañjanam     sya śa va sparśa    taras de dinan tad rahite tu 
MBaasaucadiipikaaHK-1269	asthi sañcayanātpūrvamekakālaḥ tadūrdhvaṃ snānameva -	asthi sañcayanāt pūrvam ekakālaḥ tad ūrdhvam snānam eva 
MBaasaucadiipikaaHK-1270	nṛpavaiśyayostu svavarṇarode sañcayanāt prāk sacelasnānam |	nṛpa vaiśyayoḥ tu sva varṇa rode sañcayanāt prāk sa cela snānam 
MBaasaucadiipikaaHK-1271	tadūrdhvaṃ snānamātram | brāhmaṇasya tu | svavarṇarodane	tad ūrdhvam snāna mātram brāhmaṇasya tu sva varṇa rodane 
MBaasaucadiipikaaHK-1272	sañcayanāt prāk snānam | tadūrdhva mācamanam | utkṛṣṭasya	sañcayanāt prāk snānam tad ūrdhvam mā ācamanam utkṛṣṭasya 
MBaasaucadiipikaaHK-1273	nikṛṣṭarode sañcayanātprākdinaṃ tadūrdhvaṃ snānam |	nikṛṣṭa rode sañcayanāt prāk dinam tad ūrdhvam snānam 
MBaasaucadiipikaaHK-1274	nṛpavaiśyayośśūdrarode sañcayanātprākdvayaham | tadūrdhvadinam	nṛpa vaiśyayoḥ śūdra rode sañcayanāt prāk dvayaham tad ūrdhva dinam 
MBaasaucadiipikaaHK-1275	| viprasya śūdrarode sañcayanāt prāk tryaham | taūrdhvaṃ dinam |	viprasya śūdra rode sañcayanāt prāk tri aham 
MBaasaucadiipikaaHK-1276	uktaṃ saṃgrahe -	uktam saṃgrahe 
MBaasaucadiipikaaHK-1277	tathā rode snānamevāsthisañcaye snānaṃ svavarṇarodesthināñchite	tathā rode snānam eva asthisañcaye snānam sva varṇa roda isthi nāñchite 
MBaasaucadiipikaaHK-1278	nṛpavaiśyayo ssañcite sacelaṃ tadviprasyācamanāplavau |	nṛpa vaiśyayoḥ sañcite sa celam tad viprasya ācamana āplavau 
MBaasaucadiipikaaHK-1279	p. 383)	p 
MBaasaucadiipikaaHK-1280	nikṛṣṭeṣṭvāplavācāmau varṇāgre tu dināplavau | prāk	nikṛṣṭeṣu tu āplava ācāmau varṇa agre tu dina āplavau prāk 
MBaasaucadiipikaaHK-1281	paścādasthiśayanādātura vyañjanammithaḥ ||	paścāt asthi śayanāt ātura 
MBaasaucadiipikaaHK-1282	akṛtesthicaye śūdrā dāturavyañjane kṛte | dvyahaṃ dvije tryahaṃ	śūdrā dātuḥ a vyañjane kṛte dvi aham dvije tri aham 
MBaasaucadiipikaaHK-1283	vipre dinaṃ sarveṣu sañcita iti ||	vipre dinam sarveṣu sañcitaḥ iti 
MBaasaucadiipikaaHK-1284	atrāturavyañjanaviṣaye viśeṣapratipādakāni kūrmavacanāni	atra ātura vyañjana viṣaye viśeṣa pratipādakāni kūrma vacanāni 
MBaasaucadiipikaaHK-1285	anusandheyāni | yathā -	anusandheyāni yathā 
MBaasaucadiipikaaHK-1286	anasthi sañcite śūdre rauti cedbrāhmaṇasya vai | trirātraṃ	anasthi sañcite śūdre rauti ced brāhmaṇasya vai tri rātram 
MBaasaucadiipikaaHK-1287	syāttathāśaucañcaikāhantvanyathābhavet ||	syāt tathā āśaucam ca eka ahan tu anyathā bhavet 
MBaasaucadiipikaaHK-1288	asthi sañcayanādarvāgekāhaṃ kṣatriya vaiśyayoḥ | anyathā caiva	asthi sañcayanāt arvāk eka aham kṣatriya vaiśyayoḥ anyathā ca eva 
MBaasaucadiipikaaHK-1289	sadyoti brahmaṇa sthānināmeva tu ||	sadyoti brahmaṇaḥ sthāninām eva tu 
MBaasaucadiipikaaHK-1290	anasthi sañcite vipre brāhmaṇe śaiti cettadā | snānenaiva	anasthi sañcite vipre brāhmaṇe śaiti ced tadā snānena eva 
MBaasaucadiipikaaHK-1291	bhavecchuddhissacelena na samśaya || iti	bhavet śuddhiḥ sa celena na samśayaḥ iti 
MBaasaucadiipikaaHK-1292	pretānna bhojanaṃ dvividham - buddhipūrvamabuddhipūrvamiti | tatra	pretāt na bhojanam dvividham buddhi pūrvam abuddhi pūrvam iti tatra 
MBaasaucadiipikaaHK-1293	buddhipūrve tadāśauca nivṛttiparyanta maśuddhistannivṛttau	buddhi pūrve tad āśauca nivṛtti paryantam aśuddhiḥ tad nivṛttau 
MBaasaucadiipikaaHK-1294	snānena śuddhiḥ | durbhikṣādau bhojanadinamāśaucaṃ	snānena śuddhiḥ durbhikṣa ādau bhojana dinam āśaucam 
MBaasaucadiipikaaHK-1295	prāyaścittaṃ ca kartavyam | yathā kūrmapurāṇe -	prāyaścittam ca kartavyam yathā kūrmapurāṇe 
MBaasaucadiipikaaHK-1296	yasteṣāmantramaśnāti sakṛdevāpi kāmataḥ | tadāśauce nivṛtte	yaḥ teṣām antram aśnāti sakṛt eva api kāmataḥ tad āśauce nivṛtte 
MBaasaucadiipikaaHK-1297	tu snānaṃ kṛtvā viśudhyati |	tu snānam kṛtvā viśudhyati 
MBaasaucadiipikaaHK-1298	yāvattadantamaśnāti durbhikṣādityato naraḥ |	yāvat tad antam aśnāti durbhikṣāt iti atas naraḥ 
MBaasaucadiipikaaHK-1299	tāvantyahānyāśaucaṃ prāyaścittaṃ tataścarediti |	tāvanti ahāni āśaucam prāyaścittam tatas caret iti 
MBaasaucadiipikaaHK-1300	p. 384)	p 
MBaasaucadiipikaaHK-1301	abuddhipūrve yāvadbhuktaṃ jīrṇamāśaucam | yathā - saṃgrahe -	a buddhi pūrve yāvat bhuktam jīrṇam āśaucam yathā saṃgrahe 
MBaasaucadiipikaaHK-1302	yāvadbhuktañjīrṇaṃ patatyatha iti | atra prāyaścittantu	yāvat bhuktam jīrṇam patati atha iti atra prāyaścittam tu 
MBaasaucadiipikaaHK-1303	daśavāraṃ gokṣīrapānaṃ cāndrāyaṇañca kartavyam | uktaṃ	daśa vāram go kṣīra pānam cāndrāyaṇam ca kartavyam uktam 
MBaasaucadiipikaaHK-1304	svāyaṃbhuve | śāvāntraṃ sūtakāntañca sīmantānnaṃ tathaiva ca	svāyaṃbhuve śāva antram sūtaka antam ca sīmanta annam tathā eva ca 
MBaasaucadiipikaaHK-1305	gokṣīraṃ daśavāre bhuktvā cāndrāyaṇaṃ carediti | cāndrāyaṇa	go kṣīram daśa vāre bhuktvā cāndrāyaṇam caret iti 
MBaasaucadiipikaaHK-1306	svarūpaṃ kiraṇe draṣṭavyam | kālottare tu prāyaścittamuktam |	svarūpam kiraṇe draṣṭavyam kālottare tu prāyaścittam uktam 
MBaasaucadiipikaaHK-1307	tatrake sūtake vātha bhakṣitaṃ sūtavṛddhike |	tatrake sūtake vā atha bhakṣitam sūta vṛddhike 
MBaasaucadiipikaaHK-1308	kāmato ghoramantrasya sahasraparivartayet |	kāmatas ghora mantrasya sahasra parivartayet 
MBaasaucadiipikaaHK-1309	jñānaratnāvalyāñca - sūtakāṃnādi bhojanānāṃ bahuvidhānāṃ	jñānaratnāvalyām ca sūtaka aṃnādi bhojanānām bahuvidhānām 
MBaasaucadiipikaaHK-1310	prāyaścittamuktaṃ tadyathā -	prāyaścittam uktam tat yathā 
MBaasaucadiipikaaHK-1311	abdamaṃgalake puṃsi sīmantonnayane tathā | prasūti sūtake bhuktvā	abdamaṃgalake puṃsi sīmantonnayane tathā prasūti sūtake bhuktvā 
MBaasaucadiipikaaHK-1312	japedghora sahasrakam ||	japet ghora sahasrakam 
MBaasaucadiipikaaHK-1313	nāmadheye ca niṣkrāme tathānna prāśanematam | caule varate ca	nāmadheye ca niṣkrāme tathā anna prāśanematam caule ca 
MBaasaucadiipikaaHK-1314	godāne vivāhe ca śataṃ japet ||	godāne vivāhe ca śatam japet 
MBaasaucadiipikaaHK-1315	caturthyatānnaṃ bhuktvā taṃ sahasraṃ parivartayet | pākayajñe	caturthyā atā annam bhuktvā tam sahasram parivartayet pākayajñe 
MBaasaucadiipikaaHK-1316	haviryajñe somayāge śatañjapet ||	haviḥ yajñe soma yāge śatam japet 
MBaasaucadiipikaaHK-1317	yaḥ prabandhaṃ prayātasya bhuktvā saṃvatsarāvadhi |	yaḥ prabandham prayātasya bhuktvā saṃvatsara avadhi 
MBaasaucadiipikaaHK-1318	sadyaśśrāddhaṃ samārabhya dakṣiṇasyāyutañjapet ||	sadyas śrāddham samārabhya dakṣiṇasya ayutan japet 
MBaasaucadiipikaaHK-1319	ekoddiṣṭe sapiṇḍe ca sahasrakam |	ekoddiṣṭe sapiṇḍe ca sahasrakam 
MBaasaucadiipikaaHK-1320	p. 385)	p 
MBaasaucadiipikaaHK-1321	yadvā sadyaśśrāddhe yadā bhuṅkte doṣastatra na vidyate |	yat vā sadyaśśrāddhe yadā bhuṅkte doṣaḥ tatra na vidyate 
MBaasaucadiipikaaHK-1322	uktasthāneṣu yo bhuṅkte jīrṇe snātvā puroktavat ||	ukta sthāneṣu yaḥ bhuṅkte jīrṇe snātvā purā ukta vat 
MBaasaucadiipikaaHK-1323	prāyaścittaṃ vidhāyaivaṃ yajedīśaṃ na cānyayeti |	prāyaścittam vidhāya evam yajet īśam na ca anyayā iti 
MBaasaucadiipikaaHK-1324	adhasaṃparko nāma - adhibhissahāsanaṃ sahaśayanaṃ saha paṅkti	adhasaṃparkaḥ nāma adhi bhiḥ saha āsanam saha śayanam saha 
MBaasaucadiipikaaHK-1325	bhojanādayaḥ | tasmin kṛte yāvatsaṃparkadinamāśaucaṃ bhavati |	bhojana ādayaḥ tasmin kṛte yāvat saṃparka dinam āśaucam bhavati 
MBaasaucadiipikaaHK-1326	yathā kūrme -	yathā kūrme 
MBaasaucadiipikaaHK-1327	yastaissahāsanaṃ kuryācchayanādīni caiva hi | bāndhavā bāndhavo	yaḥ taiḥ saha āsanam kuryāt śayana ādīni ca eva hi bāndhavāḥ 
MBaasaucadiipikaaHK-1328	vāpi sadaśāhena śuddhayati ||	vā api sa daśa ahena śuddhayati 
MBaasaucadiipikaaHK-1329	atra daśāhavidhiḥ | daśadina saṃparkaviṣayam | smṛtyantareṣu	atra daśa aha vidhiḥ daśa dina saṃparka viṣayam smṛti antareṣu 
MBaasaucadiipikaaHK-1330	saṃparkadina saṃkhyāśaucyāhnānāduktaṃ saṃgrahe -	saṃparka dina saṃkhyā śaucya ahnānāt uktam saṃgrahe 
MBaasaucadiipikaaHK-1331	adhisaṃparkatośaucaṃ bhavettaddina saṃkhyakamiti | idaṃ	bhavet tad dina saṃkhyakam iti idam 
MBaasaucadiipikaaHK-1332	saṃparkikāśaucaṃ dravyakriyā strīṇānta bhavati | yathā tatraiva	saṃparkika āśaucam bhavati yathā tatra eva 
MBaasaucadiipikaaHK-1333	- na tu dravyakriyāstrīṇāṃ saṃparkikamadhaṃ bhavetiti |	na tu dravya kriyā strīṇām saṃparkikam adham bhava iti 
MBaasaucadiipikaaHK-1334	saṃparkikāśauca vyatiriktāśauce tadāśauci	saṃparkika āśauca vyatirikta āśauce tad āśauci 
MBaasaucadiipikaaHK-1335	dravyasyāśuddhitvāddevapūjādau taddravya saṃbandhe snapanaśānti	dravyasya aśuddhi tvāt deva pūjā ādau tad dravya saṃbandhe snapana śānti 
MBaasaucadiipikaaHK-1336	homādikartavyam | taduktaṃ candrajñāne -	homa ādi kartavyam tat uktam candrajñāne 
MBaasaucadiipikaaHK-1337	āśauca dravya saṃbandhaṃ kārayedyadimantravit | tadastu	āśauca dravya saṃbandham kārayet yadi mantra vid tat astu 
MBaasaucadiipikaaHK-1338	devapūjānāṃ snapanaṃ śāntihomakam ||	deva pūjānām snapanam śānti homakam 
MBaasaucadiipikaaHK-1339	śuddhānnaṃ dāpayetpaścāda * dhānna samanvitam | śaṃkhadhvani	śuddha annam dāpayet paścāt 
MBaasaucadiipikaaHK-1340	samāyuktaṃ vādyaghoṣasamākulamiti ||	samāyuktam vādya ghoṣa samākulam iti 
MBaasaucadiipikaaHK-1341	p. 386)	p 
MBaasaucadiipikaaHK-1342	atra mṛtakāśauce yāvadāśaucadinamaṃgasparśena kartavyaḥ |	atra mṛtaka āśauce yāvat āśauca dinam aṃga sparśena kartavyaḥ 
MBaasaucadiipikaaHK-1343	sūtake ca taddinamanāśaucinavat sparśesnānam |	sūtake ca tad dinam anāśaucina vat sparśe snānam 
MBaasaucadiipikaaHK-1344	anyāśaucinastatparśe kṛcchramanuṣṭheyam | yathā tatraiva -	anya āśaucinaḥ tad parśe kṛcchram anuṣṭheyam yathā tatra eva 
MBaasaucadiipikaaHK-1345	āntaraśaṃkheṃgasparśanaṃtyajet | sūtau caturdinaṃ	āntara śaṃkha iṃga sparśanam tyajet sūtau catur dinam 
MBaasaucadiipikaaHK-1346	sparśanoghasya tu snānākṛṣṇo nyāśaucinaḥ smṛtiḥ |	sparśana oghasya tu snānākṛṣṇaḥ smṛtiḥ 
MBaasaucadiipikaaHK-1347	prāyaścittasamuccayeviśavaspṛgādibhisparśasnānamuktam |	prāyaścittasamuccaye viśava spṛś ādibhiḥ sparśa snānam uktam 
MBaasaucadiipikaaHK-1348	śavaspṛṣṭamṛtanistaṃ śmaśānaṃ pratasūtake | sūtikairdāhakai	śava spṛṣṭa mṛta nistam śmaśānam sūtikaiḥ dāhakaiḥ 
MBaasaucadiipikaaHK-1349	sparśe snānāccaiva viśudhyati ||	sparśe snānāt ca eva viśudhyati 
MBaasaucadiipikaaHK-1350	rajasvalāsparśe snānatrayamuktam | tatraiva -	rajasvalā sparśe snāna trayam uktam tatra eva 
MBaasaucadiipikaaHK-1351	rajasvalāṃgasparśe snānatrayamathā carediti | sūtikāyāstu	rajasvalā aṃga sparśe snāna trayam athā caret iti sūtikāyāḥ tu 
MBaasaucadiipikaaHK-1352	daśāhaparyantandarśanaṃ bhāṣaṇañca niṣiddhaḥ | yathā	daśa aha paryantam darśanam bhāṣaṇam ca niṣiddhaḥ yathā 
MBaasaucadiipikaaHK-1353	samuccaye tatra puṃsave mātu nālokādilakṣaṇamāśauca	samuccaye tatra na āloka ādi lakṣaṇam āśauca 
MBaasaucadiipikaaHK-1354	daśarātraṃ syādanaśikāralakṣaṇaṃ dvāviṃśati | rātraṃ syāt	daśa rātram syāt anaśikāra lakṣaṇam dvāviṃśati rātram syāt 
MBaasaucadiipikaaHK-1355	strī prasūtau daśādhikamiti āmaṃ vinā āśaucisparśa	strī prasūtau daśa adhikam iti āmam vinā āśauci sparśa 
MBaasaucadiipikaaHK-1356	dravyāṇāṃ parityāgaḥ | tatspṛṣṭānnabhājane	dravyāṇām parityāgaḥ tad spṛṣṭa anna bhājane 
MBaasaucadiipikaaHK-1357	kuśodumbarakathipānena śuddhiḥ | uktaṃ smṛtau -	kuśa udumbara kathi pānena śuddhiḥ uktam smṛtau 
MBaasaucadiipikaaHK-1358	dravyāṇāñca saṃsparśe nāmaṃ sarvaṃ samṛtsṛjet | bhuktvā	dravyāṇām ca saṃsparśe nāmam sarvam sa mṛd sṛjet bhuktvā 
MBaasaucadiipikaaHK-1359	praśnyai tayāśaucā keśakīṭaiśca dūṣitaḥ ||	praśnyai tayā āśaucā keśa kīṭaiḥ ca dūṣitaḥ 
MBaasaucadiipikaaHK-1360	kuśodumbara bilvādyaiḥ panasāṃbujapatrakaiḥ |	              
MBaasaucadiipikaaHK-1361	śaṃkhapuṣpasuvarcādi kāthaṃ? pītvāpi śudhyatīti ||	śaṃkha puṣpa suvarca ādi kātham pītvā api śudhyati iti 
MBaasaucadiipikaaHK-1362	p. 387)	p 
MBaasaucadiipikaaHK-1363	janimṛtivihita vapanākaraṇamapi puruṣasya karmānarhatāmatpādayati	vapana akaraṇam api puruṣasya karma anarha tām atpādayati 
MBaasaucadiipikaaHK-1364	| taduktaṃ smṛtau | yasya keśāśśiro jātā daśamehani vāpitāḥ	tat uktam smṛtau yasya keśāḥ śiraḥ jātāḥ daśa mehani vāpitāḥ 
MBaasaucadiipikaaHK-1365	| āśaucaṃ tatra līyeta tasmātkeśāṃstu vāpayediti || janane	āśaucam tatra līyeta tasmāt keśān tu vāpayet iti janane 
MBaasaucadiipikaaHK-1366	daśadinepiturvapanaṃ vihitam | maraṇe tu prathamadine |	daśa dine pituḥ vapanam vihitam maraṇe tu prathama dine 
MBaasaucadiipikaaHK-1367	anubhāvināñaca sarveṣāmapi vapanaṃ vihitam | dasamedine	anubhāvinām aca sarveṣām api vapanam vihitam dasamedine 
MBaasaucadiipikaaHK-1368	viśeṣavapanaṃ vihitam | tattadakaraṇe teṣāmāśaucasyānivṛttiḥ	viśeṣa vapanam vihitam tad tad akaraṇe teṣām āśaucasya anivṛttiḥ 
MBaasaucadiipikaaHK-1369	| vapananiṣedhe teṣānnadoṣaḥ | tara garbhavato vapanaṃ niṣiddham	vapana niṣedhe teṣām anna doṣaḥ tara garbhavataḥ vapanam niṣiddham 
MBaasaucadiipikaaHK-1370	| yathā svāyaṃbhuve |	yathā svāyaṃbhuve 
MBaasaucadiipikaaHK-1371	śvānugamanañcaiva? vapanaṃ sindhusevanam | antarvartau patiḥ	śva anugamanam ca eva vapanam sindhu sevanam antarvartau patiḥ 
MBaasaucadiipikaaHK-1372	kurvannaprajā bhavati dhruvam ||	kurvan aprajāḥ bhavati dhruvam 
MBaasaucadiipikaaHK-1373	smṛtāvapi -	smṛtau api 
MBaasaucadiipikaaHK-1374	kṣauraṃ vānugamanaṃ nakhakṛntanañca śrāddhañca	kṣauram vā anugamanam nakha kṛntanam ca śrāddham ca 
MBaasaucadiipikaaHK-1375	vāstukaraṇantviti | dūrayānam | udvāhamambudhi jalasparśo	vāstukaraṇam tu iti dūra yānam udvāham ambudhi jala sparśaḥ 
MBaasaucadiipikaaHK-1376	payogamāyuḥ kṣayaṃ bhavati garbhakā patīnāmiti | pitṛdīkṣā	payaḥ gam āyuḥ kṣayam bhavati garbhakā patīnām iti pitṛ dīkṣā 
MBaasaucadiipikaaHK-1377	madhye jñatimṛtivapanaṃ na kartavyam | yathā tatraiva -	madhye jñati mṛti vapanam na kartavyam yathā tatra eva 
MBaasaucadiipikaaHK-1378	pitṛ dīkṣāñca kurvīran jātikṣauraṃ na kārayet |	pitṛ dīkṣām ca kurvīran jāti kṣauram na kārayet 
MBaasaucadiipikaaHK-1379	dvayorbhāryayorgarbhiṇyorekasyāḥ puṃsave vapanaṃ na kartavyam |	dvayoḥ bhāryayoḥ garbhiṇyoḥ ekasyāḥ puṃsave vapanam na kartavyam 
MBaasaucadiipikaaHK-1380	yathā tatraiva -	yathā tatra eva 
MBaasaucadiipikaaHK-1381	dvibhāryā garbhiṇī caiva ekabhāryā prasūtikā | vapanaṃ naiva	dvi bhāryā garbhiṇī ca eva eka bhāryā prasūtikā vapanam na eva 
MBaasaucadiipikaaHK-1382	kurvīta nāmakarmāṇi kārayediti ||	kurvīta nāmakarmāṇi kārayet iti 
MBaasaucadiipikaaHK-1383	mātrādimaraṇe garbhavato vā vapanaṃ kartavyam |	mātṛ ādi maraṇe garbhavataḥ vā vapanam kartavyam 
MBaasaucadiipikaaHK-1384	p. 387b)	p 
MBaasaucadiipikaaHK-1385	yathā tatraiva -	yathā tatra eva 
MBaasaucadiipikaaHK-1386	mātā pitṛguruṇāñca mātule pūrvaje bhage | śvasurācārya	mātā pitṛ guruṇām ca mātule pūrvaje bhage śvasuḥ ācārya 
MBaasaucadiipikaaHK-1387	patnīnāṃ garbhavānapi vāpayet ||	patnīnām garbhavān api vāpayet 
MBaasaucadiipikaaHK-1388	mātṛ dīkṣāyāṃ pitṛmaraṇe dahanameva pitṛ dīkṣāyāṃ	mātṛ dīkṣāyām pitṛ maraṇe dahanam eva pitṛ dīkṣāyām 
MBaasaucadiipikaaHK-1389	mātṛmaraṇe dahanaṃ vapanañca bhavati | yathā tatraiva -	mātṛ maraṇe dahanam vapanam ca bhavati yathā tatra eva 
MBaasaucadiipikaaHK-1390	mātustu pūrvaṃ dīkṣāyāṃ pitṝṇāndahanaṃ bhavet | pitustu	mātuḥ tu pūrvam dīkṣāyām pitṝṇām dahanam bhavet pituḥ tu 
MBaasaucadiipikaaHK-1391	pūrva dīkṣāyāṃ dahanaṃ vapanaṃ kramāditi |	dīkṣāyām dahanam vapanam kramāt iti 
MBaasaucadiipikaaHK-1392	rātri dāhe vapanaṃ vihāya piṇḍadānaṃ kṛtvāśvo bhūte vapanaṃ	rātri dāhe vapanam vihāya piṇḍa dānam kṛtvā aśvas bhūte vapanam 
MBaasaucadiipikaaHK-1393	kāryam | tadāha kātyāyanaḥ -	kāryam tat āha kātyāyanaḥ 
MBaasaucadiipikaaHK-1394	rātrau dagdhā tu piṇḍāntaṃ kuryādvapana varjitaḥ | śco bhūte	rātrau dagdhā tu piṇḍa antam kuryāt vapana varjitaḥ ś caḥ bhūte 
MBaasaucadiipikaaHK-1395	vapanaṃ tatra keśamātraṃ vidhīyata iti ||	vapanam tatra keśa mātram vidhīyate iti 
MBaasaucadiipikaaHK-1396	sapiṇḍīkaraṇākaraṇamapi mukhya kartuḥ puruṣasya	sapiṇḍīkaraṇa akaraṇam api mukhya kartuḥ puruṣasya 
MBaasaucadiipikaaHK-1397	karmānarhatāmāpādayati | uktaṃ saṃgrahe -	karma anarha tām āpādayati uktam saṃgrahe 
MBaasaucadiipikaaHK-1398	mukhyakarturadhaṃ tāvadyāvatpreta vimocanamiti | sapiṇḍīkaraṇaṃ	mukhya kartuḥ adhas tāvat yāvat preta vimocanam iti sapiṇḍīkaraṇam 
MBaasaucadiipikaaHK-1399	nāma pretatva vimocanam | pretakarmāmanyatamaṃ karmadahana	nāma preta tva vimocanam 
MBaasaucadiipikaaHK-1400	pāṣaṇasthāpanatoyādāna piṇḍadānaṃ ca śayana	pāṣaṇa sthāpana toya ādāna piṇḍa dānam ca śayana 
MBaasaucadiipikaaHK-1401	nagnapracchādanaikoktā vṛddhabhojananalaśrāddhaikoddiṣṭapañca	nagna pracchādana eka uktā vṛddha bhojana nala śrāddha ekoddiṣṭa pañca 
MBaasaucadiipikaaHK-1402	śrāddhasotakuṃbha śrāddhāni tatpūrvakarmāṇi tatra	śrāddha sotakuṃbha śrāddhāni tad pūrva karmāṇi tatra 
MBaasaucadiipikaaHK-1403	piṇḍīkaraṇaṃ mukhyasyaiva * * * rāṇi tu mukhyasyāpi tatra	piṇḍīkaraṇam mukhyasya eva tu mukhyasya api tatra 
MBaasaucadiipikaaHK-1404	saṃskāra katṝṇāṃ kālādiśodhitānāṃ aliṃga * jātīnāṃ	saṃskāra katṝṇām kāla ādi śodhitānām aliṃga jātīnām 
MBaasaucadiipikaaHK-1405	pūrvasya pūrvasyābhāve varasya varasyamukhyamiti |	pūrvasya pūrvasya abhāve varasya varasya mukhyam iti 
MBaasaucadiipikaaHK-1406	p. 388)	p 
MBaasaucadiipikaaHK-1407	pūrvasya pūrvasyā sannidhau parasya parasya mukhyatvaṃ bhavati |	pūrvasya pūrvasya sannidhau parasya parasya mukhya tvam bhavati 
MBaasaucadiipikaaHK-1408	tatkartṛ saṃgrahaślokaḥ | kriyāputrastritayā	              
MBaasaucadiipikaaHK-1409	dinyodaratadbhrātṛmātṛsnuṣā svasre tajjapiṇḍasāṃbujanani	                                                                                 
MBaasaucadiipikaaHK-1410	sapiṇḍasākhyodakā śiṣyadmukhe varavovara sakhānṛpāveta	sapiṇḍa sākhya udakā śiṣyat mukhe 
MBaasaucadiipikaaHK-1411	janāviṃśatiḥ | pūrvā saṃbhavataḥ paraḥ	janāviṃśatiḥ pūrvā saṃbhavataḥ paraḥ 
MBaasaucadiipikaaHK-1412	parūhapretasyasaṃskāraka iti | atra putra bhrātṛta aputrādinā	iti atra putra bhrātṛtaḥ aputra ādinā 
MBaasaucadiipikaaHK-1413	krameṇa kartṛtvamuktam | tatra mukhyataḥ pañcadhā śuddhaḥ |	krameṇa kartṛ tvam uktam tatra mukhyatas pañcadhā śuddhaḥ 
MBaasaucadiipikaaHK-1414	saṃskārāntā piṇḍadānāntā sañcayanāntā ekoddiṣṭāntā	saṃskāra antā piṇḍa dāna antā sañcayana antā ekoddiṣṭa antā 
MBaasaucadiipikaaHK-1415	sapiṇḍīkaraṇāntā ceti | cauātpūrvaṃ saṃskārāntāttatra	sapiṇḍīkaraṇa antā ca iti cauāt pūrvam saṃskāra antāt tatra 
MBaasaucadiipikaaHK-1416	khananasyaiva saṃskāra tayātoyadānāyovyāt - uktaṃ smṛtau -	khananasya eva saṃskāra uktam smṛtau 
MBaasaucadiipikaaHK-1417	dāhantye vodakaṃ piṇḍamiti | tataḥ paramābdikaṃ	dāha antye vā udakam piṇḍam iti tatas parama ābdikam 
MBaasaucadiipikaaHK-1418	piṇḍadānāntanda dūrdhvamaṣṭamābdāt sañcayanāntā	dūrdhvam aṣṭama abdāt sañcayana antā 
MBaasaucadiipikaaHK-1419	ekoddiṣṭāntā tadūrdhvaṃ sapiṇḍīkaraṇaṃ bhavati | amukhya	ekoddiṣṭa antā tad ūrdhvam sapiṇḍīkaraṇam bhavati a mukhya 
MBaasaucadiipikaaHK-1420	kartṛstu catasra evaśuddhayaḥ tasya sapiṇḍīkaraṇāyogyāt	kartṛḥ tu catasraḥ eva śuddhayaḥ tasya sapiṇḍīkaraṇa ayogyāt 
MBaasaucadiipikaaHK-1421	maraṇopi ekoddiṣṭānta eva śuddheḥ | uktaṃ saṃgrahe -	ekoddiṣṭa ante eva śuddheḥ uktam saṃgrahe 
MBaasaucadiipikaaHK-1422	ekoddiṣṭānta evāsau saṃskṛtāśucitāmiyāditi | atra samānya	ekoddiṣṭa ante eva asau saṃskṛta aśuci tām iyāt iti atra samānya 
MBaasaucadiipikaaHK-1423	martyānāṃ nirūpaṇaṃ toyapiṇḍadāna śrāddhādi nirupaṇañca	martyānām nirūpaṇam toya piṇḍa dāna śrāddha ādi nirupaṇañca 
MBaasaucadiipikaaHK-1424	smṛtiṣu bahuśaḥ prapañcitaṃ neha pratanyate | śaivānāntu	smṛtiṣu bahuśas prapañcitam na iha pratanyate śaivānām tu 
MBaasaucadiipikaaHK-1425	samayiputrakācāryāṇāmanyatra smaraṇe sthitasya saṃbhāvita samaya	samayi putraka ācāryāṇām anyatra smaraṇe sthitasya saṃbhāvita samaya 
MBaasaucadiipikaaHK-1426	dharmādhyayana nirharaṇa dvārā śivī	dharmādhyayana nirharaṇa dvārā śivī 
MBaasaucadiipikaaHK-1427	bhāvātarthamantyeṣṭirguruṇāṃ kartavyā |	bhāvāt artham antyā iṣṭiḥ guruṇām kartavyā 
MBaasaucadiipikaaHK-1428	p. 389)	p 
MBaasaucadiipikaaHK-1429	tataśśvivībhūta mṛtadehasya śivāgninā saṃyojana saṃskāraḥ |	tatas śvivībhūta mṛta dehasya śiva agninā saṃyojana saṃskāraḥ 
MBaasaucadiipikaaHK-1430	kartavyaḥ | tatastasminneva dine krameṇa naṇnapracchādanaṃ	kartavyaḥ tatas tasmin eva dine krameṇa naṇna pracchādanam 
MBaasaucadiipikaaHK-1431	vapanandvāra vāmapārśvesāramaśaśava pīṭhikānyatara	pīṭhikā anyatara 
MBaasaucadiipikaaHK-1432	kūrcasthāpanaṃ samayiputrakaraṇe skandanāmapūrvakaṃ skanda * * *	kūrca sthāpanam samayi putra karaṇe skanda nāma pūrvakam skanda 
MBaasaucadiipikaaHK-1433	n prati pṛthak pṛthak tarpaṇatrayaṃ sādhakācārya mṛtāyīśa	prati pṛthak pṛthak tarpaṇa trayam sādhaka ācārya 
MBaasaucadiipikaaHK-1434	sadāśiva śāntān prati pṛthak pṛthak tarpaṇatrayaṃ	               
MBaasaucadiipikaaHK-1435	mṛtanānnaika piṇḍa dānasnānaṃ tarpaṇasaṃkhyayā	dāna snānam tarpaṇa saṃkhyayā 
MBaasaucadiipikaaHK-1436	vṛddhibhojanañca kartavyāni | dvitīyādi	vṛddhi bhojanañca kartavyāni dvitīya ādi 
MBaasaucadiipikaaHK-1437	dineṣvapidhāyadāśaimekottara vṛddhitarpaṇa * * ka * piṇḍadāna	vṛddhi tarpaṇa 
MBaasaucadiipikaaHK-1438	tarpaṇasaṃkhyā vṛddhibhojanāni kartavyāni |	tarpaṇa saṃkhyā vṛddhi bhojanāni kartavyāni 
MBaasaucadiipikaaHK-1439	caturthapañcamanavameṣu	caturtha pañcama navameṣu 
MBaasaucadiipikaaHK-1440	vṛddhibhojanāntenavaśrāddhamekamekādarśadine navaśrāddhamekam |	vṛddhi bhojana ante navaśrāddham ekam eka ādarśa dine navaśrāddham ekam 
MBaasaucadiipikaaHK-1441	prathama tṛtīya pañcama sapta navamānā manyataradine	prathama tṛtīya pañcama sapta navamānām anyatara dine 
MBaasaucadiipikaaHK-1442	asthisañcayana māśaucāntyadine pāṣāṇa sthāpana vī * * *	asthisañcayana mā āśauca antya dine 
MBaasaucadiipikaaHK-1443	rādvāsanaṃ kartavyam | āśaucānantaradine mahadekoddiṣṭa	rāt vāsanam kartavyam āśauca anantara dine 
MBaasaucadiipikaaHK-1444	pañcadaśaikoddiṣṭāni kartavyāni | ekoddiṣṭānantaradine	pañcadaśa ekoddiṣṭāni kartavyāni ekoddiṣṭa anantara dine 
MBaasaucadiipikaaHK-1445	samayiputraka mṛtānāṃ skandacaṇḍa gaṇeśa saṃyojanātmakaṃ	samayi putraka mṛtānām skanda caṇḍa gaṇeśa saṃyojana ātmakam 
MBaasaucadiipikaaHK-1446	sādhakācāryāṇāmīśa sadāśivaśānta saṃyojanātmakaṃ	sādhaka ācāryāṇām īśa sadāśiva śānta saṃyojana ātmakam 
MBaasaucadiipikaaHK-1447	sapiṇḍīkaraṇaṃ kartavyam | anena sapiṇḍīkaraṇena	sapiṇḍīkaraṇam kartavyam anena sapiṇḍīkaraṇena 
MBaasaucadiipikaaHK-1448	nirastādhasaṃbandherabdaparyantaṃ sodakuṃbhaśrāddha	nirasta adha saṃbandheḥ abda paryantam sa udakuṃbha śrāddha 
MBaasaucadiipikaaHK-1449	pañcadaśamāsikābdikāni aṣṭakādīni śiva śrāddhāni ca	pañcadaśa māsika ābdikāni aṣṭaka ādīni śiva śrāddhāni ca 
MBaasaucadiipikaaHK-1450	sarvāṇi kartavyāni |	sarvāṇi kartavyāni 
MBaasaucadiipikaaHK-1451	p. 390)	p 
MBaasaucadiipikaaHK-1452	caturtha pañcamanavameṣu etatsarvaṃ kāmike prapañcitam | tadyathā	caturtha pañcama navameṣu etat sarvam kāmike prapañcitam tat yathā 
MBaasaucadiipikaaHK-1453	nagnapracchādanandadvyāddīkṣitāya kuḍuṃbine |	nagna pracchāda nanda dvyāt dīkṣitāya kuḍuṃbine 
MBaasaucadiipikaaHK-1454	dāhāntemṛtamuddiśya vastrataṇḍula saṃyutam ||	dāha ante mṛtam uddiśya vastra taṇḍula saṃyutam 
MBaasaucadiipikaaHK-1455	pīṭhapiṭhoktarītyā tu satrimekhalamācaret |	pīṭha piṭha ukta rītyā tu sa tri mekhalam ācaret 
MBaasaucadiipikaaHK-1456	purastāttālamātreṇāvaṭaṃ kuryānnavaṃ guruḥ ||	purastāt tāla mātreṇa avaṭam kuryāt navam guruḥ 
MBaasaucadiipikaaHK-1457	homayāṃbhobhirālipya nyasetpīṭhasya madhyame |	homayā aṃbhobhiḥ ālipya nyaset pīṭhasya madhyame 
MBaasaucadiipikaaHK-1458	kūrcaprādeśamātrantu kevalantvavaṭaṃ hi vā ||	kūrca prādeśa mātram tu kevalam tu avaṭam hi vā 
MBaasaucadiipikaaHK-1459	kṛtveṣṭikāṃ vā pāṣāṇaṃ śarāvevā nidhāya ca | kūrcaṃ	kṛtvā iṣṭikām vā pāṣāṇam śarāvā iva ā nidhāya ca kūrcam 
MBaasaucadiipikaaHK-1460	puroditaṃ kṛtvā tatraitatkarmavānayet |	purā uditam kṛtvā tatra etat karma vānayet 
MBaasaucadiipikaaHK-1461	pratyahaṃ tarpaṇaṃ kāmī īśaskandādi nāmataḥ | pṛthak pṛthak	pratyaham tarpaṇam kāmī īśa skanda ādi nāmataḥ pṛthak pṛthak 
MBaasaucadiipikaaHK-1462	tridhā kāryaṃ tarpaṇaṃ prathamehani ||	tridhā kāryam tarpaṇam prathamehani 
MBaasaucadiipikaaHK-1463	pratyahaṃ vardhayedeka dvādaśāntaṃ pṛthak pṛthak | pañcasaptati	pratyaham vardhayet eka dvādaśa antam pṛthak pṛthak 
MBaasaucadiipikaaHK-1464	saṃkhyāta starpaṇaṃ pratibhojanam ||	saṃkhyātaḥ starpaṇam pratibhojanam 
MBaasaucadiipikaaHK-1465	tarpayedviśataṃ pañcapañca samanvitam | brāhmaṇe daśapiṇḍāstu	tarpayet viśatam pañca pañca samanvitam brāhmaṇe daśa piṇḍāḥ tu 
MBaasaucadiipikaaHK-1466	kṣatriye dvādaśasmṛtāḥ ||	kṣatriye dvādaśa smṛtāḥ 
MBaasaucadiipikaaHK-1467	vaiśye pañcadaśaproktāśśūdre triṃśatprakīrtitāḥ | āśaucaṃ	vaiśye pañcadaśa proktāḥ śūdre triṃśat prakīrtitāḥ āśaucam 
MBaasaucadiipikaaHK-1468	yāvadeteṣāṃ tāvatpiṇḍodakakriyā ||	yāvat eteṣām tāvat piṇḍa udaka kriyā 
MBaasaucadiipikaaHK-1469	etatsarvañca tannāmnā svadhāktena dadātviti | caturthe pañcame	etat sarvam ca tad nāmnā svadhā aktena dadātu iti caturthe pañcame 
MBaasaucadiipikaaHK-1470	vāhninavāhaikādaśāhayoḥ ||	vā ahni nava aha ekādaśa ahayoḥ 
MBaasaucadiipikaaHK-1471	p. 391)	p 
MBaasaucadiipikaaHK-1472	mṛtamuddiśya yaddānantavaśrāddhamiti smṛtam | nava śrāddhañca	mṛtam uddiśya yat dānantavaśrāddham iti smṛtam nava śrāddham ca 
MBaasaucadiipikaaHK-1473	mantrantu piṇḍodakavivarjitam ||	piṇḍa udaka vivarjitam 
MBaasaucadiipikaaHK-1474	anudakamadhūpañca gandhamālyavivarjitam | ekatripañca saptāhe nava	anudaka madhu pañca gandha mālya vivarjitam eka tri pañca sapta ahe nava 
MBaasaucadiipikaaHK-1475	bhāṇḍe tu mṛṇmaye ||	bhāṇḍe tu mṛṇmaye 
MBaasaucadiipikaaHK-1476	asthi saṃgrahaṇaṃ viprapramukhāṇāṃ krameṇa vā |	asthi saṃgrahaṇam vipra pramukhāṇām krameṇa vā 
MBaasaucadiipikaaHK-1477	tṛtīyetyathavādehī kuryātsañcayanantataḥ ||	tṛtīyā iti athavā adehī kuryāt sañcayanam tatas 
MBaasaucadiipikaaHK-1478	mṛtamudvāsya tatsthānāt piṇḍaṃ puṣpasamanvitam | tatkūrca	mṛtam udvāsya tad sthānāt piṇḍam puṣpa samanvitam tat kūrca 
MBaasaucadiipikaaHK-1479	miṣṭikāyuktaṃ pāṣāṇaṃ pītikāñca vā ||	miṣṭikā yuktam pāṣāṇam vā 
MBaasaucadiipikaaHK-1480	ātodya sahitañcaiva nikṣipettīrthamadhyame | āśaṃ * kte	ātodya sahitam ca eva nikṣipet tīrtha madhyame āśam kte 
MBaasaucadiipikaaHK-1481	prakartavyamekoddiṣṭa mathadvijāḥ ||	prakartavyam ekoddiṣṭa matha dvijāḥ 
MBaasaucadiipikaaHK-1482	ekādaśe tripakṣevā tathā ca pratimāsakam | saṃvatsarānte tu	ekādaśe tri pakṣa iva tathā ca pratimāsakam saṃvatsara ante tu 
MBaasaucadiipikaaHK-1483	ṣāṇmāse sāṃvatsarika saṃyutam ||	ṣāṇmāse sāṃvatsarika saṃyutam 
MBaasaucadiipikaaHK-1484	ṣodaśaśrāddhamityuktaṃ dānameteṣu yatkṛtam | ekoddiṣṭa	ṣodaśaśrāddham iti uktam dānam eteṣu yat kṛtam ekoddiṣṭa 
MBaasaucadiipikaaHK-1485	dvitīyāhe sapiṇḍī karaṇa kriyām ||	dvitīyāhe sapiṇḍī karaṇa kriyām 
MBaasaucadiipikaaHK-1486	ardhyātsapiṇḍīkaraṇaṃ yasya saṃvatsarādbhavet | tasyāpyannaṃ	ardhyāt sapiṇḍīkaraṇam yasya saṃvatsarāt bhavet tasya api annam 
MBaasaucadiipikaaHK-1487	sodakumbhaṃ kuryāt saṃvatsarāviti ||	sa udakumbham kuryāt saṃvatsarau iti 
MBaasaucadiipikaaHK-1488	punardahanādau tridinena piṇḍasamāpane prathamadinetvekapiṇḍaḥ |	punar dahana ādau tri dinena piṇḍa samāpane prathama dine tu eka piṇḍaḥ 
MBaasaucadiipikaaHK-1489	dvitīye catvāraḥ tṛtīye pañcadeyam | uktaṃ kāmike -	dvitīye catvāraḥ tṛtīye pañca deyam uktam kāmike 
MBaasaucadiipikaaHK-1490	prathametvekapiṇḍastu dvitīye catvārastathā | tṛtīye pañcavai	prathame tu eka piṇḍaḥ tu dvitīye catvāraḥ tathā tṛtīye pañca vai 
MBaasaucadiipikaaHK-1491	dadyāttridinādamato vidhiḥ ||	dadyāt tri dināt amataḥ vidhiḥ 
MBaasaucadiipikaaHK-1492	p. 392)	p 
MBaasaucadiipikaaHK-1493	iti daśāha madhye daśaṃkrāmantyoranyatarapāne	iti daśa aha madhye daśaṃkrāmantyoḥ anyatara pāne 
MBaasaucadiipikaaHK-1494	aurasaputravyatiriktānāṃ sarveṣāṃ sapiṇḍānāṃ tatraiva	aurasa putra vyatiriktānām sarveṣām sapiṇḍānām tatra eva 
MBaasaucadiipikaaHK-1495	piṇḍasamāpanaṃ kāryam | tathā smṛtiḥ -	piṇḍa samāpanam kāryam tathā smṛtiḥ 
MBaasaucadiipikaaHK-1496	daśāhamadhye saṃkrānti darśo vātha bhavedyadi | toyaṃ piṇḍaṃ	daśa aha madhye saṃkrānti darśaḥ vā atha bhavet yadi toyam piṇḍam 
MBaasaucadiipikaaHK-1497	samāpyeta taddinetvarasetaraḥ ||	          
MBaasaucadiipikaaHK-1498	atratilodakadānantu caturṇāmapi varāṇāṃ yāvadāśaucaṃ	atra tila udaka dānam tu caturṇām api varāṇām yāvadāśaucam 
MBaasaucadiipikaaHK-1499	pratidinaṃ ekaṃ vā trayaṃ vā pratidinamañjali vṛdhyā vā	pratidinam ekam vā trayam vā pratidinam añjali vṛdhyā vā 
MBaasaucadiipikaaHK-1500	kartavyam | kālottare tu - udakadānamuktam yathā -	kartavyam kālottare tu udaka dānam uktam yathā 
MBaasaucadiipikaaHK-1501	jale piṇḍaṃ vinikṣipya vahnau vā tadbhāvataḥ | bhūmautilodakaṃ	jale piṇḍam vinikṣipya vahnau vā tad bhāvataḥ bhūmau tilodakam 
MBaasaucadiipikaaHK-1502	datvā hṛnnāmnā svadhāya saheti ||	da tvā hṛd nāmnā svadhāya saha iti 
MBaasaucadiipikaaHK-1503	mṛtanāmnāṃ hṛdayena svadhā ityarthaḥ |	mṛta nāmnām hṛdayena svadhā iti arthaḥ 
MBaasaucadiipikaaHK-1504	suprabhede ca -	suprabhede ca 
MBaasaucadiipikaaHK-1505	tīrthaṃ gatvā yathānyāyaṃ snānaṃ kṛtvā sapiṇḍakaiḥ |	tīrtham gatvā yathānyāyam snānam kṛtvā sapiṇḍakaiḥ 
MBaasaucadiipikaaHK-1506	tilodakantu dātavyaṃ tasyāntannāma pūrvakamiti ||	tila udakam tu dātavyam tasya antar nāma pūrvakam iti 
MBaasaucadiipikaaHK-1507	kāmike tu kvacittarpaṇāyamuktam -	kāmike tu kvacid tarpaṇāyam uktam 
MBaasaucadiipikaaHK-1508	tato jalāśayaṃ gatvā snātvā satprastīrya satkuśani	tatas jalāśayam gatvā snātvā sat prastīrya sat kuśani 
MBaasaucadiipikaaHK-1509	tadūrdhvamapasavyena praṇavaṃ hṛdayaṃ purā - śuddhāti veśā	tad ūrdhvam apasavyena praṇavam hṛdayam purā śuddhā ati veśā 
MBaasaucadiipikaaHK-1510	dīśāntaparyantanāmayuk | skandapūrṇo gaṇeśāntanāmavākbhava	                    bhava 
MBaasaucadiipikaaHK-1511	paścimam | uktvāthauhaṃ mantrī trisvadhāntaṃ tarpayetpunariti |	paścimam 
MBaasaucadiipikaaHK-1512	p. 393)	p 
MBaasaucadiipikaaHK-1513	kvacidaikeka vṛddhayā tilodakadānamuktam | tatpūrvameva pradarśitam	kvacid aikeka vṛddhayā tila udaka dānam uktam tat pūrvam eva pradarśitam 
MBaasaucadiipikaaHK-1514	| adhanirṇayepi pakṣatrayamupanyastam | yacca yadāśauca pratidina	pakṣa trayam upanyastam 
MBaasaucadiipikaaHK-1515	pratidinamekamiti | kvacitpratidinaṃ trayamityapare | añjali	pratidinam ekam iti kvacid pratidinam trayam iti apare añjali 
MBaasaucadiipikaaHK-1516	vṛddhayetyanya iti | etatsarvaṃ pretakarma pitṛnyamṛtau	vṛddhayā iti anye iti etat sarvam preta karma pitṛni amṛtau 
MBaasaucadiipikaaHK-1517	brahmacāriṇā na kartavyam | tat karaṇe punarupanayanādikaṃ bhavati	brahmacāriṇā na kartavyam tat karaṇe punar upanayana ādikam bhavati 
MBaasaucadiipikaaHK-1518	| yathā smṛtiḥ -	yathā smṛtiḥ 
MBaasaucadiipikaaHK-1519	dahanādi sapiṇḍāntaṃ brahmacāri karoti ceti | anyatra mātāpitro	dahana ādi sapiṇḍa antam brahmacāri karoti ca iti anyatra mātā pitroḥ 
MBaasaucadiipikaaHK-1520	syātpunarupanīya pratītiriti | asyāṃ tu daiva kriyā	syāt punar upanīya pratītiḥ iti asyām tu daiva kriyā 
MBaasaucadiipikaaHK-1521	dīkṣitānāmeva putrādīnāṃ mukhya - (kartṛtayāśū	dīkṣitānām eva putra ādīnām mukhya 
MBaasaucadiipikaaHK-1522	mantroguruṇā pitṛṇāthavā | sutena vātha patnyāvā kāryo nā	mantraḥ guruṇā pitṛṇā athavā sutena vā atha patnyā vā kāryaḥ nā 
MBaasaucadiipikaaHK-1523	dīkṣitaiḥ) kartṛtvamuktam kāmike -	dīkṣitaiḥ kartṛ tvam uktam kāmike 
MBaasaucadiipikaaHK-1524	pretasya tu putrai śrāddhaṃ deyaṃ hi dīkṣitaiḥ | jñāti	pretasya tu putraiḥ śrāddham deyam hi dīkṣitaiḥ jñāti 
MBaasaucadiipikaaHK-1525	bandhusuhṛcchiṣyai bhṛtyācāryaiśca dīkṣitaiḥ |	bandhu suhṛd śiṣyaiḥ bhṛtya ācāryaiḥ ca dīkṣitaiḥ 
MBaasaucadiipikaaHK-1526	putrābhāve tu patnī syāt patnyābhāve tu sodaraḥ |	putra abhāve tu patnī syāt patnyā abhāve tu sodaraḥ 
MBaasaucadiipikaaHK-1527	kālottarepi -	kāla uttare pi 
MBaasaucadiipikaaHK-1528	saṃskāro hyakhiloditayā śramantro guruṇāpitṛṇāthava sutena	saṃskāraḥ hi akhila uditayā sutena 
MBaasaucadiipikaaHK-1529	vātha patnyā vā kāryo nā dīkṣitaiḥ kvaciditi |	vā atha patnyā vā kāryaḥ nā dīkṣitaiḥ kvacid iti 
MBaasaucadiipikaaHK-1530	dīkṣayāśravaṇe yogyādikṣayā pūjane kṣamaḥ | dīkṣayāśrama	dīkṣayā āśravaṇe yogya ādikṣayā pūjane kṣamaḥ 
MBaasaucadiipikaaHK-1531	dharmāstu labhate tu yathārhataḥ ||	dharmāḥ tu labhate tu yathārhataḥ 
MBaasaucadiipikaaHK-1532	dīkṣayā prāpyate jñānandīkṣayā siddibhāk bhavet |	dīkṣayā prāpyate bhavet 
MBaasaucadiipikaaHK-1533	śivadīkṣā viśuddhātmā sa tatraivādhikārataḥ ||	śiva dīkṣāḥ viśuddha ātmā sa tatra eva adhikārataḥ 
MBaasaucadiipikaaHK-1534	p. 394)	p 
MBaasaucadiipikaaHK-1535	idamapi |	idam api 
MBaasaucadiipikaaHK-1536	etanmantramayaṃ śrāddhaṃ jñānaṃ dhyānasamanvitam |	etat mantra mayam śrāddham jñānam dhyāna samanvitam 
MBaasaucadiipikaaHK-1537	samayajñādikaiḥ kāryaṃ guruṇāṃmantrasiddhaye ||	sama yajña ādikaiḥ kāryam guruṇām mantra siddhaye 
MBaasaucadiipikaaHK-1538	antyeṣṭikartṛtvañcācāryādīnāṃ bhavati | pūrvapūrvābhāve	antyeṣṭi kartṛ tvam ca ācārya ādīnām bhavati pūrva pūrva abhāve 
MBaasaucadiipikaaHK-1539	parasya parasya uktaṃ kālottare ca |	parasya parasya uktam kāla uttare ca 
MBaasaucadiipikaaHK-1540	ācāryeṇa caturṇāñca sādhakena trayasya tu | dvayostu	ācāryeṇa caturṇām ca sādhakena trayasya tu dvayoḥ tu 
MBaasaucadiipikaaHK-1541	putrakeṇaiva samayajñai svasantateḥ ||	putrakeṇa eva samaya jñaiḥ sva santateḥ 
MBaasaucadiipikaaHK-1542	abhāvādeva sarveṣāṃ samayajñena kārayet | ācāryassādhako vāpi	abhāvāt eva sarveṣām samaya jñena kārayet ācāryaḥ sādhakaḥ vā api 
MBaasaucadiipikaaHK-1543	putrakassamayī ca vā ||	putrakaḥ samayī ca vā 
MBaasaucadiipikaaHK-1544	pratīnāṃ grahaṇaṃ vāpi mṛtaṃ saṃsnāpya bhūṣayet |	pratīnām grahaṇam vā api mṛtam saṃsnāpya bhūṣayet 
MBaasaucadiipikaaHK-1545	dīkṣitānāmeva śivaśrāddhaṃ kartavyaṃ yathā	dīkṣitānām eva śivaśrāddham kartavyam yathā 
MBaasaucadiipikaaHK-1546	jñānaratnāvalyām -	jñānaratnāvalyām 
MBaasaucadiipikaaHK-1547	dīkṣamayamidamidaṃ śrāddhaṃ yathoktaṃ sā gatipradam | kartavyaṃ	dīkṣa mayam idam idam śrāddham yathā uktam sā gati pradam kartavyam 
MBaasaucadiipikaaHK-1548	dīkṣitānāṃ ca aṃgajena tu śāṃkare ||	dīkṣitānām ca aṃga jena tu śāṃkare 
MBaasaucadiipikaaHK-1549	atra dīkṣitānāṃ śaiva śrāddhameva kartavyamāna tu vaidikam |	atra dīkṣitānām tu vaidikam 
MBaasaucadiipikaaHK-1550	(kṛtañcettu śivalokaṃ na gacchati | vīrabhadra saṃhitāyāmapi	kṛtam ced tu śiva lokam na gacchati vīrabhadra saṃhitāyām api 
MBaasaucadiipikaaHK-1551	dīkṣitānāṃ mṛte śaivaśrāddhameva mācaret na vaidikamiti |	dīkṣitānām mṛte śaiva śrāddham eva mā ācaret na vaidikam iti 
MBaasaucadiipikaaHK-1552	mohaśūrottare ca -	moha śūra uttare ca 
MBaasaucadiipikaaHK-1553	dīkṣitānāñca śaivānā śrāddhaṃ syācchaivameva hi |)	dīkṣitānām ca śaivānām śrāddham syāt śaivam eva hi 
MBaasaucadiipikaaHK-1554	uktaṃ kāraṇe -	uktam kāraṇe 
MBaasaucadiipikaaHK-1555	dīkṣitāḥ pañcadīkṣābhireteṣāṃ maraṇaṃ nṛṇām | śaivameva	dīkṣitāḥ pañca dīkṣābhiḥ eteṣām maraṇam nṛṇām śaivam eva 
MBaasaucadiipikaaHK-1556	prakurvīta śrāddhamevaṃ samācaret ||	prakurvīta śrāddham evam samācaret 
MBaasaucadiipikaaHK-1557	p. 395)	p 
MBaasaucadiipikaaHK-1558	atra na vaidikamiti | mohaśūrottare ca -	atra na vaidikam iti mohaśūrottare ca 
MBaasaucadiipikaaHK-1559	dīkṣitānāñca śaivānāṃ śrāddhaṃ syucchaivameva hi | na	dīkṣitānām ca śaivānām śrāddham syuḥ śaivam eva hi na 
MBaasaucadiipikaaHK-1560	vaidikaṃ kṛtañcettu śivalokaṃ na gacchati | vīrabhadra	vaidikam kṛtam ced tu śiva lokam na gacchati vīrabhadra 
MBaasaucadiipikaaHK-1561	saṃhitāyāmapi dīkṣitānāṃ mṛte śaivaṃ śrāddhameva mācaret	saṃhitāyām api dīkṣitānām mṛte śaivam śrāddham eva mā ācaret 
MBaasaucadiipikaaHK-1562	vaidikamiti | kartuśraddhyā vaidika śrāddhakaraṇecchāyāṃ śiva	vaidikam iti kartu śraddhyā vaidika śrāddha karaṇa icchāyām śiva 
MBaasaucadiipikaaHK-1563	śrāddha karaṇānantarameva vaidikaśrāddhaṃ kartavyamiti | yathā	śrāddha karaṇa anantaram eva vaidika śrāddham kartavyam iti yathā 
MBaasaucadiipikaaHK-1564	tatraiva -	tatra eva 
MBaasaucadiipikaaHK-1565	tatkāryañcettathāśaivaṃ vaidikaṃparamato vidhiriti |	tat kāryam ced tathā śaivam vaidikam param atas vidhiḥ iti 
MBaasaucadiipikaaHK-1566	nandīśvarakāmikāyā na tu -	nandīśvarakāmikāyāḥ na tu 
MBaasaucadiipikaaHK-1567	śiva saṃskāra siddhānāntrarāṇāṃ maraṇe sati | pūrvaṃ	śiva saṃskāra siddhānāntrarāṇām maraṇe sati pūrvam 
MBaasaucadiipikaaHK-1568	kuryācchivaśrāddhaṃ parataścāpi vaidikamiti ||	kuryāt śivaśrāddham paratas ca api vaidikam iti 
MBaasaucadiipikaaHK-1569	teṣāmeva śivaśrāddhakaraṇena vaidikaśrāddhamātṛkaraṇa doṣopi	teṣām eva śiva śrāddha karaṇena doṣaḥ api 
MBaasaucadiipikaaHK-1570	bhavati | tatraiva -	bhavati tatra eva 
MBaasaucadiipikaaHK-1571	śivaśrāddhamakṛtvā yo vaidika śrāddhamācaret |	śivaśrāddham a kṛtvā yaḥ śrāddham ācaret 
MBaasaucadiipikaaHK-1572	dīkṣitaścamṛtaśco bhāvetau nirayagāmināviti ||	bhau etau niraya gāminau iti 
MBaasaucadiipikaaHK-1573	nanu śivadharmiṇī saṃskartā śivadharmī vā lokadharmī vā	nanu śiva dharmiṇī saṃskartā śiva dharmī vā loka dharmī vā 
MBaasaucadiipikaaHK-1574	putrako vā samayī vā nādyastasyāśaucā bhāvena piṇḍodakadānā	putrakaḥ vā samayī vā na ādyaḥ tasya āśaucāḥ bhāvena piṇḍa udaka dānā 
MBaasaucadiipikaaHK-1575	ca prasaṃgānnaceṣṭāpattiḥ | tasya loka vyavahārārthaṃ	ca prasaṃgāt na ceṣṭā āpattiḥ tasya loka vyavahāra artham 
MBaasaucadiipikaaHK-1576	piṇḍadānavidhānāt | na dvitīyastasyāpi tridināśauca tathā	piṇḍa dāna vidhānāt na dvitīyaḥ tasya api tri dina āśā ca tathā 
MBaasaucadiipikaaHK-1577	tridinādeva piṇḍamāpana prasaṃgāt na ceṣṭāpattiḥ |	tri dināt eva piṇḍa māpana prasaṃgāt na ca iṣṭa āpattiḥ 
MBaasaucadiipikaaHK-1578	p. 396)	p 
MBaasaucadiipikaaHK-1579	ācāravirodhāt | na tṛtīyastatrā cāravirodhā bhāvepi tasyaiva	ācāra virodhāt na tṛtīyaḥ tatra ācāra virodhāḥ bhāve pi tasya eva 
MBaasaucadiipikaaHK-1580	niyamatayā kartṛtvānupapatteḥ | na ceṣṭāpattiḥ | anyeṣāmapi	niyamatayā kartṛ tva anupapatteḥ na ca iṣṭa āpattiḥ anyeṣām api 
MBaasaucadiipikaaHK-1581	katṛtva darśanāt | na caturthastasyāvāntaraśaiveṣu	katṛ tva darśanāt na caturthaḥ tasya avāntaraśaiveṣu 
MBaasaucadiipikaaHK-1582	pañcaviṃśati dinādhikāśaucatayā piṇḍasamāpanācāra	pañcaviṃśati dina adhika āśauca tayā piṇḍa samāpana ācāra 
MBaasaucadiipikaaHK-1583	virodhāpatteḥ | na ca śivadharmiṇassaṃskartu rāśaucatāvepi	virodha āpatteḥ na ca śiva dharmiṇaḥ saṃskartuḥ 
MBaasaucadiipikaaHK-1584	pitṛmṛtau brahmacarivaddāhāśau cena piṇḍadānaṃ syāditi vācyam	pitṛ mṛtau brahmacari vat dāha āśau piṇḍa dānam syāt iti vācyam 
MBaasaucadiipikaaHK-1585	| snānaikena sadyaśśaucasya snānānantara piṇḍadāna	snāna ekena sadyaśśaucasya snāna anantara 
MBaasaucadiipikaaHK-1586	prayojakatvānupapatteḥ | na ca dāsyāśaucābhāvepi	prayojaka tva anupapatteḥ na ca dāsī āśauca abhāve pi 
MBaasaucadiipikaaHK-1587	brahmacārimṛtau tasya dāhakasya dāhyajātyuktāśaucaddāhya	brahmacāri mṛtau tasya dāhakasya dāhya jāti ukta āśauca ddāhya 
MBaasaucadiipikaaHK-1588	śivadharmi jātyuktāśaucepi piṇḍadānaṃ syāditi vācyam |	śiva dharmi jāti ukta āśauce pi piṇḍa dānam syāt iti vācyam 
MBaasaucadiipikaaHK-1589	avāntaraśaiveṣujātyuktā śaucasyāpi triṃśatpañca viṃśati	avāntara śaiva iṣu jātī uktā śaucasya api triṃśat pañca viṃśati 
MBaasaucadiipikaaHK-1590	pañcatridina rūpatayā vyavasthāpatteḥ | api ca putrakamaraṇe	pañca tri dina rūpa tayā vyavasthā āpatteḥ api ca putraka maraṇe 
MBaasaucadiipikaaHK-1591	śivadharmiṇo lokadharmiṇo vā (dāhāśaucenāśauca vistarasyāditi	śiva dharmiṇaḥ loka dharmiṇaḥ vā dāha āśaucena āśauca vistara syāt iti 
MBaasaucadiipikaaHK-1592	vācyaṃ dāhyā vāntaraśaiveṣu putraka mṛtausamayinaḥ |	vācyam dāhyāḥ vā antara śaiveṣu putraka mṛtau samayinaḥ 
MBaasaucadiipikaaHK-1593	karturadhikāśaucasya dāhāśaucena) saṃskārakatve piṇḍadānā	kartuḥ adhika āśaucasya dāha āśaucena saṃskāraka tve piṇḍa dānā 
MBaasaucadiipikaaHK-1594	bhāñca vāsyātridinapiṇḍasamāpanam | yāvadvyete śivadharmiṇo	vā asya atri dina piṇḍa samāpanam yāvat vyete śiva dharmiṇaḥ 
MBaasaucadiipikaaHK-1595	nāśaucitvāt trikokadharmiṇa stridināśaucatvācca | na ca	na āśauci tvāt trikoka dharmiṇaḥ tri dina āśauca tvāt ca na ca 
MBaasaucadiipikaaHK-1596	saṅkucitāśaucasyāpi sodakasya dāhāśaucena vartayorapi	saṅkucita āśaucasya api sa udakasya dāha āśaucena vartayoḥ api 
MBaasaucadiipikaaHK-1597	putrakavidāhaśaucenāśauca vistarasyāditi vācyam |	putraka vidāha śaucena āśauca vistara syāt iti vācyam 
MBaasaucadiipikaaHK-1598	p. 397)	p 
MBaasaucadiipikaaHK-1599	dāhyāvāntaraśaiveṣu putrakamṛtau samayinaḥ karturadhikāśaucasya	dāhya avāntaraśaiveṣu putraka mṛtau samayinaḥ kartuḥ adhika āśaucasya 
MBaasaucadiipikaaHK-1600	dāhāśaucena saṃkoca prasaṃgāt ataḥ kathamapi * * syeti cet |	dāha āśaucena saṃkoca prasaṃgāt atas katham api 
MBaasaucadiipikaaHK-1601	atrocyate yāvaddahana nimittāśaucame piṇḍadāna prayojakamiti	atra ucyate yāvat dahana nimitta āśaucam e piṇḍa dāna prayojakam iti 
MBaasaucadiipikaaHK-1602	sakalaśāstra siddham | mṛti nimittāśaucodakadānamātra prayojakam	                             
MBaasaucadiipikaaHK-1603	| tathaiva mukhyakartṛvyatiriktānāṃ sapiṇḍānāṃ piṇḍānā	tathā eva mukhya kartṛ vyatiriktānām sapiṇḍānām 
MBaasaucadiipikaaHK-1604	bhāvāt | udakadānamātra * * * nāt utaranimittāṣa	bhāvāt udaka dāna mātra 
MBaasaucadiipikaaHK-1605	kaprayuktāśaucasyakarmaparyu dāsamātra prayojakatvaṃ asya ca	asya ca 
MBaasaucadiipikaaHK-1606	dāhāśaucasya dina saṃkhyayā maraṇāśauca saṃkhya prayojikā	dāha āśaucasya dina saṃkhyayā maraṇāśauca saṃkhya prayojikā 
MBaasaucadiipikaaHK-1607	gurudāhakaniṣṭha maraṇāśaucannatatprayojakam | sodakasya	sa udakasya 
MBaasaucadiipikaaHK-1608	tridināśaucasyāpahat brahmacārī mṛtau dāhakasya	brahmacārī mṛtau dāhakasya 
MBaasaucadiipikaaHK-1609	piturdaśāhāśauce dāhyaniṣṭhantatrāpi tryahapakṣiṇya	pituḥ daśa aha āśauce 
MBaasaucadiipikaaHK-1610	hassadhaśśaucāni saṃbhāvitāni kintu	hassadhas śaucāni saṃbhāvitāni kintu 
MBaasaucadiipikaaHK-1611	jātyuktāśaucantatkvacittadāsyagataṃ prayojakaṃ yathā gṛhasthasya	jāti ukta āśaucam tat kvacid tad āsya gatam prayojakam yathā gṛhasthasya 
MBaasaucadiipikaaHK-1612	piturmṛtau brahmacāriṇo putrasya dāhakasya dāhāśauce	pituḥ mṛtau putrasya dāhakasya dāha āśauce 
MBaasaucadiipikaaHK-1613	pitṛgatamāśaucaṃ kvaciddāhya sajātīya kaniṣṭhajātimupādāya	pitṛ gatam āśaucam kvacid dāhya sajātīya kaniṣṭha jātim upādāya 
MBaasaucadiipikaaHK-1614	vidhānābhāve jātyāśaucaṃ (tvābhāvāt vastuto	vidhāna abhāve jāti āśaucam tu ābhāvāt 
MBaasaucadiipikaaHK-1615	lokadharmiṇassūtakarahitasya sahapākanimittāśaucasya) tacca triṣu	loka dharmiṇaḥ sūtaka rahitasya saha pāka nimitta āśaucasya tat ca triṣu 
MBaasaucadiipikaaHK-1616	varṇeṣu ekarūpantatra vaiṣamya vacanāt mātustriṃśatpañca	varṇeṣu vaiṣamya vacanāt mātuḥ triṃśat pañca 
MBaasaucadiipikaaHK-1617	viṃśati pañcadaśadinarūpeṇa caturvidhantathānyāśauca	viṃśati pañcadaśa dina rūpeṇa 
MBaasaucadiipikaaHK-1618	bhedasyāditi vācyam |	bheda syāt iti vācyam 
MBaasaucadiipikaaHK-1619	p. 398)	p 
MBaasaucadiipikaaHK-1620	lokadharmiṇa stridinā śaucasya jātimupādāya vidhānābhāve	loka dharmiṇaḥ tri dinā śaucasya jātim upādāya vidhāna abhāve 
MBaasaucadiipikaaHK-1621	jātyāśaucatvābhāvāt vastuto lokadharmiṇassūtaka rahitasya	jāti āśauca tva abhāvāt vastutas loka dharmiṇaḥ sūtaka rahitasya 
MBaasaucadiipikaaHK-1622	sahapākanimittāśaucasya jātimupādāya vidhāyā bhāvena	saha pāka nimitta āśaucasya jātim upādāya vidhāyāḥ bhāvena 
MBaasaucadiipikaaHK-1623	jātyāśaucatvābhāvāt vastuto lokadharmiṇassūtakarahitasya	jāti āśauca tva abhāvāt vastutas loka dharmiṇaḥ sūtaka rahitasya 
MBaasaucadiipikaaHK-1624	sahapākanimittāśaucasya saṃparkāśauca tulyatvāt iyāṃstu	saha pāka nimitta āśaucasya saṃparka āśauca tulya tvāt iyān tu 
MBaasaucadiipikaaHK-1625	viśesaḥ saṃparkadinamāśaucaṃ saṃparkanimitte saha pākanimitte	viśesaḥ saṃparka dinam āśaucam saṃparka nimitte saha pāka nimitte 
MBaasaucadiipikaaHK-1626	kartṛdinamiti tatraivāsti | śivadharmimṛtau śivadharmiṇo	kartṛ dinam iti tatra eva asti śiva dharmi mṛtau 
MBaasaucadiipikaaHK-1627	dāhakasya dāhyaśivadharmi sajātīya niṣṭhājātyāśaucenāpiṇḍa	dāhakasya dāhya śiva dharmi sajātīya 
MBaasaucadiipikaaHK-1628	dānamastu | tathā ca kathamācāravirodhaḥ | na cādiśaiva	dānam astu tathā ca katham ācāra virodhaḥ na ca ādiśā eva 
MBaasaucadiipikaaHK-1629	mahāśaivānu śaivānāṃ virodhābhāvepi avāntara śaive	mahāśaiva anu śaivānām virodha abhāve pi avāntara śaive 
MBaasaucadiipikaaHK-1630	jātyānavastheti vācyam | tatrāpi śivadharmiṇassajātīyānāṃ	                                                
MBaasaucadiipikaaHK-1631	kevala samayi putrakāṇāṃ śivāśrama saṃbandhena	kevala samayi putrakāṇām śiva āśrama saṃbandhena 
MBaasaucadiipikaaHK-1632	saṃnikṛstayossamayi putrakayorgṛhītayorapi śivārcana saṃbandhena	saṃnikṛstayoḥ samayi putrakayoḥ gṛhītayoḥ api śiva arcana saṃbandhena 
MBaasaucadiipikaaHK-1633	saṃbandhayitṛgatajātyāśauce naiva piṇḍadāna vyavasyasiddheḥ |	saṃbandhayitṛ gata jāti āśauce na eva piṇḍa dāna 
MBaasaucadiipikaaHK-1634	saṃnikṛṣṭa prakṛṣṭayossaṃnikṛṣṭa grahaṇamaṃtaraṃge	saṃnikṛṣṭa prakṛṣṭayoḥ saṃnikṛṣṭa grahaṇam aṃtaraṃge 
MBaasaucadiipikaaHK-1635	bahiraṃgayorantaraṃga grahasya lokaveda siddhatvāt | evaṃ	bahiraṃgayoḥ antaraṃga grahasya loka veda siddha tvāt evam 
MBaasaucadiipikaaHK-1636	putrakamṛtau samayinassaṃskartṛtvepi avāntaraśaivānānna doṣaḥ |	putraka mṛtau samayinaḥ saṃskartṛ tve pi doṣaḥ 
MBaasaucadiipikaaHK-1637	na ca dāsya putrakāśaucena dāhakasamayāśauca saṃkocassyāditi	na ca dāsya putraka āśaucena dāhaka samaya āśauca saṃkocaḥ syāt iti 
MBaasaucadiipikaaHK-1638	vācyam | iṣṭāpatteḥ | śivārcana dhurandharaputraka saṃskāreṇa	vācyam iṣṭa āpatteḥ śiva arcana dhurandhara putraka saṃskāreṇa 
MBaasaucadiipikaaHK-1639	gatāśauca saṃkocasya samayino bhūṣaṇatvāt |	gata āśauca saṃkocasya samayinaḥ bhūṣaṇa tvāt 
MBaasaucadiipikaaHK-1640	p. 399)	p 
MBaasaucadiipikaaHK-1641	atha vacanābhāve nāśauca saṃkocastasya na yukta iti vedastu vā	atha vacana abhāve saṃkocaḥ tasya na yuktaḥ iti vedaḥ tu vā 
MBaasaucadiipikaaHK-1642	tathā kā no hāniḥ - na cāśaucavistare sati samayinaḥ	tathā kā no hāniḥ na ca āśauca vistare sati samayinaḥ 
MBaasaucadiipikaaHK-1643	putrakamṛtau pañcadaśadinānte ekoddiṣṭakaraṇanna syāditi vācyam	putraka mṛtau pañcadaśa dina ante ekoddiṣṭa karaṇat na syāt iti vācyam 
MBaasaucadiipikaaHK-1644	| samayinastadānīmāśauca satvepi kartustātkālikī	samayinaḥ tadānīm āśauca satve pi kartuḥ tātkālikī 
MBaasaucadiipikaaHK-1645	śuddhiśśuddhiḥ punareva saḥ iti smṛtibalena ekoddiṣṭa	śuddhiḥ śuddhiḥ punar eva saḥ iti smṛti balena ekoddiṣṭa 
MBaasaucadiipikaaHK-1646	katṛtvopapatteḥ | tarhi tadanantaradine sapiṇḍīkaraṇaṃ na	katṛ tva upapatteḥ tarhi tad anantara dine sapiṇḍīkaraṇam na 
MBaasaucadiipikaaHK-1647	syāditi cet satyam | tatra saṃbhavepi kālāntarasya tripakṣāderapi	syāt iti ced satyam tatra saṃbhave pi kāla antarasya tri pakṣa ādeḥ api 
MBaasaucadiipikaaHK-1648	vihitatayā tatra sapiṇḍīkaraṇopapatteḥ |	vihita tayā tatra sapiṇḍīkaraṇa upapatteḥ 
MBaasaucadiipikaaHK-1649	sarvairapyāśaucānantaradine dāśaucānantaragamane kālāntare	sarvaiḥ api āśauca anantara dine da āśauca anantara gamane kāla antare 
MBaasaucadiipikaaHK-1650	sapiṇḍīkaraṇasyāṃgī kṛtatvāttasmāddāhya jātyuktāśaucena	sapiṇḍīkaraṇasya aṃgī kṛta tvāt tasmāt dāhya jāti ukta āśaucena 
MBaasaucadiipikaaHK-1651	dāhakasya vyavasthāyāṃ na kadācidapya * * * riti sarvaṃ nikhayam |	dāhakasya vyavasthāyām na sarvam nikhayam 
MBaasaucadiipikaaHK-1652	evamukta vidhadaśanimittāśauceṣu madhye pretakarmāntikaṃ	evam ukta vidha daśa nimitta āśauceṣu madhye preta karma antikam 
MBaasaucadiipikaaHK-1653	karmabhūti sapiṇḍīkaraṇa nimittāśaucasya sapiṇḍīkaraṇena	karma bhūti sapiṇḍīkaraṇa nimitta āśaucasya sapiṇḍīkaraṇena 
MBaasaucadiipikaaHK-1654	nivṛttau mukhyakartussarvapāpaśuddhiḥ |	nivṛttau mukhya kartuḥ sarva pāpa śuddhiḥ 
MBaasaucadiipikaaHK-1655	sapiṇḍīkaraṇādūrdhvaṃśivalokaṃ saṅgacchatīti | uktaṃ kāmike	sapiṇḍīkaraṇāt ūrdhvam śiva lokam saṅgacchati iti uktam kāmike 
MBaasaucadiipikaaHK-1656	yasyaitāni na kurvanti śrāddhāni nava ṣoḍaśa |	yasya etāni na kurvanti śrāddhāni nava ṣoḍaśa 
MBaasaucadiipikaaHK-1657	piśācatvañcirantasya dattaiśśrāddhaiśśatairapi ||	piśāca tvat ciram tasya dattaiḥ śrāddhaiḥ śataiḥ api 
MBaasaucadiipikaaHK-1658	dvāre ca bhasmanicaye ākāśe ca yathākramam | tryahāni trīṇi	dvāre ca bhasmanicaye ākāśe ca yathākramam tri ahāni trīṇi 
MBaasaucadiipikaaHK-1659	caikañca pretībhūtassadīvyati ||	ca ekaḥ ca pretībhūtaḥ sa dīvyati 
MBaasaucadiipikaaHK-1660	p. 400)	p 
MBaasaucadiipikaaHK-1661	sapiṇḍīkaraṇādūrdhvaṃ śivaloke gacchatīti |	sapiṇḍīkaraṇāt ūrdhvam śiva loke gacchati iti 
MBaasaucadiipikaaHK-1662	ṣaṭsahasrikāyām -	ṣaṭsahasrikāyām 
MBaasaucadiipikaaHK-1663	ityetacchivabhaktānāṃ saṃskārañca yathoditam | rahasyaṃ	iti etat śiva bhaktānām saṃskāram ca yathā uditam rahasyam 
MBaasaucadiipikaaHK-1664	paramākhyātamapavarga phalapradam ||	parama ākhyātam apavarga phala pradam 
MBaasaucadiipikaaHK-1665	śaivāgamarahasyānāṃ saṃpradāyapravartakaḥ |	            
MBaasaucadiipikaaHK-1666	vedajñānamunīndreti viśutoya svayaṃśivaḥ |	veda jñāna muni indra iti viśu toya svayam śivaḥ 
MBaasaucadiipikaaHK-1667	tasya śiṣyeṇa tannāma dhārakeṇa tapasvinā | śaivānāṃ	tasya śiṣyeṇa tad nāma dhārakeṇa tapasvinā śaivānām 
MBaasaucadiipikaaHK-1668	viniyogārthaṃ kṛtācāśaucyadīpikā ||	viniyoga artham kṛtā ā ca āśaucya dīpikā 
MBaasaucadiipikaaHK-1669	iti śrīmadvyāghrapurinivāsi vedajñānadevaśiracitāśaucyadīpikā	iti śrīmat vyāghrapuri nivāsi vedajñānadevaśi racitā āśaucyadīpikā 
MBaasaucadiipikaaHK-1670	samāptā |	samāptā 
MBaasaucadiipikaaHK-1671	MUKTABODHA INDOLOGICAL RESEARCH INSTITUTE©2011 Muktabodha Indological Research Institute  All Rights Reserved.E-texts may be viewed only online or downloaded for private study.E-texts may not, under any circumstances, be copied, republished,reproduced, distributed or sold, either in original or altered form, withoutthe express permission of Muktabodha Indological Research Institute in writing.Data-entered by the staff of Muktabodha under the direction of Mark S. G. Dyczkowski.	muktabodha indological research muktabodha indological research institute all rights reserved texts may be viewed only online or downloaded for private studye texts may not under any circumstances be copied republished reproduced distributed or sold either in original or altered form withoutthe express permission of muktabodha indological research institute in writing data entered by the staff of muktabodha under the direction of mark s g dyczkowski 
