segmentnr	original	analyzed
MBbodhapancadasikaaHK-0	Muktabodha E-text in UTF-8	muktabodha etext in utf
MBbodhapancadasikaaHK-1	###########################################################################MUKTABODHA INDOLOGICAL RESEARCH INSTITUTEwww.muktabodha.org©2011 Muktabodha Indological Research Institute  All Rights Reserved.E-texts may be viewed only online or downloaded for private study.E-texts may not, under any circumstances, be copied, republished,reproduced, distributed or sold, either in original or altered form, withoutthe express permission of Muktabodha Indological Research Institute in writing.Data-entered by the staff of Muktabodha under the direction of Mark S. G. Dyczkowski.Catalog number : M00173	muktabodha indological research muktabodha indological research institute all rights reserved texts may be viewed only online or downloaded for private studye texts may not under any circumstances be copied republished reproduced distributed or sold either in original or altered form withoutthe express permission of muktabodha indological research institute in writing data entered by the staff of muktabodha under the direction of mark s g dyczkowskicatalog number  /
MBbodhapancadasikaaHK-2	Uniform title: bodhapañcadaśikā	uniform title bodha pañcadaśikā 
MBbodhapancadasikaaHK-3	Main title: bodhapañcadaśikā with commentary by harabhaṭṭaśāstrī	main title bodhapañcadaśikā with commentary by harabhaṭṭaśāstrī 
MBbodhapancadasikaaHK-4	Author : abhinavagupta	authoḥ abhinavagupta 
MBbodhapancadasikaaHK-5	Editor : zadoo jagaddhar	editoḥ jagat har 
MBbodhapancadasikaaHK-6	Description: Photographic facsimiles from vol 76 of the Kashmir Series of Texts and Studies.	description photographic facsimiles from vol of the kashmir series of texts and studies 
MBbodhapancadasikaaHK-7	Notes: Data entered version added:	notes data entered vesion added 
MBbodhapancadasikaaHK-8	Revision 0: Sept. 18, 2011	revision 
MBbodhapancadasikaaHK-9	Publisher : Research Department Jammu and Kashmir State	publisher research depatment jammu and kashmir state 
MBbodhapancadasikaaHK-10	Publication year : 1947	publication year 
MBbodhapancadasikaaHK-11	Publication city : Srinigar	publication citi srinigar 
MBbodhapancadasikaaHK-12	Publication country : India	publication country india 
MBbodhapancadasikaaHK-13	śrībodhapañcadaśikā	         
MBbodhapancadasikaaHK-14	mahāmāheśvarācāryābhinavaguptapādaviracitā |	                
MBbodhapancadasikaaHK-15	śrīgaṇeśāya namaḥ ||	śrī gaṇeśāya namaḥ 
MBbodhapancadasikaaHK-16	śrīśāradāmbāyai namaḥ ||	śrī śāradā ambāyai namaḥ 
MBbodhapancadasikaaHK-17	iha khalu śivādvayaśāsanāmbhodhipāradṛśvā śrīmān	iha khalu śiva advaya śāsana ambhodhi pāra dṛśvā śrīmān 
MBbodhapancadasikaaHK-18	mahāmāheśvaro'bhinavaguptākhya	              
MBbodhapancadasikaaHK-19	ācāryavaro'titīkṣṇapratibhāprasādātiśayato'vagāhanīyeṣu	ācārya vara uti tīkṣṇa pratibhā prasāda atiśayataḥ upagāhanīyeṣu 
MBbodhapancadasikaaHK-20	śaivāgameṣu keṣāñcidanugrāhyāṇāṃ śiṣyāṇāṃ	śaiva āgameṣu keṣāṃcid anugrāhyāṇām śiṣyāṇām 
MBbodhapancadasikaaHK-21	natisaukumārya paryālocyānāyāsameva	nati saukumārya paryālocya anāyāsam eva 
MBbodhapancadasikaaHK-22	trikaśāstrasaṃpradāyajijñāsūṃstānupadidikṣuḥ pañcadaśabhiḥ	trika śāstra saṃpradāya jijñāsūn tān upadidikṣuḥ pañcadaśabhiḥ 
MBbodhapancadasikaaHK-23	ślokaistatpratibodhanāya śāstrārthamupanibadhnāti | tatrādau	ślokaiḥ tad pratibodhanāya śāstra artham upanibadhnāti tatra ādau 
MBbodhapancadasikaaHK-24	nityoditasaṃvitprakāśasyāvabhāsane pramāṇavyāpārābhāva iti	                             
MBbodhapancadasikaaHK-25	pratipādayannāha -	pratipādayan āha 
MBbodhapancadasikaaHK-26	anastamitabhārūpastejasāṃ tamasāmapi | ya eko'ntaryadantaśca	an astamita bhā rūpaḥ tejasām tamasām api yaḥ ekaḥ untar yad antaḥ ca 
MBbodhapancadasikaaHK-27	tejāṃsi ca tamāṃsi ca || 1 ||	tejāṃsi ca tamāṃsi ca 
MBbodhapancadasikaaHK-28	svatantraśivaprakāśo hi sarvābhāsakaḥ sadodito na svaṃ	svatantra śiva prakāśaḥ hi sarva ābhāsakaḥ sadā uditaḥ na svam 
MBbodhapancadasikaaHK-29	prakāśayituṃ prakāśāntaramapekṣate svaprakāśatvāt	prakāśayitum prakāśa antaram apekṣate sva prakāśa tvāt 
MBbodhapancadasikaaHK-30	tasyā'stoditatvābhāvāt sakṛdvibhāto'yamātmā iti nahi	tasyāḥ todita tva abhāvāt sakṛt vibhātā ayam ātmā iti nahi 
MBbodhapancadasikaaHK-31	draṣṭurdaṣṭrerviparilopo vidyate'vināśitvāt iti śruteḥ | (bṛ0	draṣṭuḥ daṣṭreḥ viparilopaḥ vidyate vināśi tvāt iti śruteḥ 
MBbodhapancadasikaaHK-32	ā0 4|3|23|) ya eko'dvitīyo'rkādīnāṃ tejasāṃ	ā yaḥ ekaḥ dvitīya ūrja ādīnām tejasām 
MBbodhapancadasikaaHK-33	pramāṇādiprakāśānāṃ ca tathā madamūrchādyavasthārūpāṇāṃ	pramāṇa ādi prakāśānām ca tathā mada mūrchā ādi avasthā rūpāṇām 
MBbodhapancadasikaaHK-34	tamasāṃ bāhyāprakāśānāmantaravasthitatvāt tadanuprāṇako	tamasām bāhya aprakāśānām antar avasthita tvāt tad anuprāṇakaḥ 
MBbodhapancadasikaaHK-35	bahirapi tasyaiva saṃvitprakāśasya sattvāttadantareva	bahis api tasya eva saṃvid prakāśasya sattvāt tat antar eva 
MBbodhapancadasikaaHK-36	tānyarkādīnāṃ tejastamāṃsi svasattāmupayānti |	tāni arka ādīnām tejaḥ tamāṃsi sva sattām upayānti 
MBbodhapancadasikaaHK-37	p. 2)	p 
MBbodhapancadasikaaHK-38	nahi bhārūpaṃ saṃvitprakāśaṃ vinā kimapi ghaṭādi bhāvajātaṃ	nahi bhā rūpam saṃvid prakāśam vinā kim api ghaṭa ādi bhāva jātam 
MBbodhapancadasikaaHK-39	prakāśamānatāmeti te ca prakāśā astaṃ yānti udayanti ca |	prakāśamāna tām eti te ca prakāśāḥ astam yānti udayanti ca 
MBbodhapancadasikaaHK-40	prakāśaḥ punarastodayānākalitaḥ pramāṇānāmapi jīvitarūpaṃ	prakāśaḥ punar asta udayānā kalitaḥ pramāṇānām api jīvita rūpam 
MBbodhapancadasikaaHK-41	mūlapramāṇaṃ tamarkādiprakāśaḥ kaścidavabhāsayituṃ na	mūlapramāṇam tam arka ādi prakāśaḥ kaścid avabhāsayitum na 
MBbodhapancadasikaaHK-42	śaknoti tasya prakāśyatvāt svābhāsane'pyasamarthasya kathaṃ	śaknoti tasya prakāśya tvāt sva ābhāsane pi asamarthasya katham 
MBbodhapancadasikaaHK-43	paraṃ bhāsayituṃ prāgalbhyaṃ pratyuta svābhāsane'pi	param bhāsayitum prāgalbhyam pratyuta sva ābhāsane pi 
MBbodhapancadasikaaHK-44	saṃvitprakāśamevāpekṣate sa iti svaprakāśatvādarkādīnāṃ sa	saṃvid prakāśam eva apekṣate saḥ iti sva prakāśa tvāt arka ādīnām sa 
MBbodhapancadasikaaHK-45	eva bhāsakaḥ | yaduktam -	eva bhāsakaḥ yat uktam 
MBbodhapancadasikaaHK-46	yanna sūryoṃ navā somo nāgnirbhāsayate'pi ca ||	yat na sūrya ūm na vā somaḥ na agniḥ bhāsayata ipi ca 
MBbodhapancadasikaaHK-47	nacārkasomavahṇīnāṃ tatprakāśādvinā mahaḥ ||	na ca arka soma vahṇīnām tad prakāśāt vinā mahar 
MBbodhapancadasikaaHK-48	kimapyasti nijaṃ kintu saṃviditthaṃ prakāśate | (taṃ0 3 | 115)	kim api asti nijam kintu saṃvid ittham prakāśate tam 
MBbodhapancadasikaaHK-49	iti | tathā gītāsu -	iti tathā gītāsu 
MBbodhapancadasikaaHK-50	na tadbhāsayate sūryo na śaśāṅko na pāvakaḥ | yadgatvā na	na tat bhāsayate sūryaḥ na śaśāṅkaḥ na pāvakaḥ yat gatvā na 
MBbodhapancadasikaaHK-51	nivartante taddhāma paramaṃ mama || (bha0 gī0 11|56)	nivartante tat dhāma paramam mama 
MBbodhapancadasikaaHK-52	abodho'pi na bodhyamāno bodhādbhidyate'nyathā	abodhaḥ api na bodhyamānaḥ bodhāt bhidyate nyathā 
MBbodhapancadasikaaHK-53	tatsattvānupapatteriti sthityā khapuppāderapyasato	tad sattva anupapatteḥ iti sthityā khapuppa ādeḥ api asataḥ 
MBbodhapancadasikaaHK-54	vyāpakatvādaparicchinnaḥ saṃvitprakāśo viśvatra	vyāpaka tvāt aparicchinnaḥ saṃvid prakāśaḥ viśvatra 
MBbodhapancadasikaaHK-55	nirnirodhāvaraṇaṃ tattadvaicitryātmanā vijṛmbhate ityetena kimapi	niḥ nirodha āvaraṇam tat tat vaicitrya ātmanā vijṛmbhate iti etena kim api 
MBbodhapancadasikaaHK-56	pramāṇādi tatra sarvajīvitabhū nopayujyate ityuktaṃ bhavati || 1	pramāṇa ādi tatra sarva jīvita bhū na upayujyate iti uktam bhavati 
MBbodhapancadasikaaHK-57	evaṃ saṃvitprakāśaḥ prakāśyaṃ prameyaṃ prakāśayatīti	evam saṃvid prakāśaḥ prakāśyam prameyam prakāśayati iti 
MBbodhapancadasikaaHK-58	prakāśaprakāśanīyabhāve siddhe kathaṃ śivādvayabhāva	prakāśa prakāśanīya bhāve siddhe katham śiva advaya bhāva 
MBbodhapancadasikaaHK-59	ityāśaṃkyāha -	iti āśaṃkya āha 
MBbodhapancadasikaaHK-60	sa eva sarvabhūtānāṃ svabhāvaḥ parameśvaraḥ | bhāvajātaṃ hi	saḥ eva sarva bhūtānām svabhāvaḥ parameśvaraḥ bhāva jātam hi 
MBbodhapancadasikaaHK-61	tasyaiva śaktirīśvaratāmayī || 2 ||	tasya eva śaktiḥ īśvara tā mayī 
MBbodhapancadasikaaHK-62	sa eva parameśvaraḥ svatantraciddhanatāsaparamārthaḥ	saḥ eva parameśvaraḥ svatantra cit dhana tā sa paramārthaḥ 
MBbodhapancadasikaaHK-63	sarvabhūtānāṃ samagrāṇāṃ śivādisakalāntānāṃ	sarva bhūtānām samagrāṇām śiva ādi sakala antānām 
MBbodhapancadasikaaHK-64	pramātṛvargāṇāṃ sakalānāṃ prameyavargāṇāṃ ca ubhayeṣāṃ	pramātṛ vargāṇām sakalānām prameya vargāṇām ca ubhayeṣām 
MBbodhapancadasikaaHK-65	prāhyagrāhakarūpāṇāṃ sphurattātmānuttaraprakāśavapuḥ	                  
MBbodhapancadasikaaHK-66	svabhāvo'nyathā -	svabhāvaḥ nyathā 
MBbodhapancadasikaaHK-67	p. 3)	p 
MBbodhapancadasikaaHK-68	yattatra nahi viśrāntaṃ tannabhaḥ kusumāyate | (taṃ0 8|3)	yat tatra na hi viśrāntam tat nabhaḥ kusumāyate tam 
MBbodhapancadasikaaHK-69	iti sthityā saṃvitprakāśādbhinnasyā'satvānna kimapi prakāśeta	iti sthityā saṃvid prakāśāt bhinnasya asatvāt na kim api prakāśeta 
MBbodhapancadasikaaHK-70	| etadeva hi pārameśvaryamananyāpekṣaṃ svātantryaṃ	etat eva hi pārameśvaryam an anya apekṣam svātantryam 
MBbodhapancadasikaaHK-71	yattattadaniyataviśvavaicitryeṇa svecchayaiva svātmabhittau	yat tat tat aniyata viśva vaicitryeṇa sva icchayā eva sva ātma bhittau 
MBbodhapancadasikaaHK-72	samunmīlanaṃ tatrāpi niyatākāradhāritve aiśvarya vighaṭeta |	samunmīlanam tatra api niyata ākāra dhāri tve aiśvarya vighaṭeta 
MBbodhapancadasikaaHK-73	yaduktamācāryeṇaiva -	yat uktam ācāryeṇa eva 
MBbodhapancadasikaaHK-74	asthāsyadekarūpeṇa vapuṣā cenmaheśvaraḥ | maheśvaratvaṃ	asthāsyat eka rūpeṇa vapuṣā ced maheśvaraḥ maheśvara tvam 
MBbodhapancadasikaaHK-75	saṃvittvaṃ tadatyakṣyaddhaṭādivat || (taṃ0 3|100)	saṃvid tvam tat atyakṣyat dhaṭa ādi vat tam 
MBbodhapancadasikaaHK-76	kevalaṃ vedyavedakatvarūpasya vyavahārasya māyābhūmau	kevalam vedya vedaka tva rūpasya vyavahārasya māyā bhūmau 
MBbodhapancadasikaaHK-77	kalpitapramātrapekṣayā tātkālikī vyavahniyamāṇatā |	kalpita pramātṛ apekṣayā tātkālikī 
MBbodhapancadasikaaHK-78	yaduktamīśvarapratyabhijñāyām -	yat uktam īśvarapratyabhijñāyām 
MBbodhapancadasikaaHK-79	kevalaṃ bhinnasaṃvedyadeśakālānurodhataḥ |	kevalam bhinna saṃvedya deśa kāla anurodhataḥ 
MBbodhapancadasikaaHK-80	jñānasmṛtyavasāyādivyavahāro'nubhūyate || (ī0 pra0 1|5|21)	jñāna smṛti avasāya ādi vyavahāraḥ anubhūyate 
MBbodhapancadasikaaHK-81	iti | vastutastu	iti vastutas tu 
MBbodhapancadasikaaHK-82	sadaivābhinnaprakāśamayo'nuttarānākhyeyasaṃvitsvabhāvaḥ	sadā eva abhinna prakāśa mayaḥ unuttara anākhyeya saṃvid svabhāvaḥ 
MBbodhapancadasikaaHK-83	parameśvaraḥ eva svātmocchalattayā tattadviśvabhāvaparisphuraṇena	                               
MBbodhapancadasikaaHK-84	cakāstītyarthaḥ | etadeva hetudvārā spaṣṭaṃ nirūpayannāha	cakāsti iti arthaḥ etat eva hetu dvārā spaṣṭam nirūpayan āha 
MBbodhapancadasikaaHK-85	bhāvajātamiti tasyaiva parameśvarasya hi yasmādīśvaratāmayī	bhāva jātam iti tasya eva parameśvarasya hi yasmāt īśvara tā mayī 
MBbodhapancadasikaaHK-86	śaktiraiśvaryaṃrūpaṃ svātantryameva	śaktiḥ aiśvaryam rūpam svātantryam eva 
MBbodhapancadasikaaHK-87	vācyavācakātmaviśvapadārthamayaṃ bhāvajātaṃ bhavati yaduktaṃ	vācya vācaka ātma viśva padārtha mayam bhāva jātam bhavati yat uktam 
MBbodhapancadasikaaHK-88	maṅgalāyām -	maṅgalāyām 
MBbodhapancadasikaaHK-89	śaktayo'sya jagatkṛtsnaṃ śaktimāṃstu maheśvaraḥ |	śaktayoḥ sya jagat kṛtsnam śaktimān tu maheśvaraḥ 
MBbodhapancadasikaaHK-90	itinītyā svātantryameva jagadātmanā prathate ityarthaḥ | yaduktam	iti nītyā svātantryam eva jagat ātmanā prathate iti arthaḥ yat uktam 
MBbodhapancadasikaaHK-91	bodho hi bdharūpatvādantarnānākṛtīḥ sthitāḥ |	bodhaḥ hi bdha rūpa tvāt antar nānā ākṛtīḥ sthitāḥ 
MBbodhapancadasikaaHK-92	bahirābhāsayatyeva drāk sāmānyaviśeṣataḥ || (taṃ0 1|257)	bahis ābhāsayati eva drāk sāmānya viśeṣataḥ tam 
MBbodhapancadasikaaHK-93	iti | tatheśvarapratyabhijñāyām -	iti tathā īśvarapratyabhijñāyām 
MBbodhapancadasikaaHK-94	cidātmaiva hi devo'ntaḥ sthitamicchāvaśādbahiḥ | yogīva	cit ātmā eva hi sthitam icchā vaśāt bahis yogī iva 
MBbodhapancadasikaaHK-95	nirupādānamarthajātaṃ prakāśayet || ī0 pra0 (1|5|7)	nirupādānam artha jātam prakāśayet 
MBbodhapancadasikaaHK-96	p. 4)	p 
MBbodhapancadasikaaHK-97	iti | ataśca svaiśvayanirbharaḥ śiva evaikastathā tathā	iti atas ca sva aiśvaya nirbharaḥ śivaḥ eva ekaḥ tathā tathā 
MBbodhapancadasikaaHK-98	prasphurati ityekaiva saṃvitparamārthasatīti bhāvaḥ || 2 ||	prasphurati iti ekā eva saṃvid paramārtha satī iti bhāvaḥ 
MBbodhapancadasikaaHK-99	nanvevaṃ parameśvarasya śaktayaṃ viśvamiti śaktitadvatoḥ	nanu evam parameśvarasya viśvam iti śakti tadvatoḥ 
MBbodhapancadasikaaHK-100	parasparaṃ dharmadharmibhāvena bhedāt kathamekaśivātmabhāva	parasparam dharma dharmi bhāvena bhedāt katham eka śiva ātmabhāva 
MBbodhapancadasikaaHK-101	ityāśaṃkyāha -	iti āśaṃkya āha 
MBbodhapancadasikaaHK-102	śaktiśca śaktimadrūpād vyatirekaṃ na vāñchati |	śaktiḥ ca śaktimat rūpāt vyatirekam na vāñchati 
MBbodhapancadasikaaHK-103	tādātmyamanayornityaṃ vahnidāhikayoriva || 3 ||	tādātmyam anayoḥ nityam vahni dāhikayoḥ iva 
MBbodhapancadasikaaHK-104	yathāgnestacchakteśca	yathā agneḥ tad śakteḥ ca 
MBbodhapancadasikaaHK-105	dāhakatvapācakatvaprakāśakatvādivilakṣaṇāyā	dāhaka tva pācaka tva prakāśaka tva ādi vilakṣaṇāyāḥ 
MBbodhapancadasikaaHK-106	anayorayutasiddhatvātsātatyena samavetayoraikātmyameva na kadācid	anayoḥ ayuta siddha tvāt sātatyena samavetayoḥ aikātmyam eva na kadācid 
MBbodhapancadasikaaHK-107	dāhikādistacchaktiḥ svāśrayaṃ vahnimanāṭṭatya svarūpasattāṃ	dāhikā ādiḥ tad śaktiḥ sva āśrayam vahnim an āṭṭatya svarūpa sattām 
MBbodhapancadasikaaHK-108	labhate yadyena vinā na tiṣṭheta tattasmānna vyatiricyate iti	labhate yat yena vinā na tiṣṭheta tat tasmāt na vyatiricyate iti 
MBbodhapancadasikaaHK-109	nyāyādabhinnasārūpyāt tādātmyamevāvajambate | yaduktam -	nyāyāt abhinna sārūpyāt tādātmyam eva avajambate yat uktam 
MBbodhapancadasikaaHK-110	mātṛkḷpte hi bhāvasya tatra tatra vapupyalam | ko bhedo vastuto	mātṛ kḷpte hi bhāvasya tatra tatra vapupi alam kaḥ bhedaḥ 
MBbodhapancadasikaaHK-111	vahnerdagdhṛpaktṛtvayoriva || (taṃ0 1|70)	vahneḥ dagdhṛ paktṛ tvayoḥ iva tam 
MBbodhapancadasikaaHK-112	iti | evaṃ viśvabhāvavaicitryaprathāmayī svātantryaśaktiḥ	iti evam viśva bhāva vaicitrya prathā mayī svātantrya śaktiḥ 
MBbodhapancadasikaaHK-113	śaktimallakṣaṇāt śivasvabhāvānna vyatirekamicchet tatsatve hi	śaktimat lakṣaṇāt śiva svabhāvāt na vyatirekam icchet tad satve hi 
MBbodhapancadasikaaHK-114	tasyāḥ svarūpavipralopāt svarūpavināśe	tasyāḥ sva rūpa vipralopāt sva rūpa vināśe 
MBbodhapancadasikaaHK-115	kāryasaṃpādanaśakteranupapadyamānatvādviśvamidaṃ na prasphuret	kārya saṃpādana śakteḥ anupapadyamāna tvāt viśvam idam na prasphuret 
MBbodhapancadasikaaHK-116	prasphurati ca viśvaṃ tasmācchivaprakāśābhinnā	prasphurati ca viśvam tasmāt śiva prakāśa abhinnā 
MBbodhapancadasikaaHK-117	svātantryaśaktireva vedyavedakarūpeṇa visphurati ityamunaivāśayena	svātantrya śaktiḥ eva vedya vedaka rūpeṇa visphurati iti amunā eva āśayena 
MBbodhapancadasikaaHK-118	śivasūtreṣu caitanyamātmā iti bhāvaprādhānyena nirdeśaḥ |	             
MBbodhapancadasikaaHK-119	nāpi kriyābhedāt kriyāvān bhidyate tāsvanavarataṃ	nā api kriyā bhedāt kriyāvān bhidyate tāsu anavaratam 
MBbodhapancadasikaaHK-120	pravartamānāsvapi karturekatvānapāyāt | evaṃ śaktīnāṃ	pravartamānāsu api kartuḥ eka tva anapāyāt evam śaktīnām 
MBbodhapancadasikaaHK-121	bahusve'pi śaktimānekatvaṃ na vyabhicarati tadvahutvasyāpi	bahu sve api śaktimān eka tvam na vyabhicarati tad vahu tvasya api 
MBbodhapancadasikaaHK-122	ekasyāmeva svātantryaśaktāvantarbhāvānmukhyā saiva ekā	ekasyām eva svātantrya śaktau antarbhāvāt mukhyā sā eva ekā 
MBbodhapancadasikaaHK-123	śaktiśaktimadavyatirekiṇī sarvatrābhiṣicyate | yaduktam -	śakti śaktimat avyatirekiṇī sarvatra abhiṣicyate yat uktam 
MBbodhapancadasikaaHK-124	tasmātsaṃvittvamevaitatsvātantryaṃ yattadapyalam | vivicyamānaṃ	tasmāt saṃvid tvam eva etat svātantryam yat tat api alam vivicyamānam 
MBbodhapancadasikaaHK-125	vahnīṣu paryavasyati śaktiṣu || (taṃ0 1|61)	vahnīṣu paryavasyati śaktiṣu tam 
MBbodhapancadasikaaHK-126	p. 5)	p 
MBbodhapancadasikaaHK-127	iti | tathā -	iti tathā 
MBbodhapancadasikaaHK-128	bahuśaktitvamapyasya tacchaktyaivā'viyuktatā | (taṃ0 1|68)	bahu śakti tvam api asya tad śaktyā eva a viyukta tā tam 
MBbodhapancadasikaaHK-129	iti | tathā -	iti tathā 
MBbodhapancadasikaaHK-130	eka evāsya dharmo'sau sarvākṣepeṇa vartate | tena	ekaḥ eva asya dharmaḥ asau sarva ākṣepeṇa vartate tena 
MBbodhapancadasikaaHK-131	svātantryaśaktyaiva yukta ityāñjaso vidhiḥ || (taṃ0 1|67)	svātantrya śaktyā eva yuktaḥ iti āñjasaḥ vidhiḥ tam 
MBbodhapancadasikaaHK-132	iti | etadeva hṛdayaṃ vimarśaḥ sāra ityādiśabdaiḥ paribhāṣyate	iti etat eva hṛdayam vimarśaḥ sāraḥ iti ādi śabdaiḥ paribhāṣyate 
MBbodhapancadasikaaHK-133	idameva jaḍaprakāśādvailakṣaṇyādhāyi | yaduktaṃ	idam eva jaḍa prakāśāt vailakṣaṇya ādhāyi yat uktam 
MBbodhapancadasikaaHK-134	pratyabhijñāyām -	pratyabhijñāyām 
MBbodhapancadasikaaHK-135	svabhāvamavabhāsasya vimarśaṃ viduranyathā |	svabhāvam avabhāsasya vimarśam viduḥ anyathā 
MBbodhapancadasikaaHK-136	prakāśo'rthoparakto'pi sphaṭikādijaḍopamaḥ || (ī0 pra0 1|5|10)	prakāśa ūrtha uparaktaḥ api sphaṭika ādi jaḍa upamaḥ 
MBbodhapancadasikaaHK-137	iti | evaṃ māyādhvani durapahnavatvādbhāsamānasyāpi bhedasya	iti evam māyā adhvani durapahnava tvāt bhāsamānasya api bhedasya 
MBbodhapancadasikaaHK-138	ābhāsasāratvāt na svatantraśivādvayabhāvakhaṇḍanā iti || 3 ||	ābhāsa sāra tvāt na svatantra śiva advaya bhāva khaṇḍanā iti 
MBbodhapancadasikaaHK-139	nanu parameśvarasya tattadviśvavaicitryaprathane kiṃmuddiśya	nanu parameśvarasya tat tat viśva vaicitrya prathane kim uddiśya 
MBbodhapancadasikaaHK-140	pravṛttiḥ kiṃca nimittaṃ ityāśaṃkyāha -	pravṛttiḥ kiṃca nimittam iti āśaṃkya āha 
MBbodhapancadasikaaHK-141	sa eva bhairavo devo jagadbharaṇalakṣaṇaḥ | svātmādarśe samagraṃ	saḥ eva bhairavaḥ devaḥ jagat bharaṇa lakṣaṇaḥ sva ātma ādarśe samagram 
MBbodhapancadasikaaHK-142	hi yacchaktyā pratibimbitam || 4 ||	hi yat śaktyā pratibimbitam 
MBbodhapancadasikaaHK-143	sa eva śaktimān svatantro'nuttarabhaṭṭārakaḥ	saḥ eva śaktimān svatantraḥ unuttara bhaṭṭārakaḥ 
MBbodhapancadasikaaHK-144	svasvātantryeṇodbhāsitasya viśvasya svātmabhittisaṃlagnatayā	sva svātantryeṇa udbhāsitasya viśvasya sva ātma bhitti saṃlagna tayā 
MBbodhapancadasikaaHK-145	dhāraṇapoṣaṇasvabhāvatvād bhairavo viśvabharitasvarūpaḥ -	dhāraṇa poṣaṇa svabhāva tvāt bhairavaḥ viśva bharita svarūpaḥ 
MBbodhapancadasikaaHK-146	mriyātsarvaṃ racayati sarvado vyāpako'khile | iti bhairavaśabdasya	mriyāt sarvam racayati sarva daḥ vyāpakaḥ ukhile iti bhairava śabdasya 
MBbodhapancadasikaaHK-147	santatoccāraṇācchivaḥ || (vi0 bhai0 130)	santata uccāraṇāt śivaḥ vi bhai 
MBbodhapancadasikaaHK-148	iti vijñānabhairavoktanītyā	iti vijñānabhairava uktanītyā 
MBbodhapancadasikaaHK-149	pūrṇāhantācamatkāranirbharabhairavasvarūpe viśramaṇādvā	pūrṇa ahantā camatkāra nirbhara bhairava svarūpe viśramaṇāt vā 
MBbodhapancadasikaaHK-150	viśvenāpi dhāryamāṇaḥ poṣyamāṇaśca sadaiva viśvamayatvena	viśvena api dhāryamāṇaḥ poṣyamāṇaḥ ca sadā eva viśva maya tvena 
MBbodhapancadasikaaHK-151	prasphuraṇāt ityuktaṃ jagadbharaṇalakṣaṇa iti | bhairavasaṃvido	                     
MBbodhapancadasikaaHK-152	hi vyatiricyamānasyānyasyācetyamānatvāt sarvatra pāripūrṇyaṃ	hi vyatiricyamānasya anyasya a cetyamāna tvāt sarvatra pāripūrṇyam 
MBbodhapancadasikaaHK-153	viśvabharitasvabhāvatvāt | tasyaiva svaiśvaryaghanatāmahimnā	viśva bharita svabhāva tvāt tasya eva sva aiśvarya ghana tā mahimnā 
MBbodhapancadasikaaHK-154	yacchivādibhūmyantena tattvabhūtabhāvādyātmanā vijṛmbhaṇaṃ	yat śiva ādi bhūmi antena tattva bhūta bhāva ādi ātmanā vijṛmbhaṇam 
MBbodhapancadasikaaHK-155	tadeva svātmagopanātmakrīḍārasikasya devatvaṃ	tat eva sva ātma gopana ātma krīḍā rasikasya deva tvam 
MBbodhapancadasikaaHK-156	vistaratasturbhairavadevaśabdayorvivaraṇaṃ śrītantrāloke	vistarataḥ tuḥ bhairava deva śabdayoḥ vivaraṇam śrī tantrāloke 
MBbodhapancadasikaaHK-157	draṣṭavyam |	draṣṭavyam 
MBbodhapancadasikaaHK-158	p. 6)	p 
MBbodhapancadasikaaHK-159	etadeva vaśvasṛṣṭyādau parameśvarasya nimittaṃ na punaḥ	etat eva vaśva sṛṣṭi ādau parameśvarasya nimittam na punar 
MBbodhapancadasikaaHK-160	prāṇināṃ karmādi tatsāpekṣatve hi svātantryaṃ (na punaḥ	prāṇinām karma ādi tad sāpekṣa tve hi svātantryam na punar 
MBbodhapancadasikaaHK-161	prāṇināṃ karmādi tatsāpekṣatve hi svātantryaṃ) vighaṭeta	prāṇinām karma ādi tad sāpekṣa tve hi svātantryam vighaṭeta 
MBbodhapancadasikaaHK-162	svātantryamevānandaghanatvaṃ tadeva ghanatā'tiśayaprāptā	svātantryam eva ānanda ghana tvam tat eva ghana tā atiśaya prāptā 
MBbodhapancadasikaaHK-163	samucchalatsvabhāvatvena tattadviśvavaicitryeṇa sphurati dyotate	samucchalat svabhāva tvena tat tat viśva vaicitryeṇa sphurati dyotate 
MBbodhapancadasikaaHK-164	sarvotkarṣatayāpyāste | yaduktam -	sarva utkarṣa tayā api āste yat uktam 
MBbodhapancadasikaaHK-165	tasya svatantrabhāvo hi kiṃ kiṃ yanna vicintayet | taduktaṃ	tasya svatantra bhāvaḥ hi kim kim yat na vicintayet tat uktam 
MBbodhapancadasikaaHK-166	triśiraḥśāstre sa buddha iti vetti yaḥ ||	triśiraḥśāstre sa buddhaḥ iti vetti yaḥ 
MBbodhapancadasikaaHK-167	iti | yacchaktayā parākhyayā svārtmaiva svacchatvādinā	iti yat śaktayā parākhyayā sva ārtmā eva svaccha tva ādinā 
MBbodhapancadasikaaHK-168	pratibimbasahatvād darpaṇastasmin samagraṃ	pratibimba saha tvāt darpaṇaḥ tasmin samagram 
MBbodhapancadasikaaHK-169	pramātṛprameyātmabhāvajātamupādānādisāmagrīnirapekṣatvena	pramātṛ prameya ātma bhāva jātam upādāna ādi sāmagrī nirapekṣa tvena 
MBbodhapancadasikaaHK-170	pratibimbitaṃ darpaṇo hi bimbasāpekṣaḥ	pratibimbitam darpaṇaḥ hi bimba sāpekṣaḥ 
MBbodhapancadasikaaHK-171	svāntastattadracanārvaicitryaṃ dhatte eṣā	dhatte eṣā 
MBbodhapancadasikaaHK-172	parāśaktistannirapekṣameva	parā śaktiḥ tad nirapekṣam eva 
MBbodhapancadasikaaHK-173	viśvavaicitryamābhāsayatītyetadajāḍyasya vilasitam | yadāha	viśva vaicitryam ābhāsayati iti etat ajāḍyasya vilasitam yat āha 
MBbodhapancadasikaaHK-174	bhaṭṭa utpaladevaḥ -	         
MBbodhapancadasikaaHK-175	nirupādānasaṃbhāramabhittāveva tanvate | jagaccitraṃ namastasmai	nirupādāna saṃbhāram abhittau eva tanvate jagat citram namaḥ tasmai 
MBbodhapancadasikaaHK-176	kalāślāghyāya śūline || (22|9)	kalā ślāghyāya śūline 
MBbodhapancadasikaaHK-177	iti | śrīśaktisūtreṣvapi -	iti śrī śaktisūtreṣu api 
MBbodhapancadasikaaHK-178	svecchayā svabhittau viśvamunmīlayate | (śa0 sū0 2)	sva icchayā sva bhittau viśvam unmīlayate 
MBbodhapancadasikaaHK-179	iti | śrīmānācāryo'pi -	iti śrīmān ācāryaḥ api 
MBbodhapancadasikaaHK-180	antarvibhāti sakalaṃ jagadātmanīha yadvadvicitraracanā	antar vibhāti sakalam jagat ātmani iha yadvat vicitra racanā 
MBbodhapancadasikaaHK-181	makurāntarāle | bodhaḥ punarnijavimarśanasārayogā - dviśvaṃ	                
MBbodhapancadasikaaHK-182	parāmṛśati no makurastathā tu || (taṃ0 sā0 3 ā0)	parāmṛśati naḥ makuraḥ tathā tu tam sā 
MBbodhapancadasikaaHK-183	p. 7)	p 
MBbodhapancadasikaaHK-184	iti | aṇupratyabhijñāyāmapi -	iti aṇupratyabhijñāyām api 
MBbodhapancadasikaaHK-185	nātha tvayā vinā bimbaṃ svacche svātmani darśitam |	nātha tvayā vinā bimbam svacche sva ātmani darśitam 
MBbodhapancadasikaaHK-186	prasenādarpaṇeneva prabhāvādbhāvamaṇḍalam || 4 ||	prasenā darpaṇena iva prabhāvāt bhāva maṇḍalam 
MBbodhapancadasikaaHK-187	iti | evaṃ vaiśvarūpyollāse bhedāmarśanāt kathaṃ	iti evam vaiśvarūpya ullāse bheda āmarśanāt katham 
MBbodhapancadasikaaHK-188	bhairavasyādvaitatvaṃ syādityāśaṃkyāha -	bhairavasya advaita tvam syāt iti āśaṃkya āha 
MBbodhapancadasikaaHK-189	tasyaivaiṣā parā devī svarūpāmarśanotsukā | pūrṇatvaṃ	tasya eva eṣā parā devī sva rūpa āmarśana utsukā pūrṇa tvam 
MBbodhapancadasikaaHK-190	sarvabhāveṣu yasyā nālpaṃ nacādhikam || 5 ||	sarva bhāveṣu yasyāḥ na alpam na ca adhikam 
MBbodhapancadasikaaHK-191	tasyaiva bhairavātmanaḥ saṃvitprakāśasya eṣā	tasya eva bhairava ātmanaḥ saṃvid prakāśasya eṣā 
MBbodhapancadasikaaHK-192	vaiśvarūpyeṇollasantī svātantryākhyā	vaiśvarūpyeṇa ullasantī svātantrya ākhyā 
MBbodhapancadasikaaHK-193	śaktirdyotanādikrīḍāśīlatvād devī svātmani prakāśābhedena	śaktiḥ dyotana ādi krīḍā śīla tvāt devī sva ātmani prakāśa abhedena 
MBbodhapancadasikaaHK-194	viśvasyāmarśanāvabhāsābhyāṃ parā pūrṇatayā sphurantī	viśvasya āmarśana avabhāsābhyām parā pūrṇa tayā sphurantī 
MBbodhapancadasikaaHK-195	tatraiva darpaṇanagarādivadbhedyabhedatayā viśvasya	tatra eva darpaṇa nagara ādi vat bhedya bheda tayā viśvasya 
MBbodhapancadasikaaHK-196	parāmarśanādatyantaṃ bhedenāpi māyāpramāturucitena vimarśanāt	parāmarśanāt atyantam bhedena api māyā pramātuḥ ucitena vimarśanāt 
MBbodhapancadasikaaHK-197	parāparādisaṃjñāmavāptāpi svarūpasyāmarśane svātantryāt	parāpara ādi saṃjñām avāptā api sva rūpasya āmarśane svātantryāt 
MBbodhapancadasikaaHK-198	tattadbhāvajātaṃ svātmamayameveti viśvāhaṃbhāvacamatkṛtau	tat tat bhāva jātam sva ātma mayam eva iti viśva ahaṃbhāva camatkṛtau 
MBbodhapancadasikaaHK-199	utsukā svātmānameva tathātathā parāmraṣṭumautsukyena pravṛttā	utsukā sva ātmānam eva tathā tathā parāmraṣṭum autsukyena pravṛttā 
MBbodhapancadasikaaHK-200	evaṃ tridhāpyāmarśane	evam tridhā api āmarśane 
MBbodhapancadasikaaHK-201	vyatiriktabhāvauṃnmukhyavirahātpāripūrṇyādanapetai	vyatirikta bhāva auṃnmukhya virahāt pāripūrṇyāt an apetaiḥ 
MBbodhapancadasikaaHK-202	svasvātantryeṇa svameva svātmanāmṛśati | yaduktaṃ	sva svātantryeṇa svam eva sva ātmanā āmṛśati yat uktam 
MBbodhapancadasikaaHK-203	pratyabhijñāyām -	pratyabhijñāyām 
MBbodhapancadasikaaHK-204	svātantryāmuktamātmānaṃ svātantryādadvayātmanaḥ |	svātantrya amuktam ātmānam svātantryāt advaya ātmanaḥ 
MBbodhapancadasikaaHK-205	prabhurīśādisaṅkalpairnirmāya vyavahārayet || ī0 pra0 1|5|16)	prabhuḥ īśa ādi saṅkalpaiḥ nirmāya vyavahārayet 
MBbodhapancadasikaaHK-206	iti sthityā dvaitollāse'pi nādvaiṃtahāniriti | ata eva yasyāḥ	iti sthityā dvaita ullāse api na advaiṃta hāniḥ iti atas eva yasyāḥ 
MBbodhapancadasikaaHK-207	sarvabhāveṣu sākalyena viśvavartiṣu nīlasukhādiṣu padārtheṣu	sarva bhāveṣu sākalyena viśva vartiṣu nīla sukha ādiṣu padārtheṣu 
MBbodhapancadasikaaHK-208	pūrṇatvamakhaṇḍaṃ pāripūrṇyaṃ tacca nālpaṃ nacādhikaṃ	pūrṇa tvam akhaṇḍam pāripūrṇyam tat ca na alpam na ca adhikam 
MBbodhapancadasikaaHK-209	bhāvānāmudayapralayayoḥ saṃvidoḥ nyūnādhikyābhāvāt	bhāvānām udaya pralayayoḥ saṃvidoḥ nyūna ādhikya abhāvāt 
MBbodhapancadasikaaHK-210	rudrakṣetrajñādipramātṛṣvapi cito nyūnādhikatayā	rudra kṣetrajña ādi pramātṛṣu api citaḥ nyūna adhikatayā 
MBbodhapancadasikaaHK-211	viśeṣābhāvātpūrṇatvaṃ na hīyate | yaduktaṃ brahmadarśane -	viśeṣa abhāvāt pūrṇa tvam na hīyate yat uktam brahmadarśane 
MBbodhapancadasikaaHK-212	yaiva cidgaganābhogabhūṣaṇe vyomni bhāskare | dharāvivarakoṣasthe	yā eva cit gagana ābhoga bhūṣaṇe vyomni bhāskare dharā vivara koṣa sthe 
MBbodhapancadasikaaHK-213	saiva citkīṭakodare ||	sā eva cit kīṭaka udare 
MBbodhapancadasikaaHK-214	p. 8)	p 
MBbodhapancadasikaaHK-215	iti | yathā pradeśākāśānāṃ mahākāśādanatiriktā vṛttirevaṃ	iti yathā pradeśa ākāśānām mahākāśāt anatiriktā vṛttiḥ evam 
MBbodhapancadasikaaHK-216	nīlādiprakāśānāṃ brahmaṇo bṛhattvena bṛṃhakatayā ca	nīla ādi prakāśānām brahmaṇaḥ bṛhat tvena bṛṃhaka tayā ca 
MBbodhapancadasikaaHK-217	tadanadhikavṛttitvamiti || 5 ||	tad anadhika vṛtti tvam iti 
MBbodhapancadasikaaHK-218	ata evābhinnāni kṛtyāni karoti parameśvaro na bhedamayānītyāha -	atas eva abhinnāni kṛtyāni karoti parameśvaraḥ na bheda mayāni iti āha 
MBbodhapancadasikaaHK-219	eṣa devo'nayā devyā nityaṃ krīḍārasotsukaḥ | vicitrān	eṣa devaḥ ūnayā devyā nityam krīḍā rasa utsukaḥ vicitrān 
MBbodhapancadasikaaHK-220	sṛṣṭisaṃhārān vidhatte yugapadvibhuḥ || 6 ||	sṛṣṭi saṃhārān vidhatte yugapad vibhuḥ 
MBbodhapancadasikaaHK-221	eṣa pratyabhijñāpadamārūḍho	eṣa pratyabhijñā padam ārūḍhaḥ 
MBbodhapancadasikaaHK-222	dyotanādilakṣaṇaściddevo'nayoktalakṣaṇayā parā vākrūpayā	dyotana ādi lakṣaṇaḥ cit devaḥ ūnayā ukta lakṣaṇayā parā vāc rūpayā 
MBbodhapancadasikaaHK-223	viśvollāsanādikrīḍāśīlatvād devyā devasambandhinyā vā	viśva ullāsana ādi krīḍā śīla tvāt devyāḥ deva sambandhinyāḥ vā 
MBbodhapancadasikaaHK-224	tatsamavāyadharmiṇyā saha nityamavirataṃ	tad samavāya dharmiṇyā saha nityam aviratam 
MBbodhapancadasikaaHK-225	tattadbhūmikāviṛmbhaṇe'pi avyucchinnatvāt sadoditāyāṃ	tad tad bhūmikā viṛmbhaṇe api avyucchinna tvāt sadā uditāyām 
MBbodhapancadasikaaHK-226	krīḍāyāṃ pañcakṛtyātmikāyāṃ yo raso'bhilāṣastatrotsuko	krīḍāyām pañcakṛtya ātmikāyām yaḥ rasaḥ abhilāṣaḥ tatra utsukaḥ 
MBbodhapancadasikaaHK-227	nirapekṣaṃ prasahya tatra pravartamānaḥ | yaduktam -	nirapekṣam prasahya tatra pravartamānaḥ yat uktam 
MBbodhapancadasikaaHK-228	sadā sṛṣṭivinodāya sadā sthitisukhāsine | sadā	sadā sṛṣṭi vinodāya sadā sthiti sukha āsine sadā 
MBbodhapancadasikaaHK-229	tribhuvanāhāratṛptāya svāmine namaḥ || (u0 sto0 22|9)	tribhuvana āhāra tṛptāya svāmine namaḥ u staḥ 
MBbodhapancadasikaaHK-230	iti | tathā -	iti tathā 
MBbodhapancadasikaaHK-231	pratikṣaṇamaviśrāntastrailokyaṃ kalpanāśataiḥ | kalpayannapi	pratikṣaṇam aviśrāntaḥ trailokyam kalpanā śataiḥ kalpayan api 
MBbodhapancadasikaaHK-232	ko'pyeko nirvikalpo jayatyajaḥ || (sta0 ci0 112)	kaḥ pi ekaḥ nirvikalpaḥ jayati ajaḥ 
MBbodhapancadasikaaHK-233	iti | tacca krīḍanaṃ vicitram tathāhi parābhūmau	iti tat ca krīḍanam vicitram tathā hi parā bhūmau 
MBbodhapancadasikaaHK-234	prakāśaghanatāmayānāṃ bhāvānāmavicchinnāvabhāsādinā	prakāśa ghana tā mayānām bhāvānām avicchinna avabhāsa ādinā 
MBbodhapancadasikaaHK-235	sadoditameva pañcakṛtyavidhayitvaṃ paśyantyāṃ	sadā uditam eva pañcakṛtya vidhayi tvam paśyantyām 
MBbodhapancadasikaaHK-236	codbhaviṣyatāmidantāvabhāsānāmahantārasodrekatayā tatrāpi	ca udbhaviṣyatām idantā avabhāsānām ahantā rasa udreka tayā tatra api 
MBbodhapancadasikaaHK-237	svāṅgakalpatvena bhedāsūtraṇāṃ	sva aṅga kalpa tvena bheda a sūtraṇām 
MBbodhapancadasikaaHK-238	vijṛmbhayitastadbhūmikāmāpannasya tādṛśameva kṛtyakāritvam	vijṛmbhayitar tad bhūmikām āpannasya tādṛśam eva kṛtya kāri tvam 
MBbodhapancadasikaaHK-239	madhyāyāṃ punarasphuṭatayābhāsamānānāṃ	madhyāyām punar asphuṭa tayā ābhāsamānānām 
MBbodhapancadasikaaHK-240	bhāvānāmahantāyāmevedantāpradhānyodrecaṇāt tādṛśabhe	bhāvānām ahantāyām eva idantā pradhānya udrecaṇāt tādṛśa bhe 
MBbodhapancadasikaaHK-241	vāsphuṭakalpaṃ kṛtyam saṃkocakāṣṭāyāṃ tu	vā asphuṭa kalpam kṛtyam saṃkoca kāṣṭāyām tu 
MBbodhapancadasikaaHK-242	māyīyapramātṛtāyāmapi sarvathā svātmavismṛtau tādṛśameva	māyīya pramātṛ tāyām api sarvathā sva ātma vismṛtau tādṛśam eva 
MBbodhapancadasikaaHK-243	bhedaikasāraṃ kṛtyam tatrāpi pramātṛ prakāśamantareṇa	bheda eka sāram kṛtyam tatra api pramātṛ prakāśam antareṇa 
MBbodhapancadasikaaHK-244	nīlādīnāmapratiṣṭhatvāt tatkṛtyaṃ prakāśamayameva parijñāya	nīla ādīnām apratiṣṭha tvāt tad kṛtyam prakāśa mayam eva parijñāya 
MBbodhapancadasikaaHK-245	ca yatpunaḥ svarūpalābhapratyāpattyā'ṇubhāvātsvātmano	ca yat punar sva rūpa lābha pratyāpattyā aṇu bhāvāt sva ātmanaḥ 
MBbodhapancadasikaaHK-246	vimuktirityāgameṣu parigīyate iti ata evāha vicitrāniti |	vimuktiḥ iti āgameṣu parigīyate iti atas eva āha vicitrān iti 
MBbodhapancadasikaaHK-247	p. 9)	p 
MBbodhapancadasikaaHK-248	naca brahmādivanniyataśaktayā saṃkucitatvānniyatameva	na ca brahma ādi vat niyata śaktayā saṃkucita tvāt niyatam eva 
MBbodhapancadasikaaHK-249	tadanyataratkartu śaknuyādityabhipretyāha - sṛṣṭisaṃhārāniti	tad anyatarat kartu śaknuyāt iti abhipretya āha sṛṣṭi saṃhārān iti 
MBbodhapancadasikaaHK-250	bahuvacanaṃ kṛtyāntarāṇāmupalakṣaṇārtham | tena	bahuvacanam kṛtyā antarāṇām upalakṣaṇa artham tena 
MBbodhapancadasikaaHK-251	sṛṣṭisthitisaṃhārapidhānānugrahān vidhatte karoti |	sṛṣṭi sthiti saṃhāra pidhāna anugrahān vidhatte karoti 
MBbodhapancadasikaaHK-252	kālādikṛto'tra na kaścinniyama ityāha - yugapaditi akrameṇa	kāla ādi kṛtaḥ utra na kaścid niyamaḥ iti āha yugapad iti akrameṇa 
MBbodhapancadasikaaHK-253	akālakalite parameśvare tatkramābhāvāt vibhuriti	akāla kalite parameśvare tad krama abhāvāt vibhuḥ iti 
MBbodhapancadasikaaHK-254	deśādyavachedaśūnyatve hetuḥ ata evākrameṇaiva	deśa ādi avacheda śūnya tve hetuḥ atas eva akrameṇa eva 
MBbodhapancadasikaaHK-255	vicitrāsvetāsvavasthāsu vicitrāṇāṃ sṛṣṭisaṃhārāṇāṃ	vicitrāsu etāsu avasthāsu vicitrāṇām sṛṣṭi saṃhārāṇām 
MBbodhapancadasikaaHK-256	kartṛtvamavicchinnam | atha ca kalpitapramātaryapi sadaiva	kartṛ tvam avicchinnam atha ca kalpita pramātari api sadā eva 
MBbodhapancadasikaaHK-257	sargādivinodāsaktaḥ parameśvaraḥ svasvātantryamāhātmyena	sarga ādi vinoda āsaktaḥ parameśvaraḥ sva svātantrya māhātmyena 
MBbodhapancadasikaaHK-258	karaṇeśvarīcakraṃ samullāsya paryāndolanakrīḍayā nikhilaṃ	                  
MBbodhapancadasikaaHK-259	prameyajātaṃ sṛṣṭikālyādyupārohaṇena prollāsayan paripāṭyā	                                             
MBbodhapancadasikaaHK-260	krameṇa vā kālasaṅkarṣaṇīdhāmni viśramya	krameṇa vā kāla saṅkarṣaṇī dhāmni viśramya 
MBbodhapancadasikaaHK-261	svātmaviśrāntirūpapūrṇāhaṃparāmarśacamatkāradhāmāsādayeti	sva ātma viśrānti rūpa pūrṇa ahaṃparāmarśa camatkāra dhām āsādaya iti 
MBbodhapancadasikaaHK-262	evameva bhūyobhūyaḥ krīḍārasautsukyena	evam eva bhūyas bhūyas krīḍā rasa autsukyena 
MBbodhapancadasikaaHK-263	vicitrasṛṣṭayādikāritvaṃ pariśīlayatīti	vicitra sṛṣṭayā ādi kāri tvam pariśīlayati iti 
MBbodhapancadasikaaHK-264	sahṛdayasaṃvedyametattanmukhādavagantavyam | gṛhītapaśubhūmikasya	sahṛdaya saṃvedyam etat tad mukhāt avagantavyam gṛhīta paśu bhūmikasya 
MBbodhapancadasikaaHK-265	śivasya etadevābhijñānaṃ yadāha śrīkṣemarājaḥ - tathāpi	śivasya etat eva abhijñānam yat āha śrī kṣemarājaḥ tathā api 
MBbodhapancadasikaaHK-266	tadvatpañcakṛtyāni karoti iti | ataḥ sarvamidaṃ svātantryasyaiva	tadvat pañcakṛtyāni karoti iti atas sarvam idam svātantryasya eva 
MBbodhapancadasikaaHK-267	vilasitamiti || 6 ||	vilasitam iti 
MBbodhapancadasikaaHK-268	tadāha -	tat āha 
MBbodhapancadasikaaHK-269	atidurghaṭakāritvamasyānuttarameva yat | etadeva	ati durghaṭa kāri tvam asya anuttaram eva yat etat eva 
MBbodhapancadasikaaHK-270	svatantratvamaiśvarya bodharūpatā || 7 ||	svatantra tvam aiśvarya bodha rūpa tā 
MBbodhapancadasikaaHK-271	evamasya svātantryaśālinaḥ parameśvarasya yadevābhinnasya	evam asya svātantrya śālinaḥ parameśvarasya yat eva abhinnasya 
MBbodhapancadasikaaHK-272	prakāśaikyenāvasthitasya grāhyagrāhakātmano	prakāśa aikyena avasthitasya grāhya grāhaka ātmanaḥ 
MBbodhapancadasikaaHK-273	viśvasyedantābhāvenāhantādhikyena sadāśive	viśvasya id anta abhāvena ahantā ādhikyena sadāśive 
MBbodhapancadasikaaHK-274	īṣasphuṭībhāveneśvare samadhṛtatulāpuṭanyāyena	īṣa sphuṭībhāvena īśvare sama dhṛta tulāpuṭa nyāyena 
MBbodhapancadasikaaHK-275	śuddhavidyāyāṃ bhedaikaprāṇeṃ'śuddhādhvani atyantabhedena	śuddhavidyāyām bheda eka prāṇa iṃśuddha adhvani atyanta bhedena 
MBbodhapancadasikaaHK-276	svasmādbahiravabhāsanaṃ yadapi bhāsitasyāpi punarabhedena svātmani	svasmāt bahis avabhāsanam yat api bhāsitasya api punar abhedena sva ātmani 
MBbodhapancadasikaaHK-277	prakāśaghane nimajjanaṃ nāmāmuttaramanāśritādibhyo'pi	prakāśa ghane nimajjanam nāma ām uttaram anāśrita ādibhyaḥ api 
MBbodhapancadasikaaHK-278	atyutkṛṣṭamatidurghaṭakāritvametadeva svatantratvaṃ svācchandyaṃ	atyutkṛṣṭam ati durghaṭa kāri tvam etat eva svatantra tvam svācchandyam 
MBbodhapancadasikaaHK-279	sarvaśaktikroḍīkāṃri tatraiva śaktyantarāṇyantarbhūya	tatra eva śakti antarāṇi antarbhūya 
MBbodhapancadasikaaHK-280	tanmūkhaprekṣitvāt tadākṣepyāṇyeva -	tad mūkha prekṣi tvāt tad ākṣepyāṇi eva 
MBbodhapancadasikaaHK-281	p. 10)	p 
MBbodhapancadasikaaHK-282	ata eva svātantryameva mukhyamaiśvarya	atas eva svātantryam eva mukhyam aiśvarya 
MBbodhapancadasikaaHK-283	yenānuttarānandādyuduyakrameṇa visargaparyantena yāmalaprasareṇa	yena anuttara ānanda ādi uduya krameṇa visarga paryantena yāmala prasareṇa 
MBbodhapancadasikaaHK-284	vā mātṛkāmālinībhāvametya tattadvicitravācyavācakātmanā	vā mātṛkā mālinī bhāvam etya tad tad vicitra vācya vācaka ātmanā 
MBbodhapancadasikaaHK-285	vaiśvarūpyeṇa prasphuraṇam | yaduktam -	vaiśvarūpyeṇa prasphuraṇam yat uktam 
MBbodhapancadasikaaHK-286	tasmādanuttaro devaḥ svācchandyānuttaratvataḥ |	tasmāt anuttaraḥ devaḥ svācchandya anuttara tvataḥ 
MBbodhapancadasikaaHK-287	visargaśaktiyuktatvāt saṃpanno viśvarūpakaḥ ||	visarga śakti yukta tvāt saṃpannaḥ viśva rūpakaḥ 
MBbodhapancadasikaaHK-288	iti | asvatantrasya hi anīśvaratayā viśvamudbhāvayitumasāmarthyāt	iti asvatantrasya hi anīśvara tayā viśvam udbhāvayitum asāmarthyāt 
MBbodhapancadasikaaHK-289	viśvavisarge tathā pañcavidhakṛtyakāritve ca svātantryasyaiva	viśva visarge tathā pañcavidha kṛtya kāri tve ca svātantryasya eva 
MBbodhapancadasikaaHK-290	mukhyanimattatvāt | yaduktaṃ pratyabhijñāyāma -	mukhya nimatta tvāt 
MBbodhapancadasikaaHK-291	citiḥ pratyavamarśātmā parāvāksvarasoditā |	                      
MBbodhapancadasikaaHK-292	svātantryametanmukhyaṃ tadaiśvaryaṃ paramātmanaḥ ||	svātantryam etat mukhyam tat aiśvaryam paramātmanaḥ 
MBbodhapancadasikaaHK-293	sā sphurattā mahāsattā deśakālāviśeṣiṇī | saiṣā sāratayā	sā sphurat tā mahāsattā deśa kāla a viśeṣiṇī sā eṣā sāra tayā 
MBbodhapancadasikaaHK-294	proktā hṛdayaṃ parameṣṭhinaḥ || ī0 pra0 (1|513)	proktāḥ hṛdayam parameṣṭhinaḥ 
MBbodhapancadasikaaHK-295	iti | aiśvaryamapyasyāparicchinnameva paricchede hi	iti aiśvaryam api asya aparicchinnam eva paricchede hi 
MBbodhapancadasikaaHK-296	brahmaviṣṇavādivanniyataiṃkatarakārye vyāpriya	brahma viṣṇava ādi vat niyata eṃkatara kārye 
MBbodhapancadasikaaHK-297	māṇatvādanīśvaratvameva eṣaiva bodharūpatā	māṇa tvāt anīśvara tvam eva eṣā eva bodha rūpa tā 
MBbodhapancadasikaaHK-298	jaḍaprakāśārdevailakṣaṇyāpādakatvādvimarśamayaṃ	jaḍa prakāśa ārde vailakṣaṇya āpādaka tvāt vimarśa mayam 
MBbodhapancadasikaaHK-299	bodharūpatvam | yaduktaṃ śrīpratyabhijñāyām -	bodha rūpa tvam yat uktam śrī pratyabhijñāyām 
MBbodhapancadasikaaHK-300	ātmāta eva caitanyaṃ citkriyā citikartṛtā | tātparyeṇoditastena	ātmā atas eva caitanyam cit kriyā citi kartṛ tā tātparyeṇa uditaḥ tena 
MBbodhapancadasikaaHK-301	jaḍātsa hi vilakṣaṇaḥ || ī0 pra0 (1|5|12)	jaḍāt sa hi vilakṣaṇaḥ 
MBbodhapancadasikaaHK-302	iti | anyathā svātantryavikalasya bodhasya	iti anyathā svātantrya vikalasya bodhasya 
MBbodhapancadasikaaHK-303	vijñānākalavadabodharūpatvānmalākrāntatvaṃ durvāraṃ syāditi	vijñānākala vat abodha rūpa tvāt mala ākrānta tvam durvāram syāt iti 
MBbodhapancadasikaaHK-304	nanu kiṃ nāma bodharūpatvaṃ yadabodhādvilakṣaṇamityāśaṃkya	nanu kim nāma bodha rūpatvam yat abodhāt vilakṣaṇam iti āśaṃkya 
MBbodhapancadasikaaHK-305	tallakṣaṇaṃ nirūpayannāha -	tad lakṣaṇam nirūpayan āha 
MBbodhapancadasikaaHK-306	paricchinnaprakāsatvaṃ jaḍasya kila lakṣaṇam | jaḍādvilakṣaṇo	paricchinna prakāsa tvam jaḍasya kila lakṣaṇam 
MBbodhapancadasikaaHK-307	bodho yato na parimīyate || 8 ||	bodhaḥ yatas na parimīyate 
MBbodhapancadasikaaHK-308	jaḍaprakāśasya svaprakāśasvabhāvatvābhāvāt	jaḍa prakāśasya sva prakāśa svabhāva tva abhāvāt 
MBbodhapancadasikaaHK-309	svātmānamapyavabhāsayituṃ sāmarthyaṃ nāsti kā kathā parasya	sva ātmānam api avabhāsayitum sāmarthyam nā asti kā kathā parasya 
MBbodhapancadasikaaHK-310	prakāśane tatrānelamūkatvādvodhasvabhāvādhirohaṇānupapattiḥ |	prakāśane tatra anela mūka tvāt vodha svabhāva adhirohaṇa anupapattiḥ 
MBbodhapancadasikaaHK-311	p. 11)	p 
MBbodhapancadasikaaHK-312	jaḍo hi kila deśakālākāraviśeṣito bodhena paricchidyate	jaḍaḥ hi kila deśa kāla ākāra viśeṣitaḥ bodhena paricchidyate 
MBbodhapancadasikaaHK-313	pratiyogivyavacchedena aghaṭādvyavacchinno ghaṭa	            
MBbodhapancadasikaaHK-314	ivātadvyapohanapūrvatadadhyavasāyajīvitatāmāśrayatīti	iva a tad vyapohana pūrva tad adhyavasāya jīvita tām āśrayati iti 
MBbodhapancadasikaaHK-315	ityetajjaḍasya lakṣaṇam tacca pramātrāśrayaṃ mamedaṃ bhātīti	iti etat jaḍasya lakṣaṇam tat ca pramātṛ āśrayam mama idam bhāti iti 
MBbodhapancadasikaaHK-316	jīvantaṃ pramātāramāśrityaiva ghaṭādayaḥ parisphuranti naiva	jīvantam pramātāram āśritya eva ghaṭa ādayaḥ parisphuranti nā eva 
MBbodhapancadasikaaHK-317	teṣāṃ nijaṃ kimapi prakāśamānatvam kalpitasyāpi	teṣām nijam kim api prakāśamāna tvam kalpitasya api 
MBbodhapancadasikaaHK-318	pramāturjaḍaikaśaraṇatvāt tatpakṣapātitvam tasmāt	pramātuḥ jaḍa eka śaraṇa tvāt tad pakṣapāti tvam tasmāt 
MBbodhapancadasikaaHK-319	saṃvinmayapramātaryeva parimīyamānasya jaḍaprakāśasya	saṃvid maya pramātari eva parimīyamānasya jaḍa prakāśasya 
MBbodhapancadasikaaHK-320	pratiṣṭhānam tadvailakṣaṇyena hi bodho	pratiṣṭhānam tad vailakṣaṇyena hi bodho 
MBbodhapancadasikaaHK-321	deśādiviśeṣānākalitatvena paricchedapadavīmanārūḍho naiva	deśa ādi viśeṣān ākalita tvena pariccheda padavīm an ārūḍhaḥ nā eva 
MBbodhapancadasikaaHK-322	parimīyate | deśādeḥ paricchedakasyāpi prakāśasvabhāvād	parimīyate deśa ādeḥ paricchedakasya api prakāśa svabhāvāt 
MBbodhapancadasikaaHK-323	vyatiriktāvyatiriktavikalpopahatatvāt | nāpi bodhavyatiriktasya	vyatirikta avyatirikta vikalpa upahata tvāt na api bodha vyatiriktasya 
MBbodhapancadasikaaHK-324	pramātrantarasyāsatvāt tena kriyamāṇasya	pramātṛ antarasya a sattvāt tena kriyamāṇasya 
MBbodhapancadasikaaHK-325	atadvyapohanasyābhāvenāhamātmikābodhaviśrāntirvikalpāspadamiyād	a tad vyapohanasya abhāvena aham ātmikā bodha viśrāntiḥ vikalpa āspadam iyāt 
MBbodhapancadasikaaHK-326	iti prakāśaviśrāntirasākeṅtirkītyādi atra jaḍādvelakṣaṇyaṃ	iti atra jaḍāt velakṣaṇyam 
MBbodhapancadasikaaHK-327	bodhyam | yaduktam -	bodhyam yat uktam 
MBbodhapancadasikaaHK-328	prakāśasyātmaviśrāntirahambhāvo hi kīrtitaḥ | uktā saiva ca	prakāśasya ātma viśrāntiḥ ahambhāvaḥ hi kīrtitaḥ uktā sā eva ca 
MBbodhapancadasikaaHK-329	viśrāntiḥ sarvāpekṣānirodhataḥ ||	          
MBbodhapancadasikaaHK-330	svātantryamatha kartṛtvaṃ mukhyamīśvaratāpi ca (aja0 pra0 si0 23)	svātantryam atha kartṛ tvam mukhyam īśvara tā api ca 
MBbodhapancadasikaaHK-331	iti | etadeva bodhasya svaprakāśatvaṃ yat svayaṃ bhāsamānaḥ	iti etat eva bodhasya sva prakāśa tvam yat svayam bhāsamānaḥ 
MBbodhapancadasikaaHK-332	paramapi bhāsayan svasvātantryātmyamapācamatkaroti paramapi	param api bhāsayan sva svātantrya ātmyam apācamatkaroti param api 
MBbodhapancadasikaaHK-333	svāhantāsaṃrambhātprakāśayatīti || 8 ||	svāhantā saṃrambhāt prakāśayati iti 
MBbodhapancadasikaaHK-334	svātantryāvabhāsitāḥ sṛṣṭayādayo'pi na bhinnaviṣayā ityāha	svātantrya avabhāsitāḥ sṛṣṭi ādayaḥ api na bhinna viṣayāḥ iti āha 
MBbodhapancadasikaaHK-335	evamasya svatantrasya nijaśaktyupabhedinaḥ | svātmagāḥ	evam asya svatantrasya nija śakti upabhedinaḥ sva ātma gāḥ 
MBbodhapancadasikaaHK-336	sṛṣṭisaṃhārāḥ svarūpatvena saṃsthitāḥ || 9 ||	sṛṣṭi saṃhārāḥ sva rūpa tvena saṃsthitāḥ 
MBbodhapancadasikaaHK-337	evamayaṃ parameśvaraḥ svatantro nijayā svābhinnayā	evam ayam parameśvaraḥ svatantraḥ nijayā sva abhinnayā 
MBbodhapancadasikaaHK-338	svasamavetatvāt śaktyā svātatryeṇa viśvasisṛkṣātmakena	sva samaveta tvāt śaktyā svātatryeṇa viśva sisṛkṣā ātmakena 
MBbodhapancadasikaaHK-339	bhedamupagacchati anāśritaśivādārabhya	bhedam upagacchati anāśrita śivāt ārabhya 
MBbodhapancadasikaaHK-340	sakalāntapramātṛvargaparyantaṃ pāñcadaśyādibhedena	                    
MBbodhapancadasikaaHK-341	tadanurūpaprameyabhedenāpi jaḍājaḍātmāvabhedamāpadyate |	tad anurūpa prameya bhedena api jaḍa a jaḍa ātma avabhedam āpadyate 
MBbodhapancadasikaaHK-342	p. 12)	p 
MBbodhapancadasikaaHK-343	arthācchaktireva tattadbhāvamaṇḍalarūpeṇollasantī	arthāt śaktiḥ eva tad tad bhāva maṇḍala rūpeṇa ullasantī 
MBbodhapancadasikaaHK-344	vividhavācyavācakatāṃ bhajate śaktimānpunaḥ sarvasya	vividha vācya vācaka tām bhajate śaktimān punar sarvasya 
MBbodhapancadasikaaHK-345	svātantryasāratvādeka evācyutaprācyasvarūpaḥ kevalaṃ	svātantrya sāra tvāt ekaḥ evā acyuta prācya svarūpaḥ kevalam 
MBbodhapancadasikaaHK-346	parasparalolībhāvaṃ prāptānāṃ śaktīnāṃ	paraspara lolībhāvam prāptānām śaktīnām 
MBbodhapancadasikaaHK-347	bhāsanoparañjanādibhirāpātato bhedopabheditvamiva yāti na	bhāsana uparañjana ādibhiḥ āpātataḥ bheda upabhedi tvam iva yāti na 
MBbodhapancadasikaaHK-348	punastasya saḍrakocāvabhāsamamātraṃ vinānyatpriṇāmavivartādi	punar tasya vinā anyat priṇāma vivarta ādi 
MBbodhapancadasikaaHK-349	saṃbhavitumarhati | pariṇāmavivartādestu	saṃbhavitum arhati pariṇāma vivarta ādeḥ tu 
MBbodhapancadasikaaHK-350	rūpāntaratadanyathābhāvatve bodhasvabhāvaṃ prati	rūpa antara tad anyathā bhāva tve bodha svabhāvam prati 
MBbodhapancadasikaaHK-351	tadviruddhāprakāśatvaṃ prasajyate | tatprasaktāvapi	tad viruddha aprakāśa tvam prasajyate tad prasaktau api 
MBbodhapancadasikaaHK-352	viśvasyāndhatamasaprakhyatvāt vyavahāravipralopaḥ syāditi |	viśvasya andhatamasa prakhya tvāt vyavahāra vipralopaḥ syāt iti 
MBbodhapancadasikaaHK-353	tatreyati bhedaparigrahe parameśvarasya	tatra iyati bheda parigrahe parameśvarasya 
MBbodhapancadasikaaHK-354	pūrṇāhantāścamatkārasāraviśvamayatvādviśvagatāḥ	                                        
MBbodhapancadasikaaHK-355	sṛṣṭisaṃhārāḥ svātmagāḥ svābhinnāḥ	sṛṣṭi saṃhārāḥ sva ātma gāḥ sva abhinnāḥ 
MBbodhapancadasikaaHK-356	pañcavidhakṛtyānāmupalakṣaṇametat śivapade prakāśaikyena	pañcavidha kṛtyānām upalakṣaṇam etat śiva pade prakāśa aikyena 
MBbodhapancadasikaaHK-357	sthitatvātsvarūpatve na svāṅgakalpatāya | saṃsthitāḥ |	sthita tvāt sva rūpa tve na sva aṅga kalpatāya saṃsthitāḥ 
MBbodhapancadasikaaHK-358	arvākpade'pi śrīkaṇṭhāghorabhaṭṭārakādibhiḥ kriyamāṇasya	arvāk pade api śrīkaṇṭha aghora bhaṭṭāraka ādibhiḥ kriyamāṇasya 
MBbodhapancadasikaaHK-359	sargādeḥ saṃvitprakāśādabahiravasthitatvāt tanmayatvameveti	sarga ādeḥ saṃvid prakāśāt abahir avasthita tvāt tad maya tvam eva iti 
MBbodhapancadasikaaHK-360	tatrāpi na manāgapi vibhedakalanāyā viṣayībhavantīti yaduktam -	tatra api na manāk api vibheda kalanāyāḥ viṣayībhavanti iti yat uktam 
MBbodhapancadasikaaHK-361	iti || 9 ||	iti 
MBbodhapancadasikaaHK-362	nanvitthaṃ sarvataḥ svasvātantryasya vilasitatve kathamaṇūnāṃ	nanu ittham sarvatas sva svātantryasya vilasita tve katham aṇūnām 
MBbodhapancadasikaaHK-363	bandho bhavatītyāśaṃkya yugmemāha -	bandhaḥ bhavati iti āśaṃkya yugmema āha 
MBbodhapancadasikaaHK-364	teṣu vaicitryamatyantamūrdhvādhastiryageva yat | bhuvanāni	teṣu vaicitryam atyantam ūrdhva adhas tiryak eva yat bhuvanāni 
MBbodhapancadasikaaHK-365	tadaṃśāśca sukhaduḥkhamatiśca yā || 10 ||	tad aṃśāḥ ca sukha duḥkha matiḥ ca yā 
MBbodhapancadasikaaHK-366	yadetasyāparijñānaṃ tatsvātantryaṃ hi varṇitam | sa eva khalu	yat etasya aparijñānam tat svātantryam hi varṇitam saḥ eva khalu 
MBbodhapancadasikaaHK-367	saṃsāro mūḍhānāṃ yo vibhīṣakaḥ || 11 ||	saṃsāraḥ mūḍhānām yaḥ vibhīṣakaḥ 
MBbodhapancadasikaaHK-368	teṣu sargādiṣu pañcavidhakṛtyeṣu	teṣu sarga ādiṣu pañcavidha kṛtyeṣu 
MBbodhapancadasikaaHK-369	aparādiśaktyullāsāddarpaṇanagarādivadbhedābhedaparāmarśato	apara ādi śakti ullāsāt darpaṇa nagara ādi vat bheda abheda parāmarśataḥ 
MBbodhapancadasikaaHK-370	bhedaikamayatvaparāmarśanāccātyantaṃ yadvaicitryaṃ yadvā	bheda eka maya tva parāmarśanāt ca atyantam yat vaicitryam yat vā 
MBbodhapancadasikaaHK-371	kramākramābhyāṃ viśvatra yatsargādivaicitryaṃ kramohi	kramākramābhyām viśvatra yat sarga ādi vaicitryam 
MBbodhapancadasikaaHK-372	niyatyadhīnaḥ parameśvarasya	niyati adhīnaḥ parameśvarasya 
MBbodhapancadasikaaHK-373	svatantratvānniyatiśaktimukhaprekṣitvābhāvānna kāpi paripāṭī	svatantra tvāt niyati śakti mukhaprekṣi tva abhāvāt na kā api paripāṭī 
MBbodhapancadasikaaHK-374	apekṣyate | ata eva sa svecchayaiva krameṇākrameṇa vā	apekṣyate atas eva sa sva icchayā eva krameṇa akrameṇa vā 
MBbodhapancadasikaaHK-375	karotītyarthaḥ | yaccaiṃva	karoti iti arthaḥ yat ca eṃva 
MBbodhapancadasikaaHK-376	ūrdhvādhastiryakatattatsanniveśaviśiṣṭāni sargādigocarāṇi	ūrdhva adhas tiryaka tad tad sanniveśa viśiṣṭāni sarga ādi gocarāṇi 
MBbodhapancadasikaaHK-377	bhuvanāni	bhuvanāni 
MBbodhapancadasikaaHK-378	kālāgnyāderanāśritāntamaṣṭādaśādhikaśatasaṃkhyāni	kālāgni ādeḥ anāśrita antam aṣṭādaśa adhika śata saṃkhyāni 
MBbodhapancadasikaaHK-379	saṃkṣepeṇāgameṣvāmnātāni |	saṃkṣepeṇa āgameṣu āmnātāni 
MBbodhapancadasikaaHK-380	p. 13)	p 
MBbodhapancadasikaaHK-381	yaduktaṃ śrīpūrvaśāstre -	           
MBbodhapancadasikaaHK-382	evaṃ tu sarvatattveṣu śatamaṣṭādaśottaram | bhuvanānāṃ	evam tu sarva tattveṣu śatam aṣṭādaśa uttaram bhuvanānām 
MBbodhapancadasikaaHK-383	parijñeyaṃ saṃk.epānnatu vistarāt ||	parijñeyam saṃkepāt na tu vistarāt 
MBbodhapancadasikaaHK-384	iti vistareṇa tu bhuvanānāmānantyameva yacca tadaṃśā	iti vistareṇa tu bhuvanānām ānantyam eva yat ca tad aṃśā 
MBbodhapancadasikaaHK-385	bhuvanānāmaneke purādivibhāgāḥ tathā	bhuvanānām aneke purā ādi vibhāgāḥ tathā 
MBbodhapancadasikaaHK-386	tattadbhuvanādyadhiṣṭāt-ṝṇāmupāsanābhiḥ	tad tad bhuvana ādi adhiṣṭātṝṇām upāsanābhiḥ 
MBbodhapancadasikaaHK-387	tattatsālokyādyavāpterniyatakālaṃ	tad tad sālokya ādi avāpteḥ niyata kālam 
MBbodhapancadasikaaHK-388	tadīyaiśvaryopabhogaparisamāptau tadūrdhvabhuvaneśapadaprāptiḥ	tadīya aiśvarya upabhoga parisamāptau tad ūrdhva bhuvana īśa pada prāptiḥ 
MBbodhapancadasikaaHK-389	tatrāpi tadaiśvaryādisukhānubhavaḥ	tatra api tad aiśvarya ādi sukha anubhavaḥ 
MBbodhapancadasikaaHK-390	āgamoktaśumācaraṇādyasevanāccādhīdho nirayapāte	āgama ukta śuma ācaraṇa ādi asevanāt ca adhīdhaḥ niraya pāte 
MBbodhapancadasikaaHK-391	anaiśvaryādyākrānterdurgatikleśānubhavaḥ itthaṃ ca yā teṣu	anaiśvarya ādi ākrānteḥ durgati kleśa anubhavaḥ ittham ca yā teṣu 
MBbodhapancadasikaaHK-392	sukhaduḥkhamatiryena śubhāśubhakarmasevanāt karmānurūpaṃ tatra	sukha duḥkha matiḥ yena śubha aśubha karma sevanāt karma anurūpam tatra 
MBbodhapancadasikaaHK-393	tatra saṃsaraṇam | saṃvitprakāśa eva	tatra saṃsaraṇam saṃvid prakāśaḥ eva 
MBbodhapancadasikaaHK-394	svasvātantryamāhātmyātiśayānmūrtivaicitryeṇa	sva svātantrya māhātmya atiśayāt mūrti vaicitryeṇa 
MBbodhapancadasikaaHK-395	deśādhvānamunmīlayati sa eva bhuvanatattvakalātmavācyaṃ tatra	deśa adhvānam unmīlayati saḥ eva bhuvana tattva kalā ātma vācyam tatra 
MBbodhapancadasikaaHK-396	mukhyaṃ vācyaṃ bhuvanāni tattvakalayostadantarbhāvāt |	mukhyam vācyam bhuvanāni tattva kalayoḥ tad antarbhāvāt 
MBbodhapancadasikaaHK-397	bhuvanādīnyapi parameśvarānna vyatiriktāni	bhuvana ādīni api parameśvarāt na vyatiriktāni 
MBbodhapancadasikaaHK-398	tathātve'prakāśyamānatvāttatsattvānupattiḥ tasmātsaṃvideva	tathātve prakāśyamāna tvāt tad sattva anupattiḥ tasmāt saṃvid eva 
MBbodhapancadasikaaHK-399	tathā tathā bahiḥ prasphuratīti | yaduktam -	tathā tathā bahis prasphurati iti yat uktam 
MBbodhapancadasikaaHK-400	mūrtivaicitryato deśakramamābhāsayatyasau |	mūrti vaicitryataḥ deśa kramam ābhāsayati asau 
MBbodhapancadasikaaHK-401	iti | tathā -	iti tathā 
MBbodhapancadasikaaHK-402	āśyānaṃ cidrarasasyaughaṃ sākāratvamupāgatam | jagadrūpatayā	āśyānam cidra rasasya ogham sa ākāra tvam upāgatam jagat rūpa tayā 
MBbodhapancadasikaaHK-403	vande pratyakṣaṃ bhairavaṃ vapuḥ ||	vande pratyakṣam bhairavam vapuḥ 
MBbodhapancadasikaaHK-404	iti | tathā -	iti tathā 
MBbodhapancadasikaaHK-405	adhvā samasta evāyaṃ cinmātre saṃpratiṣṭhitaḥ | yattatra nahi	adhvā samastaḥ eva ayam cit mātre saṃpratiṣṭhitaḥ yat tatra nahi 
MBbodhapancadasikaaHK-406	viśrāntaṃ tannabhaḥkusumāyate || (taṃ 8|3)	viśrāntam tat nabhaḥkusumāyate tam 
MBbodhapancadasikaaHK-407	iti ca || 11 ||	iti ca 
MBbodhapancadasikaaHK-408	p. 14)	p 
MBbodhapancadasikaaHK-409	yadetasya	yat etasya 
MBbodhapancadasikaaHK-410	bhuvanatadaṃśādestattvādyadhvāntarāṇāmupalakṣaṇībhūtasyāpar	bhuvana tad aṃśa ādeḥ tattva ādi adhva antarāṇām upalakṣaṇībhūtasya apar 
MBbodhapancadasikaaHK-411	ijñānaṃ svātantryameva bhuvanādyātmanā prasarati	ijñānam svātantryam eva bhuvana ādi ātmanā prasarati 
MBbodhapancadasikaaHK-412	etadityetasyāpratyabhijñānaṃ	etat iti etasya a pratyabhijñānam 
MBbodhapancadasikaaHK-413	tadviparītaduḥkhādyākulitabandhaparidṛṣṭiḥ taddhi	tad viparīta duḥkha ādi ākulita bandha paridṛṣṭiḥ tat hi 
MBbodhapancadasikaaHK-414	svātantryamatidurghaṭakāritvasaṃpādanasāmarthyaṃ varṇitam	svātantrya mati durghaṭa kāri tva saṃpādana sāmarthyam varṇitam 
MBbodhapancadasikaaHK-415	yaduktam -	yat uktam 
MBbodhapancadasikaaHK-416	anāvṛte svarūpe'pi yadātmācchādanaṃ vibhoḥ | saiva māyā yato	anāvṛte svarūpe api yat ātma ācchādanam vibhoḥ sā eva māyā yatas 
MBbodhapancadasikaaHK-417	bheda etāvānviśvavṛttikaḥ || (taṃ 4|11)	bhedaḥ etāvān viśvavṛttikaḥ tam 
MBbodhapancadasikaaHK-418	tathā ca paramārthasāre -	tathā ca paramārthasāre 
MBbodhapancadasikaaHK-419	paramaṃ yatsvātantryaṃ durghaṭasaṃpādanaṃ maheśasya | devī	paramam yat svātantryam durghaṭa saṃpādanam maheśasya devī 
MBbodhapancadasikaaHK-420	māyāśaktiḥ svātmāvaraṇaṃ śivasyaitat ||	māyā śaktiḥ sva ātma āvaraṇam śivasya etat 
MBbodhapancadasikaaHK-421	iti | sa eva khalu jaḍānāṃ māyāmohitānāṃ saṃsāro yo	iti saḥ eva khalu jaḍānām māyā mohitānām saṃsāraḥ yaḥ 
MBbodhapancadasikaaHK-422	vibhīṣako rajjubhujaṅgabhramavanmaraṇāditrāsajananaḥ | ayaṃ	vibhīṣakaḥ rajju bhujaṅga bhrama vat maraṇa ādi trāsa jananaḥ ayam 
MBbodhapancadasikaaHK-423	bhāvaḥ yathā bhrāntyā vikalpakalpite'rthaśūnye vastuni	bhāvaḥ yathā bhrāntyā vikalpa kalpita īrtha śūnye vastuni 
MBbodhapancadasikaaHK-424	raudrādyākṛtisaṃbhāvanayā bhīṣaṇīyamākāraviśeṣaṃ	raudra ādi ākṛti saṃbhāvanayā bhīṣaṇīyam ākāra viśeṣam 
MBbodhapancadasikaaHK-425	samullikhyānarthakāriṇīṃ tadarthakriyāṃ dhatte evameva	samullikhya anartha kāriṇīm tad artha kriyām dhatte evam eva 
MBbodhapancadasikaaHK-426	svasvātantryāparijñānādaṇutāmāpannaḥ svātmā	sva svātantrya aparijñānāt aṇu tām āpannaḥ sva ātmā 
MBbodhapancadasikaaHK-427	varṇāśramajātyādyabhimānena nibadhyate prabuddhā hi svātmamayaṃ	varṇa āśrama jāti ādi abhimānena nibadhyate prabuddhāḥ hi sva ātma mayam 
MBbodhapancadasikaaHK-428	viśvamantarbahīrūpatayā pratyabhijānānāḥ saṃsārānmucyante	viśvam antar bahis rūpa tayā pratyabhijānānāḥ saṃsārāt mucyante 
MBbodhapancadasikaaHK-429	naca tadaparijñāne kimapi svātmagopanāsatattvakrīḍāṃ vinā	na ca tad aparijñāne kim api sva ātma gopanā sa tattva krīḍām vinā 
MBbodhapancadasikaaHK-430	kāraṇamutpaśyāmaḥ tathā tathā nigūhitaparamārthatvena	kāraṇam utpaśyāmaḥ tathā tathā nigūhita parama artha tvena 
MBbodhapancadasikaaHK-431	yanmaheśvarasya prasaradrūpatvaṃ tadapi tasya svātantryameva | iyaṃ	yat maheśvarasya prasarat rūpa tvam tat api tasya svātantryam eva iyam 
MBbodhapancadasikaaHK-432	hi vimarśalatā viśvasisṛkṣayā prasarantī krameṇa	hi vimarśa latā viśva sisṛkṣayā prasarantī krameṇa 
MBbodhapancadasikaaHK-433	vācyavācakātmaṣaḍadhvātmanā pallavitājñānāṃ	vācya vācaka ātma ṣaḍadhva ātmanā pallavita ajñānām 
MBbodhapancadasikaaHK-434	bandhayitrītyarthaḥ | yadāha spande -	bandhayitrī iti arthaḥ yat āha spande 
MBbodhapancadasikaaHK-435	seyaṃ kriyātmikā śaktiḥ śivasya paśuvartinī | bandhayitrī	sā iyam kriyā ātmikā śaktiḥ śivasya paśu vartinī bandhayitrī 
MBbodhapancadasikaaHK-436	svamārgasthā jñātā siddhyupapādikā ||	           
MBbodhapancadasikaaHK-437	iti || 11 ||	iti 
MBbodhapancadasikaaHK-438	nanu svātantryapratyabhijñānaṃ saṃsārācca viratiḥ	nanu svātantrya pratyabhijñānam saṃsārāt ca viratiḥ 
MBbodhapancadasikaaHK-439	kathamaṇorbhavatītyāśaṃkya yugalakenāha -	katham aṇoḥ bhavati iti āśaṃkya yugalakena āha 
MBbodhapancadasikaaHK-440	p. 15)	p 
MBbodhapancadasikaaHK-441	tatprasādarasādeva gurvāgamata eva vā | śāstrādvā parameśasya	tad prasāda rasāt eva guru āgamataḥ eva vā śāstrāt vā parameśasya 
MBbodhapancadasikaaHK-442	yasmātkasmādupāgatam || 12 ||	yasmāt kasmāt upāgatam 
MBbodhapancadasikaaHK-443	yattattvasya parijñānaṃ sa mokṣaḥ parameśataḥ | tatpūrṇatvaṃ	yat tattvasya parijñānam sa mokṣaḥ parameśataḥ tat pūrṇa tvam 
MBbodhapancadasikaaHK-444	prabuddhānāṃ jīvanmuktiśca sā smṛtā || 13 ||	prabuddhānām jīvanmuktiḥ ca sā smṛtā 
MBbodhapancadasikaaHK-445	viśvamayatadutīrṇasvasvarūpaṃ pratyabhijñātuṃ kimapi tapaḥ	viśva maya tad utīrṇa sva svarūpam pratyabhijñātum kim api tapaḥ 
MBbodhapancadasikaaHK-446	pūjākramādi na pragalbhate tasya	pūjā krama ādi na pragalbhate tasya 
MBbodhapancadasikaaHK-447	māyīyatvenāndhatamasaprakhyatvādamāyīyaṃ saṃvitprakāśaṃ	māyīya tvena andhatamasa prakhya tvāt amāyīyam saṃvid prakāśam 
MBbodhapancadasikaaHK-448	prakāśayitumasāmarthyāt | svātmopalabdhau	prakāśayitum asāmarthyāt sva ātma upalabdhau 
MBbodhapancadasikaaHK-449	tapovairāgyādyapekṣāyāmapi tatsaṃpatteḥ	tapaḥ vairāgya ādi apekṣāyām api tad saṃpatteḥ 
MBbodhapancadasikaaHK-450	kāraṇāntaramanveṣṭavyaṃ tatrāpi	kāraṇa antaram anveṣṭavyam tatra api 
MBbodhapancadasikaaHK-451	kāraṇāntaramityanavasthāpātastathā ca svātantryaṃ hīnaṃ bhavet	kāraṇa antaram iti anavasthā pātaḥ tathā ca svātantryam hīnam bhavet 
MBbodhapancadasikaaHK-452	tasmātparameśvaraḥ svecchayeva viśvakrīḍāmudvibhāsayiṣuḥ	tasmāt parameśvaraḥ sva icchayā iva viśva krīḍām udvibhāsayiṣuḥ 
MBbodhapancadasikaaHK-453	svaśaktyā tirodhānākhyayā svātmānaṃ tirodhāya punarapi	sva śaktyā tirodhāna ākhyayā sva ātmānam tirodhāya punar api 
MBbodhapancadasikaaHK-454	tayaivānugrahākhyayā pratyabhijñāya svamudveṣṭayate	tayā eva anugraha ākhyayā pratyabhijñāya svam udveṣṭayate 
MBbodhapancadasikaaHK-455	taccodvaṣṭanaṃ paraśaktipātavaśātpratibhāprasādanapūrvaṃ	tat ca udvaṣṭanam para śaktipāta vaśāt pratibhā prasādana pūrvam 
MBbodhapancadasikaaHK-456	svātmaśivatāpratyabhijñānaṃ śaktipātavaicitryādbahudhā	sva ātma śiva tā pratyabhijñānam śaktipāta vaicitryāt bahudhā 
MBbodhapancadasikaaHK-457	bhavāti ityāśayena śaktipātakāryāṇi nirūpayannāha taditi	iti āśayena śaktipāta kāryāṇi nirūpayan āha tat iti 
MBbodhapancadasikaaHK-458	kaścittīvraraśaktipāta pavitritahṛdayaḥ	kaścid tīvra raśaktipāta pavitrita hṛdayaḥ 
MBbodhapancadasikaaHK-459	siddhayoginīdarśanacarubhojanādinānupāyapathena svātmānaṃ	siddha yoginī darśana caru bhojana ādinā anupāya pathena sva ātmānam 
MBbodhapancadasikaaHK-460	pratyabhijānātīti | yaduktaṃ tantrāloke -	pratyabhijānāti iti yat uktam tantrāloke 
MBbodhapancadasikaaHK-461	siddhānāṃ yoginīnāṃ ca darśanaṃ carubhojanam | kathanaṃ	siddhānām yoginīnām ca darśanam caru bhojanam kathanam 
MBbodhapancadasikaaHK-462	saṃkramaḥ śāstre sādhanaṃ gurusevanam ||	saṃkramaḥ śāstre sādhanam guru sevanam 
MBbodhapancadasikaaHK-463	ityādyo nirupāyasya saṃkṣopo'yaṃ varānane | iti	iti ādyaḥ nirupāyasya saṃkṣopaḥ yam varānane iti 
MBbodhapancadasikaaHK-464	ata evoktam - tatprasādarasādeva iti evaśabdaḥ kāraṇāntaraṃ	atas eva uktam tad prasāda rasāt eva iti eva śabdaḥ kāraṇa antaram 
MBbodhapancadasikaaHK-465	nirayati | prasādo hi saṃvinnairmalyena sakṛdeva	prasādaḥ hi saṃvid nairmalyena sakṛt eva 
MBbodhapancadasikaaHK-466	bhairavīyaparapratibhonmajjanaṃ tatra paunaḥ	                  
MBbodhapancadasikaaHK-467	punyenopāpapariśīlanābhāvāt | yadukta tantrāloke -	punyena upāpa pariśīlana abhāvāt 
MBbodhapancadasikaaHK-468	upāyairna śivo bhāti bhānti te tatprasādataḥ | sa evāhaṃ	upāyaiḥ na śivaḥ bhāti bhānti te tad prasādataḥ saḥ eva aham 
MBbodhapancadasikaaHK-469	svaprakāśo bhāse viśvasvarūpakaḥ ||	             
MBbodhapancadasikaaHK-470	p. 16)	p 
MBbodhapancadasikaaHK-471	ityākarṇya gurorvākyaṃ sakṛtkecana niścitāḥ | vinā	iti ākarṇya guroḥ vākyam sakṛt kecana niścitāḥ vinā 
MBbodhapancadasikaaHK-472	bhūyo'nusandhānaṃ bhānti saṃvinmayāḥ sthitāḥ ||	bhūyas nusandhānam bhānti saṃvid mayāḥ sthitāḥ 
MBbodhapancadasikaaHK-473	iti | tathā kaścittīvrasaktipātānugṛhīto gurumukhādāgamārthaṃ	iti tathā kaścid tīvra saktipāta anugṛhītaḥ guru mukhāt āgama artham 
MBbodhapancadasikaaHK-474	vijñāya akiñciccintakatvādiśāṃbhavopāyakrameṇa	vijñāya a kiñcid cintaka tva ādi śāṃbhava upāya krameṇa 
MBbodhapancadasikaaHK-475	paratattvābhijñatāmetītyata uktam - gurvāgamata eva vā iti |	para tattva abhijña tām eti iti atas uktam guru āgamataḥ eva vā iti 
MBbodhapancadasikaaHK-476	guruṇopadiṣṭaṃ pratibodhakramamāśritya viśvavaicitryasya	guruṇā upadiṣṭam pratibodha kramam āśritya viśva vaicitryasya 
MBbodhapancadasikaaHK-477	citpratibimbatvena parāmarśanādityarthaḥ | yaduktam -	cit pratibimba tvena parāmarśanāt iti arthaḥ yat uktam 
MBbodhapancadasikaaHK-478	itthaṃ viśvamidaṃ nāthe bhairavīye cidambare | pratibimbamalaṃ	ittham viśvam idam nāthe bhairavīye cit ambare pratibimba malam 
MBbodhapancadasikaaHK-479	svacche na svalvanyaprasādataḥ || (taṃ0 3|65)	svacche na svalu anya prasādataḥ tam 
MBbodhapancadasikaaHK-480	iti | tathā kaścitsatarkādisahakṛtena pārameśaśāstreṇa	iti tathā kaścid sa tarka ādi sahakṛtena pārameśa śāstreṇa 
MBbodhapancadasikaaHK-481	śāktaparipāṭyā pratyabhijñāṃ prāpnoti | taduktam -	śākta paripāṭyā pratyabhijñām prāpnoti tat uktam 
MBbodhapancadasikaaHK-482	yasya svato'yaṃ sattarkaḥ sarvatraivādhikāravān | abhiṣiktaḥ	yasya sva toyam sat tarkaḥ sarvatra eva adhikāravān abhiṣiktaḥ 
MBbodhapancadasikaaHK-483	svasaṃvittidevībhirdīkṣitaśca saḥ || (taṃ0 4|42)	sva saṃvitti devībhiḥ dīkṣitaḥ ca saḥ tam 
MBbodhapancadasikaaHK-484	iti | ataḥ śāstrādvā parameśasya ityuktam | adharadarśanāni	iti atas śāstrāt vā parameśasya iti uktam adhara darśanāni 
MBbodhapancadasikaaHK-485	parihṛtya pārameśaṃ trikādiśāsanamavalambya ityarthaḥ | yaduktam	parihṛtya pārameśam trika ādi śāsanam avalambya iti arthaḥ yat uktam 
MBbodhapancadasikaaHK-486	sa samastaṃ hi śāstrārthaṃ sattakādeva manyate | śuddhavidyā hi	sa samastam hi śāstra artham sattakāt eva manyate śuddhavidyā hi 
MBbodhapancadasikaaHK-487	tannāsti satyaṃ yadyanna bhāsayet || (4|44)	tat na asti satyam yat yat na bhāsayet 
MBbodhapancadasikaaHK-488	iti | tathā mandaśaktipātavān kaściduccārakaraṇadhyānādinā	iti tathā manda śaktipātavān kaścid uccāra karaṇa dhyāna ādinā 
MBbodhapancadasikaaHK-489	āṇavopāyakrameṇa	āṇavopāya krameṇa 
MBbodhapancadasikaaHK-490	ūrdhvordhvasopānādhirūḍhe'nuttarapadaviśrantiṃ yātītyata āha	ūrdhva ūrdhva sopāna adhirūḍhā inu ttara pada viśrantim yāti iti atas āha 
MBbodhapancadasikaaHK-491	- yasmātkasmādupāgatamiti yaṃ kaṃcit sthūlaṃ	yasmāt kasmāt upāgatam iti yam kaṃcid sthūlam 
MBbodhapancadasikaaHK-492	dhyānakaraṇādyupāyamāśritya upāgataṃ prāptamityarthaḥ	dhyāna karaṇa ādi upāyam āśritya upāgatam prāptam iti arthaḥ 
MBbodhapancadasikaaHK-493	yenaiṣāṃ nirvyutthānaṃ sadoditasamāveśo jāyate | itthaṃ	yena eṣām nirvyutthānam sadā udita samāveśaḥ jāyate ittham 
MBbodhapancadasikaaHK-494	yadanuttarasaṃvittattvasya parijñānaṃ	yat anuttara saṃvid tattvasya parijñānam 
MBbodhapancadasikaaHK-495	viśvaparipūrṇāhaṃbhāvacamatkārollāsena	              
MBbodhapancadasikaaHK-496	svasvātantryābhivyaktiḥ sa eva mokṣaḥ natu	sva svātantrya abhivyaktiḥ saḥ eva mokṣaḥ na tu 
MBbodhapancadasikaaHK-497	devādyavacchinna-sthānāntaraprāptiḥ | yadāhācāryaḥ -	deva ādi avacchinna sthāna antara prāptiḥ yat āha ācāryaḥ 
MBbodhapancadasikaaHK-498	p. 17)	p 
MBbodhapancadasikaaHK-499	mokṣasya naiva kiñciddhāmāsti nacāpi gamanamanyatra |	mokṣasya nā eva kiñcid dhāma asti na ca api gamanam anyatra 
MBbodhapancadasikaaHK-500	ajñānagranthibhidā svaśaktyabhivyaktatā mokṣaḥ || (pa0sā0 60)	           
MBbodhapancadasikaaHK-501	iti | saiṃva parameśatā tattadviśvātmanā prasphuradrūpatvaṃ	iti sā eṃva parameśa tā tat tat viśva ātmanā prasphurat rūpa tvam 
MBbodhapancadasikaaHK-502	pārameśvaryamabhinnaprakāśamayaṃ natu bhedamayāṇimāsiddhayaḥ |	pārameśvaryam abhinna prakāśa mayam na tu bheda maya aṇima siddhayaḥ 
MBbodhapancadasikaaHK-503	tadeva pūrṇāhantāvimarśamayabodhaśālināṃ prabuddhānāṃ	tat eva pūrṇa ahantā vimarśa maya bodha śālinām prabuddhānām 
MBbodhapancadasikaaHK-504	pūrṇatvaṃ viśvabharitasvabhāvattvaṃ saiva dehaprāṇādi	pūrṇa tvam viśva bharita svabhāva tvam sā eva deha prāṇa ādi 
MBbodhapancadasikaaHK-505	dhārayatāṃ jīvatāṃ pramātṛṇāṃ muktiḥ jīvacchivāvasthā	dhārayatām jīvatām pramātṛṇām muktiḥ jīvat śiva avasthā 
MBbodhapancadasikaaHK-506	śāstreṣu smṛteti || 12-13 ||	śāstreṣu smṛtā iti 
MBbodhapancadasikaaHK-507	evaṃ bandhamokṣakalpanāpi kalpitaivetyāha -	evam bandha mokṣa kalpanā api kalpitā evā iti āha 
MBbodhapancadasikaaHK-508	etau bandhavimokṣau ca parameśasvarūpataḥ | na bhidyete na bhedo hi	etau bandha vimokṣau ca parameśa svarūpataḥ na bhidyete na bhedaḥ hi 
MBbodhapancadasikaaHK-509	tattvataḥ parameśvare || 14 ||	tattvataḥ parameśvare  /
MBbodhapancadasikaaHK-510	etauṃ samanantaroktalakṣaṇau bandhamokṣau ca	etaum samanantara ukta lakṣaṇau bandha mokṣau ca 
MBbodhapancadasikaaHK-511	parameśvarecchāmātrakalpitatvāt parameśasvarūpataḥ	parameśvara icchā mātra kalpita tvāt parameśa svarūpataḥ 
MBbodhapancadasikaaHK-512	saṃvitsvātantryānna bhidyete bhinnatayā sthitiṃ na yātaḥ	saṃvid svātantryāt na bhidyete bhinna tayā sthitim na yātaḥ 
MBbodhapancadasikaaHK-513	tadvyatiriktatve'saṃvedyamānatvānna prasphuretāmityarthaḥ | yataḥ	tad vyatirikta tve saṃvedyamāna tvāt na prasphuretām iti arthaḥ yatas 
MBbodhapancadasikaaHK-514	sveccharyaiva svātmapracchādanakrīḍārasikatvānmaheśvaro	sveccharyā eva sva ātma pracchādana krīḍā rasika tvāt maheśvaraḥ 
MBbodhapancadasikaaHK-515	viśvanāṭyakrīḍāpradarśanābhiprāyeṇa antarātmaraṅge	                   
MBbodhapancadasikaaHK-516	tattadbhūmikāgrahaṇaṃ vidadhat vibhāvānubhāvādibhirvyañjitaiḥ	tad tad bhūmikā grahaṇam vidadhat vibhāva anubhāva ādibhiḥ vyañjitaiḥ 
MBbodhapancadasikaaHK-517	sāttvikabhāvādisahacaritaistattatsthāyibhāvaiḥ	sāttvika bhāva ādi sahacaritaiḥ tad tad sthāyibhāvaiḥ 
MBbodhapancadasikaaHK-518	samunmīṣitāmalaukiktarasacamatkṛtimāsvādayatītyetadvāstavārthā	samunmīṣitām alaukikta rasa camatkṛtim āsvādayati iti etat vāstava arthā 
MBbodhapancadasikaaHK-519	bhijñāna-virahādaparābhiḥ śaktibhiḥ pramuṣitaparamārthānāṃ	abhijñāna virahāt aparābhiḥ śaktibhiḥ pramuṣita paramārthānām 
MBbodhapancadasikaaHK-520	bandhābhimāno jāyate anugrahabhājanānāṃ tu	bandha abhimānaḥ jāyate anugraha bhājanānām tu 
MBbodhapancadasikaaHK-521	ciddhanasaṃvitsvātantryamevāntarbahirviśvollāsena	                     
MBbodhapancadasikaaHK-522	prasphuratītyabhijñātavatāṃ aghorātmanā śakticakreṇa	prasphurati iti abhijñātavatām aghora ātmanā śakti cakreṇa 
MBbodhapancadasikaaHK-523	svābhinnaṃ prakāśaghanātmaviśvaṃ pradarśayatā	sva abhinnam prakāśa ghana ātma viśvam pradarśayatā 
MBbodhapancadasikaaHK-524	labdhaparamārthanidhīrnāṃ mokṣābhimāna ityubhayamidaṃ bhagavān	labdha parama artha nidhīḥ nām mokṣa abhimānaḥ iti ubhayam idam bhagavān 
MBbodhapancadasikaaHK-525	svācchandyeṃna vijṛmbhayati | atastacchaktimayatvāt tasmānna	svācchandyeṃna vijṛmbhayati atas tad śakti maya tvāt tasmāt na 
MBbodhapancadasikaaHK-526	bhinnametaditi tātparyaṃ hetuvacanena draḍhayati na bheda iti hi	bhinnam etat iti tātparyam hetuvacanena draḍhayati na bhedaḥ iti hi 
MBbodhapancadasikaaHK-527	yasmāttattvataḥ paramārthata ātmani parameśvare bhedo nāsti	yasmāt tattvataḥ paramārthataḥ ātmani parameśvare bhedaḥ na asti 
MBbodhapancadasikaaHK-528	sarvasya prakāśasāraparamārthatvenāṇumātramapi bhedakalanāyā	sarvasya prakāśa sāra paramārtha tvena aṇu mātram api bheda kalanāyā 
MBbodhapancadasikaaHK-529	asaṃbhavāt tasmātpūrṇāhaṃbhāvacamatkārodrekāt pūrṇe	asaṃbhavāt tasmāt pūrṇa ahaṃbhāva camatkāra udrekāt pūrṇe 
MBbodhapancadasikaaHK-530	pūrṇaṃ vijṛmbhamāṇaṃ nāpūrṇaṃ kimapi bandhamokṣādikalaneti	pūrṇam vijṛmbhamāṇam na a pūrṇam kim api bandha mokṣa ādi kalanā iti 
MBbodhapancadasikaaHK-531	sarvamanavadyam |	sarvam anavadyam 
MBbodhapancadasikaaHK-532	p. 18)	p 
MBbodhapancadasikaaHK-533	yaduktam -	yat uktam 
MBbodhapancadasikaaHK-534	saṃsāro'sti na tattvatastanubhṛtāṃ bandhasya vārtaiva kā bandho	saṃsāraḥ usti na tattvataḥ tanubhṛtām bandhasya vārtā eva kā bandho 
MBbodhapancadasikaaHK-535	yasya na jātu tasya vitathā muktasya muktikriyā | mithyāmohakṛdeśa	yasya na jātu tasya vitathā muktasya mukti kriyā 
MBbodhapancadasikaaHK-536	rajjubhujagacchāyāpiśocabhramo mā kiñcittyaja mā gṛhāṇa vihara	rajju bhujaga chāyā piśoca bhramaḥ mā kiñcid tyaja mā gṛhāṇa vihara 
MBbodhapancadasikaaHK-537	svastho yathāvatsthitaḥ ||	svasthaḥ yathāvat sthitaḥ 
MBbodhapancadasikaaHK-538	iti || 14 ||	iti 
MBbodhapancadasikaaHK-539	evaṃ paramārthābhijñānāṃ jīvadavasthāyāmeva	evam parama artha abhijñānām jīvat avasthāyām eva 
MBbodhapancadasikaaHK-540	samāśvāsadāyinīṃ pārameśvaryarasanirbharāṃ	            
MBbodhapancadasikaaHK-541	tatsamāpattimāsādayitumabhyupāyamāha -	tad samāpattim āsādayitum abhyupāyam āha 
MBbodhapancadasikaaHK-542	itthamicchākalājñānaśaktiśūlāmbujāśritaḥ | bhairavaḥ	ittham icchā kalā jñāna śakti śūla ambuja āśritaḥ bhairavaḥ 
MBbodhapancadasikaaHK-543	sarvabhāvānāṃ svabhāvaḥ pariśīlyate || 15 ||	sarva bhāvānām svabhāvaḥ pariśīlyate 
MBbodhapancadasikaaHK-544	itthamuktaparāmarśanena sarvabhāvānāmantarbahirvartināṃ	ittham ukta parāmarśanena sarva bhāvānām antar bahis vartinām 
MBbodhapancadasikaaHK-545	nīlasukhādīnāṃ svabhāvaḥ prakāśatmā bhairavo	nīla sukha ādīnām svabhāvaḥ 
MBbodhapancadasikaaHK-546	viśvabharitasvabhāvattvāt pūrṇaḥ svatantraśivaprakāśaḥ	                    
MBbodhapancadasikaaHK-547	parīśīlyate parāmṛśyate | svātmanyeva cidākāśe	parīśīlyate parāmṛśyate sva ātmani eva cit ākāśe 
MBbodhapancadasikaaHK-548	viśvamasmyavabhāsayan sraṣṭā viśvātmaka iti prathayā	viśvam asmi avabhāsayan sraṣṭā viśva ātmakaḥ iti prathayā 
MBbodhapancadasikaaHK-549	bhairavātmatetyuttyā bhairavīyā saṃvideva hi	bhairava ātma tā iti uttyā bhairavīyā saṃvid eva hi 
MBbodhapancadasikaaHK-550	bahirantastattadbhāvādyātmanā cakāsti	bahis antar tad tad bhāva ādi ātmanā cakāsti 
MBbodhapancadasikaaHK-551	yatkiñcitkaraṇeśvarībhirābhāsyatetsarvaṃ svātmaiva svātmānaṃ	yat kiñcid karaṇa īśvarībhiḥ ābhāsyate sarvam svātmā eva svātmānam 
MBbodhapancadasikaaHK-552	svātantryātparāmṛśati na vyatiriktamiti yāvat yadukta	svātantryāt parāmṛśati na vyatiriktam iti yāvat yat ukta 
MBbodhapancadasikaaHK-553	mīśvarapratyabhijñāyām -	m īśvarapratyabhijñāyām 
MBbodhapancadasikaaHK-554	svātmaiva svātmanā pūrṇā bhāvā bhāntyamitasya tu |	sva ātmā eva sva ātmanā pūrṇāḥ bhāvāḥ bhānti amitasya tu 
MBbodhapancadasikaaHK-555	iti | kīdṛśa ityāha - iccheti kaleti kriyāśaktiḥ	iti kīdṛśaḥ iti āha icchā iti kalā iti kriyāśaktiḥ 
MBbodhapancadasikaaHK-556	icchājñānakriyāśaktaya evārātrayasāmyācchūlaṃ tatra	icchā jñāna kriyā śaktayaḥ eva ārā traya sāmyāt śūlam tatra 
MBbodhapancadasikaaHK-557	yanmatsyodarīmatādiprasiddhyā saṅkocavikāsadharmaśāli	yat matsyodarīmata ādi prasiddhyā saṅkoca vikāsa dharma śāli 
MBbodhapancadasikaaHK-558	padmamaunmanasaṃ padaṃ tadāśritastaduttīrṇatayā bhāsamāna	padmam aunmanasam padam tat āśritaḥ tad uttīrṇa tayā bhāsamāna 
MBbodhapancadasikaaHK-559	ityarthaḥ -	iti arthaḥ 
MBbodhapancadasikaaHK-560	p. 19)	p 
MBbodhapancadasikaaHK-561	atha ca viśvasya saṃvitprakāśādanatiriktatayā sthitiṃ	atha ca viśvasya saṃvid prakāśāt anatirikta tayā sthitim 
MBbodhapancadasikaaHK-562	pradarśayituṃ śrīparābījasyāpyudayaḥ proktaḥ tatra svabhāva	pradarśayitum śrī parā bījasya api udayaḥ proktaḥ tatra svabhāva 
MBbodhapancadasikaaHK-563	ityanenāmṛtabījasyoddhāraḥ kṛtaḥ	iti anena amṛta bījasya uddhāraḥ kṛtaḥ 
MBbodhapancadasikaaHK-564	tasyānacakatvāduccāraṇamaśakyamityataḥ asmiṃścaturdaśe dhāmni	tasya an acaka tvāt uccāraṇam aśakyam iti atas asmin caturdaśe dhāmni 
MBbodhapancadasikaaHK-565	sphuṭībhūtatriśaktike | ityuktyā icchākaletyanena	sphuṭībhūta tri śaktike iti uktyā icchā kalā iti anena 
MBbodhapancadasikaaHK-566	śūlabījoddhāraḥ | bharaṇavamanasvabhāvattvādabhairava ityanena	                                                            
MBbodhapancadasikaaHK-567	bahirantārūpatayā dvidhā visargasyoddhāraḥ |	bahis anta ārūpa tayā dvidhā visargasya uddhāraḥ 
MBbodhapancadasikaaHK-568	sarvabhāvānāmityanenāsya vyāptiruktā | yaduktaṃ mālinīvijaye -	sarva bhāvānām iti anena asya vyāptiḥ uktā yat uktam mālinīvijaye 
MBbodhapancadasikaaHK-569	sārṇenāṇḍatrayaṃ vyāptaṃ triśūlena caturthakam | sarvātītaṃ	sa arṇena aṇḍa trayam vyāptam triśūlena caturthakam sarva atītam 
MBbodhapancadasikaaHK-570	visargeṇa parāyā vyāptiriṣyate ||	visargeṇa parāyāḥ vyāptiḥ iṣyate 
MBbodhapancadasikaaHK-571	iti |	iti 
MBbodhapancadasikaaHK-572	tathāhi sadidaṃ brahmamūlaṃ māyāṇḍasaṃjñitam |	tathā hi sat idam brahma mūlam māyā aṇḍa saṃjñitam 
MBbodhapancadasikaaHK-573	icchājñānakriyārohaṃ vinā naiva saducyate ||	icchā jñāna kriyā āroham vinā nā eva sat ucyate 
MBbodhapancadasikaaHK-574	tacchaktitritayārohād bhairavīye cidambare | visṛjyate hi	                                                                       
MBbodhapancadasikaaHK-575	tattasmādbahirvātha visṛjyate ||	tat tasmāt bahis vā atha visṛjyate 
MBbodhapancadasikaaHK-576	iti ca | evaṃ vyāptike parābīje	iti ca evam vyāptike parā bīje 
MBbodhapancadasikaaHK-577	nirantarāmyāsakaraṇātpārameśvarasamāveśādaiśvaryasiddhiriti	nirantara āmyāsa karaṇāt pārameśvara samāveśāt aiśvarya siddhiḥ iti 
MBbodhapancadasikaaHK-578	viśvasiddhikāraṇaitadbījaparāmarśanātkaraṇasya kaṭākṣeṇa	viśva siddhi kāraṇa etad bīja parāmarśanāt karaṇasya kaṭākṣeṇa 
MBbodhapancadasikaaHK-579	pradarśanaṃ sūcitavānācāryaḥ || 15 ||	pradarśanam sūcitavān ācāryaḥ 
MBbodhapancadasikaaHK-580	idānīmācāryaḥ svanāmakīrtanācchāstrārthaṃ	idānīm ācāryaḥ sva nāma kīrtanāt śāstra artham 
MBbodhapancadasikaaHK-581	pratyabhimukhīkaraṇādupasaṃharati -	pratyabhimukhīkaraṇāt upasaṃharati 
MBbodhapancadasikaaHK-582	sukumāramatīn śiṣyānprabodhayitumañjasā | ime'bhinavaguptena	su kumāra matīn śiṣyān prabodhayitum añjasā 
MBbodhapancadasikaaHK-583	ślokāḥ pañcadaśoditāḥ ||| 16 ||	ślokāḥ pañcadaśa uditāḥ 
MBbodhapancadasikaaHK-584	iti bodhapañcadaśikā samāptā ||	iti bodha pañcadaśikā samāptā 
MBbodhapancadasikaaHK-585	sukumāramatayo mandaśaktipāatavantaḥ ajasa sukhena spaṣṭamanyat ||	su kumāra matayaḥ sukhena spaṣṭam anyat 
MBbodhapancadasikaaHK-586	yāṃ bodhapañcadaśikāṃ matimāndyabhājāṃ sambodhanāya	yām bodha pañcadaśikām mati māndya bhājām sambodhanāya 
MBbodhapancadasikaaHK-587	nivabandha guruḥ suramyām | māheśvaro'bhinavagupta itīḍyanāmā	nivabandha guruḥ su ramyām māheśvaraḥ abhinavaguptaḥ iti īḍya nāmā 
MBbodhapancadasikaaHK-588	tatra vyadhādvyavaraṇaṃ harabhaṭṭaśāstrī ||	tatra vyadhāt vyavaraṇam harabhaṭṭa śāstrī 
MBbodhapancadasikaaHK-589	bhūnandanandavede'bde (4990) laukike phālgunevadī | ekādaśyāṃ	laukike ekādaśyām 
MBbodhapancadasikaaHK-590	tithau śāstrī haro vivaraṇaṃ vyadhāt ||	tithau śāstrī haraḥ vivaraṇam vyadhāt 
MBbodhapancadasikaaHK-591	iti śrīmahāmāheśvarācāryavaryaṃ -	iti śrī mahā māheśvara ācārya varyam 
MBbodhapancadasikaaHK-592	śrīmadabhinavaguptaviracitāyāṃ bodhapañcadaśikāyāṃ paṃ0	śrīmat abhinavagupta viracitāyām bodhapañcadaśikāyām paṃ 
MBbodhapancadasikaaHK-593	harabhaṭṭaśāstrikṛtaṃ vivaraṇaṃ samāptam ||	harabhaṭṭa śāstri kṛtam vivaraṇam samāptam 
MBbodhapancadasikaaHK-594	śrīśivārpaṇamastu ||	śrī śivārpaṇam astu 
MBbodhapancadasikaaHK-595	MUKTABODHA INDOLOGICAL RESEARCH INSTITUTE©2011 Muktabodha Indological Research Institute  All Rights Reserved.E-texts may be viewed only online or downloaded for private study.E-texts may not, under any circumstances, be copied, republished,reproduced, distributed or sold, either in original or altered form, withoutthe express permission of Muktabodha Indological Research Institute in writing.Data-entered by the staff of Muktabodha under the direction of Mark S. G. Dyczkowski.	muktabodha indological research muktabodha indological research institute all rights reserved texts may be viewed only online or downloaded for private studye texts may not under any circumstances be copied republished reproduced distributed or sold either in original or altered form withoutthe express permission of muktabodha indological research institute in writing data entered by the staff of muktabodha under the direction of mark s g dyczkowski 
