segmentnr	original	analyzed
MBcandrajnanaHK-0	Muktabodha E-text in UTF-8	muktabodha etext in utf
MBcandrajnanaHK-1	###########################################################################MUKTABODHA INDOLOGICAL RESEARCH INSTITUTEwww.muktabodha.org©2011 Muktabodha Indological Research Institute  All Rights Reserved.E-texts may be viewed only online or downloaded for private study.E-texts may not, under any circumstances, be copied, republished,reproduced, distributed or sold, either in original or altered form, withoutthe express permission of Muktabodha Indological Research Institute in writing.Data-entered by the staff of Muktabodha under the direction of Mark S. G. Dyczkowski.Catalog number : M00263	muktabodha indological research muktabodha indological research institute all rights reserved texts may be viewed only online or downloaded for private studye texts may not under any circumstances be copied republished reproduced distributed or sold either in original or altered form withoutthe express permission of muktabodha indological research institute in writing data entered by the staff of muktabodha under the direction of mark s g dyczkowskicatalog number  /
MBcandrajnanaHK-2	Uniform title: candrajñānāgama	uniform title 
MBcandrajnanaHK-3	Manuscript : BHU C4243	manuscript bhu 
MBcandrajnanaHK-4	Notes: Data entered by the staff of Muktabodha under the supervision of Mark S.G. Dyczkowski.	notes data entered by the staff muktabodha under the supervision of mark sg dyczkowski 
MBcandrajnanaHK-5	Revision 0: April 7, 2012	revision april 
MBcandrajnanaHK-6	Publication country : India	publication country india 
MBcandrajnanaHK-7	śrī gurave śivāye namaḥ |	śrī gurave śivāye namaḥ 
MBcandrajnanaHK-8	oṃ namaḥ paramātmane ||	om namaḥ paramātmane 
MBcandrajnanaHK-9	oṃ namo gaṇādhipataye namaḥ ||	om namaḥ gaṇa adhipataye namaḥ 
MBcandrajnanaHK-10	oṃ namo viṣṇave ||	om namaḥ viṣṇave 
MBcandrajnanaHK-11	p. 55a) oṃ namaḥ śivāya sa śivāya śivadāya namo namaḥ |	om namaḥ śivāya sa śivāya śiva dāya namaḥ namaḥ 
MBcandrajnanaHK-12	atha candrajñānaṃ likhyate ||	atha candra jñānam likhyate 
MBcandrajnanaHK-13	oṃ kailāsapiṭhamadhyasthaṃ devadevaṃ maheśvaram |	om kailāsa piṭha madhya stham devadevam maheśvaram 
MBcandrajnanaHK-14	skandanandigaṇākīrṇaṃ viśveśvarasamanvitam || 1 ||	skanda nandi gaṇa ākīrṇam viśveśvara samanvitam 
MBcandrajnanaHK-15	brahmādi kāraṇaiḥ sārdhamumayā sahitaṃ sthitam |	brahma ādi kāraṇaiḥ sārdham umayā sahitam sthitam 
MBcandrajnanaHK-16	mahodarasamāyuktamapsarobhiḥ samāvṛtam || 2 ||	mahodara samāyuktam apsarobhiḥ samāvṛtam 
MBcandrajnanaHK-17	mahādhyānasthitaṃ devaṃ munibhiścāpi saṃvṛtam |	mahā dhyāna sthitam devam munibhiḥ ca api saṃvṛtam 
MBcandrajnanaHK-18	gandharvādi gaṇopetaṃ siddhasaṅghaiśca saṃyutam || 3 ||	gandharva ādi gaṇa upetam siddha saṅghaiḥ ca saṃyutam 
MBcandrajnanaHK-19	srūyamānaṃ suravaraiḥ sādhyarudramarudghanaiḥ |	srūyamānam sura varaiḥ sādhya rudra marut ghanaiḥ 
MBcandrajnanaHK-20	nārada pramukhaiścaiva gītanṛttaviśāradaiḥ || 4 ||	nārada pramukhaiḥ ca eva gīta nṛtta viśāradaiḥ 
MBcandrajnanaHK-21	ārādhyamānaṃ deveśaṃ varadaṃ lokakāraṇam |	ārādhyamānam deveśam vara dam loka kāraṇam 
MBcandrajnanaHK-22	sarvānugrahakartāraṃ sarvapāpapraṇāśanam || 5 ||	          
MBcandrajnanaHK-23	p. 55b) sarvamantravaraṃ nāthaṃ sarvadeva namaskṛtam |	sarva mantra varam nātham sarva deva namaskṛtam 
MBcandrajnanaHK-24	tatrasthaṃ devadeveśamumayāsahitaṃ śivam || 6 ||	tatrastham devadeveśam umayā asahitam śivam 
MBcandrajnanaHK-25	dṛṣṭvā tu varadaṃ devaṃ dhyānasthaṃ taṃ kapālinam |	dṛṣṭvā tu vara dam devam dhyāna stham tam kapālinam 
MBcandrajnanaHK-26	saṃśayā viṣṭacittastu candro vedavidāṃpatiḥ || 7 ||	saṃśayāḥ viṣṭa cittaḥ tu candraḥ veda vidāṃpatiḥ 
MBcandrajnanaHK-27	aṣṭāṅgapraṇipātena praṇamya parameśvaram |	aṣṭāṅga praṇipātena praṇamya parameśvaram 
MBcandrajnanaHK-28	rodamāno bravīdvākyamucchasaṃśca punaḥ punaḥ || || 9 ||	rodamānaḥ bravīt vākyam ucchasan ca punar punar 
MBcandrajnanaHK-29	indrajālaṃ hi paśyāmi asatyaṃ satyatāṃ gatam |	indrajālam hi paśyāmi asatyam satya tām gatam 
MBcandrajnanaHK-30	mohitaṃ māyayā sarvaṃ brahāṇḍaṃ sa carācaram || 9 ||	mohitam māyayā sarvam brahāṇḍam sa carācaram 
MBcandrajnanaHK-31	devamānuṣya tiryañca gandharvoragarākṣasām |	tiryañcam ca gandharva uraga rākṣasām 
MBcandrajnanaHK-32	sarveṣāṃ niścitā buddhiḥ praṇaṣṭā iti me matiḥ || 10 ||	sarveṣām niścitā buddhiḥ praṇaṣṭāḥ iti me matiḥ 
MBcandrajnanaHK-33	kṣaṇikasya tu rūpasya tathā śabdasya vai prabho |	kṣaṇikasya tu rūpasya tathā śabdasya vai prabho 
MBcandrajnanaHK-34	tvayoktasyaiva candrasya buddhi rūpasya nityaśaḥ || 11 ||	tvayā uktasya eva candrasya buddhi rūpasya nityaśas 
MBcandrajnanaHK-35	p. 56a) ākāśasya kathaṃ deva praṇamanti vināśinaḥ |	ākāśasya katham deva praṇamanti vināśinaḥ 
MBcandrajnanaHK-36	svayamevamasaunaṣṭaścintayāyaḥ prakalpitaḥ || 12 ||	svayam evam asau naṣṭaḥ cintayā ayaḥ prakalpitaḥ 
MBcandrajnanaHK-37	śabdasya kṛtakaṃ caiva mantratvaṃ ca kathaṃ bhavet |	śabdasya kṛtakam ca eva mantra tvam ca katham bhavet 
MBcandrajnanaHK-38	prayuktā ca yathā vīṇā tantrīsvara samanvitā || 13 ||	prayuktā ca yathā vīṇā tantrī svara samanvitā 
MBcandrajnanaHK-39	cittena sāryate yasya ṣaḍjamadhyamadaivatā |	cittena sāryate yasya ṣaḍja madhyama daivatā 
MBcandrajnanaHK-40	tathā mantrā tadākārā vidyāścaiva sahasraśaḥ || 14 ||	tathā tad ākārāḥ vidyāḥ ca eva sahasraśas 
MBcandrajnanaHK-41	aprabuddhadhiyomūḍhāḥ svacittaṃ te bahiḥ sthitāḥ |	aprabuddha dhiyaḥ mūḍhāḥ sva cittam te bahis sthitāḥ 
MBcandrajnanaHK-42	kṛtake naiva santuṣṭā bhrāmitā māyayā punaḥ || 15 ||	kṛtake na eva santuṣṭāḥ bhrāmitāḥ māyayā punar 
MBcandrajnanaHK-43	asatyamindrajālasya yadrūpaṃ tatkathaṃ prabho |	asatyam indrajālasya yat rūpam tat katham prabho 
MBcandrajnanaHK-44	uccāryamāṇā ye mantrā na te samyak tvayoditāḥ || 16 ||	uccāryamāṇāḥ ye mantrāḥ na te samyak tvayā uditāḥ 
MBcandrajnanaHK-45	mohitā devagandharvā mithyājñānena garvitāḥ |	mohitāḥ deva gandharvāḥ mithyā jñānena garvitāḥ 
MBcandrajnanaHK-46	p. 56b) māyāsvapnopamāḥ sarve mudrādhyanādi dhāraṇāḥ || 17 ||	māyā svapna upamāḥ sarve mudrā adhi anādi dhāraṇāḥ 
MBcandrajnanaHK-47	na taccitramivāsatyaṃ śāstrajālaṃ kriyāgamam |	na tat citram iva asatyam śāstra jālam kriyā āgamam 
MBcandrajnanaHK-48	devyā vināyakasyaiva ṣaṇmukhasya trilocanam || 18 ||	devyāḥ vināyakasya eva ṣaṇmukhasya trilocanam 
MBcandrajnanaHK-49	nandibhṛṅgi mahākāla kaubīrośanasāṃ tathā |	nandi bhṛṅgi mahākāla kaubīra uśanasām tathā 
MBcandrajnanaHK-50	vāsukirgāruḍaścaiva brahmaṇo viṣṇurudrayoḥ || 19 ||	vāsukiḥ gāruḍaḥ ca eva brahmaṇaḥ viṣṇu rudrayoḥ   
MBcandrajnanaHK-51	sanatkuārapramukhādṛṣīṇāṃ bhāvitātmanām |	sanatkuāra pramukhāt ṛṣīṇām bhāvitātmanām 
MBcandrajnanaHK-52	durvāsapramukhādīnāṃ munīnāṃ yastu saṃhitaḥ || 20 ||	durvāsa pramukha ādīnām munīnām yaḥ tu saṃhitaḥ 
MBcandrajnanaHK-53	mantrāśca vividhākārā devyāścāpi sahasraśaḥ |	mantrāḥ ca vividha ākārāḥ devyāḥ ca api sahasraśas 
MBcandrajnanaHK-54	saṃprāptāvividhākārā vidyāścāpi sahasraśaḥ || 21 ||	saṃprāptāḥ a vividha ākārāḥ vidyāḥ ca api sahasraśas 
MBcandrajnanaHK-55	kathitāśca yathāpūrvaṃ yukti yuktāḥ samāsataḥ |	kathitāḥ ca yathāpūrvam yukti yuktāḥ samāsatas 
MBcandrajnanaHK-56	tatsantuṣṭa mahādeva śirassthena mayā śrutam || 22 ||	tat santuṣṭa mahādeva śiraḥ sthena mayā śrutam  /
MBcandrajnanaHK-57	p. 57a) bhrāmitāste mayā sarve vyāyāmena maheśvarāḥ |	bhrāmitāḥ te mayā sarve vyāyāmena maheśvarāḥ 
MBcandrajnanaHK-58	na jñātaṃ kasyacijjñānaṃ śārīraṃ gūḍhagocaram || 13 ||	na jñātam kasyacid jñānam śārīram gūḍha gocaram 
MBcandrajnanaHK-59	aprabuddhamatitvāśca śāstrajāle bhramanti te |	aprabuddha mati tvāḥ ca śāstra jāle bhramanti te 
MBcandrajnanaHK-60	kṛtakaṃ naiva santuṣṭāḥ svacittamuṣitāḥ sthitāḥ || 14 ||	kṛtakam na eva santuṣṭāḥ sva citta muṣitāḥ sthitāḥ 
MBcandrajnanaHK-61	mayāśrūtāgamapathātantre tantre tvayā kṛtāḥ |	mayā aśrūta āgama patha atantre tantre tvayā kṛtāḥ 
MBcandrajnanaHK-62	sambhāvaṃ kasyacennoktaṃ mohitāḥ paramārthikāḥ || 15 ||	kasyaced na uktam mohitāḥ parama arthikāḥ 
MBcandrajnanaHK-63	ko mantraḥ kṛtako nāma kasya karmamatistathā |	kaḥ mantraḥ kṛtakaḥ nāma kasya karma matiḥ tathā 
MBcandrajnanaHK-64	dīyate kasya vā piṇḍaṃ vāyurvāyau pralīyate || 16 ||	dīyate kasya vā piṇḍam vāyuḥ vāyau pralīyate   
MBcandrajnanaHK-65	āpastvapsvapralīyante viśet tejaśca tejasi |	āpaḥ tu apsu apralīyante viśet tejaḥ ca tejasi 
MBcandrajnanaHK-66	ākāśe tu tathākāśaṃ manobuddhirahaṃ tathā || 17 ||	ākāśe tu tathā ākāśam manaḥ buddhiḥ aham tathā 
MBcandrajnanaHK-67	yathā gatāḥ punastatra līnāḥ sve sve pade tu te |	yathā gatāḥ punar tatra līnāḥ sve sve pade tu te 
MBcandrajnanaHK-68	ko yaṃ māṃsa mayo deho dagdho vā prāṇibhakṣitaḥ || 18 ||	kaḥ yam māṃsa mayaḥ dehaḥ dagdhaḥ vā prāṇi bhakṣitaḥ 
MBcandrajnanaHK-69	p. 57b) amūrto nirguṇo jīvo hyanādiścāpyakhaṇḍitaḥ |	amūrtaḥ nirguṇaḥ jīvaḥ hi anādiḥ ca api akhaṇḍitaḥ 
MBcandrajnanaHK-70	na rūpaṃ tasya no varṇo na sthānaṃ na ca dhāraṇā || 19 ||	na rūpam tasya no varṇaḥ na sthānam na ca dhāraṇā 
MBcandrajnanaHK-71	kasya kālo yaśaḥ kasya bhaṭāścaiva sudāruṇāḥ |	kasya kālaḥ yaśaḥ kasya bhaṭāḥ ca eva su dāruṇāḥ 
MBcandrajnanaHK-72	narakāśśāsanāścaiva pretapuṇyaṃ vasetakaḥ || 20 ||	preta puṇyam 
MBcandrajnanaHK-73	sahasrasaṅkhyāḥ puruṣā āhave ye hatāstute |	sahasra saṅkhyāḥ puruṣāḥ āhave ye hatāḥ tu te 
MBcandrajnanaHK-74	nīyante bahubhiḥkālaireko vā kiṃ bahūnnayet || 21 ||	nīyante bahubhiḥ kālaiḥ ekaḥ vā kim bahūn nayet  /
MBcandrajnanaHK-75	pakṣiṇo vihvalī bhūtā nirgatena layaṃ gatāḥ |	pakṣiṇaḥ vihvalī bhūtāḥ nirgatena layam gatāḥ 
MBcandrajnanaHK-76	lakṣasaṅkhyāśca vahavastatra kālaḥkimāgataḥ || 22 ||	lakṣa saṅkhyāḥ ca vahavaḥ tatra kālaḥ kim āgataḥ   
MBcandrajnanaHK-77	eke naiva hi kālena sahasrāṇyarbudhāni ca |	eke na eva hi kālena sahasrāṇi arbudhāni ca 
MBcandrajnanaHK-78	nīyante bahubhiḥ kiṃ vā etatsarvaṃ vadasva me || 23 ||	nīyante bahubhiḥ kim vā etat sarvam vadasva me 
MBcandrajnanaHK-79	śṛṇu candra pravakṣyāmi rahasyaṃ bhuvidurlabham |	śṛṇu candra pravakṣyāmi rahasyam bhuvi durlabham 
MBcandrajnanaHK-80	yanna kasya cidākhyātaṃ nissaṃśaya karaṃparam || 24 ||	yat na kasya cit ākhyātam nissaṃśaya karam param 
MBcandrajnanaHK-81	p. 58a) na mantro varṇasaṃyogādya upādyaḥ kriyāparaḥ |	na mantraḥ varṇa saṃyoga ādyaḥ upādyaḥ kriyā paraḥ 
MBcandrajnanaHK-82	tāneśa parameśāna mohanyuktā tu mātṛkā || 25 ||	tān īśa parameśāna mohanī uktā tu mātṛkā 
MBcandrajnanaHK-83	paśūnāṃ sthūlamārgena svātmavijñānavartmani |	paśūnām sthūla mārgena sva ātma vijñāna vartmani 
MBcandrajnanaHK-84	saṃbhavanti yathovarṇāḥ svaravyañjanasaṃjñakāḥ || 26 ||	saṃbhavanti yathā u varṇāḥ svara vyañjana saṃjñakāḥ 
MBcandrajnanaHK-85	akṣarakṣarayoryattadakṣaraṃ cākṣarādhikam |	akṣara kṣarayoḥ yat tat akṣaram ca akṣara adhikam 
MBcandrajnanaHK-86	tasyādhikāraṇaṃ yat tad vāgbhirvaktuṃ na śakyate || 27 ||	tasya adhi kāraṇam yat tat vāgbhiḥ vaktum na śakyate 
MBcandrajnanaHK-87	tadakṣaraṃ na jānanti mithyā garveṇa mohitāḥ |	tat akṣaram na jānanti mithyā garveṇa mohitāḥ 
MBcandrajnanaHK-88	tajjñātvā bījarājaṃ tu varuṇānalamadhyagam || 28 ||	tat jñātvā bījarājam tu varuṇa anala madhya gam 
MBcandrajnanaHK-89	na jāyeta punargarbhe yadyapi brahmahā bhavet |	na jāyeta punar garbhe yadi api brahma hā bhavet 
MBcandrajnanaHK-90	parivārāṅga vistāraṃ nāmajāti vivarjitam || 29 ||	parivāra aṅga vistāram nāma jāti vivarjitam 
MBcandrajnanaHK-91	ekavīraṃ smṛtaṃ mantraṃ saṅkṣiptaṃ vidhi sādhanam |	eka vīram smṛtam mantram saṅkṣiptam vidhi sādhanam 
MBcandrajnanaHK-92	śabdāvasthaṃ parityajya bodharūpeṇasaṃsthitam || 30 ||	śabda avastham parityajya bodha rūpeṇa saṃsthitam 
MBcandrajnanaHK-93	p. 58b) svaramādya svaraṃ jñeyaṃ taṃ svaraṃ svaravarjitam |	svaram ādya svaram jñeyam tam svaram svara varjitam 
MBcandrajnanaHK-94	asvaraṃ paramaṃ mantraṃ yogināṃ mokṣadaṃ dhruvam || 31 ||	asvaram paramam mantram yoginām mokṣa dam dhruvam 
MBcandrajnanaHK-95	tuṭirṇavanimeṣāśca tathā kāṣṭhāḥ kalāstathā |	tuṭiḥ ṇava nimeṣāḥ ca tathā kāṣṭhāḥ kalāḥ tathā 
MBcandrajnanaHK-96	śaśadhavaravidyāṃ ca muhūrtadinarātribhiḥ || 32 ||	śaśadhavara vidyām ca muhūrta dina rātribhiḥ 
MBcandrajnanaHK-97	pakṣamāsaṃ tvayanayoryaṃ vatsara tamaḥ smṛtaḥ |	pakṣa māsam tu ayanayoḥ yam vatsara tamaḥ smṛtaḥ 
MBcandrajnanaHK-98	kīlanāddvijarājaivamevaṃ kālobhidhīyate || 33 ||	kīlanāt dvijarājā evam evam kālaḥ abhidhīyate 
MBcandrajnanaHK-99	kṛtasya karmaṇaścaiva līnaḥ kālassatena vai |	kṛtasya karmaṇaḥ ca eva līnaḥ kālaḥ sa tena vai 
MBcandrajnanaHK-100	nīyate dehasaṃsthena karmaṇākālarūpiṇā || 34 ||	nīyate deha saṃsthena karmaṇā akāla rūpiṇā 
MBcandrajnanaHK-101	nākṛtirvikṛtirnāsti kālasya paramārthataḥ |	na ākṛtiḥ vikṛtiḥ na asti kālasya paramārthataḥ 
MBcandrajnanaHK-102	sukhaduḥkha phalaṃ bhuṅkte jīvaḥ svasyaivakarmaṇaḥ || 35 ||	sukha duḥkha phalam bhuṅkte jīvaḥ svasya eva karmaṇaḥ 
MBcandrajnanaHK-103	ekaḥ kṛtāntaḥ saṃhārī paśu hṛdbhavati kṣaṇāt |	ekaḥ kṛtāntaḥ saṃhārī paśu hṛt bhavati kṣaṇāt 
MBcandrajnanaHK-104	āyuḥ kṣīṇāśca ye bhūtāstiryañcomānuṣāḥ surāḥ || 36 ||	āyuḥ kṣīṇāḥ ca ye bhūtāḥ tiryañcaḥ mānuṣāḥ surāḥ 
MBcandrajnanaHK-105	p. 59a) teṣāṃ niyamanārthāya kālonāmapravartate |	teṣām niyamana arthāya 
MBcandrajnanaHK-106	na dveṣānna ca vairāgyāṅkālaḥ karmedamucyate || 37 ||	na dveṣāt na ca vairāgyāt kālaḥ karma idam ucyate 
MBcandrajnanaHK-107	kālena nīyate ko sau kiṃ rūpaṃ tasya śaṅkara |	kālena nīyate au kim rūpam tasya śaṅkara 
MBcandrajnanaHK-108	kiṃ vidhau devadeveśa jīvonāmamaheśvara || 38 ||	kim vidhau devadeveśa jīvaḥ nāma maheśvara  /
MBcandrajnanaHK-109	kasmin sthāne vasejjīvo mriyate sa kutaḥ punaḥ |	kasmin sthāne vaset jīvaḥ mriyate sa kutas punar 
MBcandrajnanaHK-110	kathaṃ kālaḥ praśamati jīva sthāne trilocana || 39 ||	katham kālaḥ praśamati jīva sthāne trilocana 
MBcandrajnanaHK-111	etatsarvaṃ samāsena sadbhāvena vada prabho |	etat sarvam samāsena sadbhāvena vada prabho 
MBcandrajnanaHK-112	śṛṇu tāvat pravakṣyāmi rahasyaṃ bhuvi durlabham || 40 ||	śṛṇu tāvat pravakṣyāmi rahasyam bhuvi durlabham 
MBcandrajnanaHK-113	jīvo hyanādiramalo niṣkalo virajaḥ katham |	jīvaḥ hi anādiḥ amalaḥ niṣkalaḥ virajaḥ katham 
MBcandrajnanaHK-114	śaktigarbha sthito nityaṃ rūpaṃ dhyānavivarjitam || 41 ||	śakti garbha sthitaḥ nityam rūpam dhyāna vivarjitam 
MBcandrajnanaHK-115	pramāṇatarkarahitastva hetuśca nirañjanaḥ |	pramāṇa tarka rahitaḥ tva hetuḥ ca nirañjanaḥ 
MBcandrajnanaHK-116	p. 59b) upamānavaśaścandra śṛṇu pātrastu kalpitaḥ || 42 ||	upamāna vaśaḥ candra śṛṇu pātraḥ tu kalpitaḥ 
MBcandrajnanaHK-117	bālāgraśatabhāgastu vaidikorupagīyate |	bālāgra śata bhāgaḥ tu 
MBcandrajnanaHK-118	trividhaḥ sa tu vijñeyaḥ śāktogrā kārakaḥ smṛtaḥ || 43 ||	trividhaḥ sa tu vijñeyaḥ śākta ugrā kārakaḥ smṛtaḥ 
MBcandrajnanaHK-119	śāntaḥ śūnyo nirābhāsastvaprameyo nirañjanaḥ |	śāntaḥ śūnyaḥ nirābhāsaḥ tu aprameyaḥ nirañjanaḥ 
MBcandrajnanaHK-120	sarvopamānarahitaḥ kalpanā kālavarjitaḥ || 44 ||	sarva upamāna rahitaḥ kalpanā kāla varjitaḥ 
MBcandrajnanaHK-121	dvitīyaṃ yasya yadrūpaṃ śaktiḥ saivopagīyate |	dvitīyam yasya yat rūpam śaktiḥ sā eva upagīyate 
MBcandrajnanaHK-122	guṇātmikā tu vijñeyā prakṛtistattva rūpiṇī || 45 ||	guṇa ātmikā tu vijñeyā prakṛtiḥ tattva rūpiṇī 
MBcandrajnanaHK-123	mahābhūtāḥ smṛtāḥ pañca manobuddhirahaṅkṛtā |	mahābhūtāḥ smṛtāḥ pañca manaḥ buddhiḥ ahaṅkṛtā 
MBcandrajnanaHK-124	eṣā prakṛtirutpanā saṃsthitā sarva dehiṣu || 46 ||	eṣā saṃsthitā dehiṣu 
MBcandrajnanaHK-125	tasyāḥ kriyā kramaṃ sarvaṃ piṇḍadānādi lakṣaṇam |	tasyāḥ kriyā kramam sarvam piṇḍa dāna ādi lakṣaṇam 
MBcandrajnanaHK-126	etacchrutvā dhva?hāsena candro vedavidāṃbaraḥ || 47 ||	etat śrutvā dhva hāsena candraḥ veda vidāṃbaraḥ 
MBcandrajnanaHK-127	vihasya suciraṃ kālaṃ dvijarājobhavra?vedidam |	vihasya su ciram kālam 
MBcandrajnanaHK-128	p. 60a) pañcabhūtātmakaṃ piṇḍaṃ pañcasthāna gataṃ prabho || 48 ||	pañcabhūta ātmakam piṇḍam pañca sthāna gatam prabho 
MBcandrajnanaHK-129	svasthāne ca manobuddhirahaṃkāraḥ pralīyate |	sva sthāne ca manaḥ buddhiḥ ahaṃkāraḥ pralīyate 
MBcandrajnanaHK-130	ye ye bhāvā yathā yātāstathā tatra layaṃ gatāḥ || 49 ||	ye ye bhāvāḥ yathā yātāḥ tathā tatra layam gatāḥ 
MBcandrajnanaHK-131	sarvajñasaṃśayasyāsya kiṃ bravihi vinirṇayam || 50 ||	sarvajña saṃśayasya asya kim bravihi vinirṇayam 
MBcandrajnanaHK-132	śṛṇu sadbhāva kathanaṃ rahasya mamṛtodbhavam |	śṛṇu sadbhāva kathanam rahasya 
MBcandrajnanaHK-133	mūrtairbrahmādibhiścaiva vedarājayamena ca || 51 ||	mūrtaiḥ brahma ādibhiḥ ca eva vedarāja yamena ca 
MBcandrajnanaHK-134	varuṇena tathā candra agnivittapavāyunā |	varuṇena tathā 
MBcandrajnanaHK-135	ātmārthaṃ racitaṃ śāstraṃ kriyākāṇḍamanuttamam || 52 ||	ātma artham racitam śāstram kriyā kāṇḍam anuttamam 
MBcandrajnanaHK-136	piṇḍaṃ ca māsikaśrāddhaṃ tathā sāṃvatśarīyakam |	piṇḍam ca māsika śrāddham tathā sāṃvatśarīyakam 
MBcandrajnanaHK-137	prajārthaṃ sarvabhūtānāṃ jīvanopāya hetukam || 53 ||	prajā artham sarva bhūtānām jīvana upāya hetukam 
MBcandrajnanaHK-138	kṛtaṃ śāstraṃ prajārthānnaṃ pradadanti parasparam |	kṛtam śāstram prajā artha annam pradadanti parasparam 
MBcandrajnanaHK-139	p. 60b) annena jīvalokoyaṃ vartate sarvasambhavaḥ || 54 ||	annena jīva lokaḥ iyam vartate sarva sambhavaḥ   
MBcandrajnanaHK-140	sadbhāvena tu jīvasya arūpasyāvyayasya ca |	sadbhāvena tu jīvasya arūpasya avyayasya ca 
MBcandrajnanaHK-141	śrāddhadānādikaṃ karma na ca piṇḍodaka kriyā || 55 ||	śrāddha dāna ādikam karma na ca piṇḍa udaka kriyā 
MBcandrajnanaHK-142	sarvopamānahīnasya kalpanā rahitasya ca |	sarva upamāna hīnasya kalpanā rahitasya ca 
MBcandrajnanaHK-143	kutaḥ piṇḍaṃ kutaḥ śrāddhaṃ kutodāhādi lakṣaṇam || 56 ||	kutas piṇḍam kutas śrāddham kutas dāha ādi lakṣaṇam 
MBcandrajnanaHK-144	brahmādyairacitaṃ śrāddhaṃ mohanārthaṃ dvijottama |	brahma ādyaiḥ acitam śrāddham mohana artham dvijottama 
MBcandrajnanaHK-145	sthiti kāraṇahetuṃ tvādbhūtā * * *? ta saṃskṛtam || 57 ||	kāraṇa hetum ta saṃskṛtam 
MBcandrajnanaHK-146	karmanāma dvijendrendra asti sarveṣu vastuṣu |	karma nāma dvijendra indra asti sarveṣu vastuṣu 
MBcandrajnanaHK-147	svakarmaṇā sukhaṃ bhuṅkte duḥkhaṃ bhuṅkte svakarmaṇā || 58 ||	sva karmaṇā sukham bhuṅkte duḥkham bhuṅkte sva karmaṇā 
MBcandrajnanaHK-148	yathā ca kurute karma tathaiva bhuñjate punaḥ |	yathā ca kurute karma tathā eva bhuñjate punar 
MBcandrajnanaHK-149	yena yena svabhāvena prakṛtisthāṃ tyajet tanum || 59 ||	yena yena svabhāvena prakṛti sthām tyajet tanum 
MBcandrajnanaHK-150	tena te naiva mārgeṇa sva sva karmopabhuñjate |	tena te na eva mārgeṇa sva sva karma upabhuñjate 
MBcandrajnanaHK-151	p. 61a) jīvaḥ saṃsarate dehānna cāsau mriyate punaḥ || 60 ||	jīvaḥ saṃsarate dehāt na ca asau mriyate punar  
MBcandrajnanaHK-152	janmārthe tyajate kāyaṃ kriyārthaṃ kāyameva ca |	janma arthe tyajate kāyam kriyā artham kāyam eva ca 
MBcandrajnanaHK-153	na naṣṭaścaiva notpanno baddho mukto na cāpyasau || 61 ||	na naṣṭaḥ ca eva na utpannaḥ baddhaḥ muktaḥ na ca api asau 
MBcandrajnanaHK-154	śakterabhyantarasthāyī yathāsau jāyate punaḥ |	śakteḥ abhyantara sthāyī yathā asau jāyate punar 
MBcandrajnanaHK-155	na kṛtirguṇapāśaistu veṣṭitāssarvadehinām || 62 ||	na kṛtiḥ guṇa pāśaiḥ tu veṣṭitāḥ sarva dehinām 
MBcandrajnanaHK-156	tasyāḥ karma yathāsaṃsthaṃ cchāyā vadanu tiṣṭhati |	tasyāḥ karma yathāsaṃstham chāyāḥ vat anu tiṣṭhati 
MBcandrajnanaHK-157	yena bhāvena yo tyantaḥ prakṛtergacchate punaḥ || 63 ||	yena bhāvena prakṛteḥ gacchate punar 
MBcandrajnanaHK-158	tena vai prakṛtaṃ karma tatra tatra pravartate |	tena vai prakṛtam karma tatra tatra pravartate 
MBcandrajnanaHK-159	jīvo dvandva vinirmuktaḥ sarvakarmasusaṃsthitaḥ || 64 ||	jīvaḥ dvandva vinirmuktaḥ sarva karma su saṃsthitaḥ 
MBcandrajnanaHK-160	na tena rahitaṃ kiñcidvidyate bhuvana traye |	na tena rahitam kiñcid vidyate bhuvana traye 
MBcandrajnanaHK-161	yathā vṛtau gatau vāyuḥ saṃsthitasya dvijeśvara || 65 ||	yathā vṛtau gatau vāyuḥ saṃsthitasya dvijeśvara 
MBcandrajnanaHK-162	tathā sarveṣu bhūteṣu śaktirvai prāṇarūpiṇī |	tathā sarveṣu bhūteṣu śaktiḥ vai prāṇa rūpiṇī 
MBcandrajnanaHK-163	p. 61b) tatrasthaṃ yatparaṃ śūnyaṃ candrajīvaṃ tu taṃ viduḥ || 66 ||	tatrastham yat param śūnyam candrajīvam tu tam viduḥ   
MBcandrajnanaHK-164	vinaṣṭakālayogena dhṛtiścaiva dvijādhipa |	vinaṣṭa kāla yogena dhṛtiḥ ca eva dvijādhipa 
MBcandrajnanaHK-165	yat tat tattvadharaṃ śūnyaṃ sa kathaṃ caiva naśyati || 67 ||	yat tat tattva dharam śūnyam sa katham ca eva naśyati 
MBcandrajnanaHK-166	yathā nabhassthito vāyurghaṭā madhye virājate |	yathā nabhaḥ sthitaḥ vāyuḥ ghaṭāḥ madhye virājate 
MBcandrajnanaHK-167	sahasā ca ghaṭe bhinne na vāyurvidyate kvacit || 68 ||	sahasā ca ghaṭe bhinne na vāyuḥ vidyate kvacid 
MBcandrajnanaHK-168	evaṃ sarvaśarīrastho dehapātānna pacyati |	evam sarva śarīra sthaḥ dehapātān na pacyati 
MBcandrajnanaHK-169	darpaṇānanasaṃyoga jalārka pratibimbite || 69 ||	darpaṇa ānana saṃyoga jala arka pratibimbite  /
MBcandrajnanaHK-170	bhraṣṭe ca darpaṇe candra na naṣṭaṃ caiva mānanam |	bhraṣṭe ca darpaṇe candra na naṣṭam ca eva mānanam 
MBcandrajnanaHK-171	jalakṣayādyathā cārko naiva naśyati vai kvacit || 70 ||	jala kṣayāt yathā ca arkaḥ nā eva naśyati vai kvacid 
MBcandrajnanaHK-172	evaṃ dehakṣayād dehī na naṣṭo na ca badhyate |	evam deha kṣayāt dehī na naṣṭaḥ na ca badhyate 
MBcandrajnanaHK-173	sarvagaḥ sarvakartā ca sarvadvandva bahiṣkṛtaḥ || 71 ||	sarvagaḥ sarvakartā ca sarva dvandva bahiṣkṛtaḥ 
MBcandrajnanaHK-174	na tasya kālakalanā na rāgadveṣa eva ca |	na tasya kāla kalanā na rāga dveṣaḥ eva ca 
MBcandrajnanaHK-175	puṣpairgandhai tilaistailaṃ kṣīre sarpistato nalaḥ || 72 ||	puṣpaiḥ gandhaiḥ tilaiḥ tailam kṣīre sarpiḥ tatas nalaḥ 
MBcandrajnanaHK-176	p. 62a) indhane ca yathā saṃsthastathāsau sarvagaḥ paraḥ |	indhane ca yathā saṃsthaḥ tathā asau sarvagaḥ paraḥ 
MBcandrajnanaHK-177	śakterabhyantare jīvaḥ saṃsthito naiva lipyate || 73 ||	śakteḥ abhyantare jīvaḥ saṃsthitaḥ na eva lipyate  /
MBcandrajnanaHK-178	yathā veśmāntara gataṃ nabhaḥ sarvagataṃ sthitam |	yathā veśma antara gatam nabhaḥ sarva gatam sthitam 
MBcandrajnanaHK-179	catuṣkena pranaṣṭe tu tannabho naiva naśyati || 74 ||	catuṣkena pranaṣṭe tu tat nabhaḥ nā eva naśyati  /
MBcandrajnanaHK-180	evaṃ sarvaśarīrasthaḥ śūnyarūpo hyalepakaḥ |	evam sarva śarīra sthaḥ śūnya rūpaḥ hi alepakaḥ 
MBcandrajnanaHK-181	na tasya kālo mṛtyurvā na piṇḍaḥ śrāddhalakṣaṇam || 75 ||	na tasya kālaḥ mṛtyuḥ vā na piṇḍaḥ śrāddha lakṣaṇam 
MBcandrajnanaHK-182	etatsadbhāvakathanaṃ mayā tedyaprakāśitam |	etat sadbhāva kathanam mayā tedya prakāśitam 
MBcandrajnanaHK-183	etacchrutvādyavai candraḥ praphultakamalekṣaṇaḥ || 76 ||	etat śrutvā yavai candraḥ praphulta kamala īkṣaṇaḥ 
MBcandrajnanaHK-184	apūrvamadbhutaṃ deva śrūtaṃ tvatto mayādyavai |	apūrvam adbhutam deva śrūtam tvattaḥ mayā adya avai 
MBcandrajnanaHK-185	prakṛtiḥ kiṃ vidhā caiva rūpaṃ tasyāstu kīdṛśam |	prakṛtiḥ kim vidhā ca eva rūpam tasyāḥ tu kīdṛśam 
MBcandrajnanaHK-186	mānaṃ tu karaṇaṃ tasya pramāṇaṃ vada bhairava || 78 ||	mānam tu karaṇam tasya pramāṇam vada bhairava 
MBcandrajnanaHK-187	p. 62b) anacchā aśirekaurādvikubjā tantu rūpiṇī |	anacchā tantu rūpiṇī 
MBcandrajnanaHK-188	prāṇāpānapravāhena gacchate viśate punaḥ || 79 ||	prāṇa apāna pravāhena gacchate viśate punar 
MBcandrajnanaHK-189	sarpavatkuṭilākārā bālāgraparimāṇagā |	sarpa vat kuṭila ākārā bāla agra parimāṇa gā 
MBcandrajnanaHK-190	guṇāḥ sarve sthitāstasyā uparāgāmaṇeriva || 80 ||	guṇāḥ sarve sthitāḥ tasyāḥ uparāgāmaṇeḥ iva 
MBcandrajnanaHK-191	maṇi rūpāparāśaktiruparāgopamā guṇā |	maṇi guṇā 
MBcandrajnanaHK-192	tena tena svabhāvena tatra tatrāvatiṣṭhate || 81 ||	tena tena svabhāvena tatra tatra avatiṣṭhate 
MBcandrajnanaHK-193	caturdaśa vidhe sarge śaktirnāma parā kalā |	caturdaśa vidhe sarge śaktiḥ nāma parā kalā 
MBcandrajnanaHK-194	darpaṇe ca yathā cchāyā jalamadhye tu tārakāḥ || 82 ||	darpaṇe ca yathā chāyā jala madhye tu tārakāḥ 
MBcandrajnanaHK-195	guṇāḥ prakṛtijāstadvaddṛśyante śakti madhyagāḥ |	guṇāḥ prakṛti jāḥ tadvat dṛśyante madhya gāḥ 
MBcandrajnanaHK-196	karmaṇā svena bhāvena taṃ tu bhuñjanti dehinaḥ || 83 ||	karmaṇā svena bhāvena tam tu bhuñjanti dehinaḥ 
MBcandrajnanaHK-197	śaktigarbha sthito jīvo vaṃśe dhvanirivasthitaḥ |	śakti garbha sthitaḥ jīvaḥ vaṃśe dhvaniḥ iva sthitaḥ 
MBcandrajnanaHK-198	evaṃ śaktikanirjīvaḥ sukhadohlādakaḥ smṛtaḥ || 84 ||	evam śaktika nirjīvaḥ sukha dohlādakaḥ smṛtaḥ 
MBcandrajnanaHK-199	p. 63a) āpādāścaiva mūrdhāntaṃ sarvatraiva vyavasthitaḥ |	ā pādāḥ ca eva mūrdha antam sarvatra eva vyavasthitaḥ 
MBcandrajnanaHK-200	kālāgnyādi śivāntaṃ ca yadrūpaṃ kiñcid dṛśyate || 85 ||	kālāgni ādi śiva antam ca yat rūpam kiñcid dṛśyate 
MBcandrajnanaHK-201	tatra cābhyantare śūnyaṃ saṃsthitaṃ caiva sa prabhuḥ |	tatra ca abhyantare śūnyam saṃsthitam ca eva sa prabhuḥ 
MBcandrajnanaHK-202	aśmāntaragataścaiva asthirandhraśca saṃsthitaḥ || 86 ||	aśma antara gataḥ ca eva asthi randhraḥ ca saṃsthitaḥ 
MBcandrajnanaHK-203	na tena rahitaḥ prāṇaḥ prakaroti gamāgamam |	na tena rahitaḥ prāṇaḥ prakaroti gama agamam 
MBcandrajnanaHK-204	rahasyaṃ tedya vakṣyāmi ekāgraḥ śṛṇu tatparaḥ || 87 ||	rahasyam te idya vakṣyāmi ekāgraḥ śṛṇu tad paraḥ 
MBcandrajnanaHK-205	ata ūrddhaṃ diśaḥ sarvā bhūmirāpo nalastathā |	atas ūrddham diśaḥ sarvāḥ bhūmiḥ āpaḥ nalaḥ tathā 
MBcandrajnanaHK-206	vāyuścakhaṃmanobuddhirahaṅkāraśca ye guṇāḥ || 88 ||	vāyuḥ ca kham manaḥ buddhiḥ ahaṅkāraḥ ca ye guṇāḥ 
MBcandrajnanaHK-207	sarvaśūnyaṃ nirālambaṃ tatra sarve pratiṣṭhitāḥ |	sarva śūnyam nirālambam tatra sarve pratiṣṭhitāḥ 
MBcandrajnanaHK-208	yat kiñcit sakalaṃ bhāvaṃ rūpataḥ keṣusaṃsthitam || 89 ||	yat kiñcid sakalam bhāvam rūpataḥ keṣu saṃsthitam 
MBcandrajnanaHK-209	tadasārataraṃ candrarūpaṃ svapnopamaṃ sthitam |	tat asārataram candra rūpam svapna upamam sthitam 
MBcandrajnanaHK-210	bhrāntiṃ tyaja sa vai putra sarvaṃ śūnye pratiṣṭhitam || 90 ||	bhrāntim tyaja sa vai putra sarvam śūnye pratiṣṭhitam 
MBcandrajnanaHK-211	p. 63b) śūnyāt pravartate śaktiḥ śaktervarṇāḥ prajajñire |	śūnyāt pravartate śaktiḥ śakteḥ varṇāḥ prajajñire 
MBcandrajnanaHK-212	varṇebhyaśca tathā mantrā mantrebhyaḥ sṛṣṭiravyayā || 91 ||	varṇebhyaḥ ca tathā mantrāḥ mantrebhyaḥ sṛṣṭiḥ avyayā 
MBcandrajnanaHK-213	tasmācchūnyaṃ jagaddhyāyedyannanaśyet kadācana |	tasmāt śūnyam jagat dhyāyet yat na naśyet kadācana 
MBcandrajnanaHK-214	yugādinā tato adya nityaṃ sada sataḥ param || 92 ||	yuga ādinā tatas adya nityam sada sataḥ param 
MBcandrajnanaHK-215	hṛdistho lakṣyate naiva sarvadarśī hyalepakaḥ |	hṛdisthaḥ lakṣyate nā eva sarva darśī hi alepakaḥ 
MBcandrajnanaHK-216	nāyaṃ piṇḍesti na śrāddhaṃ na kālakalanā tathā || 93 ||	na ayam na śrāddham na kāla kalanā tathā 
MBcandrajnanaHK-217	sarvakriyā vihīnosau saṃsthito naiva lipyate |	sarva kriyāḥ vihīnaḥ asau saṃsthitaḥ na eva lipyate 
MBcandrajnanaHK-218	bhūtagrāmeṣu sarveṣu śaktyantarvasate prabhuḥ || 94 ||	bhūta grāmeṣu sarveṣu śakti antar vasate prabhuḥ 
MBcandrajnanaHK-219	sa bāhyābhyantaraṃ caiva sarvaṃ tena pratitiṣṭhitam |	sa bāhya abhyantaram ca eva sarvam tena pratitiṣṭhitam 
MBcandrajnanaHK-220	sthitaṃ tadeva bhāṇḍāsthaṃ sarvasya varavarṇakam || 95 ||	sthitam tat eva bhāṇḍa āstham sarvasya vara varṇakam 
MBcandrajnanaHK-221	kriyābhedaguṇānāṃ ca bhedo mantreṣu vidyate |	kriyā bheda guṇānām ca bhedaḥ mantreṣu vidyate 
MBcandrajnanaHK-222	jñānabhedo na vidyeta teṣāṃ śāstrāgameṣu ca || 96 ||	jñāna bhedaḥ na vidyeta teṣām śāstra āgameṣu ca 
MBcandrajnanaHK-223	p. 64a) adyāpi na mayājñātamindrajālasya lakṣaṇam |	adya api na mayā ajñātam indrajālasya lakṣaṇam 
MBcandrajnanaHK-224	prakṛtirnāmadeveśa ādhāradharaṇī yathā || 97 ||	prakṛtiḥ nāma deveśaḥ ādhāra dharaṇī yathā 
MBcandrajnanaHK-225	tataḥ śāstre tvayā pūrvaṃ jīvaṃ caiva sugūhitam |	tatas śāstre tvayā pūrvam jīvam ca eva su gūhitam 
MBcandrajnanaHK-226	na naṣṭā na ca saṃbhrāntiradyāpi parameśvara || 98 ||	na naṣṭā na ca saṃbhrāntiḥ adya api parameśvara 
MBcandrajnanaHK-227	sadbhāvaṃ vadadeveśa yathā jānāmyahaṃ punaḥ || ||	sadbhāvam vada deveśa yathā jānāmi aham punar 
MBcandrajnanaHK-228	yathā nabhaścyutāścandra tuṣārāssa tatopamāḥ |	yathā nabhaḥ cyutāḥ candra tuṣārāḥ sa tata upamāḥ 
MBcandrajnanaHK-229	saro madhye ca patitā galitā ekatāṃ gatāḥ || 100 ||	saraḥ madhye ca patitāḥ galitāḥ ekatām gatāḥ 
MBcandrajnanaHK-230	tathā guṇāmarasthā tu śaktistaddharmadhāriṇī |	tathā guṇa amara sthā tu śaktiḥ tad dharma dhāriṇī 
MBcandrajnanaHK-231	nirguṇatvaṃ guṇaṃ yasya arūpaṃ caiva rūpakam || 101 ||	nirguṇa tvam guṇam yasya arūpam ca eva rūpakam 
MBcandrajnanaHK-232	tathā vidhaṃ tu yat kiñcicchakti garbhe vyavasthitam |	tathā vidham tu yat kiñcid śakti garbhe vyavasthitam 
MBcandrajnanaHK-233	tena sarvamidaṃ vyāptamābrahmabhuvanāntikam || 102 ||	tena sarvam idam vyāptam ābrahma bhuvana antikam 
MBcandrajnanaHK-234	p. 64b) tataḥ kriyāḥ pravartante hetu proktamidaṃ jagat |	tatas kriyāḥ pravartante hetu proktam idam jagat 
MBcandrajnanaHK-235	āṇavaṃ ca tathā śāktaṃ bindunādātmakaṃ ca yat || 103 ||	āṇavam ca tathā śāktam bindu nāda ātmakam ca yat 
MBcandrajnanaHK-236	vāyūnāṃ ca gamaṃ kiñcit prāṇāpānakṣaṇātmikam |	vāyūnām ca gamam kiñcid prāṇa apāna kṣaṇa ātmikam 
MBcandrajnanaHK-237	sarvaśivamayaṃ candra śivo jīvaḥ prakīrtitaḥ || 104 ||	sarva śiva mayam candra śivaḥ jīvaḥ prakīrtitaḥ 
MBcandrajnanaHK-238	śāstrajālaṃ parityajya tarkajālamathottaram |	śāstra jālam parityajya tarka jālam atha uttaram 
MBcandrajnanaHK-239	adhyātmajñānasambodhaṃ śaktigarbhaṃ tu yo bhyaset || 105 ||	adhyātma jñāna sambodham śakti garbham tu yaḥ bhyaset 
MBcandrajnanaHK-240	naiva naśyatyasau candra na kālaścāsya vidyate |	na eva naśyati asau candra na kālaḥ ca asya vidyate 
MBcandrajnanaHK-241	ajarāmarabhūto vai bhavate nātrasaṃśayaḥ || 106 ||	ajara amara bhūtaḥ vai bhavate na atra saṃśayaḥ 
MBcandrajnanaHK-242	jīvo na jāto na mṛtaḥ parāparagamaḥ sthitaḥ |	jīvaḥ na jātaḥ na mṛtaḥ para apara gamaḥ sthitaḥ 
MBcandrajnanaHK-243	karmaṇāṃ caiva mahato guṇānāṃ bhūtajastathā || 107 ||	karmaṇām ca eva mahataḥ guṇānām bhūtajaḥ tathā 
MBcandrajnanaHK-244	prakṛtistu parāśaktiryatraiva bhrānti lakṣaṇam |	prakṛtiḥ tu parā śaktiḥ yatra eva bhrānti lakṣaṇam 
MBcandrajnanaHK-245	idaṃ rahasyaṃ paramaṃ kathayāmi tavākhilam || 108 ||	idam rahasyam paramam kathayāmi tava akhilam 
MBcandrajnanaHK-246	avijñāte pare tattve na tyajet tu kriyā kramam |	avijñāte pare tattve na tyajet tu kriyā kramam 
MBcandrajnanaHK-247	p. 65a) paśutvaṃ ca patitvaṃ ca dvau bhedau ca śarīriṇām || 109 ||	paśu tvam ca pati tvam ca dvau bhedau ca śarīriṇām 
MBcandrajnanaHK-248	paśutvāt karmajālena gṛhyate hyamṛtodbhavam |	paśu tvāt karma jālena gṛhyate hi amṛta udbhavam 
MBcandrajnanaHK-249	yathābhrairarkaraśmibhyo darpaṇaṃ ca malena ca || 110 ||	yathā abhraiḥ arka raśmibhyaḥ darpaṇam ca malena ca 
MBcandrajnanaHK-250	sphaṭikaṃ pāṃsunā yad vat tathā jñānaṃ tamo vṛtam |	sphaṭikam pāṃsunā yat vat tathā jñānam tamaḥ vṛtam 
MBcandrajnanaHK-251	ajñānāddṛśyate janturguṇapāśaistu yantritaḥ || 111 ||	ajñānāt dṛśyate jantuḥ guṇa pāśaiḥ tu yantritaḥ 
MBcandrajnanaHK-252	karmopabhogaṃ bhuñjīta tiṣṭhate svānna yoniṣu |	karma upabhogam bhuñjīta tiṣṭhate sva anna yoniṣu 
MBcandrajnanaHK-253	na deho mriyate bhuṅkte karmabhogeti tasya vai || 112 ||	na dehaḥ mriyate bhuṅkte karma bhoga iti tasya vai 
MBcandrajnanaHK-254	patijñānaṃ prabuddhastu sarvajñaḥ parameśvaraḥ |	pati jñānam prabuddhaḥ tu sarvajñaḥ parameśvaraḥ 
MBcandrajnanaHK-255	prāpnoti jñānamabhyāsājjñānānmuktastu mocakaḥ || 113 ||	prāpnoti jñānam abhyāsāt jñānāt muktaḥ tu mocakaḥ 
MBcandrajnanaHK-256	caṇḍālo hīnajanmā ca śvapaco vāpi phukkasaḥ |	caṇḍālaḥ hīna janmā ca śvapacaḥ vā api phukkasaḥ 
MBcandrajnanaHK-257	sarvagaṃ paramaṃ devaṃ hetūpādhivivarjitam || 114 ||	sarvagam paramam devam hetu upādhi vivarjitam 
MBcandrajnanaHK-258	samyag jānāti yaścandra sa yogī cottamomataḥ |	samyak jānāti yaḥ candra sa yogī ca uttamaḥ mataḥ 
MBcandrajnanaHK-259	p. 65b) vipro vā mūḍhabuddhiśca ajñāna spṛśya eva saḥ || 115 ||	vipraḥ vā mūḍha buddhiḥ ca ajñāna spṛśyaḥ eva saḥ   
MBcandrajnanaHK-260	caṇḍālo yadi vā jñānī tasmai deyaṃ pratigraham |	caṇḍālaḥ yadi vā jñānī tasmai deyam pratigraham 
MBcandrajnanaHK-261	tasya hastā tu vai grāhya sa ca pūjyo yathā hyaham || 116 ||	tasya tu vai grāhya sa ca pūjyaḥ yathā hi aham 
MBcandrajnanaHK-262	bhrāntiṃ tyajasva vai candra hyetajjñānaṃ samabhya sa |	bhrāntim tyajasva vai candra hi etat jñānam sa 
MBcandrajnanaHK-263	ajñānācca kriyākāṇḍaṃ jñānāt karmakṣayo bhavet || 117 ||	ajñānāt ca kriyā kāṇḍam jñānāt karma kṣayaḥ bhavet 
MBcandrajnanaHK-264	niyamo na ca vā kālo bhrāntimetāṃ parityaja |	niyamaḥ na ca vā kālaḥ bhrāntim etām parityaja 
MBcandrajnanaHK-265	ajñānāt karmapāśaistu prakṛtairbadhyate punaḥ || 118 ||	ajñānāt karma pāśaiḥ tu prakṛtaiḥ badhyate punar 
MBcandrajnanaHK-266	prabuddhānāṃ sadā candra sarvajñānamayaṃ jagat |	prabuddhānām sadā candra sarva jñāna mayam jagat 
MBcandrajnanaHK-267	sarvaṃ jagat svadehaṃ vā parānandena pūritam || 119 ||	sarvam jagat sva deham vā parānandena pūritam 
MBcandrajnanaHK-268	sarvaśaṅkāḥ parityajya śūnyabhūmiṃ bhavet tu saḥ |	sarva śaṅkāḥ parityajya śūnya bhūmim bhavet tu saḥ 
MBcandrajnanaHK-269	na kālo na yamaḥ kaścidetā bāla vibhīṣakāḥ || 120 ||	na kālaḥ na yamaḥ kaścid etāḥ bāla vibhīṣakāḥ 
MBcandrajnanaHK-270	sarvopamā na hīnasya kalpanā rahitasya ca |	sarvā upamā na hīnasya kalpanā rahitasya ca 
MBcandrajnanaHK-271	p. 66a) kutaḥ kālaḥ kuto mṛtyurnarake śāsanāḥ katham || 121 ||	kutas kālaḥ kutas mṛtyuḥ narake śāsanāḥ katham  /
MBcandrajnanaHK-272	sarvaṃ śūnyamayaṃ dhyāyeccharīrā vayavaṃ ca yat |	sarvam śūnya mayam dhyāyet śarīrāḥ vayavam ca yat 
MBcandrajnanaHK-273	kāyaṃ śūnyamayaṃ kṛtvā na kiñcidapi carcayet || 122 ||	kāyam śūnya mayam kṛtvā na kiñcid api carcayet  /
MBcandrajnanaHK-274	vikalpa yoniṃ majjanti jantavaḥ prakṛtestute |	vikalpa yonim majjanti jantavaḥ 
MBcandrajnanaHK-275	guṇapāśairnibadhyante mūḍhāḥ pāparatāḥ punaḥ || 123 ||	guṇa pāśaiḥ nibadhyante mūḍhāḥ pāpa ratāḥ punar 
MBcandrajnanaHK-276	yatra yatra hi yonyantarjāyante te svakarmaṇā |	yatra yatra hi yoni antar jāyante te sva karmaṇā 
MBcandrajnanaHK-277	tatra tatrājñā bhāvatvaṃ paśūnāṃ syāt sadodūpa || 124 ||	tatra tatra ājñā bhāva tvam paśūnām syāt 
MBcandrajnanaHK-278	karmāṇi kasya vai deva hyetan me vada tattvataḥ |	karmāṇi kasya vai deva hi etat me vada tattvataḥ 
MBcandrajnanaHK-279	yadi jīvo hi muktaśca nīrūpaḥ khasvarūpakaḥ || 125 ||	yadi jīvaḥ hi muktaḥ ca nīrūpaḥ kha svarūpakaḥ 
MBcandrajnanaHK-280	nīrūpasya kathaṃ karma śūnyabhūtasya vai prabho |	nīrūpasya katham karma śūnya bhūtasya vai prabho 
MBcandrajnanaHK-281	etadicchāmyahaṃ śrotuṃ tvat pramādāt kapāla bhṛt || 126 ||	etat icchāmi aham śrotum tvad pramādāt kapāla bhṛt 
MBcandrajnanaHK-282	p. 66b) śūnyasya dviguṇasyaiva karma tasya karoti kim |	śūnyasya dviguṇasya eva karma tasya karoti kim 
MBcandrajnanaHK-283	prakṛtirguṇasaṃpūrṇā mriyate jāyate tathā || 127 ||	prakṛtiḥ guṇa saṃpūrṇā mriyate jāyate tathā 
MBcandrajnanaHK-284	kṛta karma tathātmīyaṃ yathāsau bhuñjate punaḥ |	kṛta karma tathā ātmīyam yathā asau bhuñjate punar 
MBcandrajnanaHK-285	na jīvo bhuñjate karma na cāsau prakṛtirguṇaiḥ || 128 ||	na jīvaḥ bhuñjate karma na ca asau prakṛtiḥ guṇaiḥ 
MBcandrajnanaHK-286	badhyate na ca vā mukto nāsthāyī sthāna varjitaḥ |	badhyate na ca vā muktaḥ na asthāyī sthāna varjitaḥ 
MBcandrajnanaHK-287	sarvajñaḥ sarvagodhyakṣaḥ kharūpī khamanaḥ khagaḥ  || 129 ||	            
MBcandrajnanaHK-288	iti me yogino dṛṣṭābrahmaviṣṇvendra bhārgavāḥ |	iti me yoginaḥ dṛṣṭāḥ brahma viṣṇu indra bhārgavāḥ 
MBcandrajnanaHK-289	te pi pra?mohamāpannā jīvaṃ jñānavidhau sadā || 130 ||	te pi pramoham āpannāḥ jīvam jñāna vidhau sadā 
MBcandrajnanaHK-290	satyaṃ ca kathayiṣyāmi dvijarājādyame śṛṇu |	satyam ca kathayiṣyāmi śṛṇu 
MBcandrajnanaHK-291	pravṛtyarthaṃ tu bhūtānāṃ prakṛtārthamasaṃsthitaḥ || 131 ||	pravṛti artham tu bhūtānām prakṛta artham asaṃsthitaḥ 
MBcandrajnanaHK-292	tathābaddhaṃ jagatsarvaṃ mūtremaṇigaṇā iva |	tathā ābaddham jagat sarvam mūtremaṇi gaṇāḥ iva 
MBcandrajnanaHK-293	p. 67a) ādhāradharaṇī śaktiraśirāhaṃ sa rūpiṇī || 132 ||	ādhāra dharaṇī śakti raśirā aham sa rūpiṇī   
MBcandrajnanaHK-294	tanmadhye saṃsthito jīvaḥ kharūpī vyāpakaḥ prabhuḥ |	tad madhye saṃsthitaḥ jīvaḥ kharūpī vyāpakaḥ prabhuḥ 
MBcandrajnanaHK-295	yathā veśmāntara gataṃ nabhaḥ sarvagataṃ sthitam || 133 ||	yathā veśma antara gatam nabhaḥ sarva gatam sthitam 
MBcandrajnanaHK-296	veśmapātena naṣṭosau jīvaścādhāra pātane |	veśma pātena naṣṭaḥ asau jīvaḥ ca ādhāra pātane 
MBcandrajnanaHK-297	tad vat sarvagataṃ brahma sarvatraiva susaṃsthitam || 134 ||	tat vat sarva gatam brahma sarvatra eva su saṃsthitam 
MBcandrajnanaHK-298	tārakendra tyajabhrāntiṃ kimanyat kathayāmite || 35 ||	tāraka indra tyaja bhrāntim kim anyat kathaya mama te 
MBcandrajnanaHK-299	atyantagahanaṃ deva rahasyaṃ bhuvidurlabham |	atyanta gahanam deva rahasyam bhuvi durlabham 
MBcandrajnanaHK-300	tvat prasādānmayājñātaṃ jīvalakṣaṇamuttamam || 36 ||	tvat prasādāt mayā ajñātam jīva lakṣaṇam uttamam 
MBcandrajnanaHK-301	adyame saphalaṃ janma adya me saphalaṃ tapaḥ |	adi ame sa phalam janma adya me sa phalam tapaḥ 
MBcandrajnanaHK-302	adya jātosmyahaṃ deva jñānenānena bhairava || 37 ||	adya jātaḥ asmi aham deva jñānena anena bhairava 
MBcandrajnanaHK-303	mahatāstotrarājena devadevo maheśvaraḥ |	mahatā stotra rājena devadevaḥ maheśvaraḥ 
MBcandrajnanaHK-304	toṣito vai mahādevaścandreṇa ca yathā kṛtaḥ || 38 ||	toṣitaḥ vai mahādevaḥ candreṇa ca yathā kṛtaḥ 
MBcandrajnanaHK-305	p. 67b) parituṣṭena devena varaṃ dattvā yathāvidhi |	parituṣṭena devena varam dattvā yathāvidhi 
MBcandrajnanaHK-306	jñānabhogī ca madvākyāt pūrvoktamyā mṛtodbhava || 39 ||	jñāna bhogī ca mad vākyāt mṛta udbhava 
MBcandrajnanaHK-307	mahābhāgi bhaviṣyaiṣā metanmedattavāndharam |	mahābhāgi bhaviṣyā eṣā mā etat me dattavān dharam 
MBcandrajnanaHK-308	evamuktvā yadā devo virarāma maheśvaraḥ || 40 ||	evam uktvā yadā devaḥ virarāma maheśvaraḥ 
MBcandrajnanaHK-309	candraśca prāptavānjñānaṃ candrajñānamataḥ smṛtam |	candraḥ ca prāptavān jñānam candra jñānam atas smṛtam 
MBcandrajnanaHK-310	bhaktāyedaṃ pradātavyaṃ śraddhādānāya dhīmate || 41 ||	bhaktāya idam pradātavyam śraddhā dānāya dhīmate 
MBcandrajnanaHK-311	yonindayati mohena idaṃ śāstramagauravam |	yaḥ nindayati mohena idam śāstram a gauravam 
MBcandrajnanaHK-312	sa mūḍhaḥ sarvadā tiṣṭedātmajñānenasaṃyutaḥ || 42 ||	sa mūḍhaḥ sarvadā tiṣṭet ātma jñānena saṃyutaḥ 
MBcandrajnanaHK-313	MUKTABODHA INDOLOGICAL RESEARCH INSTITUTE©2011 Muktabodha Indological Research Institute  All Rights Reserved.E-texts may be viewed only online or downloaded for private study.E-texts may not, under any circumstances, be copied, republished,reproduced, distributed or sold, either in original or altered form, withoutthe express permission of Muktabodha Indological Research Institute in writing.Data-entered by the staff of Muktabodha under the direction of Mark S. G. Dyczkowski.	muktabodha indological research muktabodha indological research institute all rights reserved texts may be viewed only online or downloaded for private studye texts may not under any circumstances be copied republished reproduced distributed or sold either in original or altered form withoutthe express permission of muktabodha indological research institute in writing data entered by the staff of muktabodha under the direction of mark s g dyczkowski 
