segmentnr	original	analyzed
MBcidgaganacandrika-HK-0	Muktabodha E-text in UTF-8	muktabodha etext in utf
MBcidgaganacandrika-HK-1	###########################################################################MUKTABODHA INDOLOGICAL RESEARCH INSTITUTEwww.muktabodha.org©2011 Muktabodha Indological Research Institute  All Rights Reserved.E-texts may be viewed only online or downloaded for private study.E-texts may not, under any circumstances, be copied, republished,reproduced, distributed or sold, either in original or altered form, withoutthe express permission of Muktabodha Indological Research Institute in writing.Data-entered by the staff of Muktabodha under the direction of Mark S. G. Dyczkowski.Catalog number : M00014	muktabodha indological research muktabodha indological research institute all rights reserved texts may be viewed only online or downloaded for private studye texts may not under any circumstances be copied republished reproduced distributed or sold either in original or altered form withoutthe express permission of muktabodha indological research institute in writing data entered by the staff of muktabodha under the direction of mark s g dyczkowskicatalog number  /
MBcidgaganacandrika-HK-2	Uniform title: cidgaganacandrikā	uniform title cidgaganacandrikā 
MBcidgaganacandrika-HK-3	Author : śrīvatsa	authoḥ śrīvatsa 
MBcidgaganacandrika-HK-4	Alternate name : kālidāsa	alternate name kālidāsa 
MBcidgaganacandrika-HK-5	Editor : trivikramatīrtha	e d itoḥ trivikramatīrtha 
MBcidgaganacandrika-HK-6	Alternate name : Woodroffe, John	alternate name woodroffe john 
MBcidgaganacandrika-HK-7	Alternate name : Avalon, Arthur	alte name avalon arthuḥ 
MBcidgaganacandrika-HK-8	Description: cidgaganacandrikaa by śrīvatsa alias kālidāsa	description cidgaganacandrikaa by śrīvatsa alias kālidāsa 
MBcidgaganacandrika-HK-9	E-text copied from Arthur Avalon series. Tantrik texts ; 20.	etext copied from arthur avalon series tantrik texts
MBcidgaganacandrika-HK-10	Published:  Calcutta : Sanskrit Book Depot ; London : Luzac & Co., 1937.	published calcutta sanskrit book depot london luzac co 
MBcidgaganacandrika-HK-11	Notes: Data-entered by the staff of Muktabodha under the supervision of Mark Dyczkowski.	notes data entered by the staff muktabodha under the supervision of mark dyczkowski 
MBcidgaganacandrika-HK-12	Revision 0: 30/11/2005	revision 
MBcidgaganacandrika-HK-13	Publisher : Sanskrit Book Depot	publisher sanskrit book depot 
MBcidgaganacandrika-HK-14	Publication year : 1937	publication year 
MBcidgaganacandrika-HK-15	Publication city : Calcutta	publication citi calcutta 
MBcidgaganacandrika-HK-16	Publication country : India	publication country india 
MBcidgaganacandrika-HK-17	kṣīrodaṃ paurṇamāsīśaśadhara iva yaḥ prasphurannistaraṅgaṃ	kṣīrodam paurṇamāsī śaśadharaḥ iva yaḥ prasphurat nistaraṅgam 
MBcidgaganacandrika-HK-18	cidvyoma sphāranādaṃ rucivisaralasadbinduvakrormimālam |	cit vyoma sphāra nādam ruci visara lasat bindu vakra ūrmi mālam 
MBcidgaganacandrika-HK-19	ādyaspandasvarūpaḥ prathayati sakṛdoṅkāraśuṇḍaḥ kriyādṛg	                 
MBcidgaganacandrika-HK-20	dantyāsyo'yaṃ haṭhādyaḥ śamayatu duritaṃ śaktijanmā gaṇeśaḥ || 1 ||	haṭha ādyaḥ śamayatu duritam śakti janmā gaṇeśaḥ  /
MBcidgaganacandrika-HK-21	sthūlaṃ sūkṣmaṃ paraṃ ca trividhamiha tagad yatprathāveśasiddhyā	sthūlam sūkṣmam param ca trividham iha yat prathā āveśa siddhyā 
MBcidgaganacandrika-HK-22	yuktaṃ sattā yadīyā sphurati ca parataḥ svaprathaikasvabhāvā |	yuktam sattā yadīyā sphurati ca paratas sva prathā eka svabhāvā 
MBcidgaganacandrika-HK-23	bhāmūrti yaṃ vimarśakriyamanupatitā lakṣyate lokavṛttiḥ	bhā mūrti yam vimarśa kriyam anupatitā lakṣyate loka vṛttiḥ 
MBcidgaganacandrika-HK-24	sanmārgālokanāya vyapanayatu sa vastāmasīṃ vṛttimīśaḥ || 2 ||	sat mārga ālokanāya vyapanayatu sa vaḥ tāmasīm vṛttim īśaḥ   
MBcidgaganacandrika-HK-25	iha kālidāsacandraprasūtirānandinī stutirvyājāt |	iha kālidāsa candra prasūtiḥ ānandinī stutiḥ vyājāt 
MBcidgaganacandrika-HK-26	cidgaganacandrikābdheḥ śamayatu saṃsāradāvadavathuṃ vaḥ || 3 ||	cit gagana candrikā abdheḥ śamayatu saṃsāra dāva davathum vaḥ  /
MBcidgaganacandrika-HK-27	cillocanena satataṃ śivamīkṣitumanvaye ca sadbhāvam |	cit locanena satatam śivam īkṣitum anvaye ca sadbhāvam 
MBcidgaganacandrika-HK-28	labdhuṃ ca pūrṇabhāvaṃ yadi cetaḥ samupādhvamimām || 4 ||	labdhum ca pūrṇa bhāvam yadi cetaḥ samupādhvam imām 
MBcidgaganacandrika-HK-29	hṛdguhāmabhilaṣannahantayā dṛkkriyāvapuradṛkkriyāpadam |	hṛd guhām abhilaṣan ahantayā dṛkkriyā vapuḥ a dṛkkriyā padam 
MBcidgaganacandrika-HK-30	santamemi samabhāvadaṃ śivaṃ sakhyahāniramunā hi sūyate || 5 ||	santam emi sama bhāva dam śivam sakhya hāniḥ amunā hi sūyate  /
MBcidgaganacandrika-HK-31	yā'hamityuditavāk parā ca sā yaḥ prakāśalulitātmavigrahaḥ |	yā aham iti udita vāc parā ca sā yaḥ prakāśa lulita ātma vigrahaḥ 
MBcidgaganacandrika-HK-32	yau mithaḥ samuditāvihonmukhau tau ṣaḍadhvapitarau śraye śivau || 6 ||	yau mithas samuditau iha unmukhau tau ṣaḍadhva pitarau śraye śivau 
MBcidgaganacandrika-HK-33	śaktinetrapariṇaddhamāsthitaṃ pūrṇabhāmayapayodhimanthatām	śakti netra pariṇaddham āsthitam pūrṇa bhā maya payodhi mantha tām 
MBcidgaganacandrika-HK-34	devi tarpaṇasudhākalāśrayaṃ rudramandaramahaṃ sphuṭaṃ bhaje || 7 ||	devi tarpaṇa sudhā kalā āśrayam rudra mandaram aham sphuṭam bhaje  /
MBcidgaganacandrika-HK-35	yo'bhavad bhavati yastathetaro yo bhaviṣyati pṛthakkriyo janaḥ |	yaḥ bhavat bhavati yaḥ tathā itaraḥ yaḥ bhaviṣyati pṛthak kriyaḥ janaḥ 
MBcidgaganacandrika-HK-36	tatra yo'dharamahantayaikayā santamasmi hṛdirandhra ānataḥ || 8 ||	tatra yodharam ahantayā ekayā santam asmi hṛdirandhre ānataḥ 
MBcidgaganacandrika-HK-37	viśvasadmani sadātmanīśvare pūraṇāt puruṣatāmupeyuṣi |	viśva sadmani sat ātmani īśvare pūraṇāt puruṣa tām upeyuṣi 
MBcidgaganacandrika-HK-38	ye manaḥ praṇidadhurmaharṣayastān patañjalimukhānupāsmahe || 9 ||	ye manaḥ praṇidadhuḥ mahā ṛṣayaḥ tān patañjali mukhān upāsmahe 
MBcidgaganacandrika-HK-39	khecarīmukhamarīcijālakaṃ vyomaśaktitanu saṃśraye sadā |	khecarī mukha marīci jālakam vyomaśakti tanu saṃśraye sadā 
MBcidgaganacandrika-HK-40	śambhudakṣatanujāvabhāsayā yatra viśvamanukartumīhate || 10 ||	śambhu dakṣa tanuja avabhāsayā yatra viśvam anukartum īhate  /
MBcidgaganacandrika-HK-41	khaṇḍasatprasaragarbhayā yayā lakṣitaṃ sphuravipūrṇasattayā |	khaṇḍa sat prasara garbhayā yayā lakṣitam sphura vipūrṇa sattayā 
MBcidgaganacandrika-HK-42	tattvamaiśvaramakhaṇḍamambikāṃ tvāṃ praṇaumyakhilatattvanāyikām || 11 ||	tattvam aiśvaram akhaṇḍam ambikām tvām praṇaumi akhila tattva nāyikām 
MBcidgaganacandrika-HK-43	yaḥ kilāsa sa kilāsa īśvaraḥ khyātasattvalulitordhvamūrdhani |	yaḥ sa kilāsaḥ īśvaraḥ khyāta sattva lulita ūrdhva mūrdhani 
MBcidgaganacandrika-HK-44	pratyahaṃ janani yatra tiṣṭhati tvaṃ sa sattvavapuradrirasya yaḥ || 12 ||	pratyaham janani yatra tiṣṭhati tvam sa sattva vapuḥ adriḥ asya yaḥ 
MBcidgaganacandrika-HK-45	kalpanātigamatīndriyaṃ ca yallakṣyamujjhati bahirmukhaṃ tathā |	kalpanā atigam atīndriyam ca yat lakṣyam ujjhati bahirmukham tathā 
MBcidgaganacandrika-HK-46	antarālagamabhāvabhāvayostannato'smi sadahaṃ nirākṛti || 13 ||	antarāla gama bhāva bhāvayoḥ tat nataḥ asmi sat aham nirākṛti 
MBcidgaganacandrika-HK-47	amba yadbhavati tattdātmanā svairitāmajahadadvayodayam |	amba yat bhavati tat tdā ātmanā svairi tām ajahat a dvaya udayam 
MBcidgaganacandrika-HK-48	tāvakaṃ padamapākṛtakramaṃ brahma tatsaditi vā śrutaṃ bhaje || 14 ||	tāvakam padam apākṛta kramam brahma tat sat iti vā śrutam bhaje 
MBcidgaganacandrika-HK-49	deśakālakalanā viśeṣato yad bhavāni bihitaṃ nigadyate |	deśa kāla kalanā viśeṣataḥ yat bhavāni bihitam nigadyate 
MBcidgaganacandrika-HK-50	vyaktijāti tanusaṃśritakramaṃ taddhitaṃ tava bahirvijṛmbhaṇam || 15 ||	vyakti jāti tanu saṃśrita kramam tat hitam tava bahis vijṛmbhaṇam 
MBcidgaganacandrika-HK-51	sattvamamba ! vihitasya vastunstatprasāditadayodayaṃ vapuḥ |	sattvam amba vihitasya vastunaḥ tad prasādita dayā udayam vapuḥ 
MBcidgaganacandrika-HK-52	syāt tamaśca yadidaṃ niṣiddhyate dve rajo sadasadanyarūpataḥ || 16 ||	syāt tamaḥ ca yat idam niṣiddhyate dve sat asat anya rūpataḥ 
MBcidgaganacandrika-HK-53	yat tamo'nyadiha tat kṣitervapuḥ sattvamanyadiha tejasaḥ śive |	yat tamaḥ nyat iha tat kṣiteḥ vapuḥ sattvam anyat iha tejasaḥ śive 
MBcidgaganacandrika-HK-54	miśraṇotthamitaradrajastayostvatkasattvajamato guṇatrayam || 17 ||	miśraṇa uttham itarat rajaḥ tayoḥ tvad ka sattva jam atas guṇatrayam 
MBcidgaganacandrika-HK-55	īśvarasya tava bhartturakṣayaiśvaryarūpamasi tattvamambike |	īśvarasya tava bharttuḥ akṣaya aiśvarya rūpam asi tat tvam ambike 
MBcidgaganacandrika-HK-56	jñānamasya śuci karma vā phalaṃ te virāgamayapūrṇatāphale || 18 ||	jñānam asya śuci karma vā phalam te virāga maya pūrṇa tā phale 
MBcidgaganacandrika-HK-57	jyotiramba hṛdi vidyayekṣitaṃ yallagh prasṛtamarghamaṇḍape |	jyotiḥ amba hṛdi vidyayā īkṣitam yat lagh prasṛtam arghamaṇḍape 
MBcidgaganacandrika-HK-58	dhūmalakṣmaguru yacca taccyutaṃ te tu sattvatamasī vapustava || 19 ||	dhūma lakṣma guru yat ca tat cyutam te tu sattva tamasī vapuḥ tava 
MBcidgaganacandrika-HK-59	tvaṃ hi rudrajakaṭākṣavartinī jāyamānamavalokya caṇḍike |	tvam hi rudra ja kaṭākṣa vartinī jāyamānam avalokya caṇḍike 
MBcidgaganacandrika-HK-60	sāṃkhyayogapathadeśikadvayaṃ jātasaṃmatisamādhikaṃ yathā || 20 ||	sāṃkhya yoga patha deśika dvayam jāta saṃmati samādhikam yathā 
MBcidgaganacandrika-HK-61	saprakāśakṛtamajjanaṃ jagat kurvatī bhavasi pūrṇimā śive |	sa prakāśa kṛta majjanam jagat kurvatī bhavasi pūrṇimā śive 
MBcidgaganacandrika-HK-62	pūrṇameva tava rūpamanyathā kurvatī kila kuhūḥ pratīyase || 21 ||	pūrṇam eva tava rūpam anyathā kurvatī kila kuhūḥ pratīyase  /
MBcidgaganacandrika-HK-63	pūrṇatākṛśatayoryadantaraṃ tatra kāli vijahatkrame sthitā |	pūrṇa tā kṛśa tayoḥ yat antaram tatra kāli vijahat krame sthitā 
MBcidgaganacandrika-HK-64	darśitakramavibhāgasaṃbhramaṃ kālamadyatanamattumīhase || 22 ||	darśita krama vibhāga saṃbhramam kālam adyatanam attum īhase  /
MBcidgaganacandrika-HK-65	mātṛmeyamitisādhanātmikā tvatkṛtonmiṣati yā vikalpadhīḥ |	mātṛ mā iyam iti sādhana ātmikā tvad kṛtā unmiṣati yā vikalpa dhīḥ 
MBcidgaganacandrika-HK-66	tvatsvarūpamakalaṅkitaṃ tayā kasya devi viduṣo na muktatā || 23 ||	tvad sva rūpam akalaṅkitam tayā kasya devi viduṣaḥ na mukta tā 
MBcidgaganacandrika-HK-67	akramakramavimarśalakṣaṇaṃ yā kramākramamayī kramākramam |	akrama krama vimarśa lakṣaṇam yā kramākrama mayī kramākramam 
MBcidgaganacandrika-HK-68	akramaṃ śivamavekṣya madhyagaṃ tvāṃ ca satkulamidaṃ tavānanam || 24 ||	akramam śivam avekṣya madhya gam tvām ca sat kulam idam tava ānanam 
MBcidgaganacandrika-HK-69	vedyavedya(da)kavibhedadakṣayā māyayā kramavadaṅgagāminī |	vedya vedya daka vibheda dakṣayā māyayā kramavat aṅga gāminī 
MBcidgaganacandrika-HK-70	yā sthitāmba bahirakṣakāṅkṣiṇī tāṃ jahi tvamaṇutāṃ mayi sthitām || 25 ||	yā sthitā amba bahis rakṣa kāṅkṣiṇī tām jahi tvam aṇu tām mayi sthitām 
MBcidgaganacandrika-HK-71	karma yad vividhavāsanātmakaṃ māyayā saha kṛtāṇubhāvayā |	karma yat vividha vāsanā ātmakam māyayā saha kṛta aṇu bhāvayā 
MBcidgaganacandrika-HK-72	vṛttibhistava vilāpyate hi tad devi ! bhānurucibhiryathā tamaḥ || 26 ||	vṛttibhiḥ tava vilāpyate hi tat devi bhānu rucibhiḥ yathā tamaḥ 
MBcidgaganacandrika-HK-73	cinmayīkṛtamato(')kṣadṛśyayā guhyayā'mba viparītacaryayā |	cinmayīkṛta mata ukṣa dṛśyayā guhyayā amba viparīta caryayā 
MBcidgaganacandrika-HK-74	labhyate samarasīkṛtākhiladvaitavṛtti tava ghasmaraṃ vapuḥ || 27 ||	labhyate samarasīkṛta akhila dvaita vṛtti tava ghasmaram vapuḥ  /
MBcidgaganacandrika-HK-75	yāścaranti tava khe cidātmake śaktayaḥ karaṇalakṣaṇāḥ śive |	yāḥ caranti tava khe cit ātmake śaktayaḥ karaṇa lakṣaṇāḥ śive 
MBcidgaganacandrika-HK-76	muktabāhyapadajṛmbhaṇodyamāḥ tvaṃ hi tiṣṭhasi tadūrdhvage pathi || 28 ||	mukta bāhya pada jṛmbhaṇa udyamāḥ tvam hi tiṣṭhasi tad ūrdhva ge pathi 
MBcidgaganacandrika-HK-77	saptadhā vamasi yā tvamīśvari vyomaśāntamukhacidguṇāspadam |	saptadhā vamasi yā tvam īśvari vyoma śānta mukha cit guṇa āspadam 
MBcidgaganacandrika-HK-78	āśritān nayasi nāparaṃ śivaṃ dvandvayā'dvayapadātilaṅkinī || 29 ||	āśritān nayasi na aparam śivam dvandva yādvaya padāti laṅkinī 
MBcidgaganacandrika-HK-79	yā pramātari niṣeduṣī parā pratyagātmani vimarśavigrahā |	yā pramātari niṣeduṣī parā pratyagātmani vimarśa vigrahā 
MBcidgaganacandrika-HK-80	vāgiyaṃ trividhabhāvabhāsitā tvāṃ sa vakti kimutāmba vaikharī || 30 ||	vāc iyam trividha bhāva bhāsitā tvām sa vakti kim uta amba vaikharī 
MBcidgaganacandrika-HK-81	nādabindulipivigrahā girastisra ūrdhvagavimarśaśīkarāḥ |	nāda bindu lipi vigrahāḥ giraḥ tisraḥ ūrdhva ga vimarśa śīkarāḥ 
MBcidgaganacandrika-HK-82	saṃhṛtisthitivisṛṣṭidhāmasu vyāhṛtāstvadadha īśavallabhe || 31 ||	saṃhṛti sthiti visṛṣṭi dhāmasu vyāhṛtāḥ tvad adhas īśa vallabhe 
MBcidgaganacandrika-HK-83	dṛkkriyātmaśaśibhānumadhyagaṃ khe caratyanalavat sudhāma yat |	dṛkkriyā ātma śaśi bhānu madhya gam khe carati anala vat sudhāma yat 
MBcidgaganacandrika-HK-84	yattadūrdhvaśikhare paraṃ nabhastatra darśaya śivaṃ tvamambike || 32 ||	yat tat ūrdhva śikhare param nabhaḥ tatra darśaya śivam tvam ambike 
MBcidgaganacandrika-HK-85	vaikharīprabhṛtivāktrayaṃ pare meyamānamiti kartṛlakṣaṇam |	vaikharī prabhṛti vāc trayam pare meya mānam iti kartṛ lakṣaṇam 
MBcidgaganacandrika-HK-86	udbhavasthitilayātmakaṃ vapurbhūribhedamaparaṃ smaranti te || 33 ||	udbhava sthiti laya ātmakam vapuḥ bhūri bhedam aparam smaranti te 
MBcidgaganacandrika-HK-87	viśvamūrti yadadṛṣṭavigrahaṃ tvatpraśāntipadamaiśvaraṃ vapuḥ |	viśvamūrti yat adṛṣṭa vigraham tvad praśānti padam aiśvaram vapuḥ 
MBcidgaganacandrika-HK-88	tatra te ya udayaḥ kuleśi ! taṃ sṛṣṭirāśrayati pañcavāhatā || 34 ||	tatra te yaḥ udayaḥ kula īśi tam sṛṣṭiḥ āśrayati pañca vāha tā   /
MBcidgaganacandrika-HK-89	yā parā sphurati śaktirambike tatra hi tvayi payodhivīcivat |	yā parā sphurati śaktiḥ ambike tatra hi tvayi payodhi vīci vat 
MBcidgaganacandrika-HK-90	śiñjikāvayavakārthapañcakaṃ vartate vividhasūkṣmavigraham || 35 ||	śiñjikā avayavaka artha pañcakam vartate vividha sūkṣma vigraham 
MBcidgaganacandrika-HK-91	tvanmukhaṃ tripathanetri ! bhātmakaṃ śaktivṛndamiha turyathāgamam (yad yathāgamam ) |	tvad mukham tripatha netri bha ātmakam śakti vṛndam iha yat yathāgamam 
MBcidgaganacandrika-HK-92	dvādaśa kramapadaṃ padādibhirjṛmbhitaṃ jagati taccatustrikaiḥ || 36 ||	dvādaśa krama padam pada ādibhiḥ jṛmbhitam jagati tat catur trikaiḥ 
MBcidgaganacandrika-HK-93	mānameyamitinetralakṣaṇāḥ somasūryadahanāstridhāmagāḥ |	māna meya miti netra lakṣaṇāḥ soma sūrya dahanāḥ tridhāma gāḥ 
MBcidgaganacandrika-HK-94	rāśirājividhibhañjitaiḥ svarairlakṣitāstava hi vipruṣo'mbike || 37 ||	rāśi rāji vidhi bhañjitaiḥ svaraiḥ lakṣitāḥ tava hi vipruṣā umbike   
MBcidgaganacandrika-HK-95	āhatetaraduruttarāśrayastvatpadādudayate śivātmike |	āhata itara duruttara āśrayaḥ tvad padāt udayate śiva ātmike 
MBcidgaganacandrika-HK-96	advayādviṣayacitprathātanurdṛgvimarśa iha vācakaḥ svaraḥ || 38 ||	advayāt viṣaya cit prathā tanuḥ dṛś vimarśaḥ iha vācakaḥ svaraḥ 
MBcidgaganacandrika-HK-97	amba ! dhāmakaraṇaprayatnajo vaikharaḥ sphurati śabda āhataḥ |	amba dhāma karaṇa prayatna jaḥ vaikharaḥ sphurati śabdaḥ āhataḥ 
MBcidgaganacandrika-HK-98	mānasaḥ punarasāvanāhato vāsitastvadupalakṣya uttaraḥ || 39 ||	mānasaḥ punar asau anāhataḥ vāsitaḥ tvad upalakṣyaḥ uttaraḥ  /
MBcidgaganacandrika-HK-99	ṣaṣṭhavarjamahimadyuteḥ kalāḥ sargabindurahitāśca ye śubhe |	ṣaṣṭha varja mahima dyuteḥ kalāḥ sarga bindu rahitāḥ ca ye śubhe 
MBcidgaganacandrika-HK-100	sarva eva śaśinaḥ kalāḥ śive yonayo vidhṛtabījatatsvarāḥ || 40 ||	sarve eva śaśinaḥ kalāḥ śive yonayaḥ vidhṛta bīja tad svarāḥ 
MBcidgaganacandrika-HK-101	bījayonividhibhedabheditā mātṛkāsukṛtamātṛlakṣaṇā |	bīja yoni vidhi bheda bheditā mātṛkā sukṛta mātṛ lakṣaṇā 
MBcidgaganacandrika-HK-102	śaktiramba bhavati kriyāmayī tvattanurjayati pārameśvarī || 41 ||	śaktiḥ amba bhavati kriyā mayī tvad tanuḥ jayati pārameśvarī  /
MBcidgaganacandrika-HK-103	bindurakṣaramayaṃ kriyāmayaṃ yo niyantrayati buddhilakṣaṇaḥ |	binduḥ akṣara mayam kriyā mayam yaḥ niyantrayati buddhi lakṣaṇaḥ 
MBcidgaganacandrika-HK-104	nāda iṣṭatanurasya kāraṇaṃ | tvaṃ pare ! tritayadharmarūpiṇī || 42 ||	nādaḥ iṣṭa tanuḥ asya kāraṇam tvam pare tritaya dharma rūpiṇī   /
MBcidgaganacandrika-HK-105	udyamaḥ prathama ūrmiruttaro nistaraṅgaśivacitpayonidheḥ |	udyamaḥ prathamaḥ ūrmiḥ uttaraḥ nistaraṅga śiva cit payonidheḥ 
MBcidgaganacandrika-HK-106	prāgacitpadaparigrahāttava vyomanīśvari tanurmahodayaḥ || 43 ||	prāk acit pada parigrahāt tava vyomani īśvari tanuḥ mahā udayaḥ 
MBcidgaganacandrika-HK-107	sphāritā janati seyameṣaṇā khecaratvasamupāśritā diśi |	sphāritā janati sā iyam eṣaṇā khecara tva samupāśritā diśi 
MBcidgaganacandrika-HK-108	akṣacakramanujagmuṣī gavi prāptagocarapadā bhava svayam || 44 ||	akṣa cakram anujagmuṣī gavi prāpta gocara padā bhava svayam 
MBcidgaganacandrika-HK-109	khecarīprabhṛti yaccatuṣṭayaṃ sāṃśamamba ! tava tad bahirvapuḥ |	khecarī prabhṛti yat catuṣṭayam sa aṃśam amba tava tat bahis vapuḥ 
MBcidgaganacandrika-HK-110	yad dvayādvayavibhāgaghasmaraṃ tanniraṃśamabahirna vākpadam || 45 ||	yat dvaya advaya vibhāga ghasmaram tat niraṃśam abahir na vāc padam 
MBcidgaganacandrika-HK-111	pañcavṛttitanuramba ! nirgatā śaktirarpitakulaprabhāsanā |	pañca vṛtti tanuḥ amba nirgatā śaktiḥ arpita kula prabhāsanā 
MBcidgaganacandrika-HK-112	tvaṃ śivādakulataḥ sameyuṣī tena tatra punareṣi viśramam || 46 ||	tvam śivāda kulataḥ sameyuṣī tena tatra punar eṣi viśramam 
MBcidgaganacandrika-HK-113	yuktito'mba ! tava vṛttipañcakaṃ pañcabhūtaguṇavṛtti lakṣyate |	yuktitomba tava vṛtti pañcakam pañca bhūta guṇa vṛtti lakṣyate 
MBcidgaganacandrika-HK-114	gharmivṛttikṛtasiddhanāmakaṃ dharmavṛttikṛtaśaktināma te || 47 ||	gharmi vṛtti kṛta siddha nāmakam dharma vṛtti kṛta śakti nāma te 
MBcidgaganacandrika-HK-115	brahmaṇaḥ prabhṛti siddhapañcakaṃ bhāratīprabhṛti śaktipañcakam |	brahmaṇaḥ prabhṛti siddha pañcakam bhāratī prabhṛti śakti pañcakam 
MBcidgaganacandrika-HK-116	unmanīṃ smarati yastavākṛtiṃ siddhavartmani jayatyasau janaḥ || 48 ||	unmanīm smarati yaḥ tava ākṛtim siddhavartmani jayati asau janaḥ  /
MBcidgaganacandrika-HK-117	tvaṃ prakāśayasi yaṃ sa sṛjyate dharmidharmatanurartha īśvare |	tvam prakāśayasi yam sa sṛjyate dharmi dharma tanuḥ arthe īśvare 
MBcidgaganacandrika-HK-118	yaḥ prakāśa iha sa tvayā kṛtaḥ tattadākṛtirūpaiti sṛṣṭitām || 49 ||	yaḥ prakāśaḥ iha sa tvayā kṛtaḥ tad tad ākṛti rūpā eti sṛṣṭi tām 
MBcidgaganacandrika-HK-119	tvaṃ hi cittanurato na cittatā svena te viṣayacittatāṃ vinā |	tvam hi cit tanuḥ atas na cittatā svena te viṣaya cittatām vinā 
MBcidgaganacandrika-HK-120	śiṣyase yadi vinārthamaṇḍalaṃ sargasīmani kuto'sti cittatā || 50 ||	śiṣyase yadi vinā artha maṇḍalam sarga sīmani kutas asti citta tā   
MBcidgaganacandrika-HK-121	vāsanā ca na vicitratāpadaṃ tatprasūstvamiha kevalaiva cet |	vāsanā ca na vicitra tā padam tad prasūḥ tvam iha kevalā eva ced 
MBcidgaganacandrika-HK-122	śaktilakṣaṇajagadbhṛtodarī mānasaindriyakavastusūrasi || 51 ||	                
MBcidgaganacandrika-HK-123	sārvakālikamidaṃ jagat tvayā bhāsyate vidhṛtaśabdarūpayā |	sārvakālikam idam jagat tvayā bhāsyate vidhṛta śabda rūpayā 
MBcidgaganacandrika-HK-124	āntaraṃ janani buddhidarpaṇe bāhyamadyatanamakṣarūpayā || 52 ||	āntaram janani buddhi darpaṇe bāhyam adyatanam akṣa rūpayā 
MBcidgaganacandrika-HK-125	yāvadamba ! puruṣasya śāntatā saptamī sakalabhāvavartinaḥ |	yāvat amba puruṣasya śānta tā saptamī sakala bhāva vartinaḥ 
MBcidgaganacandrika-HK-126	tāvadadvayavimarśabhinnatā sārvakālikavimarśabhāvitā || 53 ||	tāvat advaya vimarśa bhinna tā sārvakālika vimarśa bhāvi tā 
MBcidgaganacandrika-HK-127	amba tajjaḍamuśanti bhedibhiryad guṇaiḥ sphuradapohyate kramāt |	amba tat jaḍam uśanti bhedibhiḥ yat guṇaiḥ sphurat apohyate kramāt 
MBcidgaganacandrika-HK-128	cittadākṛtinirākṛtiḥ svato bhāti yā sakṛdasau tvameva sā || 54 ||	citta dākṛti nirākṛtiḥ svatas bhāti yā sakṛt asau tvam eva sā   
MBcidgaganacandrika-HK-129	jāḍyamamba ! jagato nisargato yatparāprabhṛti bhāti bhedataḥ |	jāḍyam amba jagataḥ nisargataḥ yat parā prabhṛti bhāti bhedataḥ 
MBcidgaganacandrika-HK-130	tvaṃ tu jāḍyaparipanthinī smṛtā yā vibhāsi sakṛdarthamaṇḍale || 55 ||	tvam tu jāḍya paripanthinī smṛtā yā vibhāsi sakṛt artha maṇḍale 
MBcidgaganacandrika-HK-131	viśvametaditi yā'hamityasau nāmarūpaviraheṇa niścitā |	viśvam etat iti yā aham iti asau nāma rūpa viraheṇa niścitā 
MBcidgaganacandrika-HK-132	sā tvamamba ! na bibharṣi bhāsyatāṃ bhātmano yadasi dharma īśituḥ || 56 ||	sā tvam amba na bibharṣi bhāsyatām bhā ātmanaḥ yat asi dharmaḥ īśituḥ   
MBcidgaganacandrika-HK-133	bhāvadṛk smūtiviyuktamīśvare śūnyaratnamavalambya pudgalam |	bhāva dṛś smūti viyuktam īśvare śūnya ratnam avalambya pudgalam 
MBcidgaganacandrika-HK-134	nirniruktikamidaṃ jagat sthitaṃ cillayordhvagapathānna tattathā || 57 ||	nirniruktikam idam jagat sthitam cillayā ūrdhva ga pathāt na tat tathā 
MBcidgaganacandrika-HK-135	śāntatāṃ bhajadanāśritaṃ padaṃ śaktimātrajagadekasadma yat |	śānta tām bhajat anāśritam padam śakti mātra jagat eka sadma yat 
MBcidgaganacandrika-HK-136	nirmalajvalanaśaucavajjagat tatra hi tviṣi nimajjitaṃ tvayā || 58 ||	nirmala jvalana śauca vat jagat tatra hi tviṣi nimajjitam tvayā 
MBcidgaganacandrika-HK-137	siddhaśaktimayabhātṛbhāsanavyāptibhāva upayukprakāśatām |	siddha śakti maya bhātṛ bhāsana vyāpti bhāvaḥ upayuj prakāśa tām 
MBcidgaganacandrika-HK-138	yo'yamarthanikarastvadantike tvatpramātrabhimukhaṃ tanoṣyasau || 59 ||	yaḥ yam artha nikaraḥ tvad antike tvad pramātṛ abhimukham tanoṣi asau  /
MBcidgaganacandrika-HK-139	draṣṭṭatā jagati yatprakāśane yaśca niścayavidhau pramātṛtā |	draṣṭṛ tā jagati yat prakāśane yaḥ ca niścaya vidhau pramātṛ tā 
MBcidgaganacandrika-HK-140	grāhakatvamapi niścitagrahe vettyataḥ sa tava vṛttipoṣitaḥ || 60 ||	grāhaka tvam api niścita grahe vetti atas sa tava vṛtti poṣitaḥ 
MBcidgaganacandrika-HK-141	āsthitaḥ sadasadarthamaṇḍalaṃ ghīmano'kṣavapurasmitāmayaḥ |	āsthitaḥ sat asat artha maṇḍalam ghī manaḥ ukṣa vapuḥ asmitā mayaḥ 
MBcidgaganacandrika-HK-142	yastrayodaśavidhaḥ svatantratā taddvayo'hamasau tavāṃśakaḥ || 61 ||	yaḥ trayodaśavidhaḥ svatantra tā tad dvayaḥ ham asau tava aṃśakaḥ   
MBcidgaganacandrika-HK-143	tattadarthamayabhogyalakṣaṇānandamūrtirayamuttamaḥ pumān |	tad tad artha maya bhogya lakṣaṇa ānanda mūrtiḥ ayam uttamaḥ pumān 
MBcidgaganacandrika-HK-144	arpaṇena jagataścidambare bhāti saṃhṛtimayaḥ śive tava || 62 ||	arpaṇena jagataḥ cit ambare bhāti saṃhṛti mayaḥ śive tava  /
MBcidgaganacandrika-HK-145	aṣṭadhā sphurati yā purī śive sūkṣmabhāvamupagamya laiṅgikam |	aṣṭadhā sphurati yā purī śive sūkṣma bhāvam upagamya laiṅgikam 
MBcidgaganacandrika-HK-146	tajjapauṣṭakṛtacittavṛttayo vāsanāstvadudarasthite paśau || 63 ||	tad ja pauṣṭa kṛta cittavṛttayaḥ vāsanāḥ tvad udara sthite paśau 
MBcidgaganacandrika-HK-147	sargasaṃvṛtiśarīrayordvayorbhakṣyabhakṣakapadasthayostayoḥ |	sarga saṃvṛti śarīrayoḥ dvayoḥ bhakṣya bhakṣaka pada sthayoḥ tayoḥ 
MBcidgaganacandrika-HK-148	antarevamahamāsthitaḥ śive dhīmano'kṣavapurarpitaṃ tvayā || 64 ||	antar evam aham āsthitaḥ śive dhī manaḥ ukṣa vapuḥ arpitam tvayā  /
MBcidgaganacandrika-HK-149	rājanāt prakṛtirañjanācca māṃ rājasaṃjñamanu bodhakarmaṇoḥ |	rājanāt prakṛti rañjanāt ca mām rāja saṃjñam anu bodha karmaṇoḥ 
MBcidgaganacandrika-HK-150	ṣaṭ tvayā pṛthagamī pravartakāḥ putrabhāvamadhiropitāḥ śive || 65 ||	ṣaṭ tvayā pravartakāḥ putra bhāvam adhiropitāḥ śive  /
MBcidgaganacandrika-HK-151	ūrdhvavāhamayabindulakṣaṇaḥ prāṇasūrya iha ciddviṣaṭkalaḥ |	ūrdhva vāha maya bindu lakṣaṇaḥ prāṇa sūryaḥ iha cit dvi ṣaṣ kalaḥ 
MBcidgaganacandrika-HK-152	tatkalādharatanurgurukrame tvaṃ prakāśatanu siddhamaṇḍalam || 66 ||	tad kalā adhara tanuḥ guru krame tvam prakāśa tanu siddha maṇḍalam 
MBcidgaganacandrika-HK-153	yastvadhovahananādalakṣaṇo'pānasoma iha bhogyavigrahaḥ |	yaḥ tu adhas vahana nāda lakṣaṇa upāna somaḥ iha bhogya vigrahaḥ 
MBcidgaganacandrika-HK-154	tasya ṣoḍaśakalāḥ kṛtāstvayā''nandacakratanavo gurukrame || 67 ||	tasya ṣoḍaśa kalāḥ kṛtāḥ tvayā ānanda cakra tanavaḥ guru krame 
MBcidgaganacandrika-HK-155	vāsareśarajanīśayoḥ kalāścaṇḍi yāvadudayaṃ vitanvate |	vāsara īśa rajanīśayoḥ kalāḥ caṇḍi yāvat udayam vitanvate 
MBcidgaganacandrika-HK-156	tāvadeva divasakṣapodayastvatkṛtaḥ prakaṭaguptavigrahaḥ || 68 ||	tāvat eva divasa kṣapā udayaḥ tvad kṛtaḥ prakaṭa gupta vigrahaḥ 
MBcidgaganacandrika-HK-157	devi taddvayakalāvimiśraṇāt sāmarasyapadameti yā sthitiḥ |	devi tad dvaya kalā vimiśraṇāt sāmarasya padam eti yā sthitiḥ 
MBcidgaganacandrika-HK-158	bindunādasamavedyavedakā'ntargatā hi tava mūrtiratra sā || 69 ||	bindu nāda samavedya vedaka antargatā hi tava mūrtiḥ atra sā 
MBcidgaganacandrika-HK-159	līḍhabhānuśaśimaṇḍalā sthitirlambhitā pralayavahninā tvayā |	līḍha bhānu śaśi maṇḍalā sthitiḥ lambhitā pralaya vahninā tvayā 
MBcidgaganacandrika-HK-160	prāṇadhāmni daśasaptadhā satī mūrtirāśritagurukramā śive || 70 ||	prāṇa dhāmni daśa saptadhā satī mūrtiḥ āśrita guru kramā śive 
MBcidgaganacandrika-HK-161	iṣṭabodhakṛtaśaktayastvayā saṃhṛtisthitivisṛṣṭisadmasu |	iṣṭa bodha kṛta śaktayaḥ tvayā saṃhṛti sthiti visṛṣṭi sadmasu 
MBcidgaganacandrika-HK-162	turyacitpadamayuḥ prasāritāḥ suptitaḥ prabhṛti dhāmasu triṣu || 71 ||	turya cit padam ayuḥ prasāritāḥ suptitaḥ prabhṛti dhāmasu triṣu 
MBcidgaganacandrika-HK-163	meyamātṛmitilakṣaṇaṃ kulaṃ prāntato vrajati yatra viśramam |	meya mātṛ miti lakṣaṇam kulam prāntataḥ vrajati yatra viśramam 
MBcidgaganacandrika-HK-164	tatpadaṃ tava turīyamambike yanmahadbhiranupākhyamiṣyate || 72 ||	tat padam tava turīyam ambike yat mahadbhiḥ anupākhyam iṣyate  /
MBcidgaganacandrika-HK-165	cārarāvacarubhirvibheditairmudrayā ca yadupāsanaṃ tava |	cāra rāva carubhiḥ vibheditaiḥ mudrayā ca yat upāsanam tava 
MBcidgaganacandrika-HK-166	tadvaśena bhajate paramparāṃ tāvakī kramatayā sphuṭākṛtiḥ || 73 ||	tad vaśena bhajate paramparām tāvakī krama tayā sphuṭa ākṛtiḥ 
MBcidgaganacandrika-HK-167	maṅgale tvamasi vākcatuṣṭaye yā parā sphurati mūrtimaṇḍale |	maṅgale tvam asi vāc catuṣṭaye yā parā sphurati mūrti maṇḍale 
MBcidgaganacandrika-HK-168	sā prakāśa-sukha-vṛndacakragā nādabindulipimūrtirijyase || 74 ||	sā prakāśa sukha vṛnda cakra gā nāda bindu lipi mūrtiḥ ijyase 
MBcidgaganacandrika-HK-169	ādyacitprasaramūrtirambike pītatāṃ vrajati yatkṛtāspadā |	ādya cit prasara mūrtiḥ ambike pīta tām vrajati yad kṛta āspadā 
MBcidgaganacandrika-HK-170	akṣayaṃ śivamupāsya tajjanaḥ śakticakrajanitaḥ pramucyate || 75 ||	akṣayam śivam upāsya tad janaḥ śakti cakra janitaḥ pramucyate  /
MBcidgaganacandrika-HK-171	amba ! śaktivapuṣā tvayonmiṣadrūpayā samarasaḥ śivo yadā |	amba śakti vapuṣā tvayā unmiṣat rūpayā samarasaḥ śivaḥ yadā 
MBcidgaganacandrika-HK-172	yattadollasati vīryamūrjitaṃ pīṭha eṣa hi mahāṃstvadutthitaḥ || 76 ||	yat tadā ullasati vīryam ūrjitam pīṭhe eṣa hi mahān tvad utthitaḥ  /
MBcidgaganacandrika-HK-173	yā śive sphuraṇaśaktirakṣayā kṣmādipañcakaniviṣṭabhātanuḥ |	yā śive sphuraṇa śaktiḥ akṣayā kṣmā ādi pañcaka niviṣṭa bhā tanuḥ 
MBcidgaganacandrika-HK-174	sā mahad bhavati vīryamagrimaṃ yanmayī tvamasi pīṭhacakrasūḥ || 77 ||	sā mahat bhavati vīryam agrimam yad mayī tvam asi pīṭha cakra sūḥ 
MBcidgaganacandrika-HK-175	pīṭhacakranikaraikadharmiṇī tvaṃ sthitā ca satataṃ samantataḥ |	pīṭha cakra nikara eka dharmiṇī tvam sthitā ca satatam samantataḥ 
MBcidgaganacandrika-HK-176	sadbhirudyamanirantarātmabhirlakṣyase'mba niravagrahodayā || 78 ||	sadbhiḥ udyama nirantarātmabhiḥ lakṣya sā imba niravagrahā udayā 
MBcidgaganacandrika-HK-177	īraṇena vividhena vīratāṃ yo'yamakṣaragaṇaḥ prapadyate |	īraṇena vividhena vīra tām yaḥ yam akṣara gaṇaḥ prapadyate 
MBcidgaganacandrika-HK-178	antyamīśamasi taṃ tridhāmakaṃ varṇaśaktipadavī ca citkalā || 79 ||	antyam īśam asi tam tri dhāmakam varṇa śakti padavī ca cit kalā 
MBcidgaganacandrika-HK-179	yā'nalārkaśaśivigrahā kalānāhatāmbaravisarpiṇī śive |	yā anala arka śaśi vigrahā kalā anāhata ambara visarpiṇī śive 
MBcidgaganacandrika-HK-180	pīṭhataḥ prabhṛti yāvadarcyate tāvadunmiṣati tanmayī satī || 80 ||	pīṭhataḥ prabhṛti yāvat arcyate tāvat unmiṣati tad mayī satī 
MBcidgaganacandrika-HK-181	nirjanasthitilayaprathātmike'grāsanityaniravagrahodayaḥ |	              
MBcidgaganacandrika-HK-182	jṛmbhitastvadanupākṣadīpito dvyaṣṭakaṃ manurume ! tavāsanam || 81 ||	jṛmbhitaḥ tvad anupākṣa dīpitaḥ dvyaṣṭakam manuḥ ume tava āsanam   
MBcidgaganacandrika-HK-183	nityabhātaruci viśvaghasmaraṃ durnirīkṣamapi sanniketanam |	nitya bhāta ruci viśva ghasmaram durnirīkṣam api sat niketanam 
MBcidgaganacandrika-HK-184	tvaṃ śmaśānamasi vīrahṛdgataṃ kṣīṇavṛtti karavīramijyase || 82 ||	tvam śmaśānam asi vīra hṛd gatam kṣīṇa vṛtti karavīram ijyase 
MBcidgaganacandrika-HK-185	viśvasaṃharaṇalīlayotkaṭaṃ vyomni śaśvaduditaṃ nirāśraye |	viśva saṃharaṇa līlayā utkaṭam vyomni śaśvat uditam nirāśraye 
MBcidgaganacandrika-HK-186	kṣetrapālamanupādhikollasat tvadvimarśamabhinandatīśvare || 83 ||	kṣetrapālam anupādhika ullasat tvad vimarśam abhinandati īśvare 
MBcidgaganacandrika-HK-187	khecarīprabhṛtiramba śākinīprānta eṣa tava yo gurukramaḥ |	khecarī prabhṛtiḥ amba śākinī prānte eṣa tava yaḥ guru kramaḥ 
MBcidgaganacandrika-HK-188	sṛṣṭitaśca yadanākhyavikramaṃ cakrametadakhilaṃ tavodgamaḥ || 84 ||	sṛṣṭitaḥ ca yat anākhya vikramam cakram etat akhilam tava udgamaḥ 
MBcidgaganacandrika-HK-189	taddvayollasitamamba ! vartate yatra nityamiha sāmarasyataḥ |	tad dvaya ullasitam amba vartate yatra nityam iha sāmarasyataḥ 
MBcidgaganacandrika-HK-190	sanniketapadanityajṛmbhitollāsa eṣa tava me purassaraḥ || 85 ||	sanniketa pada nitya jṛmbhita ullāsaḥ eṣa tava me purassaraḥ 
MBcidgaganacandrika-HK-191	bhogyabhoktṛrucighasmaraṃ manaḥ pañcavāhamayamucyate tamaḥ |	bhogya bhoktṛ ruci ghasmaram manaḥ pañca vāha mayam ucyate tamaḥ 
MBcidgaganacandrika-HK-192	nirniketapadameti yatra te ko'pyasau satatamadhvarotsavaḥ || 86 ||	nirniketa padam eti yatra te kopī asau satatam adhvara utsavaḥ   
MBcidgaganacandrika-HK-193	pūrṇasattvaraja-ādihṛdgatādhiṣṭhitā tvakhilalokavāhinī |	pūrṇa sattva rajaḥ ādi hṛd gata adhiṣṭhitā tu akhila loka vāhinī 
MBcidgaganacandrika-HK-194	pañcadhā vahasi śāśvatodayā siddhasindhuriva siddhasevitā || 87 ||	pañcadhā vahasi śāśvata udayā siddha sindhuḥ iva siddha sevitā 
MBcidgaganacandrika-HK-195	vyomayānamatimatpurassaraḥ pañcadhā prasara eṣa tāvakaḥ |	vyoma yāna matimat purassaraḥ pañcadhā prasaraḥ eṣa tāvakaḥ 
MBcidgaganacandrika-HK-196	jṛmbhamāṇaguruvaktracitpathollāsimūrtirayamāsthito jagat || 88 ||	jṛmbhamāṇa guru vaktra cit patha ullāsi mūrtiḥ ayam āsthitaḥ jagat 
MBcidgaganacandrika-HK-197	spandamādyamanu kurvatī śive nirniketanapathotthitā guṇaiḥ |	spandam ādyam anu kurvatī śive nirniketana patha utthitā guṇaiḥ 
MBcidgaganacandrika-HK-198	śūnyadhāma vasasi tvamiṣṭitaḥ prāgadhiṣṭhitaravā vijṛmbhase || 89 ||	śūnya dhāma vasasi tvam iṣṭitaḥ prāc adhiṣṭhita ravā vijṛmbhase   
MBcidgaganacandrika-HK-199	ciccamatkaraṇarūḍhanirbharā tvaṃ purā sphurasi saiva khecarī |	cit camatkaraṇa rūḍha nirbharā tvam purā sphurasi sā eva khecarī 
MBcidgaganacandrika-HK-200	rūpasaṃgrahadarśitaiṣaṇā tejasā svarasavāhinā'mbike || 90 ||	rūpa saṃgraha darśita eṣaṇā tejasā sva rasa vāhinā ambike  /
MBcidgaganacandrika-HK-201	devi naikaviṣayodyamasphuṭārohiṇī bhavasi saiva bhūcarī |	devi nā eka viṣaya udyama sphuṭa ārohiṇī bhavasi sā eva bhūcarī 
MBcidgaganacandrika-HK-202	sparśasaṃgrahaṇanityasammukhī svairitāmajahatī svabhāvajām || 91 ||	sparśa saṃgrahaṇa nitya sammukhī svairi tām a jahatī svabhāva jām 
MBcidgaganacandrika-HK-203	pratyagātmani dṛśo'vakuñcanā viśvamannamudare vitanvatī |	pratyagātmani dṛśaḥ avakuñcanā viśvam annam udare vitanvatī 
MBcidgaganacandrika-HK-204	grasya saṃhṛtimukhena dikcarī saiva devi rasacarvaṇonmukhī || 92 ||	saṃhṛti mukhena diś carī sā eva devi rasa carvaṇa unmukhī 
MBcidgaganacandrika-HK-205	prāptacittamukhato'dhitasthuṣī svasvarūpamaniketamañjasā |	prāpta citta mukhataḥ dhitasthuṣī sva sva rūpam aniketam añjasā 
MBcidgaganacandrika-HK-206	raudrabhāvakṛtabāhyajṛmbhaṇā gocarī tvamasi gandhahāriṇī || 93 ||	raudra bhāva kṛta bāhya jṛmbhaṇā gocarī tvam asi gandha hāriṇī 
MBcidgaganacandrika-HK-207	brahmavigrahakalādhirohiṇī pañcavāhavapuṣaḥ kalā tava |	brahma vigraha kalā adhirohiṇī pañca vāha vapuṣaḥ kalā tava 
MBcidgaganacandrika-HK-208	sāmarasyaghaṭitodayā śive śaśvadullasati siddhamaṇḍale || 94 ||	sāmarasya ghaṭita udayā śive śaśvat ullasati siddha maṇḍale 
MBcidgaganacandrika-HK-209	bhānuśītakaravahnikuṇḍalībindusūtritaparāvarasthalā |	                                                
MBcidgaganacandrika-HK-210	rudraśaktiriha kālakarṣiṇī tvatkapañcavidhavṛttisūcinī || 95 ||	rudra śaktiḥ iha kāla karṣiṇī tvad ka pañcavidha vṛtti sūcinī 
MBcidgaganacandrika-HK-211	ghoṣavāḍavaśikhāstaduttaraṃ bindunādayugalaṃ ca yatpadam |	ghoṣa vāḍava śikhāḥ tat uttaram bindu nāda yugalam ca yat padam 
MBcidgaganacandrika-HK-212	saprasādamiha pañcabhiḥ śive tvāṃ kalābhiranukḷptamomapi || 96 ||	sa prasādam iha pañcabhiḥ śive tvām kalābhiḥ anukḷptam om api 
MBcidgaganacandrika-HK-213	induśūlavṛṣaṭaṅkamātṛkākālabījadhṛtapañcabhūmikaḥ |	                                                                    
MBcidgaganacandrika-HK-214	lopasandhivihitadhruvodayaścinmayaśca tava devi darśitaḥ || 97 ||	lopa sandhi vihita dhruva udayaḥ cit mayaḥ ca tava devi darśitaḥ 
MBcidgaganacandrika-HK-215	yajjvarādipadamamba vāyunā yā śikhā madhusapannagāspadā |	yat jvara ādi padam amba vāyunā yā śikhā madhu sa pannaga āspadā 
MBcidgaganacandrika-HK-216	yā niśā madhuniviṣṭasṛṣṭikā paṅktirapyanukaroti te sthitim || 98 ||	yā niśā madhu niviṣṭa sṛṣṭikā paṅktiḥ api anukaroti te sthitim 
MBcidgaganacandrika-HK-217	yannabhaḥ sphurati yo marut tvayādhiṣṭhito vidhṛtasargarūpayā |	yat nabhaḥ sphurati yaḥ marut tvayā adhiṣṭhitaḥ vidhṛta sarga rūpayā 
MBcidgaganacandrika-HK-218	yā śikhā yaduta vāri yajñasūryāmba paṅktirapi taistathāvidhaḥ || 99 ||	yā śikhā yat uta vāri yajñasūrya amba paṅktiḥ api taiḥ tathāvidhaḥ 
MBcidgaganacandrika-HK-219	bhūcarī vahasi daṇḍataḥ kramaṃ muṇḍato'paracatuṣṭayī ca sā |	bhūcarī vahasi daṇḍataḥ kramam muṇḍa tā upara catuṣṭayī ca sā 
MBcidgaganacandrika-HK-220	bhogyabhoktṛkalanormisaṃkṣaye sāmarasyarasarohiṇī śive || 100 ||	bhogya bhoktṛ kalanā ūrmi saṃkṣaye sāmarasya rasa rohiṇī śive 
MBcidgaganacandrika-HK-221	yastvanāhatadhṛtordhvapāragastryaśramūlagaganasthitaḥ svaraḥ |	yaḥ tu anāhata dhṛta ūrdhva pāragaḥ tri aśra mūla gagana sthitaḥ svaraḥ 
MBcidgaganacandrika-HK-222	tatra devi viyadagnipārśvayormadhyagā vahasi pañcadhā kramaiḥ || 101 ||	tatra devi viyat agni pārśvayoḥ madhya gā vahasi pañcadhā kramaiḥ 
MBcidgaganacandrika-HK-223	pañcavargamayapiṇḍagāminī mañcapañcakatanustvamamba yā |	pañcavarga maya piṇḍa gāminī mañcapañcaka tanuḥ tvam amba yā 
MBcidgaganacandrika-HK-224	devi varṇa iva bhāsi niṣkramā sāmarasyakṛtapañcavṛttikā || 102 ||	devi varṇaḥ iva bhāsi niṣkramā sāmarasya kṛta pañcavṛttikā 
MBcidgaganacandrika-HK-225	śūnyamamba mahamucyase tu yā yat tvamatra gagane sadoditā |	śūnyam amba maham ucyase tu yā yat tvam atra gagane sadā uditā 
MBcidgaganacandrika-HK-226	divyamoghamata udgirantyasau sparśamujjhasi hi vāmavigrahā || 103 ||	divyam ogham atas udgirantī asau sparśam ujjhasi hi vāma vigrahā   
MBcidgaganacandrika-HK-227	ambarasya paramāgatā śive saiva cittamanaghā svabhāvataḥ |	ambarasya paramā āgatā śive sā eva cittam anaghā svabhāvataḥ 
MBcidgaganacandrika-HK-228	spandametya paramaṃ virājate khecari praṇatakhecarastvayā || 104 ||	spandam etya paramam virājate khecari praṇata khecaraḥ tvayā  /
MBcidgaganacandrika-HK-229	vyaktamakramavijṛmbhitā śive tvaṃ visṛṣṭabhuvanadvayodayā |	vyaktam akrama vijṛmbhitā śive tvam visṛṣṭa bhuvana dvaya udayā 
MBcidgaganacandrika-HK-230	saiva saṃcarasi saṃśritā yadā bhūcarī bhavasi saṃjñayā tadā || 105 ||	sā eva saṃcarasi saṃśritā yadā bhū carī bhavasi saṃjñayā tadā 
MBcidgaganacandrika-HK-231	svaṃ vapuḥ sphuraṇaśaktilakṣaṇaṃ tattadarthamayamambike kṣaṇāt |	svam vapuḥ sphuraṇa śakti lakṣaṇam tad tad artha mayam ambike kṣaṇāt 
MBcidgaganacandrika-HK-232	saiva cennijapadāntavartinī saṃharasyatha tadāsi dikcarī || 106 ||	sā eva ced nija padānta vartinī saṃharasi atha tadā asi diś carī 
MBcidgaganacandrika-HK-233	pratyagarpitamukhī bhidākṣayādaikarasyamaghiropitaṃ tridhā |	pratyak arpita mukhī bhidā kṣayāt aikarasyam aghiropitam tridhā 
MBcidgaganacandrika-HK-234	svaṃ kramaṃ grasasi saiva cedasau gocarī khalu mahāmbarāntagā || 107 ||	svam kramam grasasi sā eva ced asau gocarī khalu mahā ambara anta gā 
MBcidgaganacandrika-HK-235	pañcasu sphurati devi vṛttisu tvanmayīṣu yadi kācana svataḥ |	pañcasu sphurati devi vṛttisu tvanmayīṣu yadi kācana svatas 
MBcidgaganacandrika-HK-236	śaśvadāśu nikhilāstadaiva tāḥ sāmarasyamadhiruhya bhāntyamūḥ || 108 ||	śaśvat āśu nikhilāḥ tadā eva tāḥ sāmarasyam adhiruhya bhānti amūḥ   
MBcidgaganacandrika-HK-237	nirṇiketanatayā'mba khecarī sphāritā gaganakāmayā tvayā |	nirṇiketana tayā amba khecarī sphāritā gagana kāmayā tvayā 
MBcidgaganacandrika-HK-238	nādasarganihitasvavaibhavā dikcarī sphuṭamadhiṣṭhitā yayā || 109 ||	nāda sarga nihita sva vaibhavā diś carī sphuṭam adhiṣṭhitā yayā 
MBcidgaganacandrika-HK-239	kṣobhamamba ! tava tāvadiṣṭato dvyaṣṭaraśmitanunādavigrahā |	kṣobham amba tava tāvat iṣṭataḥ dvi aṣṭa raśmi tanu nāda vigrahā 
MBcidgaganacandrika-HK-240	bindubhūmimadhitasthuṣī sphuṭānandacakravibhavāsi bhūcarī || 110 ||	bindu bhūmim adhitasthuṣī sphuṭa ānanda cakra vibhavā asi bhū carī 
MBcidgaganacandrika-HK-241	dikcarī tvamasi bindubhāskarā jṛmbhitā bahirihāmba nirgatā |	diś carī tvam asi bindu bhāskarā jṛmbhitā bahis iha amba nirgatā 
MBcidgaganacandrika-HK-242	arthapañcakamalaṃ grasantyasau bhūcarīṃ nayasi nirvibhāgatām || 111 ||	artha pañca kamalam grasantī asau bhūcarīm nayasi nirvibhāga tām 
MBcidgaganacandrika-HK-243	tad dvipañcakalavahnivigrahaṃ saptatacchikhamaśeṣaghasmaram |	tat dvi pañca kala vahni vigraham sapta tad śikham aśeṣa ghasmaram 
MBcidgaganacandrika-HK-244	mūrticakramadhiruhya dikcarī tvaṃ parāṃ viśasi vācamadvayām || 112 ||	mūrti cakram adhiruhya diś carī tvam parām viśasi vācam advayām 
MBcidgaganacandrika-HK-245	cetasaḥ kṛtamadā svajṛmbhayā tvaṃ nijaṃ viyadabhūmi jagmuṣī	cetasaḥ kṛta madā sva jṛmbhayā tvam nijam viyat abhūmi jagmuṣī 
MBcidgaganacandrika-HK-246	gṛhṇatī paramamamba citpadaṃ maṅgalāsi vidhutāhṛtiḥ parā || 113 ||	gṛhṇatī paramam amba cit padam maṅgalā asi vidhuta āhṛtiḥ parā 
MBcidgaganacandrika-HK-247	asvarāgrimavikāsadharmiṇī viśvacakraparimelanodyamā |	                    
MBcidgaganacandrika-HK-248	bhāvanādikalanātivartinī pañcavaktramadhipīṭha ijyase || 114 ||	bhāvanā ādi kalanā ativartinī pañcavaktram adhipīṭhe ijyase  /
MBcidgaganacandrika-HK-249	bindunādaśaśipīṭhabhāsvarā jvālarājabhagakālavigrahā |	bindu nāda śaśi pīṭha bhāsvarā jvāla rāja bhaga kāla vigrahā 
MBcidgaganacandrika-HK-250	asvarākhyaparamāmbarātmikā maṅgalā tvamasi vāktrayātigā || 115 ||	asvara ākhya parama ambara ātmikā maṅgalā tvam asi vāc traya atigā 
MBcidgaganacandrika-HK-251	dvyaṣṭadhāmanilayā citiḥ śive sphārayantyaniśamātmano balam |	dvi aṣṭadhām anilayā citiḥ śive sphārayanti aniśam ātmanaḥ balam 
MBcidgaganacandrika-HK-252	nirniketanapadā tanoṣyasau jñānaraśmivisaraṃ sadoditam || 116 ||	nirniketana padā tanoṣi asau jñāna raśmi visaram sadā uditam 
MBcidgaganacandrika-HK-253	antaramba bahirapyamī karā ye tavākṣatanavo'ṅka eṣa yaḥ |	antar amba bahis api amī karāḥ ye tava akṣata nava uṅkaḥ eṣa yaḥ 
MBcidgaganacandrika-HK-254	vigrahadvitayamapyataḥ paraṃ cinnabho nayasi naḥ karaṅkiṇī || 117 ||	vigraha dvitayam api atas param cit nabhaḥ nayasi naḥ karaṅkiṇī   
MBcidgaganacandrika-HK-255	yatprakṛtyavadhitattvamaṇḍalaṃ kṣmāmukhaṃ parimitagrahāsṣadam |	yat prakṛti avadhi tattva maṇḍalam kṣmāmukham parimita graha asṣadam 
MBcidgaganacandrika-HK-256	krodhanī tvamasi tajjihīrṣayā mantramūrtiriha te vijṛmbhate || 118 ||	krodhanī tvam asi tad jihīrṣayā mantra mūrtiḥ iha te vijṛmbhate 
MBcidgaganacandrika-HK-257	devi kāryakaraṇāhvayaṃ vapustvaṃ triśaktivisaradguṇātmakam |	devi kārya karaṇa āhvayam vapuḥ tvam tri śakti visarat guṇa ātmakam 
MBcidgaganacandrika-HK-258	māntramugrarasasaṃkulaṃ paraṃ vīryamānayasi tajjihīrṣayā || 119 ||	māntram ugra rasa saṃkulam param vīryam ānayasi tad jihīrṣayā 
MBcidgaganacandrika-HK-259	granthayo'pi ṣaḍume yayā dhṛtā sā nirāvaraṇacinnabhaḥpadā |	ṣaṣ ume yayā dhṛtā sā nirāvaraṇa cit nabhaḥpadā 
MBcidgaganacandrika-HK-260	spandamūrtidhṛtabhedaḍambarā bhairavi tvamasi viśvabhedinī || 120 ||	spanda mūrti dhṛta bheda ḍambarā bhairavi tvam asi viśva bhedinī 
MBcidgaganacandrika-HK-261	aṣṭapuryuditabījavāsanāsaṃhṛtipravaṇaraśmipuñjayā |	aṣṭa purī udita bīja vāsanā saṃhṛti pravaṇa raśmi puñjayā 
MBcidgaganacandrika-HK-262	līḍhamātramukhabheditā tvayā bhūyase janani lelihānayā || 121 ||	līḍha mātra mukha bheditā tvayā bhūyase janani lelihānayā  /
MBcidgaganacandrika-HK-263	tvaṃ parāprabhṛtivaikharāntimollekhavistaravilāpanonmukhī |	tvam parā prabhṛti vaikhara antima ullekha vistara vilāpana unmukhī 
MBcidgaganacandrika-HK-264	devyanāvaraṇaśambhusadmagā khecarī bhavasi cidvikāsinī || 122 ||	devi an āvaraṇa śambhu sadma gā khecarī bhavasi cit vikāsinī 
MBcidgaganacandrika-HK-265	vahnisūryaśaśidhāmaghasmarī kuṇḍalī taḍidivotpatantyasau |	vahni sūrya śaśi dhāma ghasmarī kuṇḍalī taḍit iva utpatantī asau 
MBcidgaganacandrika-HK-266	śāmbhavaṃ janani bindumadhvanā madhyamena ca gatāsi khecarī || 123 ||	śāmbhavam janani bindum adhvanā madhyamena ca gatā asi khecarī  /
MBcidgaganacandrika-HK-267	mudritasvakṛtatattvamaṇḍalā jṛmbhase svajaṭhare sadoditā |	mudrita sva kṛta tattva maṇḍalā jṛmbhase sva jaṭhare sadā uditā 
MBcidgaganacandrika-HK-268	vṛndacakragatapañcabhedagā tvaṃ śive diśasi yogajāṃ śriyam || 124 ||	vṛnda cakra gata pañca bheda gā tvam śive diśasi yoga jām śriyam 
MBcidgaganacandrika-HK-269	jñānamamba tava bheditaiḥ svaraistaistu yoga iha ṣaṇḍavarjitaiḥ |	jñānam amba tava bheditaiḥ svaraiḥ taiḥ tu yogaḥ iha ṣaṇḍa varjitaiḥ 
MBcidgaganacandrika-HK-270	vyañjanairudayate mahāntikairmantraśaktiyugalaṃ kahādibhiḥ || 125 ||	vyañjanaiḥ udayate mahāntikaiḥ mantra śakti yugalam ka ha ādibhiḥ 
MBcidgaganacandrika-HK-271	binducakraśaśikuṇḍalī śikhā mūrtirambaragatā caturvidhā |	bindu cakra śaśi kuṇḍalī śikhā mūrtiḥ ambara gatā caturvidhā 
MBcidgaganacandrika-HK-272	śaktiratra kṛtaśambhubhedanā ṣaṣṭirambaragatāścatuṣparāḥ || 126 ||	śaktiḥ atra kṛta śambhu bhedanā ṣaṣṭiḥ ambara gatāḥ catuṣparāḥ 
MBcidgaganacandrika-HK-273	ādihāntanijadehanirgatāḥ ṣaṣṭiratra caturuttarā rucaḥ |	ādi ha anta nija deha nirgatāḥ ṣaṣṭiḥ atra catur uttarāḥ rucaḥ 
MBcidgaganacandrika-HK-274	khecarījaṭharaniṣṭhitāstvayā maṅgale paramabhedataḥ kṛtāḥ || 127 ||	khecarī jaṭhara niṣṭhitāḥ tvayā maṅgale parama bhedataḥ kṛtāḥ  /
MBcidgaganacandrika-HK-275	jñānadīdhitiṣu raudradīdhitermantradīdhitiṣu vāmayoditam |	jñāna dīdhitiṣu raudra dīdhiteḥ mantra dīdhitiṣu vāmayā uditam 
MBcidgaganacandrika-HK-276	yogadīdhitiṣu jṛmbhate'mbikā jyeṣṭhayaivamatha śaktidīdhiteḥ || 128 ||	yoga dīdhitiṣu jṛmbhatā imbikā jyeṣṭhayā evam atha śakti dīdhiteḥ 
MBcidgaganacandrika-HK-277	devyabheditakalācatuṣṭayā śambhudīdhitiṣu dīpyate svaraḥ |	               
MBcidgaganacandrika-HK-278	tatsthitistvamapi varṇabhedinī maṅgale vahasi yatpradhānatām || 129 ||	tad sthitiḥ tvam api varṇa bhedinī maṅgale vahasi yat pradhāna tām 
MBcidgaganacandrika-HK-279	sarvadaiva sakṛdāsthitodayāḥ sarvataḥ kṣapitakalpanābhidāḥ |	sarvadā eva sakṛt āsthita udayāḥ sarvatas kṣapita kalpanā bhidāḥ 
MBcidgaganacandrika-HK-280	itthamekavapuṣā tvayā nijāḥ sphāritā mahati lakṣmacittviṣaḥ || 130 ||	ittham eka vapuṣā tvayā nijāḥ sphāritāḥ mahati lakṣma cit tviṣaḥ   
MBcidgaganacandrika-HK-281	udyamaprathanacarvaṇātmakaṃ jāgarādipadamamba yatkriyā |	udyama prathana carvaṇa ātmakam jāgara ādi padam amba yat kriyā 
MBcidgaganacandrika-HK-282	yatturīyamapi tadvilāpanaṃ bhātanustvamakhile'tra jṛmbhase || 131 ||	yat turīyam api tat vilāpanam bhā tanuḥ tvam akhilā itra jṛmbhase 
MBcidgaganacandrika-HK-283	yo vikalparahito'kṣamaṇḍalārūḍha ullasati māturambike |	yaḥ vikalpa rahita ukṣa maṇḍala ārūḍhaḥ ullasati mātuḥ ambike 
MBcidgaganacandrika-HK-284	prāgvimarśa iha tanmukhī prathā jñānamarthavidhṛtā tanustava || 132 ||	prāk vimarśe iha tad mukhī prathā jñānam artha vidhṛtā tanuḥ tava   
MBcidgaganacandrika-HK-285	īdṛgetaditi tatprathāsthiteryo vimarśa udito'ntarakṣataḥ |	īdṛś etat iti tad prathā sthiteḥ yaḥ vimarśaḥ uditaḥ untara kṣataḥ 
MBcidgaganacandrika-HK-286	mantra eṣa tava vṛndacakrago yanmukhī bhavati tāvakī kriyā || 133 ||	mantraḥ eṣa tava vṛnda cakra gaḥ yat mukhī bhavati tāvakī kriyā 
MBcidgaganacandrika-HK-287	bhogyabhoktṛparighaṭṭanollasannirmalapramadanirbharodayā	bhogya bhoktṛ parighaṭṭana ullasat nirmala pramada nirbhara udayā 
MBcidgaganacandrika-HK-288	lolitākhilahṛṣīkavṛttikā yuktiramba ! tava viśvamelinī || 134 ||	lolita akhila hṛṣīka vṛttikā yuktiḥ amba tava viśva melinī   
MBcidgaganacandrika-HK-289	jñaptimātramapanītavāsanaṃ nirvikalpamadhiruhya cittviṣā |	jñapti mātram apanīta vāsanam nirvikalpam adhiruhya cit tviṣā 
MBcidgaganacandrika-HK-290	sāmarasyakṛtaśāśvatodayā tvaṃ hi śaktiradhitiṣṭhasīśvare || 135 ||	sāmarasya kṛta śāśvata udayā tvam hi śaktiḥ adhitiṣṭhasi īśvare 
MBcidgaganacandrika-HK-291	śūnyamamba gaganaṃ hi yā mahat spandabījamaniketamīyuṣī |	śūnyam amba gaganam hi yā mahat spanda bījam aniketam īyuṣī 
MBcidgaganacandrika-HK-292	līyase jhaṭiti cittayā tvayā śambhuraśmivapuṣā'tra bhūyate || 136 ||	līyase jhaṭiti cittayā tvayā śambhu raśmi vapuṣā atra bhūyate  /
MBcidgaganacandrika-HK-293	jñānamamba śamapūrṇacitpayorāśilambilaharī tvamucyase |	jñānam amba śama pūrṇa cit payaḥ rāśi lambi laharī tvam ucyase 
MBcidgaganacandrika-HK-294	tadvimarśatadupāśritakramadhvaṃsamūrtiśatamūrdhvamaṇḍalā || 137 ||	tad vimarśa tad upāśrita krama dhvaṃsa mūrti śata mūrdhva maṇḍalā 
MBcidgaganacandrika-HK-295	styāyamānaśivacidrasātmakaṃ bhāvavṛndamadhiruhya bhāmayī |	styāyamāna śiva cit rasa ātmakam bhāva vṛndam adhiruhya bhā mayī 
MBcidgaganacandrika-HK-296	khānilāgnijalabhūmibhāsinī śambhutaḥ prabhṛti jṛmbhase śive || 138 ||	kha anila agni jala bhūmi bhāsinī śambhutaḥ prabhṛti jṛmbhase śive   
MBcidgaganacandrika-HK-297	sphāratāvakavimarśapāvakabhrāmyamāṇadhanasārabhātmikāḥ |	sphāra tāvaka vimarśa pāvaka bhrāmyamāṇa dhana sārabha ātmikāḥ 
MBcidgaganacandrika-HK-298	pañcadivyakulabījavigrahāḥ tvattviṣo'mba ! śivacinnabhaḥpradāḥ || 139 ||	pañca divya kula bīja vigrahāḥ tvad tviṣā umba śiva cit nabhaḥ pradāḥ 
MBcidgaganacandrika-HK-299	pañcacakratanureṣa jṛmbhate nirvikalpaśivabodhasatphalaḥ |	pañca cakra tanuḥ eṣa jṛmbhate nirvikalpa śiva bodha sat phalaḥ 
MBcidgaganacandrika-HK-300	pañcasu kramamahīruhaḥ śive tvanmarīciṣu nirastavaibhavam || 140 ||	pañcasu krama mahīruhaḥ śive tvad marīciṣu nirasta vaibhavam 
MBcidgaganacandrika-HK-301	bījamamba ! tava pañcadhoditasphāritapraguṇadevatākramaḥ |	bījam amba tava pañcadhā udita sphārita praguṇa devatā kramaḥ 
MBcidgaganacandrika-HK-302	siddhido'yamaparītajṛmbhaṇo yaḥ prakāśa iha so'ntacakragaḥ || 141 ||	siddhi daḥ yama parīta jṛmbhaṇaḥ yaḥ prakāśaḥ iha 
MBcidgaganacandrika-HK-303	śambhudhāmni patitāmbareśvarī śaktidhāmani tato'nu khecarī |	śambhu dhāmni patita ambara īśvarī śakti dhāmani tatonu khecarī 
MBcidgaganacandrika-HK-304	bhūcarī tvamanu yogadhāmnyato dikcarī tadanu mantradhāmani || 142 ||	bhūcarī tvam anu yoga dhāmni atas diś carī tadanu mantra dhāmani 
MBcidgaganacandrika-HK-305	pañcamaṃ jhaṭiti pātukakramādīyuṣī sphurasi raudravaibhavāt |	pañcamam jhaṭiti pātuka kramāt īyuṣī sphurasi raudra vaibhavāt 
MBcidgaganacandrika-HK-306	jñānadhāmni nikhileśi gocarī na kramastava nirāśraye pade || 143 ||	jñāna dhāmni nikhila īśi gocarī na kramaḥ tava nirāśraye pade 
MBcidgaganacandrika-HK-307	jñānataḥ prabhṛti pañcamaṃ śive yat tvamatra paracinnabhastanuḥ |	jñānataḥ prabhṛti pañcamam śive yat tvam atra para cit nabhaḥ tanuḥ 
MBcidgaganacandrika-HK-308	pañcavāhamayaśaktigarbhiṇī bhāsase prathanaketaghasmarī || 144 ||	pañca vāha maya śakti garbhiṇī bhāsase prathana keta ghasmarī  /
MBcidgaganacandrika-HK-309	tvaṃ nirantaracidambarātmikā velayā'mba tulitā dayāmbugheḥ |	tvam nirantara cit ambara ātmikā velayā amba tulitā dayā ambugheḥ 
MBcidgaganacandrika-HK-310	tvayyamūrjhaṭiti saṃvidāpagāḥ pūrṇatāṃ dadhati nirniketanāḥ || 145 ||	tvayi amūḥ jhaṭiti saṃvid āpagāḥ pūrṇa tām dadhati nirniketanāḥ 
MBcidgaganacandrika-HK-311	pañcadhā prabhṛtavaibhavaṃ śive cakrametadiha gocarīkṛtam |	pañcadhā prabhṛta vaibhavam śive cakram etat iha gocarīkṛtam 
MBcidgaganacandrika-HK-312	viśvabhakṣanirupākhyacinmayāt tvatpadād galati naiva jātucit || 146 ||	viśva bhakṣa nirupākhya cit mayāt tvad padāt galati nā eva jātucit 
MBcidgaganacandrika-HK-313	dhāma yad bhavati mudrayā samaṃ yā ca saṃvidaniketanāśraye |	dhāma yat bhavati mudrayā samam yā ca saṃvida niketana āśraye 
MBcidgaganacandrika-HK-314	yā'ṇubhāvakalitā kalā ca tat sarvamamba tava bṛndacakragam || 147 ||	yā aṇu bhāva kalitā kalā ca tat sarvam amba tava bṛnda cakra gam 
MBcidgaganacandrika-HK-315	asvarollasanabījamagrimo kṣīṇato'vapurapākṛtakramaḥ |	a svara ullasana bījam agrimaḥ kṣīṇataḥ vapuḥ apākṛta kramaḥ 
MBcidgaganacandrika-HK-316	nāda eṣa tava viśvadaiśikaḥ ko'pi saṃvidi vimarśa īśvaraḥ || 148 ||	nādaḥ eṣa tava viśva daiśikaḥ kaḥ api saṃvidi vimarśaḥ īśvaraḥ 
MBcidgaganacandrika-HK-317	granthipañcakavibhedinī citiḥ pañcatāralipivṛttisūcitā |	                 
MBcidgaganacandrika-HK-318	yeyamamba paradhāmni te tanuryonipañcakamayī nirākṛtiḥ || 149 ||	yā iyam amba para dhāmni te tanuḥ yoni pañcaka mayī nirākṛtiḥ 
MBcidgaganacandrika-HK-319	sparśavarṇamayapañcavargajairvistarairjanani mudritā tvayā |	sparśa varṇa maya pañcavarga jaiḥ vistaraiḥ janani mudritā tvayā 
MBcidgaganacandrika-HK-320	vyaktibhedaracanā samantato vyaktidhāmasahitā jaganmayī || 150 ||	vyakti bheda racanā samantataḥ vyakti dhāma sahitā jagat mayī 
MBcidgaganacandrika-HK-321	āditaḥ kramamayībhiramba yaḥ pañcabhirbhavati yonibhiḥ svataḥ |	āditas krama mayībhiḥ amba yaḥ pañcabhiḥ bhavati yonibhiḥ svatas 
MBcidgaganacandrika-HK-322	akramaḥ kramamayastvadāśrayāt sakramaḥ sphurati sṛṣṭilakṣaṇaḥ || 151 ||	akramaḥ krama mayaḥ tvad āśrayāt sa kramaḥ sphurati sṛṣṭi lakṣaṇaḥ 
MBcidgaganacandrika-HK-323	kevalaṃ jagati yonirakramā yogamūrtiriha te satāṃ matā |	kevalam jagati yoniḥ akramā yoga mūrtiḥ iha te satām matā 
MBcidgaganacandrika-HK-324	yoniratra mahatī taduttarā sā yadetadavabhāsanaṃ tava || 152 ||	yoniḥ atra mahatī tad uttarā sā yat etat avabhāsanam tava  /
MBcidgaganacandrika-HK-325	śaṅkhayonirata uttarā dhṛtā vṛttiramba tava yattu cavarṇam |	śaṅkhayoniḥ atas uttarā dhṛtā vṛttiḥ amba tava yat tu cavarṇam 
MBcidgaganacandrika-HK-326	kālavigrahavilāsanaṃ punaḥ padmayonirapi te vikasvarā || 153 ||	kāla vigraha vilāsanam punar padmayoniḥ api te vikasvarā  /
MBcidgaganacandrika-HK-327	nistaraṅgajaladhikramā sthitā kāli dhāmni tava bhedaghasmare |	nistaraṅga jaladhi kramā sthitā kāli dhāmni tava bheda ghasmare 
MBcidgaganacandrika-HK-328	divyayoniriha svasvarūpiṇī niḥsvabhāva udayaḥ parastava || 154 ||	divya yoniḥ iha sva svarūpiṇī niḥsvabhāvaḥ udayaḥ paraḥ tava  /
MBcidgaganacandrika-HK-329	svasvarūpamayaviśvamūrtidṛksiddhagāḍhaṣarirabdhavigrahāḥ |	sva svarūpa maya viśvamūrti dṛś siddha gāḍha ṣarirabdha vigrahāḥ 
MBcidgaganacandrika-HK-330	sparśamūrtimadhiruhya pañca te yonayo vidhṛtasṛṣṭimaṇḍalāḥ || 155 ||	sparśa mūrtim adhiruhya pañca te yonayaḥ vidhṛta sṛṣṭi maṇḍalāḥ 
MBcidgaganacandrika-HK-331	jāgarāmukhacatuḥpadā'dvayonmeṣasaṃsphuritamātṛlakṣaṇā |	                                                           
MBcidgaganacandrika-HK-332	nirdvayādvayagatirmahākhage drāk tavāmba patisiddhamaṇḍalī || 156 ||	nirdvaya advaya gatiḥ mahā khage drāk tava amba pati siddha maṇḍalī   
MBcidgaganacandrika-HK-333	kuṇḍahṛtsvaracatuṣṭaye sthito vyaktitaḥ prabhṛti yo jagatkramaḥ |	kuṇḍa hṛd svara catuṣṭaye sthitaḥ vyaktitaḥ prabhṛti yaḥ jagat kramaḥ 
MBcidgaganacandrika-HK-334	tasya gopaka udagravaibhavo yo'vatāra iha sāmba te prathā || 157 ||	tasya gopakaḥ udagra vaibhavaḥ yovatāraḥ iha sāmba te prathā  
MBcidgaganacandrika-HK-335	spandamūrtimavinaśvaraṃ khagaṃ sparśaśūnya iha haṃsamāsthitaḥ |	spanda mūrtim avinaśvaram kha gam sparśa śūnyaḥ iha haṃsam āsthitaḥ 
MBcidgaganacandrika-HK-336	īśvarastripathabhakṣyadhāmago yastamamba bhajate khagendratā || 158 ||	īśvaraḥ tripatha bhakṣya dhāma gaḥ yaḥ tam amba bhajate khagendra tā 
MBcidgaganacandrika-HK-337	prātibhaḥ prathama udyamo'mba yaścitraviśvaracanādaro'dvayaḥ |	prātibhaḥ prathamaḥ yaḥ citra viśva racanā ādara udvayaḥ 
MBcidgaganacandrika-HK-338	kūrmavṛttimanukṛtya kūrmatāṃ yātyasau tava niveśitaḥ pathi || 159 ||	kūrma vṛttim anukṛtya kūrma tām yāti asau tava niveśitaḥ pathi 
MBcidgaganacandrika-HK-339	meṣa eṣa udayaḥ paro mama chandatokṣatanutāṃ vahatyume |	meṣaḥ eṣaḥ udayaḥ paraḥ mama chanda tā ukṣa tanu tām vahati ume 
MBcidgaganacandrika-HK-340	nityaturyamahimā grasannibhaṃ meṣa eti tava dhāmni saṃsthitim || 160 ||	nitya turya mahimā gra sat nibham meṣaḥ eti tava dhāmni saṃsthitim 
MBcidgaganacandrika-HK-341	chandato mama nirāśraye pade muktabāhyapadasiddhikalpanāḥ |	chandataḥ mama nirāśraye pade mukta bāhya pada siddhi kalpanāḥ 
MBcidgaganacandrika-HK-342	saṃvido vasata yūyamityamūḥ śāstyasau tava nirargalaḥ śive || 161 ||	saṃvidaḥ vasata yūyam iti amūḥ śāsti asau tava nirargalaḥ śive   
MBcidgaganacandrika-HK-343	nistaraṅgaparamādvayaprathāmbhonidhau pratinivartitakramaḥ |	                        
MBcidgaganacandrika-HK-344	viśvamannamudaraṃ nayatyume mīna utkaṭavimarśavaktragaḥ || 162 ||	viśvam annam udaram nayati ume mīnaḥ utkaṭa vimarśa vaktra gaḥ   
MBcidgaganacandrika-HK-345	nirniketamahimā nirākṛtistāvako'yamavabhāsanakramaḥ |	nirniketa mahimā nirākṛtiḥ tāvakaḥ yam avabhāsana kramaḥ 
MBcidgaganacandrika-HK-346	svasthaśaktivisaratsamāhito yatra śaktinivaho'mba jṛmbhate || 163 ||	svastha śakti visarat samāhitaḥ yatra śakti nivaha umba jṛmbhate 
MBcidgaganacandrika-HK-347	kṣānta ādikalitākṣacakrago dhīnirāsakṛtatadvicāraṇaḥ |	kṣāntaḥ ādi kalita akṣa cakra gaḥ dhī nirāsa kṛta tad vicāraṇaḥ 
MBcidgaganacandrika-HK-348	khaṇḍacakra udito'mba te kramo rudrasaṃkhya iha saṃhṛtikramaḥ || 164 ||	khaṇḍa cakraḥ te kramaḥ rudra saṃkhyaḥ iha saṃhṛti kramaḥ 
MBcidgaganacandrika-HK-349	niścitagrahanideśavarjito yuktyayuktyatigato'kramaḥ paraḥ |	niścita graha nideśa varjitaḥ yukti ayukti atigata ukramaḥ paraḥ 
MBcidgaganacandrika-HK-350	satpathoditakhadhāmagaḥ śive khaṇḍacakravisarastavotkaṭaḥ || 165 ||	sat patha udita kha dhāma gaḥ śive khaṇḍa cakra visaraḥ tava utkaṭaḥ 
MBcidgaganacandrika-HK-351	vyaktimattaditarakramaprathāguptikṛt kṣatabahirjagatkramaḥ |	                                                                                    
MBcidgaganacandrika-HK-352	nirgatādhamamahārthajṛmbhitaḥ saṃbhṛtau janani te'nvayakramaḥ || 166 ||	nirgata adhama mahā artha jṛmbhitaḥ saṃbhṛtau janani tena vaya kramaḥ 
MBcidgaganacandrika-HK-353	grāhyatadgrahavidhātṛsaṃbhramo nādayugma iha viśramonmukhaḥ |	grāhya tad graha vidhātṛ saṃbhramaḥ nāda yugmaḥ iha viśrama unmukhaḥ 
MBcidgaganacandrika-HK-354	rudrasaṃkhya imamattumīhate tāvake tava marīcirambike || 167 ||	rudra saṃkhye imam attum īhate tāvake tava marīciḥ ambike   
MBcidgaganacandrika-HK-355	yo daśendriyaniviṣṭa uddhṛto'tyarthamātmajaḍabhedaviplutaḥ |	yaḥ daśa indriya niviṣṭaḥ uddhṛta utyartham ātma jaḍa bheda viplutaḥ 
MBcidgaganacandrika-HK-356	tat kṣayāya vata kālakarṣiṇī tvatsamullasati tāvakī ruciḥ || 168 ||	tat kṣayāya vata kāla karṣiṇī tvad samullasati tāvakī ruciḥ 
MBcidgaganacandrika-HK-357	akṣacakranivaho'rkasaṃkhyayā svaṃ svamarthamiha yo grasatyume |	akṣa cakra nivaha ūrka saṃkhyayā svam svam artham iha yaḥ grasati ume 
MBcidgaganacandrika-HK-358	ciccamatkaraṇanirbharaḥ sa te pratyagullasati tatpadaṃ gataḥ || 169 ||	cit camatkaraṇa nirbharaḥ sa te pratyak ullasati tad padam gataḥ 
MBcidgaganacandrika-HK-359	tatpadaṃ jhaṭiti nītasantatiḥ prekṣya devi tava turyadhāmagaḥ |	tat padam jhaṭiti nīta santatiḥ prekṣya devi tava turya dhāma gaḥ 
MBcidgaganacandrika-HK-360	nistaraṅgaparamāmbarātmagāḥ sāmarasyamupayanti dīptayaḥ || 170 ||	nistaraṅga parama ambara ātma gāḥ sāmarasyam upayanti dīptayaḥ 
MBcidgaganacandrika-HK-361	ādisargasamakhaṇḍavarjitasvasvarātmarucicakragāmini |	ādi sarga sama khaṇḍa varjita sva svara ātma ruci cakra gāmini 
MBcidgaganacandrika-HK-362	vyaktatatparatayā sthitaṃ bahistāvakārtharucicakramambike || 171 ||	vyakta tatpara tayā sthitam bahis tāvaka artha ruci cakram ambike  
MBcidgaganacandrika-HK-363	nirvikalpaparamāmbarāśrayāḥ ujjhitetarapadāstviṣastava |	nirvikalpa parama ambara āśrayāḥ ujjhita itara padāḥ tviṣaḥ tava 
MBcidgaganacandrika-HK-364	sphāritā hi yadi pūrṇatāmadhuḥ saṃbhramaṃ jagati bāhyamīśvare || 172 ||	sphāritāḥ hi yadi pūrṇa tā madhuḥ saṃbhramam jagati bāhyam īśvare   
MBcidgaganacandrika-HK-365	cañcalā taṭidivākramaṃ parā spandavṛttilaharī tavāmba yā |	cañcalā taṭit iva ākramam parā spanda vṛtti laharī tava amba yā 
MBcidgaganacandrika-HK-366	sodayāt prabhṛti kalpanāṃ vinā vṛttibhistisṛbhirujjhitā sakṛt || 173 ||	sa udayāt prabhṛti kalpanām vinā vṛttibhiḥ tisṛbhiḥ ujjhitā sakṛt 
MBcidgaganacandrika-HK-367	amba tatra kalanā pṛthakkriyā sṛṣṭitaḥ svapathage krame ca yā |	amba tatra kalanā pṛthakkriyā sṛṣṭitaḥ sva patha ge krame ca yā 
MBcidgaganacandrika-HK-368	tadvirūpamamalaṃ tanukramodyogamukhyacaturūrmisañcitam || 174 ||	tat virūpam amalam tanu krama udyoga mukhya catur ūrmi sañcitam 
MBcidgaganacandrika-HK-369	ekamamba tava bhātyanāvṛto dvādaśakramacidūrmiḍambaraḥ |	ekamamba tava bhāti anāvṛtaḥ dvādaśa krama cit ūrmi ḍambaraḥ 
MBcidgaganacandrika-HK-370	sṛṣṭikālyudayameti yanmukhe yaḥ sphuṭo niravadhirnirāśrayaḥ || 175 ||	sṛṣṭi kālī udayam eti yad mukhe yaḥ sphuṭaḥ niravadhiḥ nirāśrayaḥ 
MBcidgaganacandrika-HK-371	tasya devi harasaṃbhṛtervaśād durnirīkṣyatanurucchritāśrayaḥ |	tasya devi hara saṃbhṛteḥ vaśāt durnirīkṣya tanuḥ ucchrita āśrayaḥ 
MBcidgaganacandrika-HK-372	svasvabhāvavihitakramākrame dvaidha eṣa tava cittviṣāṃ cayaḥ || 176 ||	sva svabhāva vihita krama akrame dvaidhaḥ eṣa tava cit tviṣām cayaḥ 
MBcidgaganacandrika-HK-373	yo manonmanamanonmanītaraḥ svasvarūpacaturātmabhāvataḥ |	yaḥ manonmana manonmanī itaraḥ sva svarūpa catur ātma bhāvataḥ 
MBcidgaganacandrika-HK-374	dvādaśaikyatanurakramakramo bhairavastvamasi devi te sthitiḥ || 177 ||	dvādaśa aikya tanuḥ akra makramaḥ bhairavaḥ tvam asi devi te sthitiḥ   
MBcidgaganacandrika-HK-375	brahmaviṣṇuharamūrtitāṃ yato'bhyeti tattava turīyamāspadam |	brahma viṣṇu hara mūrti tām yatas abhyeti tat tava turīyam āspadam 
MBcidgaganacandrika-HK-376	vyoma yat kramamayī tvadīraṇā dhūyate layakhacakragā śive || 178 ||	vyoma yat krama mayī tvad īraṇā dhūyate laya kha cakra gā śive  /
MBcidgaganacandrika-HK-377	bindugarbhanihitaṃ tridhāmagaṃ tadviśiṣṭamupari prasarpati |	bindu garbha nihitam tridhāma gam tad viśiṣṭam upari prasarpati 
MBcidgaganacandrika-HK-378	bhedanānidhanamoṃ yadambike tattvameva paratattvadarśanam || 179 ||	bhedanā nidhanam om yat ambike tattvam eva para tattva darśanam 
MBcidgaganacandrika-HK-379	sattvajāśrutakalāvadhi tvayā kālavahnibhuvanā marīcayaḥ |	sattva ja aśruta kalā avadhi tvayā kāla vahni bhuvanāḥ marīcayaḥ 
MBcidgaganacandrika-HK-380	bhakṣaṇāya jagataḥ prasāritā yallayānnṛbhiraṇutvamujjhyate || 180 ||	bhakṣaṇāya jagataḥ prasāritāḥ yad layāt nṛbhiḥ aṇu tvam ujjhyate   
MBcidgaganacandrika-HK-381	varṇamantrapadajṛmbhayā sama yāḥ kalāstadanu tattvamaṇḍalam |	varṇa mantra pada jṛmbhayā sama yāḥ kalāḥ tadanu tattva maṇḍalam 
MBcidgaganacandrika-HK-382	yāni tatra bhuvanāni caṇḍike tatra kṛtsnamapi gṛhyate sthitau || 181 ||	yāni tatra bhuvanāni caṇḍike tatra kṛtsnam api gṛhyate sthitau 
MBcidgaganacandrika-HK-383	tvaṃ nirāvaṇayuktimāsthitaistāvakādvayavimarśasādhitā |	tvam nirāvaṇa yuktim āsthitaiḥ tāvaka advaya vimarśa sādhitā 
MBcidgaganacandrika-HK-384	antarāhitaṣaḍadhvamaṇḍapairyogibhirjanani śaśvadīḍyase || 182 ||	antara āhita ṣaḍadhva maṇḍapaiḥ yogibhiḥ janani śaśvat īḍyase  /
MBcidgaganacandrika-HK-385	mūlataḥ prabhṛti pāvakāśrayaṃ dvādaśāntanidhanaṃ śive jagat |	mūlataḥ prabhṛti pāvaka āśrayam dvādaśānta nidhanam śive jagat 
MBcidgaganacandrika-HK-386	vāhatatprathanayorniṣeduṣī majjayasva tava dhāmni citpade || 183 ||	vāha tad prathanayoḥ niṣeduṣī majjayasva tava dhāmni cit pade 
MBcidgaganacandrika-HK-387	ye nirāvaraṇayuktiśālinastān prati sphurati tatparaṃ nabhaḥ |	ye nirāvaraṇa yukti śālinaḥ tān prati sphurati tat param nabhaḥ 
MBcidgaganacandrika-HK-388	yatra meyamitimātṛghasmare vāsanāpi na jagadvibhedagā || 184 ||	yatra mā iyam iti mātṛ ghasmare vāsanā api na jagat vibheda gā 
MBcidgaganacandrika-HK-389	vṛttisaṃharaṇameva mātari vyajyate na khalu saṃstutikṣayaḥ |	vṛtti saṃharaṇam eva mātari vyajyate na khalu saṃstuti kṣayaḥ 
MBcidgaganacandrika-HK-390	taddvayaṃ ca tava dhāmni saṃbhṛtaṃ caṇḍi keyamiti caṇḍimā tvayi || 185 ||	tat dvayam ca tava dhāmni saṃbhṛtam caṇḍi kā iyam iti caṇḍimā tvayi 
MBcidgaganacandrika-HK-391	bhūtayantranilayāstavāmbike śaktayo'kṣarakavṛndamāsthitāḥ |	bhūta yantra nilayāḥ tava ambike śaktayā ukṣaraka vṛndam āsthitāḥ 
MBcidgaganacandrika-HK-392	tvatpadaṃ hi viṣayāmṛtāsavaiḥ svasvavṛttikusumairyajantyamūḥ || 186 ||	tvad padam hi viṣaya amṛta āsavaiḥ sva sva vṛtti kusumaiḥ yajanti amūḥ 
MBcidgaganacandrika-HK-393	gocarīprabhṛti śūnyapaścimaṃ bhūtaṣaṭkamavamajya dhāmni te |	gocarī prabhṛti śūnya paścimam bhūta ṣaṭkam avamajya dhāmni te 
MBcidgaganacandrika-HK-394	svaprabhe pramadanirbharāḥ paraṃ śaktayo dadhati darpamīśvare || 187 ||	sva prabhe pramada nirbharāḥ param śaktayaḥ dadhati darpam īśvare  /
MBcidgaganacandrika-HK-395	dvādaśāmba ! kiraṇātmano ravermātṛvahnividite tvadambare |	dvādaśāmba kiraṇa ātmanaḥ raveḥ mātṛ vahni vidite tvad ambare 
MBcidgaganacandrika-HK-396	viśvametya sahasā marīcayo'śnanti cinmukurabimbitaṃ jagat || 188 ||	viśvam etya sahasā marīcayā uśnanti cit mukura bimbitam jagat   
MBcidgaganacandrika-HK-397	bāhyamīśvari vinā sudarpaṇo bimbametadanukāriṇī tanuḥ |	bāhyam īśvari vinā sudarpaṇaḥ bimbam etad anukāriṇī tanuḥ 
MBcidgaganacandrika-HK-398	vyāptatāmupeyuṣī tvadambare yuktimarhati na bimbabāhyatām || 189 ||	vyāpta tām upeyuṣī tvad ambare yuktim arhati na bimba bāhya tām 
MBcidgaganacandrika-HK-399	asti bāhyamiti tatpratheta cet tādṛśaprathanagarbhitaṃ hi tat |	asti bāhyam iti tat pratheta ced tādṛśa prathana garbhitam hi tat 
MBcidgaganacandrika-HK-400	na pravedayati niṣpramāṇakam mānamamba khalu sādhayet prathām || 190 ||	na pravedayati niṣpramāṇakam mānam amba khalu sādhayet prathām 
MBcidgaganacandrika-HK-401	īdṛgetaditi caiva mā phalaṃ tattatheti hi vimarśa āntaraḥ |	īdṛś etat iti ca eva mā phalam tat tathā iti hi vimarśaḥ āntaraḥ 
MBcidgaganacandrika-HK-402	nirvibādha upadhānaśabdavat karma sā tvayi puṭatrayī sthitā || 191 ||	nirvibādhaḥ upadhāna śabda vat karma sā tvayi puṭa trayī sthitā 
MBcidgaganacandrika-HK-403	māyayāntaramapi sthitaṃ jagad vartamānamavabhāti bāhyavat |	māyayā antaram api sthitam jagat vartamānam avabhāti bāhya vat 
MBcidgaganacandrika-HK-404	bhūtabhāviyugalaṃ yathāpuraṃ vidyayāmba tava vṛttirūpayā || 192 ||	bhūta bhāvi yugalam yathāpuram vidyayā amba tava vṛtti rūpayā 
MBcidgaganacandrika-HK-405	tvaṃ guhā nikhilabhāvagūhanī bhāmayena vapuṣā'vatiṣṭhase |	tvam guhā nikhila bhāva gūhanī bhā mayena vapuṣā avatiṣṭhase 
MBcidgaganacandrika-HK-406	yacca yastava patirguhāśayaḥ prāṇicakramakhilaṃ ca yasya pūḥ || 193 ||	yat ca yaḥ tava patiḥ guhā āśayaḥ prāṇi cakram akhilam ca yasya pūḥ 
MBcidgaganacandrika-HK-407	bhāsitaṃ janani māyayā bahirbimbametadanukāri mānasam |	bhāsitam janani māyayā bahis bimbam etat anukāri mānasam 
MBcidgaganacandrika-HK-408	māturetadubhayaṃ ca bimbitaṃ tāvake vapuṣi yad dvayaṃ sthitam || 194 ||	mātuḥ etat ubhayam ca bimbitam tāvake vapuṣi yat dvayam sthitam  /
MBcidgaganacandrika-HK-409	vārivahnimukurādiṣu sphuṭā svacchavastuṣu kumāri bimbatā |	vāri vahni mukura ādiṣu sphuṭā svaccha vastuṣu kumāri bimba tā 
MBcidgaganacandrika-HK-410	mantritā saha paricchadena yat tena bimbamanavekṣitaṃ tava || 195 ||	mantri tā saha paricchadena yat tena bimbam anavekṣitam tava 
MBcidgaganacandrika-HK-411	yatsmṛtau sphurati vastu bimbitaṃ svapnasaṃprathanakalpayośca yat |	yat smṛtau sphurati vastu bimbitam svapna saṃprathana kalpayoḥ ca yat 
MBcidgaganacandrika-HK-412	bimbavarjamiha tannidarśanāt tvannimagnamuditaṃ jagat tvayā || 196 ||	bimba varjam iha tad nidarśanāt tvad nimagnam uditam jagat tvayā 
MBcidgaganacandrika-HK-413	svapnadṛṣṭamasadityasadvaco divya eṣa yadiha pramāṇitaḥ |	svapna dṛṣṭam asat iti asat vacaḥ divyaḥ eṣa yat iha pramāṇitaḥ 
MBcidgaganacandrika-HK-414	kalpanāpi na mṛṣā phalaṃ śive yat sthitaṃ garuḍabhāvanādijam || 197 ||	kalpanā api na mṛṣā phalam śive yat sthitam garuḍa bhāvanā ādi jam 
MBcidgaganacandrika-HK-415	khyātiramba ! yadi yāti pūrṇatāmīdṛgetaditi kalpanāmayī |	khyātiḥ amba yadi yāti pūrṇa tām īdṛś etat iti kalpanā mayī 
MBcidgaganacandrika-HK-416	tattatheti hi vimarśa uttaro nāntareti parimardayogyatām || 198 ||	tat tathā iti hi vimarśaḥ uttaraḥ na antareti parimarda yogya tām 
MBcidgaganacandrika-HK-417	asti tadyadi dhṛtaṃ jalasthale devi ! tadvadanalārkasomayoḥ |	asti tat yadi dhṛtam jala sthale devi tadvat anala arka somayoḥ 
MBcidgaganacandrika-HK-418	mārute nabhasi vā tadākṛtistatkṛtiṃ ca kurute hi pūruṣaḥ || 199 ||	mārute nabhasi vā tad ākṛtiḥ tad kṛtim ca kurute hi pūruṣaḥ 
MBcidgaganacandrika-HK-419	kalpanā yadi mṛṣeti bhāṣitā dhāraṇā phalati kena hetunā |	kalpanā yadi mṛṣā iti bhāṣitā dhāraṇā phalati kena hetunā 
MBcidgaganacandrika-HK-420	devi ! saṃkalanabodhajīvitā devatā kimiti kairna hīyase || 200 ||	devi saṃkalana bodha jīvitā devatā kim iti kaiḥ na hīyase  /
MBcidgaganacandrika-HK-421	tanna jagmurudadhau svayauktito viṣṇurātmajamadarśayaccitaḥ |	tat na jagmuḥ udadhau sva yauktitaḥ viṣṇuḥ ātmajam adarśayat citaḥ 
MBcidgaganacandrika-HK-422	tātamamba tanayasya śaṅkaro dagdha eṣa hi bahiḥkramastava || 201 ||	tātam amba tanayasya śaṅkaraḥ dagdhaḥ eṣa hi bahis kramaḥ tava  /
MBcidgaganacandrika-HK-423	rūpameṣyati hayānanaṃ harirgopasaṃjñamagamad bahiḥ puraḥ |	rūpam eṣyati haya ānanam hariḥ gopa saṃjñam agamat bahis puras 
MBcidgaganacandrika-HK-424	tad dvayaṃ ca bhajatāṃ bahiḥ phalaṃ bhāvi cenna sadatītamamba yat || 202 ||	tat dvayam ca bhajatām bahis phalam bhāvi ced na sat atītam amba yat  /
MBcidgaganacandrika-HK-425	akṣare'mba parame viyadṛco yatra yatra sakalā ca devatā |	parame viyat ṛcaḥ yatra yatra sakalā ca devatā 
MBcidgaganacandrika-HK-426	tanna vedayati cedṛcāṃ phalaṃ tadvidāṃ taditi hi sphuṭā śrutiḥ || 203 ||	tat na vedayati ced ṛcām phalam tad vidām tat iti hi sphuṭā śrutiḥ 
MBcidgaganacandrika-HK-427	vahnibhānuśaśividyudātapaṃ jyotiriṅgaṇanabhaścarādayaḥ |	vahni bhānu śaśi vidyut ātapam jyotiḥ iṅgaṇa nabhaścara ādayaḥ 
MBcidgaganacandrika-HK-428	yāḥ sphuranti hṛdaye'pi sāravāḥ taistadambaragatairhi bhūyate || 204 ||	yāḥ sphuranti hṛdaye pi sāravāḥ taiḥ tad ambara gataiḥ hi bhūyate  /
MBcidgaganacandrika-HK-429	deśakālamavabhāsi yādṛśaṃ yattayā'nubhaviturvibhedinaḥ |	deśa kālam avabhāsi yādṛśam yad tayā anubhavituḥ vibhedinaḥ 
MBcidgaganacandrika-HK-430	tattayā sakalamīkṣyate smṛtau matkṛtasmṛtimavekṣate kṣaṇam || 205 ||	tat tayā sakalam īkṣyate smṛtau mad kṛta smṛtim avekṣate kṣaṇam 
MBcidgaganacandrika-HK-431	yadyanaṅkṣyadanubhūtirīśvare sā smṛtistaditinā pratiṣyate |	yadi anaṅkṣyat anubhūtiḥ īśvare sā smṛtiḥ tad itinā pratiṣyate 
MBcidgaganacandrika-HK-432	saṃstavo hyanubhavasmṛtau sthitastatkṣaye'nubhava eva na smṛtiḥ || 206 ||	saṃstavaḥ hi anubhava smṛtau sthitaḥ tad kṣaye anubhavaḥ eva na smṛtiḥ 
MBcidgaganacandrika-HK-433	saṃsmṛtiḥ sadṛśavastubodhikā dṛṣṭa eva viṣayaḥ smṛtetaraḥ |	saṃsmṛtiḥ sadṛśa vastu bodhikā dṛṣṭaḥ eva viṣayaḥ smṛtā itaraḥ 
MBcidgaganacandrika-HK-434	dṛk śive viṣayabhānavigrahā tatprathā smṛtiriyaṃ yadāhṛtā || 207 ||	  śive viṣaya bhāna vigrahā tad prathā smṛtiḥ iyam yadā āhṛtā 
MBcidgaganacandrika-HK-435	draṣṭṛdṛśyadṛśilakṣaṇaṃ jagat prāksmṛtestvayi tadamba saṃhṛtam |	draṣṭṛ dṛśya dṛśi lakṣaṇam jagat prāk smṛteḥ tvayi tat amba saṃhṛtam 
MBcidgaganacandrika-HK-436	unmiṣatyapi punastadudgame tallaye nimiṣati tvadicchayā || 208 ||	unmiṣati api punar tad udgame tad laye nimiṣati tvad icchayā  /
MBcidgaganacandrika-HK-437	sā pramāturiha jīvitaṃ smṛtiryatnatāṃ prakaṭayatyamuṣya yā |	sā pramātuḥ iha jīvitam smṛtiḥ yatna tām prakaṭayati amuṣya yā 
MBcidgaganacandrika-HK-438	yā ca dṛg janani nihnutena te apyubhe saha punarvirūpatām || 209 ||	yā ca dṛś janani nihnutena te api ubhe saha punar virūpatām 
MBcidgaganacandrika-HK-439	dṛg vidhatta iha viśvamambike tatpunaḥ sthirayati smṛtistava |	dṛś vidhatte iha viśvam ambike tat punar sthirayati smṛtiḥ tava 
MBcidgaganacandrika-HK-440	tanmithopanihitā niṣīdasi tvaṃ tu yogatamasītyanāśritā || 210 ||	tat mitha upanihitā niṣīdasi tvam tu yoga tamasi iti anāśritā 
MBcidgaganacandrika-HK-441	sṛṣṭipālananirodhalakṣaṇā rūpatāṃ vahasi bindulakṣaṇā |	sṛṣṭi pālana nirodha lakṣaṇā rūpa tām vahasi bindu lakṣaṇā 
MBcidgaganacandrika-HK-442	tadvilakṣaṇapadā tvamambike cinmayī punararūpamucyase || 211 ||	tad vilakṣaṇa padā tvam ambike cit mayī punar arūpam ucyase 
MBcidgaganacandrika-HK-443	bhogyabhoktṛmayagā vimarśagā devi māṃ cidudare dṛḍhāṃ daśām |	bhogya bhoktṛ maya gāḥ vimarśa gāḥ devi mām cit udare dṛḍhām daśām 
MBcidgaganacandrika-HK-444	ārpayadanalasomamiśraṇastvadvimarśa iha bhānujṛmbhaṇaḥ || 212 ||	ārpayat anala soma miśraṇaḥ tvad vimarśaḥ iha bhānu jṛmbhaṇaḥ 
MBcidgaganacandrika-HK-445	dṛṣṭirūpamidamamba bhāvitaṃ sthemarūpakaraṇāṃśubhirjagat |	dṛṣṭi rūpam idam amba bhāvitam sthema rūpa karaṇa aṃśubhiḥ jagat 
MBcidgaganacandrika-HK-446	syādanākhyamaniketayuktitastatpunarlayamanena cātmanā || 213 ||	syāt anākhyam aniketa yuktitaḥ tat punar layam anena ca ātmanā 
MBcidgaganacandrika-HK-447	akṣamūlapaśubhedavigrahā nyāyasaṃbhṛtihṛtārdharūpiṇī |	akṣa mūla paśu bheda vigrahā nyāya saṃbhṛti hṛta ardha rūpiṇī 
MBcidgaganacandrika-HK-448	tvatpade glapitakalpane layād bhāti binduriti kiṃ nu mudrayā || 214 ||	tvad pade glapita kalpane layāt bhāti binduḥ iti kim nu mudrayā 
MBcidgaganacandrika-HK-449	yā daśāsu nikhilāsu sarvathā sarvataḥ sphurati citparā sakṛt |	yā daśāsu nikhilāsu sarvathā sarvatas sphurati cit parā sakṛt 
MBcidgaganacandrika-HK-450	guptabhāṣitajagadvijṛmbhaṇā mantratāṃ bhajasi tattvamamba sā || 215 ||	gupta bhāṣita jagat vijṛmbhaṇā mantra tām bhajasi tat tvam amba sā 
MBcidgaganacandrika-HK-451	akṣimātravisaracchikhaṃ śive vahnimugramudare vitanvatī |	akṣi mātra visarat śikham śive vahnim ugram udare vitanvatī 
MBcidgaganacandrika-HK-452	grastakālatanubhānumatkalā svodaye diśasi śaktijṛmbhaṇam || 216 ||	grasta kāla tanu bhānumat kalā sva udaye diśasi śakti jṛmbhaṇam 
MBcidgaganacandrika-HK-453	tatra te sadasadarthaśūnyatā nirvṛtirjayati yatra viśramaḥ |	tatra te sat asat artha śūnyatā nirvṛtiḥ jayati yatra viśramaḥ 
MBcidgaganacandrika-HK-454	mātṛtatkaraṇagocarojjhitā kālyakālamanu tallayo'stu me || 217 ||	mātṛ tad karaṇa gocara ujjhitā kālya kālam anu tallayoḥ tu me  /
MBcidgaganacandrika-HK-455	kṣepamamba vitanoti saṃkhyayā tadgrahaśca sahasā paratraye |	kṣepam amba vitanoti saṃkhyayā tad grahaḥ ca sahasā para traye 
MBcidgaganacandrika-HK-456	akramaḥ sa khalu kāla īśvare pratyamuṣya bhavatī ca kālyasau || 218 ||	akramaḥ sa khalu kāle īśvare prati amuṣya bhavatī ca kālī asau   
MBcidgaganacandrika-HK-457	khe bahirghanavṛte rucistamohāriṇī vahasi hāsyarūpatām |	khe bahis ghana vṛte ruciḥ tamaḥ hāriṇī vahasi hāsya rūpa tām 
MBcidgaganacandrika-HK-458	tvaṃ ca cinnabhasi māyayā vṛte taddhi kālyasi paraistvamīkṣitā || 219 ||	tvam ca cit nabhasi māyayā vṛte tat hi kālyasi paraiḥ tvam īkṣitā  /
MBcidgaganacandrika-HK-459	dvādaśaśātmaravikālaghasmarī kālakāliśivabhūmikā varā |	                     
MBcidgaganacandrika-HK-460	yādṛśī bhavasi caṇḍi ! tādṛśīṃ tvāṃ viduḥ kalitakalpanāparām || 220 ||	yādṛśī bhavasi caṇḍi tādṛśīm tvām viduḥ kalita kalpanā parām 
MBcidgaganacandrika-HK-461	yatkulaṃ trividhamamba tadbhavo yaḥ prakāśa upalakṣyate mahān |	yat kulam trividham amba tad bhavaḥ yaḥ prakāśaḥ upalakṣyate mahān 
MBcidgaganacandrika-HK-462	tatra yo nikhilakalpito'rṇavastvaṃ yadūrmirasi kṛtyalālasā || 221 ||	tatra yaḥ nikhila kalpita ūrṇavaḥ tvam yad ūrmiḥ asi kṛtya lālasā 
MBcidgaganacandrika-HK-463	unmiṣannimiṣadapyuta dvayaṃ viśvametadudare dhṛtaṃ yayā |	unmiṣat nimiṣat api uta dvayam viśvam etat udare dhṛtam yayā 
MBcidgaganacandrika-HK-464	sā tvamamba laharī śivāmbudheḥ kṣepasaṃprakaṭanagrahonmukhī || 222 ||	sā tvam amba laharī śiva ambudheḥ kṣepa saṃprakaṭana graha unmukhī 
MBcidgaganacandrika-HK-465	yaḥ paro nirupasargataḥ paraḥ syānmahānapi ca kevalaḥ śive |	yaḥ paraḥ nirupasargataḥ paraḥ syāt mahān api ca kevalaḥ śive 
MBcidgaganacandrika-HK-466	uttaraṃ ca viṣayotsavastadānanda ullasati cidghanāsi yat || 223 ||	uttaram ca viṣaya utsavaḥ tad ānandaḥ ullasati cidghana asi yat 
MBcidgaganacandrika-HK-467	viśvasaṃhṛtipade layojjhite līyase yadi niraṃśataḥ śive |	viśva saṃhṛti pade laya ujjhite līyase yadi niraṃśataḥ śive 
MBcidgaganacandrika-HK-468	sṛṣṭikālyasi yayā bahiḥpade kṣiptamamba jagadāśu gṛhyate || 224 ||	sṛṣṭi kālī asi yayā bahis pade kṣiptam amba jagat āśu gṛhyate  /
MBcidgaganacandrika-HK-469	labdhasāmyapavanadvayāhṛtaṃ vātacakramadhitasthuṣī śive |	labdha sāmya pavana dvaya āhṛtam vātacakram adhitasthuṣī śive 
MBcidgaganacandrika-HK-470	nirgamāgamamapojjhitāntare tvaṃ sthitaṃ grasasi hi sthitāmbike || 225 ||	nirgama āgamam apojjhita antare tvam sthitam grasasi hi sthitā ambike 
MBcidgaganacandrika-HK-471	yā śikhāntarahutāśanirgatā dhāmacakramavabhindatī kramāt |	yā śikhā antara hutāśaniḥ gatā dhāma cakram avabhindatī kramāt 
MBcidgaganacandrika-HK-472	ūrdhvasomarasapānadīpitā sā'pi devi kalaye bahiḥ sthitaḥ || 226 ||	ūrdhva soma rasa pāna dīpitā sā api devi kalaye bahis sthitaḥ  /
MBcidgaganacandrika-HK-473	barhiṇo'ṇḍarasavad yadantare śabdataḥ prabhṛti citritāsanam |	barhiṇa uṇḍa rasa vat yad antare śabdataḥ prabhṛti citrita āsanam 
MBcidgaganacandrika-HK-474	arthapañcakamasau tvamunmanī sandhipūrvapadakalpaghasmarī || 227 ||	artha pañcakam asau tvam unmanī sandhi pūrva pada kalpa ghasmarī   
MBcidgaganacandrika-HK-475	ātmabhāvamakhilasya jagmuṣī tvaṃ śive niravadhiḥ sadoditā |	ātma bhāvam akhilasya jagmuṣī tvam śive niravadhiḥ sadā uditā 
MBcidgaganacandrika-HK-476	bhāvasaṃhṛtinimeṣavigrahā saṃhṛtaṃ kalayasi hyanāvṛtiḥ || 228 ||	bhāva saṃhṛti nimeṣa vigrahā saṃhṛtam kalayasi hi anāvṛtiḥ 
MBcidgaganacandrika-HK-477	svairakhelananiveśitāḥ śive ātmanā'kṣarucayastrayodaśa |	svaira khelana niveśitāḥ śive ātmanā akṣa rucayaḥ trayodaśa 
MBcidgaganacandrika-HK-478	arthapañcakamayāśca vedakāstvaṃ vinītaghanasāramūrcchitā || 229 ||	artha pañcaka mayāḥ ca vedakāḥ tvam vinīta ghanasāra mūrcchitā 
MBcidgaganacandrika-HK-479	bhakṣayantyakhilamakṣajaiḥ śive śaktiraśmibhirimāśca mātṛbhiḥ |	bhakṣayanti akhilam akṣa jaiḥ śive śakti raśmibhiḥ imāḥ ca mātṛbhiḥ 
MBcidgaganacandrika-HK-480	tāśca saṃsmṛtimahālaye pare rajyatī harasi viśvavigraham || 230 ||	tāḥ ca saṃsmṛti mahā ālaye pare rajyatī harasi viśva vigraham 
MBcidgaganacandrika-HK-481	kālapālakamukhaṃ śivāntakaṃ viśvamabdhipatitodabinduvat |	kālapālaka mukham śiva antakam viśvam abdhi pati toda binduvat 
MBcidgaganacandrika-HK-482	pūrṇatāṃ vahati yatra dīpticid ghasmarī tvamiha sādhyakālyasi || 231 ||	pūrṇa tām vahati yatra dīpti cit ghasmarī tvam iha sādhyakālī asi  /
MBcidgaganacandrika-HK-483	etadamba sadidaṃ tu neti naḥ śaṅkayā hṛdi vikalpalakṣaṇaḥ |	etat amba sat idam tu nā iti naḥ śaṅkayā hṛdi vikalpa lakṣaṇaḥ 
MBcidgaganacandrika-HK-484	yo yamaḥ sa khalu kālyate tvayā bhūtasaṃyamanakelikovidaḥ || 232 ||	yaḥ yamaḥ sa khalu kālyate tvayā bhūta saṃyamana keli kovidaḥ 
MBcidgaganacandrika-HK-485	amba kāryakaraṇe niyacchataḥ pūrṇacitpadamahotsavadviṣaḥ |	amba kārya karaṇe niyacchataḥ pūrṇa cit pada mahā utsava dviṣaḥ 
MBcidgaganacandrika-HK-486	jambitasya hṛdaye svaśaṅkayā tvaṃ yamasya vapuṣā'si bhīṣaṇā || 233 ||	jambitasya hṛdaye sva śaṅkayā tvam yamasya vapuṣā asi bhīṣaṇā 
MBcidgaganacandrika-HK-487	vittadāramukhabhogyagāminī yā mametyabhimatirmadoddhatā |	vitta dāra mukha bhogya gāminī yā mama iti abhimatiḥ mada uddhatā 
MBcidgaganacandrika-HK-488	yā'pyahaṅkṛtiranātmani sthitā mṛtyurūpamubhyaṃ tavāsanam || 234 ||	yā api ahaṅkṛtiḥ anātmani sthitā mṛtyu rūpam ubhyam tava āsanam 
MBcidgaganacandrika-HK-489	viśvamamba kuruṣe śavāsanaṃ mṛtyusecanamakhaṇḍitodayā |	viśvam amba kuruṣe śava āsanam mṛtyu secanam akhaṇḍita udayā 
MBcidgaganacandrika-HK-490	cidvikalpamayamantarudyamaṃ kālamohitajagattrayam prati || 235 ||	cit vikalpa mayam antar udyamam kāla mohita jagattrayam prati 
MBcidgaganacandrika-HK-491	śāśvataprasarayā cidarciṣā dīpitākhilahṛṣīkamārgayā |	śāśvata prasarayā cit arciṣā dīpita akhila hṛṣīka mārgayā 
MBcidgaganacandrika-HK-492	arthapañcakamidaṃ tvayā jagad bhadramamba gamitaṃ tavāntaram || 236 ||	artha pañcakam idam tvayā jagat bhadram amba gamitam tava antaram 
MBcidgaganacandrika-HK-493	vāsanā sthitimayī bhavāspadā tvaṃ niyojya kṛtaviśvasaṃhṛtā |	vāsanā sthiti mayī bhava āspadā tvam niyojya kṛta viśva saṃhṛtā 
MBcidgaganacandrika-HK-494	tvadbhruvā kuṭilayā śive kṣaṇāt saṃhṛtaḥ khalu bhavaḥ savāsanaḥ || 237 ||	tvad bhruvā kuṭilayā śive kṣaṇāt saṃhṛtaḥ khalu bhavaḥ sa vāsanaḥ   
MBcidgaganacandrika-HK-495	kurvatī janani sṛṣṭicitratāṃ yā kalā bhramati vedyamaṇḍale |	kurvatī janani sṛṣṭi citra tām yā kalā bhramati vedya maṇḍale 
MBcidgaganacandrika-HK-496	brūhi sā tava kalonmukhī yadā tvaṃ kriyotkuṭilayāttyamū tadā || 238 ||	brūhi sā tava kalā unmukhī yadā tvam kriyā utkuṭilayā atti amū tadā 
MBcidgaganacandrika-HK-497	unmiṣannimiṣadarkavimbayā'nantayāmba paramārthamadhyataḥ |	unmiṣat nimiṣat arka vimbayā anantayā amba paramārtha madhyatas 
MBcidgaganacandrika-HK-498	agnimūrtiriha sṛjyate tvayā bhakṣyate'pi ca sakṛtprabhātayā || 239 ||	agni mūrtiḥ iha sṛjyate tvayā bhakṣyate api ca sakṛt prabhātayā 
MBcidgaganacandrika-HK-499	bharganāmna iha bhāraveḥ śikhā śaktiramba viṣayendhanonmukhī |	bharga nāmnaḥ iha bhāraveḥ śikhā śaktiḥ amba viṣaya indhana unmukhī 
MBcidgaganacandrika-HK-500	śāntidhāmajuṣi yāti nirvṛtiṃ tvayyasau khalu śivaikapāvake || 240 ||	śānti dhāma juṣi yāti nirvṛtim tvayi asau khalu śiva eka pāvake 
MBcidgaganacandrika-HK-501	yo'mṛtāṇḍanibhamarthapañcakaṃ prāṇinaḥ sphurati bhāmayo raviḥ |	yaḥ umṛta aṇḍa nibham artha pañcakam prāṇinaḥ sphurati bhā mayaḥ raviḥ 
MBcidgaganacandrika-HK-502	saṃhṛtārdhamanu antarāhitaṃ tadvahiḥ sṛjati cārthapañcakam || 241 ||	saṃhṛta ardham anu antara āhitam tat vahis sṛjati ca artha pañcakam 
MBcidgaganacandrika-HK-503	saṃhatordhvanikarasmṛtāvadhirvyaktamaṇḍatanuramba bhāsvaram |	saṃhata ūrdhva nikara smṛta avadhiḥ vyakta maṇḍa tanuḥ amba bhāsvaram 
MBcidgaganacandrika-HK-504	kālalakṣaṇakalāpradīptaye tvaṃ hi viśvarasabhakṣamāsthitā || 242 ||	kāla lakṣaṇa kalā pradīptaye tvam hi viśva rasa bhakṣam āsthitā 
MBcidgaganacandrika-HK-505	bhūtacakramadhukośasambhṛtaṃ tattadarthamadhu pātumutsukaḥ |	bhūta cakra madhu kośa sambhṛtam tat tad artha madhu pātum utsukaḥ 
MBcidgaganacandrika-HK-506	yanmarīciviṣayaḥ sabhāskarastvadrucau śalabhavat pralīyate || 243 ||	yat marīci viṣayaḥ sa bhāskaraḥ tvad rucau śalabha vat pralīyate 
MBcidgaganacandrika-HK-507	prāṇa eṣa yamakāla ucyate madhyavāhatanuragnimamba yaḥ |	prāṇaḥ eṣa yama kālaḥ ucyate madhya vāha tanuḥ agnim amba yaḥ 
MBcidgaganacandrika-HK-508	rudrametadupanīya khaṃ paraṃ tatra sargavimukhaṃ karoṣyamum || 244 ||	rudram etat upanīya kham param tatra sarga vimukham karoṣi amum 
MBcidgaganacandrika-HK-509	tvatkramopahatabhānumaṇḍalaḥ krodha eṣa layavahniruddhataḥ |	tvad krama upahata bhānu maṇḍalaḥ krodhaḥ eṣa laya vahniḥ uddhataḥ 
MBcidgaganacandrika-HK-510	viśvabhakṣaṇarasā marīcayo yasya bhīmavibhavāstvayā hṛtāḥ || 245 ||	viśva bhakṣaṇa rasāḥ marīcayaḥ yasya bhīma vibhavāḥ tvayā hṛtāḥ  /
MBcidgaganacandrika-HK-511	grāhyamatra purato haranti te yat pṛthag grahaṇamapyasuṃ tataḥ |	grāhyam atra puratas haranti te yat pṛthak grahaṇam api asum tatas 
MBcidgaganacandrika-HK-512	grāhakāṃśca varade marīcayaḥ tāstvadarpitajagadvijṛmbhaṇāḥ || 246 ||	grāhakān ca vara de marīcayaḥ tāḥ tvad arpita jagat vijṛmbhaṇāḥ 
MBcidgaganacandrika-HK-513	yaḥ śmaśāna iha bhūtaghasmare rajyate'mba karavīranāmani |	yaḥ śmaśāne iha bhūta ghasmare karavīra nāmani 
MBcidgaganacandrika-HK-514	grāhakaṃ grasasi taṃ śrutaṃ mahākālamapyasuhutāśadurgrahā || 247 ||	grāhakam grasasi tam śrutam mahākālam api asu hutāśa durgrahā 
MBcidgaganacandrika-HK-515	dikcarī daśasu dikṣu yā bahistattadindriyamayīṣu jṛmbhate |	diś carī daśasu dikṣu yā bahis tad tad indriya mayīṣu jṛmbhate 
MBcidgaganacandrika-HK-516	antaramba karaṇatraye ca yā khecarī galasi te ca tvatpriye || 248 ||	antar amba karaṇa traye ca yā khecarī galasi te ca tvad priye 
MBcidgaganacandrika-HK-517	tvaṣṭuramba ! śivabodhabhāsvataḥ sṛṣṭitaḥ prabhṛti yā marīcayaḥ |	tvaṣṭuḥ amba śiva bodha bhāsvataḥ sṛṣṭitaḥ prabhṛti yāḥ marīcayaḥ 
MBcidgaganacandrika-HK-518	dvādaśakramapadatrayordhvagāstāsu saṃcarasi vā trayodaśī || 249 ||	dvādaśa krama pada traya ūrdhva gāḥ tāsu saṃcarasi vā trayodaśī  /
MBcidgaganacandrika-HK-519	sakramākramavimiśrabhāvatastvatkramastritayacāruvīkṣaṇaḥ |	sa krama akrama vimiśra bhāvataḥ tvad kramaḥ tritaya cāru vīkṣaṇaḥ 
MBcidgaganacandrika-HK-520	turyaraśmiguṇavikramaikabhūstvaṃ kramatriguṇabhīmakālyasi || 250 ||	turya raśmi guṇa vikrama eka bhūḥ tvam krama triguṇa bhīma kālī asi 
MBcidgaganacandrika-HK-521	yatra kāli daśa te karāḥ sthitā dve ca yāntyudayamapyamūryataḥ |	yatra kāli daśa te karāḥ sthitāḥ dve ca yānti udayam api a mūryataḥ 
MBcidgaganacandrika-HK-522	tannabhaḥ śrayasi sarvataḥ paraṃ tvaṃ prakāśaśivacandrikā satī || 251 ||	tat nabhaḥ śrayasi sarvatas param tvam prakāśa śiva candrikā satī 
MBcidgaganacandrika-HK-523	śāntamamba yadabhinnamambaraṃ yat prakāśaghanamapyapohyete |	śāntam amba yat abhinnam ambaram yat prakāśa ghanam api apohyete 
MBcidgaganacandrika-HK-524	yad dvayobhayapadātirocanād yatra muktanikaro nilīyase || 252 ||	yat dvaya ubhaya padāti rocanāt yatra mukta nikaraḥ nilīyase  /
MBcidgaganacandrika-HK-525	tvaṃ padatritayagarbhitodayaṃ nirvyapohamupaguhya śaṅkaram |	tvam pada tritaya garbhita udayam nirvyapoham upaguhya śaṅkaram 
MBcidgaganacandrika-HK-526	aikarasyalasadakṣayaprathaṃ nādamudvamasi sarvataḥ śive || 253 ||	aikarasya lasat akṣaya pratham nādam udvamasi sarvatas śive 
MBcidgaganacandrika-HK-527	ye vidanti tava rūpamīdṛśaṃ ye ca nityakṛtatallayodyamāḥ |	ye vidanti tava rūpam īdṛśam ye ca nitya kṛta tad laya udyamāḥ 
MBcidgaganacandrika-HK-528	eṣa tān prati bhavan sudhāmayo ye'nyathā viṣamayaśca tān prati || 254 ||	eṣa tān prati bhavan sudhā mayaḥ viṣa mayaḥ ca tān prati 
MBcidgaganacandrika-HK-529	yaḥ pramajjayati mūḍhacetasaṃ tārayatyapi sa eṣa dhīmataḥ |	yaḥ pramajjayati mūḍha cetasam tārayati api saḥ eṣa dhīmataḥ 
MBcidgaganacandrika-HK-530	yena tadbhavasudhāmbudhiḥ śive yajjuṣāṃ vahati nistaraṅgatām || 255 ||	yena tad bhava sudhā ambudhiḥ śive yat juṣām vahati nistaraṅga tām 
MBcidgaganacandrika-HK-531	arthapañcakasudhāprapūrite yadbhavāmṛtanidhau sukhaplave |	artha pañcaka sudhā prapūrite yad bhava amṛta nidhau sukha plave 
MBcidgaganacandrika-HK-532	padyatāṃ vahasi saṃvidindirā dhāmavastu tadume vapustava || 256 ||	padyatām vahasi saṃvid indirā dhāma vastu tat ume vapuḥ tava  /
MBcidgaganacandrika-HK-533	tatra padmarucivedyamaṇḍale svāduni prakaṭameyivān layam |	tatra padma ruci vedya maṇḍale svāduni prakaṭam eyivān layam 
MBcidgaganacandrika-HK-534	māyayā'mba puruṣo nimīlitaḥ tvaddhiyonmiṣati vidyayāvṛtaḥ || 257 ||	māyayā amba puruṣaḥ nimīlitaḥ tvad dhiyā unmiṣati vidyayā āvṛtaḥ  /
MBcidgaganacandrika-HK-535	tattadarthadalaśobhitaṃ jahannidramullasitamamba vārijam |	tad tad artha dala śobhitam jahannidram ullasitam amba vārijam 
MBcidgaganacandrika-HK-536	tvadvimarśamakarandanirbharaṃ pīṭhatāṃ vrajati yatra cinmayam || 258 ||	tvad vimarśa makaranda nirbharam pīṭha tām vrajati yatra cit mayam 
MBcidgaganacandrika-HK-537	tvaṃ malatrayavilāpinī śive pūrṇapīṭhamahamātmakaṃ śritā |	tvam mala traya vilāpinī śive pūrṇa pīṭham aham ātmakam śritā 
MBcidgaganacandrika-HK-538	śuddhabhānutanuradvayaprathānandasārarasavāhinī satām || 259 ||	śuddha bhānu tanuḥ advaya prathā ānanda sāra rasa vāhinī satām 
MBcidgaganacandrika-HK-539	satsudhābdhirasabhṛt kalāntarī garbhaṣoḍaśakalābjaviṣṭaram |	                     
MBcidgaganacandrika-HK-540	pretamujjhitagamāgamaṃ śive smerabhūḥ sarasijaṃ tvamāśritā || 260 ||	pretam ujjhita gama āgamam śive smera bhūḥ sarasijam tvam āśritā  
MBcidgaganacandrika-HK-541	niṣkalaṅkamanavekṣitakṣayaṃ yāminīdivasatūlajṛmbhaṇam |	niṣkalaṅkam anavekṣita kṣayam yāminī divasa tūla jṛmbhaṇam 
MBcidgaganacandrika-HK-542	svaprakāśavinimagnacijjaḍaṃ candravarṣma yadi caṇḍike samam || 261 ||	sva prakāśa vinimagna cit jaḍam candra varṣma yadi caṇḍike samam 
MBcidgaganacandrika-HK-543	ye tu kuṇḍalaśikhākulasthitāḥ ye bhavantyakulabinduśālinaḥ |	ye tu kuṇḍala śikhā kula sthitāḥ ye bhavanti akula bindu śālinaḥ 
MBcidgaganacandrika-HK-544	te vidanti nu tavāmba vaibhavaṃ pūrṇabhānamayaviśvaghasmaram || 262 ||	te vidanti nu tava amba vaibhavam pūrṇabhāna maya viśva ghasmaram 
MBcidgaganacandrika-HK-545	jyotiṣāmba ! śikhayāpahanyate puṃsi caitasikamuddhataṃ tamaḥ |	jyotiṣā amba śikhayā apahanyate puṃsi caitasikam uddhatam tamaḥ 
MBcidgaganacandrika-HK-546	yatpathaprathanalakṣmapuṅkhitaṃ tattvameva śivaśaktirapyasi || 263 ||	yat patha prathana lakṣma puṅkhitam tattvam eva śiva śaktiḥ api asi 
MBcidgaganacandrika-HK-547	nihnutoditaśatārkadīdhitiśchannacandraśatalakṣmacandrikam |	nihnuta udita śata arka dīdhitiḥ channa candra śata lakṣma candrikam 
MBcidgaganacandrika-HK-548	tvaṃ bibharṣi vapuramba bhātmakaṃ tatpraveśya kuru māmanāmayam || 264 ||	tvam bibharṣi vapuḥ amba bhā ātmakam tat praveśya kuru mām anāmayam 
MBcidgaganacandrika-HK-549	tvaṃ kulākhyaśaśibhānupāvake bhrājamānakaraṇātmanāyike |	tvam kula ākhya śaśi bhānu pāvake bhrājamāna karaṇa ātma nāyike 
MBcidgaganacandrika-HK-550	saṃsmṛtāsi municittamaṇḍape adya me kuru tavāṅghrisaṃśrayam || 265 ||	saṃsmṛtā asi muni citta maṇḍape adya me kuru tava aṅghri saṃśrayam 
MBcidgaganacandrika-HK-551	pañcavāhagata śaktilakṣaṇaistvanmukhairakhilamarthamaṇḍalam |	pañca vāha gata śakti lakṣaṇaiḥ tvad mukhaiḥ akhilam artha maṇḍalam 
MBcidgaganacandrika-HK-552	gṛhṇatī mayi niveśya caṇḍike yā karoṣi sahajaṃ tavādhvaram || 266 ||	gṛhṇatī mayi niveśya caṇḍike yā karoṣi sahajam tava adhvaram 
MBcidgaganacandrika-HK-553	tvatpadasmṛtividhūtakalmaṣaṃ sarvataḥ sphuritapūrṇabhāghanam |	tvad pada smṛti vidhūta kalmaṣam sarvatas sphurita pūrṇa bhā ghanam 
MBcidgaganacandrika-HK-554	siddhacakramiha modate śive pūrṇimāpyahaha me na tāpahā || 267 ||	siddha cakram iha modate śive pūrṇimā api ahaha me na tāpa hā   /
MBcidgaganacandrika-HK-555	bhūtabhāvibhavadarthagarbhitaṃ kālaghasmaramupāsyate vapuḥ |	bhūta bhāvi bhavat artha garbhitam kāla ghasmaram upāsyate vapuḥ 
MBcidgaganacandrika-HK-556	kālakarṣiṇi vahanti yoginaḥ kṛṣṇataḥ prabhṛti viśvarūpatām || 268 ||	kāla karṣiṇi vahanti yoginaḥ kṛṣṇataḥ prabhṛti viśva rūpa tām 
MBcidgaganacandrika-HK-557	sparśarūparasagandharūpajaṃ śabdacidvalasabhā vibhindatī |	sparśa rūpa rasa gandha rūpa jam śabda cit vala sabhā vibhindatī 
MBcidgaganacandrika-HK-558	vṛtti ca kramakṛtāḥ ṣaḍadhvano deśakālamayamūrticakragā || 269 ||	ca krama kṛtāḥ ṣaṣ adhvanaḥ deśa kāla maya mūrti cakra gā   /
MBcidgaganacandrika-HK-559	yatprakāśatamarañjakaṃ padaṃ tasya bhāva iha yaḥ sato'mbike |	yat prakāśatama rañjakam padam tasya bhāvaḥ iha yaḥ sa tombike 
MBcidgaganacandrika-HK-560	induvahniravilakṣaṇaṃ kulaṃ tvaṃ turīyapadagā'pyalakṣyasau || 270 ||	indu vahniḥ avilakṣaṇam kulam tvam turīya pada gāpya lakṣya asau 
MBcidgaganacandrika-HK-561	amba nandati samantataḥ śive lokanena ya udagravaibhavaḥ |	amba nandati samantataḥ śive lokanena yaḥ udagra vaibhavaḥ 
MBcidgaganacandrika-HK-562	prajñayā vahasi sārvabhaumayā yā ca netramayamarcitā tava || 271 ||	prajñayā vahasi sārvabhaumayā yā ca netra mayam arcitā tava  /
MBcidgaganacandrika-HK-563	prāptadivyanayanairvilakṣaṇairvīkṣya kāli ! mahimā'nuvarṇyate |	prāpta divya nayanaiḥ vilakṣaṇaiḥ vīkṣya kāli mahimā anuvarṇyate 
MBcidgaganacandrika-HK-564	kevalaṃ tadanuvarṇane'pyume tvanmude tadapi dāsajalpitam || 272 ||	kevalam tad anuvarṇane ipi ume tvad mude tat api dāsa jalpitam 
MBcidgaganacandrika-HK-565	na tvamamba puruṣaśca nāṅganā citsvarūpiṇi na ṣaṇḍhatāpi te |	na tvam amba puruṣaḥ ca nā aṅganā cit svarūpiṇi na ṣaṇḍha tā api te 
MBcidgaganacandrika-HK-566	nāpi bharturapi te trirūpatā tvāṃ vinā tadapi na sphuret trayam || 273 ||	nā api bhartuḥ api te tri rūpa tā tvām vinā tat api na sphuret trayam 
MBcidgaganacandrika-HK-567	īśvaro janani cintitapradaḥ ko'pyanādinighano mahāmanāḥ |	īśvaraḥ janani cintita pradaḥ kopya nādi nighanaḥ mahāmanāḥ 
MBcidgaganacandrika-HK-568	tvatprathā tvamasi viśvaghasmarī tvāṃ tataḥ ka iha bhettumarhati || 274 ||	tvad prathā tvam asi viśva ghasmarī tvām tatas kaḥ iha bhettum arhati  /
MBcidgaganacandrika-HK-569	raktaśuklatanuhaṃsabhedinī tvaṃ patiśca tava tatkṛtākṛtiḥ |	rakta śukla tanu haṃsa bhedinī tvam patiḥ ca tava tad kṛta ākṛtiḥ 
MBcidgaganacandrika-HK-570	bhānuśāṅkaravibhedatastava strī ca kāpyasi pumāniva svayam || 275 ||	bhānu śāṅkara vibhedataḥ tava strī ca kā api asi pumān iva svayam 
MBcidgaganacandrika-HK-571	rūpamamba tava bhāsvaraṃ puro varṇapañcakavibheditaṃ punaḥ |	rūpam amba tava bhāsvaram puras varṇa pañcaka vibheditam punar 
MBcidgaganacandrika-HK-572	tvadvimiśraṇamapi hyasusthitaṃ citrasaṃjñitamataścaturvidham || 276 ||	tvad vimiśraṇam api hi asusthitam citra saṃjñitam atas caturvidham 
MBcidgaganacandrika-HK-573	bhāsanāvaraṇaśaktyadhiṣṭhito jyotirañjanamatho dvidhā tava |	bhāsana āvaraṇa śakti adhiṣṭhitaḥ jyotiḥ añjanam atho dvidhā tava 
MBcidgaganacandrika-HK-574	vigrahābharaṇabinduśarvarīsaṃjña udbhavabhavaḥ sphuṭodayaḥ || 277 ||	             
MBcidgaganacandrika-HK-575	añjanena rucimiśraṇe same raktamullasati tāvakaṃ vaṣuḥ |	añjanena ruci miśraṇe same raktam ullasati tāvakam vaṣuḥ 
MBcidgaganacandrika-HK-576	śyāmanīlatanutā'ñjane'ghike pītaśuklatanutā ca te rucau || 278 ||	śyāma nīla tanu tā añjaneghike pīta śukla tanu tā ca te rucau 
MBcidgaganacandrika-HK-577	saumyatā tava sisṛkṣayā tanoḥ sā tathāpyatha rirakṣiṣā yadā |	saumya tā tava sisṛkṣayā tanoḥ sā tathā api atha rirakṣiṣā yadā 
MBcidgaganacandrika-HK-578	ghoratā punariyaṃ jihīrṣayā saṃsmṛte'mba tava dhāmni śāntatā || 279 ||	ghora tā punar iyam jihīrṣayā saṃsmṛtā imba tava dhāmni śānta tā 
MBcidgaganacandrika-HK-579	bhāsvare vapuṣi sarvage tava spaṣṭamaṇḍanivaho nimajjati |	bhāsvare vapuṣi sarvage tava spaṣṭa maṇḍa nivahaḥ nimajjati 
MBcidgaganacandrika-HK-580	kālavahnyadhikṛtau śive yathā tatsamullasati dīptipañjare || 280 ||	kāla vahni adhikṛtau śive yathā tat samullasati dīpti pañjare 
MBcidgaganacandrika-HK-581	tāvakaṃ trividharūpavarjitaṃ garbhitatrividharūpamambike |	tāvakam trividha rūpa varjitam garbhita trividha rūpam ambike 
MBcidgaganacandrika-HK-582	cinmayaṃ paramarūpalakṣaṇaṃ rūpamantaravabhāti tadbabahiḥ || 281 ||	cit mayam parama rūpa lakṣaṇam rūpam antar avabhāti 
MBcidgaganacandrika-HK-583	strīti nāma tava kāpi kalpanā strītirūpamapi tādṛśī ca dhīḥ |	strī iti nāma tava kā api kalpanā strī iti rūpam api tādṛśī ca dhīḥ 
MBcidgaganacandrika-HK-584	vastutastvamasi viśvavigrahā tatparā ca citireva śāṅkarī || 282 ||	vastutas tvam asi viśva vigrahā tad parā ca citiḥ eva śāṅkarī  
MBcidgaganacandrika-HK-585	tvaṃ caturthapadavartinī śive yaddvitīyamapi tatpadaṃ sthitā |	tvam caturtha pada vartinī śive yat dvitīyam api tat padam sthitā 
MBcidgaganacandrika-HK-586	yo'pi pañcamapadāśritaḥ śive yastṛtīyamapi tatpadaṃ sthitaḥ || 283 ||	yaḥ api pañcama pada āśritaḥ śive yaḥ tṛtīyam api tat padam sthitaḥ 
MBcidgaganacandrika-HK-587	yatpadaṃ prathametaduttare tatpare tadapi turyagāminī |	yat padam prathama etat uttare tat pare tat api turya gāminī 
MBcidgaganacandrika-HK-588	tvaṃ turīyatanurāhṛtatrikā pañcamaṃ viśasi pūritatrikam || 284 ||	tvam turīya tanuḥ āhṛta trikā pañcamam viśasi pūrita trikam 
MBcidgaganacandrika-HK-589	ambareśvari nirākṛtestava vyajyate nikhilamākṛtitvataḥ |	ambareśvari nirākṛteḥ tava vyajyate nikhilam ākṛti tvataḥ 
MBcidgaganacandrika-HK-590	sarvadā sphurasi yeyamadvayānandacitprasarapīṭhavartinī || 285 ||	sarvadā sphurasi yā iyam advaya ānanda cit prasara pīṭha vartinī 
MBcidgaganacandrika-HK-591	na śrutirna ca giro na cāgamāḥ khaṇḍavastu viniveśitāśayāḥ |	na śrutiḥ na ca giraḥ na ca āgamāḥ khaṇḍa vastu viniveśita āśayāḥ 
MBcidgaganacandrika-HK-592	tvāṃ nayanti parameśi te makhā yāgayogavidhayaśca nedṛśīm || 286 ||	tvām nayanti parameśi te makhāḥ yāga yoga vidhayaḥ ca na īdṛśīm 
MBcidgaganacandrika-HK-593	nityatādiguṇalakṣite pade jñānayogamukhakalpanāpi te |	nitya tā ādi guṇa lakṣite pade jñāna yoga mukha kalpanā api te 
MBcidgaganacandrika-HK-594	amba na tvadanubhūtidāyinī tvallayaikagurusaṃśrayaṃ vinā || 287 ||	amba na tvad anubhūti dāyinī tvad laya eka guru saṃśrayam vinā 
MBcidgaganacandrika-HK-595	vyomabhāvaviniviṣṭacetasaḥ prātibhaṃ jagadavekṣya ninditāḥ |	vyoma bhāva viniviṣṭa cetasaḥ prātibham jagat avekṣya ninditāḥ 
MBcidgaganacandrika-HK-596	te tvamāviśasi yānanārataṃ tvannayena guruṇāmba ! vīkṣitān || 288 ||	te tvam āviśasi yān anāratam tvad nayena guruṇā amba vīkṣitān   
MBcidgaganacandrika-HK-597	nityatā tvayi vibhutvapūrṇate dṛkkṛye svarasagocare ca ye |	nitya tā tvayi vibhu tva pūrṇa te dṛkkṛye sva rasa gocare ca ye 
MBcidgaganacandrika-HK-598	tāni tāni viyatīva śobhane rāgavedasakalāśca bhāntyatha || 289 ||	tāni tāni viyati iva śobhane rāga veda sakalāḥ ca bhānti atha 
MBcidgaganacandrika-HK-599	vyomavṛttighaṭitaikya ullasatyadvayo janani ! devatāgaṇaḥ |	vyoma vṛtti ghaṭita aikye ullasati advayaḥ janani devatā gaṇaḥ 
MBcidgaganacandrika-HK-600	tāvakodyamapade'pi sarvago drāgvilāpanapadaṃ vināpi te || 290 ||	tāvaka udyama pade api sarva gaḥ drāk vilāpana padam vinā api te 
MBcidgaganacandrika-HK-601	itthamamba tava vṛttipañcakasyodayo'dbhutavibhāgasaṃbhramaḥ |	ittham amba tava vṛtti pañcakasya udaya udbhuta vibhāga saṃbhramaḥ 
MBcidgaganacandrika-HK-602	sarvadā sphurati sarvataḥ paraṃ khaṇḍitetaranijasvarūpabhāk || 291 ||	sarvadā sphurati sarvatas param khaṇḍita itara nija sva rūpa bhāj 
MBcidgaganacandrika-HK-603	khaṇḍitetarasamastagarbhago yastripañcavisarāśrayo'kramaḥ |	khaṇḍita itara samasta garbha gaḥ yaḥ tri pañca visara āśraya ukramaḥ 
MBcidgaganacandrika-HK-604	devatākrama udetyanārataṃ tasya hi tvamasi devajanmabhūḥ || 292 ||	devatā kramaḥ udeti anāratam tasya hi tvam asi deva janma bhūḥ   
MBcidgaganacandrika-HK-605	divyavāhavibhavodarasthito raśmimaṇḍalasamudgamāspadam |	divya vāha vibhava udara sthitaḥ raśmi maṇḍala samudgama āspadam 
MBcidgaganacandrika-HK-606	avyayastava navārṇavigrahe saṃhṛtikrama udetyakalpitaḥ || 293 ||	avyayaḥ tava nava arṇa vigrahe saṃhṛti kramaḥ udeti a kalpitaḥ 
MBcidgaganacandrika-HK-607	lakṣyaśūnyasahajāśramodayārambhapūrṇanijakoṭyabhedinī |	                      
MBcidgaganacandrika-HK-608	raśmicakratanuraśmitojjhitā tvaṃ ca gauri ! varapuṇyavāsanā || 294 ||	raśmi cakra tanu raśmi tā ujjhitā tvam ca gauri vara puṇya vāsanā 
MBcidgaganacandrika-HK-609	adhvabhirdhvanivimiśraṇakramamabjabījamaniketanaṃ varam |	adhvabhiḥ dhvani vimiśraṇa kramam abja bījam aniketanam varam 
MBcidgaganacandrika-HK-610	kalpanaikyabahubhedamadvayaṃ mantrapīṭhamasi kālyanargalam || 295 ||	kalpanā aikya bahu bhedam advayam mantrapīṭham asi kālī anargalam 
MBcidgaganacandrika-HK-611	spandamamba paripūrṇamapyabhūḥ spandamu~jjhitapadaṃ nirāvṛti |	spandam amba paripūrṇam api abhūḥ spandam ujjhita padam nirāvṛti 
MBcidgaganacandrika-HK-612	vyomarūpamakhilakramāspadam pīṭhamāvadhikavidyayāmbayā || 296 ||	vyoma rūpam akhila krama āspadam pīṭham au adhika vidyayā ambayā 
MBcidgaganacandrika-HK-613	aṣṭayonidalapatrapūruṣaṃ tvantavṛttidalaśaktipeṭikā |	                 
MBcidgaganacandrika-HK-614	tvaṃ patiśca tava liṅgavigraho rudrasiddhamunivṛndavandite ! || 297 ||	tvam patiḥ ca tava liṅga vigrahaḥ rudra siddha muni vṛnda vandite 
MBcidgaganacandrika-HK-615	sṛṣṭitaḥ prabhṛti yaccatuṣṭayaṃ yatprakāśanibhamūrtivṛndajam |	sṛṣṭitaḥ prabhṛti yat catuṣṭayam yat prakāśa nibha mūrti vṛnda jam 
MBcidgaganacandrika-HK-616	yacca khaṇḍapadamamba ! pīṭhagaṃ dehi cakranavakaṃ nutaṃ tava || 298 ||	yat ca khaṇḍa padam amba pīṭha gam dehi cakra navakam nutam tava  /
MBcidgaganacandrika-HK-617	tvaṃ navārṇamanucakravigrahā svodarārpitasamastadevatā |	tvam nava arṇa manu cakra vigrahā sva udara arpita samasta devatā 
MBcidgaganacandrika-HK-618	devi saptadaśavarṇabheditā tvaṃ prakāśaśivacandragāminī || 299 ||	devi saptadaśa varṇa bheditā tvam prakāśa śiva candra gāminī 
MBcidgaganacandrika-HK-619	yaḥ śivātprabhṛtisomapaścimastvatkramaikarasiko gurukramaḥ |	yaḥ śivāt prabhṛti soma paścimaḥ tvad krama eka rasikaḥ guru kramaḥ 
MBcidgaganacandrika-HK-620	ānanāgramiha cakrabhānuto yattu edadubhayaṃ tvayā yayā || 300 ||	ānana agram iha cakra bhānutaḥ yat tu tvayā yayā 
MBcidgaganacandrika-HK-621	tattadarthapuruṣo dhṛtakramaḥ pratibhasphuritadivyavigrahaḥ |	tad tad artha puruṣaḥ dhṛta kramaḥ pratibha sphurita divya vigrahaḥ 
MBcidgaganacandrika-HK-622	akramastava varaṃ padaṃ śive yo'hamadvayavimarśalakṣaṇaḥ || 301 ||	akramaḥ tava varam padam śive yaḥ ham advaya vimarśa lakṣaṇaḥ 
MBcidgaganacandrika-HK-623	lakṣaṇaṃ tadanu sūkṣmamiṣyate jyotirātmakamavarṇamāsthitā |	lakṣaṇam tadanu sūkṣmam iṣyate jyotiḥ ātmakam avarṇam āsthitā 
MBcidgaganacandrika-HK-624	sthūlametadanuvarṇya lakṣyate bhāvyate śamayituṃ mano mayā || 302 ||	sthūlam etat anuvarṇya lakṣyate bhāvyate śamayitum manaḥ mayā  /
MBcidgaganacandrika-HK-625	tatra śāntavati pauruṣe male vyomavadgatamavedayā tvayā |	tatra śāntavati pauruṣe male vyoma vat gatam avedayā tvayā 
MBcidgaganacandrika-HK-626	siddhakāryakaraṇaṃ niraṅkuśaṃ cinmarīcivisareṇa maṅgale || 303 ||	siddha kārya karaṇam niraṅkuśam cit marīci visareṇa maṅgale 
MBcidgaganacandrika-HK-627	somaputramapanīya madgatastvatkramo'dya kimapi stuto mayā |	somaputram apanīya mad gataḥ tvad krama udya kim api stutaḥ mayā 
MBcidgaganacandrika-HK-628	grastabhīṣaṇabhavo'yamambike tvatpadāmbujavimarśatejasā || 304 ||	grasta bhīṣaṇa bhavā uyam ambike tvad pada ambuja vimarśa tejasā 
MBcidgaganacandrika-HK-629	muktameva na mayā mayocitaḥ prerito'smi tava tartinī tayā |	muktam eva na mayā mayā ucitaḥ preritaḥ asmi tava tartinī tayā 
MBcidgaganacandrika-HK-630	siddhanāthakṛtatvatkramastuteḥ kālidāsaracitāṃ ca pañcikām || 305 ||	siddha nātha kṛta tvad krama stuteḥ kālidāsa racitām ca pañcikām 
MBcidgaganacandrika-HK-631	yadviniścayapadaṃ ca te stavaṃ yo'mba veda kuru tanmukhaṃ jagat |	yad viniścaya padam ca te stavam yomba veda kuru tad mukham jagat 
MBcidgaganacandrika-HK-632	kālidāsapadavīṃ tavāśritaḥ tvatprasādakṛtavāgvijṛmbhaṇaḥ || 306 ||	kālidāsa padavīm tava āśritaḥ tvad prasāda kṛta vāc vijṛmbhaṇaḥ 
MBcidgaganacandrika-HK-633	tvadguṇān yadahamastu vai jagat tena mohamatiradya mucyatām |	tvad guṇān yat aham astu vai jagat tena moha matiḥ adya mucyatām 
MBcidgaganacandrika-HK-634	pūrṇapīṭhamavagamya maṅgale tvatprasādanakṛte mayā kṛtaḥ || 307 ||	pūrṇapīṭham avagamya maṅgale tvad prasādana kṛte mayā kṛtaḥ  /
MBcidgaganacandrika-HK-635	eṣa cidgaganacandrikāstavaḥ kinnu vāñchitamasūta māṃ prati |	eṣa cit gagana candrikā stavaḥ kin nu vāñchitam asūta mām prati 
MBcidgaganacandrika-HK-636	yaḥ paṭhejjapati devi ! te stutiṃ yo'rthamatra vivṛṇoti vetti yaḥ || 308 ||	yaḥ paṭhet japati devi te stutim yaḥ artham atra vivṛṇoti vetti yaḥ  
MBcidgaganacandrika-HK-637	yo'nugātyabhinayatyabhīpsitāṃ tacca tasya kuru siddhimiśvari |	yonugā ati abhinayati abhīpsitām tat ca tasya kuru siddhimiśvari 
MBcidgaganacandrika-HK-638	kālavarṣiṇi śataistribhiḥ stutiṃ tāvakīmiha navottaraiḥ kṛtām || 309 ||	kāla varṣiṇi śataiḥ tribhiḥ stutim tāvakīm iha nava uttaraiḥ kṛtām 
MBcidgaganacandrika-HK-639	traiṣṭubhairaharahaḥ parāmṛśan kālacakramatiyan prasīdati |	traiṣṭubhaiḥ ahar ahar parāmṛśan kālacakram atiyan prasīdati 
MBcidgaganacandrika-HK-640	kartumicchati śivaṃ śive nṛṇāṃ jñāyate tad vicārya yā tvayā || 310 ||	kartum icchati śivam śive nṛṇām jñāyate tat vicārya yā tvayā 
MBcidgaganacandrika-HK-641	kṣepadhīstavana (?) gauri tatkṛtā viśvarāśi (?jñi) kuru sarvamīpsitam |	kṣepa dhī stavana gauri tad kṛtā viśvarāśi jñi kuru sarvam īpsitam 
MBcidgaganacandrika-HK-642	kevalaṃ mama punastadīpsitaṃ sarvatastava madīkṣaṇaṃ śive ||	kevalam mama punar tat īpsitam sarvatas tava mad īkṣaṇam śive 
MBcidgaganacandrika-HK-643	yena khelanasarohaṇārṇavaḥ śaśvadāviśati yena māṃ śivaḥ || 311 ||	yena khelana sarohaṇa arṇavaḥ śaśvat āviśati yena mām śivaḥ 
MBcidgaganacandrika-HK-644	pūrṇapīṭhakṛtaṃ siddhestadbhāvastavamādarāt |	pūrṇapīṭha kṛtam siddheḥ tad bhāva stavam ādarāt 
MBcidgaganacandrika-HK-645	vā narārthaṃ mahāguhya śrīvatso vidadhe sa tu || 312 ||	vā nara artham mahā guhya śrīvatsaḥ vidadhe sa tu 
MBcidgaganacandrika-HK-646	iti śrīkālīdāsamahākaviviracitā cidgaganacandrikā sampūrṇā ||	iti śrī kālīdāsa mahā kavi viracitā cidgaganacandrikā sampūrṇā 
MBcidgaganacandrika-HK-647	kramaprakāśikāsaṃvalitā	           
MBcidgaganacandrika-HK-648	praśastipadyāni	praśastipadyāni 
MBcidgaganacandrika-HK-649	tantre sūrya ivaiva bodhakiraṇairajñānanāśe'graṇīr-	tantre sūryaḥ iva eva bodha kiraṇaiḥ ajñāna nāśegraṇīḥ 
MBcidgaganacandrika-HK-650	lokālokakalākadambavibhavairdedīpyamāno maṇiḥ	lokāloka kalā kadamba vibhavaiḥ dedīpyamānaḥ maṇiḥ 
MBcidgaganacandrika-HK-651	śaśvacchāntisudhāsamudralaharī dolāyate yad-hṛdi	śaśvat śānti sudhā samudra laharī dolāyate yat hṛdi 
MBcidgaganacandrika-HK-652	gopīnāthabudhaṃ namāmi vibudhaṃ sārasvataṃ tanmahaḥ || 1 ||	gopīnātha budham namāmi vibudham sārasvatam tat mahaḥ 
MBcidgaganacandrika-HK-653	mīmāṃsā sahasā sudheva dhavalā yebhyaḥ pradatte nidhiṃ	mīmāṃsā sahasā sudhā iva dhavalā yebhyaḥ pradatte nidhim 
MBcidgaganacandrika-HK-654	vedāntāmaratattvabodhavibhavo brahmeva bodhākaraḥ |	                   
MBcidgaganacandrika-HK-655	tarkāgādhapayodhilolalaharī līlāyate yaddhṛdi	tarka agādha payodhi lola laharī līlāyate yat hṛdi 
MBcidgaganacandrika-HK-656	śuklopāhvavibhūtibhavyabadarīnāthān sadā tān numaḥ || 2 ||	śukla upāhva vibhūti bhavya badarīnāthān sadā tān numaḥ  /
MBcidgaganacandrika-HK-657	vedāṅgāni vibhānti yatra vimale vidyāgurau mārgade	vedāṅgāni vibhānti yatra vimale vidyā gurau mārgade 
MBcidgaganacandrika-HK-658	manye śrīraghunāthaśarmavibudhe sāṅgāni ratnāmbudhau |	manye śrī raghunātha śarma vibudhe sa aṅgāni ratna ambudhau 
MBcidgaganacandrika-HK-659	stutyā kīrtilatā sudheva bhuvane yasyāmarā bhāsate	stutyā kīrti latā sudhā iva bhuvane yasya amarāḥ bhāsate 
MBcidgaganacandrika-HK-660	pūjyaṃ taṃ satataṃ smarāmi sukhadaṃ vidyākaraṃśaṅkaram || 3 ||	pūjyam tam satatam smarāmi sukha dam vidyā karam śaṅkaram 
MBcidgaganacandrika-HK-661	yoge tantrabhare vibhāgakamale bābhāti vijño varaḥ	yoge tantra bhare vibhāga kamale bābhāti vijñaḥ varaḥ 
MBcidgaganacandrika-HK-662	prakhyāto vrajavallabho'tra dhavale vidyānikete'dhunā |	prakhyātaḥ vraja vallabhaḥ utra dhavale vidyāniketa idhunā 
MBcidgaganacandrika-HK-663	yasyāsīmadayaiva heturaparo nābhāti me mānase	yasya āsīt ima dayā eva hetuḥ aparaḥ nā ābhāti me mānase 
MBcidgaganacandrika-HK-664	ṭīkākarmasahāyikā navanavā taṃ bhāvaye prerakam || 4 ||	ṭīkā karma sahāyikā nava navā tam bhāvaye prerakam 
MBcidgaganacandrika-HK-665	mānī śrīśivapūjano mama pitā mātā ramā mohadā	mānī śrī śiva pūjanaḥ mama pitā mātā ramā moha dā 
MBcidgaganacandrika-HK-666	yatpārśve prabalaṃ manobalakulaṃ samprāpya kṛtvā'dhunā |	yad pārśve prabalam manaḥ bala kulam samprāpya kṛtvā adhunā 
MBcidgaganacandrika-HK-667	ṭīkāṃ cidgagane navāṃ navabalāmarthaprakāśe parāṃ	ṭīkām cit gagane navām nava balām artha prakāśe parām 
MBcidgaganacandrika-HK-668	vaiduṣyāñcitacidbharāṃ matimatāṃ yāce dayāṃ bodhadām || 5 ||	vaiduṣya añcita cit bharām matimatām yāce dayām bodha dām 
MBcidgaganacandrika-HK-669	śrīrukmiṇīkamrakaraṃ sahāyaṃ	śrī rukmiṇī kamra karam sahāyam 
MBcidgaganacandrika-HK-670	samprāpya nirvighnamihāsmi loke |	samprāpya nirvighnam iha asmi loke 
MBcidgaganacandrika-HK-671	prakhyātasīvāna iti pradeśe	iti pradeśe 
MBcidgaganacandrika-HK-672	vāso madīyaḥ sarayāṃ-subhūmau || 6 ||	vāsaḥ madīyaḥ 
MBcidgaganacandrika-HK-673	tatrāgame śrīraghunāthamiśro	tatra āgame śrī raghunāthamiśraḥ 
MBcidgaganacandrika-HK-674	bhūriśramo yasya vibhāgatantre |	bhūri śramaḥ yasya vibhāga tantre 
MBcidgaganacandrika-HK-675	arthaprakāśāṃ vimalāṃ ca ṭīkāṃ	arthaprakāśām vimalām ca ṭīkām 
MBcidgaganacandrika-HK-676	kamrāṃ sa tene'rthaprakāśikākhyām || 7 ||	kamrām sa tena īrthaprakāśikā ākhyām 
MBcidgaganacandrika-HK-677	kā pañcamī yā'rthaprakāśikāyāḥ	kā pañcamī yā artha prakāśikāyāḥ 
MBcidgaganacandrika-HK-678	sāphalyasiddhāvupakārikaiva |	sāphalya siddhau upakārikā eva 
MBcidgaganacandrika-HK-679	nāgānanā saṃśayanāśakārī	          
MBcidgaganacandrika-HK-680	mohāpahantrī kṛtibhārahārī || 8 ||	        
MBcidgaganacandrika-HK-681	sadā lokāloko dalayati dalaṃ gāḍhatamasāṃ	sadā lokālokaḥ dalayati dalam gāḍha tamasām 
MBcidgaganacandrika-HK-682	bhṛśaṃ jvālālīlo darayati daraṃ vepathumatām |	bhṛśam jvālā līlaḥ darayati daram vepathumatām 
MBcidgaganacandrika-HK-683	maruddhīrā dhārā dahati vipulāmuṣmalaharīṃ	marut dhīrā dhārāḥ dahati vipulā amuṣma laharīm 
MBcidgaganacandrika-HK-684	tavaivaikā dṛṣṭiḥ sakalamiha mātaḥ śamayati ||	tava eva ekā dṛṣṭiḥ sakalam iha mātar śamayati 
MBcidgaganacandrika-HK-685	|| śubhaṃ kulakramaṃ kuryāt ||	śubham kula kramam kuryāt 
MBcidgaganacandrika-HK-686	MUKTABODHA INDOLOGICAL RESEARCH INSTITUTE©2011 Muktabodha Indological Research Institute  All Rights Reserved.E-texts may be viewed only online or downloaded for private study.E-texts may not, under any circumstances, be copied, republished,reproduced, distributed or sold, either in original or altered form, withoutthe express permission of Muktabodha Indological Research Institute in writing.Data-entered by the staff of Muktabodha under the direction of Mark S. G. Dyczkowski.	muktabodha indological research muktabodha indological research institute all rights reserved texts may be viewed only online or downloaded for private studye texts may not under any circumstances be copied republished reproduced distributed or sold either in original or altered form withoutthe express permission of muktabodha indological research institute in writing data entered by the staff of muktabodha under the direction of mark s g dyczkowski 
