segmentnr	original	analyzed
MBdarsanopanisatHK-0	Muktabodha E-text in UTF-8	muktabodha etext in utf
MBdarsanopanisatHK-1	###########################################################################MUKTABODHA INDOLOGICAL RESEARCH INSTITUTEwww.muktabodha.org©2011 Muktabodha Indological Research Institute  All Rights Reserved.E-texts may be viewed only online or downloaded for private study.E-texts may not, under any circumstances, be copied, republished,reproduced, distributed or sold, either in original or altered form, withoutthe express permission of Muktabodha Indological Research Institute in writing.Data-entered by the staff of Muktabodha under the direction of Mark S. G. Dyczkowski.Catalog number : M00296	muktabodha indological research muktabodha indological research institute all rights reserved texts may be viewed only online or downloaded for private studye texts may not under any circumstances be copied republished reproduced distributed or sold either in original or altered form withoutthe express permission of muktabodha indological research institute in writing data entered by the staff of muktabodha under the direction of mark s g dyczkowskicatalog number  /
MBdarsanopanisatHK-2	Uniform title: darśanopaniṣat	uniform title darśana upaniṣad 
MBdarsanopanisatHK-3	Main title: yoga upaniṣads with the commentary of śrī upaniṣad brahmayogin	main title yoga upaniṣads with the commentary of śrī upaniṣad brahmayogin 
MBdarsanopanisatHK-4	Secondary title: darśana upaniṣat	secondary title darśana upaniṣad 
MBdarsanopanisatHK-5	Commentator : brahmayogin	commentatoḥ brahmayogin 
MBdarsanopanisatHK-6	Alternate name : śrī upaniṣad brahmayogin	alternate name śrī upaniṣad brahmayogin 
MBdarsanopanisatHK-7	Editor : śāstrī mahādeva	e t itoḥ śāstrī mahādeva 
MBdarsanopanisatHK-8	Notes: Transcribed by the staff of Muktabodha under the supervision of Mark S. G. Dyczkowski.	notes transcribed by the staff muktabodha under the supervision of mark s g dyczkowski 
MBdarsanopanisatHK-9	Revision 0: January 6, 2014	revision january 
MBdarsanopanisatHK-10	Publisher : Adyar library and research centre	publisher adyar library and research centre 
MBdarsanopanisatHK-11	Publication year : 1920	publication year 
MBdarsanopanisatHK-12	Publication city : Madras	publication citi madras 
MBdarsanopanisatHK-13	Publication country : India	publication country india 
MBdarsanopanisatHK-14	darśanopaniṣat	darśana upaniṣad 
MBdarsanopanisatHK-15	āpyāyantu- iti śāntiḥ	āpyāyantu iti śāntiḥ 
MBdarsanopanisatHK-16	prathama khaṇḍaḥ	prathama khaṇḍaḥ 
MBdarsanopanisatHK-17	jīvanmuktisādhanam aṣṭāṅgayogaḥ	          
MBdarsanopanisatHK-18	dattātreyo mahāyogī bhagavān bhūtabhāvanaḥ |	dattātreyaḥ mahā yogī bhagavān bhūtabhāvanaḥ 
MBdarsanopanisatHK-19	caturbhujo mahāviṣṇuryogasāmrājyadīkṣitaḥ || 1 ||	          
MBdarsanopanisatHK-20	tasya śiṣyo munivaraḥ sāṃkṛtirnāma bhaktimān |	tasya śiṣyaḥ muni varaḥ sāṃkṛtiḥ nāma bhaktimān 
MBdarsanopanisatHK-21	papraccha gurumekānte prāñjalirvinayānvitaḥ || 2 ||	papraccha gurum ekānte prāñjaliḥ vinaya anvitaḥ 
MBdarsanopanisatHK-22	bhagavan brūuhi me yogaṃ sāṣṭāṅgaṃ saprapañcakam |	bhagavan brūuhi me yogam sa aṣṭāṅgam sa prapañcakam 
MBdarsanopanisatHK-23	yena vijñānamātreṇa jīvanmukto bhavāmyaham || 3 ||	yena vijñāna mātreṇa jīvanmuktaḥ bhavāmi aham 
MBdarsanopanisatHK-24	sāṃkṛte śṛṇu vakṣyāmi yogaṃ sāṣṭāṅgadarśanam |	sāṃkṛte śṛṇu vakṣyāmi yogam sa aṣṭāṅga darśanam 
MBdarsanopanisatHK-25	vivaraṇam	vivaraṇam 
MBdarsanopanisatHK-26	yamādyaṣṭāṅgayogeddhabrahmamātraprabodhataḥ |	                
MBdarsanopanisatHK-27	yogino yatpadaṃ yānti tatkaivalyapadaṃ bhaje ||	yoginaḥ yat padam yānti tat kaivalya padam bhaje 
MBdarsanopanisatHK-28	iha khalu samāvedapravibhakteyaṃ darśanopaniṣat	iha khalu samāveda pravibhaktā iyam darśana upaniṣad 
MBdarsanopanisatHK-29	nirviśeṣabrahmajñānasahakṛtayamādyaṣṭāṅgayogaprakaṭanavyagrā	                                              
MBdarsanopanisatHK-30	niṣpratiyogikabrahmamātraparyavasannā vijṛmbhate | asyāḥ svalpagranthato	niṣpratiyogika brahma mātra paryavasannā vijṛmbhate asyāḥ 
MBdarsanopanisatHK-31	vivaraṇamārabhyate |	vivaraṇam ārabhyate 
MBdarsanopanisatHK-32	sāṃkṛtidattātreyapraśnaprativacanarūpeyamākhyāyikā vidyāstutyarthā |	sāṃkṛti dattātreya praśna prativacana rūpā iyam ākhyāyikā vidyā stuti arthā 
MBdarsanopanisatHK-33	ākhyāyikāmavatārayati- dattātreya iti || 1-2 || kimiti ? bhagavan	ākhyāyikām avatārayati dattātreyaḥ iti     kim iti bhagavan 
MBdarsanopanisatHK-34	ityādi || 3 || sāṃkṛtinā evaṃ pṛṣṭo bhagavānāha- sāṃkṛta iti ||	ityādi sāṃkṛtinā evam pṛṣṭaḥ bhagavān āha sāṃkṛtaḥ iti 
MBdarsanopanisatHK-35	"p. 153) 				aṣṭāṅgoddeśaḥ"	         
MBdarsanopanisatHK-36	yamaśca niyamaścaiva tathaivāsanameva ca || 4 ||	yamaḥ ca niyamaḥ ca eva tathā eva āsanam eva ca 
MBdarsanopanisatHK-37	prāṇāyāmastathā brahman pratyāhārastataḥ param |	prāṇāyāmaḥ tathā brahman pratyāhāraḥ tatas param 
MBdarsanopanisatHK-38	dhāraṇā ca tathā dhyānaṃ samādhiścāṣṭamaṃ mune || 5 ||	dhāraṇā ca tathā dhyānam samādhiḥ ca aṣṭamam mune 
MBdarsanopanisatHK-39	aṣṭāṅgāni kānīyata āha- yamaśceti || 4-5 ||	aṣṭāṅgāni kāni iyatas āha yamaḥ ca iti 
MBdarsanopanisatHK-40	daśavidhayamaḥ	daśavidha yamaḥ 
MBdarsanopanisatHK-41	ahiṃsā satyamasteyaṃ brahmacaryaṃ dayārjavam |	ahiṃsā satyam asteyam brahmacaryam dayā ārjavam 
MBdarsanopanisatHK-42	kṣamā dhṛtirmitāhāraḥ śaucaṃ ceti yamā daśa || 6 ||	kṣamā dhṛtiḥ mita āhāraḥ śaucam ca iti yamāḥ daśa 
MBdarsanopanisatHK-43	daśadhā bhinnayamāvayavamāha- ahiṃseti || 6 ||	daśadhā bhinna yama avayavam āha ahiṃsā iti 
MBdarsanopanisatHK-44	ahiṃsā	ahiṃsā 
MBdarsanopanisatHK-45	vedoktena prakāreṇa vinā satyaṃ tapodhana |	veda uktena prakāreṇa vinā satyam tapodhana 
MBdarsanopanisatHK-46	kāyena manasā vācā hiṃsā hiṃsā na cānyathā || 7 ||	kāyena manasā vācā hiṃsā hiṃsā na ca anyathā 
MBdarsanopanisatHK-47	ātmā sarvagato'cchedyo na grāhya iti yā matiḥ |	ātmā sarva gata ucchedyaḥ na grāhyaḥ iti yā matiḥ 
MBdarsanopanisatHK-48	sā cāhiṃsā varā proktā mune vedāntavedibhiḥ || 8 ||	sā ca ahiṃsā varā proktā mune vedānta vedibhiḥ 
MBdarsanopanisatHK-49	upāyopeyabhedena ahiṃsādidaśayamalakṣaṇamāha- vedeti |	upāya upeya bhedena ahiṃsā ādi daśa yama lakṣaṇam āha veda iti 
MBdarsanopanisatHK-50	vedoktayajñīyapaścādihiṃsā ahiṃsaivetyarthaḥ  || 7 || yadvā-	veda ukta yajñīya paśca ādi hiṃsā ahiṃsā eva iti arthaḥ        yat vā 
MBdarsanopanisatHK-51	ātmetyādi || 8 ||	ātmā ityādi 
MBdarsanopanisatHK-52	satyam	satyam 
MBdarsanopanisatHK-53	cakṣurādīndriyairdṛṣṭaṃ śrutaṃ ghrātaṃ munīśvara |	cakṣuḥ ādi indriyaiḥ dṛṣṭam śrutam ghrātam muni īśvara 
MBdarsanopanisatHK-54	tasyaivoktirbhavet satyaṃ vipra tannānyathā bhavet || 9 ||	tasya eva uktiḥ bhavet satyam vipra tat na anyathā bhavet 
MBdarsanopanisatHK-55	p. 154) sarvaṃ satyaṃ varaṃ brahma na cānyāditi yā matiḥ |	sarvam satyam varam brahma na ca anyāt iti yā matiḥ 
MBdarsanopanisatHK-56	tacca satyaṃ varaṃ proktaṃ vedāntajñānapāragaiḥ || 10 ||	tat ca satyam varam proktam vedānta jñāna pāragaiḥ 
MBdarsanopanisatHK-57	upāyopeyasatyalakṣaṇaṃ tu- cakṣurityādi || 9-25 ||	upāya upeya satya lakṣaṇam tu cakṣuḥ ityādi 
MBdarsanopanisatHK-58	asteyam	asteyam 
MBdarsanopanisatHK-59	anyadīye tṛṇe ratne kāñcane mauktike'pi ca |	anyadīye tṛṇe ratne kāñcane mauktike api ca 
MBdarsanopanisatHK-60	manasā vinivṛttiryā tadasteyaṃ vidurbudhāḥ || 11 ||	manasā vinivṛttiḥ yā tat astā iyam viduḥ budhāḥ 
MBdarsanopanisatHK-61	ātmanyanātmabhāvena vyavahāravivarjitam |	ātmani anātma bhāvena vyavahāra vivarjitam 
MBdarsanopanisatHK-62	yattadasteyamityuktamātmavidbhirmahāmune || 12 ||	yat tat asteyam iti uktam ātma vidbhiḥ mahā mune 
MBdarsanopanisatHK-63	brahmacaryam	brahmacaryam 
MBdarsanopanisatHK-64	kāyena vācā manasā strīṇāṃ parivivarjanam |	kāyena vācā manasā strīṇām parivivarjanam 
MBdarsanopanisatHK-65	ṛtau bhāryāṃ tadā svasya brahmacaryaṃ taducyate || 13 ||	ṛtau bhāryām tadā svasya brahmacaryam tat ucyate 
MBdarsanopanisatHK-66	brahmabhāve manaścāraṃ brahmacaryaṃ paraṃtapa |	brahma bhāve manaḥ cāram brahmacaryam paraṃtapa 
MBdarsanopanisatHK-67	dayā	dayā 
MBdarsanopanisatHK-68	svātmavat sarvabhūteṣu kāyena manasā girā || 14 ||	sva ātma vat sarva bhūteṣu kāyena manasā girā 
MBdarsanopanisatHK-69	anujñā yā dayā saiva proktā vedāntavedibhiḥ |	anujñā yā dayā sā eva proktā vedānta vedibhiḥ 
MBdarsanopanisatHK-70	ārjavam	ārjavam 
MBdarsanopanisatHK-71	putre mitre kalatre ca ripau svātmani saṃtatam || 15 ||	putre mitre kalatre ca ripau sva ātmani saṃtatam 
MBdarsanopanisatHK-72	ekarūpaṃ mune yattadārjavaṃ procyate mayā |	eka rūpam mune yat tat ārjavam procyate mayā 
MBdarsanopanisatHK-73	"p. 155) 				kṣamā"	kṣamā 
MBdarsanopanisatHK-74	kāyena manasā vācā śatrubhiḥ paripīḍite || 16 ||	kāyena manasā vācā śatrubhiḥ paripīḍite 
MBdarsanopanisatHK-75	buddhikṣobhanivṛttiryā kṣamā sā munipuṃgava |	buddhi kṣobha nivṛttiḥ yā kṣamā sā muni puṃgava 
MBdarsanopanisatHK-76	dhṛtiḥ	dhṛtiḥ 
MBdarsanopanisatHK-77	vedāveda vinirmokṣaḥ saṃsārasya na cānyathā || 17 ||	veda aveda vinirmokṣaḥ saṃsārasya na ca anyathā 
MBdarsanopanisatHK-78	iti vijñānaniṣpattirdhṛtiḥ proktā hi vaidikaiḥ |	iti vijñāna niṣpattiḥ dhṛtiḥ proktā hi vaidikaiḥ 
MBdarsanopanisatHK-79	ahamātmā na cānyo'smītyevamapracyutā matiḥ || 18 ||	aham ātmā na ca anyaḥ asmi iti evam apracyutā matiḥ 
MBdarsanopanisatHK-80	mitāhāraḥ	mita āhāraḥ 
MBdarsanopanisatHK-81	alpamṛṣṭāśanābhyāṃ ca caturthāṃśāvaśeṣakam |	alpa mṛṣṭa aśanābhyām ca caturtha aṃśa avaśeṣakam 
MBdarsanopanisatHK-82	tasmādyogānuguṇyena bhojanaṃ mitabhojanam || 19 ||	tasmāt yoga ānuguṇyena bhojanam mita bhojanam 
MBdarsanopanisatHK-83	śaucam	śaucam 
MBdarsanopanisatHK-84	svadehamalanirmokṣo mṛjjalābhyāṃ mahāmune |	sva deha mala nirmokṣaḥ mṛd jalābhyām mahā mune 
MBdarsanopanisatHK-85	yattacchaucaṃ bhavedbāhyaṃ mānasaṃ mananaṃ viduḥ || 20 ||	yat tat śaucam bhavet bāhyam mānasam mananam viduḥ  /
MBdarsanopanisatHK-86	ahaṃ śuddha iti jñānaṃ śaucamāhurmanīṣiṇaḥ |	aham śuddhaḥ iti jñānam śaucam āhuḥ manīṣiṇaḥ 
MBdarsanopanisatHK-87	atyantamalino deho dehī cātyantanirmalaḥ || 21 ||	atyanta malinaḥ dehaḥ dehī ca atyanta nirmalaḥ 
MBdarsanopanisatHK-88	ubhayorantaraṃ jñātvā kasya śaucaṃ vidhīyate |	ubhayoḥ antaram jñātvā kasya śaucam vidhīyate 
MBdarsanopanisatHK-89	jñānaśaucaṃ parityajya bāhye yo ramate naraḥ || 22 ||	jñāna śaucam parityajya bāhye yaḥ ramate naraḥ 
MBdarsanopanisatHK-90	sa mūḍhaḥ kāñcanaṃ tyaktvā loṣṭaṃ gṛhṇāti suvrata |	sa mūḍhaḥ kāñcanam tyaktvā loṣṭam gṛhṇāti suvrata 
MBdarsanopanisatHK-91	"p. 156) 				brahmātmavedanavidhiḥ"	          
MBdarsanopanisatHK-92	jñānamṛtena tṛptasya kṛtakṛtyasya yoginaḥ || 23 ||	jñāna mṛtena tṛptasya kṛtakṛtyasya yoginaḥ 
MBdarsanopanisatHK-93	na cāsti kiṃcit kartavyamasti cenna sa tattvavit |	na ca asti kiṃcid kartavyam asti ced na sa tattva vid 
MBdarsanopanisatHK-94	lokatraye'pi kartavyaṃ kiṃcinnāstyātmavedinām || 24 ||	lokatraye api kartavyam kiṃcid na asti ātma vedinām 
MBdarsanopanisatHK-95	tasmāt sarvaprayatnena mune'hiṃsādisādhanaiḥ |	tasmāt sarva prayatnena mune hiṃsā ādi sādhanaiḥ 
MBdarsanopanisatHK-96	ātmānamakṣaraṃ brahma viddhi jñānāttu vedanāt || 25 ||	ātmānam akṣaram brahma viddhi jñānāt tu vedanāt 
MBdarsanopanisatHK-97	iti prathamaḥ khaṇḍaḥ	iti prathamaḥ khaṇḍaḥ 
MBdarsanopanisatHK-98	dvitīyaḥ khaṇḍaḥ	dvitīyaḥ khaṇḍaḥ 
MBdarsanopanisatHK-99	daśavidhaniyamaḥ	daśavidha niyamaḥ 
MBdarsanopanisatHK-100	tapaḥ saṃtoṣamāstikyaṃ dānamīśvarapūjanam |	tapaḥ saṃtoṣam āstikyam dānam īśvara pūjanam 
MBdarsanopanisatHK-101	siddhāntaśravaṇaṃ caiva hrīrmatiśca japo vratam || 1 ||	siddhānta śravaṇam ca eva hrīḥ matiḥ ca japaḥ vratam 
MBdarsanopanisatHK-102	ete ca niyamāḥ proktāstān vakṣyāmi kramāchṛṇu |	ete ca niyamāḥ proktāḥ tān vakṣyāmi 
MBdarsanopanisatHK-103	daśadhā bhinnaniyamāvayavānāha- tapa iti || 1 ||	daśadhā bhinna niyama avayavān āha tapaḥ iti 
MBdarsanopanisatHK-104	tapaḥ	tapaḥ 
MBdarsanopanisatHK-105	vedoktena prakāreṇa kṛcchracāndrāyaṇādibhiḥ || 2 ||	veda uktena prakāreṇa kṛcchra cāndrāyaṇa ādibhiḥ 
MBdarsanopanisatHK-106	śarīraśoṣaṇaṃ yattattapa ityucyate budhaiḥ |	śarīra śoṣaṇam yat tat tapaḥ iti ucyate budhaiḥ 
MBdarsanopanisatHK-107	ko vā mokṣaḥ kathaṃ kena saṃsāraṃ pratipannavān || 3 ||	kaḥ vā mokṣaḥ katham kena saṃsāram pratipannavān 
MBdarsanopanisatHK-108	ityālocanamarthajñāstapaḥ śaṃsanti paṇḍitāḥ |	iti ālocanam artha jñāḥ tapaḥ śaṃsanti paṇḍitāḥ 
MBdarsanopanisatHK-109	upāyopeyabhedena tapa ādiniyamalakṣaṇamāha- vedeti || 2-10	upāya upeya bhedena tapaḥ ādi niyama lakṣaṇam āha veda iti 
MBdarsanopanisatHK-110	"p. 157) 				saṃtoṣaḥ"	saṃtoṣaḥ 
MBdarsanopanisatHK-111	yadṛcchālābhato nityaṃ prītiryā jāyate nṛṇām || 4 ||	yadṛcchā lābhataḥ nityam prītiḥ yā jāyate nṛṇām 
MBdarsanopanisatHK-112	tat saṃtoṣaṃ viduḥ prājñāḥ parijñānaikatatparāḥ |	tat saṃtoṣam viduḥ prājñāḥ parijñāna eka tatparāḥ 
MBdarsanopanisatHK-113	brahmāvalokaparyantādviraktyā yallabhet priyam || 5 ||	brahmāvaloka paryantāt viraktyā yat labhet priyam 
MBdarsanopanisatHK-114	sarvatra vigatasnehaḥ saṃtoṣaṃ paramaṃ viduḥ |	sarvatra vigata snehaḥ saṃtoṣam paramam viduḥ 
MBdarsanopanisatHK-115	āstikyam	āstikyam 
MBdarsanopanisatHK-116	śraute smārte ca viśvāso yattadāstikyamucyate || 6 ||	śraute smārte ca viśvāsaḥ yat tat āstikyam ucyate 
MBdarsanopanisatHK-117	dānam	dānam 
MBdarsanopanisatHK-118	nyāyārjitadhanaṃ śrānte śraddhayā vaidike jane |	nyāya arjita dhanam śrānte śraddhayā vaidike jane 
MBdarsanopanisatHK-119	anyadvā yat pradīyante taddānaṃ procyate mayā || 7 ||	anyat vā yat pradīyante tat dānam procyate mayā 
MBdarsanopanisatHK-120	īśvarapūjanam	īśvara pūjanam 
MBdarsanopanisatHK-121	rāgādyapetaṃ hṛdayaṃ vāgaduṣṭānṛtādinā |	rāga ādi apetam hṛdayam vāc aduṣṭa anṛta ādinā 
MBdarsanopanisatHK-122	hiṃsādirahitaṃ karma yattadīśvarapūjanam || 8 ||	hiṃsā ādi rahitam karma yat tat īśvara pūjanam 
MBdarsanopanisatHK-123	siddhāntaśravaṇam	siddhānta śravaṇam 
MBdarsanopanisatHK-124	satyaṃ jñānamanantaṃ ca parānandaṃ paraṃ dhruvam |	satyam jñānam anantam ca parānandam param dhruvam 
MBdarsanopanisatHK-125	pratyagityavagantavyaṃ vedāntaśravaṇaṃ budhaḥ || 9 ||	pratyak iti avagantavyam vedānta śravaṇam budhaḥ 
MBdarsanopanisatHK-126	"p. 158) 				hrīḥ"	hrīḥ 
MBdarsanopanisatHK-127	vedalaukikamārgeṣu kutsitaṃ karma yadbhavet |	veda laukika mārgeṣu kutsitam karma yat bhavet 
MBdarsanopanisatHK-128	tasmin bhavati yā lajjā hrīḥ saiveti prakīrtitā || 10 ||	tasmin bhavati yā lajjā hrīḥ sā eva iti prakīrtitā 
MBdarsanopanisatHK-129	matiḥ	matiḥ 
MBdarsanopanisatHK-130	vaidikeṣu ca sarveṣu śraddhā yā sā matirbhavet |	vaidikeṣu ca sarveṣu śraddhā yā sā matiḥ bhavet 
MBdarsanopanisatHK-131	guruṇā copadiṣṭo'pi tatra saṃbandhavarjitaḥ || 11 ||	guruṇā ca upadiṣṭaḥ api tatra saṃbandha varjitaḥ 
MBdarsanopanisatHK-132	vedaviruddhamārgaḥ guruṇā upadiṣṭo'pi tatra sambandhavarjitaḥ san	veda viruddha mārgaḥ guruṇā upadiṣṭaḥ api tatra sambandha varjitaḥ san 
MBdarsanopanisatHK-133	vedoktānuṣṭhānameva kuryādityarthaḥ || 11- 16 ||	veda ukta anuṣṭhānam eva kuryāt iti arthaḥ   
MBdarsanopanisatHK-134	japaḥ	japaḥ 
MBdarsanopanisatHK-135	vedoktenaiva mārgeṇa mantrābhyāso japaḥ smṛtaḥ |	veda uktena eva mārgeṇa mantra abhyāsaḥ japaḥ smṛtaḥ 
MBdarsanopanisatHK-136	kalpasūtre yathā vede dharmaśāstre purāṇake || 12 ||	kalpasūtre yathā vede dharma śāstre purāṇake  
MBdarsanopanisatHK-137	itihāse ca vṛttiryā sa japaḥ procyate mayā |	itihāse ca vṛttiḥ yā sa japaḥ procyate mayā 
MBdarsanopanisatHK-138	japastu dvividhaḥ prokto vāciko mānasastathā || 13 ||	japaḥ tu dvividhaḥ proktaḥ vācikaḥ mānasaḥ tathā 
MBdarsanopanisatHK-139	vācikopāṃśuruccaiśca dvividhaḥ parikīrtitaḥ |	vācika upāṃśuḥ uccais ca dvividhaḥ parikīrtitaḥ 
MBdarsanopanisatHK-140	mānaso mananadhyānabhedāt dvaividhyamāśritaḥ || 14 ||	mānasaḥ manana dhyāna bhedāt dvaividhyam āśritaḥ 
MBdarsanopanisatHK-141	uccairjapādupāṃśuśca sahasraguṇamucyate |	uccais japāt upāṃśuḥ ca sahasraguṇam ucyate 
MBdarsanopanisatHK-142	mānasaśca tathopāṃśoḥ sahasraguṇamucyate || 15 ||	mānasaḥ ca tathā upāṃśoḥ sahasraguṇam ucyate  /
MBdarsanopanisatHK-143	p. 159) uccairjapaśca sarveṣāṃ yathoktaphalado bhavet |	uccais japaḥ ca sarveṣām yathā ukta phala daḥ bhavet 
MBdarsanopanisatHK-144	nīcaiḥ śrotreṇa cenmantraḥ śrutaścenniṣphalaṃ bhavet || 16 ||	nīcais śrotreṇa ced mantraḥ śrutaḥ ced niṣphalam bhavet 
MBdarsanopanisatHK-145	iti dvitīyaḥ khaṇḍaḥ	iti dvitīyaḥ khaṇḍaḥ 
MBdarsanopanisatHK-146	tṛtīyaḥ khaṇḍaḥ	tṛtīyaḥ khaṇḍaḥ 
MBdarsanopanisatHK-147	āsanāni nava	āsanāni nava 
MBdarsanopanisatHK-148	svastikaṃ gomukhaṃ padmaṃ vīrasiṃhāsane tathā |	svastikam gomukham padmam vīra siṃhāsane tathā 
MBdarsanopanisatHK-149	bhadraṃ muktāsanaṃ caiva mayūrāsanameva ca || 1 ||	bhadram muktāsanam ca eva mayūrāsanam eva ca 
MBdarsanopanisatHK-150	sukhāsanasamākhyaṃ ca navamaṃ munipuṃgava |	sukhāsana sama ākhyam ca navamam muni puṃgava 
MBdarsanopanisatHK-151	yamaniyamalakṣaṇamuktvā āsanalakṣaṇamāha- svastikamiti ||	yama niyama lakṣaṇam uktvā āsana lakṣaṇam āha svastikam iti 
MBdarsanopanisatHK-152	svastikam	svastikam 
MBdarsanopanisatHK-153	jānūrvorantare kṛtvā samyak pādatale ubhe || 2 ||	jānu ūrvoḥ antare kṛtvā samyak pāda tale ubhe 
MBdarsanopanisatHK-154	samagrīvaśiraḥkāyaḥ svastikaṃ nityamabhyaset |	sama grīva śiraḥ kāyaḥ svastikam nityam abhyaset 
MBdarsanopanisatHK-155	gomukham	gomukham 
MBdarsanopanisatHK-156	savye dakṣiṇagulphaṃ tu pṛṣṭhapārśve niyojayet || 3 ||	savye dakṣiṇa gulpham tu pṛṣṭha pārśve niyojayet  /
MBdarsanopanisatHK-157	dakṣiṇe'pi tathā savyaṃ gomukhaṃ tat pracakṣate |	dakṣiṇe api tathā savyam gomukham tat pracakṣate 
MBdarsanopanisatHK-158	padmam	padmam 
MBdarsanopanisatHK-159	aṅguṣṭhāvadhi gṛhṇīyāddhastābhyāṃ vyutkrameṇa tu || 4 ||	aṅguṣṭha avadhi gṛhṇīyāt hastābhyām vyutkrameṇa tu 
MBdarsanopanisatHK-160	ūrvorupari viprendra kṛtvā pādataladvayam |	ūrvoḥ upari vipra indra kṛtvā pāda tala dvayam 
MBdarsanopanisatHK-161	padmāsanaṃ bhavet prāña sarvarogabhayāpaham || 5 ||	padmāsanam bhavet sarva roga bhaya apaham 
MBdarsanopanisatHK-162	"p. 160) 			vīrāsanam"	vīrāsanam 
MBdarsanopanisatHK-163	gulphau ca vṛṣaṇasyādhaḥ sīvinyāḥ pārśvayoḥ kṣipet |	gulphau ca vṛṣaṇasya adhas sīvinyāḥ pārśvayoḥ kṣipet 
MBdarsanopanisatHK-164	dakṣiṇaṃ savyagulphena dakṣiṇena tathetarat || 6-1 ||	dakṣiṇam savya gulphena dakṣiṇena tathā itarat 
MBdarsanopanisatHK-165	hastau jānau samāsthāpya svāṅgulīṃśca prasārya ca |	hastau jānau samāsthāpya sva aṅgulīn ca prasārya ca 
MBdarsanopanisatHK-166	vyaktavaktro nirīkṣeta nāsāgraṃ susamāhitaḥ || 6-2 ||	vyakta vaktraḥ nirīkṣeta nāsā agram su samāhitaḥ 
MBdarsanopanisatHK-167	siṃhāsanaṃ bhavedetat pūjitaṃ yogibhiḥ sadā || 6-3 ||	siṃhāsanam bhavet etat pūjitam yogibhiḥ sadā 
MBdarsanopanisatHK-168	bhadrāsanam	bhadrāsanam 
MBdarsanopanisatHK-169	gulphau tu vṛṣaṇasyādhaḥ sīvinyāḥ pārśvayoḥ kṣipet |	gulphau tu vṛṣaṇasya adhas sīvinyāḥ pārśvayoḥ kṣipet 
MBdarsanopanisatHK-170	pārśvapādau ca pāṇibhyāṃ dṛḍhaṃ baddhvā suniścalam || 7 ||	pārśva pādau ca pāṇibhyām dṛḍham baddhvā su niścalam 
MBdarsanopanisatHK-171	bhadrāsanaṃ bhavedetadviṣarogavināśanam |	bhadrāsanam bhavet etat viṣa roga vināśanam 
MBdarsanopanisatHK-172	muktāsanam	muktāsanam 
MBdarsanopanisatHK-173	nipīḍya sīvinīṃ sūkṣmāṃ dakṣiṇetaragulphataḥ || 8 ||	nipīḍya sīvinīm sūkṣmām dakṣiṇetara gulphataḥ 
MBdarsanopanisatHK-174	vāmaṃ yāmyena gulphena muktāsanamidaṃ bhavet |	vāmam yāmyena gulphena muktāsanam idam bhavet 
MBdarsanopanisatHK-175	meḍhrādupari nikṣipya savyaṃ gulphaṃ tatopari || 9 ||	meḍhrāt upari nikṣipya savyam gulpham tata upari 
MBdarsanopanisatHK-176	gulphāntaraṃ ca saṃkṣipya muktāsanamidaṃ mune |	gulpha antaram ca saṃkṣipya muktāsanam idam mune 
MBdarsanopanisatHK-177	"p. 161) 			mayūrāsanam"	mayūrāsanam 
MBdarsanopanisatHK-178	kūrparāgre muniśreṣṭha nikṣipennābhipārśvayoḥ || 10 ||	kūrpara agre muni śreṣṭha nikṣipet nābhi pārśvayoḥ 
MBdarsanopanisatHK-179	bhūmyāṃ pāṇitaladvandvaṃ nikṣipyaikāgramānasaḥ |	bhūmyām pāṇi tala dvandvam nikṣipya ekāgra mānasaḥ 
MBdarsanopanisatHK-180	samunnataśiraḥpādo daṇḍavadvyomni saṃsthitaḥ || 11 ||	samunnata śiraḥ pādaḥ daṇḍa vat vyomni saṃsthitaḥ 
MBdarsanopanisatHK-181	mayūrāsanametat syāt sarvapāpapraṇāsanam |	mayūrāsanam etat syāt sarva pāpa praṇāsanam 
MBdarsanopanisatHK-182	sukhāsanam	sukha āsanam 
MBdarsanopanisatHK-183	yena kena prakāreṇa sukhaṃ dhairyaṃ ca jāyate || 12 ||	yena kena prakāreṇa sukham dhairyam ca jāyate 
MBdarsanopanisatHK-184	tat sukhāsanamityuktamaśaktastat samāśrayet |	tat sukha āsanam iti uktam aśaktaḥ tat samāśrayet 
MBdarsanopanisatHK-185	āsanajayaphalam	āsana jaya phalam 
MBdarsanopanisatHK-186	āsanaṃ vijitaṃ yena jitaṃ tena jagattrayam || 13 ||	āsanam vijitam yena jitam tena jagattrayam 
MBdarsanopanisatHK-187	anena vidhinā yuktaḥ prāṇāyāmaṃ sadā kuru ||	anena vidhinā yuktaḥ prāṇāyāmam sadā kuru 
MBdarsanopanisatHK-188	iti tṛtīyaḥ khaṇḍaḥ	iti tṛtīyaḥ khaṇḍaḥ 
MBdarsanopanisatHK-189	caturthaḥ khaṇḍaḥ	caturthaḥ khaṇḍaḥ 
MBdarsanopanisatHK-190	dehapramāṇam	deha pramāṇam 
MBdarsanopanisatHK-191	śarīraṃ tāvadeva syāt ṣaṇṇavatyaṅgulātmakam |	śarīram tāvat eva syāt ṣaṇṇavati aṅgula ātmakam 
MBdarsanopanisatHK-192	dehamadhye śikhisthānaṃ taptajāmbūnadaprabham || 1 ||	deha madhye śikhi sthānam tapta jāmbūnada prabham 
MBdarsanopanisatHK-193	trikoṇaṃ manujānāṃ tu satyamuktaṃ hi sāṃkṛte |	trikoṇam manujānām tu satyam uktam hi sāṃkṛte 
MBdarsanopanisatHK-194	gudāttu dvyaṅgulādūrdhvaṃ meḍhrāttu dvyaṅgulādadhaḥ || 2 ||	gudāt tu dvi aṅgulāt ūrdhvam meḍhrāt tu dvi aṅgulāt adhas 
MBdarsanopanisatHK-195	p. 162) dehamadhyaṃ vijānīhi manujānāṃ tu sāṃkṛte |	deha madhyam vijānīhi manujānām tu sāṃkṛte 
MBdarsanopanisatHK-196	kandasthānaṃ muniśreṣṭha mūlādhārānnavāṅgulam || 3 ||	kanda sthānam muni śreṣṭha mūlādhārāt nava aṅgulam 
MBdarsanopanisatHK-197	caturaṅgulamāyāmavistāraṃ munipuṃgava |	catur aṅgulam āyāma vistāram muni puṃgava 
MBdarsanopanisatHK-198	kukkuṭāṇḍavadākāraṃ bhūṣitaṃ tu tvagādibhiḥ || 4 ||	kukkuṭa aṇḍa vat ākāram bhūṣitam tu tvac ādibhiḥ 
MBdarsanopanisatHK-199	tanmadhye nābhirityuktaṃ yogajñairmunipuṃgava |	tad madhye nābhiḥ iti uktam yoga jñaiḥ muni puṃgava 
MBdarsanopanisatHK-200	prāṇāyāmasya nāḍīpuñjadehaprāṇanirvartyatvena	                         
MBdarsanopanisatHK-201	dehatatkāryeyattāparijñānaṃ vinā prāṇāyāmasiddhiḥ na syāditi	                                           
MBdarsanopanisatHK-202	dehanāḍīprāṇeyattāṃ prapañcayati- śarīramiti | śikhisthānam	deha nāḍī prāṇa iyattām prapañcayati śarīram iti śikhi sthānam 
MBdarsanopanisatHK-203	agnisthānam || 1-10 ||	agni sthānam 
MBdarsanopanisatHK-204	nāḍīparigaṇanam	nāḍī parigaṇanam 
MBdarsanopanisatHK-205	kandamadhyasthitā nāḍī suṣumneti prakīrtitā || 5 ||	kanda madhya sthitā nāḍī suṣumnā iti prakīrtitā 
MBdarsanopanisatHK-206	tiṣṭhanti paritastasya nāḍayo munipuṃgava |	tiṣṭhanti paritas tasya nāḍayaḥ muni puṃgava 
MBdarsanopanisatHK-207	dvisaptatisahasrāṇi tāsāṃ mukhyāścaturdaśa || 6 ||	dvisaptati sahasrāṇi tāsām mukhyāḥ caturdaśa 
MBdarsanopanisatHK-208	suṣumnā piṅgalā tadvadiḍā caiva sarasvatī |	suṣumnā piṅgalā tadvat iḍā ca eva sarasvatī 
MBdarsanopanisatHK-209	pūṣā ca varuṇā caiva hastijihvā yaśasvinī || 7 ||	pūṣā ca varuṇā ca eva hastijihvā yaśasvinī 
MBdarsanopanisatHK-210	alambusā kuhūścaiva viśvodārā payasvinī |	alambusā kuhūḥ ca eva viśvodārā payasvinī 
MBdarsanopanisatHK-211	śaṅkhinī caiva gāndhārā iti mukhyāścaturdaśa || 8 ||	śaṅkhinī ca eva gāndhārā iti mukhyāḥ caturdaśa 
MBdarsanopanisatHK-212	āsāṃ mukhyatamāstisrastisṛṣvekottamottamā |	āsām mukhyatamāḥ tisraḥ tisṛṣu ekā uttama uttamā 
MBdarsanopanisatHK-213	brahmanāḍīti sā proktā mune vedāntavedibhiḥ || 9 ||	brahmanāḍī iti sā proktā mune vedānta vedibhiḥ 
MBdarsanopanisatHK-214	pṛṣṭhamadhyasthitenāsthnā viṇādaṇḍena suvrata |	pṛṣṭha madhya sthitena asthnā viṇā daṇḍena suvrata 
MBdarsanopanisatHK-215	saha mastakaparyantaṃ suṣumnā supratiṣṭhitā || 10 ||	saha mastaka paryantam suṣumnā su pratiṣṭhitā 
MBdarsanopanisatHK-216	"p. 163) 			kuṇḍalyāḥ sthānaṃ svarūpaṃ ca"	kuṇḍalyāḥ sthānam svarūpam ca 
MBdarsanopanisatHK-217	nābhikandādadhaḥ sthānaṃ kuṇḍalyā dvyaṅgulaṃ mune |	nābhi kandāt adhas sthānam kuṇḍalyāḥ dvi aṅgulam mune 
MBdarsanopanisatHK-218	aṣṭaprakṛtirūpā sa kuṇḍalī munisattamaḥ || 11 ||	aṣṭa prakṛti rūpā sa kuṇḍalī muni sattamaḥ 
MBdarsanopanisatHK-219	yathāvadvāyuceṣṭāṃ ca jalānnādīni nityaśaḥ |	yathāvat vāyu ceṣṭām ca jala anna ādīni nityaśas 
MBdarsanopanisatHK-220	paritaḥ kandapārśveṣu nirudhyaiva sadā sthitā || 12 ||	paritas kanda pārśveṣu nirudhya eva sadā sthitā 
MBdarsanopanisatHK-221	svamukhena sadāveṣṭya brahmarandhramukhaṃ mune |	sva mukhena sadā āveṣṭya brahmarandhra mukham mune 
MBdarsanopanisatHK-222	kuṇḍalinīsthānaṃ tatsvarūpaṃ cāha- nābhīti |	kuṇḍalinī sthānam tad svarūpam ca āha nābhi iti 
MBdarsanopanisatHK-223	pṛthivyaptejovāyvākāśamanobuddhyahaṃkārarūpiṇyaḥ aṣṭau	pṛthivī ap tejaḥ vāyu ākāśa manaḥ buddhi ahaṃkāra rūpiṇyaḥ aṣṭau 
MBdarsanopanisatHK-224	prakṛtayaḥ || 11- 12 ||	prakṛtayaḥ 
MBdarsanopanisatHK-225	nāḍīsthānāni	nāḍī sthānāni 
MBdarsanopanisatHK-226	suṣumnāyā iḍā savye dakṣiṇe piṅgalā sthitā || 13 ||	suṣumnāyāḥ iḍā savye dakṣiṇe piṅgalā sthitā  /
MBdarsanopanisatHK-227	sarasvatī kuhūścaiva suṣumnāpārśvayoḥ sthite |	sarasvatī kuhūḥ ca eva suṣumnā pārśvayoḥ sthite 
MBdarsanopanisatHK-228	gāndhārā hastijihvā ca iḍāyāḥ pṛṣṭhapūrvayoḥ || 14 ||	gāndhārā hastijihvā ca iḍāyāḥ pṛṣṭha pūrvayoḥ  /
MBdarsanopanisatHK-229	pūṣā yaśasvinī caiva piṅgalāpṛṣṭhapūrvayoḥ |	pūṣā yaśasvinī ca eva piṅgalā pṛṣṭha pūrvayoḥ 
MBdarsanopanisatHK-230	kuhośca hastijihvāyā madhye viśvodarā sthitā || 15 ||	kuhoḥ ca hasti jihvāyāḥ madhye viśva udarā sthitā 
MBdarsanopanisatHK-231	yaśasvinyāḥ kuhormadhye varuṇā supratiṣṭhitā |	yaśasvinyāḥ kuhoḥ madhye varuṇā su pratiṣṭhitā 
MBdarsanopanisatHK-232	pūṣāyāśca sarasvatyā madhye proktā yaśasvinī || 16 ||	pūṣāyāḥ ca sarasvatyāḥ madhye proktā yaśasvinī 
MBdarsanopanisatHK-233	gāndhārāyāḥ sarasvatyā madhye proktā ca śaṅkhinī |	gāndhārāyāḥ sarasvatyāḥ madhye proktā ca śaṅkhinī 
MBdarsanopanisatHK-234	alambusā sthitā pāyuparyantaṃ kandamadhyagā || 17 ||	alambusā sthitā pāyu paryantam kanda madhya gā 
MBdarsanopanisatHK-235	pūrvabhāge suṣumnāyā rākāyāḥ saṃsthitā kuhūḥ |	pūrva bhāge suṣumnāyāḥ rākāyāḥ saṃsthitā kuhūḥ 
MBdarsanopanisatHK-236	adhaścordhvaṃ sthitā nāḍī yāmyanāsāntamiṣyate || 18 ||	adhas ca ūrdhvam sthitā nāḍī yāmya nāsā antam iṣyate  /
MBdarsanopanisatHK-237	p. 164) iḍā tu savyanāsāntaṃ saṃsthitā munipuṃgava |	iḍā tu savya nāsā antam saṃsthitā muni puṃgava 
MBdarsanopanisatHK-238	yaśasvinī ca vāmasya pādāṅguṣṭhāntamiṣyate || 19 ||	yaśasvinī ca vāmasya pādāṅguṣṭha antam iṣyate  /
MBdarsanopanisatHK-239	pūṣā vāmākṣiparyantā piṅgalāyāstu pṛṣṭhataḥ |	pūṣā vāma akṣi paryantā piṅgalāyāḥ tu pṛṣṭhatas 
MBdarsanopanisatHK-240	payasvinī ca yāmyasya karṇāntaṃ procyate budhaiḥ || 20 ||	payasvinī ca yāmyasya karṇa antam procyate budhaiḥ 
MBdarsanopanisatHK-241	sarasvatī tathā cordhvaṃ gatā jihvā tathā mune |	sarasvatī tathā ca ūrdhvam gatā jihvā tathā mune 
MBdarsanopanisatHK-242	hastijihvā tathā savyapādāṅguṣṭhāntamiṣyate || 21 ||	hastijihvā tathā savya pāda aṅguṣṭha antam iṣyate  /
MBdarsanopanisatHK-243	śaṅkhinī nāma yā nāḍī savyakarṇāntamiṣyate |	śaṅkhinī nāma yā nāḍī savya karṇa antam iṣyate 
MBdarsanopanisatHK-244	gāndhārā savyanetrāntā proktā vedāntavedibhiḥ || 22 ||	gāndhārā savya netra antā proktā vedānta vedibhiḥ 
MBdarsanopanisatHK-245	viśvodarābhidhā nāḍī kandhamadhye vyavasthitā |	viśvodarā abhidhā nāḍī kandha madhye vyavasthitā 
MBdarsanopanisatHK-246	suṣumnānāḍīparitaḥ pradhānanāḍyaḥ tiṣṭhantītyāha-	suṣumnā nāḍī paritas pradhāna nāḍyaḥ tiṣṭhanti iti āha 
MBdarsanopanisatHK-247	suṣumnāyā iti || 13-22 ||	suṣumnāyāḥ iti 
MBdarsanopanisatHK-248	nāḍīṣu vāyusaṃcāraḥ	nāḍīṣu vāyu saṃcāraḥ 
MBdarsanopanisatHK-249	prāṇo'pānastathā vyānaḥ samānodāna eva ca || 23 ||	prāṇa upānaḥ tathā vyānaḥ samāna udānaḥ eva ca 
MBdarsanopanisatHK-250	nāgaḥ kūrmaśca kṛkaro devadatto dhanaṃjayaḥ |	nāgaḥ kūrmaḥ ca kṛkaraḥ devadattaḥ dhanaṃjayaḥ 
MBdarsanopanisatHK-251	ete nāḍīṣu sarvāsu caranti daśa vāyavaḥ || 24 ||	ete nāḍīṣu sarvāsu caranti daśa vāyavaḥ   
MBdarsanopanisatHK-252	teṣu prāṇādayaḥ pañca mukhyāḥ pañcasu suvrata |	teṣu prāṇa ādayaḥ pañca mukhyāḥ pañcasu suvrata 
MBdarsanopanisatHK-253	prāṇasaṃjñastathāpānaḥ pūjyaḥ prāṇastayormune || 25 ||	prāṇa saṃjñaḥ tathā apānaḥ pūjyaḥ prāṇaḥ tayoḥ mune 
MBdarsanopanisatHK-254	āsyanāsikayormadhye nābhimadhye tathā hṛdi |	āsya nāsikayoḥ madhye nābhi madhye tathā hṛdi 
MBdarsanopanisatHK-255	prāṇasaṃjño'nilo nityaṃ vartate munisattama || 26 ||	prāṇa saṃjñaḥ anilaḥ nityam vartate muni sattama 
MBdarsanopanisatHK-256	p. 165) apāno vartate nityaṃ gudamadhyorujānuṣu |	apānaḥ vartate nityam guda madhya ūru jānuṣu 
MBdarsanopanisatHK-257	udare sakale kaṭyāṃ nābhau jaṅghe ca suvrata || 27 ||	udare sakale kaṭyām nābhau jaṅghe ca suvrata 
MBdarsanopanisatHK-258	vyānaḥ śrotrākṣimadhye ca kakudbhyāṃ gulphayorapi |	vyānaḥ śrotra akṣi madhye ca kakudbhyām gulphayoḥ api 
MBdarsanopanisatHK-259	prāṇasthāne gale caiva vartate munipuṃgava || 28 ||	prāṇasthāne gale ca eva vartate muni puṃgava 
MBdarsanopanisatHK-260	udānasaṃjño vijñeyaḥ pādayorhastayorapi |	udāna saṃjñaḥ vijñeyaḥ pādayoḥ hastayoḥ api 
MBdarsanopanisatHK-261	samānaḥ sarvadeheṣu vyāpya tiṣṭhatyasaṃśayaḥ || 29 ||	samānaḥ sarva deheṣu vyāpya tiṣṭhati asaṃśayaḥ 
MBdarsanopanisatHK-262	nāgādivāyavaḥ pañca tvagasthyādiṣu saṃsthitāḥ |	nāga ādi vāyavaḥ pañca tvac asthi ādiṣu saṃsthitāḥ 
MBdarsanopanisatHK-263	evamuktāsu nāḍīṣu prāṇādayaścarantītyāha- prāṇa iti || 23##-	evam uktāsu nāḍīṣu prāṇa ādayaḥ caranti iti āha prāṇe iti 
MBdarsanopanisatHK-264	vāyuvyāpārāḥ	vāyu vyāpārāḥ 
MBdarsanopanisatHK-265	niḥśvāsocchvāsakāsāśca prāṇakarma hi sāṃkṛte || 30 ||	niḥśvāsa ucchvāsa kāsāḥ ca prāṇa karma hi sāṃkṛte 
MBdarsanopanisatHK-266	apānākhyasya vāyostu viṇmūtrādivisarjanam |	apāna ākhyasya vāyoḥ tu viṣ mūtra ādi visarjanam 
MBdarsanopanisatHK-267	samānaḥ sarvasāmīpyaṃ karoti munipuṃgava || 31 ||	samānaḥ sarva sāmīpyam karoti muni puṃgava 
MBdarsanopanisatHK-268	udāna ūrdhvagamanaṃ karotyeva na saṃśayaḥ |	udāne ūrdhvagamanam karoti eva na saṃśayaḥ 
MBdarsanopanisatHK-269	vyāno vivādakṛt prokto mune vedāntavedibhiḥ || 32 ||	vyānaḥ vivāda kṛt proktaḥ mune vedānta vedibhiḥ 
MBdarsanopanisatHK-270	udgārādiguṇaḥ prokto nāgākhyasya mahāmune |	udgāra ādi guṇaḥ proktaḥ nāga ākhyasya mahā mune 
MBdarsanopanisatHK-271	dhanaṃjayasya śobhādi karma proktaṃ hi sāṃkṛte || 33 ||	dhanaṃjayasya śobhā ādi karma proktam hi sāṃkṛte 
MBdarsanopanisatHK-272	nimīlanādi kūrmasya kṣudhā tu kṛkarasya ca |	nimīlana ādi kūrmasya kṣudhā tu kṛkarasya ca 
MBdarsanopanisatHK-273	devadattasya viprendra tandrīkarma prakīrtitam || 34 ||	devadattasya vipra indra tandrīkarma prakīrtitam 
MBdarsanopanisatHK-274	prāṇādidaśavāyuvyāpārānāha- niḥśvāseti || 30-34 ||	prāṇa ādi daśa vāyu vyāpārān āha niḥśvāsa iti 
MBdarsanopanisatHK-275	"p. 166) 			nāḍīdevatāḥ"	nāḍī devatāḥ 
MBdarsanopanisatHK-276	suṣumnāyāḥ śivo deva iḍayā devatā hariḥ |	suṣumnāyāḥ śivaḥ devaḥ iḍayā devatā hariḥ 
MBdarsanopanisatHK-277	piṅgalāyā viriccaḥ syāt sarasvatyā virāṇmune || 35 ||	piṅgalāyāḥ viriccaḥ syāt sarasvatyāḥ virāj mune 
MBdarsanopanisatHK-278	pūṣādhidevatā prokto varuṇā vāyudevatā |	pūṣā adhidevatā proktaḥ varuṇāḥ vāyu devatā 
MBdarsanopanisatHK-279	hastijihvābhidhāyāstu varuṇo devatā bhavet || 36 ||	hastijihva abhidhāyāḥ tu varuṇaḥ devatā bhavet 
MBdarsanopanisatHK-280	yaśasvinyā muniśreṣṭha bhagavān bhāskarastathā |	yaśasvinyāḥ muni śreṣṭha bhagavān bhāskaraḥ tathā 
MBdarsanopanisatHK-281	alambusāyā abātmā varuṇaḥ parikīrtitaḥ || 37 ||	alambusāyāḥ ap ātmā varuṇaḥ parikīrtitaḥ 
MBdarsanopanisatHK-282	kuho kṣuddevatā proktā gāndhārī candradevatā |	kuho kṣudh devatā proktā gāndhārī candra devatā 
MBdarsanopanisatHK-283	śaṅkhinyāścandramāstadvat payasvinyāḥ prajāpatiḥ || 38 ||	śaṅkhinyāḥ candramāḥ tadvat payasvinyāḥ prajāpatiḥ 
MBdarsanopanisatHK-284	viśvodarābhidhāyāstu bhagavān pāvakaḥ patiḥ |	viśvodara abhidhāyāḥ tu bhagavān pāvakaḥ patiḥ 
MBdarsanopanisatHK-285	suṣumnādicaturdaśanāḍīdevatābhedamāha- suṣumnāyā iti ||	suṣumnā ādi caturdaśa nāḍī devatā bhedam āha suṣumnāyāḥ iti 
MBdarsanopanisatHK-286	nāḍīṣu candrasūryasaṃcāraḥ	nāḍīṣu candra sūrya saṃcāraḥ 
MBdarsanopanisatHK-287	iḍāyāṃ candramā nityaṃ caratyeva mahāmune || 39 ||	iḍāyām candramāḥ nityam carati eva mahā mune 
MBdarsanopanisatHK-288	piṅgalāyāṃ ravistadvanmune vedavidāṃ vara |	piṅgalāyām raviḥ tadvat mune veda vidām vara 
MBdarsanopanisatHK-289	sadeḍāpiṅgalayoścandrasūryau carata ityāha- iḍāyāmiti || 39 ||	sadā iḍā piṅgalayoḥ candra sūryau carataḥ iti āha iḍāyām iti 
MBdarsanopanisatHK-290	nāḍīṣu saṃvatsarātmakaprāṇasūryasaṃcāraḥ	nāḍīṣu saṃvatsara ātmaka prāṇa sūrya saṃcāraḥ 
MBdarsanopanisatHK-291	piṅgalāyā iḍāyāṃ tu vāyoḥ saṃkramaṇaṃ tu yat || 40 ||	piṅgalāyāḥ iḍāyām tu vāyoḥ saṃkramaṇam tu yat 
MBdarsanopanisatHK-292	taduttarāyaṇaṃ proktaṃ mune vedāntavedibhiḥ |	tat uttarāyaṇam proktam mune vedānta vedibhiḥ 
MBdarsanopanisatHK-293	iḍāyāḥ piṅgalāyāṃ tu prāṇasaṃkramaṇaṃ mune || 41 ||	iḍāyāḥ piṅgalāyām tu prāṇa saṃkramaṇam mune 
MBdarsanopanisatHK-294	p. 167) dakṣiṇāyanamityuktaṃ piṅgalāyāmiti śrutiḥ |	dakṣiṇāyanam iti uktam piṅgalāyām iti śrutiḥ 
MBdarsanopanisatHK-295	iḍāpiṅgalayoḥ saṃdhiṃ yadā prāṇaḥ samāgataḥ || 42 ||	iḍā piṅgalayoḥ saṃdhim yadā prāṇaḥ samāgataḥ 
MBdarsanopanisatHK-296	amāvasyā tadā proktā dehe dehabhṛtāṃ vara |	amāvasyā tadā proktā dehe dehabhṛtām vara 
MBdarsanopanisatHK-297	mūlādhāraṃ yadā prāṇaḥ praviṣṭaḥ paṇḍitottama || 43 ||	mūlādhāram yadā prāṇaḥ praviṣṭaḥ paṇḍita uttama 
MBdarsanopanisatHK-298	tadādyaṃ viṣuvaṃ proktaṃ tāpasaistāpasottama |	tad ādyam viṣuvam proktam tāpasaiḥ tāpasa uttama 
MBdarsanopanisatHK-299	prāṇasaṃjño muniśreṣṭha mūrdhānaṃ prāviśadyadā || 44 ||	prāṇa saṃjñaḥ muni śreṣṭha mūrdhānam prāviśat yadā 
MBdarsanopanisatHK-300	tadantyaṃ viṣuvaṃ proktaṃ tāpasaistattvacintakaiḥ |	tad antyam viṣuvam proktam tāpasaiḥ tattva cintakaiḥ 
MBdarsanopanisatHK-301	niḥśvāsocchvāsanaṃ sarvaṃ māsānāṃ saṃkramo bhavet || 45 ||	niḥśvāsa ucchvāsanam sarvam māsānām saṃkramaḥ bhavet 
MBdarsanopanisatHK-302	iḍayā kuṇḍalīsthānaṃ yadā prāṇaḥ samāgataḥ |	iḍayā kuṇḍalī sthānam yadā prāṇaḥ samāgataḥ 
MBdarsanopanisatHK-303	somagrahaṇamityuktaṃ tadā tattvavidāṃ vara || 46 ||	soma grahaṇam iti uktam tadā tattva vidām vara 
MBdarsanopanisatHK-304	yadā piṅgalayā prāṇaḥ kuṇḍalīsthānamāgataḥ |	yadā piṅgalayā prāṇaḥ kuṇḍalī sthānam āgataḥ 
MBdarsanopanisatHK-305	tadā tadā bhavet sūryagrahaṇaṃ munipuṅgava || 47 ||	tadā tadā bhavet sūrya grahaṇam muni puṅgava 
MBdarsanopanisatHK-306	saṃvatsarātmakaprāṇasūryasya nāḍīrāśisaṃcārato	           
MBdarsanopanisatHK-307	dinapakṣamāsāyanādigrahaṇādiḥ bhavatītyāha- piṅgalāyā iti || 40##-	dina pakṣa māsa ayana ādi grahaṇa ādiḥ bhavati iti āha piṅgalāyāḥ iti 
MBdarsanopanisatHK-308	antastīrthaprāśastyam	antar tīrtha prāśastyam 
MBdarsanopanisatHK-309	śrīparvataṃ śiraḥsthāne kedāraṃ tu lalāṭake |	śrīparvatam śiraḥ sthāne kedāram tu lalāṭake 
MBdarsanopanisatHK-310	vārāṇasīṃ mahāprājña bhrūvorghrāṇasya madhyame || 48 ||	vārāṇasīm mahā prājña bhrūvoḥ ghrāṇasya madhyame  /
MBdarsanopanisatHK-311	kurukṣetraṃ kucasthāne prayāgaṃ hṛtsaroruhe |	kurukṣetram kuca sthāne prayāgam hṛd saroruhe 
MBdarsanopanisatHK-312	cidambaraṃ tu hṛnmadhye ādhāre kamalālayam || 49 ||	              
MBdarsanopanisatHK-313	p. 168) ātmatīrthaṃ samutsṛjya bahistīrthāni yo vrajet |	ātma tīrtham samutsṛjya bahis tīrthāni yaḥ vrajet 
MBdarsanopanisatHK-314	karasthaṃ sa mahāratnaṃ tyaktvā kācaṃ vimārgate || 50 ||	kara stham sa mahā ratnam tyaktvā kācam vimārgate 
MBdarsanopanisatHK-315	bhāvatīrthaṃ paraṃ tīrthaṃ pramāṇaṃ sarvakarmasu |	bhāvatīrtham param tīrtham pramāṇam sarva karmasu 
MBdarsanopanisatHK-316	anyathāliṅgyate kāntā anyathāliṅgyate sutā || 51 ||	anyathā āliṅgyate kāntā anyathā āliṅgyate sutā   
MBdarsanopanisatHK-317	tīrthāni toyapūrṇāni devān kāṣṭhādinirmitān |	tīrthāni toya pūrṇāni devān kāṣṭha ādi nirmitān 
MBdarsanopanisatHK-318	yogino na prapadyante svātmapratyayakāraṇāt || 52 ||	yoginaḥ na prapadyante sva ātma pratyaya kāraṇāt 
MBdarsanopanisatHK-319	bahistīrthāt paraṃ tīrthamantastīrthaṃ mahāmune |	bahis tīrthāt param tīrtham antar tīrtham mahā mune 
MBdarsanopanisatHK-320	ātmatīrthaṃ mahātīrthamanyattīrthaṃ nirarthakam || 53 ||	ātmatīrtham mahā tīrtham anyat tīrtham nirarthakam 
MBdarsanopanisatHK-321	cittamantargataṃ duṣṭaṃ tīrthasnānairna śudhyati |	cittam antargatam duṣṭam tīrtha snānaiḥ na śudhyati 
MBdarsanopanisatHK-322	śataśo'pi jalairdhautaṃ surābhāṇḍamivāśuci || 54 ||	śataśas upi jalaiḥ dhautam surā bhāṇḍam iva aśuci 
MBdarsanopanisatHK-323	viṣuvāyanakāleṣu grahaṇe cāntare sadā |	viṣuva ayana kāleṣu grahaṇe ca antare sadā 
MBdarsanopanisatHK-324	vāraṇasyādike sthāne snātvā śuddho bhavennaraḥ || 55 ||	vāraṇasya ādike sthāne snātvā śuddhaḥ bhavet naraḥ  /
MBdarsanopanisatHK-325	jñānayogaparāṇāṃ tu pādaprakṣālitaṃ jalam |	jñāna yoga parāṇām tu pāda prakṣālitam jalam 
MBdarsanopanisatHK-326	bhāvaśuddhyarthamajñānāṃ tattīrthaṃ munipuṅgava || 56 ||	bhāva śuddhi artham ajñānām tat tīrtham muni puṅgava 
MBdarsanopanisatHK-327	mastakādyādhārāntaṃ śrīśailādipuṇyasthalaṃ bhavatītyāha-	mastaka ādi ādhāra antam śrīśaila ādi puṇya sthalam bhavati iti āha 
MBdarsanopanisatHK-328	śrīparvatamiti || 48-49 || evaṃ bhāvanāmayamātmatīrthaṃ tadeva	śrīparvatam iti     evam bhāvanā mayam ātma tīrtham tat eva 
MBdarsanopanisatHK-329	mumukṣubhiḥ sevyam iti stauti- ātmatīrthamiti | kācaṃ- kācamaṇim	mumukṣubhiḥ sevyam iti stauti ātma tīrtham iti kācam kācamaṇim 
MBdarsanopanisatHK-330	|| 50 || dehādinirvartyasarvakarmasu tīrthabuddhiḥ garīyasītyarthaḥ | tatra	              tatra 
MBdarsanopanisatHK-331	dṛṣṭāntastu- anyatheti || 51 || ata evaṃ tīrthānīti || 52 || tadeva	dṛṣṭāntaḥ tu anyathā iti    atas evam tīrthāni iti    tat eva 
MBdarsanopanisatHK-332	ātmatīrtham || 53 || bāhyatīrthasnānena ko'pi na śudhyatīti	ātma tīrtham    bāhya tīrtha snānena kaḥ api na śudhyati iti 
MBdarsanopanisatHK-333	sadṛṣṭāntamāha- cittamiti || 54 || na tathā bhāvatīrthasnānenetyāha##-	sa dṛṣṭāntam āha cittam iti   na tathā bhāva tīrtha snānena iti āha 
MBdarsanopanisatHK-334	p. 169) bhrūmadhyādisthāneṣu svātmalakṣyānusaṃdhānataḥ	bhrū madhya ādi sthāneṣu sva ātma lakṣya anusaṃdhānāt 
MBdarsanopanisatHK-335	śuddhātmaiva bhavatītyarthaḥ || 55 ||	śuddha ātmā eva bhavati iti arthaḥ 
MBdarsanopanisatHK-336	evātmatīrthasnānānadhikāro[rī] tīrthapādacaraṇodakasparśataḥ	eva ātma tīrtha snāna anadhikāra ūrī tīrtha pāda caraṇa udaka sparśataḥ 
MBdarsanopanisatHK-337	śuddho bhavatītyāha- jñāneti || 56 ||	śuddhaḥ bhavati iti āha jñāna iti 
MBdarsanopanisatHK-338	ātmani śivadṛṣṭiḥ	ātmani śiva dṛṣṭiḥ 
MBdarsanopanisatHK-339	tīrthe dāne jape yajñe kāṣṭhe pāṣāṇake sadā |	tīrthe dāne jape yajñe kāṣṭhe pāṣāṇake sadā 
MBdarsanopanisatHK-340	śivaṃ paśyati mūḍhātmā śive dehe pratiṣṭhite || 57 ||	śivam paśyati mūḍha ātmā śive dehe pratiṣṭhite 
MBdarsanopanisatHK-341	antaḥsthaṃ māṃ parityajya bahiṣṭhaṃ yastu sevate |	antar stham mām parityajya bahiṣṭham yaḥ tu sevate 
MBdarsanopanisatHK-342	hastasthaṃ piṇḍamutsṛjya lihet kūrparamātmanaḥ || 58 ||	hasta stham piṇḍam utsṛjya lihet kūrparam ātmanaḥ 
MBdarsanopanisatHK-343	śivamātmani paśyanti pratimāsu na yoginaḥ |	śivam ātmani paśyanti pratimāsu na yoginaḥ 
MBdarsanopanisatHK-344	ajñānāṃ bhāvanārthāya pratimāḥ parikalpitāḥ || 59 ||	ajñānām bhāvanā arthāya pratimāḥ parikalpitāḥ 
MBdarsanopanisatHK-345	svājñāḥ svātiriktātmānaṃ draṣṭumicchanti, svajñāḥ	sva ajñāḥ sva atirikta ātmānam draṣṭum icchanti sva jñāḥ 
MBdarsanopanisatHK-346	svāmātmānaṃ paśyantītyāha- tīrtha iti || 57-58 || ata eva śivamiti |	svām ātmānam paśyanti iti āha tīrthe iti     atas eva śivam iti 
MBdarsanopanisatHK-347	ayogijanānukampayā pratimāpi vikalpitetyāha- ajñānāmiti || 59 ||	ayogi jana anukampayā pratimā api vikalpitā iti āha ajñānām iti 
MBdarsanopanisatHK-348	brahmadarśanena brahmabhāvaḥ	brahma darśanena brahma bhāvaḥ 
MBdarsanopanisatHK-349	apūrvamaparaṃ brahma svātmānaṃ satyamadvayam |	apūrvam aparam brahma sva ātmānam satyam advayam 
MBdarsanopanisatHK-350	prajñānaghanamānandaṃ yaḥ paśyati sa paśyati || 60 ||	prajñāna ghanam ānandam yaḥ paśyati sa paśyati 
MBdarsanopanisatHK-351	nāḍīpuñjaṃ sadāsāraṃ narabhāvaṃ mahāmune |	nāḍī puñjam sadā sāram nara bhāvam mahā mune 
MBdarsanopanisatHK-352	samutsṛjyātmanātmānamahamityavadhāraya || 61 ||	samutsṛjya ātmanā ātmānam aham iti avadhāraya 
MBdarsanopanisatHK-353	aśarīraṃ śarīreṣu mahāntaṃ vibhumīśvaram |	aśarīram śarīreṣu mahāntam vibhum īśvaram 
MBdarsanopanisatHK-354	ānandamakṣaraṃ sākṣānmatvā dhīro na śocati || 62 ||	ānandam akṣaram sākṣāt matvā dhīraḥ na śocati  /
MBdarsanopanisatHK-355	p. 170) vibhedajanake'jñāne naṣṭe jñānabalātmune |	vibheda janake jñāne naṣṭe jñāna balāt mune 
MBdarsanopanisatHK-356	ātmano brahmaṇo bhedamasantaṃ kiṃ kariṣyati || 63 ||	ātmanaḥ brahmaṇaḥ bhedam asantam kim kariṣyati 
MBdarsanopanisatHK-357	nirviśeṣaṃ brahma yaḥ paśyati sa tadeva bhavatītyāha-	nirviśeṣam brahma yaḥ paśyati sa tat eva bhavati iti āha 
MBdarsanopanisatHK-358	apūrvamiti | yasmāt pūrvaṃ kāraṇaṃ paraṃ kāryaṃ vā na vidyate tat	apūrvam iti yasmāt pūrvam kāraṇam param kāryam vā na vidyate tat 
MBdarsanopanisatHK-359	kāryakāraṇakalanāśūnyaṃ brahma svamātramiti yaḥ paśyati sa	kārya kāraṇa kalanā śūnyam brahma sva mātram iti yaḥ paśyati sa 
MBdarsanopanisatHK-360	tanmātramavaśiṣyata ityarthaḥ || 60 || yāvaccittaśuddhiḥ tāvat	tanmātram avaśiṣyate iti arthaḥ      yāvat citta śuddhiḥ tāvat 
MBdarsanopanisatHK-361	narabhāvanayā yogaṃ yuñjīta, tataḥ śuddhāvuditāyāṃ narabhāvaṃ	nara bhāvanayā yogam yuñjīta tatas śuddhau uditāyām nara bhāvam 
MBdarsanopanisatHK-362	vihāya brahmabhāvena vartasvetyāha- nāḍīti || 61 || yaḥ	vihāya brahma bhāvena vartasva iti āha nāḍī iti     yaḥ 
MBdarsanopanisatHK-363	ko'pyevamātmānaṃ jānāti sa kṛtakṛtyo bhavatītyāha- aśarīramiti ||	kaḥ api evam ātmānam jānāti sa kṛtakṛtyaḥ bhavati iti āha aśarīram iti 
MBdarsanopanisatHK-364	62 || svajñānajabhedadṛṣṭyapāye nirbhedaṃ brahma prasīdatītyāha-	                                  
MBdarsanopanisatHK-365	vibhedeti | vastutaḥ kālatraye'pyasaṃbhavabhedaḥ kiṃ kariṣyati ? svasya	vibheda iti vastutas kāla traye pi asaṃbhava bhedaḥ kim kariṣyati svasya 
MBdarsanopanisatHK-366	labdhātmakatvānnirbhedaṃ brahmāvaśiṣyate ityarthaḥ || 63 ||	labdha ātmaka tvāt nirbhedam brahma avaśiṣyate iti arthaḥ 
MBdarsanopanisatHK-367	iti caturthaḥkhaṇḍaḥ	iti caturthaḥ khaṇḍaḥ 
MBdarsanopanisatHK-368	pañcamaḥ khaṇḍaḥ	pañcamaḥ khaṇḍaḥ 
MBdarsanopanisatHK-369	nāḍīśodhanam	nāḍī śodhanam 
MBdarsanopanisatHK-370	samyakkathaya me brahman nāḍīśuddhiṃ samāsataḥ |	samyak kathaya me brahman nāḍī śuddhim samāsatas 
MBdarsanopanisatHK-371	yayā śuddhyā sadā dhyāyan jīvanmukto bhavāmyaham || 1 ||	yayā śuddhyā sadā dhyāyan jīvanmuktaḥ bhavāmi aham 
MBdarsanopanisatHK-372	sāṃkṛte śṛṇu vakṣyāmi nāḍīśuddhiṃ samāsataḥ |	sāṃkṛte śṛṇu vakṣyāmi nāḍī śuddhim samāsatas 
MBdarsanopanisatHK-373	vidhyuktakarmasaṃyuktaḥ kāmasaṃkalpavarjitaḥ || 2 ||	vidhi ukta karma saṃyuktaḥ kāma saṃkalpa varjitaḥ 
MBdarsanopanisatHK-374	yamādyaṣṭāṅgasaṃyuktaḥ śāntaḥ satyaparāyaṇaḥ |	yama ādi aṣṭa aṅga saṃyuktaḥ śāntaḥ satya parāyaṇaḥ 
MBdarsanopanisatHK-375	svātmamanyavasthitaḥ samyak jñānibhiśca suśikṣitaḥ || 3 ||	samyak jñānibhiḥ ca su śikṣitaḥ 
MBdarsanopanisatHK-376	p. 171) parvatāgre nadītīre bilvamūle vane'thavā |	parvata agre nadī tīre bilva mūle 
MBdarsanopanisatHK-377	manorame śucau deśe maṭhaṃ kṛtvā samāhitaḥ || 4 ||	manorame śucau deśe maṭham kṛtvā samāhitaḥ 
MBdarsanopanisatHK-378	ārabhya cāsanaṃ paścāt prāṅmukhodaṅmukho'pi vā |	ārabhya ca āsanam paścāt prāc mukha udak mukhaḥ upi vā 
MBdarsanopanisatHK-379	samagrīvaśiraḥkāyaḥ saṃvṛtāsyaḥ suniścalaḥ || 5 ||	sama grīva śiraḥ kāyaḥ saṃvṛta āsyaḥ su niścalaḥ 
MBdarsanopanisatHK-380	nāsāgre śaśabhṛdbimbe bindumadhye turīyakam |	nāsā agre śaśabhṛt bimbe bindu madhye turīyakam 
MBdarsanopanisatHK-381	sravantamamṛtaṃ paśyennetrābhyāṃ susamāhitaḥ || 6 ||	sravantam amṛtam paśyet netrābhyām su samāhitaḥ 
MBdarsanopanisatHK-382	iḍayā prāṇamākṛṣya pūrayitvodarasthitam |	iḍayā prāṇam ākṛṣya pūrayitvā udara sthitam 
MBdarsanopanisatHK-383	tato'gniṃ dehamadhyasthaṃ dhyāyan jvālāvalīyutam || 7 ||	tatas agnim deha madhya stham dhyāyan jvālā āvalī yutam 
MBdarsanopanisatHK-384	bindunādasamāyuktamagnibījaṃ vicintayet |	bindu nāda samāyuktam agnibījam vicintayet 
MBdarsanopanisatHK-385	paścāvirecayet samyak prāṇaṃ piṅgalayā budhaḥ || 8 ||	paścā virecayet samyak prāṇam piṅgalayā budhaḥ 
MBdarsanopanisatHK-386	punaḥ piṅgalayāpūrya vahnibījamanusmaret |	punar piṅgalayā āpūrya vahnibījam anusmaret 
MBdarsanopanisatHK-387	punarvirecayeddhīmāniḍayaiva śanaiḥ śanaiḥ || 9 ||	punar virecayet hi imān iḍayā eva śanais śanais 
MBdarsanopanisatHK-388	tricaturvāsaraṃ vātha tricaturvārameva ca |	tri catur vāsaram vā atha tri catur vāram eva ca 
MBdarsanopanisatHK-389	ṣaṭkṛtvo vicarennityaṃ rahasyevaṃ trisaṃdhiṣu || 10 ||	ṣaṣ kṛtvas vicaret nityam rahasi evam tri saṃdhiṣu 
MBdarsanopanisatHK-390	narabhāvabhāvitanāḍīśuddhibubhutsayā pṛcchatītyāha-	nara bhāva bhāvita nāḍī śuddhi bubhutsayā pṛcchati iti āha 
MBdarsanopanisatHK-391	samyagiti || 1 || praśnottaraṃ bhagavānāha- sāṃkṛta iti ||	samyak iti praśna uttaram bhagavān āha sāṃkṛtaḥ iti 
MBdarsanopanisatHK-392	kastatprakāraḥ ityatra- vidhyukteti || 2-5 ||	kaḥ tad prakāraḥ iti atra vidhi uktā iti 
MBdarsanopanisatHK-393	sravadamṛtacandrabimbaṃ nāsāgre avalokayan yogaṃ samārabhedityarthaḥ	sravat amṛta candra bimbam nāsā agre avalokayan yogam samārabhet iti arthaḥ 
MBdarsanopanisatHK-394	|| 6-7 || rāmiti agnibījaṃ || 8-9 || pratidinaṃ tricaturvāram || 10-14	rāṃ iti agnibījam      pratidinam tri catur vāram 
MBdarsanopanisatHK-395	"p. 172) 				nāḍīśuddhicihnāni"	        
MBdarsanopanisatHK-396	nāḍīśuddhimavāpnoti pṛthakcihnopalakṣitaḥ |	nāḍī śuddhim avāpnoti pṛthak cihna upalakṣitaḥ 
MBdarsanopanisatHK-397	śarīralaghutā dīptirvahnerjāṭharavartinaḥ || 11 ||	śarīra laghu tā dīptiḥ vahneḥ jāṭhara vartinaḥ 
MBdarsanopanisatHK-398	nādābhivyaktirityetaccihnaṃ tatsiddhisūcakam |	nāda abhivyaktiḥ iti etat cihnam tad siddhi sūcakam 
MBdarsanopanisatHK-399	yāvadetāni saṃpaśyet tāvadevaṃ samācaret || 12 ||	yāvat etāni saṃpaśyet tāvat evam samācaret 
MBdarsanopanisatHK-400	svātmaśuddhiḥ	sva ātma śuddhiḥ 
MBdarsanopanisatHK-401	athavaitat parityajya svātmaśuddhiṃ samācaret |	athavā etat parityajya sva ātma śuddhim samācaret 
MBdarsanopanisatHK-402	ātmā śuddhaḥ sadā nityaḥ sukharūpaḥ svayaṃprabhaḥ || 13 ||	ātmā śuddhaḥ sadā nityaḥ sukha rūpaḥ svayaṃprabhaḥ 
MBdarsanopanisatHK-403	ajñānānmalino bhāti jñānācchuddho vibhātyayam |	ajñānāt malinaḥ bhāti jñānāt śuddhaḥ vibhāti ayam 
MBdarsanopanisatHK-404	ajñānamalapaṅkaṃ yaḥ kṣālayejjñānatoyataḥ |	ajñāna mala paṅkam yaḥ kṣālayet jñāna toyataḥ 
MBdarsanopanisatHK-405	sa eva sarvadā śuddho nānyaḥ karmarato hi saḥ || 14 ||	saḥ eva sarvadā śuddhaḥ na anyaḥ karma rataḥ hi saḥ  /
MBdarsanopanisatHK-406	iti pañcamaḥ khaṇḍaḥ	iti pañcamaḥ khaṇḍaḥ 
MBdarsanopanisatHK-407	ṣaṣṭhaḥ khaṇḍaḥ	ṣaṣṭhaḥ khaṇḍaḥ 
MBdarsanopanisatHK-408	prāṇāyāmalakṣaṇam	         
MBdarsanopanisatHK-409	prāṇāyāmakramaṃ vakṣye sāṃkṛte śṛṇu sādaram |	prāṇāyāma kramam vakṣye sāṃkṛte śṛṇu sādaram 
MBdarsanopanisatHK-410	prāṇāyāma iti prokto recapūrakakumbhakaiḥ || 1 ||	prāṇāyāmaḥ iti proktaḥ reca pūraka kumbhakaiḥ 
MBdarsanopanisatHK-411	varṇatrayātmakāḥ proktā recapūrakakumbhakāḥ |	varṇa traya ātmakāḥ proktāḥ reca pūraka kumbhakāḥ 
MBdarsanopanisatHK-412	sa eṣa praṇavaḥ proktaḥ prāṇāyāmaśca tanmayaḥ || 2 ||	saḥ eṣa praṇavaḥ proktaḥ prāṇāyāmaḥ ca tad mayaḥ 
MBdarsanopanisatHK-413	p. 173) iḍayā vāyumākṛṣya pūrayitvodarasthitam |	iḍayā vāyum ākṛṣya pūrayitvā udara sthitam 
MBdarsanopanisatHK-414	śanaiḥ ṣoḍaśabhirmātrairakāraṃ tatra saṃsmaret || 3 ||	śanais ṣoḍaśabhiḥ mātraiḥ akāram tatra saṃsmaret  /
MBdarsanopanisatHK-415	pūritaṃ dhārayet paścāccatuḥṣaṣṭyā tu mātrayā |	pūritam dhārayet paścāt catuḥṣaṣṭyā tu mātrayā 
MBdarsanopanisatHK-416	ukāramūrtimatrāpi saṃsmaran praṇavaṃ japet || 4 ||	ukāra mūrtim atra api saṃsmaran praṇavam japet 
MBdarsanopanisatHK-417	yāvadvā śakyate tāvaddhārayejjapatatparaḥ |	yāvat vā śakyate tāvat dhārayet japa tatparaḥ 
MBdarsanopanisatHK-418	pūritaṃ recayet paścānmakāreṇānilaṃ budhaḥ || 5 ||	pūritam recayet paścāt makāreṇa anilam budhaḥ  
MBdarsanopanisatHK-419	śanaiḥ piṅgalayā tatra dvātriṃśanmātrayā punaḥ |	śanais piṅgalayā tatra dvātriṃśat mātrayā punar 
MBdarsanopanisatHK-420	prāṇāyāmo bhavedeṣa tataścaivaṃ samabhyaset || 6 ||	prāṇāyāmaḥ bhavet eṣa tatas ca evam samabhyaset 
MBdarsanopanisatHK-421	punaḥ piṅgalayāpūrya mātraiḥ ṣoḍaśabhistathā |	punar piṅgalayā āpūrya mātraiḥ ṣoḍaśabhiḥ tathā 
MBdarsanopanisatHK-422	akāramūrtimatrāpi smaredekāgramānasaḥ || 7 ||	akāra mūrtim atra api smaret ekāgra mānasaḥ 
MBdarsanopanisatHK-423	dhārayet pūritaṃ vidvān praṇavaṃ saṃjapan vaśī |	dhārayet pūritam vidvān praṇavam saṃjapan vaśī 
MBdarsanopanisatHK-424	ukāramūrtiṃ sa dhyāyan catuḥṣaṣṭyā tu mātrayā || 8 ||	ukāra mūrtim sa dhyāyan catuḥṣaṣṭyā tu mātrayā 
MBdarsanopanisatHK-425	makāraṃ tu smaran paścādrecayediḍayānilam |	makāram tu smaran paścāt recayet iḍayā anilam 
MBdarsanopanisatHK-426	evameva punaḥ kuryādiḍayāpūrya buddhimān || 9 ||	evam eva punar kuryāt iḍayā āpūrya buddhimān 
MBdarsanopanisatHK-427	evaṃ samabhyasennityaṃ prāṇāyāmaṃ munīśvara |	evam samabhyaset nityam prāṇāyāmam muni īśvara 
MBdarsanopanisatHK-428	evamabhyāsato nityaṃ ṣaṇmāsād jñānavān bhavet || 10 ||	evam abhyāsataḥ nityam ṣaṣ māsāt jñānavān bhavet  /
MBdarsanopanisatHK-429	vatsarādbrahmavidvān syāt tasmānnityaṃ samabhyaset |	vatsarāt brahma vidvān syāt tasmāt nityam samabhyaset 
MBdarsanopanisatHK-430	yogābhyāsarato nityaṃ svadharmanirataśca yaḥ || 11 ||	yoga abhyāsa rataḥ nityam svadharma nirataḥ ca yaḥ 
MBdarsanopanisatHK-431	prāṇasaṃyamanenaiva jñānamukto bhaviṣyati |	prāṇa saṃyamanena eva jñāna muktaḥ bhaviṣyati 
MBdarsanopanisatHK-432	viśeṣataḥ prāṇāyāmeti || 1-11 ||	viśeṣataḥ prāṇāyāma iti 
MBdarsanopanisatHK-433	"p. 174) 			pūrakādilakṣaṇam"	        
MBdarsanopanisatHK-434	bāhyadāpūraṇaṃ vāyorudare pūrako hi saḥ || 12 ||	bāhya dā pūraṇam vāyoḥ udare pūrakaḥ hi saḥ 
MBdarsanopanisatHK-435	saṃpūrṇakumbhavadvāyordhāraṇaṃ kumbhako bhavet |	saṃpūrṇa kumbha vat vāyoḥ dhāraṇam kumbhakaḥ bhavet 
MBdarsanopanisatHK-436	bahirvirecanaṃ vāyorudarādrecakaḥ smṛtaḥ || 13 ||	bahis virecanam vāyoḥ udarāt recakaḥ smṛtaḥ 
MBdarsanopanisatHK-437	pūrakādilakṣaṇamāha- bāhyāditi || 12-13 ||	pūraka ādi lakṣaṇam āha bāhyāt iti 
MBdarsanopanisatHK-438	prāṇāyāmasiddhayaḥ	        
MBdarsanopanisatHK-439	prasvedajanako yastu prāṇāyāmeṣu so'dhamaḥ |	prasveda janakaḥ yaḥ tu prāṇāyāmeṣu saḥ dhamaḥ 
MBdarsanopanisatHK-440	kampanaṃ madhyamaṃ vidyādutthānaṃ cottamaṃ viduḥ || 14 ||	kampanam madhyamam vidyāt utthānam ca uttamam viduḥ  /
MBdarsanopanisatHK-441	pūrvapūrvaṃ prakurvīta yāvadutthānasaṃbhavaḥ |	pūrva pūrvam prakurvīta yāvat utthāna saṃbhavaḥ 
MBdarsanopanisatHK-442	saṃbhavatyuttame prājñaḥ prāṇāyāme sukhī bhavet || 15 ||	saṃbhavati uttame prājñaḥ prāṇāyāme sukhī bhavet 
MBdarsanopanisatHK-443	prāṇāyāmena cittaṃ tu śuddhaṃ bhavati suvrata |	prāṇāyāmena cittam tu śuddham bhavati suvrata 
MBdarsanopanisatHK-444	citte śuddhe śuciḥ sākṣāt pratyagjyotirvyavasthitaḥ || 16 ||	citte śuddhe śuciḥ sākṣāt pratyak jyotiḥ vyavasthitaḥ 
MBdarsanopanisatHK-445	prāṇaścittena saṃyuktaḥ paramātmani tiṣṭhati |	prāṇaḥ cittena saṃyuktaḥ paramātmani tiṣṭhati 
MBdarsanopanisatHK-446	prāṇāyāmaparasyāsya puruṣasya mahātmanaḥ || 17 ||	prāṇāyāma parasya asya puruṣasya mahātmanaḥ 
MBdarsanopanisatHK-447	dehaścottiṣṭhate tena kiṃcijjñānādvimuktatā |	dehaḥ ca uttiṣṭhate tena kiṃcid jñānāt vimukta tā 
MBdarsanopanisatHK-448	recakaṃ pūrakaṃ muktvā kumbhakaṃ cityamabhyaset || 18 ||	recakam pūrakam muktvā kumbhakam cityam abhyaset 
MBdarsanopanisatHK-449	sarvapāpavinirmuktaḥ samyagjñānamavāpnuyāt |	sarva pāpa vinirmuktaḥ samyak jñānam avāpnuyāt 
MBdarsanopanisatHK-450	manojavatvamāpnoti palitādi ca naśyati || 19 ||	manojava tvam āpnoti palita ādi ca naśyati 
MBdarsanopanisatHK-451	p. 175) prāṇāyāmaikaniṣṭhasya na kiṃcidapi durlabham |	prāṇāyāma eka niṣṭhasya na kiṃcid api durlabham 
MBdarsanopanisatHK-452	tasmāt sarvaprayatnena prāṇāyāmān samabhyaset || 20 ||	tasmāt sarva prayatnena prāṇāyāmān samabhyaset 
MBdarsanopanisatHK-453	svedādisiddhimāha- prasvedeti || 14-17 || uttiṣṭhate bhūtalāt ||	sveda ādi siddhim āha prasveda iti      uttiṣṭhate bhū talāt 
MBdarsanopanisatHK-454	roganivartakaprāṇāyāmabhedāḥ	            
MBdarsanopanisatHK-455	viniyogān pravakṣyāmi prāṇāyāmasya suvrata |	viniyogān pravakṣyāmi prāṇāyāmasya suvrata 
MBdarsanopanisatHK-456	saṃdhyayorbrāhmakāle'pi madhyāhne vāthavā sadā || 21 ||	saṃdhyayoḥ brāhma kāle api madhyāhne vā athavā sadā 
MBdarsanopanisatHK-457	bāhyaṃ prāṇaṃ samākṛṣya pūrayitvodareṇa ca |	bāhyam prāṇam samākṛṣya pūrayitvā udareṇa ca 
MBdarsanopanisatHK-458	nāsāgre nābhimadhye ca pādāṅguṣṭhe ca dhāraṇāt || 22 ||	nāsā agre nābhi madhye ca pādāṅguṣṭhe ca dhāraṇāt  /
MBdarsanopanisatHK-459	sarvarogavinirmukto jīvedvarṣaśataṃ naraḥ |	sarva roga vinirmuktaḥ jīvet varṣa śatam naraḥ 
MBdarsanopanisatHK-460	nāsāgradhāraṇādvāpi jito bhavati suvrata || 23 ||	nāsā agra dhāraṇāt vā api jitaḥ bhavati suvrata 
MBdarsanopanisatHK-461	sarvaroganivṛttiḥ syānnābhimadhye tu dhāraṇāt |	sarva roga nivṛttiḥ syāt nābhi madhye tu dhāraṇāt 
MBdarsanopanisatHK-462	śarīralaghutā vipra pādāṅguṣṭhanirodhanāt || 24 ||	śarīra laghu tā vipra pādāṅguṣṭha nirodhanāt 
MBdarsanopanisatHK-463	jihvayā vāyumākṛṣya yaḥ pibet satataṃ naraḥ |	jihvayā vāyum ākṛṣya yaḥ pibet satatam naraḥ 
MBdarsanopanisatHK-464	śramadāhavinirmukto yogī nīrogatāmiyāt || 25 ||	śrama dāha vinirmuktaḥ yogī nīroga tām iyāt 
MBdarsanopanisatHK-465	jihvayā vāyumākṛṣya jihvāmūle nirodhayet |	jihvayā vāyum ākṛṣya jihvā mūle nirodhayet 
MBdarsanopanisatHK-466	pibedamṛtamavyagraṃ sakalaṃ sukhamāpnuyāt || 26 ||	pibet amṛtam avyagram sakalam sukham āpnuyāt 
MBdarsanopanisatHK-467	iḍayā vāyumākṛṣya bhrūvormadhye nirodhayet |	iḍayā vāyum ākṛṣya bhrūvoḥ madhye nirodhayet 
MBdarsanopanisatHK-468	yaḥ pibedamṛtaṃ śuddhaṃ vyādhibhirmucyate hi saḥ || 27 ||	yaḥ pibet amṛtam śuddham vyādhibhiḥ mucyate hi saḥ 
MBdarsanopanisatHK-469	"p. 176) 			yogopaniṣadaḥ"	yoga upaniṣadaḥ 
MBdarsanopanisatHK-470	iḍayā vedatattvajña tathā piṅgalayaiva ca |	iḍayā veda tattva jña tathā piṅgalayā eva ca 
MBdarsanopanisatHK-471	nābhau nirodhayettena vyādhibhirmucyate naraḥ || 28 ||	nābhau nirodhayet tena vyādhibhiḥ mucyate naraḥ 
MBdarsanopanisatHK-472	māsamātraṃ trisaṃdhyāyāṃ jihvayāropya mārutam |	māsa mātram trisaṃdhyāyām jihvayā āropya mārutam 
MBdarsanopanisatHK-473	amṛtaṃ ca pibannābhau mandaṃ mandaṃ nirodhayet || 29 ||	amṛtam ca piban nābhau mandam mandam nirodhayet 
MBdarsanopanisatHK-474	vātajāḥ pittajā doṣā naśyantyeva na saṃśayaḥ |	vāta jāḥ pitta jāḥ doṣāḥ naśyanti eva na saṃśayaḥ 
MBdarsanopanisatHK-475	nāsābhyāṃ vāyumākṛṣya netradvandve nirodhayet || 30 ||	nāsābhyām vāyum ākṛṣya netra dvandve nirodhayet  /
MBdarsanopanisatHK-476	netrarogā vinaśyanti tathā śrotranirodhanāt |	netra rogāḥ vinaśyanti tathā śrotra nirodhanāt 
MBdarsanopanisatHK-477	tathā vāyuṃ samāropya dhārayecchirasi sthitam || 31 ||	tathā vāyum samāropya dhārayet śirasi sthitam 
MBdarsanopanisatHK-478	śirorogā vinaśyanti satyamuktaṃ hi sāṃkṛte |	śiraḥ rogāḥ vinaśyanti satyam uktam hi sāṃkṛte 
MBdarsanopanisatHK-479	yogasiddhyantarāyaroganirāsakān dhāraṇābhedānāha-	yoga siddhi antarāya roga nirāsakān dhāraṇā bhedān āha 
MBdarsanopanisatHK-480	viniyogāniti | brahmakāle brāhme muhūrte || 21-35 ||	viniyogān iti brahma kāle brāhme muhūrte  /
MBdarsanopanisatHK-481	ṣaṇmukhīmudrābhyāsādinā vāyujayaḥ	             
MBdarsanopanisatHK-482	svastikāsanamāsthāya samāhitamanāstathā || 32 ||	svastika āsanam āsthāya samāhita manāḥ tathā 
MBdarsanopanisatHK-483	apānamūrdhvamutthāpya praṇavena śanaiḥ śanaiḥ |	apānam ūrdhvam utthāpya praṇavena śanais śanais 
MBdarsanopanisatHK-484	hastābhyāṃ dhārayet samyak karaṇādikaraṇāni ca || 33 ||	hastābhyām dhārayet samyak karaṇa ādi karaṇāni ca 
MBdarsanopanisatHK-485	aṅguṣṭhābhyāṃ mune śrotre tarjanībhyāṃ tu cakṣuṣī |	aṅguṣṭhābhyām mune śrotre tarjanībhyām tu cakṣuṣī 
MBdarsanopanisatHK-486	nāsāpuṭāvasthānyābhyāṃ pracchādya karaṇāni vai || 34 ||	nāsāpuṭa avasthāni ābhyām pracchādya karaṇāni vai 
MBdarsanopanisatHK-487	ānandāvirbhavo yāvat tāvanmūrdhani dhārayet |	ānanda āvirbhavaḥ yāvat tāvat mūrdhani dhārayet 
MBdarsanopanisatHK-488	prāṇaḥ prayātyanenaiva brahmarandhraṃ mahāmune || 35 ||	prāṇaḥ prayāti anena eva brahmarandhram mahā mune 
MBdarsanopanisatHK-489	p. 177) brahmarandhraṃ gate vāyau nādaścotpadyate'nagha |	brahmarandhram gate vāyau nādaḥ ca utpadyate anagha 
MBdarsanopanisatHK-490	śaṅkhadhvaninibhaścādau madhye meghadhvaniryathā || 36 ||	śaṅkha dhvani nibhaḥ ca ādau madhye megha dhvaniḥ yathā 
MBdarsanopanisatHK-491	śiromadhyagate vāyau giriprasravaṇaṃ yathā |	śiraḥ madhya gate vāyau giri prasravaṇam yathā 
MBdarsanopanisatHK-492	paścāt prīto mahāprājña sākṣādātmonmukho bhavet || 37 ||	paścāt prītaḥ mahā prājña sākṣāt ātma unmukhaḥ bhavet 
MBdarsanopanisatHK-493	punastajjñānaniṣpattiryogāt saṃsāranihnutiḥ |	punar tad jñāna niṣpattiḥ yogāt saṃsāra nihnutiḥ 
MBdarsanopanisatHK-494	dakṣiṇottaragulphena sīvinīṃ pīḍayet sthirām || 38 ||	dakṣiṇa uttara gulphena sīvinīm pīḍayet sthirām 
MBdarsanopanisatHK-495	savyetareṇa gulphena pīḍayed bddhimān naraḥ |	savyetareṇa gulphena pīḍayet bddhimān naraḥ 
MBdarsanopanisatHK-496	jānvoradhaḥ sthitāṃ saṃdhiṃ smṛtvā devaṃ triyambakam || 39 ||	jānvoḥ adhas sthitām saṃdhim smṛtvā devam tryambakam 
MBdarsanopanisatHK-497	vināyakaṃ ca saṃsmṛtya tathā vāgīśvarīṃ punaḥ |	vināyakam ca saṃsmṛtya tathā vāgīśvarīm punar 
MBdarsanopanisatHK-498	liṅganālāt samākṛṣya vāyumapyagrato mune || 40 ||	liṅganālāt samākṛṣya vāyum api agratas mune 
MBdarsanopanisatHK-499	praṇavena niyuktena binduyuktena buddhimān |	praṇavena niyuktena bindu yuktena buddhimān 
MBdarsanopanisatHK-500	mūlādhārasya viprendra madhye taṃ tu nirodhayet || 41 ||	mūlādhārasya vipra indra madhye tam tu nirodhayet 
MBdarsanopanisatHK-501	nirudhya vāyunā dīpto vahnirūhati kuṇḍalīm |	nirudhya vāyunā dīptaḥ vahniḥ ūhati kuṇḍalīm 
MBdarsanopanisatHK-502	punaḥ suṣumnayā vāyurvahninā saha gacchati || 42 ||	punar suṣumnayā vāyuḥ vahninā saha gacchati  /
MBdarsanopanisatHK-503	evamabhyasatastasya jito vāyurbhaved bhṛśam |	evam abhyasataḥ tasya jitaḥ vāyuḥ bhavet bhṛśam 
MBdarsanopanisatHK-504	evaṃ ṣaṇmukhīmudrābhyāsataḥ brahmarandhramiti || 36 || yathā tathā	evam ṣaṇmukhī mudrā abhyāsataḥ brahmarandhram iti yathā tathā 
MBdarsanopanisatHK-505	candramaṇḍalagiritaḥ amṛtapravāho jāyate | tena	candra maṇḍala giritaḥ amṛta pravāhaḥ jāyate tena 
MBdarsanopanisatHK-506	bhrūmadhyasthajyotirliṅgamabhiṣicya tadamṛtāsvādanato yogī vimṛtyuḥ	bhrū madhya stha jyotiḥ liṅgam abhiṣicya tad amṛta āsvādanataḥ yogī vimṛtyuḥ 
MBdarsanopanisatHK-507	bhavati | tataḥ paścāt || 37-38 || dakṣiṇetaragulphābhyāṃ sīvinīṃ	bhavati tatas paścāt    dakṣiṇetara gulphābhyām sīvinīm 
MBdarsanopanisatHK-508	meḍhragudāntarālasthanāḍīṃ saṃpīḍayan jānvoradhaḥ- sthitasaṃdhiṃ	meḍhra guda antarāla stha nāḍīm saṃpīḍayan jānvoḥ adhas sthita saṃdhim 
MBdarsanopanisatHK-509	śivaliṅgaṃ smṛtvā vināyakaṃ vāgīśvarīṃ ca dhyātvā tato	śiva liṅgam smṛtvā vināyakam vāgīśvarīm ca dhyātvā 
MBdarsanopanisatHK-510	liṅganālādityādi || 39-42 ||	liṅganālāt ityādi 
MBdarsanopanisatHK-511	"p. 178) 			vāyujayacihnāni"	vāyu jaya cihnāni 
MBdarsanopanisatHK-512	prasvedaḥ prathamaḥ paścāt kampanaṃ munipuṅgava || 43 ||	prasvedaḥ prathamaḥ paścāt kampanam muni puṅgava 
MBdarsanopanisatHK-513	utthānaṃ ca śarīrasya cihnametajjite'nile |	utthānam ca śarīrasya cihnam etat jita inile 
MBdarsanopanisatHK-514	vāyujayasūcakācihnānyāha- prasveda iti || 43-48 ||	vāyu jaya sūcaka a cihnāni āha prasvedaḥ iti 
MBdarsanopanisatHK-515	vāyujayena rogapāpavināśavairāgyapūrvikā jñānotpattiḥ	vāyu jayena roga pāpa vināśa vairāgya pūrvikā jñāna utpattiḥ 
MBdarsanopanisatHK-516	evamabhyasatastasya mūlarogo vinaśyati || 44 ||	evam abhyasataḥ tasya mūla rogaḥ vinaśyati 
MBdarsanopanisatHK-517	bhagaṃdharaṃ ca naṣṭaṃ syāt sarvarogāśca sāṃkṛte |	bhagaṃdharam ca naṣṭam syāt sarva rogāḥ ca sāṃkṛte 
MBdarsanopanisatHK-518	pātakāni vinaśyanti kṣudrāṇi ca mahānti ca || 45 ||	pātakāni vinaśyanti kṣudrāṇi ca mahānti ca 
MBdarsanopanisatHK-519	naṣṭe pāpe viśuddhaṃ syāccittadarpaṇamadbhutam |	naṣṭe pāpe viśuddham syāt citta darpaṇam adbhutam 
MBdarsanopanisatHK-520	punarbrahmādibhogebhyo vairāgyaṃ jāyate hṛdi || 46 ||	punar brahma ādi bhogebhyaḥ vairāgyam jāyate hṛdi 
MBdarsanopanisatHK-521	viraktasya tu saṃsārājjñānaṃ kaivalyasādhanam |	viraktasya tu saṃsārāt jñānam kaivalya sādhanam 
MBdarsanopanisatHK-522	tena pāśāpahāniḥ syāt jñātvā devaṃ sadāśivam || 47 ||	tena pāśa apahāniḥ syāt jñātvā devam sadāśivam 
MBdarsanopanisatHK-523	jñānāmṛtaraso yena sakṛdāsvādito bhavet |	jñāna amṛta rasaḥ yena sakṛt āsvāditaḥ bhavet 
MBdarsanopanisatHK-524	sa sarvakāryamutsṛjya tatraiva paridhāvati || 48 ||	sa sarva kāryam utsṛjya tatra eva paridhāvati 
MBdarsanopanisatHK-525	jñānasvarūpamevāhurjagadetadvicakṣaṇāḥ |	jñāna svarūpam eva āhuḥ jagat etat vicakṣaṇāḥ 
MBdarsanopanisatHK-526	arthasvarūpamajñānāt paśyantyanye kudṛṣṭayaḥ || 49 ||	artha svarūpam ajñānāt paśyanti anye kudṛṣṭayaḥ 
MBdarsanopanisatHK-527	ātmasvarūpavijñānādajñānasya parikṣayaḥ |	ātma svarūpa vijñānāt ajñānasya parikṣayaḥ 
MBdarsanopanisatHK-528	kṣīṇe'jñāne mahāprājña rāgādīnāṃ parikṣayaḥ || 50 ||	kṣīṇe jñāne mahā prājña rāga ādīnām parikṣayaḥ 
MBdarsanopanisatHK-529	p. 179) rāgādyasaṃbhave prājña puṇyapāpavimarśanam |	rāga ādi asaṃbhave prājña puṇya pāpa vimarśanam 
MBdarsanopanisatHK-530	tayornāśe śarīreṇa na punaḥ saṃprayujyate || 51 ||	tayoḥ nāśe śarīreṇa na punar saṃprayujyate  /
MBdarsanopanisatHK-531	vicakṣaṇāḥ jñāninaḥ || 49-50 || vimarśanaṃ viśodhanaṃ	vicakṣaṇāḥ jñāninaḥ 
MBdarsanopanisatHK-532	vināśanamityarthaḥ || 51 ||	vināśanam iti arthaḥ 
MBdarsanopanisatHK-533	iti ṣaṣṭhaḥ khaṇḍaḥ	iti ṣaṣṭhaḥ khaṇḍaḥ 
MBdarsanopanisatHK-534	saptamaḥ khaṇḍaḥ	saptamaḥ khaṇḍaḥ 
MBdarsanopanisatHK-535	pratyāhāralakṣaṇam, tadbhedāśca	pratyāhāra lakṣaṇam tad bhedāḥ ca 
MBdarsanopanisatHK-536	athātaḥ saṃpravakṣyāmi pratyāhāraṃ mahāmune |	atha atas saṃpravakṣyāmi pratyāhāram mahā mune 
MBdarsanopanisatHK-537	indriyāṇāṃ vicaratāṃ viṣayeṣu svabhāvataḥ || 1 ||	indriyāṇām vicaratām viṣayeṣu svabhāvataḥ 
MBdarsanopanisatHK-538	balādāharaṇaṃ teṣāṃ pratyāhāraḥ sa ucyate |	balāt āharaṇam teṣām pratyāhāraḥ saḥ ucyate 
MBdarsanopanisatHK-539	yat paśyati tu tat sarvaṃ brahma paśyan samāhitaḥ || 2 ||	yat paśyati tu tat sarvam brahma paśyan samāhitaḥ 
MBdarsanopanisatHK-540	pratyāhāro bhavedeṣa brahmavidbhiḥ puroditaḥ |	pratyāhāraḥ bhavet eṣa brahma vidbhiḥ purā uditaḥ 
MBdarsanopanisatHK-541	yadyacchuddhamaśuddhaṃ vā karotyāmaraṇāntikam || 3 ||	yat yat śuddham aśuddham vā karoti āmaraṇāntikam 
MBdarsanopanisatHK-542	tat sarvaṃ brahmaṇe kuryāt pratyāhāraḥ sa ucyate |	tat sarvam brahmaṇe kuryāt pratyāhāraḥ saḥ ucyate 
MBdarsanopanisatHK-543	athavā nityakarmāṇi brahmārādhanabuddhitaḥ || 4 ||	athavā nityakarmāṇi brahma ārādhana buddhitaḥ 
MBdarsanopanisatHK-544	kāmyāni ca tathā kuryāt pratyāhāraḥ sa ucyate |	kāmyāni ca tathā kuryāt pratyāhāraḥ saḥ ucyate 
MBdarsanopanisatHK-545	athavā vāyumākṛṣya sthānāt sthānaṃ nirodhayet || 5 ||	athavā vāyum ākṛṣya sthānāt sthānam nirodhayet  /
MBdarsanopanisatHK-546	dantamūlāt tathā kāṣṭhe kaṇṭhādurasi mārutam |	danta mūlāt tathā kāṣṭhe kaṇṭhāt urasi mārutam 
MBdarsanopanisatHK-547	urodeśāt samākṛṣya nābhideśe nirodhayet || 6 ||	uraḥ deśāt samākṛṣya nābhi deśe nirodhayet  /
MBdarsanopanisatHK-548	p. 180) nābhideśāt samākṛṣya kuṇḍalyāṃ tu nirodhayet |	nābhi deśāt samākṛṣya kuṇḍalyām tu nirodhayet 
MBdarsanopanisatHK-549	kuṇḍalīdeśato vidvān mūlādhāre nirodhayet || 7 ||	kuṇḍalī deśataḥ vidvān mūlādhāre nirodhayet 
MBdarsanopanisatHK-550	athāpānāt kaṭidvandve tathorau ca sumadhyame |	atha apānāt kaṭi dvandve tathā ūrau ca sumadhyame 
MBdarsanopanisatHK-551	tasmājjānudvaye jaṅghe pādāṅguṣṭhe nirodhayet || 8 ||	tasmāt jānu dvaye jaṅghe pādāṅguṣṭhe nirodhayet  /
MBdarsanopanisatHK-552	pratyāhāro'yamuktastu pratyāhāraparaiḥ purā |	pratyāhāraḥ ūyam uktaḥ tu pratyāhāra paraiḥ purā 
MBdarsanopanisatHK-553	yamaniyamāsanaprāṇāyāmeyattāṃ pratipādya tataḥ	yama niyama āsana prāṇāyāma iyattām pratipādya tatas 
MBdarsanopanisatHK-554	pratyāhārasvarūpamāha- atheti || 1-12 ||	pratyāhāra svarūpam āha atha iti 
MBdarsanopanisatHK-555	pratyāhāraphalam	pratyāhāra phalam 
MBdarsanopanisatHK-556	evamabhyāsayuktasya puruṣasya mahātmanaḥ || 9 ||	evam abhyāsa yuktasya puruṣasya mahātmanaḥ 
MBdarsanopanisatHK-557	sarvapāpāni naśyanti bhavarogaśca suvrata |	sarva pāpāni naśyanti bhava rogaḥ ca suvrata 
MBdarsanopanisatHK-558	vāyudhāraṇātmakapratyāhāraḥ	vāyu dhāraṇa ātmaka pratyāhāraḥ 
MBdarsanopanisatHK-559	nāsābhyāṃ vāyumākṛṣya niścalaḥ svastikāsanaḥ || 10 ||	nāsābhyām vāyum ākṛṣya niścalaḥ svastika āsanaḥ 
MBdarsanopanisatHK-560	pūrayedanilaṃ vidvānāpādatalamastakam |	pūrayet anilam vidvān āpādatalamastakam 
MBdarsanopanisatHK-561	paścāt pādadvaye tadvat mūlādhāre tathaiva ca || 11 ||	paścāt pāda dvaye tadvat mūlādhāre tathā eva ca 
MBdarsanopanisatHK-562	nābhikande ca hṛnmadhye kaṇṭhamūle ca tāluke |	nābhi kande ca hṛd madhye kaṇṭha mūle ca tāluke 
MBdarsanopanisatHK-563	bhruvormadhye lalāṭe ca tathā mūrdhani dhārayet || 12 ||	bhruvoḥ madhye lalāṭe ca tathā mūrdhani dhārayet 
MBdarsanopanisatHK-564	vedāntasaṃmatapratyāhāraḥ	vedānta saṃmata pratyāhāraḥ 
MBdarsanopanisatHK-565	dehe tvātmamatiṃ vidvān samākṛṣya samāhitaḥ |	dehe tu ātma matim vidvān samākṛṣya samāhitaḥ 
MBdarsanopanisatHK-566	ātmanātmani nirdvandve nirvikalpe nirodhayet || 13 ||	ātmanā ātmani nirdvandve nirvikalpe nirodhayet 
MBdarsanopanisatHK-567	p. 181) pratyāhāraḥ samākhyātaḥ sākṣādvedāntavedibhiḥ |	pratyāhāraḥ samākhyātaḥ sākṣāt vedānta vedibhiḥ 
MBdarsanopanisatHK-568	evamabhyasatastasya na kiṃcidapi durlabham || 14 ||	evam abhyasataḥ tasya na kiṃcid api durlabham 
MBdarsanopanisatHK-569	kiṃ bahunā- dehe iti || 13-14 ||	kim bahunā dehe iti 
MBdarsanopanisatHK-570	iti saptamaḥ khaṇḍaḥ	iti saptamaḥ khaṇḍaḥ 
MBdarsanopanisatHK-571	aṣṭamaḥ khaṇḍaḥ	aṣṭamaḥ khaṇḍaḥ 
MBdarsanopanisatHK-572	pañcabhūteṣu dhāraṇā	pañcabhūteṣu dhāraṇā 
MBdarsanopanisatHK-573	athātaḥ saṃpravakṣyāmi dhāraṇāḥ pañca suvrata |	atha atas saṃpravakṣyāmi dhāraṇāḥ pañca suvrata 
MBdarsanopanisatHK-574	dehamadhyagate vyomni bāhyākāśaṃ tu dhārayet || 1 ||	deha madhya gate vyomni bāhya ākāśam tu dhārayet 
MBdarsanopanisatHK-575	prāṇe bāhyānilaṃ tadvat jvalane cāgnimaudare |	prāṇe bāhya anilam tadvat jvalane ca agnim audare 
MBdarsanopanisatHK-576	toyaṃ toyāṃśake bhūmiṃ bhūmibhāge mahāmune || 2 ||	toyam toyāṃśake bhūmim bhūmi bhāge mahā mune 
MBdarsanopanisatHK-577	hayarāvalakārākhyaṃ mantramuccārayet kramāt |	                
MBdarsanopanisatHK-578	dhāraṇaiṣā parā proktā sarvapāpaviśodhinī || 3 ||	dhāraṇā eṣā parā proktā sarva pāpa viśodhinī 
MBdarsanopanisatHK-579	jānvantaṃ pṛthivī hyaṃśo hyapāṃ pāyvantamucyate |	jānu antam pṛthivī hi aṃśaḥ hi apām pāyu antam ucyate 
MBdarsanopanisatHK-580	hṛdayāṃśastathāgnyaṃśo bhrūmadhyānto'nilāṃśakaḥ || 4 ||	hṛdaya aṃśaḥ tathā agni aṃśaḥ bhrū madhya antaḥ nila aṃśakaḥ 
MBdarsanopanisatHK-581	ākāśāṃśastathā prājña mūrdhāṃśaḥ parikīrtitaḥ |	ākāśa aṃśaḥ tathā prājña mūrdha aṃśaḥ parikīrtitaḥ 
MBdarsanopanisatHK-582	brahmāṇaṃ pṛthivībhāge viṣṇuṃ toyāṃśake tathā || 5 ||	brahmāṇam pṛthivī bhāge viṣṇum toya aṃśake tathā 
MBdarsanopanisatHK-583	agnyaṃśe ca maheśānamīśvaraṃ cānilāṃśake |	agni aṃśe ca maheśānam īśvaram ca anila aṃśake 
MBdarsanopanisatHK-584	ākāśāṃśe māhāprajña dhārayettu sadāśivam || 6 ||	ākāśa aṃśe māhāprajña dhārayet tu sadāśivam 
MBdarsanopanisatHK-585	pratyāhāralakṣaṇamuktvā dhāraṇālakṣaṇamāha- atheti || 1##-	pratyāhāra lakṣaṇam uktvā dhāraṇā lakṣaṇam āha atha iti 
MBdarsanopanisatHK-586	"p. 182) 				ātmani dhāraṇā"	ātmani dhāraṇā 
MBdarsanopanisatHK-587	atha vā tava vakṣyāmi dhāraṇāṃ munipuṃgava |	atha vā tava vakṣyāmi dhāraṇām muni puṃgava 
MBdarsanopanisatHK-588	puruṣe sarvaśāstāraṃ bodhānandamayaṃ śivam || 7 ||	puruṣe sarva śāstāram bodha ānanda mayam śivam 
MBdarsanopanisatHK-589	dhārayedbuddhimān nityaṃ sarvapāpaviśuddhaye |	dhārayet buddhimān nityam sarva pāpa viśuddhaye 
MBdarsanopanisatHK-590	brahmādikāryarūpāṇi sve sve saṃhṛtya kāraṇe || 8 ||	brahma ādi kārya rūpāṇi sve sve saṃhṛtya kāraṇe 
MBdarsanopanisatHK-591	sarvakāraṇamavyaktamanirūpyamacetanam |	sarva kāraṇam avyaktam anirūpyam acetanam 
MBdarsanopanisatHK-592	sākṣādātmani saṃpūrṇe dhārayet praṇave manaḥ |	sākṣāt ātmani saṃpūrṇe dhārayet praṇave manaḥ 
MBdarsanopanisatHK-593	indriyāṇi samāhṛtya manasātmani yojayet || 9 ||	indriyāṇi samāhṛtya manasā ātmani yojayet   
MBdarsanopanisatHK-594	puruṣe pratīci svātiriktasarvagrāsatayā śivaṃ dhārayet | yadvā-	puruṣe pratīci sva atirikta sarva grāsa tayā śivam dhārayet yat vā 
MBdarsanopanisatHK-595	puruṣe paramātmani sarvaśāstāraṃ pratyañcaṃ dhārayet || 7-9 ||	puruṣe paramātmani sarva śāstāram pratyañcam dhārayet  /
MBdarsanopanisatHK-596	ityaṣṭamaḥ khaṇḍaḥ	iti aṣṭamaḥ khaṇḍaḥ 
MBdarsanopanisatHK-597	navamaḥ khaṇḍaḥ	navamaḥ khaṇḍaḥ 
MBdarsanopanisatHK-598	saveśeṣabrahmadhyānam	          
MBdarsanopanisatHK-599	athātaḥ saṃpravākṣyāmi dhyānaṃ saṃsāranāśanam |	atha atas saṃpravākṣyāmi dhyānam saṃsāra nāśanam 
MBdarsanopanisatHK-600	ṛtaṃ satyaṃ paraṃ brahma sarvasaṃsārabheṣajam || 1 ||	ṛtam satyam param brahma sarva saṃsāra bheṣajam 
MBdarsanopanisatHK-601	ūrdhvaretaṃ virūpākṣaṃ viśvarūpaṃ maheśvaram |	ūrdhvaretam virūpākṣam viśvarūpam maheśvaram 
MBdarsanopanisatHK-602	so'hamityādareṇaiva dhyāyedyogīśvareśvaram || 2 ||	saḥ ham iti ādareṇa eva dhyāyet yogi īśvara īśvaram 
MBdarsanopanisatHK-603	dhāraṇāmuktvā saviśeṣanirviśeṣabrahmadhyānamāha- atheti |	dhāraṇām uktvā sa viśeṣa nirviśeṣa brahma dhyānam āha atha iti 
MBdarsanopanisatHK-604	ṛtaṃ karmaphalamaparaṃ brahma | satyaṃ jñānaphalaṃ praṃ brahma ||	ṛtam karma phalam aparam brahma satyam jñāna phalam pram brahma 
MBdarsanopanisatHK-605	"p. 183) 			nirviśeṣabrahmadhyānam"	nirviśeṣa brahma dhyānam 
MBdarsanopanisatHK-606	atha vā satyamīśānaṃ jñānamānandamadvayam |	atha vā satyam īśānam jñānam ānandam advayam 
MBdarsanopanisatHK-607	atyarthamamalaṃ nityamādimadhyāntavarjitam || 3 ||	atyartham amalam nityam ādi madhya anta varjitam 
MBdarsanopanisatHK-608	tathāsthūlamanākāśamasaṃspṛśyamacākṣuṣam |	tathā asthūlam an ākāśam asaṃspṛśyam acākṣuṣam 
MBdarsanopanisatHK-609	na rasaṃ na ca gandhākhyamaprameyamanūpamam || 4 ||	na rasam na ca gandha ākhyam aprameyam anūpamam 
MBdarsanopanisatHK-610	ātmānaṃ saccidānandamanantaṃ brahma suvrata |	ātmānam saccidānandam anantam brahma suvrata 
MBdarsanopanisatHK-611	ahamasmītyabhidhyāyeddehātītaṃ vimuktaye || 5 ||	aham asmi iti abhidhyāyet deha atītam vimuktaye 
MBdarsanopanisatHK-612	arthajātamatītya jñaptimātratayā vartate iti atyartham || 3 ||	artha jātam atītya jñapti mātra tayā vartate iti atyartham 
MBdarsanopanisatHK-613	anākāśamityādipañcaviśeṣaṇataḥ pañcabhūtavailakṣaṇyamuktaṃ	an ākāśam ityādi pañca viśeṣaṇataḥ pañcabhūta vailakṣaṇyam uktam 
MBdarsanopanisatHK-614	bhavati || 4-6 ||	bhavati 
MBdarsanopanisatHK-615	dhyānaphalam	dhyāna phalam 
MBdarsanopanisatHK-616	evamabhyāsayuktasya puruṣasya mahātmanaḥ |	evam abhyāsa yuktasya puruṣasya mahātmanaḥ 
MBdarsanopanisatHK-617	kramādvedāntavijñānaṃ vijāyeta na saṃśayaḥ || 6 ||	kramāt vedānta vijñānam vijāyeta na saṃśayaḥ 
MBdarsanopanisatHK-618	iti navamaḥ khaṇḍaḥ	iti navamaḥ khaṇḍaḥ 
MBdarsanopanisatHK-619	daśamaḥ khaṇḍaḥ	daśamaḥ khaṇḍaḥ 
MBdarsanopanisatHK-620	samādhisvarūpam	          
MBdarsanopanisatHK-621	athātaḥ saṃpravakṣyāmi samādhiṃ bhavanāśanam |	atha atas saṃpravakṣyāmi samādhim bhava nāśanam 
MBdarsanopanisatHK-622	samādhiḥ saṃvidutpattiḥ parajīvaikatāṃ prati || 1 ||	            
MBdarsanopanisatHK-623	nityaḥ sarvagato hyātmā kūṭastho doṣavarjitaḥ |	nityaḥ sarva gataḥ hi ātmā kūṭasthaḥ doṣa varjitaḥ 
MBdarsanopanisatHK-624	ekaḥ san bhidyate bhrāntyā māyayā na svarūpataḥ || 2 ||	ekaḥ san bhidyate bhrāntyā māyayā na svarūpataḥ 
MBdarsanopanisatHK-625	p. 184) tasmādadvaitamevāsti na prapañco na saṃsṛtiḥ |	tasmāt advaitam eva asti na prapañcaḥ na saṃsṛtiḥ 
MBdarsanopanisatHK-626	tathākāśo ghaṭākāśo maṭhākāśa itīritaḥ || 3 ||	tathā ākāśaḥ ghaṭa ākāśaḥ maṭha ākāśaḥ iti īritaḥ 
MBdarsanopanisatHK-627	tathā bhrāntairdvidhā prokto hyātmā jīveśvarātmanā |	tathā bhrāntaiḥ dvidhā proktaḥ hi ātmā jīva īśvara ātmanā 
MBdarsanopanisatHK-628	nāhaṃ deho na ca prāṇo nendriyāṇi mano na hi || 4 ||	na aham dehaḥ na ca prāṇaḥ na indriyāṇi manaḥ na hi 
MBdarsanopanisatHK-629	sadā sākṣisvarūpatvācchiva evāsmi kevalaḥ |	sadā sākṣi sva rūpa tvāt śivaḥ eva asmi kevalaḥ 
MBdarsanopanisatHK-630	iti dhīryā muniśreṣṭha sā samādhirihocyate || 5 ||	iti dhīḥ yā muni śreṣṭha sā samādhiḥ iha ucyate 
MBdarsanopanisatHK-631	dhyānaprakāramuktvā samādhiprakāramāha- atheti || 1-2 ||	dhyāna prakāram uktvā samādhi prakāram āha atha iti 
MBdarsanopanisatHK-632	yasmādevaṃ tasmāt | yathākāśa eva ghaṭākāśaḥ || 3-6 ||	yasmāt evam tasmāt yathā ākāśaḥ eva ghaṭa ākāśaḥ 
MBdarsanopanisatHK-633	brahmamātrāvaśeṣaḥ	brahmamātrā avaśeṣaḥ 
MBdarsanopanisatHK-634	so'haṃ brahma na saṃsārī na matto'nyaḥ kadācana |	saḥ ham brahma na saṃsārī na mattaḥ nyaḥ kadācana 
MBdarsanopanisatHK-635	yathā phenataraṅgādi samudrādutthitaṃ punaḥ || 6 ||	yathā phena taraṅga ādi samudrāt utthitam punar 
MBdarsanopanisatHK-636	samudre līyate tadvat jaganmayyanulīyate |	samudre līyate tadvat jagat mayi anulīyate 
MBdarsanopanisatHK-637	tasmānmanaḥ pṛthaṅ nāsti jaganmāyā ca nāsti hi || 7 ||	tasmāt manaḥ pṛthak nā asti jagat māyā ca nā asti hi 
MBdarsanopanisatHK-638	yasyaiva paramātmāyaṃ pratyagbhūtaḥ prakāśitaḥ |	yasya eva paramātmā ayam pratyak bhūtaḥ prakāśitaḥ 
MBdarsanopanisatHK-639	sa tu yāti ca puṃbhāvaṃ svayaṃ sākṣāt parāmṛtam || 8 ||	sa tu yāti ca puṃbhāvam svayam sākṣāt para amṛtam 
MBdarsanopanisatHK-640	yadā manasi caitanyaṃ bhāti sarvatragaṃ sadā |	yadā manasi caitanyam bhāti sarvatragam sadā 
MBdarsanopanisatHK-641	yogino'vyavadhānena tadā saṃpadyate svayam || 9 ||	tadā saṃpadyate svayam 
MBdarsanopanisatHK-642	yadā sarvāṇi bhūtāni svātmanyeva hi paśyati |	yadā sarvāṇi bhūtāni sva ātmani eva hi paśyati 
MBdarsanopanisatHK-643	sarvabhūteṣu cātmānaṃ brahma saṃpadyate tadā || 10 ||	sarva bhūteṣu ca ātmānam brahma saṃpadyate tadā 
MBdarsanopanisatHK-644	p. 185) yadā sarvāṇi bhūtāni samādhistho na paśyati |	yadā sarvāṇi bhūtāni samādhi sthaḥ na paśyati 
MBdarsanopanisatHK-645	ekībhūtaḥ pareṇāsau tadā bhavati kevalaḥ || 11 ||	ekībhūtaḥ pareṇa asau tadā bhavati kevalaḥ 
MBdarsanopanisatHK-646	yadā paśyati cātmānaṃ kevalaṃ paramārthataḥ |	yadā paśyati ca ātmānam kevalam paramārthataḥ 
MBdarsanopanisatHK-647	māyāmātraṃ jagat kṛtsnaṃ tadā bhavati nirvṛtiḥ || 12 ||	māyā mātram jagat kṛtsnam tadā bhavati nirvṛtiḥ 
MBdarsanopanisatHK-648	yasmādevaṃ tasmāt manaḥ mattaḥ pṛthak nāsti || 7 ||	yasmāt evam tasmāt manaḥ mattaḥ pṛthak na asti  /
MBdarsanopanisatHK-649	pratyakparacitorekatvāt svayam ityādi | svātiriktaprapañce māyāmātrapadaṃ	pratyak para citoḥ eka tvāt svayam ityādi sva atirikta prapañce māyā mātra padam 
MBdarsanopanisatHK-650	gate svayameva niṣpratiyogikabrahmamātramavaśiṣyate iti	gate svayam eva niṣpratiyogika brahma mātram avaśiṣyate iti 
MBdarsanopanisatHK-651	darśanopaniṣatphalito'rthaḥ || 8-12 ||	        
MBdarsanopanisatHK-652	upasaṃhāraḥ	upasaṃhāraḥ 
MBdarsanopanisatHK-653	evamuktvā sa bhagavān dattātreyo mahāmuniḥ |	evam uktvā sa bhagavān dattātreyaḥ mahā muniḥ 
MBdarsanopanisatHK-654	sāṃkṛtiḥ svasvarūpeṇa sukhamāste'tinirbhayaḥ || 13 ||	sāṃkṛtiḥ sva svarūpeṇa sukham āsta iti nirbhayaḥ 
MBdarsanopanisatHK-655	iti ||	iti 
MBdarsanopanisatHK-656	ākhyāyikāmupasaṃharati- evamiti | iti śabdo	ākhyāyikām upasaṃharati evam iti iti 
MBdarsanopanisatHK-657	darśanopaniṣaṭparisamāptyarthaḥ || 13 ||	          
MBdarsanopanisatHK-658	iti daśamaḥ khaṇḍaḥ	iti daśamaḥ khaṇḍaḥ 
MBdarsanopanisatHK-659	śrīvāsudevendraśiṣyopaniṣadbrahmayoginā |	              
MBdarsanopanisatHK-660	darśanopaniṣadvyākhyā likhitā brahmamātragā ||	darśana upaniṣad vyākhyā likhitā brahma mātra gā 
MBdarsanopanisatHK-661	darśanopaniṣadvyākhyāgranthastu dviśataṃ smṛtaḥ ||	darśana upaniṣad vyākhyā granthaḥ tu dviśatam smṛtaḥ 
MBdarsanopanisatHK-662	iti śrīmadīśādyaṣṭottaraśatopaniṣacchāstravivaraṇe	iti śrīmat īśa ādi aṣṭottaraśata upaniṣad śāstra vivaraṇe 
MBdarsanopanisatHK-663	navatisaṃkhyāpūrakaṃ darśanopaniṣadvivaraṇaṃ saṃpūraṇam	navati saṃkhyā pūrakam darśana upaniṣad vivaraṇam saṃpūraṇam 
MBdarsanopanisatHK-664	MUKTABODHA INDOLOGICAL RESEARCH INSTITUTE©2011 Muktabodha Indological Research Institute  All Rights Reserved.E-texts may be viewed only online or downloaded for private study.E-texts may not, under any circumstances, be copied, republished,reproduced, distributed or sold, either in original or altered form, withoutthe express permission of Muktabodha Indological Research Institute in writing.Data-entered by the staff of Muktabodha under the direction of Mark S. G. Dyczkowski.	muktabodha indological research muktabodha indological research institute all rights reserved texts may be viewed only online or downloaded for private studye texts may not under any circumstances be copied republished reproduced distributed or sold either in original or altered form withoutthe express permission of muktabodha indological research institute in writing data entered by the staff of muktabodha under the direction of mark s g dyczkowski 
