segmentnr	original	analyzed
MBdhyaanabinduupanisatHK-0	Muktabodha E-text in UTF-8	muktabodha etext in utf
MBdhyaanabinduupanisatHK-1	###########################################################################MUKTABODHA INDOLOGICAL RESEARCH INSTITUTEwww.muktabodha.org©2011 Muktabodha Indological Research Institute  All Rights Reserved.E-texts may be viewed only online or downloaded for private study.E-texts may not, under any circumstances, be copied, republished,reproduced, distributed or sold, either in original or altered form, withoutthe express permission of Muktabodha Indological Research Institute in writing.Data-entered by the staff of Muktabodha under the direction of Mark S. G. Dyczkowski.Catalog number : M00106	muktabodha indological research muktabodha indological research institute all rights reserved texts may be viewed only online or downloaded for private studye texts may not under any circumstances be copied republished reproduced distributed or sold either in original or altered form withoutthe express permission of muktabodha indological research institute in writing data entered by the staff of muktabodha under the direction of mark s g dyczkowskicatalog number  /
MBdhyaanabinduupanisatHK-2	Uniform title: dhyānabindūpaniṣat	uniform title dhyānabindūpaniṣad 
MBdhyaanabinduupanisatHK-3	Main title: yoga upaniṣads with the commentary of śrī upaniṣad brahmayogin	main title yoga upaniṣads with the commentary of śrī upaniṣad brahmayogin 
MBdhyaanabinduupanisatHK-4	Secondary title: dhyānabindu upaniṣat	secondary title dhyānabindu upaniṣad 
MBdhyaanabinduupanisatHK-5	Commentator : brahmayogin	commentatoḥ brahmayogin 
MBdhyaanabinduupanisatHK-6	Alternate name : śrī upaniṣad brahmayogin	alternate name śrī upaniṣad brahmayogin 
MBdhyaanabinduupanisatHK-7	Editor : śāstrī mahādeva	e t itoḥ śāstrī mahādeva 
MBdhyaanabinduupanisatHK-8	Notes: Transcribed by the staff of Muktabodha under the supervision of Mark S. G. Dyczkowski.	notes transcribed by the staff muktabodha under the supervision of mark s g dyczkowski 
MBdhyaanabinduupanisatHK-9	Revision 0: June 14, 2007	revision june 
MBdhyaanabinduupanisatHK-10	Publisher : Adyar library and research centre	publisher adyar library and research centre 
MBdhyaanabinduupanisatHK-11	Publication year : 1920	publication year 
MBdhyaanabinduupanisatHK-12	Publication city : Madras	publication citi madras 
MBdhyaanabinduupanisatHK-13	Publication country : India	publication country india 
MBdhyaanabinduupanisatHK-14	dhyānabindūpaniṣat	      
MBdhyaanabinduupanisatHK-15	saha nāvavatu- iti śāntiḥ	saha nau avatu iti śāntiḥ 
MBdhyaanabinduupanisatHK-16	brahmadhyānayogamahimā	          
MBdhyaanabinduupanisatHK-17	yadi śailasamaṃ pāpaṃ vistīrṇaṃ bahuyojanam |	yadi śaila samam pāpam vistīrṇam bahu yojanam 
MBdhyaanabinduupanisatHK-18	bhidyate dhyānayogena nānyo bhedaḥ kadācana || 1 ||	bhidyate dhyāna yogena na anyaḥ bhedaḥ kadācana 
MBdhyaanabinduupanisatHK-19	bījākṣaraṃ paraṃ vindu nādaṃ tasyopari sthitam |	bījākṣaram param vindu nādam tasya upari sthitam 
MBdhyaanabinduupanisatHK-20	saśabdaścākṣare kṣīṇe niḥśabdaṃ paramaṃ padam || 2 ||	sa śabdaḥ ca akṣare kṣīṇe niḥśabdam paramam padam 
MBdhyaanabinduupanisatHK-21	anāhataṃ tu yacchabdaṃ tasya śabdasya yatparam |	anāhatam tu yat śabdam tasya śabdasya yat param 
MBdhyaanabinduupanisatHK-22	tatparaṃ vindate yastu sa yogī chinnasaṃśayaḥ || 3 ||	tat param vindate yaḥ tu sa yogī chinna saṃśayaḥ 
MBdhyaanabinduupanisatHK-23	vivaraṇam	vivaraṇam 
MBdhyaanabinduupanisatHK-24	dhyātvā yadbrahmamātraṃ te svāvaśeṣadhiyā yayuḥ |	dhyātvā yat brahma mātram te sva avaśeṣa dhiyā yayuḥ 
MBdhyaanabinduupanisatHK-25	yogatattvajñānaphalaṃ tat svamātraṃ vicintaye ||	yoga tattva jñāna phalam tat sva mātram vicintaye 
MBdhyaanabinduupanisatHK-26	iha khalu kṛṣṇayajurvedapravibhakteyaṃ dhyānabindūpaniṣat	iha khalu kṛṣṇayajurveda pravibhaktā iyam dhyānabindu upaniṣad 
MBdhyaanabinduupanisatHK-27	nirviśeṣabrahmamātraparyavasannāntaḥpraṇavārthaprakāśinī	                 
MBdhyaanabinduupanisatHK-28	tadupāyājapāhaṃsavidyātadupāyaṣaḍaṅgayogaprakāśinī ca satī	tad upāya ajapā haṃsa vidyā tad upāya ṣaḍaṅga yoga prakāśinī ca satī 
MBdhyaanabinduupanisatHK-29	pravṛttā | tasyāḥ svalpagranthato vivaraṇamārabhyate | tasyāḥ	pravṛttā tasyāḥ su alpa granthataḥ vivaraṇam ārabhyate tasyāḥ 
MBdhyaanabinduupanisatHK-30	upodghātādikaṃ kaṭhavallyādivat ūhyam | śrutirādau tāvat	upodghāta ādikam kaṭhavallī ādi vat ūhyam śrutiḥ ādau tāvat 
MBdhyaanabinduupanisatHK-31	dhyānayogasāmānyamukhyaphalaprakaṭanapūrvakaṃ	dhyāna yoga sāmānya mukhya phala prakaṭana pūrvakam 
MBdhyaanabinduupanisatHK-32	nirviśeṣabrahmasvarūpaṃ prakāśayati- yadīti |	nirviśeṣa brahma svarūpam prakāśayati yadi iti 
MBdhyaanabinduupanisatHK-33	p. 187) yasya kasyacidyogino'nantakoṭijanmasaṃcitaṃ vistīrṇaṃ	yasya kasyacid yoginaḥ ananta koṭi janma saṃcitam vistīrṇam 
MBdhyaanabinduupanisatHK-34	bahuyojanaṃ yadi śailamasaṃ pāpaṃ durbhedaṃ vidyate tadā tadapi	bahu yojanam yadi śailamasam pāpam durbhedam vidyate tadā tat api 
MBdhyaanabinduupanisatHK-35	vajraṭaṅkopabrahmadhyānayogena bhidyate tilaśaśchidyate |	vajra ṭaṅka upabrahma dhyāna yogena bhidyate tilaśas chidyate 
MBdhyaanabinduupanisatHK-36	itthaṃbhūtadhyānayogaṃ vinā kadācana nānyo bhedo	itthaṃbhūta dhyāna yogam vinā kadācana na anyaḥ 
MBdhyaanabinduupanisatHK-37	bhedako'stītyarthaḥ || 1 || evaṃ dhyānayogaṃ dhyeyasvarūpamāha- bījeti |	                                                                                      
MBdhyaanabinduupanisatHK-38	praṇavo hi bījākṣaraṃ akārokāramakārārdhamātrātmakaṃ tatparaṃ tu	praṇavaḥ hi bījākṣaram akāra ukāra makāra ardha mātrā ātmakam tat param tu 
MBdhyaanabinduupanisatHK-39	bindunādakalākalātītam | yaḥ evaṃviśeṣaṇaviśiṣṭaḥ śabdaprapañcaḥ	bindu nāda kalā kalā atītam yaḥ evam viśeṣaṇa viśiṣṭaḥ śabda prapañcaḥ 
MBdhyaanabinduupanisatHK-40	praṇavaḥ tasyopari nirviśeṣatayā yat sthitaṃ tat niḥśabdamityarthaḥ |	praṇavaḥ tasya upari nirviśeṣa tayā yat sthitam tat niḥśabdam iti arthaḥ 
MBdhyaanabinduupanisatHK-41	saśabdaḥ praṇavaḥ | caśabdaḥ tadabhidheyopalakṣaṇārthaḥ | tasmin	sa śabdaḥ praṇavaḥ caśabdaḥ tad abhidheya upalakṣaṇa arthaḥ tasmin 
MBdhyaanabinduupanisatHK-42	śabdaprapañce svādhikaraṇaparamākṣare kṣīṇe vilayamapahnavaṃ vā	śabda prapañce sva adhikaraṇa parama akṣare kṣīṇe vilayam apahnavam vā 
MBdhyaanabinduupanisatHK-43	gate sati tato yanniḥśabdaṃ brahma avaśiṣyate tadeva paramaṃ padaṃ	gate sati tatas yat niḥśabdam brahma avaśiṣyate tat eva paramam padam 
MBdhyaanabinduupanisatHK-44	videhakaivalyamityarthaḥ || 2 || evaṃvidaṃ stauti- anāhatamiti | hṛjjatvāt	videha kaivalyam iti arthaḥ     evaṃvidam stauti anāhatam iti hṛd ja tvāt 
MBdhyaanabinduupanisatHK-45	nityatvādvā anāhatam | tuśabdo nityatvakhyāpanārthaḥ | tathāca	nitya tvāt vā anāhatam tuśabdaḥ nitya tva khyāpana arthaḥ tathā ca 
MBdhyaanabinduupanisatHK-46	bhāṣyavārttikakaroktiḥ nityo hyoṃkāraḥ iti, oṃkārasya tu nityatvāt	bhāṣya vārttika kara uktiḥ nityaḥ hi oṃkāraḥ iti oṃkārasya tu nitya tvāt 
MBdhyaanabinduupanisatHK-47	nāñjasotpattiriṣyate iti, ca | yacchabdaṃ śabdātmakapraṇavarūpaṃ vidyate	na añjasā utpattiḥ iṣyate iti ca yat śabdam śabda ātmaka praṇava rūpam vidyate 
MBdhyaanabinduupanisatHK-48	tasya śabdasya yat paraṃ vyaṣṭisamaṣṭisākṣirūpaṃ tat paraṃ nirviśeṣaṃ	tasya śabdasya yat param vyaṣṭi samaṣṭi sākṣi rūpam tat param nirviśeṣam 
MBdhyaanabinduupanisatHK-49	brahma yastu yo vā ko vā svāmātramiti vindate saḥ yogī chinnasaṃśayo	brahma yaḥ tu yaḥ vā kaḥ vā svā mātram iti vindate saḥ yogī chinna saṃśayaḥ 
MBdhyaanabinduupanisatHK-50	videhamukto bhavati || 3 ||	videha muktaḥ bhavati 
MBdhyaanabinduupanisatHK-51	brahmaṇaḥ sūkṣmatvaṃ sarvavyāpakatvaṃ ca	brahmaṇaḥ sūkṣma tvam sarva vyāpaka tvam ca 
MBdhyaanabinduupanisatHK-52	vālāgraśatasāhasraṃ tasya bhāgasya bhāginaḥ |	vāla agra śata sāhasram tasya bhāgasya bhāginaḥ 
MBdhyaanabinduupanisatHK-53	tasya bhāgasya bhāgārdhaṃ tatkṣaye tu nirañjanam || 4 ||	tasya bhāgasya bhāga ardham tad kṣaye tu nirañjanam 
MBdhyaanabinduupanisatHK-54	puṣpamadhye yathā gandhaḥ payomadhye yathā ghṛtam |	puṣpa madhye yathā gandhaḥ payaḥ madhye yathā ghṛtam 
MBdhyaanabinduupanisatHK-55	tilamadhye yathā tailaṃ pāṣāṇeṣviva kāñcanam || 5 ||	tila madhye yathā tailam pāṣāṇeṣu iva kāñcanam 
MBdhyaanabinduupanisatHK-56	evaṃ sarvāṇi bhūtāni maṇau sūtra ivātmani |	evam sarvāṇi bhūtāni maṇau sūtre iva ātmani 
MBdhyaanabinduupanisatHK-57	sthirabuddhirasaṃmūḍho brahmavidbrahmaṇi sthitaḥ || 6 ||	sthira buddhiḥ asaṃmūḍhaḥ brahma vid brahmaṇi sthitaḥ 
MBdhyaanabinduupanisatHK-58	p. 188) tilānāṃ tu yathā tailaṃ puṣpe gandha ivāśritaḥ |	tilānām tu yathā tailam puṣpe gandhaḥ iva āśritaḥ 
MBdhyaanabinduupanisatHK-59	puruṣasya śarīre tu sabāhyābhyantare sthitaḥ || 7 ||	puruṣasya śarīre tu sa bāhya abhyantare sthitaḥ 
MBdhyaanabinduupanisatHK-60	vṛkṣaṃ tu sakalaṃ vidyācchādyā tasyaiva niṣkalā |	vṛkṣam tu sakalam vidyāt chādyā tasya eva niṣkalā 
MBdhyaanabinduupanisatHK-61	sakale niṣkale bhāve sarvatrātmā vyavasthitaḥ || 8 ||	sakale niṣkale bhāve sarvatra ātmā vyavasthitaḥ 
MBdhyaanabinduupanisatHK-62	itthaṃbhūtayogigamyabrahmaṇo nirviśeṣatvena	itthaṃbhūta yogi gamya brahmaṇaḥ nirviśeṣa tvena 
MBdhyaanabinduupanisatHK-63	paramasūkṣmatāmāha- vālāgreti | vālāgraṃ nīvāraśūkaṃ	parama sūkṣmatām āha vāla agra iti vāla agram nīvāra śūkam 
MBdhyaanabinduupanisatHK-64	dṛśyādṛśyatayā sthitasusūkṣmaṃ, tasya śatasāhasraṃ	dṛśya a dṛśya tayā sthita su sūkṣmam tasya śata sāhasram 
MBdhyaanabinduupanisatHK-65	lakṣaikāṃśasūkṣmaṃ jīvacaitanyaṃ sūkṣmaṃ	          
MBdhyaanabinduupanisatHK-66	vyaṣṭiprapañcavyāpakatvāt, tasya jīvacaitanyagatasūkṣmasya	vyaṣṭi prapañca vyāpaka tvāt tasya jīva caitanya gata sūkṣmasya 
MBdhyaanabinduupanisatHK-67	śatasahasraikabhāgayuktamīśvaracaitanyaṃ sūkṣmataraṃ	śata sahasra eka bhāga yuktam īśvara caitanyam sūkṣmataram 
MBdhyaanabinduupanisatHK-68	samaṣṭyaṇḍavyāpakatvāt, tasyaivaṃ bhāginaḥ īśvarasya bhāgārdhaṃ	samaṣṭi aṇḍa vyāpaka tvāt tasya evam bhāginaḥ īśvarasya bhāga ardham 
MBdhyaanabinduupanisatHK-69	pañcāśatsahasraikabhāgarūpaṃ sākṣicaitanyaṃ sūkṣmatamaṃ	pañcāśat sahasra eka bhāga rūpam sākṣi caitanyam sūkṣmatamam 
MBdhyaanabinduupanisatHK-70	svāvidyāpadatatkāryavyāpakatvāt,	               
MBdhyaanabinduupanisatHK-71	sākṣyasāpekṣasākṣicaitanyagatasaviśeṣakṣaye tu	sākṣya sāpekṣa sākṣi caitanya gata sa viśeṣa kṣaye tu 
MBdhyaanabinduupanisatHK-72	tatsarvakalanānirañjanaṃ añjanīyasvātiriktāsaṃbhavāt	tat sarva kalanā nirañjanam añjanīya sva atirikta asaṃbhavāt 
MBdhyaanabinduupanisatHK-73	niṣpratiyogikabrahmamātramavaśiṣyata ityarthaḥ || 4 || kathaṃ punaḥ	niṣpratiyogika brahma mātram avaśiṣyate iti arthaḥ     katham punar 
MBdhyaanabinduupanisatHK-74	sākṣiṇo'vidyāpadavyāpakatvamityata āha- puṣpeti | puṣpatilapāṣāṇeṣu	sākṣiṇaḥ vidyā pada vyāpaka tvam iti atas āha puṣpa iti puṣpa tila pāṣāṇeṣu 
MBdhyaanabinduupanisatHK-75	gandhatailakāñcanaṃ yathā vyāpya vartate, yathā maṇigaṇe sūtraṃ,	gandha taila kāñcanam yathā vyāpya vartate yathā maṇi gaṇe sūtram 
MBdhyaanabinduupanisatHK-76	tathaiva jīvātmanā puruṣasya śarīre tu sabāhyābhyantare sthitaḥ || 5-7 ||	tathā eva jīvātmanā puruṣasya śarīre tu sa bāhya abhyantare sthitaḥ  /
MBdhyaanabinduupanisatHK-77	īśvarasākṣātmanā vraścanaṃ chedanamarhatīti vṛkṣaṃ tu	īśvara sākṣā ātmanā vraścanam chedanam arhati iti vṛkṣam tu 
MBdhyaanabinduupanisatHK-78	svāvidyāpadaṃ sakalamiti vidyāt | svena rūpeṇāvidyāpadavṛkṣaṃ	sva avidyā padam sakalam iti vidyāt svena rūpeṇa avidyā pada vṛkṣam 
MBdhyaanabinduupanisatHK-79	chādayatyāvṛṇotīti chāyā māyā tu niṣkalā niravayavatvāt | itthaṃ	chādayati āvṛṇoti iti chāyā māyā tu niṣkalā niravayava tvāt ittham 
MBdhyaanabinduupanisatHK-80	sakale niṣkale bhāve	sakale niṣkale bhāve 
MBdhyaanabinduupanisatHK-81	vṛkṣachāyāsthānīyasvāvidyāpadataddhetumāyātattve sarvatra tatkārye	                                                                   
MBdhyaanabinduupanisatHK-82	ca paramātmā vyavasthitaḥ vyāpya sthitaḥ, antarbahiśca tatsarvaṃ vyāpya	ca paramātmā vyavasthitaḥ vyāpya sthitaḥ antar bahis ca tat sarvam vyāpya 
MBdhyaanabinduupanisatHK-83	nārāyaṇaḥ sthitaḥ iti śruteḥ | yadvā- sakale jīvādisākṣyante niṣkale	nārāyaṇaḥ sthitaḥ iti śruteḥ yat vā sakale jīva ādi sākṣi ante niṣkale 
MBdhyaanabinduupanisatHK-84	bhāve- ityatra dvitīyārthe saptamī- niṣkalabhāvaṃ gate purā	bhāve iti atra dvitīyā arthe saptamī niṣkala bhāvam gate purā 
MBdhyaanabinduupanisatHK-85	svājñadaśāyāṃ sarvatra svātiriktaṃ yadanubhūtaṃ tadātmaiva	sva ajña daśāyām sarvatra sva atiriktam yat anubhūtam tat ātmā eva 
MBdhyaanabinduupanisatHK-86	svamātraṃ vyavasthito bhavatītyarthaḥ || 8 ||	sva mātram vyavasthitaḥ bhavati iti arthaḥ 
MBdhyaanabinduupanisatHK-87	"p. 189) 			praṇavasvarūpam"	praṇava svarūpam 
MBdhyaanabinduupanisatHK-88	omityekākṣaraṃ brahma dhyeyaṃ sarvaṃ mumukṣubhiḥ |	om iti ekākṣaram brahma dhyeyam sarvam mumukṣubhiḥ 
MBdhyaanabinduupanisatHK-89	pṛthivyagniśca ṛgvedo bhūrityeva pitāmahaḥ || 9 ||	pṛthivī agniḥ ca ṛgvedaḥ bhūḥ iti eva pitāmahaḥ 
MBdhyaanabinduupanisatHK-90	akāre tu layaṃ prāpte prathame praṇavāṃśake |	akāre tu layam prāpte prathame praṇava aṃśake 
MBdhyaanabinduupanisatHK-91	antarikṣaṃ yajurvāyurbhuvo viṣṇurjanārdanaḥ || 10 ||	antarikṣam yajuḥ vāyuḥ bhuvaḥ viṣṇuḥ janārdanaḥ 
MBdhyaanabinduupanisatHK-92	ukāre tu layaṃ prāpte dvitīye praṇavāṃśake |	ukāre tu layam prāpte dvitīye praṇava aṃśake 
MBdhyaanabinduupanisatHK-93	dyauḥ sūryaḥ sāmavedaśca svarityeva maheśvaraḥ || 11 ||	dyauḥ sūryaḥ sāmavedaḥ ca svar iti eva maheśvaraḥ   
MBdhyaanabinduupanisatHK-94	makāre tu layaṃ prāpte tṛtīye praṇavāṃśake |	makāre tu layam prāpte tṛtīye praṇava aṃśake 
MBdhyaanabinduupanisatHK-95	akāraḥ pītavarṇaḥ syādrajoguṇa udīritaḥ || 12 ||	akāraḥ pīta varṇaḥ syāt rajaḥ guṇaḥ udīritaḥ 
MBdhyaanabinduupanisatHK-96	ukāraḥ sāttvikaḥ śuklo makāraḥ kṛṣṇatāmasaḥ |	ukāraḥ sāttvikaḥ śuklaḥ makāraḥ kṛṣṇa tāmasaḥ 
MBdhyaanabinduupanisatHK-97	aṣṭāṅgaṃ ca catuṣpādaṃ tristhānaṃ pañcadaivatam || 13 ||	aṣṭa aṅgam ca catuṣpādam tri sthānam pañca daivatam 
MBdhyaanabinduupanisatHK-98	oṃkāraṃ yo na jānāti brāhmaṇo na bhavettu saḥ |	oṃkāram yaḥ na jānāti brāhmaṇaḥ na bhavet tu saḥ 
MBdhyaanabinduupanisatHK-99	tadarthaṃ mumukṣubhiḥ kiṃ dhyeyamityata āha- omiti | tasya	tad artham mumukṣubhiḥ kim dhyeyam iti atas āha om iti tasya 
MBdhyaanabinduupanisatHK-100	sarvāpavādādhikaraṇatāmāha- pṛthivīti || 9 || prāpte iti saptamī	sarva apavāda adhikaraṇa tām āha pṛthivī iti    prāpte iti saptamī 
MBdhyaanabinduupanisatHK-101	prathamārthā | pṛthivyādiḥ praṇavaprathamāṃśākāre vilayaṃ prāpto	                     
MBdhyaanabinduupanisatHK-102	bhavatītyuktyā saṃbhūtisthitirapi tatreti dyotyate | tathā ca antarīkṣādiḥ	bhavati iti uktyā saṃbhūti sthitiḥ api tatra iti dyotyate tathā ca antarīkṣa ādiḥ 
MBdhyaanabinduupanisatHK-103	dyaurādiśca krameṇa ukāre makāre ca saṃbhūtisthitipralayaṃ	dyauḥ ādiḥ ca krameṇa ukāre makāre ca saṃbhūti sthiti pralayam 
MBdhyaanabinduupanisatHK-104	prāpnotītyarthaḥ,	prāpnoti iti arthaḥ 
MBdhyaanabinduupanisatHK-105	akāre līyate brahmā ukāre līyate hariḥ |	akāre līyate brahmā ukāre līyate hariḥ 
MBdhyaanabinduupanisatHK-106	makāre līyate rudraḥ praṇavo hi paraḥ smṛtaḥ ||	makāre līyate rudraḥ praṇavaḥ hi paraḥ smṛtaḥ 
MBdhyaanabinduupanisatHK-107	ityādi śruteḥ || 10-11 || akārādipraṇavamātrāṇāṃ triguṇānvitatvena	ityādi śruteḥ    akāra ādi praṇava mātrāṇām triguṇa anvita tvena 
MBdhyaanabinduupanisatHK-108	pītādivarṇavaiśiṣṭyamucyate- akāra iti || 12 ||	pīta ādi varṇa vaiśiṣṭyam ucyate akāraḥ iti 
MBdhyaanabinduupanisatHK-109	aṅgapādasthānadevatāviśiṣṭapraṇavajñānājñānābhyāṃ	aṅga pāda sthāna devatā viśiṣṭa praṇava jñāna ajñānābhyām 
MBdhyaanabinduupanisatHK-110	p. 190) brāhmaṇānāṃ brāhmaṇatvaṃ bhavedityāha- aṣṭāṅgamiti |	brāhmaṇānām brāhmaṇa tvam bhavet iti āha aṣṭāṅgam iti 
MBdhyaanabinduupanisatHK-111	akārokāramakārabindunādakalākalātītatatparabhedenāṣṭāvaṅgāni	akāra ukāra makāra bindu nāda kalā kalā atīta tad para bhedena aṣṭāvaṅgāni 
MBdhyaanabinduupanisatHK-112	yasya taṃ, viśvataijasaprājñaturīyabhedena vyaṣṭau, samaṣṭau tu	yasya tam viśva taijasa prājña turīya bhedena vyaṣṭau samaṣṭau tu 
MBdhyaanabinduupanisatHK-113	virāṭsūtrabījaturyabhedena, vyaṣṭisamaṣṭyavibhāge tu	virāj sūtra bīja turya bhedena vyaṣṭi samaṣṭi avibhāge tu 
MBdhyaanabinduupanisatHK-114	otānujñātranujñaikarasāvikalpabhedena catvāraḥ pādā yasya taṃ	catvāraḥ pādāḥ yasya tam 
MBdhyaanabinduupanisatHK-115	catuṣpādaṃ, jāgradādyavasthātrayaṃ sthūlādidehatrayaṃ	catuṣpādam jāgrat ādi avasthā trayam sthūla ādi deha trayam 
MBdhyaanabinduupanisatHK-116	satvādiguṇatrayaṃ kriyāśaktyādi śaktitrayaṃ bhūtādikālatrayaṃ vā	satva ādi guṇa trayam kriyā śakti ādi śakti trayam bhūta ādi kāla trayam vā 
MBdhyaanabinduupanisatHK-117	yasya sthānamāvasathaṃ bhavati taṃ tristhānaṃ	yasya sthānam āvasatham bhavati tam tri sthānam 
MBdhyaanabinduupanisatHK-118	brahmaviṣṇurudreśvarasadāśivā yadavayavākārādidevabhāvaṃ	brahma viṣṇu rudra īśvara sadāśivāḥ yad avayava ākāra ādi deva bhāvam 
MBdhyaanabinduupanisatHK-119	prapedire taṃ pañcadaivatam || 13 || itthaṃ bhūtamoṃkāraṃ yo jānāti sa	prapedire tam pañca daivatam ittham bhūta moṃkāram yaḥ jānāti sa 
MBdhyaanabinduupanisatHK-120	brāhmaṇo brahmaniṣṭho jīvanmukto bhavet | ya evaṃ na jānāti sa	brāhmaṇaḥ brahma niṣṭhaḥ jīvanmuktaḥ bhavet yaḥ evam na jānāti sa 
MBdhyaanabinduupanisatHK-121	brāhmaṇo na bhavedityarthaḥ ||	brāhmaṇaḥ na bhavet iti arthaḥ 
MBdhyaanabinduupanisatHK-122	praṇavadhyānavidhiḥ	          
MBdhyaanabinduupanisatHK-123	praṇavo dhanuḥ śaro hyātmā brahma tallakṣyamucyate || 14 ||	praṇavaḥ dhanuḥ śaraḥ hi ātmā brahma tat lakṣyam ucyate   
MBdhyaanabinduupanisatHK-124	apramattena veddhavyaṃ śaravattanmayo bhavet |	apramattena veddhavyam śara vat tad mayaḥ bhavet 
MBdhyaanabinduupanisatHK-125	nivartante kriyāḥ sarvāstasmin dṛṣṭe parāvare || 15 ||	nivartante kriyāḥ sarvāḥ tasmin dṛṣṭe parāvare 
MBdhyaanabinduupanisatHK-126	oṃkāraprabhavā devā oṃkāraprabhavāḥ svarāḥ |	oṃkāra prabhavāḥ devāḥ oṃkāra prabhavāḥ svarāḥ 
MBdhyaanabinduupanisatHK-127	oṃkāraprabhavaṃ sarvaṃ trailokyaṃ sacarācaram || 16 ||	oṃkāra prabhavam sarvam trailokyam sacarācaram 
MBdhyaanabinduupanisatHK-128	hrasvo dahati pāpāni dīrghaḥ saṃpatprado'vyayaḥ |	hrasvaḥ dahati pāpāni dīrghaḥ saṃpad pradaḥ vyayaḥ 
MBdhyaanabinduupanisatHK-129	ardhamātrāsamāyuktaḥ praṇavo mokṣadāyakaḥ || 17 ||	ardha mātrā samāyuktaḥ praṇavaḥ mokṣa dāyakaḥ 
MBdhyaanabinduupanisatHK-130	tailadhārāmivācchinnaṃ dīrghaghaṇṭāninādavat |	taila dhārām iva ācchinnam dīrgha ghaṇṭā ninādavat 
MBdhyaanabinduupanisatHK-131	avācyaṃ praṇavasyāgraṃ yastaṃ veda sa vedavit || 18 ||	avācyam praṇavasya agram yaḥ tam veda sa veda vid  /
MBdhyaanabinduupanisatHK-132	yata evamantaḥpraṇavo viśiṣṭaphaladaḥ ataḥ tatsādhanena brahma	yatas evam antar praṇavaḥ viśiṣṭa phala daḥ atas tad sādhanena brahma 
MBdhyaanabinduupanisatHK-133	jānatastadbhāvāpattiḥ niraṅkuśaṃ bhavedityāha- praṇava iti |	jānataḥ tad bhāva āpattiḥ niraṅkuśam bhavet iti āha praṇavaḥ iti 
MBdhyaanabinduupanisatHK-134	aṣṭamātrātmakāntaḥpraṇava eva dhanuriva dhanuḥ	aṣṭa mātrā ātmaka antar praṇavaḥ eva dhanuḥ iva dhanuḥ 
MBdhyaanabinduupanisatHK-135	śarasthānīyāntaḥkaraṇādhikaraṇatvāt | śaro hyātmā manaḥ	śara sthānīya antaḥkaraṇa adhikaraṇa tvāt śaraḥ hi ātmā manaḥ 
MBdhyaanabinduupanisatHK-136	vegavattaratvāccharasya | kiṃ lakṣyamityatra brahma tallakṣyamucyate	vegavattara tvāt śarasya kim lakṣyam iti atra brahma tat lakṣyam ucyate 
MBdhyaanabinduupanisatHK-137	svātmatayā lakṣyamāṇatvāt || 14 ||	sva ātma tayā lakṣyamāṇa tvāt 
MBdhyaanabinduupanisatHK-138	p. 191) tadetallakṣyam apramattena ekāgracittena veddhavyam	tat etat lakṣyam apramattena ekāgra cittena veddhavyam 
MBdhyaanabinduupanisatHK-139	antaḥpraṇavārthabrahmaivāsmītyanusaṃdhānaṃ kartavyam | evaṃ kṛte	antar praṇava artha brahmā eva asmi iti anusaṃdhānam kartavyam evam kṛte 
MBdhyaanabinduupanisatHK-140	yathā śaro lakṣyanimagno bhavati tathā tanmayo brahmaiva bhavet |	yathā śaraḥ lakṣya nimagnaḥ bhavati tathā tad mayaḥ brahmā eva bhavet 
MBdhyaanabinduupanisatHK-141	sakriyasya brahmabhāvāpattiḥ kuta ityata āha- nivartanta iti || 15 ||	sakriyasya brahma bhāva āpattiḥ kutas iti atas āha nivartante iti 
MBdhyaanabinduupanisatHK-142	parāvarapratyagabhinnabrahmadarśanasya sarvavyāpṛtinyāsapūrvakatvāt	                      
MBdhyaanabinduupanisatHK-143	brahmālambanoṃkārasya sarvāropādhikaraṇatāmāha- oṃkāreti || 16 ||	brahma ālambana uṃkārasya sarva āropa adhikaraṇatām āha oṃkāra iti 
MBdhyaanabinduupanisatHK-144	hrasvadīrghaplutatayā praṇavajapaphalamāha- hrasva iti | yadi hrasvo bhavati	hrasva dīrgha pluta tayā praṇava japa phalam āha hrasvaḥ iti yadi hrasvaḥ bhavati 
MBdhyaanabinduupanisatHK-145	sarvaṃ pāṣmānaṃ dahati amṛtatvaṃ ca gacchati | yadi dīrgho bhavati	sarvam pāṣmānam dahati amṛta tvam ca gacchati yadi dīrghaḥ bhavati 
MBdhyaanabinduupanisatHK-146	mahatīṃ śriyamāpnoti amṛtatvaṃ ca gacchati | yadi pluto bhavati	mahatīm śriyam āpnoti amṛta tvam ca gacchati yadi plutaḥ bhavati 
MBdhyaanabinduupanisatHK-147	jñānavān bhavati  amṛtatvaṃ ca gacchati iti śruteḥ || 17 ||	jñānavān bhavati amṛta tvam ca gacchati iti śruteḥ  /
MBdhyaanabinduupanisatHK-148	praṇavāgrajñānaphalamāha- taileti || 18 ||	praṇava agra jñāna phalam āha taila iti 
MBdhyaanabinduupanisatHK-149	prāṇāyāmapūrvakaṃ praṇavadhyānam	           
MBdhyaanabinduupanisatHK-150	hṛtpadmakarṇikāmadhye sthiradīpanibhākṛtim |	hṛd padma karṇikā madhye sthira dīpa nibha ākṛtim 
MBdhyaanabinduupanisatHK-151	aṅguṣṭhamātramacalaṃ dhyāyedoṃkāramīśvaram || 19 ||	aṅguṣṭha mātram acalam dhyāyet oṃkāram īśvaram 
MBdhyaanabinduupanisatHK-152	iḍayā vāyumāpūrya pūrayitvodarasthitam |	iḍayā vāyum āpūrya pūrayitvā udara sthitam 
MBdhyaanabinduupanisatHK-153	oṃkāraṃ dehamadhyasthaṃ dhyāyejjvālāvalīvṛtam || 20 ||	oṃkāram deha madhya stham dhyāyet jvālā āvalī vṛtam 
MBdhyaanabinduupanisatHK-154	brahmā pūraka ityukto viṣṇuḥ kumbhaka ucyate |	brahmā pūrakaḥ iti uktaḥ viṣṇuḥ kumbhakaḥ ucyate 
MBdhyaanabinduupanisatHK-155	reco rudra iti proktaḥ prāṇāyāmasya devatāḥ || 21 ||	recaḥ rudraḥ iti proktaḥ prāṇāyāmasya devatāḥ 
MBdhyaanabinduupanisatHK-156	kathamoṃkāro dhyeya ityata āha- hṛditi || 19 || kiṃ tūṣṇīṃ	katham oṃkāraḥ dhyeyaḥ iti atas āha hṛd iti    kim tūṣṇīm 
MBdhyaanabinduupanisatHK-157	dhyātavyamityata āha- iḍayeti | mūlāgnāvagnirūpaṃ praṇavaṃ	dhyātavyam iti atas āha iḍayā iti mūlāgnau agni rūpam praṇavam 
MBdhyaanabinduupanisatHK-158	saṃdadhyāt iti śrutyunurodhena mūlādhāratrikoṇe jājvalyamānatayā	saṃdadhyāt iti śruti unurodhena mūlādhāra trikoṇe jājvalyamāna tayā 
MBdhyaanabinduupanisatHK-159	praṇavārtheśvaraṃ kumbhake'nudhyāyet || 20 ||	praṇava artha īśvaram 
MBdhyaanabinduupanisatHK-160	prāṇāyāmāvayavadevatāsvarūpamāha- brahmeti | pūrakādikāle	                                                                             
MBdhyaanabinduupanisatHK-161	brahmaviṣṇurudrān dhyāyedityarthaḥ || 21 ||	brahma viṣṇu rudrān dhyāyet iti arthaḥ 
MBdhyaanabinduupanisatHK-162	"p. 192)			prakārāntareṇa praṇavadhyānam"	prakāra antareṇa praṇava dhyānam 
MBdhyaanabinduupanisatHK-163	ātmānamaraṇiṃ kṛtvā praṇavaṃ cottarāraṇim |	ātmānam araṇim kṛtvā praṇavam ca uttarāraṇim 
MBdhyaanabinduupanisatHK-164	dhyānanirmathanābhyāsādevaṃ paśyennigūḍhavat || 22 ||	dhyāna nirmathana abhyāsāt evam paśyet nigūḍha vat 
MBdhyaanabinduupanisatHK-165	oṃkāradhvaninādena vāyoḥ saṃharaṇāntikam |	oṃkāra dhvani nādena vāyoḥ saṃharaṇa antikam 
MBdhyaanabinduupanisatHK-166	yāvadbalaṃ samādadhyāt samyaṅnādalayāvadhi || 23 ||	yāvadbalam samādadhyāt samyak nāda laya avadhi 
MBdhyaanabinduupanisatHK-167	gamāgamasthaṃ gamanādiśūnyamoṃkāramekaṃ ravikoṭidīptam |	gama āgama stham gamana ādi śūnyam oṃkāram ekam ravi koṭi dīptam 
MBdhyaanabinduupanisatHK-168	paśyanti ye sarvajanāntarasthaṃ haṃsātmakaṃ te virajā bhavanti || 24 ||	paśyanti ye sarva jana antara stham haṃsa ātmakam te virajāḥ bhavanti 
MBdhyaanabinduupanisatHK-169	vidhāntareśvaradhyānamāha- ātmānamiti | ātmānam	vidhā antara īśvara dhyānam āha ātmānam iti ātmānam 
MBdhyaanabinduupanisatHK-170	antaḥkaraṇam adharāraṇiṃ kṛtvā praṇavamuttarāraṇiṃ	antaḥkaraṇam adharāraṇim kṛtvā praṇavam uttarāraṇim 
MBdhyaanabinduupanisatHK-171	praṇavoccāraṇapūrvakaṃ praṇavārthabrahmāhamasmīti paunaḥ-	praṇava uccāraṇa pūrvakam praṇava artha brahmā aham asmi iti paunar 
MBdhyaanabinduupanisatHK-172	punyenānusaṃdhānaṃ dhyānanirmathanābhyāsaḥ tasmāt	punyena anusaṃdhānam dhyāna nirmathana abhyāsaḥ tasmāt 
MBdhyaanabinduupanisatHK-173	nigūḍhakalaśāntadīpavat evaṃ ātmānamayamahamasmīti paśyet	nigūḍha kalaśa anta dīpa vat evam ātmānam ayam aham asmi iti paśyet 
MBdhyaanabinduupanisatHK-174	avalokayedityarthaḥ || 22 ||	avalokayet iti arthaḥ 
MBdhyaanabinduupanisatHK-175	praṇavoccāraṇapraṇavanādāvasānavidyotabrahmadarśanaphalamāha-	                                                                                     
MBdhyaanabinduupanisatHK-176	oṃkāreti |	oṃkāra iti 
MBdhyaanabinduupanisatHK-177	yāvadbalamoṃkāroccāraṇaprabhavanādavāyuvilayādhikaraṇatayā yat	yāvadbalam oṃkāra uccāraṇa prabhava nāda vāyu vilaya adhikaraṇa tayā yat 
MBdhyaanabinduupanisatHK-178	vibhāti tat svājñadṛṣṭyā	vibhāti tat sva ajña dṛṣṭyā 
MBdhyaanabinduupanisatHK-179	gamanāgamanalakṣaṇanādarūpaprāṇopādhisthamiva bhātamapi	gamana āgamana lakṣaṇa nāda rūpa prāṇa upādhi stham iva bhātam api 
MBdhyaanabinduupanisatHK-180	svajñadṛṣṭyā gamanādiśūnyaṃ anantakoṭiraviprabhaṃ sarvāntaraṃ	svajña dṛṣṭyā gamana ādi śūnyam ananta koṭi ravi prabham sarva antaram 
MBdhyaanabinduupanisatHK-181	haṃsātmakaṃ pratyagabhinnabrahmarūpaṃ ye paśyanti te virajāḥ	haṃsa ātmakam pratyak abhinna brahma rūpam ye paśyanti te virajāḥ 
MBdhyaanabinduupanisatHK-182	kṛtakṛtyā bhavantītyarthaḥ || 23-24 ||	kṛtakṛtyāḥ bhavanti iti arthaḥ 
MBdhyaanabinduupanisatHK-183	saviśeṣabrahmadhyānam	            
MBdhyaanabinduupanisatHK-184	yanmanastrijagatsṛṣṭisthitipralayakarmakṛt |	yat manaḥ trijagat sṛṣṭi sthiti pralaya karma kṛt 
MBdhyaanabinduupanisatHK-185	tanmano vilayaṃ yāti tadviṣṇoḥ paramaṃ padam || 25 ||	tat manaḥ vilayam yāti tat viṣṇoḥ paramam padam 
MBdhyaanabinduupanisatHK-186	aṣṭapatraṃ tu hṛtpadmaṃ dvātriṃśatkesarānvitam |	aṣṭa patram tu hṛd padmam dvātriṃśat kesara anvitam 
MBdhyaanabinduupanisatHK-187	tasya madhyagato bhānurbhānumadhyagataḥ śaśī || 26 ||	tasya madhya gataḥ bhānuḥ bhānu madhya gataḥ śaśī   
MBdhyaanabinduupanisatHK-188	p. 193) śaśimadhyagato vahnirvahnimadhyagatā prabhā |	śaśi madhya gataḥ vahniḥ vahni madhya gatā prabhā 
MBdhyaanabinduupanisatHK-189	prabhāmadhyagataṃ pīṭhaṃ nānāratnapraveṣṭitam || 27 ||	prabhā madhya gatam pīṭham nānā ratna praveṣṭitam 
MBdhyaanabinduupanisatHK-190	tasya madhyagataṃ devaṃ vāsudevaṃ nirañjanam |	tasya madhya gatam devam vāsudevam nirañjanam 
MBdhyaanabinduupanisatHK-191	śrīvatsakaustubhoraskaṃ muktāmaṇivibhūṣitam || 28 ||	śrīvatsa kaustubha uraskam muktāmaṇi vibhūṣitam 
MBdhyaanabinduupanisatHK-192	śuddhasphaṭikasaṃkāśaṃ candrakoṭisamaprabham |	śuddha sphaṭika saṃkāśam candra koṭi sama prabham 
MBdhyaanabinduupanisatHK-193	evaṃ dhyāyenmahāviṣṇumevaṃ vā vinayānvitaḥ || 29 ||	evam dhyāyet mahā viṣṇum evam vā vinaya anvitaḥ 
MBdhyaanabinduupanisatHK-194	brahmamātrāvaraṇaṃ manaḥ, tadapahnavato niṣpratiyogikaṃ	                    
MBdhyaanabinduupanisatHK-195	brahmamātraṃ prakāśata ityāha- yaditi || 25 || evaṃ dhyātumaśaktasya	brahma mātram prakāśate iti āha yat iti     evam dhyātum aśaktasya 
MBdhyaanabinduupanisatHK-196	yathoktalakṣaṇahṛtkamale saviśeṣabrahmadhyānaprakāramāha-	yathā ukta lakṣaṇa hṛd kamale sa viśeṣa brahma dhyāna prakāram āha 
MBdhyaanabinduupanisatHK-197	aṣṭapatramiti || 26-28 || evaṃ kalpanāsṛṣṭamityarthaḥ | evaṃ dhyānaṃ	aṣṭa patram iti     evam kalpanā sṛṣṭam iti arthaḥ evam dhyānam 
MBdhyaanabinduupanisatHK-198	kṛtaṃ cet tatprasādalabdhacittaśuddhiprāpyajñānadvārā kṛtakṛtyo bhavet	kṛtam ced tad prasāda labdha citta śuddhi prāpya jñāna dvārā kṛtakṛtyaḥ bhavet 
MBdhyaanabinduupanisatHK-199	| evaṃ kartumalasasya evaṃ vā vakṣyamāṇapūrakādau	evam kartum alasasya evam vā vakṣyamāṇa pūraka ādau 
MBdhyaanabinduupanisatHK-200	trimūrtidhyānamāha- evamiti || 29-31 ||	trimūrti dhyānam āha evam iti 
MBdhyaanabinduupanisatHK-201	trimūrtidhyānam	        
MBdhyaanabinduupanisatHK-202	atasīpuṣpasaṃkāśaṃ nābhisthāne pratiṣṭhitam |	atasī puṣpa saṃkāśam nābhi sthāne pratiṣṭhitam 
MBdhyaanabinduupanisatHK-203	caturbhujaṃ mahāviṣṇuṃ pūrakeṇa vicintayet || 30 ||	caturbhujam mahā viṣṇum pūrakeṇa vicintayet 
MBdhyaanabinduupanisatHK-204	kumbhakena hṛdi sthāne cintayet kamalāsanam |	kumbhakena hṛdi sthāne cintayet kamalāsanam 
MBdhyaanabinduupanisatHK-205	brahmāṇaṃ ratnagaurābhaṃ caturvaktraṃ pitāmaham || 31 ||	brahmāṇam ratna gaura ābham caturvaktram pitāmaham 
MBdhyaanabinduupanisatHK-206	recakena tu vidyātmā lalāṭasthaṃ trilocanam |	recakena tu vidyā ātmā lalāṭa stham trilocanam 
MBdhyaanabinduupanisatHK-207	śuddhasphaṭikasaṃkāśaṃ niṣkalaṃ pāpanāśanam || 32 ||	śuddha sphaṭika saṃkāśam niṣkalam pāpa nāśanam 
MBdhyaanabinduupanisatHK-208	vidyātmā saguṇavidyāviśiṣṭopāsakaḥ | vastuto niṣkalam || 32 ||	              
MBdhyaanabinduupanisatHK-209	"p. 194) 			hṛdaye dhyānaṃ tatphalaṃ ca"	hṛdaye dhyānam tad phalam ca 
MBdhyaanabinduupanisatHK-210	abjapatramadhaḥpuṣpamūrdhvanālamadhomukham |	abja patram adhas puṣpam ūrdhva nālam adhomukham 
MBdhyaanabinduupanisatHK-211	kadalīpuṣpasaṃkāśaṃ sarvavedamayaṃ śivam || 33 ||	kadalī puṣpa saṃkāśam sarva veda mayam śivam 
MBdhyaanabinduupanisatHK-212	śatābdaṃ śatapatrāḍhyaṃ viprakīrṇābjakarṇikam |	śata abdam śata patra āḍhyam viprakīrṇa abja karṇikam 
MBdhyaanabinduupanisatHK-213	tatrārkacandravahnīnāmuparyupari cintayet || 34 ||	tatra arka candra vahnīnām upari upari cintayet 
MBdhyaanabinduupanisatHK-214	padmasyodghāṭanaṃ kṛtvā sūryacandrāgnivarcasaḥ |	padmasya udghāṭanam kṛtvā sūrya candra agni varcasaḥ 
MBdhyaanabinduupanisatHK-215	tasya hṛdbījamāhṛtya ātmānaṃ carate dhruvam || 35 ||	tasya hṛd bījam āhṛtya ātmānam carate dhruvam 
MBdhyaanabinduupanisatHK-216	tristhānaṃ ca trimārgaṃ ca tribrahma ca trayākṣaram |	tri sthānam ca tri mārgam ca tri brahma ca traya akṣaram 
MBdhyaanabinduupanisatHK-217	trimātramardhamātraṃ vā yastaṃ veda sa vedavit || 36 ||	tri mātram ardha mātram vā yaḥ tam veda sa veda vid 
MBdhyaanabinduupanisatHK-218	tailadhārāmivācchinnaṃ dīrghaghaṇṭāninādavat |	taila dhārām iva ācchinnam dīrgha ghaṇṭā ninādavat 
MBdhyaanabinduupanisatHK-219	avācyaṃ praṇavasyāgraṃ yastaṃ veda sa vedavit || 37 ||	avācyam praṇavasya agram yaḥ tam veda sa veda vid  /
MBdhyaanabinduupanisatHK-220	dhyānādhārahṛdayaṃ vidhāntareṇa varṇayati- abjeti || abjam	                    
MBdhyaanabinduupanisatHK-221	abjātam ammayaṃ śarīraṃ paritaḥ trātaya iti abjapatraṃ hṛtkamakaṃ,	ap jātam am mayam śarīram paritas trātaye iti abja patram hṛd kamakam 
MBdhyaanabinduupanisatHK-222	adhaḥpuṣpam adhobhāgakusumitatvāt, ūrdhvanālamadhomukhaṃ	adhas puṣpam adhobhāga kusumita tvāt ūrdhva nālam adhomukham 
MBdhyaanabinduupanisatHK-223	lambamānakadalīpuṣpasadṛśaṃ, sarvavedamayaṃ	lambamāna kadalī puṣpa sadṛśam sarva veda mayam 
MBdhyaanabinduupanisatHK-224	vedahetunādādhāratvāt, ata eva śivam || 33 || śatābdaṃ śatāyuḥ-	                                                    
MBdhyaanabinduupanisatHK-225	parimitasthititvāt, śatapatrāḍhyaṃ śatapatrakuśeśayopamatvāt,	parimita sthiti tvāt śata patra āḍhyam śata patra kuśeśaya upama tvāt 
MBdhyaanabinduupanisatHK-226	viprakīrṇābjakarṇikaṃ vikasitapadmakarṇikopamaṃ hṛtkamalaṃ yadasti	viprakīrṇa abja karṇikam vikasita padma karṇikā upamam hṛd kamalam yat asti 
MBdhyaanabinduupanisatHK-227	tasya lambamānasūryacandrāgnivarcasaḥ hṛtpadmasya	tasya lambamāna sūrya candra agni varcasaḥ hṛd padmasya 
MBdhyaanabinduupanisatHK-228	praṇavenodghāṭanaṃ kṛtvā ūrdhvamukhaṃ vidhāya tatra	praṇavena udghāṭanam kṛtvā ūrdhva mukham vidhāya tatra 
MBdhyaanabinduupanisatHK-229	arkacandravahnīnāṃ maṇḍalaṃ uparyupari cintayet bhāvayet | tasya	arka candra vahnīnām maṇḍalam upari upari cintayet bhāvayet tasya 
MBdhyaanabinduupanisatHK-230	hṛtpadmasya hṛdbījamakārākhyaṃ	hṛd padmasya hṛd bīja makāra ākhyam 
MBdhyaanabinduupanisatHK-231	p. 195) tadāhṛtya gṛhītvā tadrūpaṃ dhruvamātmānaṃ saṃbhāvya	tat āhṛtya gṛhītvā tad rūpam dhruvam ātmānam saṃbhāvya 
MBdhyaanabinduupanisatHK-232	tatastatrākārārtho viṣṇuścarate- padavyatyayaḥ- carati || 34-35 || evaṃ	tatas tatra ākāra arthaḥ viṣṇuḥ carate pada vyatyayaḥ carati  / evam 
MBdhyaanabinduupanisatHK-233	carantaṃ haṃsamātmānaṃ praṇavatvena cintayataḥ jīvanmuktatāmāha-	carantam haṃsam ātmānam praṇava tvena cintayataḥ jīvanmukta tām āha 
MBdhyaanabinduupanisatHK-234	tristhānamiti | avasthātrayādisthānatrayaṃ yasya taṃ, yadyāthātmyavidaḥ	tri sthānam iti avasthā traya ādi sthāna trayam yasya tam yad yāthātmya vidaḥ 
MBdhyaanabinduupanisatHK-235	svajñānānurodhena dhūmārcirādigatibhedena yat yānti taṃ trimārgaṃ,	sva jñāna anurodhena dhūma arciḥ ādi gati bhedena yat yānti tam tri mārgam 
MBdhyaanabinduupanisatHK-236	viśvavirāḍotṛbrahmādibhedena brahmatrayaṃ yadarthabhūtaṃ taṃ	viśva virāj lotṛ brahma ādi bhedena brahmatrayam yad artha bhūtam tam 
MBdhyaanabinduupanisatHK-237	tribrahmātmakaṃ, akārāditrīṇyakṣarāṇi yadavayavatayoktāni taṃ	tri brahma ātmakam akāra ādi trīṇi akṣarāṇi yad avayavatayā uktāni tam 
MBdhyaanabinduupanisatHK-238	trayākṣaraṃ, hrasvadīrghaplutabhedena tisro mātrā yasya taṃ	traya akṣaram hrasva dīrgha pluta bhedena tisraḥ mātrāḥ yasya tam 
MBdhyaanabinduupanisatHK-239	trimātramardhamātraṃ vā, yaḥ taṃ veda sa vedavit jīvanmukto	tri mātram ardha mātram vā yaḥ tam veda sa veda vid jīvanmuktaḥ 
MBdhyaanabinduupanisatHK-240	bhavatītyarthaḥ || 36 || oṃkārāgravidyotaṃ turyaturīyam iti śrutyanurodhena	bhavati iti arthaḥ     oṃkāra agra vidyotam turyaturīyam iti śruti anurodhena 
MBdhyaanabinduupanisatHK-241	praṇavāgradarśanaphalamāha- taileti || 37 ||	praṇava agra darśana phalam āha taila iti 
MBdhyaanabinduupanisatHK-242	brahmāyatane prāṇavilāpanam	brahmāyatane prāṇa vilāpanam 
MBdhyaanabinduupanisatHK-243	yathaivotpalanālena toyamākarṣayennaraḥ |	yathā eva utpala nālena toyam ākarṣayet naraḥ 
MBdhyaanabinduupanisatHK-244	tathaivotkarṣayedvāyuṃ yogī yogapathe sthitaḥ || 38 ||	tathā eva utkarṣayet vāyum yogī yoga pathe sthitaḥ 
MBdhyaanabinduupanisatHK-245	ardhamātrātmakaṃ kṛtvā kośabhūtaṃ tu paṅkajam |	ardha mātrā ātmakam kṛtvā kośa bhūtam tu paṅkajam 
MBdhyaanabinduupanisatHK-246	karṣayennālamātreṇa bhrūvormadhye layaṃ nayet || 39 ||	karṣayet nāla mātreṇa bhrūvoḥ madhye layam nayet  /
MBdhyaanabinduupanisatHK-247	bhrūmadhye tu lālāṭe tu nāsikāyāstu mūlataḥ |	bhrū madhye tu lālāṭe tu nāsikāyāḥ tu mūlataḥ 
MBdhyaanabinduupanisatHK-248	jānīyādamṛtasthānaṃ tadbrahmāyatanaṃ mahat || 40 ||	jānīyāt amṛta sthānam tat brahma āyatanam mahat 
MBdhyaanabinduupanisatHK-249	parāgvāyuṃ pratyaṅmukhaṃ nītvā brahmāyatane	parāc vāyum pratyak mukham nītvā brahma āyatane 
MBdhyaanabinduupanisatHK-250	vilāpayedityāha- yatheti | yathaiva naraḥ utpalanālena toyamākarṣayet	vilāpayet iti āha yathā iti yathā eva naraḥ utpala nālena toyam ākarṣayet 
MBdhyaanabinduupanisatHK-251	tathaiva yogī yogamārge tiṣṭhan mūlādhārāt	tathā eva yogī yoga mārge tiṣṭhan mūlādhārāt 
MBdhyaanabinduupanisatHK-252	apānaikyamāpannaprāṇavāyumūrdhvam utkarṣayet	apāna aikyam āpanna prāṇa vāyum ūrdhvam utkarṣayet 
MBdhyaanabinduupanisatHK-253	suṣumnāyāmūrdhvamukhaṃ nayet || 38 || punaḥ	suṣumnāyām ūrdhva mukham nayet      punar 
MBdhyaanabinduupanisatHK-254	sthūlasūkṣmabījabhāvamāpannaṃ dṛṣṭino'gnibhirekībhūtaṃ	sthūla sūkṣma bīja bhāvam āpannam dṛṣṭinā ugnibhiḥ ekībhūtam 
MBdhyaanabinduupanisatHK-255	kośabhūtaṃ yat hṛdayapaṅkajaṃ vartate tatra ardhamātrātmakaṃ kṛtvā	kośa bhūtam yat hṛdaya paṅkajam vartate tatra ardha mātrā ātmakam kṛtvā 
MBdhyaanabinduupanisatHK-256	suṣumnāmārgeṇa bhrūvormadhyelayaṃ nayet vilayaṃ prāpayet || 39 ||	suṣumnā mārgeṇa bhrūvoḥ madhye layam nayet vilayam prāpayet  /
MBdhyaanabinduupanisatHK-257	prāṇalayādhikaraṇaṃ kīdṛśamityata āha-	prāṇa laya adhikaraṇam kīdṛśam iti atas āha 
MBdhyaanabinduupanisatHK-258	p. 196) bhrūmadhye tviti | bhrūmadhyasya brahmopalabdhisthānatvāt |	bhrūmadhye tu iti bhrūmadhyasya brahma upalabdhi sthāna tvāt 
MBdhyaanabinduupanisatHK-259	tuśabdatrayataḥ tasmāt bahirnirgatamapi tatraiva punaḥ punaḥ layaṃ nayediti	tuśabda trayataḥ tasmāt bahis nirgatam api tatra eva punar punar layam nayet iti 
MBdhyaanabinduupanisatHK-260	dyotyate || 40 ||	dyotyate    
MBdhyaanabinduupanisatHK-261	ṣaḍaṅgayogaḥ	ṣaṣ aṅga yogaḥ 
MBdhyaanabinduupanisatHK-262	āsanaṃ prāṇasaṃrodhaḥ pratyāhāraśca dhāraṇā |	āsanam prāṇa saṃrodhaḥ pratyāhāraḥ ca dhāraṇā 
MBdhyaanabinduupanisatHK-263	dhyānaṃ samādhiretāni yogāṅgāni bhavanti ṣaṭ || 41 ||	dhyānam samādhiḥ etāni yoga aṅgāni bhavanti ṣaḍ 
MBdhyaanabinduupanisatHK-264	amṛtasthāne prāṇādilayasya suṣumnādvārakatvāt, nahi	amṛta sthāne prāṇa ādi layasya suṣumnā dvāraka tvāt nahi 
MBdhyaanabinduupanisatHK-265	suṣumnāpraveśaḥ sarvasādhāraṇo bhavati, nahi yogābhyāsaṃ vinā	suṣumnā praveśaḥ sarva sādhāraṇaḥ bhavati nahi yoga abhyāsam vinā 
MBdhyaanabinduupanisatHK-266	suṣumnāmārgaḥ spraṣṭuṃ śakyate, atastadupāyatvena ṣaḍaṅgayoga	suṣumnā mārgaḥ spraṣṭum śakyate atas tad upāya tvena ṣaḍaṅga yoga 
MBdhyaanabinduupanisatHK-267	ucyate- āsanamiti || 41 ||	ucyate āsanam iti 
MBdhyaanabinduupanisatHK-268	āsanacatuṣṭayam	āsana catuṣṭayam 
MBdhyaanabinduupanisatHK-269	āsanāni ca tāvanti yāvantyo jīvajātayaḥ |	āsanāni ca tāvanti yāvantyaḥ jīva jātayaḥ 
MBdhyaanabinduupanisatHK-270	eteṣāmatulān bhedān vijānāti maheśvaraḥ || 42 ||	eteṣām atulān bhedān vijānāti maheśvaraḥ 
MBdhyaanabinduupanisatHK-271	siddhaṃ bhadraṃ tathā siṃhaṃ padmaṃ ceti catuṣṭayam |	siddham bhadram tathā siṃham padmam ca iti catuṣṭayam 
MBdhyaanabinduupanisatHK-272	yogāsanānāmanekatvāt tatra śreṣṭhatayā	yoga āsanānām aneka tvāt tatra śreṣṭha tayā 
MBdhyaanabinduupanisatHK-273	siddhādyāsanacatuṣṭayamuddiśati- āsanānīti | asaṃkhyeyatayā	siddha ādi āsana catuṣṭayam uddiśati āsanāni iti asaṃkhyeya tayā 
MBdhyaanabinduupanisatHK-274	durvijñeyatvāt eteṣāmiti || 42 || teṣu mukhyānyāsanacatuṣṭayānītyatra	durvijñeya tvāt eteṣām iti teṣu mukhyāni āsana catuṣṭayāni iti atra 
MBdhyaanabinduupanisatHK-275	siddham iti | tatpratipādakaśrutayo likhyante-	siddham iti tad pratipādaka śrutayaḥ likhyante 
MBdhyaanabinduupanisatHK-276	yoniṃ vāmena saṃpīḍya meḍhrādupari dakṣiṇam |	yonim vāmena saṃpīḍya meḍhrāt upari dakṣiṇam 
MBdhyaanabinduupanisatHK-277	ṛjukāyaḥ samāsīnaḥ siddhāsanamidaṃ bhavet ||	ṛju kāyaḥ samāsīnaḥ siddhāsanam idam bhavet 
MBdhyaanabinduupanisatHK-278	gulphau tu vṛṣaṇasyādhaḥ sīvinyāḥ pārśvayoḥ kṣipet |	gulphau tu vṛṣaṇasya adhas sīvinyāḥ pārśvayoḥ kṣipet 
MBdhyaanabinduupanisatHK-279	pārśvapādau ca pāṇibhyāṃ dṛḍhaṃ badhvā suniścalam |	pārśva pādau ca pāṇibhyām dṛḍham badhvā su niścalam 
MBdhyaanabinduupanisatHK-280	bhadrāsanaṃ bhavedetadviṣarogavināśanam |	bhadrāsanam bhavet etat viṣa roga vināśanam 
MBdhyaanabinduupanisatHK-281	p. 197) sīvinīṃ gulphadeśābhyāṃ nipīḍya vyutkrameṇa tu |	sīvinīm gulpha deśābhyām nipīḍya vyutkrameṇa tu 
MBdhyaanabinduupanisatHK-282	prasārya jānunorhastāvāsanaṃ siṃharūpakam ||	prasārya jānunoḥ hastau āsanam siṃha rūpakam 
MBdhyaanabinduupanisatHK-283	ūrvorupari vai dhatte yadā pādatale ubhe |	ūrvoḥ upari vai dhatte yadā pāda tale ubhe 
MBdhyaanabinduupanisatHK-284	padmāsanaṃ bhavedetat sarvavyādhiviṣāpaham ||	padmāsanam bhavet etat sarva vyādhi viṣa apaham 
MBdhyaanabinduupanisatHK-285	iti ||	iti 
MBdhyaanabinduupanisatHK-286	yonisthānam	yoni sthānam 
MBdhyaanabinduupanisatHK-287	ādhāraṃ prathamaṃ cakraṃ svādhiṣṭhānaṃ dvitīyakam || 43 ||	ādhāram prathamam cakram svādhiṣṭhānam dvitīyakam 
MBdhyaanabinduupanisatHK-288	yonisthānaṃ tayormadhye kāmarūpaṃ nigadyate |	yoni sthānam tayoḥ madhye kāmarūpam nigadyate 
MBdhyaanabinduupanisatHK-289	ādhārākhye gudasthāne paṅkajaṃ yaccaturdalam || 44 ||	ādhāra ākhye guda sthāne paṅkajam yat catur dalam 
MBdhyaanabinduupanisatHK-290	tanmadhye procyate yoniḥ kāmākhyā siddhavanditā |	tad madhye procyate yoniḥ kāma ākhyā siddha vanditā 
MBdhyaanabinduupanisatHK-291	yonimadhye sthitaṃ liṅgaṃ paścimābhimukhaṃ tathā || 45 ||	yoni madhye sthitam liṅgam paścima abhimukham tathā 
MBdhyaanabinduupanisatHK-292	mastake maṇivadbhinnaṃ yo jānāti sa yogavit |	mastake maṇi vat bhinnam yaḥ jānāti sa yoga vid 
MBdhyaanabinduupanisatHK-293	tato mūlādhārasvādhiṣṭhānamadhyagatavyaṣṭiprapañcayonyādi-	tatas mūlādhāra sva adhiṣṭhāna madhya gata vyaṣṭi prapañca yoni ādi 
MBdhyaanabinduupanisatHK-294	jñānaphalaṃ ṣaḍādhārasvarūpaṃ ca viśadayati- ādhāramiti || 43 ||	jñāna phalam ṣaṣ ādhāra svarūpam ca viśadayati ādhāram iti 
MBdhyaanabinduupanisatHK-295	mūlādhārasvādhiṣṭhānamadhye yonisthānaṃ vartata ityuktam | tatra	mūlādhāra svādhiṣṭhāna madhye yoni sthānam vartate iti uktam tatra 
MBdhyaanabinduupanisatHK-296	yoniḥ kīdṛśītyata āha- ādhāreti || 44 || mūlādhāracaturdalamadhye	yoniḥ kīdṛśī iti atas āha ādhāra iti      mūlādhāra catur dala madhye 
MBdhyaanabinduupanisatHK-297	vyaṣṭisaṃsārapravṛttinivṛttihetutayā yogāyogasiddhairapi vanditā	vyaṣṭi saṃsāra pravṛtti nivṛtti hetutayā yoga ayoga siddhaiḥ api vanditā 
MBdhyaanabinduupanisatHK-298	kāmarūpiṇī nāma kācana yoniḥ kuṇḍalinīśaktiḥ vidyate | tasyāḥ	kāmarūpiṇī nāma kācana yoniḥ kuṇḍalinīśaktiḥ vidyate tasyāḥ 
MBdhyaanabinduupanisatHK-299	siddhāsiddhavanditatvaṃ kathamityatra- yadi hṛdayādūrdhvagāminī	siddha asiddha vandita tvam katham iti atra yadi hṛdayāt ūrdhva gāminī 
MBdhyaanabinduupanisatHK-300	syāttadā nivṛttimārgabhūṣaṇasiddhasevyā bhavati | yadā punaḥ	syāt tadā nivṛtti mārga bhūṣaṇa siddha sevyā bhavati yadā punar 
MBdhyaanabinduupanisatHK-301	svasthānānna calati tadā pravṛttihetutayā saṃsārisevitā bhavatītyarthaḥ |	sva sthānāt na calati tadā pravṛtti hetutayā saṃsāri sevitā bhavati iti arthaḥ 
MBdhyaanabinduupanisatHK-302	tādṛśayonimadhye kuṇḍalinīmadhyapradeśe mastakabhāge maṇivat	tādṛśa yoni madhye kuṇḍalinī madhya pradeśe mastaka bhāge maṇi vat 
MBdhyaanabinduupanisatHK-303	bhinnaṃ svayaṃ prakāśitaṃ paścimābhimukhaṃ pratyagātmaliṅgaṃ	bhinnam svayam prakāśitam paścima abhimukham pratyagātma liṅgam 
MBdhyaanabinduupanisatHK-304	vidyate | pravṛttinivṛttiprakāśakatvāt tadasmīti yo jānāti sa yogavit	vidyate pravṛtti nivṛtti prakāśaka tvāt tat asmi iti yaḥ jānāti sa yoga vid 
MBdhyaanabinduupanisatHK-305	pratyakparaikyajño jīvanmukto bhavatītyarthaḥ || 45-46 ||	           
MBdhyaanabinduupanisatHK-306	"p. 198) 		mūlādhārādicatuścakrasvarūpam"	            
MBdhyaanabinduupanisatHK-307	taptacāmīkarākāraṃ taḍillekheva visphurat || 46 ||	tapta cāmīkara ākāram taḍit lekhā iva visphurat 
MBdhyaanabinduupanisatHK-308	caturasramuparyagneradho meḍhrāt pratiṣṭhitam |	catur asram upari agneḥ adhas meḍhrāt pratiṣṭhitam 
MBdhyaanabinduupanisatHK-309	svaśabdena bhavet prāṇaḥ svādhiṣṭhānaṃ tadāśrayam || 47 ||	sva śabdena bhavet prāṇaḥ svādhiṣṭhānam tad āśrayam 
MBdhyaanabinduupanisatHK-310	svādhiṣṭhānaṃ tataścakraṃ meḍhrameva nigadyate |	svādhiṣṭhānam tatas cakram meḍhram eva nigadyate 
MBdhyaanabinduupanisatHK-311	maṇivattantunā yatra vāyunā pūritaṃ vapuḥ || 48 ||	maṇi vat tantunā yatra vāyunā pūritam vapuḥ 
MBdhyaanabinduupanisatHK-312	tannābhimaṇḍalaṃ cakraṃ procyate maṇipūrakam |	tad nābhi maṇḍalam cakram procyate maṇipūrakam 
MBdhyaanabinduupanisatHK-313	dvādaśāramahācakre puṇyapāpaniyantritaḥ || 49 ||	dvādaśa āra mahā cakre puṇya pāpa niyantritaḥ 
MBdhyaanabinduupanisatHK-314	tāvajjīvo bhramatyevaṃ yāvattattvaṃ na vindati |	tāvat jīvaḥ bhramati evam yāvat tattvam na vindati 
MBdhyaanabinduupanisatHK-315	tato mūlādhārasvarūpamāha- tapteti |	tatas mūlādhāra svarūpam āha tapta iti 
MBdhyaanabinduupanisatHK-316	mūlādhāracakrasyāgnimaṇḍalameḍhramadhyagatatvāt || 46-47 ||	mūlādhāra cakrasya agni maṇḍala meḍhra madhya gata tvāt  /
MBdhyaanabinduupanisatHK-317	svādhiṣṭhānasvarūpamāha- sveti | liṅgamūle ṣaḍdalayuktaṃ	svādhiṣṭhāna svarūpam āha sva iti liṅga mūle ṣaṣ dala yuktam 
MBdhyaanabinduupanisatHK-318	svādhiṣṭhānamityarthaḥ || 47-48 || maṇipūrakaṃ vyutpādayati- maṇivaditi |	svādhiṣṭhānam iti arthaḥ 
MBdhyaanabinduupanisatHK-319	daśadalānvitaṃ maṇipūrakamityarthaḥ | tata anāhatacakraṃ	daśa dala anvitam maṇipūrakam iti arthaḥ tata anāhatacakram 
MBdhyaanabinduupanisatHK-320	dvādaśadalaṃ ṣoḍaśadalaṃ viśuddhicakraṃ tadupari	dvādaśa dalam ṣoḍaśa dalam viśuddhi cakram tad upari 
MBdhyaanabinduupanisatHK-321	candrasūryamaṇḍalaṃ tadupari sahasrāracakraṃ vidyate iti mantavyam || 48-	candra sūrya maṇḍalam tad upari sahasrāra cakram vidyate iti mantavyam 
MBdhyaanabinduupanisatHK-322	49 || tatrānāhatacakre jīvātmasvarūpamāha- dvādaśeti | tatratyo jīvo	tatra anāhatacakre jīvātma svarūpam āha dvādaśa iti tatratyaḥ 
MBdhyaanabinduupanisatHK-323	yāvat svayāthātmyaṃ na jānāti tāvat saṃsarati, svajñānena naṣṭe	yāvat sva yāthātmyam na jānāti tāvat saṃsarati sva jñānena naṣṭe 
MBdhyaanabinduupanisatHK-324	jīvasya brahmamātratvādityarthaḥ || 49-50 ||	jīvasya brahma mātra tvāt iti arthaḥ 
MBdhyaanabinduupanisatHK-325	nāḍīcakram	nāḍī cakram 
MBdhyaanabinduupanisatHK-326	ūrdhvaṃ meḍhrādadho nābheḥ kando yo'sti khagāṇḍavat || 50 ||	ūrdhvam meḍhrāt adhas nābheḥ kandaḥ yaḥ asti khaga aṇḍa vat 
MBdhyaanabinduupanisatHK-327	tatra nāḍyaḥ samutpannāḥ sahasrāṇi dvisaptatiḥ |	tatra nāḍyaḥ samutpannāḥ sahasrāṇi dvisaptatiḥ 
MBdhyaanabinduupanisatHK-328	teṣu nāḍīsahasreṣu dvisaptatirudāhṛtā || 51 ||	teṣu nāḍī sahasreṣu dvisaptatiḥ udāhṛtā 
MBdhyaanabinduupanisatHK-329	p. 199) pradhānāḥ prāṇavāhinyo bhūyastatra daśa smṛtāḥ |	pradhānāḥ prāṇa vāhinyaḥ bhūyas tatra daśa smṛtāḥ 
MBdhyaanabinduupanisatHK-330	iḍā ca piṅgalā caiva suṣumnā ca tṛtīyakā || 52 ||	iḍā ca piṅgalā ca eva suṣumnā ca tṛtīyakā 
MBdhyaanabinduupanisatHK-331	gāndhārī hastijihvā ca pūṣā caiva yaśasvinī |	gāndhārī hastijihvā ca pūṣā ca eva yaśasvinī 
MBdhyaanabinduupanisatHK-332	alambusā kuhūratra śaṅkhinī daśamī smṛtā || 53 ||	alambusā kuhūḥ atra śaṅkhinī daśamī smṛtā 
MBdhyaanabinduupanisatHK-333	evaṃ nāḍīmayaṃ cakraṃ vijñeyaṃ yogināṃ sadā |	evam nāḍī mayam cakram vijñeyam yoginām sadā 
MBdhyaanabinduupanisatHK-334	satataṃ prāṇavāhinyaḥ somasūryāgnidevatāḥ || 54 ||	satatam prāṇa vāhinyaḥ soma sūrya agni devatāḥ 
MBdhyaanabinduupanisatHK-335	iḍāpiṅgalāsuṣumnāstisro nāḍyaḥ prakīrtitāḥ |	iḍā piṅgalā suṣumnāḥ tisraḥ nāḍyaḥ prakīrtitāḥ 
MBdhyaanabinduupanisatHK-336	iḍā vāme sthitā nāḍī piṅgalā dakṣiṇe sthitā || 55 ||	iḍā vāme sthitā nāḍī piṅgalā dakṣiṇe sthitā  /
MBdhyaanabinduupanisatHK-337	suṣumnā madhyadeśasthā prāṇamārgāstrayaḥ smṛtāḥ |	suṣumnā madhya deśa sthā prāṇa mārgāḥ trayaḥ smṛtāḥ 
MBdhyaanabinduupanisatHK-338	tato nāḍīkandasthānaṃ	tatas nāḍī kanda sthānam 
MBdhyaanabinduupanisatHK-339	tadiyattāmadhidevatāsahitapradhānanāḍīsvarūpa cāha- ūrdhvamiti || 51-	tat iyat tām adhidevatā sahita pradhāna nāḍī svarūpa ca āha ūrdhvam iti 
MBdhyaanabinduupanisatHK-340	53 || yogināṃ, tṛtīyārthe ṣaṣṭhī, yogibhirityarthaḥ etat sarvaṃ spaṣṭamiti	yoginām tṛtīyā arthe ṣaṣṭhī yogibhiḥ iti arthaḥ etat sarvam spaṣṭam iti 
MBdhyaanabinduupanisatHK-341	na vyākhyātam || 54-56 ||	na vyākhyātam 
MBdhyaanabinduupanisatHK-342	prāṇādidaśavāyavaḥ	prāṇa ādi daśa vāyavaḥ 
MBdhyaanabinduupanisatHK-343	prāṇo'pānaḥ samānaścodāno vyānastathaiva ca || 56 ||	prāṇa upānaḥ samānaḥ ca udānaḥ vyānaḥ tathā eva ca 
MBdhyaanabinduupanisatHK-344	nāgaḥ kūrmaḥ kṛkarako devadatto dhanaṃjayaḥ |	nāgaḥ kūrmaḥ kṛkarakaḥ devadattaḥ dhanaṃjayaḥ 
MBdhyaanabinduupanisatHK-345	prāṇādyāḥ pañca vikhyātā nāgādyāḥ pañca vāyavaḥ || 57 ||	prāṇa ādyāḥ pañca vikhyātāḥ nāga ādyāḥ pañca vāyavaḥ 
MBdhyaanabinduupanisatHK-346	ete nāḍīsahasreṣu vartante jīvarūpiṇaḥ |	ete nāḍī sahasreṣu vartante jīva rūpiṇaḥ 
MBdhyaanabinduupanisatHK-347	jīvādhiṣṭheyanāḍīcaraprāṇādidaśavāyunāma nirdiśati- prāṇa	jīva adhiṣṭheya nāḍī cara prāṇa ādi daśa vāyu nāma nirdiśati prāṇa 
MBdhyaanabinduupanisatHK-348	iti || 57 || tatra prāṇādyāḥ pañca pradhānatayā vikhyātāḥ nāgādyā	iti   tatra prāṇa ādyāḥ pañca pradhāna tayā vikhyātāḥ nāga ādyā 
MBdhyaanabinduupanisatHK-349	vāyavastu	vāyavaḥ tu 
MBdhyaanabinduupanisatHK-350	p. 200) upaprāṇā ucyante || 57 || teṣāṃ jīvarūpeṇa nāḍīcaratvaṃ jīvasya	upaprāṇāḥ ucyante     teṣām jīva rūpeṇa nāḍī cara tvam jīvasya 
MBdhyaanabinduupanisatHK-351	prāṇāpānavaśataḥ yātāyātatvamaviśrāntamityāha- eta iti || 58 ||	prāṇa apāna vaśataḥ yāta āyāta tvam aviśrāntam iti āha ete iti 
MBdhyaanabinduupanisatHK-352	jīvasya prāṇāpānavaśatvam	jīvasya prāṇa apāna vaśa tvam 
MBdhyaanabinduupanisatHK-353	prāṇāpānavaśo jīvo hyadhaścordhvaṃ ca dhāvati || 58 ||	prāṇa apāna vaśaḥ jīvaḥ hi adhas ca ūrdhvam ca dhāvati 
MBdhyaanabinduupanisatHK-354	vāmadakṣiṇamārgeṇa cañcalatvānna dṛśyate |	vāma dakṣiṇa mārgeṇa cañcala tvāt na dṛśyate 
MBdhyaanabinduupanisatHK-355	ākṣipto bhujadaṇḍena yathoccalati kandukaḥ || 59 ||	ākṣiptaḥ bhuja daṇḍena yathā uccalati kandukaḥ 
MBdhyaanabinduupanisatHK-356	prāṇāpānasamākṣiptastadvajjīvo na viśramet |	prāṇa apāna samākṣiptaḥ tadvat jīvaḥ na viśramet 
MBdhyaanabinduupanisatHK-357	aviśrāntatve dṛṣṭāntaḥ ākṣipta iti || 59 ||	aviśrānta tve dṛṣṭāntaḥ ākṣiptaḥ iti 
MBdhyaanabinduupanisatHK-358	yogakāle prāṇāpānaikyam	yoga kāle prāṇa apāna aikyam 
MBdhyaanabinduupanisatHK-359	apānāt karṣati prāṇo'pānaḥ prāṇācca karṣati || 60 ||	apānāt karṣati prāṇa upānaḥ prāṇāt ca karṣati  /
MBdhyaanabinduupanisatHK-360	khagarajjuvadityetadyo jānāti sa yogavit |	khaga rajju vat iti etat yaḥ jānāti sa yoga vid 
MBdhyaanabinduupanisatHK-361	yogakāle prāṇāpānaikyaṃ tajjñānaphalaṃ cāha- apānāditi |	yoga kāle prāṇa apāna aikyam tad jñāna phalam ca āha apānāt iti 
MBdhyaanabinduupanisatHK-362	prāṇādapānāditi pañcamī dvitīyārthā || 60 ||	prāṇāt apānāt iti pañcamī dvitīyā arthā 
MBdhyaanabinduupanisatHK-363	ajapāhaṃsavidyā	ajapā haṃsa vidyā 
MBdhyaanabinduupanisatHK-364	hakāreṇa bahiryāti sakāreṇa viśet punaḥ || 61 ||	hakāreṇa bahis yāti sakāreṇa viśet punar 
MBdhyaanabinduupanisatHK-365	haṃsahaṃsetyamuṃ mantraṃ jīvo japati sarvadā |	haṃsa haṃsa iti amum mantram jīvaḥ japati sarvadā 
MBdhyaanabinduupanisatHK-366	śatāni ṣaḍ divārātraṃ sahasrāṇyekaviṃśatiḥ || 62 ||	śatāni ṣaḍ divārātram sahasrāṇi ekaviṃśatiḥ  /
MBdhyaanabinduupanisatHK-367	etatsaṃkhyānvitaṃ mantraṃ jīvo japati sarvadā |	etad saṃkhyā anvitam mantram jīvaḥ japati sarvadā 
MBdhyaanabinduupanisatHK-368	ajapā nāma gāyatrī yogināṃ mokṣadā sadā || 63 ||	ajapā nāma gāyatrī yoginām mokṣa dā sadā 
MBdhyaanabinduupanisatHK-369	p. 201) asyāḥ saṃkalpamātreṇa naraḥ pāpaiḥ pramucyate |	asyāḥ saṃkalpa mātreṇa naraḥ pāpaiḥ pramucyate 
MBdhyaanabinduupanisatHK-370	anayā sadṛśī vidyā anayā sadṛśo japaḥ || 64 ||	anayā sadṛśī vidyā anayā sadṛśaḥ japaḥ 
MBdhyaanabinduupanisatHK-371	anayā sadṛśaṃ puṇyaṃ na bhūtaṃ na bhaviṣyati |	anayā sadṛśam puṇyam na bhūtam na bhaviṣyati 
MBdhyaanabinduupanisatHK-372	ahorātranirvartyocchvāsaniḥśvāsarūpahaṃsavidyājapāsvarūpa-	                                                     
MBdhyaanabinduupanisatHK-373	māha- hakāreṇeti || 61 || prāṇāpānavyāpārocchvāsaniḥśvāsavyāpāra	mā āha hakāreṇa iti 
MBdhyaanabinduupanisatHK-374	eva haṃsamanuḥ taṃ haṃsahaṃsetyamuṃ mantram |	eva haṃsa manuḥ tam haṃsa haṃsa iti amum mantram 
MBdhyaanabinduupanisatHK-375	haṃsamanvāvartanasaṃkhyeyattāmāha- śatānīti || 62 || svayamajapan	haṃsa manvāvartana saṃkhyā iyattām āha śatāni iti svayam ajapan 
MBdhyaanabinduupanisatHK-376	tūṣṇīṃ tiṣṭhannapi etat iti | yā ajapato japabhāvameti seyam ajapā	tūṣṇīm tiṣṭhan api etat iti yā a japataḥ japa bhāvam eti sā iyam ajapā 
MBdhyaanabinduupanisatHK-377	gāyatrī sadaivamanusaṃdhānayogināṃ mokṣadā bhavati || 63 || yataḥ evam	gāyatrī sadā evam anusaṃdhāna yoginām mokṣa dā bhavati yatas evam 
MBdhyaanabinduupanisatHK-378	ataḥ asyāḥ iti | ajapāṃ stauti- anayeti || 64 ||	atas asyāḥ iti ajapām stauti anayā iti  
MBdhyaanabinduupanisatHK-379	kuṇḍalinībodhanena mokṣadvāravibhedanam	           
MBdhyaanabinduupanisatHK-380	yena mārgeṇa gantavyaṃ brahmasthānaṃ nirāmayam || 65 ||	yena mārgeṇa gantavyam brahma sthānam nirāmayam 
MBdhyaanabinduupanisatHK-381	mukhenācchādya taddvāraṃ prasuptā parameśvarī |	mukhena ācchādya tat dvāram prasuptā parameśvarī 
MBdhyaanabinduupanisatHK-382	prabuddhā vahniyogena manasā marutā saha || 66 ||	prabuddhāḥ vahni yogena manasā marutā saha 
MBdhyaanabinduupanisatHK-383	sūcivadguṇamādāya vrajatyūrdhvaṃ suṣumnayā |	sūci vat guṇam ādāya vrajati ūrdhvam suṣumnayā 
MBdhyaanabinduupanisatHK-384	udghāṭayet kapāṭaṃ tu yathā kuñcikayā haṭhāt || 67 ||	udghāṭayet kapāṭam tu yathā kuñcikayā haṭhāt 
MBdhyaanabinduupanisatHK-385	kuṇḍalinyā tathā yogī mokṣadvāraṃ vibhedayet || 68 ||	kuṇḍalinyā tathā yogī mokṣa dvāram vibhedayet 
MBdhyaanabinduupanisatHK-386	kṛtvā saṃpuṭitau karau dṛḍhataraṃ badhvātha padmāsanaṃ	kṛtvā saṃpuṭitau karau dṛḍhataram badhvā atha padmāsanam 
MBdhyaanabinduupanisatHK-387	gāḍhaṃ vakṣasi saṃnidhāya cubukaṃ dhyānaṃ ca taccetasi |	gāḍham vakṣasi saṃnidhāya cubukam dhyānam ca tat cetasi 
MBdhyaanabinduupanisatHK-388	vāraṃvāramapānamūrdhvamanilaṃ proccārayan pūritaṃ	vāram vāram apānam ūrdhvam anilam proccārayan pūritam 
MBdhyaanabinduupanisatHK-389	muñcan prāṇamupaiti bodhamatulaṃ śaktiprabhāvānnaraḥ || 69 ||	muñcan prāṇam upaiti bodham atulam śakti prabhāvāt naraḥ  /
MBdhyaanabinduupanisatHK-390	p. 202) kuṇḍalinīsthitimāha- yeneti | turīyaṃ mūrdhni saṃsthitam iti	kuṇḍalinī sthitim āha yena iti turīyam mūrdhni saṃsthitam iti 
MBdhyaanabinduupanisatHK-391	śrutyanurodhena sahasrāracakraṃ brahmasthānaṃ, tatraivopalabhyate hi	śruti anurodhena sahasrāra cakram brahma sthānam tatra evā upalabhyate hi 
MBdhyaanabinduupanisatHK-392	brahma yoginām | tatra svātiriktāmayavairalyāt nirāmayam || 65 || yena	brahma yoginām tatra sva atirikta āmaya vairalyāt nirāmayam       
MBdhyaanabinduupanisatHK-393	suṣumnāmārgeṇa tadgantavyaṃ taddvāraṃ svamukhena ācchādya	suṣumnā mārgeṇa tat gantavyam tat dvāram sva mukhena ācchādya 
MBdhyaanabinduupanisatHK-394	parameśvarī kuṇḍalinī prāṇisāmānyajaṭhare prasuptā bhavati | sā kadā	parameśvarī kuṇḍalinī prāṇi sāmānya jaṭhare prasuptā bhavati sā kadā 
MBdhyaanabinduupanisatHK-395	pratibudhyata ityatra yoginaḥ kevalakumbhakāvasthāyāṃ	pratibudhyate iti atra yoginaḥ kevala kumbhaka avasthāyām 
MBdhyaanabinduupanisatHK-396	mūlādhārasthāgninā manasā marutā ca saha prabuddhā satī || 66 ||	mūlādhāra sthā agninā manasā marutā ca saha prabuddhā satī 
MBdhyaanabinduupanisatHK-397	sūkṣmasūcivat guṇaṃ bhogamādāya suṣumnayordhvaṃ sahasrāraṃ	sūkṣma sūci vat guṇam bhogam ādāya suṣumnayā ūrdhvam sahasra aram 
MBdhyaanabinduupanisatHK-398	vrajati | kuṇḍalinyā suṣumnāvadanaṃ vibhedayedityāha- udghāṭayediti |	vrajati kuṇḍalinyā suṣumnā vadanam vibhedayet iti āha udghāṭayet iti 
MBdhyaanabinduupanisatHK-399	yathā naro haṭhāt kuñcikāprayatnena kavāṭamudghāṭayet tathaiva yogī	yathā naraḥ haṭhāt kuñcikā prayatnena kavāṭam udghāṭayet tathā eva yogī 
MBdhyaanabinduupanisatHK-400	kuṇḍalinyā mokṣahetusuṣumnādvaraṃ vibhedayedityarthaḥ || 67-68 ||	kuṇḍalinyāḥ mokṣa hetu suṣumnāt varam vibhedayet iti arthaḥ 
MBdhyaanabinduupanisatHK-401	suṣumnāmāgabhedopāyamāha- kṛtveti | ādau yogī padmāsanaṃ baddhvā	suṣumnā māga bheda upāyam āha kṛtvā iti ādau yogī padmāsanam baddhvā 
MBdhyaanabinduupanisatHK-402	atha svakarau saṃpuṭitau kṛtvā vakṣasi cubukaṃ cetasi	atha sva karau saṃpuṭitau kṛtvā vakṣasi cubukam cetasi 
MBdhyaanabinduupanisatHK-403	svasvarūpadhyānaṃ ca saṃnidhāya vāraṃvāramapānānilamūrdhvaṃ	sva svarūpa dhyānam ca saṃnidhāya vāram vāram apāna anilam ūrdhvam 
MBdhyaanabinduupanisatHK-404	proccārayan ākuñcayan evaṃ pūritaṃ prāṇaṃ suṣumnāyāṃ muñcan	proccārayan ākuñcayan evam pūritam prāṇam suṣumnāyām muñcan 
MBdhyaanabinduupanisatHK-405	naro yogī suṣumnāṃ praviṣṭakuṇḍalinīśaktiprabhāvāt nirūpamam	naraḥ yogī suṣumnām praviṣṭa kuṇḍalinī śakti prabhāvāt 
MBdhyaanabinduupanisatHK-406	atulaṃ niratiśayaṃ brahmāham ahameva brahmeti brahmātmabodhamupaiti ||	atulam niratiśayam brahma aham aham eva brahma iti brahma ātma bodham upaiti 
MBdhyaanabinduupanisatHK-407	brahmacaryādinā kuṇḍalinībodhaḥ	          
MBdhyaanabinduupanisatHK-408	padmāsanasthito yogī nāḍīdvāreṣu pūrayan |	             
MBdhyaanabinduupanisatHK-409	mārutaṃ kumbhayan yastu sa mukto nātra saṃśayaḥ || 70 ||	mārutam kumbhayan yaḥ tu sa muktaḥ na atra saṃśayaḥ 
MBdhyaanabinduupanisatHK-410	aṅgānāṃ mardanaṃ kṛtvā śramajātena vāriṇā |	aṅgānām mardanam kṛtvā śrama jātena vāriṇā 
MBdhyaanabinduupanisatHK-411	kaṭvamlalavaṇatyāgī kṣīrapānarataḥ sukhī || 71 ||	            
MBdhyaanabinduupanisatHK-412	brahmacārī mitāhārī yogī yogaparāyaṇaḥ |	            
MBdhyaanabinduupanisatHK-413	abdādūrdhvaṃ bhavet siddho nātra kāryā vicāraṇā || 72 ||	abdāt ūrdhvam bhavet siddhaḥ na atra kāryā vicāraṇā 
MBdhyaanabinduupanisatHK-414	kandordhvakuṇḍalīśaktiḥ sa yogī siddhibhājanam |	             
MBdhyaanabinduupanisatHK-415	p. 203) evaṃ suṣumnākumbhakānmukto bhavatītyāha- padmeti | yastu	evam suṣumnā kumbhakāt muktaḥ bhavati iti āha padma iti yaḥ tu 
MBdhyaanabinduupanisatHK-416	punaḥ yogī padmāsane sthitvā bāhyaṃ vāyumiḍayā ākṛṣya	punar yogī padmāsane sthitvā bāhyam vāyum iḍayā ākṛṣya 
MBdhyaanabinduupanisatHK-417	nāḍīdvāreṣu pūrayan pūritaṃ mārutaṃ kumbhayan suṣumnāṃ	nāḍī dvāreṣu pūrayan pūritam mārutam kumbhayan suṣumnām 
MBdhyaanabinduupanisatHK-418	prāpayitvā yadā yogī brahmarandhraṃ bhinatti so'yaṃ yogī tato	prāpayitvā yadā yogī brahmarandhram bhinatti saḥ uyam yogī 
MBdhyaanabinduupanisatHK-419	brahmarandhraṃ bhittvā yat prāpyaṃ tat prāpya mukto bhavatītyatra na hi	brahmarandhram bhittvā yat prāpyam tat prāpya muktaḥ bhavati iti atra na hi 
MBdhyaanabinduupanisatHK-420	saṃśayo'stītyarthaḥ || 70 || tatropāyamāha- aṅgānāmiti |	saṃśayaḥ asti iti arthaḥ   tatra upāyam āha aṅgānām iti 
MBdhyaanabinduupanisatHK-421	abhyāsadaśāyāmādau prāṇāyāmakāle svedo jāyate | tena	abhyāsa daśāyām ādau prāṇāyāma kāle svedaḥ jāyate tena 
MBdhyaanabinduupanisatHK-422	sarvāṅgānāṃ mardanaṃ kṛtvā dṛḍhakāyo bhūtvā tadānīṃ	sarva aṅgānām mardanam kṛtvā dṛḍha kāyaḥ bhūtvā tadānīm 
MBdhyaanabinduupanisatHK-423	kaṭvamlalavaṇatyāgī kṣīrapānarataḥ sukhī || 71 || evaṃ	                     
MBdhyaanabinduupanisatHK-424	brahmacaryādiniyamasaṃpanno bhūtvā saṃvatsarādūrdhvaṃ siddho	brahmacarya ādi niyama saṃpannaḥ bhūtvā saṃvatsarāt ūrdhvam siddhaḥ 
MBdhyaanabinduupanisatHK-425	bhavati || 72 || yasya nāḍīkandordhvabhāge suṣumnāyāṃ kuṇḍalinīśaktiḥ	bhavati                        
MBdhyaanabinduupanisatHK-426	syāt so'yaṃ yogī yogasiddhibhājanaṃ bhavati ||	syāt saḥ uyam yogī yoga siddhi bhājanam bhavati 
MBdhyaanabinduupanisatHK-427	bandhatrayam	        
MBdhyaanabinduupanisatHK-428	apānaprāṇayoraikyaṃ kṣayānmūtrapurīṣayoḥ || 73 ||	apāna prāṇayoḥ aikyam kṣayāt mūtra purīṣayoḥ 
MBdhyaanabinduupanisatHK-429	yuvā bhavati vṛddho'pi satataṃ mūlabandhanāt |	yuvā bhavati vṛddhaḥ api satatam mūlabandhanāt 
MBdhyaanabinduupanisatHK-430	pārṣṇibhāgena saṃpīḍya yonimākuñcayedgudam || 74 ||	pārṣṇi bhāgena saṃpīḍya yonim ākuñcayet gudam 
MBdhyaanabinduupanisatHK-431	apānamūrdhvamutkṛṣya mūlabandho'yamucyate |	apānam ūrdhvam utkṛṣya mūlabandhaḥ yam ucyate 
MBdhyaanabinduupanisatHK-432	uḍyāṇaṃ kurute yasmādaviśrāntamahākhagaḥ || 75 ||	uḍyāṇam kurute yasmāt aviśrānta mahākhagaḥ 
MBdhyaanabinduupanisatHK-433	uḍḍiyāṇaṃ tadeva syāttatra bandho vidhīyate |	uḍḍiyānam tat eva syāt tatra bandhaḥ vidhīyate 
MBdhyaanabinduupanisatHK-434	udare paścimaṃ tāṇaṃ nābherūrdhvaṃ tu kārayet || 76 ||	udare paścimam tāṇam nābheḥ ūrdhvam tu kārayet  /
MBdhyaanabinduupanisatHK-435	uḍḍiyāṇo'pyathaṃ bandho mṛtyumātaṅgakesarī |	bandhaḥ mṛtyu mātaṅga kesarī 
MBdhyaanabinduupanisatHK-436	badhnāti hi śirojātamadhogāminabhojalam || 77 ||	badhnāti hi śiraḥ jātam adhogāmi nabhaḥ jalam 
MBdhyaanabinduupanisatHK-437	tato jālaṃdharo bandhaḥ kaṇṭhaduḥkhaughanāśanaḥ |	tatas jālaṃdharaḥ bandhaḥ kaṇṭha duḥkha ogha nāśanaḥ 
MBdhyaanabinduupanisatHK-438	jālaṃdhare kṛte bandhe kaṇṭhasaṃkocalakṣaṇe || 78 ||	jālaṃdhare kṛte bandhe kaṇṭha saṃkoca lakṣaṇe 
MBdhyaanabinduupanisatHK-439	p. 204) tadaṅgatvena bandhatrayaṃ tatphalaṃ cācaṣṭe- apāneti || 73-75 ||	tad aṅga tvena bandha trayam tad phalam ca ācaṣṭe apāna iti 
MBdhyaanabinduupanisatHK-440	udarasaṃkocanaṃ paścimaṃ tāṇamityarthaḥ || 76 ||	udara saṃkocanam paścimam tāṇam iti arthaḥ 
MBdhyaanabinduupanisatHK-441	ayamuḍḍiyāṇabandhaḥ śironabhojātaṃ sahasrāranabhovidyamānaṃ	ayam uḍḍiyāṇa bandhaḥ śiraḥ nabhaḥ jātam sahasra ara nabhaḥ vidyamānam 
MBdhyaanabinduupanisatHK-442	sarvarogākāraṃ kaphajalaṃ badhnāti śuṣkaṃ karotītyarthaḥ || 77-78 ||	sarva roga ākāram kapha jalam badhnāti śuṣkam karoti iti arthaḥ 
MBdhyaanabinduupanisatHK-443	khecarīmudrābhyāsaḥ	          
MBdhyaanabinduupanisatHK-444	na pīyūṣaṃ patatyagnau na ca vāyuḥ pradhāvati |	na pīyūṣam patati agnau na ca vāyuḥ pradhāvati 
MBdhyaanabinduupanisatHK-445	kapālakuhare jihvā praviṣṭā viparītagā || 79 ||	kapāla kuhare jihvā praviṣṭā viparīta gā 
MBdhyaanabinduupanisatHK-446	bhrūvorantargatā dṛṣṭirmudrā bhavati khecarī |	bhrūvoḥ antargatā dṛṣṭiḥ mudrā bhavati khecarī 
MBdhyaanabinduupanisatHK-447	na rogo maraṇaṃ tasya na nidrā na kṣudhā tṛṣā || 80 ||	na rogaḥ maraṇam tasya na nidrā na kṣudhā tṛṣā 
MBdhyaanabinduupanisatHK-448	na ca mūrcchā bhavettasya yo mudrāṃ vetti khecarīm |	na ca mūrcchā bhavet tasya yaḥ mudrām vetti khecarīm 
MBdhyaanabinduupanisatHK-449	pīḍyate na ca rogeṇa lipyate na ca karmaṇā || 81 ||	pīḍyate na ca rogeṇa lipyate na ca karmaṇā  
MBdhyaanabinduupanisatHK-450	badhyate na ca kālena yasya mudrāsti khecarī |	badhyate na ca kālena yasya mudrā asti khecarī 
MBdhyaanabinduupanisatHK-451	cittaṃ carati khe yasmājjihvā bhavati khegatā || 82 ||	cittam carati khe yasmāt jihvā bhavati khegatā 
MBdhyaanabinduupanisatHK-452	tenaiṣā khecarī nāma mudrā siddhanamaskṛtā |	tena eṣā khecarī nāma mudrā siddha namaskṛtā 
MBdhyaanabinduupanisatHK-453	yogāṅgatayā bandhatrayamuktvātha khecarīmudrāṃ	yoga aṅga tayā bandha trayam uktvā atha khecarī mudrām 
MBdhyaanabinduupanisatHK-454	tadabhyāsasiddhaphalaṃ cāha- kapāleti || 79 || tadabhyāsāntarālikaphalaṃ	tad abhyāsa siddha phalam ca āha kapāla iti tad abhyāsa āntarālika phalam 
MBdhyaanabinduupanisatHK-455	tu na roga iti || 80-82 ||	tu na rogaḥ iti 
MBdhyaanabinduupanisatHK-456	khecaryabhyāsena vajrolisiddhiḥ	             
MBdhyaanabinduupanisatHK-457	khecaryā mudrayā yasya vivaraṃ lambikordhvataḥ || 83 ||	khecaryā mudrayā yasya vivaram lambikā ūrdhvatas 
MBdhyaanabinduupanisatHK-458	binduḥ kṣarati yo yasya kāminyāliṅgitasya ca |	binduḥ kṣarati yaḥ yasya kāminī āliṅgitasya ca 
MBdhyaanabinduupanisatHK-459	yāvadbinduḥ sthito dehe tāvanmṛtyubhayaṃ kutaḥ || 84 ||	yāvat binduḥ sthitaḥ dehe tāvat mṛtyu bhayam kutas 
MBdhyaanabinduupanisatHK-460	p. 205) yāvadbaddhā nabhomudrā tāvadbindurna gacchati |	yāvat baddhā nabhomudrā tāvat binduḥ na gacchati 
MBdhyaanabinduupanisatHK-461	galito'pi yadā binduḥ saṃprāpto yonimaṇḍale || 85 ||	galitaḥ api yadā binduḥ saṃprāptaḥ yoni maṇḍale 
MBdhyaanabinduupanisatHK-462	vrajatyūtdhvaṃ haṭhācchaktyā nibaddho yonimudrayā |	haṭhāt śaktyā nibaddhaḥ yonimudrayā 
MBdhyaanabinduupanisatHK-463	khecarīmudrārūḍhasya jīvanahetubindusthairyaṃ vajrolisiddhirapi	khecarī mudrā rūḍhasya jīvana hetu bindu sthairyam vajroli siddhiḥ api 
MBdhyaanabinduupanisatHK-464	bhavatītyāha- khecaryeti | khecaryā mudrayā yasya jihvā lambikāyāḥ	bhavati iti āha khecaryā iti khecaryā mudrayā yasya jihvā lambikāyāḥ 
MBdhyaanabinduupanisatHK-465	antarjihvāyā ūrdhvataḥ tadvivaraṃ praviśati || 83 ||	antar jihvāyāḥ ūrdhvatas tat vivaram praviśati 
MBdhyaanabinduupanisatHK-466	yacchabdastacchabdārthaḥ | apyarthaḥ cakāraḥ | kāminyāliṅgitasyāpi	yad śabdaḥ tad śabda arthaḥ api arthaḥ cakāraḥ kāminī āliṅgitasya api 
MBdhyaanabinduupanisatHK-467	yasya tasya naiva binduḥ śuklaṃ kṣarati | yāvadbindusthairyaṃ jāyate	yasya tasya na eva binduḥ śuklam kṣarati yāvat bindu sthairyam jāyate 
MBdhyaanabinduupanisatHK-468	tāvattasya mṛtyubhayaṃ kutaḥ saṃbhavati || 84 || yāvatkhecarīmudrā	tāvat tasya mṛtyu bhayam kutas saṃbhavati       yāvat khecarī mudrā 
MBdhyaanabinduupanisatHK-469	baddhā bhavet tāvadbinduḥ na gacchati | yadā galito'pi binduḥ yonimaṇḍale	baddhā bhavet tāvat binduḥ na gacchati yadā galitaḥ api binduḥ yoni maṇḍale 
MBdhyaanabinduupanisatHK-470	saṃprāpto'pi || 85 || tadā vajrolisaṃskṛtayonimudrayā haṭācchaktyā	saṃprāptaḥ api tadā vajroli saṃskṛta yonimudrayā haṭāt śaktyā 
MBdhyaanabinduupanisatHK-471	ūrdhvaṃ vrajati ||	ūrdhvam vrajati 
MBdhyaanabinduupanisatHK-472	dvividhabindvaikyabodhato jīvanmuktatvam	             
MBdhyaanabinduupanisatHK-473	sa eva dvividho binduḥ pāṇḍaro lohitastathā || 86 ||	saḥ eva dvividhaḥ binduḥ pāṇḍaraḥ lohitaḥ tathā 
MBdhyaanabinduupanisatHK-474	pāṇḍaraṃ śuklamityahurlohitākhyaṃ mahārajaḥ |	pāṇḍaram śuklam iti ahuḥ lohita ākhyam mahārajaḥ 
MBdhyaanabinduupanisatHK-475	vidrumadrumasaṃkāśaṃ yonisthāne sthitaṃ rajaḥ || 87 ||	vidruma druma saṃkāśam yoni sthāne sthitam rajaḥ 
MBdhyaanabinduupanisatHK-476	śaśisthāne vasedbindustayoraikyaṃ sudurlabham |	śaśi sthāne vaset binduḥ tayoḥ aikyam su durlabham 
MBdhyaanabinduupanisatHK-477	binduḥ śivo rajaḥ śaktirbindurindū rajo raviḥ || 88 ||	binduḥ śivaḥ rajaḥ śaktiḥ binduḥ induḥ rajaḥ raviḥ 
MBdhyaanabinduupanisatHK-478	ubhayoḥ saṃgamādeva prāpyate paramaṃ vapuḥ |	ubhayoḥ saṃgamāt eva prāpyate paramam vapuḥ 
MBdhyaanabinduupanisatHK-479	vāyunā śakticālena preritaṃ khe yathā rajaḥ || 89 ||	vāyunā śakti cālena preritam khe yathā rajaḥ 
MBdhyaanabinduupanisatHK-480	raviṇaikatvamāyāti bhaveddivyavapustadā |	raviṇā eka tvam āyāti bhavet divya vapuḥ tadā 
MBdhyaanabinduupanisatHK-481	śuklaṃ candreṇa saṃyuktaṃ rajaḥ sūryasamanvitam || 90 ||	śuklam candreṇa saṃyuktam rajaḥ sūrya samanvitam 
MBdhyaanabinduupanisatHK-482	dvayoḥ samarasībhāvaṃ yo jānāti sa yogavit |	dvayoḥ samarasībhāvam yaḥ jānāti sa yoga vid 
MBdhyaanabinduupanisatHK-483	p. 206) vindordvaividhyaṃ tayoraikyaprabodhato jīvanmuktatvaṃ cāha- sa	vindoḥ dvaividhyam tayoḥ aikya prabodhāt jīvanmukta tvam ca āha sa 
MBdhyaanabinduupanisatHK-484	eveti || 86 || mūlādhārasthaṃ yonisthānaṃ tatra rajo devītattvaṃ	eva iti mūlādhāra stham yoni sthānam tatra rajaḥ devī tattvam 
MBdhyaanabinduupanisatHK-485	jīvākhyaṃ vā bhavati || 87 || bhrūmadhyasahasrāramadhyaṃ	jīva ākhyam vā bhavati bhrū madhya sahasra ara madhyam 
MBdhyaanabinduupanisatHK-486	śaśisthānaṃ, tatra binduḥ śivatattvaṃ vasati | tayoḥ śivaśaktyoḥ	śaśi sthānam tatra binduḥ śivatattvam vasati tayoḥ śiva śaktyoḥ 
MBdhyaanabinduupanisatHK-487	jīvaparayorvā aikyaṃ yogino vinā yasya kasyāpi durlabhaṃ bhavet || 88-90 ||	jīva parayoḥ vā aikyam yoginaḥ vinā yasya kasya api durlabham bhavet 
MBdhyaanabinduupanisatHK-488	śuklarajorūpabhrūsahasrāramadhyasthasomasūryaikyaṃ yo jānāti sa	śukla rajaḥ rūpa bhrū sahasrāra madhya stha soma sūrya aikyam yaḥ jānāti sa 
MBdhyaanabinduupanisatHK-489	yogavit brahmavit bhavatītyarthaḥ ||	yoga vid brahma vid bhavati iti arthaḥ 
MBdhyaanabinduupanisatHK-490	mahāmudrābhyāsaḥ	        
MBdhyaanabinduupanisatHK-491	śodhanaṃ malajālānāṃ ghaṭanaṃ candrasūryayoḥ || 91 ||	śodhanam mala jālānām ghaṭanam candra sūryayoḥ  /
MBdhyaanabinduupanisatHK-492	rasānāṃ śoṣaṇaṃ samyaṅ mahāmudrābhidhīyate || 92 ||	rasānām śoṣaṇam samyak mahāmudrā abhidhīyate 
MBdhyaanabinduupanisatHK-493	vakṣonyastahanurnipīḍya suṣiraṃ yoneśca vāmāṅghriṇā	vakṣaḥ nyasta hanuḥ nipīḍya suṣiram yoneḥ ca vāma aṅghriṇā 
MBdhyaanabinduupanisatHK-494	hasyābhyāmanudhārayan pravitataṃ pādaṃ tathā dakṣiṇam |	hasyābhyām anudhārayan pravitatam pādam tathā dakṣiṇam 
MBdhyaanabinduupanisatHK-495	āpūrya śvasanena kukṣiyugalaṃ badhvā śanai recaye-	āpūrya śvasanena kukṣi yugalam badhvā śanais recaye 
MBdhyaanabinduupanisatHK-496	deṣā pātakanāśinī nanu mahāmudrā nṛṇāṃ procyate || 93 ||	pātaka nāśinī nanu mahāmudrā nṛṇām procyate 
MBdhyaanabinduupanisatHK-497	mahāmudrālakṣaṇamucyate- śodhanamiti | nānāsādhanasiddha-	mahāmudrā lakṣaṇam ucyate śodhanam iti nānā sādhana siddha 
MBdhyaanabinduupanisatHK-498	recakapūrakakumbhakātmakaprāṇāyāmaśuddhodakena	recaka pūraka kumbhaka ātmaka prāṇāyāma śuddha udakena 
MBdhyaanabinduupanisatHK-499	nāḍīgatamalajātaśodhanaṃ candrasūryayoraikyaṃ vātapittādirasānāṃ	nāḍī gata mala jāta śodhanam candra sūryayoḥ aikyam vāta pitta ādi rasānām 
MBdhyaanabinduupanisatHK-500	śoṣaṇaṃ ca yayā bhavati seyaṃ mahāmudretyabhidhīyate || 91-92 ||	śoṣaṇam ca yayā bhavati sā iyam mahāmudrā iti abhidhīyate 
MBdhyaanabinduupanisatHK-501	mahāmudrābhyāsamāha- vakṣa iti | ādau yogī jālandharabandhamāropya	mahāmudrā abhyāsam āha vakṣaḥ iti ādau yogī jālandhara bandham āropya 
MBdhyaanabinduupanisatHK-502	vāmāṅghriṇā yonisuṣiraṃ nipīḍya prasāritadakṣiṇapādaṃ	vāma aṅghriṇā yoni suṣiram nipīḍya prasārita dakṣiṇa pādam 
MBdhyaanabinduupanisatHK-503	hastābhyāṃ dhārayan kukṣiyugalaṃ śvasanenāpūrya kumbhayitvātha	hastābhyām dhārayan kukṣi yugalam śvasanena āpūrya kumbhayitvā atha 
MBdhyaanabinduupanisatHK-504	śanairiḍayā recayet | saiṣā rītiḥ sarvapātakanāśinī nṛṇāṃ yogināṃ	śanais iḍayā recayet sā eṣā rītiḥ sarva pātaka nāśinī nṛṇām yoginām 
MBdhyaanabinduupanisatHK-505	yogavighnanāśinī mahāmudreti procyate || evaṃ prāṇāyāma uktaḥ |	                                                                   
MBdhyaanabinduupanisatHK-506	anātmadehādigatāhaṃbhāva [vasya] pratīci pratyāharaṇaṃ pratyāhāraḥ	anātma deha ādi gata ahaṃbhāva pratīci pratyāharaṇam pratyāhāraḥ 
MBdhyaanabinduupanisatHK-507	| pratyageva	pratyak eva 
MBdhyaanabinduupanisatHK-508	p. 207) brahmeti niścayo dhāraṇā bhavati | ahaṃ brahmāsmi	brahma iti niścayaḥ dhāraṇā bhavati aham brahma asmi 
MBdhyaanabinduupanisatHK-509	brahmaivāhamasmi iti dṛḍhabhāvanā dhyānam |	brahma eva aham asmi iti dṛḍha bhāvanā dhyānam 
MBdhyaanabinduupanisatHK-510	dhyānāditripuṭīvikalpalayo nirvikalpasamādhiḥ | ṣaḍaṅgo yoga ucyate iti	                                                                                                    
MBdhyaanabinduupanisatHK-511	pratijñātatvāt tadanurodhena prativacanābhāve'pyevaṃ pratyāhārādi	pratijñāta tvāt tad anurodhena prativacana abhāve pi evam pratyāhāra ādi 
MBdhyaanabinduupanisatHK-512	ūhyamityarthaḥ || 93 ||	ūhyam iti arthaḥ 
MBdhyaanabinduupanisatHK-513	hṛdaye ātmasākṣātkāraḥ	hṛdaye ātma sākṣātkāraḥ 
MBdhyaanabinduupanisatHK-514	athātmanirṇayaṃ vyākhyāsye- hṛdi sthāne aṣṭadalapadmaṃ vartate	atha ātmanirṇayam vyākhyāsye hṛdi sthāne aṣṭadala padmam vartate 
MBdhyaanabinduupanisatHK-515	tanmadhye rekhāvalayaṃ kṛtvā jīvātmarūpaṃ jyotīrūpamaṇumātraṃ	tad madhye rekhā valayam kṛtvā jīvātma rūpam jyotī rūpam aṇu mātram 
MBdhyaanabinduupanisatHK-516	vartate | tasmin sarvaṃ pratiṣṭhitaṃ bhavati sarvaṃ jānāti sarvaṃ karoti	vartate tasmin sarvam pratiṣṭhitam bhavati sarvam jānāti sarvam karoti 
MBdhyaanabinduupanisatHK-517	sarvametaccaritamahaṃ kartāhaṃ proktā sukhī duḥkhī kāṇaḥ khañjo	sarvam etat caritam aham kartā aham proktā sukhī duḥkhī kāṇaḥ khañjo 
MBdhyaanabinduupanisatHK-518	badhiro mūkaḥ kṛśaḥ sthūlo'nena prakāreṇa svatantravādena vartate || 93-	badhiraḥ mūkaḥ kṛśaḥ sthūla ūnena prakāreṇa svatantra vādena vartate 
MBdhyaanabinduupanisatHK-519	1 || pūrvadale viśramate pūrvadalaṃ śvetavarṇaṃ tadā bhaktipuraḥsaraṃ	                             
MBdhyaanabinduupanisatHK-520	dharme matirbhavati || 93-2 || yadāgneyadale viśramate tadāgneyadalaṃ	dharme matiḥ bhavati yat āgneyadale viśramate tat āgneyadalam 
MBdhyaanabinduupanisatHK-521	raktavarṇaṃ tadā nidrālasyamatirbhavati || 93-3 || yadā dakṣiṇadale	rakta varṇam tadā nidrā ālasya matiḥ bhavati yadā dakṣiṇa dale 
MBdhyaanabinduupanisatHK-522	viśramate taddakṣiṇadalaṃ kṛṣṇavarṇaṃ tadā dveṣakopamatirbhavati || 93-	viśramate tat dakṣiṇa dalam kṛṣṇa varṇam tadā dveṣa kopa matiḥ bhavati 
MBdhyaanabinduupanisatHK-523	4 || yadā nair-ṛtadale viśramate tannair-ṛtadalaṃ nīlavarṇaṃ tadā	yadā nairṛtadale viśramate tat nairṛtadalam nīla varṇam tadā 
MBdhyaanabinduupanisatHK-524	pāpakarmahiṃsāmatirbhavati || 93-5 || yadā paścimadale viśramate	pāpa karma hiṃsā matiḥ bhavati yadā paścima dale viśramate 
MBdhyaanabinduupanisatHK-525	tatpaścimadalaṃ sphaṭikavarṇaṃ tadā krīḍāvinodamatirbhavati || 93-6 ||	tad paścima dalam sphaṭika varṇam tadā krīḍā vinoda matiḥ bhavati 
MBdhyaanabinduupanisatHK-526	yadā vāyavyadale viśramate vāyavyadalaṃ māṇikyavarṇaṃ tadā	yadā vāyavya dale viśramate vāyavya dalam māṇikya varṇam tadā 
MBdhyaanabinduupanisatHK-527	gamanacālanavairāgyamatirbhavati || 93-7 || yadottaradale viśramate	gamana cālana vairāgya matiḥ bhavati yadā uttara dale viśramate 
MBdhyaanabinduupanisatHK-528	taduttaradalaṃ pītavarṇaṃ tadā sukhaśṛṅgāramatirbhavati || 93-8 ||	tat uttara dalam pīta varṇam tadā sukha śṛṅgāra matiḥ bhavati 
MBdhyaanabinduupanisatHK-529	yadeśānadale viśramate tadīśānadalaṃ vaiḍūryavarṇaṃ	yadā īśāna dale viśramate tat īśāna dalam vaiḍūrya varṇam 
MBdhyaanabinduupanisatHK-530	p. 208) tadā dānādikṛpāmatirbhavati || 93-9 || yadā saṃdhisaṃdhiṣu	tadā dāna ādi kṛpā matiḥ bhavati     yadā saṃdhi saṃdhiṣu 
MBdhyaanabinduupanisatHK-531	matirbhavavi tadā vātapittaśleṣmamahāvyādhiprakopo bhavati || 93-10 ||	tadā vāta pitta śleṣma mahā vyādhi prakopaḥ bhavati 
MBdhyaanabinduupanisatHK-532	yadā madhye tiṣṭhati tadā sarvaṃ jānāti gāyati nṛtyati paṭhatyānandaṃ	yadā madhye tiṣṭhati tadā sarvam jānāti gāyati nṛtyati paṭhati ānandam 
MBdhyaanabinduupanisatHK-533	karoti || 93-11 || yadā netraśramo bhavati śramanirharaṇārthaṃ	karoti    yadā netra śramaḥ bhavati śrama nirharaṇa artham 
MBdhyaanabinduupanisatHK-534	prathamarekhāvalayaṃ kṛtvā madhye nimajjanaṃ kurute prathamarekhā	prathama rekhā valayam kṛtvā madhye nimajjanam kurute prathama rekhā 
MBdhyaanabinduupanisatHK-535	bandhūkapuṣpavarṇaṃ tadā nidrāvasthā bhavati | nidrāvasthāmadhye	bandhūka puṣpa varṇam tadā nidrā avasthā bhavati nidrā avasthā madhye 
MBdhyaanabinduupanisatHK-536	svapnāvasthā bhavati | svapnāvasthāmadhye dṛṣṭaṃ	svapna avasthā bhavati svapna avasthā madhye dṛṣṭam 
MBdhyaanabinduupanisatHK-537	śrutamanumānasaṃbhavavārtā ityādikalpanāṃ karoti tadādiśramo	śrutam anumāna saṃbhava vārtāḥ ityādi kalpanām karoti 
MBdhyaanabinduupanisatHK-538	bhavati || 93-12 || śramanirharaṇārthaṃ dvitīyarekhā valayaṃ kṛtvā madhye	bhavati               kṛtvā   
MBdhyaanabinduupanisatHK-539	nimajjanaṃ kurute dvitīyarekhā indrakopavarṇaṃ tadā suṣuptyavasthā	nimajjanam kurute dvitīya rekhā indra kopa varṇam tadā suṣupti avasthā 
MBdhyaanabinduupanisatHK-540	bhavati suṣuptau kevalaparameśvarasaṃbandhinī buddhirbhavati	bhavati suṣuptau kevala parameśvara saṃbandhinī buddhiḥ bhavati 
MBdhyaanabinduupanisatHK-541	nityabodhasvarūpā bhavati paścāt parameśvararūpeṇa prāptirbhavati || 93-	nitya bodha sva rūpā bhavati paścāt parameśvara rūpeṇa prāptiḥ bhavati 
MBdhyaanabinduupanisatHK-542	13 || tṛtīyarekhā valayaṃ kṛtvā madhye nimajjanaṃ kurute tṛtīyarekhā	tṛtīya rekhā valayam kṛtvā madhye nimajjanam kurute tṛtīya rekhā 
MBdhyaanabinduupanisatHK-543	padmarāgavarṇaṃ tadā turīyāvasthā bhavati turīye	padmarāga varṇam tadā turīya avasthā bhavati turīye 
MBdhyaanabinduupanisatHK-544	kevalaparamātmasaṃbandhinī matirbhavati nityabodhasvarūpo bhavati tadā	kevala paramātma saṃbandhinī matiḥ bhavati nitya bodha svarūpaḥ bhavati tadā 
MBdhyaanabinduupanisatHK-545	śanaiḥ śanairuparamed buddhyā dhṛtigṛhītayā |	śanais śanais uparamet buddhyā dhṛti gṛhītayā 
MBdhyaanabinduupanisatHK-546	ātmasaṃsthaṃ manaḥ kṛtvā na kiṃcidapi cintayet || 93-14 ||	ātma saṃstham manaḥ kṛtvā na kiṃcid api cintayet  /
MBdhyaanabinduupanisatHK-547	tadā prāṇāpānayoraikyaṃ kṛtvā sarvaṃ viśvamātmasvarūpeṇa	tadā prāṇa apānayoḥ aikyam kṛtvā sarvam viśvam ātma svarūpeṇa 
MBdhyaanabinduupanisatHK-548	lakṣyaṃ dhārayati yadā turīyātītāvasthā tadā sarveṣāmānandasvarūpo	lakṣyam dhārayati yadā turīyātīta avasthā tadā sarveṣām ānanda sva rūpā 
MBdhyaanabinduupanisatHK-549	bhavati dvandvātīto bhavati yāvaddehadhāraṇā vartate tāvattiṣṭhati	bhavati dvandva atītaḥ bhavati yāvat deha dhāraṇā vartate tāvat tiṣṭhati 
MBdhyaanabinduupanisatHK-550	paścāt paramātmasvarūpeṇa	paścāt paramātma svarūpeṇa 
MBdhyaanabinduupanisatHK-551	p. 209) prāptirbhavati ityanena prakāreṇa mokṣo	prāptiḥ bhavati iti anena prakāreṇa 
MBdhyaanabinduupanisatHK-552	bhavatīdamevātmadarśanopāyaṃ bhavati || 93-15 ||	bhavati idam eva ātma darśana upāyam bhavati 
MBdhyaanabinduupanisatHK-553	sacuṣpathasamāyuktamahādvāragavāyunā |	sa cuṣpatha samāyukta mahā dvāra gavāyunā 
MBdhyaanabinduupanisatHK-554	sahasthitatrikoṇordhvagamane dṛśyate'cyutaḥ || 94 ||	saha sthita trikoṇa ūrdhva gamane dṛśyate cyutaḥ 
MBdhyaanabinduupanisatHK-555	dhyeyanirṇayaḥ kathaṃ syādityāśaṅkya sopāyaṃ	dhyeya nirṇayaḥ katham syāt iti āśaṅkya sa upāyam 
MBdhyaanabinduupanisatHK-556	paramātmanirṇayamācaṣṭe- atheti | atha yathoktādhikārilābhānantaraṃ	paramātma nirṇayam ācaṣṭe atha iti atha yathā ukta adhikāri lābha anantaram 
MBdhyaanabinduupanisatHK-557	ātmayāthātmyaṃ sopāyaṃ vyākhyāsya iti paramadayāvatī śrutiḥ	ātma yāthātmyam sa upāyam vyākhyāsye iti parama dayāvatī śrutiḥ 
MBdhyaanabinduupanisatHK-558	evamāha- hṛdīti | hṛdayāṣṭadalamadhye rekhāvalayaṃ kṛtvā	evam āha hṛdi iti hṛdaya aṣṭadala madhye rekhā valayam kṛtvā 
MBdhyaanabinduupanisatHK-559	vṛttākāraṃ vibhāvya tanmadhye prāṇādhāraṃ haṃsajyotīrūpam	vṛtta ākāram vibhāvya tad madhye prāṇa ādhāram haṃsa jyotīḥ rūpam 
MBdhyaanabinduupanisatHK-560	jīvātmarūpaṃ aṇumātraṃ vartate | ya evaṃ vartate tasmin sarvaṃ	jīvātma rūpam aṇu mātram vartate yaḥ evam vartate tasmin sarvam 
MBdhyaanabinduupanisatHK-561	pratiṣṭhitaṃ bhavati tasya sarvādhikaraṇatvāt | sa hi sarvaṃ jānāti sarvaṃ	pratiṣṭhitam bhavati tasya sarva adhikaraṇa tvāt sa hi sarvam jānāti sarvam 
MBdhyaanabinduupanisatHK-562	karoti yat kartavyaṃ tat kṛtameva sarvam ahaṃ kartā ityādyabhimānī san	karoti yat kartavyam tat kṛtam eva sarvam aham kartā ityādi abhimānī san 
MBdhyaanabinduupanisatHK-563	vartata ityarthaḥ || 93-1 || tasya pūrvādidalayogato dharmādivṛttimattvamāha-	vartate iti arthaḥ    tasya pūrva ādi dala yogataḥ dharma ādi vṛttimat tvam āha 
MBdhyaanabinduupanisatHK-564	pūrveti | so'yaṃ jīvākhyo'haṃ haṃsaḥ yadā pūrvadale || 93-2-93-13 ||	pūrvā iti saḥ ayam jīva ākhyaḥ ham haṃsaḥ yadā pūrva dale 
MBdhyaanabinduupanisatHK-565	yat evaṃ ataḥ pūrvadalādidvitīyarekhāntaṃ vihāya	yat evam atas pūrva dala ādi dvitīya rekhā antam vihāya 
MBdhyaanabinduupanisatHK-566	tṛtīyarekhāmavalambya turyasvarūpaṃ	tṛtīya rekhām avalambya turya svarūpam 
MBdhyaanabinduupanisatHK-567	turyādiviśvāntagataheyāṃśāpahnavasiddhaṃ turyātītaṃ brahma	turya ādi viśva anta gata heya aṃśa apahnava siddham turyātītam brahma 
MBdhyaanabinduupanisatHK-568	niṣpratiyogikasvamātramiti tanmātratayā'vaśiṣṭo bhavatītyāha- tadā	niṣpratiyogika sva mātram iti tad mātra tayā avaśiṣṭaḥ bhavati iti āha tadā 
MBdhyaanabinduupanisatHK-569	śanaiḥ śanairiti || 93-14 || yadi svātiriktavṛttyudayo bhavati tadā	śanais śanais iti yadi sva atirikta vṛtti udayaḥ bhavati tadā 
MBdhyaanabinduupanisatHK-570	prāṇāpānayoraikyamityādi | sarvaṃ viśvamātmasvarūpeṇa lakṣyaṃ	prāṇa apānayoḥ aikyam ityādi sarvam viśvam ātma svarūpeṇa lakṣyam 
MBdhyaanabinduupanisatHK-571	dhārayati, viśvagataheyāṃśāahnavasiddhabrahmaṇaḥ svāvaśeṣatayā	dhārayati viśva gata heya aṃśa āahnava siddha brahmaṇaḥ sva avaśeṣa tayā 
MBdhyaanabinduupanisatHK-572	lakṣitatvāt | yadaivamavasthā lakṣyate tadā seyaṃ turīyāvasthā |	lakṣita tvāt yadā evam avasthā lakṣyate tadā sā iyam turīya avasthā 
MBdhyaanabinduupanisatHK-573	yāvaddehadhāraṇā           prāptirbhavati- yāvatprāptibhāsikatayāpi	      bhavati       api 
MBdhyaanabinduupanisatHK-574	deho'smīti jñānaṃ tāvajjīvanmuktidaśāmavalambya paścāt	dehaḥ asmi iti jñānam tāvat jīvanmukti daśām avalambya paścāt 
MBdhyaanabinduupanisatHK-575	svātiriktaṃ na kiṃcidastīti prabodhānantaraṃ paramātmaiva	sva atiriktam na kiṃcid asti iti prabodha anantaram paramātmā eva 
MBdhyaanabinduupanisatHK-576	bhavatītyarthaḥ | jīvatāyā anena prakāreṇa mokṣo bhavati |	bhavati iti arthaḥ jīvatāyāḥ anena prakāreṇa mokṣaḥ bhavati 
MBdhyaanabinduupanisatHK-577	idamevātmadarśanopāyaṃ netaradityarthaḥ || 93-15 ||	idam eva ātma darśana upāyam na itarat iti arthaḥ 
MBdhyaanabinduupanisatHK-578	mandānāmātmadarśanopāyamāha- catuṣpatheti | catuṣpatho	mandānām ātma darśana upāyam āha catuṣpatha iti 
MBdhyaanabinduupanisatHK-579	p. 210) jālaṃdharabandhaḥ tena samāyuktaṃ mahādvāraṃ	jālaṃdhara bandhaḥ tena samāyuktam mahā dvāram 
MBdhyaanabinduupanisatHK-580	suṣumnārandhraṃ gacchatīti mahādvāragaḥ sa cāsau vāyuśceti	suṣumnā randhram gacchati iti mahā dvāra gaḥ sa ca asau vāyuḥ ca iti 
MBdhyaanabinduupanisatHK-581	mahādvāragavāyuḥ tena mahādvāragavāyunā saha	mahādvāragavāyuḥ tena mahādvāragavāyunā saha 
MBdhyaanabinduupanisatHK-582	sthitamūlādhāratrikoṇasyordhvamūlādhāragamano	sthita mūlādhāra trikoṇasya ūrdhva mūlādhāra gamanaḥ 
MBdhyaanabinduupanisatHK-583	mūlādhārasthasuṣumnāyāṃ	mūlādhāra stha suṣumnāyām 
MBdhyaanabinduupanisatHK-584	dṛkprāṇāgnimanaḥkuṇḍalinīpraveśamātreṇa svamātrācyutaḥ	dṛś prāṇa agni manaḥ kuṇḍalinī praveśa mātreṇa sva mātrā acyutaḥ 
MBdhyaanabinduupanisatHK-585	paramātmā dṛśyate sākṣātkriyate ityarthaḥ || 94 ||	paramātmā dṛśyate sākṣātkriyate iti arthaḥ  
MBdhyaanabinduupanisatHK-586	nādānusaṃdhānataḥ ātmadarśanam	nāda anusaṃdhānataḥ ātma darśanam 
MBdhyaanabinduupanisatHK-587	pūrvoktatrikoṇasthānādupari pṛthivyādipañcavarṇakaṃ dhyeyam |	pūrva ukta trikoṇa sthānāt upari pṛthivī ādi pañca varṇakam dhyeyam 
MBdhyaanabinduupanisatHK-588	prāṇādipañcavāyuśca bījaṃ varṇaṃ ca sthānakam |	prāṇa ādi pañca vāyuḥ ca bījam varṇam ca sthānakam 
MBdhyaanabinduupanisatHK-589	yakāraṃ prāṇabījaṃ ca nīlajīmūtasaṃnibham |	yakāram prāṇa bījam ca nīla jīmūta saṃnibham 
MBdhyaanabinduupanisatHK-590	rakāramagnibījaṃ ca apānādityasaṃnibham || 95 ||	rakāram agni bījam ca apāna āditya saṃnibham 
MBdhyaanabinduupanisatHK-591	lakāraṃ pṛthivīrūpaṃ vyānaṃ bandhūkasaṃnibham |	lakāram pṛthivī rūpam vyānam bandhūka saṃnibham 
MBdhyaanabinduupanisatHK-592	vakāraṃ jīvabījaṃ ca udānaṃ śaṅkhavarṇakam || 96 ||	vakāram jīva bījam ca udānam śaṅkha   
MBdhyaanabinduupanisatHK-593	hakāraṃ viyatsvarūpaṃ ca samānaṃ sphaṭikaprabham |	hakāram viyat svarūpam ca samānam sphaṭika prabham 
MBdhyaanabinduupanisatHK-594	hṛnnābhināsikākaṇṭhapādāṅguṣṭhādisaṃsthitaḥ || 97 ||	hṛd nābhi nāsikā kaṇṭha pāda aṅguṣṭha ādi saṃsthitaḥ 
MBdhyaanabinduupanisatHK-595	dvisaptatisahasrāṇi nāḍīmārgeṣu vartate |	dvisaptati sahasrāṇi nāḍī mārgeṣu vartate 
MBdhyaanabinduupanisatHK-596	aṣṭāviṃśatikoṭīṣu romakūpeṣu saṃsthitaḥ || 98 ||	aṣṭāviṃśati koṭīṣu romakūpeṣu saṃsthitaḥ 
MBdhyaanabinduupanisatHK-597	samānaprāṇa ekastu jīvaḥ sa eka eva hi |	samāna prāṇaḥ ekaḥ tu jīvaḥ saḥ ekaḥ eva hi 
MBdhyaanabinduupanisatHK-598	recakāditrayaṃ kuryād dṛḍhacittaṃ samāhitaḥ || 99 ||	recaka ādi trayam kuryāt dṛḍha cittam samāhitaḥ 
MBdhyaanabinduupanisatHK-599	śanaiḥ samastamākṛṣya hṛtsaroruhakoṭare |	śanais samastam ākṛṣya hṛd saroruha koṭare 
MBdhyaanabinduupanisatHK-600	prāṇāpānau ca baddhvā tu praṇavena samuccaret || 100 ||	prāṇa apānau ca baddhvā tu praṇavena samuccaret 
MBdhyaanabinduupanisatHK-601	p. 211) kaṇṭhasaṃkocanaṃ kṛtvā liṅgasaṃkocanaṃ tathā |	kaṇṭha saṃkocanam kṛtvā liṅga saṃkocanam tathā 
MBdhyaanabinduupanisatHK-602	mūlādhārāt suṣumnā ca bisatantunibhā śubhā || 101 ||	mūlādhārāt suṣumnā ca bisa tantu nibhā śubhā 
MBdhyaanabinduupanisatHK-603	amūrto vartate nādo vīṇādaṇḍasamutthitaḥ |	amūrtaḥ vartate nādaḥ vīṇā daṇḍa samutthitaḥ 
MBdhyaanabinduupanisatHK-604	śaṅkhanādādibhiścaiva madhyameva dhvaniryathā || 102 ||	śaṅkha nāda ādibhiḥ ca eva madhyam eva dhvaniḥ yathā 
MBdhyaanabinduupanisatHK-605	vyomarandhragato nādo māyūraṃ nādameva ca |	vyomarandhra gataḥ nādaḥ māyūram nādam eva ca 
MBdhyaanabinduupanisatHK-606	kapālakuhare madhye caturdvārasya madhyame || 103 ||	kapāla kuhare madhye catur dvārasya madhyame 
MBdhyaanabinduupanisatHK-607	tadātmā rājate tatra yathā vyomni divākaraḥ |	tad ātmā rājate tatra yathā vyomni divākaraḥ 
MBdhyaanabinduupanisatHK-608	kodaṇḍadvayamadhye tu brahmarandhreṣu śakti ca || 104 ||	     tu     ca 
MBdhyaanabinduupanisatHK-609	svātmānaṃ puruṣaṃ paśyenmanastatra layaṃ gatam |	sva ātmānam puruṣam paśyet manaḥ tatra layam gatam 
MBdhyaanabinduupanisatHK-610	ratnāni jyotsninādaṃ tu bindu māheśvaraṃ padam || 105 ||	ratnāni jyotsni nādam tu bindu māheśvaram padam 
MBdhyaanabinduupanisatHK-611	ya evaṃ veda puruṣaḥ sa kaivalyaṃ samaśnute || 106 ||	yaḥ evam veda puruṣaḥ sa kaivalyam samaśnute  /
MBdhyaanabinduupanisatHK-612	ityupaniṣat ||	iti upaniṣad 
MBdhyaanabinduupanisatHK-613	evamakṛtasākṣātkārāṇāṃ nādānusaṃdhānopāyataḥ tatpadāptiṃ	evam akṛta sākṣātkārāṇām nāda anusaṃdhāna upāyataḥ tatpada āptim 
MBdhyaanabinduupanisatHK-614	prakaṭayannupasaṃharati- pūrveti || dhyeyam- kiṃ tat ? prāṇādi |	prakaṭayan upasaṃharati pūrvā iti dhyeyam kim tat prāṇa ādi 
MBdhyaanabinduupanisatHK-615	yadyevamapakvacittaḥ kaścit tena	yadi evam apakva cittaḥ kaścid tena 
MBdhyaanabinduupanisatHK-616	pūrvoktamūlādhāratrikoṇāgnimaṇḍalādupari prāṇādivāyujātaṃ	pūrva ukta mūlādhāra trikoṇa agni maṇḍalāt upari prāṇa ādi vāyu jātam 
MBdhyaanabinduupanisatHK-617	pṛthivyādipañcavarṇayuktaṃ dhyeyam | yakārādibījaṃ	pṛthivī ādi pañca varṇa yuktam dhyeyam yakāra ādi bījam 
MBdhyaanabinduupanisatHK-618	nīlajīmūtādivarṇaṃ hṛdayādisthānaviśiṣṭaṃ dhyeyamiti	nīla jīmūta ādi varṇam hṛdaya ādi sthāna viśiṣṭam dhyeyam iti 
MBdhyaanabinduupanisatHK-619	pūrveṇānvayaḥ | ādau hṛdi yakāraṃ prāṇabījaṃ vidyāt	pūrveṇa anvayaḥ ādau hṛdi yakāram prāṇa bījam vidyāt 
MBdhyaanabinduupanisatHK-620	nīlajīmūtatulyavarṇaviśiṣṭaṃ prāṇaṃ jānīyādityadhyāhāryam | gude	nīla jīmūta tulya varṇa viśiṣṭam prāṇam jānīyāt iti adhyāhāryam gude 
MBdhyaanabinduupanisatHK-621	rephamagnibījamapānamādityasaṃnibhaṃ vidyāt || 95 || pṛthivībījaṃ	repham agni bījam apānam āditya saṃnibham vidyāt pṛthivī bījam 
MBdhyaanabinduupanisatHK-622	lakāraṃ bandhūkasaṃnibhaṃ vyānaṃ kṛtsnaśarīravyāpakaṃ vidyāt |	lakāram bandhūka saṃnibham vyānam kṛtsna śarīra vyāpakam vidyāt 
MBdhyaanabinduupanisatHK-623	kaṇṭhadeśe vakāraṃ jīvabījamudānaṃ śaṅkhavarṇaviśiṣṭaṃ vidyāt ||	kaṇṭha deśe vakāram jīva bījam udānam śaṅkha varṇa viśiṣṭam vidyāt 
MBdhyaanabinduupanisatHK-624	96 || hakāraṃ viyadbījaṃ samānaṃ nābhyāsanaṃ sphaṭikaprabhaṃ ca	                   
MBdhyaanabinduupanisatHK-625	vidyāt | evaṃ prāṇapañcakaṃ	vidyāt evam prāṇa pañcakam 
MBdhyaanabinduupanisatHK-626	p. 212) hṛnnābhināsikākaṇṭhapādāṅguṣṭhādiṣu saṃsthitaṃ vidyāt ||	hṛd nābhi nāsikā kaṇṭha pāda aṅguṣṭha ādiṣu saṃsthitam vidyāt 
MBdhyaanabinduupanisatHK-627	97 || tatra samānavāyustu dvisaptatisahasranāḍīmārgeṣu sadā saṃcaran	tatra samāna vāyuḥ tu dvisaptati sahasra nāḍī mārgeṣu sadā saṃcaran 
MBdhyaanabinduupanisatHK-628	vartate aṣṭāviṃśatikoṭiromakūpeṣu vyāpya sthito bhavati || 98 ||	vartate aṣṭāviṃśati koṭi romakūpeṣu vyāpya sthitaḥ bhavati 
MBdhyaanabinduupanisatHK-629	vicāryamāṇe ekastu- tuśabdo'vadhāraṇārthaḥ-	vicāryamāṇe ekaḥ tu tuśabdaḥ vadhāraṇa arthaḥ 
MBdhyaanabinduupanisatHK-630	samānādiprāṇāntavāyubhedaḥ eka eva | ya evaṃ pañcaprāṇādhāraḥ	samāna ādi prāṇa anta vāyu bhedaḥ ekaḥ eva yaḥ evam pañca prāṇa ādhāraḥ 
MBdhyaanabinduupanisatHK-631	so'yaṃ jīva eka eva | hiśabdaḥ prasiddhidyotakaḥ | evaṃ jñātvā tataḥ	saḥ ayam jīvaḥ ekaḥ eva hi śabdaḥ prasiddhi dyotakaḥ evam jñātvā tatas 
MBdhyaanabinduupanisatHK-632	paraṃ recakādi iti | evaṃ yathoktapañcaprāṇārūḍhajīvasvarūpaṃ	param recaka ādi iti evam yathā ukta pañca prāṇa ārūḍha jīva svarūpam 
MBdhyaanabinduupanisatHK-633	jñātvā tato dṛḍhacitto yogī samāhito bhūtvā	jñātvā tatas dṛḍha cittaḥ yogī samāhitaḥ bhūtvā 
MBdhyaanabinduupanisatHK-634	recakādyavayavatrayaviśiṣṭaprāṇāyāmatrayaṃ kuryāt || 99 || śanaiḥ	recaka ādi avayava traya viśiṣṭa prāṇāyāma trayam kuryāt śanais 
MBdhyaanabinduupanisatHK-635	svāntaḥkaraṇavṛttisahasraṃ hṛtsaroruhakoṭare samākṛṣya tatraiva	sva antaḥkaraṇa vṛtti sahasram hṛd saroruha koṭare samākṛṣya tatra eva 
MBdhyaanabinduupanisatHK-636	prāṇāpānau ca baddhvā praṇavena tu praṇavenaiva	prāṇa apānau ca baddhvā praṇavena tu praṇavena eva 
MBdhyaanabinduupanisatHK-637	praṇavenājñāsahasrāracakraṃ pratyuccaret ūrdhvaṃ nayet || 100 ||	praṇavena ājñā sahasra āra cakram pratyuccaret ūrdhvam nayet  /
MBdhyaanabinduupanisatHK-638	tadupāyatayā kaṇṭhaliṅgasaṃkocanagrahaṇaṃ	tad upāya tayā kaṇṭha liṅga saṃkocana grahaṇam 
MBdhyaanabinduupanisatHK-639	bandhatrayopalakṣaṇārtham | tathā bandha trayaṃ kṛtvā mūlādhārāt	bandha traya upalakṣaṇa artham tathā bandha trayam kṛtvā mūlādhārāt 
MBdhyaanabinduupanisatHK-640	mūlādhāramārabhya padmatantunibhā śubhā suṣumnā- caśabdāt	mūlādhāram ārabhya padma tantu nibhā śubhā suṣumnā caśabdāt 
MBdhyaanabinduupanisatHK-641	tadantaḥkaivalyanāḍī ca- pratiṣṭhitā bhavatīti dyotyate || 101 || tatra	tad antar kaivalyanāḍī ca pratiṣṭhitā bhavati iti dyotyate tatra 
MBdhyaanabinduupanisatHK-642	suṣumnāśrayavīṇādaṇḍe samutthitaḥ san amūrto nādo vartate | ata eva	suṣumnā āśraya vīṇā daṇḍe samutthitaḥ san amūrtaḥ nādaḥ vartate atas eva 
MBdhyaanabinduupanisatHK-643	vīṇādaṇḍamadhyameva nādotpattisthānaṃ yathā	vīṇā daṇḍa madhyam eva nāda utpatti sthānam yathā 
MBdhyaanabinduupanisatHK-644	śaṅkhanādādibhiścaiva || 102 || hṛdvyomarandhragato nādo'bhivyakto	śaṅkhanāda ādibhiḥ ca eva hṛd vyoma randhra gataḥ 
MBdhyaanabinduupanisatHK-645	bhavati | yadāyaṃ nādo māyūraṃ nādamevānukaroti tadā	bhavati yadā ayam nādaḥ māyūram nādam eva anukaroti tadā 
MBdhyaanabinduupanisatHK-646	iḍāpiṅgalāsuṣumnāghaṇṭikābhedena caturdvārasya madhyame	iḍā piṅgalā suṣumnā ghaṇṭikā bhedena catur dvārasya madhyame 
MBdhyaanabinduupanisatHK-647	kapālakuharamadhye || 103 || tatra yadā vyomni divākaraḥ tathā paramātmā	kapāla kuhara madhye tatra yadā vyomni divākaraḥ tathā paramātmā 
MBdhyaanabinduupanisatHK-648	rājate samyagabhivyakto bhavati | yatra mana-	rājate samyak abhivyaktaḥ bhavati yatra 
MBdhyaanabinduupanisatHK-649	upalakṣitadṛṣṭivāyvagnikuṇḍalyādikaṃ layaṃ gataṃ tatra	upalakṣita dṛṣṭi vāyu agni kuṇḍalī ādikam layam gatam tatra 
MBdhyaanabinduupanisatHK-650	mūlādhārādibrahmopalabdhirandhreṣu kodaṇḍadvayamadhye tu-	                            
MBdhyaanabinduupanisatHK-651	tuścārthaḥ- yathāśakti yathābalam || 104 || svātmānaṃ puruṣaṃ paśyet |	tuḥ ca arthaḥ yathāśakti yathābalam       sva ātmānam puruṣam paśyet 
MBdhyaanabinduupanisatHK-652	kiṃviśeṣaṇaviśiṣṭamityatra, vajradaṇḍasamudbhūtāḥ	kiṃviśeṣaṇa viśiṣṭam iti atra vajra daṇḍa samudbhūtāḥ 
MBdhyaanabinduupanisatHK-653	maṇayaścaikaviṃśatiḥ iti śrutyanurodhena	maṇayaḥ ca ekaviṃśatiḥ iti śruti anurodhena 
MBdhyaanabinduupanisatHK-654	viśvaturyamityārabhyāvikalpānujñaikarasāntāni	viśvaturyam iti ārabhya a vikalpa anujñā ekarasa antāni 
MBdhyaanabinduupanisatHK-655	ekaviṃśatiturīyaratnāni teṣāṃ jyotsni jyotiṣmadadhikaraṇaṃ	ekaviṃśati turīya ratnāni teṣām jyotsni jyotiṣmat adhikaraṇam 
MBdhyaanabinduupanisatHK-656	jāgrajjāgradādicatuṣpañcadaśavikalpaṃ na dadātīti nadaṃ tadeva	jāgrat jāgrat ādi catuṣpañcadaśa vikalpam na dadāti iti nadam tat eva 
MBdhyaanabinduupanisatHK-657	nādaṃ turyaturyaṃ bindu nirviśeṣarūpaṃ mahāṃścāsau	nādam turya turyam bindu nirviśeṣa rūpam mahān ca asau 
MBdhyaanabinduupanisatHK-658	niṣpratiyogikabrahmamātratayāvasthātumīśvaraśceti maheśvaraḥ	niṣpratiyogika brahma mātra tayā avasthātum īśvaraḥ ca iti maheśvaraḥ 
MBdhyaanabinduupanisatHK-659	tadbhāvo māheśvaraṃ svamātratayā padmate iti padaṃ vidvān paśyediti	tad bhāvaḥ māheśvaram sva mātra tayā iti padam vidvān paśyet iti 
MBdhyaanabinduupanisatHK-660	pūrveṇānvayaḥ || 105 || vidyāphalaṃ vadannupasaṃharati- ya	pūrveṇa anvayaḥ     vidyā phalam vadan upasaṃharati yaḥ 
MBdhyaanabinduupanisatHK-661	p. 213) iti | vidvān vedanasamakālaṃ kaivalyarūpeṇa avaśiṣyate ityatra	iti vidvān vedana sama kālam kaivalya rūpeṇa avaśiṣyate iti atra 
MBdhyaanabinduupanisatHK-662	brahma veda brahmaiva bhavati iti jñānasamakālameva	brahma veda brahmā eva bhavati iti jñāna sama kālam eva 
MBdhyaanabinduupanisatHK-663	brahmamātrabhāvāpattiśruteḥ | ityupaniṣacchabdo'yaṃ	brahma mātra bhāva āpatti śruteḥ iti upaniṣad śabdaḥ yaḥ 
MBdhyaanabinduupanisatHK-664	dhyānabindūpaniṣatsamāptyarthaḥ || 106 ||	          
MBdhyaanabinduupanisatHK-665	śrīvāsudevendraśiṣyopaniṣadbrahmayoginā |	              
MBdhyaanabinduupanisatHK-666	likhitaṃ syādvivaraṇaṃ dhyānabindoḥ sphuṭaṃ laghu ||	likhitam syāt vivaraṇam dhyānabindoḥ sphuṭam laghu 
MBdhyaanabinduupanisatHK-667	dhyānabinduvivaraṇaṃ triṃśadadhiśatatrayam ||	            
MBdhyaanabinduupanisatHK-668	iti śrīmadīśādyaṣṭottaraśatopaniṣacchāstravivaraṇe	iti śrīmat īśa ādi aṣṭottaraśata upaniṣad śāstra vivaraṇe 
MBdhyaanabinduupanisatHK-669	ekonacatvāriṃśatsaṃkhyāpūrakaṃ dhyānabindūpaniṣadvivaraṇaṃ	ekonacatvāriṃśat saṃkhyā pūrakam dhyānabindu upaniṣad vivaraṇam 
MBdhyaanabinduupanisatHK-670	saṃpūrṇam	saṃpūrṇam 
MBdhyaanabinduupanisatHK-671	MUKTABODHA INDOLOGICAL RESEARCH INSTITUTE©2011 Muktabodha Indological Research Institute  All Rights Reserved.E-texts may be viewed only online or downloaded for private study.E-texts may not, under any circumstances, be copied, republished,reproduced, distributed or sold, either in original or altered form, withoutthe express permission of Muktabodha Indological Research Institute in writing.Data-entered by the staff of Muktabodha under the direction of Mark S. G. Dyczkowski.	muktabodha indological research muktabodha indological research institute all rights reserved texts may be viewed only online or downloaded for private studye texts may not under any circumstances be copied republished reproduced distributed or sold either in original or altered form withoutthe express permission of muktabodha indological research institute in writing data entered by the staff of muktabodha under the direction of mark s g dyczkowski 
