segmentnr	original	analyzed
MBIISVARASIDDHI_hk-0	Muktabodha E-text in UTF-8	muktabodha etext in utf
MBIISVARASIDDHI_hk-1	###########################################################################MUKTABODHA INDOLOGICAL RESEARCH INSTITUTEwww.muktabodha.org©2011 Muktabodha Indological Research Institute  All Rights Reserved.E-texts may be viewed only online or downloaded for private study.E-texts may not, under any circumstances, be copied, republished,reproduced, distributed or sold, either in original or altered form, withoutthe express permission of Muktabodha Indological Research Institute in writing.Data-entered by the staff of Muktabodha under the direction of Mark S. G. Dyczkowski.Catalog number : M00023	muktabodha indological research muktabodha indological research institute all rights reserved texts may be viewed only online or downloaded for private studye texts may not under any circumstances be copied republished reproduced distributed or sold either in original or altered form withoutthe express permission of muktabodha indological research institute in writing data entered by the staff of muktabodha under the direction of mark s g dyczkowskicatalog number  /
MBIISVARASIDDHI_hk-2	Uniform title: īśvarasiddhi	uniform title īśvarasiddhi 
MBIISVARASIDDHI_hk-3	Main title: īśvarasiddhiḥ	main title īśvarasiddhiḥ 
MBIISVARASIDDHI_hk-4	Secondary title: siddhitrayī	secondara title siddhitrayī 
MBIISVARASIDDHI_hk-5	Author : utpaladeva	authoḥ utpaladeva 
MBIISVARASIDDHI_hk-6	Editor : śastrī m k	e t itoḥ śastrī m k 
MBIISVARASIDDHI_hk-7	Description: Text taken from Volume 34 of the Kashmir Series of Texts and Studies.  The Siddhitrayi and the Pratyabhijna-karika-vritti of Rajanaka Utpala deva  Note: siddhitrayī consists of three works by utpaladeva: ājaḍa-pramātṛ-siddhi, iśvara-siddhi and sambandha-siddhi .	description text taken from volume of the kashmir series of texts and studies the siddhitrayi and the pratyabhijnakarikavritti of rajanaka utpala deva note siddhitrayī consists of three works by utpaladeva ājaḍa pramātṛsiddhi iśvarasiddhi and sambandhasiddhi 
MBIISVARASIDDHI_hk-8	Notes: Data-entered by the staff of Muktabodha under the supervision of Mark Dyczkowski.    Revision 0: 28/11/2005	notes data entered by the staff muktabodha under the supervision of mark dyczkowski 
MBIISVARASIDDHI_hk-9	Publisher : Research Department, Jammu and Kashmir State	publisher research depatment jammu and kashmir state 
MBIISVARASIDDHI_hk-10	Publication year : 1921	publication year 
MBIISVARASIDDHI_hk-11	Publication city : Srinigar	publication citi srinigar 
MBIISVARASIDDHI_hk-12	Publication country : India	publication country india 
MBIISVARASIDDHI_hk-13	|| oṃ ||	om 
MBIISVARASIDDHI_hk-14	atha	atha 
MBIISVARASIDDHI_hk-15	īśvarasiddhiḥ	īśvara siddhiḥ 
MBIISVARASIDDHI_hk-16	śrīmadācāryotpaladevaviracitā |	śrīmat ācārya utpaladeva viracitā 
MBIISVARASIDDHI_hk-17	karoti tamahaṃ devamekaṃ naumi maheśvaram || 1 ||	karoti tam aham devam ekam naumi maheśvaram 
MBIISVARASIDDHI_hk-18	tanukaraṇādikāryaṃ buddhimatkartṛpūrvakaṃ saṃniveśaviśeṣavattvāt,	tanu karaṇa ādi kāryam buddhimat kartṛ pūrvakam saṃniveśa viśeṣavat tvāt 
MBIISVARASIDDHI_hk-19	yadyatsaṃniveśaviśeṣavat tattadbuddhimatkartṛnirmitaṃ yathā ghaṭaḥ,	yat yat saṃniveśa viśeṣa vat tat tat buddhimat kartṛ nirmitam yathā ghaṭaḥ 
MBIISVARASIDDHI_hk-20	buddhimatkartṛpūrvakaṃ yanna bhavati na tat saṃniveśaviśeṣavatkāryaṃ yathā	buddhimat kartṛ pūrvakam yat na bhavati na tat saṃniveśa viśeṣavat kāryam yathā 
MBIISVARASIDDHI_hk-21	paramāṇvākāśaśaśaviṣāṇādi, tathā ca bhavati saṃniveśaviśeṣavat	paramāṇu ākāśa śaśaviṣāṇa ādi tathā ca bhavati saṃniveśa viśeṣa vat 
MBIISVARASIDDHI_hk-22	tanvādikāryaṃ, tasmādbuddhimatkartṛpūrvakamiti | tadāha	tanu ādi kāryam tasmāt buddhimat kartṛ pūrvakam iti tat āha 
MBIISVARASIDDHI_hk-23	tanvādi buddhimaddhetu saṃniveśaviśeṣavat |	tanu ādi buddhimat hetu saṃniveśa viśeṣavat 
MBIISVARASIDDHI_hk-24	(p. 2)	p 
MBIISVARASIDDHI_hk-25	ghaṭa..............................................paramāṇuvat || 2 ||	ghaṭa paramāṇu vat 
MBIISVARASIDDHI_hk-26	iti ||	iti 
MBIISVARASIDDHI_hk-27	atra ca dharmisaṃbandhabalāt............................. hetubhūtārthakriyopayogitā	atra ca dharmi saṃbandha balāt hetu bhūta artha kriyā upayogi tā 
MBIISVARASIDDHI_hk-28	ca kathyate | ghaṭasya hi mṛdupādānakāraṇatvena siddhā | tatra ca na	ca kathyate ghaṭasya hi mṛd upādānakāraṇa tvena siddhā tatra ca na 
MBIISVARASIDDHI_hk-29	pṛthubudhnodarākārasaṃniveśaviśeṣasaṃbhavaḥ, lokayātrāyāśca tathā	pṛthu budhna udara ākāra saṃniveśa viśeṣa saṃbhavaḥ lokayātrāyāḥ ca tathā 
MBIISVARASIDDHI_hk-30	saṃniveśaviśeṣavatā vicitreṇa vastunā vinā mahatī khaṇḍanā, sahakārī ca	saṃniveśa viśeṣavatā vicitreṇa vastunā vinā mahatī khaṇḍanā sahakārī ca 
MBIISVARASIDDHI_hk-31	tathā saṃniveśavata eva rūparasādyanyathātve vyāpriyeta | yathā	tathā saṃniveśavataḥ eva rūpa rasa ādi anyathātve vyāpriyeta yathā 
MBIISVARASIDDHI_hk-32	svacchasarasyūṣmasaṃparkaḥ | vāyusaṃbandhavaśādapi kāryasya	svaccha sarasi ūṣma saṃparkaḥ vāyu saṃbandha vaśāt api kāryasya 
MBIISVARASIDDHI_hk-33	saṃsthānāntaraṃ syādapi kadācit na tu niyamena bhavet anantapadārthasārthasya	saṃsthāna antaram syāt api kadācid na tu niyamena bhavet ananta padārtha sa arthasya 
MBIISVARASIDDHI_hk-34	samānajātīyatotthāpananimittamanyathāpi vāyuprasarasya saṃbhavāt,	samāna jātīya tā utthāpana nimittam anyathā api vāyu prasarasya saṃbhavāt 
MBIISVARASIDDHI_hk-35	ekarūpa..................................... utthāpakatve vā vāyureva buddhimānastu.................	eka rūpe utthāpaka tve vā vāyuḥ eva buddhimān astu 
MBIISVARASIDDHI_hk-36	kiṃ saṃvidā..........................................................	kim saṃvidā 
MBIISVARASIDDHI_hk-37	buddhimatprorito vā.......................................... |	buddhimat proritaḥ vā 
MBIISVARASIDDHI_hk-38	..............................................ṭato ghaṭo yathā || 3 ||	ṭataḥ ghaṭaḥ yathā 
MBIISVARASIDDHI_hk-39	iti ||	iti 
MBIISVARASIDDHI_hk-40	ghaṭajātīya eva dṛṣṭāntadharmī.................................................... rapi	ghaṭa jātīyaḥ eva dṛṣṭānta dharmī 
MBIISVARASIDDHI_hk-41	tadākāraniyataḥ sādhyadharmitayā jātiprādhānyenaivopādīyate | taditthaṃ	tad ākāra niyataḥ sādhya dharmitayā jāti prādhānyena eva upādīyate tat ittham 
MBIISVARASIDDHI_hk-42	dharmaviśeṣasaṃniveśaviśeṣo lokayātrā	dharma viśeṣa saṃniveśa viśeṣaḥ lokayātrā 
MBIISVARASIDDHI_hk-43	nirvāhakaheturupādānakāraṇāsaṃbhavī ca na	nirvāhaka hetuḥ upādānakāraṇa asaṃbhavī ca na 
MBIISVARASIDDHI_hk-44	svatantrecchāvatkāraṇasaṃbandhamantareṇa	svatantra icchāvat kāraṇa saṃbandham antareṇa 
MBIISVARASIDDHI_hk-45	(p. 3)	p 
MBIISVARASIDDHI_hk-46	niyamāt upādānadeśaparihāreṇāparadeśagamanenopapadyate | karmāṇyapi	niyamāt upādāna deśa parihāreṇa apara deśa gamanena upapadyate karmāṇi api 
MBIISVARASIDDHI_hk-47	sahakāritāmāpadyamānāni tadavasthāsaṃsthāne rūpamātravaicitryaṃ	sahakāri tām āpadyamānāni tad avasthā saṃsthāne rūpa mātra vaicitryam 
MBIISVARASIDDHI_hk-48	vidadhyuḥ, na tvekaikasādhanā deśakramākramaṇalakṣaṇā	vidadhyuḥ na tu ekaika sādhanā deśa krama ākramaṇa lakṣaṇā 
MBIISVARASIDDHI_hk-49	saṃniveśanāpadeśā sadṛśārthakriyākārisajātīyārthajātotthāpananiyatā	saṃniveśana apadeśā sadṛśa artha kriyā kāri sajātīya artha jāta utthāpana niyatā 
MBIISVARASIDDHI_hk-50	kriyā tatkāryā bhavitumarhati | yadyapyādhārasaṃyogabhaṅgotpātalakṣaṇā	kriyā tad kāryā bhavitum arhati yadi api ādhāra saṃyoga bhaṅga utpāta lakṣaṇā 
MBIISVARASIDDHI_hk-51	kriyā syāt tathāpi ādhārasyaikasaṃsthānāvasthānāt bhaṅga eva nopapanno	kriyā syāt tathā api ādhārasya eka saṃsthāna avasthānāt bhaṅgaḥ eva na upapannaḥ 
MBIISVARASIDDHI_hk-52	yāvatsākṣāt pāraṃparyeṇa vāpi avayavānāmasya prekṣāpūrvakāriṇā	yāvat sākṣāt pāraṃparyeṇa vā api avayavānām asya prekṣā pūrva kāriṇā 
MBIISVARASIDDHI_hk-53	buddhimatā deśāntarasaṃcaraṇaṃ na kṛtaṃ, vātādikṛta...............................	buddhimatā deśa antara saṃcaraṇam na kṛtam vāta ādi kṛta 
MBIISVARASIDDHI_hk-54	mayamaprasaṅgaḥ prāgukta eva | .....................ṇirupākhyatāmādhāramā-	mayam aprasaṅgaḥ prāc uktaḥ eva 
MBIISVARASIDDHI_hk-55	pādayannādheyamadhaḥ pātayati, tadāpyagneḥ prāktanadeśaparihāre	pādayan ādheyam adhas pātayati tadā api agneḥ prāktana deśa parihāre 
MBIISVARASIDDHI_hk-56	nimittāntaramicchāvadvācyam | .................. pārthivadravyasaṃgharṣajatve'pi	nimitta antaram icchāvat vācyam pārthiva dravya saṃgharṣa ja tve pi 
MBIISVARASIDDHI_hk-57	pūrvavanniyamoddhoṣaṇadūṣaṇam | yadā punarniyamenāgneḥ	pūrvavat niyama uddhoṣaṇa dūṣaṇam yadā punar niyamena agneḥ 
MBIISVARASIDDHI_hk-58	svedapākadāhādinā dravyamanyasaṃniveśaṃ karoti, yena viśiṣṭajātibhāñji	sveda pāka dāha ādinā dravyam anya saṃniveśam karoti yena viśiṣṭa jāti bhāñji 
MBIISVARASIDDHI_hk-59	bhāvāntarāṇyucchūnatādiracanāviśeṣavanti uttiṣṭhanti, tadā	bhāva antarāṇi ucchūna tā ādi racanā viśeṣavanti uttiṣṭhanti tadā 
MBIISVARASIDDHI_hk-60	buddhimatpreraṇopapāditatathākṛtīni tāni, nānyathā pūrvoktanayena	buddhimat preraṇa upapādita tathā ākṛtīni tāni na anyathā pūrva ukta nayena 
MBIISVARASIDDHI_hk-61	niyamayogaḥ | tadevamupādānāsaṃbhavī deśāntaropasarpaṇātmā	niyama yogaḥ tat evam upādāna asaṃbhavī deśa antara upasarpaṇa ātmā 
MBIISVARASIDDHI_hk-62	lokasthitihetuḥ saṃniveśo niyamena tajjātīyatāpādako buddhimatkāraṇābhāve	                                       
MBIISVARASIDDHI_hk-63	sarvathānupapadyamāno buddhimatkartṛnirmito dṛṣṭaḥ | .................	sarvathā anupapadyamānaḥ buddhimat kartṛ nirmitaḥ dṛṣṭaḥ 
MBIISVARASIDDHI_hk-64	.....................................................ksaṃsthānavarjitaḥ |	k saṃsthāna varjitaḥ 
MBIISVARASIDDHI_hk-65	niścito'rtho'sya saṃsthāne tasminnarthakriyācite || 4 ||	niścitaḥ ūrthaḥ asya saṃsthāne tasmin artha kriyā cite  /
MBIISVARASIDDHI_hk-66	(p. 4)	p 
MBIISVARASIDDHI_hk-67	vicitre buddhimāneva ghaṭādiṣviva lakṣyate |	vicitre buddhimān eva ghaṭa ādiṣu iva lakṣyate 
MBIISVARASIDDHI_hk-68	kartā vijño vicitraitadupayogābhisaṃdhimān || 5 ||	kartā vijñaḥ vicitra etad upayoga abhisaṃdhimān 
MBIISVARASIDDHI_hk-69	iti ||	iti 
MBIISVARASIDDHI_hk-70	vyāptisiddhaye na cāpyeṣa saṃniveśaviśeṣastanvādiṣvasiddhaḥ | tathā hi	vyāpti siddhaye na ca api eṣa saṃniveśa viśeṣaḥ tanu ādiṣu asiddhaḥ tathā hi 
MBIISVARASIDDHI_hk-71	śarīre tāvadupādānakāraṇaṃ śukraśoṇitādi siddhaṃ | na cāsya	śarīre tāvat upādānakāraṇam śukra śoṇita ādi siddham na ca asya 
MBIISVARASIDDHI_hk-72	tatsaṃniveśayogaḥ | cakṣuḥśrotrapāṇipādāderapi	tad saṃniveśa yogaḥ cakṣuḥ śrotra pāṇi pāda ādeḥ api 
MBIISVARASIDDHI_hk-73	tadevopādānamatatsaṃniveśi, bhuvanānāmapi	tat eva upādānam a tad saṃniveśi bhuvanānām api 
MBIISVARASIDDHI_hk-74	pārthivādyartharacanātmakānāṃ mṛdādyupādānamatatsaṃniveśyeva	pārthiva ādi artha racanā ātmakānām mṛd ādi upādānam a tad saṃniveśyā iva 
MBIISVARASIDDHI_hk-75	siddhaṃ, nātra kiṃciddurupapādam | lokayātrātrāṇahetutāpi śarīrādeḥ	siddham na atra kiṃcid durupapādam lokayātrā trāṇa hetu tā api śarīra ādeḥ 
MBIISVARASIDDHI_hk-76	sarvavādisiddhaiva pratyakṣata eva | nātrāsthāne vistaropanyāsaḥ saphalaḥ | tataḥ	sarva vādi siddhā eva pratyakṣatas eva na atra asthāne vistara upanyāsaḥ saphalaḥ tatas 
MBIISVARASIDDHI_hk-77	siddha eva hetuḥ || tadāha	siddhaḥ eva hetuḥ tat āha 
MBIISVARASIDDHI_hk-78	asti cārthakriyāyoge śarīrabhuvanādiṣu |	asti ca artha kriyā yoge śarīra bhuvana ādiṣu 
MBIISVARASIDDHI_hk-79	saṃniveśaviśeṣo'yamanupādānasaṃbhavī || 6 ||	saṃniveśa viśeṣaḥ ayam anupādāna saṃbhavī 
MBIISVARASIDDHI_hk-80	iti ||	iti 
MBIISVARASIDDHI_hk-81	īśvarasiddhiparyavasānaścāyaṃ sādhanārthaḥ | tanvādiṣu hi	īśvara siddhi paryavasānaḥ ca ayam sādhana arthaḥ tanu ādiṣu hi 
MBIISVARASIDDHI_hk-82	viśvāparaparyāyeṣu parasparānuguṇeṣu sarveṣu yāvajjñānaṃ nāsti	viśva apara paryāyeṣu paraspara anuguṇeṣu sarveṣu yāvat jñānam na asti 
MBIISVARASIDDHI_hk-83	tāvatkathaṃ nirmitsā syāt,-iti sarvajñatā tāvatsthitā, tathā	tāvat katham nirmitsā syāt iti sarvajña tā tāvat sthitā tathā 
MBIISVARASIDDHI_hk-84	nirmāṇasāmarthyācca anekatve pramāṇābhāvācca ekasya sarvakartṛtvam,-	nirmāṇa sāmarthyāt ca aneka tve pramāṇa abhāvāt ca ekasya sarva kartṛ tvam 
MBIISVARASIDDHI_hk-85	(p. 5)	p 
MBIISVARASIDDHI_hk-86	iti dharmiviśeṣasaṃbandhaucityāt īśvara eva buddhimān paryavasyati || tadāha	iti dharmi viśeṣa saṃbandha aucityāt īśvaraḥ eva buddhimān paryavasyati tat āha 
MBIISVARASIDDHI_hk-87	tadatra buddhimatkartṛsiddhyā siddheśvarakriyā |	tat atra buddhimat kartṛ siddhyā siddheśvara kriyā 
MBIISVARASIDDHI_hk-88	na hi tādṛśavaicitryaviduṣaḥ syādanīśitā || 7 ||	na hi tādṛśa vaicitrya viduṣaḥ syāt anīśitā 
MBIISVARASIDDHI_hk-89	iti ||	iti 
MBIISVARASIDDHI_hk-90	tathā hi saṃniveśaviśeṣasya buddhimanmātreṇa anvayaḥ pradarśyate, na	tathā hi saṃniveśa viśeṣasya buddhimat mātreṇa anvayaḥ pradarśyate na 
MBIISVARASIDDHI_hk-91	tu buddhimadviśeṣeṇa kumbhakāreṇa īśvareṇa vā; tattu sāmānyarūpaṃ na	tu buddhimat viśeṣeṇa kumbhakāreṇa īśvareṇa vā tat tu sāmānya rūpam na 
MBIISVARASIDDHI_hk-92	viśeṣasaṃbandhaṃ vinā sthitiṃ labhate,-iti pakṣasaṃbandhaucityānusāreṇa	viśeṣa saṃbandham vinā sthitim labhate iti pakṣa saṃbandha aucitya anusāreṇa 
MBIISVARASIDDHI_hk-93	vyaktiviśeṣaṃ kulālaṃ kuvindamīśvaramanyaṃ	vyakti viśeṣam kulālam kuvindam īśvaram anyam 
MBIISVARASIDDHI_hk-94	vāpyāśrayaviśeṣamāśrayatvenāvalambate | yathā dhūmamātreṇa dūrāt	vā api āśraya viśeṣam āśraya tvena avalambate yathā dhūma mātreṇa dūrāt 
MBIISVARASIDDHI_hk-95	khadiravane'gnimātre'pi anumīyamāne khādiratvaviśeṣo	khadira vana igni mātre api anumīyamāne khādira tva viśeṣaḥ 
MBIISVARASIDDHI_hk-96	dhūmaviśeṣānapekṣayāpi āśrayavaśātprasiddhyati | yathā vā sāṃkhyenaiva	dhūma viśeṣa anapekṣayā api āśraya vaśāt prasiddhi ati yathā vā sāṃkhyena eva 
MBIISVARASIDDHI_hk-97	ātmasiddhyarthaṃ cakṣurādau dharmiṇi saṃghātavattvalakṣaṇe hetāvupanyaste	ātma siddhi artham cakṣuḥ ādau dharmiṇi saṃghātavat tva lakṣaṇe hetau upanyaste 
MBIISVARASIDDHI_hk-98	tasya pārārthyamātreṇa anyatra śayanāsanādau anvayadarśane'pi asaṃhata	tasya pārārthya mātreṇa anyatra śayana āsana ādau anvaya darśane api asaṃhata 
MBIISVARASIDDHI_hk-99	evātmā paro dharmisaṃbandhabalāllabhyate, na hi	eva ātmā paraḥ dharmi saṃbandha balāt labhyate na hi 
MBIISVARASIDDHI_hk-100	cakṣurāderbuddhiparyantāddharmiṇaḥ paro'saṃhatarūpamātmatattvaṃ vihāya	cakṣuḥ ādeḥ buddhi paryantāt dharmiṇaḥ paraḥ saṃhata rūpam ātma tattvam vihāya 
MBIISVARASIDDHI_hk-101	aparaḥ saṃbhavati,-iti tathābhūtapakṣasāmarthyādeva tasyātmatattvasyaiva tatra	aparaḥ saṃbhavati iti tathābhūta pakṣa sāmarthyāt eva tasya ātma tattvasya eva tatra 
MBIISVARASIDDHI_hk-102	siddhiḥ | na tu tenaiva śayanāsanādāvanvayaḥ pradarśanīyaḥ, yena	siddhiḥ na tu tena eva śayana āsana ādau anvayaḥ pradarśanīyaḥ yena 
MBIISVARASIDDHI_hk-103	sādhyavikalatvāt dṛṣṭāntasyāsiddhānvayatā hetudoṣaḥ syāt | nāpi	sādhya vikala tvāt dṛṣṭāntasya asiddha anvaya tā hetu doṣaḥ syāt nā api 
MBIISVARASIDDHI_hk-104	vyavahartṛpuruṣākāraparārthatvenānvayaḥ,	            
MBIISVARASIDDHI_hk-105	yenātmaviruddhasaṃhatārthasādhanādviruddhatā syāt |	yena ātma viruddha saṃhata artha sādhanāt viruddha tā syāt 
MBIISVARASIDDHI_hk-106	(p. 6)	p 
MBIISVARASIDDHI_hk-107	evamihāpi neśvareṇa buddhimatā kumbhakāreṇa vā anvayapradarśanaṃ,	evam iha api na īśvareṇa buddhimatā kumbhakāreṇa vā anvaya pradarśanam 
MBIISVARASIDDHI_hk-108	yato'siddhānvayatādidoṣodbhāvanaṃ kriyate | tathoktaṃ paraiḥ	yatas siddha anvaya tā ādi doṣa udbhāvanam kriyate tathā uktam paraiḥ 
MBIISVARASIDDHI_hk-109	kumbhakārādyadhiṣṭhānaṃ ghaṭādau yadi veṣyate |	kumbhakāra ādi adhiṣṭhānam ghaṭa ādau yadi vā iṣyate 
MBIISVARASIDDHI_hk-110	neśvarādhiṣṭhitatvaṃ syādasti cetsādhyahīnatā ||	na īśvara adhiṣṭhita tvam syāt asti ced sādhya hīna tā 
MBIISVARASIDDHI_hk-111	yathāsiddhe ca dṛṣṭānte bhaveddhetorviruddhatā | [ślokavārtike	yathā asiddhe ca dṛṣṭānte bhavet hetoḥ viruddha tā ślokavārtike 
MBIISVARASIDDHI_hk-112	saṃbandhākṣepa. 79 ślo. |]	      
MBIISVARASIDDHI_hk-113	iti | kiṃ tu buddhimanmātreṇaiva anvayādi pradarśyate, tanvādiṣu ca	iti kim tu buddhimat mātreṇa eva anvaya ādi pradarśyate tanu ādiṣu ca 
MBIISVARASIDDHI_hk-114	buddhimanmātrarūpa eva kartāsmābhiḥ prasādhyate, tasya tu tatra siddhyato	buddhimat mātra rūpaḥ eva kartā asmābhiḥ prasādhyate tasya tu tatra siddhyataḥ 
MBIISVARASIDDHI_hk-115	viśvakartṛtārūpamaiśvaryamīśvaraśabdavyavahāryamāpatati | kvaciddhaṭādau	viśvakartṛ tā rūpam aiśvaryam īśvara śabda vyavahāryam āpatati kvacid dhaṭa ādau 
MBIISVARASIDDHI_hk-116	kartā kulālaśabdavyapadeśyaḥ phalataḥ saṃpadyate na tu īśvaratvaṃ	kartā kulāla śabda vyapadeśyaḥ phalataḥ saṃpadyate na tu īśvara tvam 
MBIISVARASIDDHI_hk-117	tanukaraṇāderviśvasya kartuḥ saṃniveśaviśeṣānumitādbuddhimato'nyatkiṃcit,	tanu karaṇa ādeḥ viśvasya kartuḥ saṃniveśa viśeṣa anumitāt buddhimataḥ anyat kiṃcid 
MBIISVARASIDDHI_hk-118	yatsādhanāya yasya hetoratrāvyāpārāt pramāṇāntaramanviṣyeta |	yad sādhanāya yasya hetoḥ atra avyāpārāt pramāṇa antaram anviṣyeta 
MBIISVARASIDDHI_hk-119	anyonyopayogitanukaraṇādisarvakriyaiva īśvaratvaṃ yathā	anyonya upayogi tanu karaṇa ādi sarva kriyā eva īśvara tvam yathā 
MBIISVARASIDDHI_hk-120	mṛtsaṃniveśaviśeṣakartṛtaiva kulālatvam | pakṣasaṃbandhaśca dharmo yadi	mṛd saṃniveśa viśeṣa kartṛ tā eva kulāla tvam pakṣa saṃbandhaḥ ca dharmaḥ yadi 
MBIISVARASIDDHI_hk-121	pramāṇāntarasādhyaḥ syādanumānasya, tarhi tadā ko viśeṣo dharmamātrasya	pramāṇa antara sādhyaḥ syāt anumānasya tarhi tadā kaḥ viśeṣaḥ dharma mātrasya 
MBIISVARASIDDHI_hk-122	aniyatadeśāditvena apramāṇaviṣayatvādasya vyāptimātraviṣayatvaṃ na tu	aniyata deśa ādi tvena apramāṇa viṣaya tvāt asya vyāpti mātra viṣaya tvam na tu 
MBIISVARASIDDHI_hk-123	trairūpyaphalatvaṃ | tena yathā dhūmenāgniḥ sāmānyena kvacitpradeśe	trairūpya phala tvam tena yathā dhūmena agniḥ sāmānyena kvacid pradeśe 
MBIISVARASIDDHI_hk-124	sādhyamānastatpradeśādhāraviśiṣṭaḥ sāmarthyātsidhyati na tu tatra	sādhyamānaḥ tad pradeśa ādhāra viśiṣṭaḥ sāmarthyāt sidhyati na tu tatra 
MBIISVARASIDDHI_hk-125	pramāṇāntaramupayujyate, tathā īśvarasādhane'pi | na ca śakyaṃ vaktuṃ	pramāṇa antaram upayujyate tathā īśvara sādhane api na ca śakyam vaktum 
MBIISVARASIDDHI_hk-126	pradeśāyogavyavacchedenāgniṃ viśeṣayatyeva, sa tu viśeṣaḥ kevalaṃ	pradeśa ayoga vyavacchedena agnim viśeṣayati eva sa tu viśeṣaḥ kevalam 
MBIISVARASIDDHI_hk-127	dharmisaṃbandhabalātsidhyati na tu pramāṇāntarāpekṣasiddhikaḥ, tathaiveha	dharmi saṃbandha balāt sidhyati na tu pramāṇa antara apekṣa siddhikaḥ tathā eva iha 
MBIISVARASIDDHI_hk-128	buddhimānapi viśvanirmāṇaśaktiḥ siddhyet; kiṃ	buddhimān api viśva nirmāṇa śaktiḥ siddhyet kim 
MBIISVARASIDDHI_hk-129	tvagnipradeśāvacchede'gnirityeva	tu agni pradeśa avaccheda igniḥ iti eva 
MBIISVARASIDDHI_hk-130	(p. 7)	p 
MBIISVARASIDDHI_hk-131	vyavahriyate, tanvādikartā punarbuddhimān īśvaraśabdenā'pi,-itīyāneva	vyavahriyate tanu ādi kartā punar buddhimān īśvara śabdena api itīyān eva 
MBIISVARASIDDHI_hk-132	viśeṣaḥ, tato na kiṃcit viruddhatādidoṣāvakāśaḥ || tadāha	viśeṣaḥ tatas na kiṃcid viruddha tā ādi doṣa avakāśaḥ tat āha 
MBIISVARASIDDHI_hk-133	na kulālena neśenāpyanvayo'tra pradarśyate |	na kulālena na īśena api anvayaḥ utra pradarśyate 
MBIISVARASIDDHI_hk-134	yato viruddhatāsya syādasiddhānvayatāpi vā || 8 ||	yatas viruddha tā asya syāt asiddha anvaya tā api vā 
MBIISVARASIDDHI_hk-135	kevalaṃ buddhimanmātravyāptisaṃdarśanādapi |	kevalam buddhimat mātra vyāpti saṃdarśanāt api 
MBIISVARASIDDHI_hk-136	pakṣadharmabalāddhīmānkvacitkaścitpratīyate || 9 ||	pakṣa dharma balāt dhīmān kvacid kaścid pratīyate   
MBIISVARASIDDHI_hk-137	yathā pārārthyamātreṇa saṃghātatve'nvitekṣite [kṣate iti	yathā pārārthya mātreṇa kṣate iti 
MBIISVARASIDDHI_hk-138	pāṭhāntaram |] ||	pāṭha antaram 
MBIISVARASIDDHI_hk-139	cakṣurādau tadaucityādātmeṣṭo'saṃhataḥ paraḥ || 10 ||	cakṣuḥ ādau tad aucityāt ātma iṣṭaḥ usaṃhataḥ paraḥ 
MBIISVARASIDDHI_hk-140	yathā vā dūrato dhūmātsiddhiḥ khadirakānane |	yathā vā dūratas dhūmāt siddhiḥ khadirakānane 
MBIISVARASIDDHI_hk-141	vahnistatpratipattyaiva khādiratvena siddhyati || 11 ||	vahniḥ tad pratipattyā eva khādira tvena siddhi ati 
MBIISVARASIDDHI_hk-142	iti ||	iti 
MBIISVARASIDDHI_hk-143	(p. 8)	p 
MBIISVARASIDDHI_hk-144	na cāpi ghaṭādisvalakṣaṇo viśiṣṭa eva saṃniveśaḥ pramāṇena siddhaḥ-	na ca api ghaṭa ādi sva lakṣaṇaḥ viśiṣṭaḥ eva saṃniveśaḥ pramāṇena siddhaḥ 
MBIISVARASIDDHI_hk-145	iti sa evānyatra dharmiṇi adṛṣṭakartṛke dṛṣṭasajātīyakameva kartāraṃ sādhayati	iti saḥ eva anyatra dharmiṇi adṛṣṭa kartṛke dṛṣṭa sajātīyakam eva kartāram sādhayati 
MBIISVARASIDDHI_hk-146	na tu saṃniveśanāmātraṃ, tasya sāmānyarūpasya kāryatvāsiddheriti vācyam;	na tu saṃniveśanā mātram tasya sāmānya rūpasya kāryatva asiddheḥ iti vācyam 
MBIISVARASIDDHI_hk-147	yataḥ svalakṣaṇameva | yadyapi svalakṣaṇāpekṣayā darśanādarśanābhyāṃ	yatas sva lakṣaṇam eva yadi api sva lakṣaṇa apekṣayā darśana adarśanābhyām 
MBIISVARASIDDHI_hk-148	kāryaṃ pratīyate, tathāpi tattathā svalakṣaṇaṃ kāryatvena tathā siddhaṃ	kāryam pratīyate tathā api tat tathā sva lakṣaṇam kārya tvena tathā siddham 
MBIISVARASIDDHI_hk-149	sajātīyasvalakṣaṇāntarāṇyapi tatkāraṇasajātīyasvalakṣaṇāntarakāryatvena	sajātīya sva lakṣaṇa antarāṇi api tad kāraṇa sajātīya sva lakṣaṇa antara kārya tvena 
MBIISVARASIDDHI_hk-150	vyavasthāpayati | yathā sakṛdapyeko dhūmo'gnikāryatayā siddho	vyavasthāpayati yathā sakṛt api ekaḥ dhūma ugni kārya tayā siddhaḥ 
MBIISVARASIDDHI_hk-151	dhūmāntarāṇyapi agnikāryatve siddhānyeva karoti | tacca	dhūma antarāṇi api agni kārya tve siddhāni eva karoti tat ca 
MBIISVARASIDDHI_hk-152	kāryasvalakṣaṇamanekasahakārijanyatayānekavidhasva-lakṣaṇāntaraiḥ	kārya sva lakṣaṇam aneka sahakāri janyatayā anekavidha sva lakṣaṇa antaraiḥ 
MBIISVARASIDDHI_hk-153	sajātīyaṃ | tathā ca ghaṭasvalakṣaṇaṃ mṛṇmayatvena valmīkādibhiḥ,	sajātīyam tathā ca ghaṭa sva lakṣaṇam mṛṇmaya tvena valmīka ādibhiḥ 
MBIISVARASIDDHI_hk-154	saṃniveśena paṭādibhiḥ, parivartulatvena	saṃniveśena paṭa ādibhiḥ parivartula tvena 
MBIISVARASIDDHI_hk-155	piṣṭādimayaśarāvādibhirvicchinnatvena cchinnavṛkṣādibhirityevamādinā	piṣṭa ādi maya śarāva ādibhiḥ vicchinna tvena chinna vṛkṣa ādibhiḥ iti evamādinā 
MBIISVARASIDDHI_hk-156	krameṇa ekaikajātiyuktāni svalakṣaṇāni ekaikakāraṇakāryāṇi vyavasthāpyante	krameṇa ekaika jāti yuktāni sva lakṣaṇāni ekaika kāraṇa kāryāṇi vyavasthāpyante 
MBIISVARASIDDHI_hk-157	| tajjātīyārthitāyāstajjātīyakāraṇopādānāya saugatairapīyaṃ vyavasthā	tad jātīya arthitāyāḥ tad jātīya kāraṇa upādānāya saugataiḥ api iyam vyavasthā 
MBIISVARASIDDHI_hk-158	kṛtā, na mṛdaḥ saṃsthānaṃ na kulālānmṛdrūpatā ityevaṃ vadadbhiḥ |	kṛtā na mṛdaḥ saṃsthānam na kulālāt mṛd rūpa tā iti evam vadadbhiḥ 
MBIISVARASIDDHI_hk-159	vastusthitiścedṛśyeva, na hi yathā ghaṭaḥ saṃsthānavān buddhimatā puruṣeṇa	vastu sthitiḥ ca īdṛśī eva na hi yathā ghaṭaḥ saṃsthānavān buddhimatā puruṣeṇa 
MBIISVARASIDDHI_hk-160	niyatena tathā paṭo'pi | tathaiva ca pratītirubhayatrāpi	niyatena tathā paṭaḥ api tathā eva ca pratītiḥ ubhayatra api 
MBIISVARASIDDHI_hk-161	prājñakṛtatvapratīterupayogāya ca pravṛttirityevaṃvyavasāyaiva | kevalaṃ	prājña kṛta tva pratīteḥ upayogāya ca pravṛttiḥ iti evam vyavasāya eva kevalam 
MBIISVARASIDDHI_hk-162	teṣāṃ pareṣāṃ saugatānāṃ yathā sajātīyatvaṃ jātyā vinaiva	teṣām pareṣām saugatānām yathā sajātīya tvam jātyāḥ vinā eva 
MBIISVARASIDDHI_hk-163	avaśyābhyupagantavyam ekapratyayakāritvaṃ svalakṣaṇaniṣṭhameva tathaiva	avaśya abhyupagantavyam eka pratyaya kāri tvam sva lakṣaṇa niṣṭham eva tathā eva 
MBIISVARASIDDHI_hk-164	etadapīti,	etat api iti 
MBIISVARASIDDHI_hk-165	siddhaṃ yādṛgadhiṣṭhātṛbhāvābhāvānuvṛttimat |	siddham yādṛś adhiṣṭhātṛ bhāva abhāva anuvṛttimat 
MBIISVARASIDDHI_hk-166	saṃniveśādi tadyuktaṃ yasmāttadanumīyate ||	saṃniveśa ādi tat yuktam yasmāt tat anumīyate 
MBIISVARASIDDHI_hk-167	(p. 9)	p 
MBIISVARASIDDHI_hk-168	anyathā kumbhakārasya mṛdvikārasya kasyacit |	anyathā kumbhakārasya mṛd vikārasya kasyacid 
MBIISVARASIDDHI_hk-169	ghaṭādeḥ kāraṇātsiddhyedvalmīkasyāpi tatkṛtiḥ ||	ghaṭa ādeḥ kāraṇāt siddhyet valmīkasya api tad kṛtiḥ 
MBIISVARASIDDHI_hk-170	ityādi teṣāṃ pūrvoktahetuvibhāgakārisvavacanānusaṃdhāna-	ityādi teṣām pūrva ukta hetu vibhāga kāri sva vacana anusaṃdhāna 
MBIISVARASIDDHI_hk-171	śūnyamabhidhānam | sāmānyānāṃ guṇānāṃ kriyāṇāmanyeṣāmapi vā	śūnyam abhidhānam sāmānyānām guṇānām kriyāṇām anyeṣām api vā 
MBIISVARASIDDHI_hk-172	dharmāṇāmarthakriyākārisvalakṣaṇaniṣṭhatayaiva pṛthakkāraṇopayogasya	dharmāṇām arthakriyā kāri sva lakṣaṇa niṣṭha tayā eva pṛthak kāraṇa upayogasya 
MBIISVARASIDDHI_hk-173	siddheranavadyatvādityavyabhicāryeva saṃniveśaḥ strīpuṃsāderiva	siddheḥ anavadya tvāt iti avyabhicārī eva saṃniveśaḥ strīpuṃsa ādeḥ iva 
MBIISVARASIDDHI_hk-174	anyonyasādhyārthakriyānuguṇyādi-viśeṣitastanvāderīśvarakartṛtāsādhana iti	                                                            
MBIISVARASIDDHI_hk-175	|| tadāha	tat āha 
MBIISVARASIDDHI_hk-176	evaṃ ca hetuḥ saṃsthānamātramatra viśeṣitam |	evam ca hetuḥ saṃsthāna mātram atra viśeṣitam 
MBIISVARASIDDHI_hk-177	tathā vaicitryamātreṇa na svalakṣaṇalakṣmaṇā || 12 ||	tathā vaicitrya mātreṇa na sva lakṣaṇa lakṣmaṇā 
MBIISVARASIDDHI_hk-178	paraistairapi hetūnāṃ ghaṭātmapravivecane |	paraiḥ taiḥ api hetūnām ghaṭa ātma pravivecane 
MBIISVARASIDDHI_hk-179	saṃsthānamātra eva............ hetutvaṃ buddhiśālinaḥ || 13 ||	saṃsthāna mātre eva hetu tvam buddhi śālinaḥ 
MBIISVARASIDDHI_hk-180	anyonyārthakriyāyogyasaṃniveśaviśeṣitam |	anyonya artha kriyā yogya saṃniveśa viśeṣitam 
MBIISVARASIDDHI_hk-181	tadidaṃ sakalaṃ viśvaṃ yuktamīśvaranirmitam || 14 ||	tat idam sakalam viśvam yuktam īśvara nirmitam 
MBIISVARASIDDHI_hk-182	iti ||	iti 
MBIISVARASIDDHI_hk-183	(p. 10)	p 
MBIISVARASIDDHI_hk-184	atra sāṃkhyāḥ pratyavatiṭhante | bhavedapyetadevaṃ yadi	atra sāṃkhyāḥ pratyavatiṭhante bhavet api etat evam yadi 
MBIISVARASIDDHI_hk-185	kiṃcidekaikameva kasyacit kāraṇaṃ syāt, yāvatānekameva	kiṃcid ekaikam eva kasyacid kāraṇam syāt yāvatā anekam eva 
MBIISVARASIDDHI_hk-186	tattadekakāryābhivyaktinimittatāṃ saṃtatāviviktadeśakālādiyogena upayāti |	tad tad eka kārya abhivyakti nimitta tām saṃtata avivikta deśa kāla ādi yogena upayāti 
MBIISVARASIDDHI_hk-187	tataśca ye te sahabhāvamāpannāḥ kāryabhāvirbhāvayanti te parasparayoge	tatas ca ye te sahabhāvam āpannāḥ kārya bhāvirbhāvayanti te paraspara yoge 
MBIISVARASIDDHI_hk-188	vicitravṛttayo dṛśyante | tathā hi bījāntargamanena bījabhūtā jalabhūmyādayo	vicitra vṛttayaḥ dṛśyante tathā hi bīja antargamanena bīja bhūtāḥ jala bhūmi ādayaḥ 
MBIISVARASIDDHI_hk-189	rasādipariṇāmāt dīrghapracitasaṃniveśamaṅkuraṃ sahakāritayā kurvanti |	rasa ādi pariṇāmāt dīrgha pracita saṃniveśam aṅkuram sahakāri tayā kurvanti 
MBIISVARASIDDHI_hk-190	kriyāpi deśāntarākramaṇalakṣaṇā na taddeśapariṇāmavadrūpātiriktā	kriyā api deśa antara ākramaṇa lakṣaṇā na tad deśa pariṇāmavat rūpa atiriktā 
MBIISVARASIDDHI_hk-191	kācidupalabhyate | tena yathaikopādānadeśe eva pratikṣaṇaṃ pariṇāmastathā	kācid upalabhyate tena yathā eka upādāna deśe eva pratikṣaṇam pariṇāmaḥ tathā 
MBIISVARASIDDHI_hk-192	deśāntarasthitarūpatayā yadi syāt tatko virodhaḥ | kūṭasthanityatābhyupagame	deśa antara sthita rūpatayā yadi syāt tat kaḥ virodhaḥ kūṭastha nityatā abhyupagame 
MBIISVARASIDDHI_hk-193	bhāvānāmeṣa doṣo na tu kṣaṇapariṇāmanaye, vāyuvahniprabhṛtīnāmapi	bhāvānām eṣa doṣaḥ na tu kṣaṇa pariṇāma naye vāyu vahni prabhṛtīnām api 
MBIISVARASIDDHI_hk-194	bhāvānāṃ digantarākramaṇamaniyamena yathā bhāve, tathā	bhāvānām diś antara ākramaṇam aniyamena yathā bhāve tathā 
MBIISVARASIDDHI_hk-195	tathāvidhasahakārikāraṇaviśeṣasāhityāt niyamena |	tathāvidha sahakāri kāraṇa viśeṣa sāhityāt niyamena 
MBIISVARASIDDHI_hk-196	sajātīyatāyogyakāryotthāpanasamarthā api te yadi syustanna kiṃcidduṣyet | na ca	sajātīya tā yogya kārya utthāpana samarthāḥ api te yadi syuḥ tat na kiṃcid duṣyet na ca 
MBIISVARASIDDHI_hk-197	dṛśyamānārthayogitopapannaṃ vastu adṛṣṭakalpanāya aṅgatāmupanayati,	dṛśyamāna artha yogitā upapannam vastu adṛṣṭa kalpanāya aṅga tām upanayati 
MBIISVARASIDDHI_hk-198	īśvaropagame'pyanavasthāprasaṅgāt | arthānāṃ	īśvara upagame pi anavasthā prasaṅgāt arthānām 
MBIISVARASIDDHI_hk-199	svabhāvavaicitryamabhyupagamanīyaṃ sarvavādibhiḥ, yena bījādevāṅkuro	svabhāva vaicitryam abhyupagamanīyam sarva vādibhiḥ yena bījāt eva aṅkuraḥ 
MBIISVARASIDDHI_hk-200	mṛda eva ghaṭaḥ, tataḥ sahakārisāmarthyātiśayāveśitaviśeṣādeva	mṛdaḥ eva ghaṭaḥ tatas sahakāri sāmarthya atiśaya āveśita viśeṣāt eva 
MBIISVARASIDDHI_hk-201	deśāntarākramaṇena upādānavilakṣaṇasaṃsthānatayā udbhavanto bhāvā na	deśa antara ākramaṇena upādāna vilakṣaṇa saṃsthāna tayā udbhavantaḥ bhāvāḥ na 
MBIISVARASIDDHI_hk-202	vācyatābhājaḥ | yatra punaḥ sahakāriṇo bahiḥ svadeśasaṃniviṣṭā eva kāryeṣu	vācya tā bhājaḥ yatra punar sahakāriṇaḥ bahis sva deśa saṃniviṣṭāḥ eva kāryeṣu 
MBIISVARASIDDHI_hk-203	upayujyante yathā mṛtpiṇḍacakrādayaḥ, tatropādānasaṃniveśavaisādṛśye	upayujyante yathā mṛd piṇḍa cakra ādayaḥ tatra upādāna saṃniveśa vaisādṛśye 
MBIISVARASIDDHI_hk-204	syādavasaro buddhimataḥ kumbhakārasyeva, upādānamātrasya hi	syāt avasaraḥ buddhimataḥ kumbhakārasya iva upādāna mātrasya hi 
MBIISVARASIDDHI_hk-205	deśāntaragamanasamarthāvayavatve pūrvamapi tathābhāvaḥ syāt |	deśa antara gamana samartha avayava tve pūrvam api tathābhāvaḥ syāt 
MBIISVARASIDDHI_hk-206	(p. 11)	p 
MBIISVARASIDDHI_hk-207	na punaratra buddhimadupayogamātreṇa sarvatra sahakāriṇāmiyameva vyavasthā	na punar atra buddhimat upayoga mātreṇa sarvatra sahakāriṇām iyam eva vyavasthā 
MBIISVARASIDDHI_hk-208	sthāpitā prāmāṇikatāṃ puṣṇāti || tadāha	sthāpitā prāmāṇika tām puṣṇāti tat āha 
MBIISVARASIDDHI_hk-209	atrocyate gatiścitrā dṛśyate sahakāriṇām |	atrā ucyate gatiḥ citrā dṛśyate sahakāriṇām 
MBIISVARASIDDHI_hk-210	kecitkathaṃcideveyurupādānaiḥ samāgamam || 15 ||	kecid kathaṃcid eva eyuḥ upādānaiḥ samāgamam 
MBIISVARASIDDHI_hk-211	hetumantaḥpraviśyānye prāpyopādānarūpatām |	hetum antar praviśya anye prāpya upādāna rūpa tām 
MBIISVARASIDDHI_hk-212	citrayanti hi kāryāṇi bhaumodakarasā iva || 16 ||	citrayanti hi kāryāṇi bhauma udaka rasāḥ iva 
MBIISVARASIDDHI_hk-213	anye punarupādāne bahirviparivartinaḥ |	anye punar upādāne bahis viparivartinaḥ 
MBIISVARASIDDHI_hk-214	rūpavaicitryayogāya kāryeṣu na tathā kṣamāḥ || 17 ||	rūpa vaicitrya yogāya kāryeṣu na tathā kṣamāḥ 
MBIISVARASIDDHI_hk-215	tatra buddhimato nāma prasaro yadi kalpyate |	tatra buddhimataḥ nāma prasaraḥ yadi kalpyate 
MBIISVARASIDDHI_hk-216	na tāvataiva sarvatra vyavasthā ghaṭate tathā || 18 ||	na tāvatā eva sarvatra vyavasthā ghaṭate tathā 
MBIISVARASIDDHI_hk-217	iti ||	iti 
MBIISVARASIDDHI_hk-218	(p. 12)	p 
MBIISVARASIDDHI_hk-219	evaṃ kāraṇānāmekatra kāryātmanā vyāpriyamāṇānāṃ	evam kāraṇānām ekatra kārya ātmanā vyāpriyamāṇānām 
MBIISVARASIDDHI_hk-220	pravṛttiprakāravaicitrye vyavasthāpite, prastutatanukaraṇādisakalabhāgalakṣaṇa-	pravṛtti prakāra vaicitrye vyavasthāpite prastuta tanu karaṇa ādi sakala bhāga lakṣaṇa 
MBIISVARASIDDHI_hk-221	kāryakāri pradhānasaṃjñaṃ tāvanmūlakāraṇaṃ pradhānasiddhau	kārya kāri pradhāna saṃjñam tāvat mūla kāraṇam pradhāna siddhau 
MBIISVARASIDDHI_hk-222	samanvayādivītopanyāsena nirbādhameva sādhitameva,-iti neha tatprameyam | na	samanvaya ādi vīta upanyāsena nirbādham eva sādhitam eva eti na iha tat prameyam na 
MBIISVARASIDDHI_hk-223	hi pradhānasiddhimātreṇaiva īśvaranirākṛtiḥ syāt upādānakāraṇatayā	hi pradhāna siddhi mātreṇa eva īśvara nirākṛtiḥ syāt upādānakāraṇatayā 
MBIISVARASIDDHI_hk-224	paramāṇusthāna eva pradhānasya mūlakāraṇatvena samarthanāt | tacca	paramāṇu sthāne eva pradhānasya mūla kāraṇa tvena samarthanāt tat ca 
MBIISVARASIDDHI_hk-225	pradhānena paramāṇuvāda eva yadi paraṃ nirākriyeta, tataḥ pradhānavyavasthā	pradhānena paramāṇu vādaḥ eva yadi param nirākriyeta tatas pradhāna vyavasthā 
MBIISVARASIDDHI_hk-226	viśvasya upādānakāraṇavicāraprastāve prameyībhavati, na tu	viśvasya upādāna kāraṇa vicāra prastāve prameyībhavati na tu 
MBIISVARASIDDHI_hk-227	nimittakāraṇopapādanaprakrame | tadevaṃ mūlaprakṛtiḥ	nimitta kāraṇa upapādana prakrame tat evam mūlaprakṛtiḥ 
MBIISVARASIDDHI_hk-228	sattvarajastamaḥsaṃjñaguṇatrayasāmyātmikā prakṛtitayaiva prasavadharmiṇī	sattva rajaḥ tamaḥ saṃjña guṇatraya sāmya ātmikā prakṛti tayā eva prasava dharmiṇī 
MBIISVARASIDDHI_hk-229	guṇānāmevāṅgāṅgibhāvagamanena yāvanmahadādivikārātmanā	guṇānām eva aṅgāṅgibhāva gamanena yāvat mahat ādi vikāra ātmanā 
MBIISVARASIDDHI_hk-230	pariṇamate, tāvatpuruṣārthatvameva tatra tasyāḥ svabhāvabhūtaṃ nimittam | na	pariṇamate tāvat puruṣa artha tvam eva tatra tasyāḥ svabhāva bhūtam nimittam na 
MBIISVARASIDDHI_hk-231	hi yadṛcchayā vartamānāyāḥ kārya?vargasya devamānuṣatiryagyonirūpasya	hi yadṛcchayā vartamānāyāḥ kārya vargasya deva mānuṣa tiryagyoni rūpasya 
MBIISVARASIDDHI_hk-232	tadavāntarajātivaicitryavato niyamena strīpuṃsasaṃsthānadvayasya vā	tad avāntara jāti vaicitryavataḥ niyamena strīpuṃsa saṃsthāna dvayasya vā 
MBIISVARASIDDHI_hk-233	anyonyānuguṇyamupapadyate | tadetatsaṃniveśaviśeṣarūpatayā	anyonya ānuguṇyam upapadyate tat etat saṃniveśa viśeṣa rūpa tayā 
MBIISVARASIDDHI_hk-234	abhyupetamīśvaravādināpi | tadetadapyeṣāṃ saprakṛtikānāṃ	abhyupetam īśvara vādinā api tat etat api eṣām sa prakṛtikānām 
MBIISVARASIDDHI_hk-235	vyūhavibhavabhāvenāvasthitānāmaśeṣavikārāṇām	vyūha vibhava bhāvena avasthitānām aśeṣa vikārāṇām 
MBIISVARASIDDHI_hk-236	itaretarāṅgāṅgibhāvagamanaṃ lokayātropayogitayā	itaretara aṅga aṅgi bhāva gamanam lokayātrā upayogi tayā 
MBIISVARASIDDHI_hk-237	tāvatsaṃniveśaviśeṣaphalaṃ nirarthakam | yaduktaṃ	tāvat saṃniveśa viśeṣa phalam nirarthakam yat uktam 
MBIISVARASIDDHI_hk-238	na syātkriyāvyūhavidhistathāyaṃ	na syāt kriyā vyūha vidhiḥ tathā ayam 
MBIISVARASIDDHI_hk-239	yādṛcchikā....................................... |	yādṛcchikā 
MBIISVARASIDDHI_hk-240	ityādi | arthavattvaṃ ca sukhaduḥkhopalambhasaṃpādanārthatayaiva sarvasyaiva	ityādi arthavat tvam ca sukha duḥkha upalambha saṃpādana arthatayā eva sarvasya eva 
MBIISVARASIDDHI_hk-241	artharūpasya paramparayā paryavasyati | santo'pi hi savidhamupayānto'rthāḥ	artha rūpasya paramparayā paryavasyati santaḥ api hi savidham upayāntaḥ ṛthāḥ 
MBIISVARASIDDHI_hk-242	śaśaviṣāṇakalpāḥ prakalpante | ataḥ	śaśaviṣāṇa kalpāḥ prakalpante atas 
MBIISVARASIDDHI_hk-243	(p. 13)	p 
MBIISVARASIDDHI_hk-244	saṃvidautsukyena tadarthatayaiva tadbhogyasvabhāvā eva,-iti bhogyādapi bhoktuḥ	saṃvid autsukyena tad artha tayā eva tad bhogya svabhāvā eva eti bhogyāt api bhoktuḥ 
MBIISVARASIDDHI_hk-245	saṃvitsvabhāvasya ātmatattvasya siddheranupapannameva pramāṇam | yadyapi	saṃvid svabhāvasya ātma tattvasya siddheḥ anupapannam eva pramāṇam yadi api 
MBIISVARASIDDHI_hk-246	bhāvāścittabhūmau bhāsamānāḥ pratyakṣeṇāpi	bhāvāḥ citta bhūmau bhāsamānāḥ pratyakṣeṇa api 
MBIISVARASIDDHI_hk-247	saṃvittattvamavabhāsamānamāvedayanti, tathāpi	saṃvid tattvam avabhāsamānam āvedayanti tathā api 
MBIISVARASIDDHI_hk-248	tadarthātmoparāgakaluṣamavabhāsyamānaṃ bhogyabhūtamaviśuddhaṃ	tad artha ātma uparāga kaluṣam avabhāsyamānam bhogya bhūtam aviśuddham 
MBIISVARASIDDHI_hk-249	bhoktṛtābhinnalakṣaṇaṃ tata eva	bhoktṛ tā abhinna lakṣaṇam tatas eva 
MBIISVARASIDDHI_hk-250	kevalamekacinmātrarūpasākṣimātramātmatattvamanumīyate	kevalam eka cit mātra rūpa sākṣi mātram ātma tattvam anumīyate 
MBIISVARASIDDHI_hk-251	bhogyabhoktṛbhāvāparaparyāyasvasvāmisaṃbandhavaśāt, na tu	bhogya bhoktṛ bhāva apara paryāya sva svāmi saṃbandha vaśāt na tu 
MBIISVARASIDDHI_hk-252	sākṣātkāryatāṃ tadupayāti | taduktam	sākṣāt kārya tām tat upayāti tat uktam 
MBIISVARASIDDHI_hk-253	vijñātāramare kena vijānīyāt (bṛ. ā. 4|5|15)	vijñātāram are kena vijānīyāt bṛ ā 
MBIISVARASIDDHI_hk-254	iti | tatsaṃnidhānamātra eva ca yataścittopārohiviṣayākāraprakāśanaṃ bhavet	iti tad saṃnidhāna mātre eva ca yatas citta upārohi viṣaya ākāra prakāśanam bhavet 
MBIISVARASIDDHI_hk-255	anyathā jaḍātmanaḥ svaśaktyā tathābhāvāyogāt | tato'tadarthamapi vastutaḥ	anyathā jaḍa ātmanaḥ sva śaktyā tathābhāva ayogāt vastutas 
MBIISVARASIDDHI_hk-256	prakṛtipariṇāmakarma tadadhīnaṃ citrāvabhāsanārthatvāttadarthamupavarṇyate |	prakṛti pariṇāma karma tad adhīnam citra avabhāsana artha tvāt tad artham upavarṇyate 
MBIISVARASIDDHI_hk-257	parasparārthatve guṇapariṇāmasyaikatama eṣāṃ paryāyeṇa citsvabhāvaḥ	paraspara artha tve guṇa pariṇāmasya ekatamaḥ eṣām paryāyeṇa cit svabhāvaḥ 
MBIISVARASIDDHI_hk-258	syāccidupayogaparisamāpteḥ sarvapariṇāmānām | na	syāt cit upayoga parisamāpteḥ sarva pariṇāmānām na 
MBIISVARASIDDHI_hk-259	caitadatyantabhinnajātīyaṃ cidacidrūpamekasya ghaṭate | tadeva	ca etat atyanta bhinna jātīyam cit acit rūpam ekasya ghaṭate tat eva 
MBIISVARASIDDHI_hk-260	kadācidupakārakatāyāṃ jaḍam, ajaḍasya tu cidātmanaḥ	kadācid upakāraka tāyām jaḍam ajaḍasya tu cit ātmanaḥ 
MBIISVARASIDDHI_hk-261	paropakārakriyāpariṇāmāyogāt, anyadā copakāryatāyāmajaḍam, na	para upakāra kriyā pariṇāma ayogāt anyadā ca upakārya tāyām ajaḍam na 
MBIISVARASIDDHI_hk-262	caivamekatvaṃ virodhe sati upapadyate na cāpyupakāryatā cinmātravapuṣaḥ	ca evam eka tvam virodhe sati upapadyate na ca api upakārya tā cit mātra vapuṣaḥ 
MBIISVARASIDDHI_hk-263	kramate | tadaṅgabhūtārthopakārasaṃsparśena	kramate tad aṅga bhūta artha upakāra saṃsparśena 
MBIISVARASIDDHI_hk-264	cidrūpādādhikyaprasaṅgājjaḍatāpattiḥ | tadādhikyameva hi jaḍatvaṃ | tadevaṃ	cit rūpāt ādhikya prasaṅgāt jaḍa tā āpattiḥ tad ādhikyam eva hi jaḍa tvam tat evam 
MBIISVARASIDDHI_hk-265	yāvadaṅgāṅgitopakāryopakārakabhāvena tāvajjaḍatāmupeyuṣī	yāvat aṅga aṅgita upakārya upakāraka bhāvena tāvat jaḍa tām upeyuṣī 
MBIISVARASIDDHI_hk-266	bhogyabhūmireva, puruṣasya tūpakāryopacārastatsaṃnidhāne	bhogya bhūmiḥ eva puruṣasya tu upakārya upacāraḥ tad saṃnidhāne 
MBIISVARASIDDHI_hk-267	cittasyārthākāravataḥ prakāśamānatvāt |	cittasya artha ākāravataḥ prakāśamāna tvāt 
MBIISVARASIDDHI_hk-268	(p. 14)	p 
MBIISVARASIDDHI_hk-269	evaṃ ca guṇānāmabhyupagamena cidrūpatāpattiprasaṅgena guṇatāhāneḥ | ata	evam ca guṇānām abhyupagamena cit rūpa tā āpatti prasaṅgena guṇatā hāneḥ 
MBIISVARASIDDHI_hk-270	evaiṣāṃ svārthatā na yuktā | tasyaivaikasya	eva eṣām svārtha tā na yuktā tasya eva ekasya 
MBIISVARASIDDHI_hk-271	viruddhobhayabhoktṛbhogyarūpatāpatteriti sarvametatprakṛticalaṃ	viruddha ubhaya bhoktṛ bhogya rūpatā āpatteḥ iti sarvam etat prakṛti calam 
MBIISVARASIDDHI_hk-272	guṇavṛttamacalācittattvasākṣikacittagataviṣayasaṃvitprayojanameva | yāvāṃśca	guṇa vṛttam acala acit tattva sākṣika citta gata viṣaya saṃvid prayojanam eva yāvān ca 
MBIISVARASIDDHI_hk-273	viṣayabhedaḥ saṃvedanakṣamastatsaṃvedanaṃ sarvameva puruṣārthasaṃjñaṃ	viṣaya bhedaḥ saṃvedana kṣamaḥ tat saṃvedanam sarvam eva puruṣa artha saṃjñam 
MBIISVARASIDDHI_hk-274	guṇapariṇāmapravṛttinimittaṃ, viṣayaśca saṃvedanasya	guṇa pariṇāma pravṛtti nimittam viṣayaḥ ca saṃvedanasya 
MBIISVARASIDDHI_hk-275	susūkṣmādibhāvāvasthitā guṇāstathā guṇapuruṣāntaramapi | tato yathā	su sūkṣma ādi bhāva avasthitāḥ guṇāḥ tathā guṇa puruṣa antaram api tatas yathā 
MBIISVARASIDDHI_hk-276	sukhaduḥkhamohamayaparārthasaṃvedanaṃ puruṣārthastathā	sukha duḥkha moha maya para artha saṃvedanam puruṣa arthaḥ tathā 
MBIISVARASIDDHI_hk-277	śāstropadiṣṭānumānopamānādinā guṇapuruṣāntaropalabdhirapi |	śāstra upadiṣṭa anumāna upamāna ādinā guṇa puruṣa antara upalabdhiḥ api 
MBIISVARASIDDHI_hk-278	tadubhayamapi prayojanaṃ bhogāpavargarūpaguṇapravṛtteḥ |	tat ubhayam api prayojanam bhoga apavarga rūpa guṇa pravṛtteḥ 
MBIISVARASIDDHI_hk-279	tatprayojanasaṃpādanayogyasvabhāvatā ca nimittakāraṇamucyate | na tu	tad prayojana saṃpādana yogya svabhāva tā ca nimitta kāraṇam ucyate na tu 
MBIISVARASIDDHI_hk-280	bhāviprayojanamanāgatameva nimittatāṃ gacchet | tatra ca	bhāvi prayojanam anāgatam eva nimitta tām gacchet tatra ca 
MBIISVARASIDDHI_hk-281	vivekajñānaparyantapuruṣārthaprayojane parisamāpte	viveka jñāna paryanta puruṣa artha prayojane parisamāpte 
MBIISVARASIDDHI_hk-282	pravṛttinimittakāraṇābhāvāt na guṇāstamuddiśya puruṣārthaṃ pravartante,-iti	pravṛtti nimitta kāraṇa abhāvāt na guṇāḥ tam uddiśya puruṣa artham pravartante iti 
MBIISVARASIDDHI_hk-283	kaivalyaṃ puṃsa ucyate nityakevalasyāpi | itthamavasthite mṛddaṇḍādeḥ svato	kaivalyam puṃsaḥ ucyate nitya kevalasya api ittham avasthite mṛd daṇḍa ādeḥ 
MBIISVARASIDDHI_hk-284	ghaṭādivyaktyaśaktasya sahakārī buddhimān kumbhakāro'stu, tantvādeśca	ghaṭa ādi vyakti aśaktasya sahakārī buddhimān kumbhakāroḥ tu tantu ādeḥ ca 
MBIISVARASIDDHI_hk-285	tantravāyastathā nāmādṛśyaḥ | na tāvatā śarīrāderutpādasamaye	tantravāyaḥ tathā nāma adṛśyaḥ na tāvatā śarīra ādeḥ utpāda samaye 
MBIISVARASIDDHI_hk-286	kaścitprasiddhakāraṇātirikto'pi kalpanīyo bhavati | mā bhūdatiprasaṅgaḥ,-iti	kaścid prasiddha kāraṇa atiriktaḥ api kalpanīyaḥ bhavati mā bhūt atiprasaṅgaḥ iti 
MBIISVARASIDDHI_hk-287	dṛṣṭopādānādikāraṇasāmarthyaviśeṣādapi ca upapadyate eva kāryāṇāṃ	dṛṣṭa upādāna ādi kāraṇa sāmarthya viśeṣāt api ca upapadyate eva kāryāṇām 
MBIISVARASIDDHI_hk-288	ghaṭāṅkurādīnāṃ rūpādibhedaḥ, tathā saṃsthānaviśeṣaprathāpi	ghaṭa aṅkura ādīnām rūpa ādi bhedaḥ tathā saṃsthāna viśeṣa prathā api 
MBIISVARASIDDHI_hk-289	tatsāmarthyādeva syāt, ko doṣaḥ, kimarthamadṛṣṭakalpanaṃ | yāvatā hi rūpeṇa	tad sāmarthyāt eva syāt kaḥ doṣaḥ kimartham adṛṣṭa kalpanam yāvatā hi rūpeṇa 
MBIISVARASIDDHI_hk-290	saṃniveśena vā puruṣārtho'vasthitiṃ labhate, tatra tāvati guṇasvabhāva eva	saṃniveśena vā puruṣa artha uvasthitim labhate tatra tāvati guṇa svabhāve eva 
MBIISVARASIDDHI_hk-291	nimittaṃ tathaivopapatteḥ | tatsvabhāvānugrahādeva ca śarīraviṣayendriyādika-	nimittam tathā eva upapatteḥ tad svabhāva anugrahāt eva ca śarīra viṣaya indriya ādika 
MBIISVARASIDDHI_hk-292	(p. 15)	p 
MBIISVARASIDDHI_hk-293	cetaḥpūrvāparabhūmikāvasthāyini kāryavarge dharmādikarmāpi	cetaḥ pūrva apara bhūmikā avasthāyini kārya varge dharma ādi karma api 
MBIISVARASIDDHI_hk-294	nimittakāraṇatayā prabhavet | ataḥ paraṃ	nimitta kāraṇa tayā prabhavet atas param 
MBIISVARASIDDHI_hk-295	parikalpayannītimārgātigo'vadhīraṇīya eva syādapi | etāvanmātramaṣṭaguṇaṃ	parikalpayan nīti mārga atigaḥ vadhīraṇīyaḥ eva syāt api etāvanmātram aṣṭaguṇam 
MBIISVARASIDDHI_hk-296	cittavarti dharmādivadaiśvaryaṃ kadācidabhivyaktaṃ yadguṇānāmeva	citta varti dharma ādi vat aiśvaryam kadācid abhivyaktam yat guṇānām eva 
MBIISVARASIDDHI_hk-297	sahabhāvi bhavadyogitāvyapadeśamāvahet | yattu tato'dhikaṃ nityaṃ	sahabhāvi bhavat yogitā vyapadeśam āvahet yat tu tatas adhikam nityam 
MBIISVARASIDDHI_hk-298	kasyacitpuruṣaviśeṣasya tanukaraṇabhuvanādividhau sargasthitipralayeṣu ca	kasyacid puruṣa viśeṣasya tanu karaṇa bhuvana ādi vidhau sarga sthiti pralayeṣu ca 
MBIISVARASIDDHI_hk-299	kāraṇatāmupeyāt	kāraṇa tām upeyāt 
MBIISVARASIDDHI_hk-300	tatprakṛtisvabhāvasadbhāvamanatiriktamanekavaicitryopakalpyamānapuruṣārthapra	tat prakṛti svabhāva sadbhāvam anatiriktam aneka vaicitrya upakalpyamāna puruṣa artha pra 
MBIISVARASIDDHI_hk-301	yojanamanādṛtya pṛthagbhūtamāśrīyamāṇaṃ bhaktimātrasādhanameva ||	yojanam an ādṛtya pṛthak bhūtam āśrīyamāṇam bhakti mātra sādhanam eva 
MBIISVARASIDDHI_hk-302	tadāha	tat āha 
MBIISVARASIDDHI_hk-303	asti cāsya pradhānasya prasiddhasyānvayādinā |	asti ca asya pradhānasya prasiddhasya anvaya ādinā 
MBIISVARASIDDHI_hk-304	svārthatādiniṣedhena sādhitā puruṣārthatā || 19 ||	svārthatā ādi niṣedhena sādhitā puruṣa arthatā 
MBIISVARASIDDHI_hk-305	tenāsya bhogasaṃsiddhiḥ puruṣasya yathā yathā |	tena asya bhoga saṃsiddhiḥ puruṣasya yathā yathā 
MBIISVARASIDDHI_hk-306	tathā tathā pariṇatiḥ syānna kiṃcana durghaṭam || 20 ||	tathā tathā pariṇatiḥ syāt na kiṃcana durghaṭam 
MBIISVARASIDDHI_hk-307	ata eva pradhānasya mahattvapariṇāminaḥ |	atas eva pradhānasya mahat tva pariṇāminaḥ 
MBIISVARASIDDHI_hk-308	nimittakāraṇaṃ nānyatpuruṣārthodyamādṛte || 21 ||	nimitta kāraṇam na anyat puruṣa artha udyamāt ṛte 
MBIISVARASIDDHI_hk-309	(p. 16)	p 
MBIISVARASIDDHI_hk-310	svabhāva eva caiṣo'sya mūlahetostathekṣaṇāt |	svabhāvaḥ eva ca eṣaḥ usya mūla hetoḥ tathā īkṣaṇāt 
MBIISVARASIDDHI_hk-311	cittabhūmeradharataḥ śarīrādividhiṃ prati || 22 ||	citta bhūmeḥ adharatas śarīra ādi vidhim prati 
MBIISVARASIDDHI_hk-312	nimittakāraṇaṃ karma syādapyādyasvabhāvataḥ |	nimitta kāraṇam karma syāt api ādi asvabhāvataḥ 
MBIISVARASIDDHI_hk-313	tato'tra kutra vyāpāra īśvarasyopakalpyatām || 23 ||	tatas utra kutra vyāpāraḥ īśvarasya upakalpyatām 
MBIISVARASIDDHI_hk-314	cetasyaṣṭaguṇe jātu jātādaiśvaryato'dhikaḥ |	cetasi aṣṭaguṇe jātu jātāt aiśvarya tā adhikaḥ 
MBIISVARASIDDHI_hk-315	iti ||	iti 
MBIISVARASIDDHI_hk-316	uktanītyā ca cinmātrasya adhikaviśeṣānupapatteḥ | tathā hi	ukta nītyā ca cit mātrasya adhika viśeṣa anupapatteḥ tathā hi 
MBIISVARASIDDHI_hk-317	jaḍatāpatteraiśvaryābhāvāt dharmādivaccittabhūmibhāgino'syeśvarasya	jaḍa tā āpatteḥ aiśvarya abhāvāt dharma ādi vat citta bhūmi bhāginaḥ usya īśvarasya 
MBIISVARASIDDHI_hk-318	kathamivābhivyaktacittāvasthe mūlakāraṇe mahadādikāryapariṇāmāya	katham iva abhivyakta citta avasthe mūlakāraṇe mahat ādi kārya pariṇāmāya 
MBIISVARASIDDHI_hk-319	nimittakāraṇatvamupakalpyeta | tadatra pūrvatra pariṇāme	nimitta kāraṇa tvam upakalpyeta tat atra pūrvatra pariṇāme 
MBIISVARASIDDHI_hk-320	cetpuruṣārthocitottarottaravikārakāriṇi nimittakāraṇaṃ puruṣārthatāsvabhāvaḥ	ced puruṣa artha ucita uttarottara vikāra kāriṇi nimitta kāraṇam puruṣa artha tā svabhāvaḥ 
MBIISVARASIDDHI_hk-321	prakṛtestatsakalaviśeṣaparyante'pi vikārarāśau sa evāstu	prakṛteḥ tad sakala viśeṣa paryante pi vikāra rāśau saḥ eva astu 
MBIISVARASIDDHI_hk-322	kimardhajaratīyanyāyābhiniveśena || tadāha	kim ardha jarati iya nyāya abhiniveśena tat āha 
MBIISVARASIDDHI_hk-323	raha(natva)sya mūlaprakṛtāvantaḥ karaṇacāriṇaḥ || 24 ||	rahana tvasya mūlaprakṛtau antaḥ karaṇa cāriṇaḥ 
MBIISVARASIDDHI_hk-324	(p. 17)	p 
MBIISVARASIDDHI_hk-325	īśvarasyopakalpyeta pariṇāmanimittatā |	īśvarasya upakalpyeta pariṇāma nimitta tā 
MBIISVARASIDDHI_hk-326	iti ||	iti 
MBIISVARASIDDHI_hk-327	evaṃ cātra prayogaḥ-pradhānaṃ mahadādipariṇāme	evam ca atra prayogaḥ pradhānam mahat ādi pariṇāme 
MBIISVARASIDDHI_hk-328	nimittāntarānapekṣaṃ puruṣārthopayogitayā	nimitta antara anapekṣam puruṣa artha upayogi tayā 
MBIISVARASIDDHI_hk-329	bhūtavikārapariṇāmaikasvabhāvatvāt | yadyathā pariṇāmaikasvabhāvaṃ	bhūta vikāra pariṇāma eka svabhāva tvāt yat yathā pariṇāma eka svabhāvam 
MBIISVARASIDDHI_hk-330	tattatra pariṇāme'nyanimittā(na)pekṣaṃ tataḥ svabhāvādeva tathā bhavati yathā	tat tatra tatas svabhāvāt eva tathā bhavati yathā 
MBIISVARASIDDHI_hk-331	bījādikāraṇakalāpo'ṅkurapariṇāme | yaccānyānapekṣaṃ na tathā bhavati na	bīja ādi kāraṇa kalāpa uṅkura pariṇāme yat ca anya anapekṣam na tathā bhavati na 
MBIISVARASIDDHI_hk-332	tattatra tathāsvabhāvaṃ yathā śālibījaṃ yavāṅkure jalādirahitaṃ vā bījam |	tat tatra tathā svabhāvam yathā śāli bījam yava aṅkure jala ādi rahitam vā bījam 
MBIISVARASIDDHI_hk-333	tathā ca pradhānaṃ puruṣārthopayogimahadādivikārapariṇāmaikasvabhāvaṃ	tathā ca pradhānam puruṣa artha upayogi mahat ādi vikāra pariṇāma eka svabhāvam 
MBIISVARASIDDHI_hk-334	na tu śālibījaṃ yavāṅkura iva | tasmādanyeśvarādinimittakāraṇānapekṣaṃ	na tu śāli bījam yava aṅkure iva tasmāt anya īśvara ādi nimitta kāraṇa anapekṣam 
MBIISVARASIDDHI_hk-335	svabhāvādeva mahadādipariṇāmavatpradhānamiti | atra pradhānaṃ	svabhāvāt eva mahat ādi pariṇāmavat pradhānam iti atra pradhānam 
MBIISVARASIDDHI_hk-336	tāvatsamanvayādihetubhiḥ siddhameva | svārthatādiniṣedhena ca	tāvat samanvaya ādi hetubhiḥ siddham eva svārtha tā ādi niṣedhena ca 
MBIISVARASIDDHI_hk-337	puruṣārthasvabhāvatvamasyopapāditam | dṛṣṭāntasyāpi	puruṣa artha svabhāva tvam asya upapāditam dṛṣṭāntasya api 
MBIISVARASIDDHI_hk-338	bījādikāraṇakalāpasya na ca paraṃ prati saṃdigdhasādhyatve pakṣakṛtatvameva |	bīja ādi kāraṇa kalāpasya na ca param prati saṃdigdha sādhya tve pakṣa kṛta tvam eva 
MBIISVARASIDDHI_hk-339	sā ca tadaṅkurakaraṇasvabhāvaiva,-iti na taṃ pratyapi tasyāstāvatyāstathā	sā ca tad aṅkura karaṇa svabhāvā eva eti na tam prati api tasyāḥ tāvatyāḥ tathā 
MBIISVARASIDDHI_hk-340	svakāryakaraṇena nyāyā(ananyā)pekṣasvabhāvatvaṃ saṃdigdhamiti || tadāha	sva kārya karaṇena saṃdigdham iti tat āha 
MBIISVARASIDDHI_hk-341	yadyathā pariṇāmaikasvabhāvaṃ tatra tattataḥ || 25 ||	yat yathā pariṇāma eka svabhāvam tatra tat tatas 
MBIISVARASIDDHI_hk-342	ananyāpekṣi bījādisāmagrī yadvadaṅkure |	an anya apekṣi bīja ādi sāmagrī yadvat aṅkure 
MBIISVARASIDDHI_hk-343	(p. 18)	p 
MBIISVARASIDDHI_hk-344	mahadādivikāraughapariṇāmasvabhāvakam || 26 ||	mahat ādi vikāra ogha pariṇāma svabhāvakam 
MBIISVARASIDDHI_hk-345	triguṇātma pradhānaṃ ca tena sāṃkhyamanīśvaram |	triguṇa ātma pradhānam ca tena sāṃkhyam anīśvaram 
MBIISVARASIDDHI_hk-346	iti ||	iti 
MBIISVARASIDDHI_hk-347	tatraitānsāṃkhyānpratyucyate,-yathā nāvagato bhavadbhiḥ sādhanārtha	tatra etān sāṃkhyān pratyucyate yathā na avagataḥ bhavadbhiḥ sādhana artha 
MBIISVARASIDDHI_hk-348	iti | yadi hi sarvavicitrasaṃsthānakāryotpādaneṣu pradhānasyaiva yā	iti yadi hi sarva vicitra saṃsthāna kārya utpādaneṣu pradhānasya eva yā 
MBIISVARASIDDHI_hk-349	puruṣabhogārthatā saiva nimittakāraṇaṃ kimiśvareṇeti ucyate	puruṣa bhoga arthatā sā eva nimitta kāraṇam kim iśvareṇa iti ucyate 
MBIISVARASIDDHI_hk-350	tatkumbhakāreṇāpi kiṃ ghaṭakaraṇe | tatrāpi prādhānikasya mṛtpiṇḍādeḥ	tat kumbhakāreṇa api kim ghaṭa karaṇe tatra api prādhānikasya mṛd piṇḍa ādeḥ 
MBIISVARASIDDHI_hk-351	puruṣārthasvabhāvatāvaśādeva tathābhūtasaṃniveśavaddhaṭakaraṇa-	puruṣa artha svabhāva tā vaśāt eva tathābhūta saṃniveśa vat dhaṭa karaṇa 
MBIISVARASIDDHI_hk-352	sāmarthyaṃ syāt | nahi pṛthubudhnodarākārasaṃniveśaṃ vinā	sāmarthyam syāt nahi pṛthu budhna udara ākāra saṃniveśam vinā 
MBIISVARASIDDHI_hk-353	bhokturudakāharaṇalabhyo bhogaḥ siddhyet | tṛṇavāriṇādyarthināṃ vā	bhoktuḥ udaka āharaṇa labhyaḥ bhogaḥ siddhyet tṛṇa vāriṇā ādi arthinām vā 
MBIISVARASIDDHI_hk-354	karmabhireva? tadākāravattā ghaṭasya bhavet kiṃ tatra kulālena | atha	karmabhiḥ eva tad ākāravat tā ghaṭasya bhavet kim tatra kulālena atha 
MBIISVARASIDDHI_hk-355	pradhānasyāyamapi svabhāvaviśeṣa eva, yaddhaṭasaṃniveśādau	pradhānasya ayam api svabhāva viśeṣaḥ eva yat dhaṭa saṃniveśa ādau 
MBIISVARASIDDHI_hk-356	daṇḍacakravadbuddhimadapekṣā, tāvatā prādhānikena kāraṇakalāpena	daṇḍa cakra vat buddhimat apekṣā tāvatā prādhānikena kāraṇa kalāpena 
MBIISVARASIDDHI_hk-357	puruṣārthopayogitatsaṃniveśavaddhaṭavastusiddheḥ | tadevameva	puruṣa artha upayogi tad saṃniveśa vat dhaṭa vastu siddheḥ tat evam eva 
MBIISVARASIDDHI_hk-358	tanukaraṇādikāraṇasyāpi prādhānikāttathāsvabhāvayogāt kathaṃ	tanu karaṇa ādi kāraṇasya api prādhānikāt tathā svabhāva yogāt katham 
MBIISVARASIDDHI_hk-359	tathākaraṇayogyabuddhimadapekṣā neṣyate | eṣa hi tāvannyāyo'sti	tathā karaṇa yogya buddhimat apekṣā na iṣyate eṣa hi tāvat nyāyaḥ usti 
MBIISVARASIDDHI_hk-360	yadekatraikadā dhūmāgnyoḥ saṃbandhe'vagate'nyadā anyatra anyayoreva	yat ekatra ekadā dhūma agnyoḥ anyatra anyayoḥ eva 
MBIISVARASIDDHI_hk-361	dhūmāgnyostathaiva saṃbandho'vaśyabhāvī, yena dhūmāntarādadṛṣṭo'pi	dhūma agnyoḥ tathā eva saṃbandhaḥ vaśya bhāvī yena dhūma antarāt adṛṣṭaḥ api 
MBIISVARASIDDHI_hk-362	agnirniścīyate | tadanenaiva nyāyenaikatra saṃniveśaviśeṣe	agniḥ niścīyate tat anena eva nyāyena ekatra saṃniveśa viśeṣe 
MBIISVARASIDDHI_hk-363	buddhimatsaṃbandhapratītyā sarvatraiva tathā saṃniveśasya	buddhimat saṃbandha pratītyā sarvatra eva tathā saṃniveśasya 
MBIISVARASIDDHI_hk-364	(p. 19)	p 
MBIISVARASIDDHI_hk-365	buddhimadavinābhāvasiddherdehādisaṃniveśādapyadṛṣṭasya tādṛśo	buddhimat avinābhāva siddheḥ deha ādi saṃniveśāt api adṛṣṭasya 
MBIISVARASIDDHI_hk-366	buddhimataḥ kathaṃ nānumatiḥ || tadāha	buddhimataḥ katham na anumatiḥ tat āha 
MBIISVARASIDDHI_hk-367	puruṣārthasvabhāvatvaṃ samastārthakriyāsu cet || 27 ||	puruṣa artha svabhāva tvam samasta artha kriyāsu ced 
MBIISVARASIDDHI_hk-368	nimittakāraṇatvena pradhānasyopakalpyate |	nimitta kāraṇa tvena pradhānasya upakalpyate 
MBIISVARASIDDHI_hk-369	tadvinā kumbhakāreṇa ghaṭo'pi na bhavetkatham || 28 ||	tat vinā kumbhakāreṇa ghaṭaḥ api na bhavet katham 
MBIISVARASIDDHI_hk-370	pradhānamayamṛtpiṇḍādeva tādṛksvabhāvataḥ |	pradhāna maya mṛd piṇḍāt eva tādṛś svabhāvataḥ 
MBIISVARASIDDHI_hk-371	atha svabhāva eṣo'sya yatkulālādyapekṣaṇam || 29 ||	atha svabhāvaḥ eṣa usya yat kulāla ādi apekṣaṇam 
MBIISVARASIDDHI_hk-372	tatheśvaravyapekṣāstu dehahetoḥ svabhāvataḥ |	tathā īśvara vyapekṣāḥ tu deha hetoḥ svabhāvataḥ 
MBIISVARASIDDHI_hk-373	iti ||	iti 
MBIISVARASIDDHI_hk-374	na cāpi sahakāriṇāmupādānakāraṇasyāntaḥ praveśamātrādupayoga-	na ca api sahakāriṇām upādāna kāraṇasya antar praveśa mātrāt upayoga 
MBIISVARASIDDHI_hk-375	viśeṣānusaṃdhānavataḥ kasyacidavyāpāre'pi vicitrā puruṣārthopayoginī	viśeṣa anusaṃdhānavataḥ kasyacid avyāpāre pi vicitrā puruṣa artha upayoginī 
MBIISVARASIDDHI_hk-376	racanā upakalpyate | tathāhi yāvadidamito bhavati kiṃcidadhikaviśeṣātpunarata	racanā upakalpyate tathā hi yāvat idam itas bhavati kiṃcid adhika viśeṣāt punar atas 
MBIISVARASIDDHI_hk-377	evānena viśeṣeṇa saviśeṣamidameva bhavati, aparaviśeṣayuktātpunarasmādeva	eva anena viśeṣeṇa sa viśeṣam idam eva bhavati apara viśeṣa yuktāt punar asmāt eva 
MBIISVARASIDDHI_hk-378	anyadeva anyajātīyameva kāryaṃ jāyate, tataḥ saṃprati	anyat eva anya jātīyam eva kāryam jāyate tatas saṃprati 
MBIISVARASIDDHI_hk-379	(p. 20)	p 
MBIISVARASIDDHI_hk-380	evaṃvidhamupayujyate tathaiva karomītyevaṃ vicāracaturā matirna syāt,	evaṃvidham upayujyate tathā eva karomi iti evam vicāra caturā matiḥ na syāt 
MBIISVARASIDDHI_hk-381	tāvatkathaṃ tathābhūtaviśeṣakaraṇāya hānopādāne syātām | tathā vijñatve	tāvat katham tathābhūta viśeṣa karaṇāya hāna upādāne syātām tathā vijña tve 
MBIISVARASIDDHI_hk-382	ca sarvadā tathābhūtakāryasaṃbhavo na bhavati, tasya prajñāvataḥ sarvadā	ca sarvadā tathābhūta kārya saṃbhavaḥ na bhavati tasya prajñāvataḥ sarvadā 
MBIISVARASIDDHI_hk-383	tatkaraṇecchāyā abhāvāt, tataḥ sāpi tasyāpekṣaṇīyā;	tad karaṇa icchāyāḥ abhāvāt tatas sā api tasya apekṣaṇīyā 
MBIISVARASIDDHI_hk-384	icchānusaṃdhānaśūnyena tu jalabhūmyādirasena upādānāntaḥpraviṣṭenāpi	icchā anusaṃdhāna śūnyena tu jala bhūmi ādi rasena upādāna antar praviṣṭena api 
MBIISVARASIDDHI_hk-385	kāryasya sthūlatāmātramavicitrameva syāt, na tūpayogavibhāgaprayojitā	kāryasya sthūla tā mātram avicitram eva syāt na tu upayoga vibhāga prayojitā 
MBIISVARASIDDHI_hk-386	avayavasaṃsthānabhaṅgyaḥ | vilakṣaṇā dṛśyante etāḥ sarvāstathā | na	avayava saṃsthāna bhaṅgyaḥ vilakṣaṇāḥ dṛśyante etāḥ sarvāḥ tathā na 
MBIISVARASIDDHI_hk-387	cāpyetā ekāntavilakṣaṇā eva, yāvadekārthakriyopayoginyaḥ, sajātīyā api	ca api etāḥ ekānta vilakṣaṇāḥ eva yāvat eka artha kriyā upayoginyaḥ sajātīyāḥ api 
MBIISVARASIDDHI_hk-388	prājñakṛtatattatsahakārisaṃyojanaviyojanavaśādupalakṣyante |	prājña kṛta tat tat sahakāri saṃyojana viyojana vaśāt upalakṣyante 
MBIISVARASIDDHI_hk-389	buddhiśūnyasahakārimātrasāmarthye saṃśayarūpatā kevalakāryasyocitā;	buddhi śūnya sahakāri mātra sāmarthye saṃśaya rūpa tā kevala kāryasya ucitā 
MBIISVARASIDDHI_hk-390	kākatālīyo'vayavavibhāga ekatraiva sā..................ḍanyatrānyādṛśataiva bhavet	kākatālīya uvayava vibhāgaḥ ekatra eva sāṭ anyatra anyādṛśa tā eva bhavet 
MBIISVARASIDDHI_hk-391	| yatpunaranugāmitvamavaśyamupayogaviśeṣānugāmitānuvidhāyi	yat punar anugāmi tvam avaśyam upayoga viśeṣa anugāmi tā anuvidhāyi 
MBIISVARASIDDHI_hk-392	sarvakāryeṣūpalabhyate, tattathā niyamena na syāt |	sarva kāryeṣu upalabhyate tat tathā niyamena na syāt 
MBIISVARASIDDHI_hk-393	tasmānmṛtpiṇḍāyātaghaṭaśarāvodañcaneṣṭakādisaṃniveśa-vibhāgakārī	tasmāt mṛd piṇḍa āyāta ghaṭa śarāva udañcana iṣṭakā ādi saṃniveśa vibhāga kārī 
MBIISVARASIDDHI_hk-394	prayojanabhedānusāritayā dṛśyate buddhimata icchādivyāpāraḥ	prayojana bheda anusāri tayā dṛśyate buddhimataḥ icchā ādi vyāpāraḥ 
MBIISVARASIDDHI_hk-395	prajñāviśeṣamayo, na tu jaḍavijātīyatāpātratayā sahakāritvena | tathā sati hi sa	prajñā viśeṣa mayaḥ na tu jaḍa vijātīya tā pātra tayā sahakāri tvena tathā sati hi sa 
MBIISVARASIDDHI_hk-396	kumbhakārasaṃbandhāddhaṭa eva vā syāt śarāva eva vā, na tu	kumbhakāra saṃbandhāt dhaṭaḥ eva vā syāt śarāvaḥ eva vā na tu 
MBIISVARASIDDHI_hk-397	kuṇḍamapīṣṭakānya(dya)pi vā | tato yathābhūtamicchati jānāti ca kartuṃ	kuṇḍam api iṣṭakāni adi api vā tatas yathābhūtam icchati jānāti ca kartum 
MBIISVARASIDDHI_hk-398	tādṛgevātra kāryaviśeṣodgamaḥ | ata eva saṃniveśasya viśeṣaḥ	tādṛś eva atra kārya viśeṣa udgamaḥ atas eva saṃniveśasya viśeṣaḥ 
MBIISVARASIDDHI_hk-399	puruṣārthopayogitvenārthanīyatvāt na tu pṛthubudhnodarākāratvādi, yena	puruṣa artha upayogi tvena arthanīya tvāt na tu pṛthu budhna udara ākāra tva ādi yena 
MBIISVARASIDDHI_hk-400	siddhaṃ yādṛgadhiṣṭhātṛbhāva.............. ityādi codyeta | icchayā saha	siddham yādṛś adhiṣṭhātṛ bhāvaḥ ityādi codyeta icchayā saha 
MBIISVARASIDDHI_hk-401	saṃniveśasyāpi hi punarhastādyapekṣayānavasthānāt | tataśca	saṃniveśasya api hi punar hasta ādi apekṣayā anavasthānāt tatas ca 
MBIISVARASIDDHI_hk-402	(p. 21)	p 
MBIISVARASIDDHI_hk-403	tanukaraṇabhuvanānāmanyonyānuguṇyavida ekasyaiva	tanu karaṇa bhuvanānām anyonya ānuguṇya vidaḥ ekasya eva 
MBIISVARASIDDHI_hk-404	kartustathecchāmātrasaṃniveśaviśeṣavattvam | sthādau takṣṇo	kartuḥ tathā icchā mātra saṃniveśa viśeṣavat tvam sthā ādau takṣṇaḥ 
MBIISVARASIDDHI_hk-405	yadyapyayaḥsaṃniveśavijñatāpi syāt tathāpi tasya	yadi api ayaḥ saṃniveśa vijña tā api syāt tathā api tasya 
MBIISVARASIDDHI_hk-406	hastādivyāpārānabhyāsādayoyojane'yaskāra eva kartā |	hasta ādi vyāpāra an abhyāsa ādayaḥ yojana iyaskāraḥ eva kartā 
MBIISVARASIDDHI_hk-407	bhinnadeśakālagatavivartitatvādyanusaṃdhānavatastu	bhinna deśa kāla gata vivartita tva ādi anusaṃdhānavataḥ tu 
MBIISVARASIDDHI_hk-408	saṃhatecchāmātrātkāryasya siddhau na siddhā viśvabhāge kartrantarāpekṣā,	saṃhata icchā mātrāt kāryasya siddhau na siddhā viśva bhāge kartṛ antara apekṣā 
MBIISVARASIDDHI_hk-409	ayaskāra iva hastābhyāsānapekṣaṇādityeka eva tanvādiviśvakartā	ayaskāraḥ iva hasta abhyāsa anapekṣaṇāt iti ekaḥ eva tanu ādi viśva kartā 
MBIISVARASIDDHI_hk-410	puruṣārthopayogitvena | taccārthisārthairarthanīyatvaṃ na ghaṭamātrāśrayeṇa,	puruṣa artha upayogi tvena tat ca arthi sārthaiḥ arthanīya tvam na ghaṭa mātra āśrayeṇa 
MBIISVARASIDDHI_hk-411	kuṇḍapaṭaśakaṭādigatatvena prājñaśaktakartṛkatayā ca tādṛśa	kuṇḍa paṭa śakaṭa ādi gata tvena prājña śakta kartṛka tayā ca 
MBIISVARASIDDHI_hk-412	evānumitādhikṛto na tu ghaṭakumbhakāramātradarśī, yathā	eva anumita adhikṛtaḥ na tu ghaṭa kumbhakāra mātra darśī yathā 
MBIISVARASIDDHI_hk-413	tārṇapārṇacāndanādyanekāgnidhūmagatapratyakṣānupalambha-	tārṇa pārṇa cāndana ādi aneka agni dhūma gata pratyakṣa anupalambha 
MBIISVARASIDDHI_hk-414	pravṛttimānāgnimātrānumāne | anekaviśeṣadarśane hi	pravṛtti māna agni mātra anumāne aneka viśeṣa darśane hi 
MBIISVARASIDDHI_hk-415	sāmānyaniṣṭhakāryakāraṇabhāvapratiṣṭhāyāṃ viśeṣavyabhicāraḥ	sāmānya niṣṭha kārya kāraṇa bhāva pratiṣṭhāyām viśeṣa vyabhicāraḥ 
MBIISVARASIDDHI_hk-416	siddhyati; ekaviśeṣavyabhicārācca sarvaviśeṣavyabhicāraniścayena	siddhi ati eka viśeṣa vyabhicārāt ca sarva viśeṣa vyabhicāra niścayena 
MBIISVARASIDDHI_hk-417	atyantādṛṣṭapūrvaśāṃśapādiviśeṣānirākaraṇāt na	atyanta adṛṣṭa pūrva śāṃśapa ādi viśeṣa anirākaraṇāt na 
MBIISVARASIDDHI_hk-418	sarvaviśeṣadarśanamupayujyate | evamihāpi saṃniveśaviśeṣamātrasya	sarva viśeṣa darśanam upayujyate evam iha api saṃniveśa viśeṣa mātrasya 
MBIISVARASIDDHI_hk-419	tathābhūtacikīrṣāyāśca anekasaṃniveśadarśanāt sāmānyena	tathābhūta cikīrṣāyāḥ ca aneka saṃniveśa darśanāt sāmānyena 
MBIISVARASIDDHI_hk-420	kāryakāraṇatāsiddhau	kārya kāraṇa tā siddhau 
MBIISVARASIDDHI_hk-421	kulālānīśvarādiviśeṣavyabhicāraniścaye'tyantādṛṣṭatanu-	                    
MBIISVARASIDDHI_hk-422	karaṇādicikīrṣāviśeṣānirākaraṇena saṃniveśaviśeṣāt tathā	karaṇa ādi cikīrṣā viśeṣa a nirākaraṇena saṃniveśa viśeṣāt tathā 
MBIISVARASIDDHI_hk-423	cikīrṣāmātrānumānam; icchākāryeṣu anaṅgabhūte'pyanīśvaratve	cikīrṣā mātra anumānam icchā kāryeṣu anaṅga bhūte pi anīśvara tve 
MBIISVARASIDDHI_hk-424	sahadarśanamātrādapekṣopagamena	saha darśana mātrāt apekṣā upagamena 
MBIISVARASIDDHI_hk-425	kiṃcidapīcchākāryamupadeśādyamīśvarasya anīśvarasya vā siddhyet;	kiṃcid api icchā kāryam upadeśa ādyam īśvarasya anīśvarasya vā siddhyet 
MBIISVARASIDDHI_hk-426	deharāgādisahabhāvadarśane ca rūpyadhātvādau icchāvatāṃ tatkāryaṃ na	deha rāga ādi sahabhāva darśane ca rūpya dhātu ādau icchāvatām tat kāryam na 
MBIISVARASIDDHI_hk-427	syāt | tadevaṃ tanukaraṇabhuvanānāṃ saṃsthānabhaṅgīvaicitryaṃ	syāt tat evam tanu karaṇa bhuvanānām saṃsthāna bhaṅgī vaicitryam 
MBIISVARASIDDHI_hk-428	tadanuguṇaprajñāmahimānaṃ	tad anuguṇa prajñā mahimānam 
MBIISVARASIDDHI_hk-429	(p. 22)	p 
MBIISVARASIDDHI_hk-430	vinā kathaṃ prādhānikajaḍavastusvabhāvamātrādupayogavibhāga-	vinā katham prādhānika jaḍa vastu svabhāva mātrāt upayoga vibhāga 
MBIISVARASIDDHI_hk-431	niyatamanugāmi cārthitāspadamupapadyeta || tadāha	niyatam anugāmi ca arthita āspadam upapadyeta tat āha 
MBIISVARASIDDHI_hk-432	naivopādanahetvantaḥ praveśātsahakāribhiḥ || 30 ||	na eva upādana hetu antar praveśāt sahakāribhiḥ 
MBIISVARASIDDHI_hk-433	saṃniveśaviśeṣo'pi śakyaḥ kartumiti kṣamam |	saṃniveśa viśeṣaḥ api śakyaḥ kartum iti kṣamam 
MBIISVARASIDDHI_hk-434	lokayātrānusaṃdhānavatīṃ prajñāṃ vinā nahi || 31 ||	lokayātrā anusaṃdhānavatīm prajñām vinā nahi 
MBIISVARASIDDHI_hk-435	tathā cikīrṣāṃ ca vinā vicitraracanodbhavaḥ |	tathā cikīrṣām ca vinā vicitra racanā udbhavaḥ 
MBIISVARASIDDHI_hk-436	sthūlatāmātrameva syānna tu lokopayoginī || 32 ||	sthūla tā mātram eva syāt na tu loka upayoginī 
MBIISVARASIDDHI_hk-437	racanā niyamena syādvicitrā jātirūpiṇī |	racanā niyamena syāt vicitrā jāti rūpiṇī 
MBIISVARASIDDHI_hk-438	kulālasahakāritvamātrāccejjāyate ghaṭaḥ || 33 ||	kulāla sahakāri tva mātrāt ced jāyate ghaṭaḥ 
MBIISVARASIDDHI_hk-439	na syājjātu śarīrādi dīrghamṛtpiṇḍa eva vā |	na syāt jātu śarīra ādi dīrgha mṛd piṇḍaḥ eva vā 
MBIISVARASIDDHI_hk-440	ata evārthanīyatvātsaṃniveśo viśiṣyate || 34 ||	atas eva arthanīya tvāt saṃniveśaḥ viśiṣyate 
MBIISVARASIDDHI_hk-441	(p. 23)	p 
MBIISVARASIDDHI_hk-442	na ghaṭāditayā siddhaḥ so'rthitāparipūrakaḥ |	na ghaṭa ādi tayā siddhaḥ saḥ ṛthita a paripūrakaḥ 
MBIISVARASIDDHI_hk-443	na ceśvaro'nīśvaro vā prakṛto'trāṇulakṣaṇaḥ || 35 ||	na ca īśvaraḥ unīśvaraḥ vā prakṛtaḥ utra aṇu lakṣaṇaḥ 
MBIISVARASIDDHI_hk-444	vaicitryakārī yo yatra sa tatreśvara iṣyate |	vaicitrya kārī yaḥ yatra sa tatra īśvaraḥ iṣyate 
MBIISVARASIDDHI_hk-445	iti ||	iti 
MBIISVARASIDDHI_hk-446	na ca pradhānasyaiva mūlakāraṇasya vyavasāyādibhirvyāktirasti	na ca pradhānasya eva mūla kāraṇasya vyavasāya ādibhiḥ vyāktiḥ asti 
MBIISVARASIDDHI_hk-447	tatkathaṃ tasyecchādiyogaḥ puruṣārthoddeśānītaḥ syāt yataḥ pravṛttirbhavet |	tat katham tasya icchā ādi yogaḥ puruṣa artha uddeśa ānītaḥ syāt yatas pravṛttiḥ bhavet 
MBIISVARASIDDHI_hk-448	yadyapi ca buddherastīcchānusaṃdhānaṃ ca vyāpārastathāpi	yadi api ca buddheḥ asti icchā anusaṃdhānam ca vyāpāraḥ tathā api 
MBIISVARASIDDHI_hk-449	puruṣasaṃnidhānādyāvanna cetyamānaḥ prakāśamāno'sau	puruṣa saṃnidhānāt yāvat na cetyamānaḥ prakāśamānaḥ asau 
MBIISVARASIDDHI_hk-450	saṃpannastāvannecchādirūpatāṃ dhatte tathālakṣaṇatvādicchānu-	saṃpannaḥ tāvat na icchā ādi rūpa tām dhatte tathā lakṣaṇa tvāt icchā anu 
MBIISVARASIDDHI_hk-451	saṃdhānādīnām | anyathārthāntarameva tatsyāt | tathā ca sati na	saṃdhāna ādīnām anyathā artha antaram eva tat syāt tathā ca sati na 
MBIISVARASIDDHI_hk-452	buddhipravṛttireva puruṣārthā yāvatpuruṣasya saṃvedanavyāpāro'pi	buddhi pravṛttiḥ eva puruṣa arthā yāvat puruṣasya saṃvedana vyāpāraḥ api 
MBIISVARASIDDHI_hk-453	puruṣārthaḥ syāt na tu kevalaṃ pradhānameva saṃvedanameva ca	puruṣa arthaḥ syāt na tu kevalam pradhānam eva saṃvedanam eva ca 
MBIISVARASIDDHI_hk-454	puruṣasyārthaḥ, tasmātpuruṣanairapekṣyeṇa pradhānabuddhyādivyāpārasya	puruṣasya arthaḥ tasmāt puruṣa nairapekṣyeṇa pradhāna buddhi ādi vyāpārasya 
MBIISVARASIDDHI_hk-455	puruṣārthatā na vācyā, tādṛśasya ceṣṭānusaṃdhānarūpatvābhāvāt na sā	puruṣa artha tā na vācyā tādṛśasya ceṣṭā anusaṃdhāna rūpa tva abhāvāt na sā 
MBIISVARASIDDHI_hk-456	yuktā,-iti yuktameva | atha sarvapuruṣasādhāraṇasya ekasyāpi buddhitattvasya	yuktāḥ iti yuktam eva atha sarva puruṣa sādhāraṇasya ekasya api buddhi tattvasya 
MBIISVARASIDDHI_hk-457	mahatsaṃjñakasya pratipuruṣamadhyavasāyalakṣaṇavṛttiḥ satyaṃ bhidyate,	mahat saṃjñakasya prati puruṣam adhyavasāya lakṣaṇa vṛttiḥ satyam bhidyate 
MBIISVARASIDDHI_hk-458	mahatkāraṇāsmitājanmano vā manaḥsaṃjñakaraṇasya | eṣā	mahat kāraṇa asmitā janmanaḥ vā manaḥ saṃjña karaṇasya eṣā 
MBIISVARASIDDHI_hk-459	adhyavasāyādivṛttiḥ pratyekapuruṣaniyatāstu, na tayā uttarakālabhāvinyā	adhyavasāya ādi vṛttiḥ pratyeka puruṣa niyatā astu na tayā uttara kāla bhāvinyā 
MBIISVARASIDDHI_hk-460	pradhānasya mahato vā puruṣārthānusaṃdhānecchāvattā yujyate kiṃ tu	pradhānasya mahataḥ vā puruṣa artha anusaṃdhāna icchāvat tā yujyate kim tu 
MBIISVARASIDDHI_hk-461	pradhānasyaiva	pradhānasya eva 
MBIISVARASIDDHI_hk-462	(p. 24)	p 
MBIISVARASIDDHI_hk-463	prathamavikārakaraṇa eva sarvapuruṣoddeśena sāmānyānusaṃdhānecchā	prathama vikāra karaṇe eva sarva puruṣa uddeśena sāmānya anusaṃdhāna icchā 
MBIISVARASIDDHI_hk-464	vyavasāyādivṛttiḥ prathamā buddhisaṃjñā astyeva, yena tasyāpi	vyavasāya ādi vṛttiḥ prathamā buddhi saṃjñā asti eva yena tasya api 
MBIISVARASIDDHI_hk-465	buddhipūrvakāritā syāt | tadaiva tadapi na yuktam, pradhānya(nasya)sarvathaiva	buddhi pūrva kāri tā syāt tadā eva tat api na yuktam pradhānya nasya sarvathā eva 
MBIISVARASIDDHI_hk-466	avyaktarūpatvenānupalakṣaṇīyavṛttitvāt | na ca vṛttau	avyakta rūpa tvena anupalakṣaṇīya vṛtti tvāt na ca vṛttau 
MBIISVARASIDDHI_hk-467	puruṣeṇāsaṃviditāyāmicchānusaṃdhānādirūpatvaṃ saṃbhavati,	puruṣeṇa asaṃviditāyām icchā anusaṃdhāna ādi rūpa tvam saṃbhavati 
MBIISVARASIDDHI_hk-468	puruṣeṇāpi pradhānavṛtteḥ kena saṃvedyamānatā sarvapuruṣoddeśena	puruṣeṇa api pradhāna vṛtteḥ kena saṃvedyamāna tā sarva puruṣa uddeśena 
MBIISVARASIDDHI_hk-469	sāmānyapravṛtteḥ, ekaikena cet tattasya sarvajñatvaṃ syāt, puruṣārthatvaṃ ca	sāmānya pravṛtteḥ ekaikena ced tat tasya sarvajña tvam syāt puruṣa artha tvam ca 
MBIISVARASIDDHI_hk-470	pūrvavatsarvapuruṣopayogi svakāryānusaṃdhānavattvāt,	pūrvavat sarva puruṣa upayogi sva kārya anusaṃdhānavat tvāt 
MBIISVARASIDDHI_hk-471	prakāśyadharmabhūtā(yā)śca prakāśasthānatāyā	prakāśya dharma bhūtāyāḥ ca prakāśa sthāna tāyāḥ 
MBIISVARASIDDHI_hk-472	anantapuruṣasaṃnidhānānītatvādānantye'pi āśrayaikyena	ananta puruṣa saṃnidhāna ānīta tvāt ānantye pi āśraya aikyena 
MBIISVARASIDDHI_hk-473	anyonyonmūlanātpuruṣabahutvāsiddhiḥ | atha sāmānyarūpeṇaiva sarvajñena ca	anyonya unmūlanāt puruṣa bahu tva asiddhiḥ atha sāmānya rūpeṇa eva sarvajñena ca 
MBIISVARASIDDHI_hk-474	puruṣaviśeṣeṇa sāmānyapradhānavṛtteḥ saṃvedyamānatā tatsa eveśvaro'stu,	puruṣa viśeṣeṇa sāmānya pradhāna vṛtteḥ saṃvedyamāna tā tat saḥ eva īśvaroḥ tu 
MBIISVARASIDDHI_hk-475	tasyaiva viśvanirmitsā saṃvedyā satī saṃbandhinī bhavati,-iti pradhānavat	tasya eva viśva nirmitsā saṃvedyā satī saṃbandhinī bhavati iti pradhāna vat 
MBIISVARASIDDHI_hk-476	tasyāpi nimittakāraṇatāyogātsarvajñatvātsarvakartṛtvācca || tadāha	tasya api nimitta kāraṇa tā yogāt sarvajña tvāt sarva kartṛ tvāt ca tat āha 
MBIISVARASIDDHI_hk-477	na ca pradhānasyecchādisaṃbhavaḥ puruṣārthatā || 36 ||	na ca pradhānasya icchā ādi saṃbhavaḥ puruṣa artha tā 
MBIISVARASIDDHI_hk-478	yataḥ syādasya buddhestu saṃbhavannapyasaṃbhavī |	yatas syāt asya buddheḥ tu saṃbhavan api asaṃbhavī 
MBIISVARASIDDHI_hk-479	vinā saṃvedyatāṃ puṃsastathātve puruṣārthatā || 37 ||	vinā saṃvedya tām puṃsaḥ tathātve puruṣa artha tā 
MBIISVARASIDDHI_hk-480	puṃso'pi syātpradhānasyāvācyā sā kevalasya tu |	puṃsaḥ api syāt pradhānasya avācyā sā kevalasya tu 
MBIISVARASIDDHI_hk-481	(p. 25)	p 
MBIISVARASIDDHI_hk-482	athāpi manaso vṛttirbuddhervaikaikasaṃskṛtā || 38 ||	atha api manasaḥ vṛttiḥ buddheḥ vā ekaika saṃskṛtā 
MBIISVARASIDDHI_hk-483	icchā nāma kathaṃ sarvapuruṣārthopayoginī |	icchā nāma katham sarva puruṣa artha upayoginī 
MBIISVARASIDDHI_hk-484	syātikiṃ tu sā pradhānasya sāmānyasyākhilānprati || 39 ||	tu sā pradhānasya sāmānyasya akhilān prati 
MBIISVARASIDDHI_hk-485	puṃsaḥ syātsāpyasaṃvedyā necchā vedyā ca kasya sā |	puṃsaḥ syāt sā api a saṃvedyā nā icchā vedyā ca kasya sā 
MBIISVARASIDDHI_hk-486	sarveṣāṃ yadi sārvajñyamekaikasya prasajyate || 40 ||	sarveṣām yadi sārvajñyam ekaikasya prasajyate 
MBIISVARASIDDHI_hk-487	saṃkīryeranprakāśaikyādbhinnāścābhāsamānatāḥ |	saṃkīryeran prakāśa aikyāt bhinnāḥ ca ābhāsa māna tāḥ 
MBIISVARASIDDHI_hk-488	athāpi sarvapuruṣābhinnenaikena kenacit || 41 ||	atha api sarva puruṣa abhinnena ekena kenacid 
MBIISVARASIDDHI_hk-489	vedyā sā vaiṣa tarhyekaḥ kartā jñātā sa ceśvaraḥ |	vedyā sā vā eṣa tarhi ekaḥ kartā jñātā sa ca īśvaraḥ 
MBIISVARASIDDHI_hk-490	iti ||	iti 
MBIISVARASIDDHI_hk-491	atha na puruṣasyopayogi karomi ityevamanusaṃdhānavata eva	atha na puruṣasya upayogi karomi iti evam anusaṃdhānavataḥ eva 
MBIISVARASIDDHI_hk-492	puruṣārthatvaṃ yena pradhānasya tadabhāvānna syāt, api tu pradhānaṃ	puruṣa artha tvam yena pradhānasya tad abhāvāt na syāt api tu pradhānam 
MBIISVARASIDDHI_hk-493	mahadvā tanmātrāṇi vā yadi vā śukraśoṇitādyapi tatsvabhāvatvādeva	mahat vā tanmātrāṇi vā yadi vā śukra śoṇita ādi api tad svabhāva tvāt eva 
MBIISVARASIDDHI_hk-494	(p. 26)	p 
MBIISVARASIDDHI_hk-495	tādṛkkāryamabhinirva(rta)yati, yajjātaṃ sadvicitrasaṃniveśādikaṃ	tādṛś kāryam abhinirvartayati yat jātam sat vicitra saṃniveśa ādikam 
MBIISVARASIDDHI_hk-496	parato'rthakriyāviśeṣārthī pramātā dṛṣṭvā strīpuṃsādivadanyonyaṃ yojayati	paratas ṛthak kriyā viśeṣa arthī pramātā dṛṣṭvā strīpuṃsa ādi vat anyonyam yojayati 
MBIISVARASIDDHI_hk-497	| kvacitpunaḥ karmavaśācca vyāghātakādīnāṃ kākatālīyena anyathā vā	kvacid punar karma vaśāt ca vyāghātaka ādīnām kākatālīyena anyathā vā 
MBIISVARASIDDHI_hk-498	saṃnipāto bhavettataḥ puruṣabhogārthamiva kāraṇānāṃ pravṛttirityupacāreṇa	saṃnipātaḥ bhavet tatas puruṣa bhoga artham iva kāraṇānām pravṛttiḥ iti upacāreṇa 
MBIISVARASIDDHI_hk-499	puruṣārthatā ucyate, tadetadapi na yuktaṃ | yata evaṃ sati vastuto	puruṣa artha tā ucyate tat etat api na yuktam yatas evam sati 
MBIISVARASIDDHI_hk-500	nimittakāraṇābhāvāt svātantryeṇa svabhāvādeva kāraṇānāṃ	nimitta kāraṇa abhāvāt svātantryeṇa svabhāvāt eva kāraṇānām 
MBIISVARASIDDHI_hk-501	tathāvidhakāryaviśeṣakāriteti dṛṣṭe prakṛtipuruṣāntare tameva puruṣaṃ pratyapi	tathāvidha kārya viśeṣa kāri tā iti dṛṣṭe prakṛti puruṣa antare tam eva puruṣam prati api 
MBIISVARASIDDHI_hk-502	teṣāṃ kathaṃ kāryakaraṇāya pravṛttirna bhavati | atha bhavatyeva prakṛtyaikasya |	teṣām katham kārya karaṇāya pravṛttiḥ na bhavati atha bhavati eva prakṛtyā ekasya 
MBIISVARASIDDHI_hk-503	nanu ekasya prakṛtipuruṣāntarajñānādeva sā nirudhyate,	nanu ekasya prakṛti puruṣa antara jñānāt eva sā nirudhyate 
MBIISVARASIDDHI_hk-504	sarvapuruṣasādhanatvaṃ kasya(syāḥ)prakṛterekarūpatvāt aṣṭānāṃ	sarva puruṣa sādhana tvam kasya asyāḥ prakṛteḥ eka rūpa tvāt aṣṭānām 
MBIISVARASIDDHI_hk-505	prakṛtīnāṃ, tadastvāsāṃ; śukraśoṇitādestu muktābhimataṃ puruṣaṃ prati	prakṛtīnām tat astu āsām śukra śoṇita ādeḥ tu mukta abhimatam puruṣam prati 
MBIISVARASIDDHI_hk-506	kasmāddehātmakakāryajananaṃ na bhavet | atha tasyāpi tadbhavatyeva kiṃ tu	kasmāt deha ātmaka kārya jananam na bhavet atha tasya api tat bhavati eva kim tu 
MBIISVARASIDDHI_hk-507	puruṣasya kṛtārthatvāt na tadutpannamatisaṃvedyatāṃ yāti | tadetadevaṃ syāt,	puruṣasya kṛtārtha tvāt na tat utpanna mati saṃvedya tām yāti tat etat evam syāt 
MBIISVARASIDDHI_hk-508	yadi puruṣasya buddhisaṃvedanāya svarūpātiśayalakṣaṇaḥ kaścidudyamaḥ	yadi puruṣasya buddhi saṃvedanāya sva rūpa atiśaya lakṣaṇaḥ kaścid udyamaḥ 
MBIISVARASIDDHI_hk-509	syāt, sa cedānīṃ kṛtakāryatvāt tasya nivṛttaḥ,-iti yāvatā sarvadā	syāt sa ca idānīm kṛta kārya tvāt tasya nivṛttaḥ iti yāvatā sarvadā 
MBIISVARASIDDHI_hk-510	nirabhiprāyo nirudyama eva caikarūpa udāsīnaḥ puruṣo na	nirabhiprāyaḥ nirudyamaḥ eva ca ekarūpaḥ udāsīnaḥ puruṣaḥ na 
MBIISVARASIDDHI_hk-511	tasyaikadātiśayayogo'nyadā tannivṛttiḥ kūṭasthatāhāniprasaṅgāt | kevalaṃ	tasya ekadā atiśaya yogaḥ nyadā tad nivṛttiḥ kūṭastha tā hāni prasaṅgāt kevalam 
MBIISVARASIDDHI_hk-512	buddheḥ karmavaśāt pratipuruṣaṃ vṛttiviśeṣo'ntaḥkaraṇasya vā niyato, yena	buddheḥ karma vaśāt prati puruṣam vṛtti viśeṣaḥ ntaḥkaraṇasya vā niyataḥ yena 
MBIISVARASIDDHI_hk-513	muktapuruṣasyāparabuddhivṛttiḥ saṃvedanamanubhavati, anyathā	mukta puruṣasya apara buddhi vṛttiḥ saṃvedanam anubhavati anyathā 
MBIISVARASIDDHI_hk-514	ekātmīyābhimatabuddhivṛttibhogānivṛtteḥ, tataḥ puruṣasya	ekātmīya abhimata buddhi vṛtti bhoga anivṛtteḥ tatas puruṣasya 
MBIISVARASIDDHI_hk-515	arthitvānarthitvavibhāgābhāvāt nityanirmuktasvabhāvasya	arthi tva anarthi tva vibhāga abhāvāt nitya nirmukta svabhāvasya 
MBIISVARASIDDHI_hk-516	antaḥkaraṇamātmakarmaniyataṃ kevalaṃ baddhāvasthāyāṃ karmabhiḥ	antaḥkaraṇam ātma karma niyatam kevalam baddha avasthāyām karmabhiḥ 
MBIISVARASIDDHI_hk-517	saṃvedyaṃ bhavet	saṃvedyam bhavet 
MBIISVARASIDDHI_hk-518	(p. 27)	p 
MBIISVARASIDDHI_hk-519	mokṣadaśāyāṃ tu notpadyata eva, anyathā karmaṇāṃ tādavasthyāt kathaṃ na	mokṣa daśāyām tu nā utpadyate eva anyathā karmaṇām tādavasthyāt katham na 
MBIISVARASIDDHI_hk-520	niyataprastutapuruṣasaṃvedyatā syādeva, na hi puruṣāṇāṃ karma niyāmakam	niyata prastuta puruṣa saṃvedya tā syāt eva na hi puruṣāṇām karma niyāmakam 
MBIISVARASIDDHI_hk-521	api tu antaḥkaraṇasyaiva | tadevaṃ svakāraṇasvātantryādevotpanne sāntaḥkaraṇe	api tu antaḥkaraṇasya eva tat evam sva kāraṇa svātantryāt eva utpanne sa antaḥkaraṇe 
MBIISVARASIDDHI_hk-522	dehe nānarthitvāt tasya puruṣasaṃvedyatā syādeva, na bhavatīti nopapannaṃ tasya	dehe na anarthi tvāt tasya puruṣa saṃvedya tā syāt eva na bhavati iti na upapannam tasya 
MBIISVARASIDDHI_hk-523	saṃvedyasvabhāvatvāt | atha kṣīṇakarmaṇo'ntaḥkaraṇasya na	saṃvedya svabhāva tvāt atha kṣīṇa karmaṇaḥ antaḥkaraṇasya na 
MBIISVARASIDDHI_hk-524	saṃvedyatāsvabhāva ucyate, tadatra kiṃ pramāṇam | karma(bhāvā)	saṃvedya tā svabhāvaḥ ucyate tat atra kim pramāṇam karma bhāvā 
MBIISVARASIDDHI_hk-525	bhāvābhyāṃ ca tadānīṃ bandhamokṣābhyupagamaḥ syāt, na	bhāvābhyām ca tadānīm bandha mokṣa abhyupagamaḥ syāt na 
MBIISVARASIDDHI_hk-526	saṃyogaviyogābhyāṃ, tataśca darśanakṣatiḥ | na cāpi karmāṇi karuṇayāpi	saṃyoga viyogābhyām tatas ca darśana kṣatiḥ na ca api karmāṇi karuṇayā api 
MBIISVARASIDDHI_hk-527	dānādīni jñātapuruṣāntarasya viramanti, rāgadveṣaprayuktānāṃ karmaṇāṃ	dāna ādīni jñāta puruṣa antarasya viramanti rāga dveṣa prayuktānām karmaṇām 
MBIISVARASIDDHI_hk-528	bandhakatvābhyupagame	bandhaka tva abhyupagame 
MBIISVARASIDDHI_hk-529	rāgādibhāvābhāvakṛtabandhamokṣavādidarśanāśrayaṇameva syāt,-iti	rāga ādi bhāva abhāva kṛta bandha mokṣa vādi darśana āśrayaṇam eva syāt iti 
MBIISVARASIDDHI_hk-530	svābhāvikapuruṣavāde jñātapuruṣavivekasyāpi	svābhāvika puruṣa vāde jñāta puruṣa vivekasya api 
MBIISVARASIDDHI_hk-531	buddhisaṃbandhaparihārāyogādanirmokṣāpattiḥ,-	buddhi saṃbandha parihāra ayogāt anirmokṣa āpattiḥ 
MBIISVARASIDDHI_hk-532	ityaparabuddhimatpuruṣapreraṇayaiva sā mūlakāraṇasya	iti apara buddhimat puruṣa preraṇayā eva sā mūla kāraṇasya 
MBIISVARASIDDHI_hk-533	saṃsāropayogisaṃniveśaviśeṣakaraṇe pravṛttirupapannā,-iti niravadya eva	saṃsāra upayogi saṃniveśa viśeṣa karaṇe pravṛttiḥ upapannā iti niravadyaḥ eva 
MBIISVARASIDDHI_hk-534	prāktanahetūpanyāsaḥ || tadāha	prāktana hetu upanyāsaḥ tat āha 
MBIISVARASIDDHI_hk-535	na lokayātrābhiprāyājjanayedbījamaṅkuram || 42 ||	na lokayātrā abhiprāyāt janayet bījam aṅkuram 
MBIISVARASIDDHI_hk-536	kiṃ tu svabhāvātsā tasya sāmagrī heturīdṛśaḥ |	kim tu svabhāvāt sā tasya sāmagrī hetuḥ īdṛśaḥ 
MBIISVARASIDDHI_hk-537	yajjātaṃ yogyamanyonyaṃ yojayedbuddhimāñjanaḥ || 43 ||	yat jātam yogyam anyonyam yojayet buddhimān janaḥ  /
MBIISVARASIDDHI_hk-538	(p. 28)	p 
MBIISVARASIDDHI_hk-539	asya tenopacāreṇa puruṣārthatvamucyate |	asya tena upacāreṇa puruṣa artha tvam ucyate 
MBIISVARASIDDHI_hk-540	iti cettatsamāpte'pi puruṣārthe'pi taṃ prati || 44 ||	iti ced tat samāpte api puruṣa arthe api tam prati 
MBIISVARASIDDHI_hk-541	svakāryapariṇāmānna viramenmūlakāraṇam |	sva kārya pariṇāmāt na viramet mūla kāraṇam 
MBIISVARASIDDHI_hk-542	āho na viramatyetatparaṃ prakṛtisaptake || 45 ||	āho na viramati etat param prakṛti saptake 
MBIISVARASIDDHI_hk-543	pariṇāmāttadekaṃ hi sarvānpuṃsaḥ pratīṣyate |	pariṇāmāt tat ekam hi sarvān puṃsaḥ pratīṣyate 
MBIISVARASIDDHI_hk-544	tathāpi [tayeti pāṭhāntaram |] dehabhūtādeḥ pariṇāmaḥ	tathā api tayā iti pāṭha antaram deha bhūta ādeḥ pariṇāmaḥ 
MBIISVARASIDDHI_hk-545	svabhāvataḥ || 46 ||	svabhāvataḥ 
MBIISVARASIDDHI_hk-546	pūrvavanna bhavetkasmāttaṃ muktābhimataṃ prati |	pūrvavat na bhavet kasmāt tam mukta abhimatam prati 
MBIISVARASIDDHI_hk-547	athāpi sa bhavatyeva kiṃ tu tena na yujyate || 47 ||	atha api sa bhavati eva kim tu tena na yujyate  /
MBIISVARASIDDHI_hk-548	muktapuṃsā kṛtārthatvādanarthitvātsa kevalaḥ |	mukta puṃsā kṛtārtha tvāt anarthi tvāt sa kevalaḥ 
MBIISVARASIDDHI_hk-549	naitannārthitvamasyāsti jātu puṃso'tha cetasaḥ || 48 ||	na etat na arthi tvam asya asti jātu puṃsaḥ utha cetasaḥ 
MBIISVARASIDDHI_hk-550	(p. 29)	p 
MBIISVARASIDDHI_hk-551	arthitvavigamānna syādbhūyaḥ puṃsā samāgamaḥ |	arthi tva vigamāt na syāt bhūyas puṃsā samāgamaḥ 
MBIISVARASIDDHI_hk-552	tadetadapi na nyāyyaṃ jāte dehasthacetasi || 49 ||	tat etat api na nyāyyam jāte deha stha cetasi 
MBIISVARASIDDHI_hk-553	saṃvedyaikasvabhāvatvāttasya karmakṣayānna cet |	saṃvedya eka svabhāva tvāt tasya karma kṣayāt na ced 
MBIISVARASIDDHI_hk-554	tatsvabhāvatvameva syānmokṣaḥ karmakṣayāśrayaḥ || 50 ||	tad svabhāva tvam eva syāt mokṣaḥ karma kṣaya āśrayaḥ 
MBIISVARASIDDHI_hk-555	syurjñātapuṃvivekānāṃ karmāṇyapi kṛpāditaḥ |	syuḥ jñāta puṃs vivekānām karmāṇi api kṛpā āditaḥ 
MBIISVARASIDDHI_hk-556	na rāgāttāni cedevaṃ mokṣo rāgakṣayādbhavet || 51 ||	na rāgāt tāni ced evam mokṣaḥ rāga kṣayāt bhavet 
MBIISVARASIDDHI_hk-557	tathā ca darśanatyāgastanna yuktā svabhāvadṛk |	tathā ca darśana tyāgaḥ tat na yuktā svabhāva dṛś 
MBIISVARASIDDHI_hk-558	tasmātprasiddhaṃ tanvādi buddhimatkartṛpūrvakam || 52 ||	tasmāt prasiddham tanu ādi buddhimat kartṛ pūrvakam 
MBIISVARASIDDHI_hk-559	saṃsthānabhedādityetanniravadyaṃ prasādhanam || 53 ||	saṃsthāna bhedāt iti etat niravadyam prasādhanam 
MBIISVARASIDDHI_hk-560	iti ||	iti 
MBIISVARASIDDHI_hk-561	sa eṣa hetuḥ parameśvaraṃ prati	saḥ eṣa hetuḥ parameśvaram prati 
MBIISVARASIDDHI_hk-562	prayujyamānaḥ svaniveśitātmanā |	prayujyamānaḥ sva niveśita ātmanā 
MBIISVARASIDDHI_hk-563	(p. 30)	p 
MBIISVARASIDDHI_hk-564	na hetudoṣaiḥ paribhūyate manāk	na hetu doṣaiḥ paribhūyate manāk 
MBIISVARASIDDHI_hk-565	paro'pi vā kevalametaducyate || 54 ||	paraḥ api vā kevalam etat ucyate  /
MBIISVARASIDDHI_hk-566	samujjvalannyāyasahasrasādhito'-	           
MBIISVARASIDDHI_hk-567	pyupaiti siddhiṃ na vimūḍhacetasām |	pyupaiti siddhim na vimūḍha cetasām 
MBIISVARASIDDHI_hk-568	maheśvaraḥ pāṇitalasthito'pi san	maheśvaraḥ pāṇi tala sthitaḥ api san 
MBIISVARASIDDHI_hk-569	palāyate daivahatasya sanmaṇiḥ || 55 ||	palāyate daiva hatasya sat maṇiḥ 
MBIISVARASIDDHI_hk-570	svātmaivāyaṃ sphurati sakala-	svātmā eva ayam sphurati sakala 
MBIISVARASIDDHI_hk-571	prāṇināmīśvaro'ntaḥ	prāṇinām īśvaraḥ ūntaḥ 
MBIISVARASIDDHI_hk-572	kartā jñātāpi ca yadi paraṃ	kartā jñātā api ca yadi param 
MBIISVARASIDDHI_hk-573	pratyabhijñāsya sādhyā |	pratyabhijñā asya sādhyā 
MBIISVARASIDDHI_hk-574	sā cāsmābhirvihitaghaṭanā-	sā ca asmābhiḥ vihita ghaṭanā 
MBIISVARASIDDHI_hk-575	nyatra kiṃ tvīśasiddhi-	nyatra kim 
MBIISVARASIDDHI_hk-576	rdvaite'pyastītyucitamadhikaṃ	rdvaite pi asti iti ucitam adhikam 
MBIISVARASIDDHI_hk-577	bhāti vahnirniśīthe || 56 ||	bhāti vahniḥ niśīthe 
MBIISVARASIDDHI_hk-578	iti śrīmanmahāmāheśvarācāryotpaladevenodayākarasūnunā viracitā	iti śrīmat mahā māheśvara ācārya utpaladevena udayākara sūnunā viracitā 
MBIISVARASIDDHI_hk-579	īśvarasiddhiḥ samāptā ||	īśvarasiddhiḥ samāptā 
MBIISVARASIDDHI_hk-580	śrīmatkaśmīrabhūbharturājñayā prītaye satām |	śrīmat kaśmīra bhūbhartuḥ ājñayā prītaye satām 
MBIISVARASIDDHI_hk-581	madhusūdanakaulena saṃpādyeyaṃ prakāśitā ||	madhusūdana kaulena saṃpādyā iyam prakāśitā 
MBIISVARASIDDHI_hk-582	MUKTABODHA INDOLOGICAL RESEARCH INSTITUTE©2011 Muktabodha Indological Research Institute  All Rights Reserved.E-texts may be viewed only online or downloaded for private study.E-texts may not, under any circumstances, be copied, republished,reproduced, distributed or sold, either in original or altered form, withoutthe express permission of Muktabodha Indological Research Institute in writing.Data-entered by the staff of Muktabodha under the direction of Mark S. G. Dyczkowski.	muktabodha indological research muktabodha indological research institute all rights reserved texts may be viewed only online or downloaded for private studye texts may not under any circumstances be copied republished reproduced distributed or sold either in original or altered form withoutthe express permission of muktabodha indological research institute in writing data entered by the staff of muktabodha under the direction of mark s g dyczkowski 
