segmentnr	original	analyzed
MBjanmamaranavicaaraHK-0	Muktabodha E-text in UTF-8	muktabodha etext in utf
MBjanmamaranavicaaraHK-1	###########################################################################MUKTABODHA INDOLOGICAL RESEARCH INSTITUTEwww.muktabodha.org©2011 Muktabodha Indological Research Institute  All Rights Reserved.E-texts may be viewed only online or downloaded for private study.E-texts may not, under any circumstances, be copied, republished,reproduced, distributed or sold, either in original or altered form, withoutthe express permission of Muktabodha Indological Research Institute in writing.Data-entered by the staff of Muktabodha under the direction of Mark S. G. Dyczkowski.Catalog number : M00155	muktabodha indological research muktabodha indological research institute all rights reserved texts may be viewed only online or downloaded for private studye texts may not under any circumstances be copied republished reproduced distributed or sold either in original or altered form withoutthe express permission of muktabodha indological research institute in writing data entered by the staff of muktabodha under the direction of mark s g dyczkowskicatalog number  /
MBjanmamaranavicaaraHK-2	Uniform title: janmamaṛanavicāra	uniform title 
MBjanmamaranavicaaraHK-3	Author : vāmadeva	authoḥ vāmadeva 
MBjanmamaranavicaaraHK-4	Editor : śāstrī m r	e t itoḥ śāstrī m 
MBjanmamaranavicaaraHK-5	Description: Photographed from volume 19 of the Kashmir Series of Texts and Studies.	description photographed from volume of the kashmir series of texts and studies 
MBjanmamaranavicaaraHK-6	Publisher : Research Department Jammu and Kashmir State	publisher research depatment jammu and kashmir state 
MBjanmamaranavicaaraHK-7	Publication year : 1918	publication year 
MBjanmamaranavicaaraHK-8	Publication city : Srinagar	publication citi srinagar 
MBjanmamaranavicaaraHK-9	Publication country : India	publication country india 
MBjanmamaranavicaaraHK-10	oṃ	om 
MBjanmamaranavicaaraHK-11	tatsatsaṃvidvapuṣe amṛteśvarāya namaḥ |	tad sat saṃvid vapuṣe amṛta īśvarāya namaḥ 
MBjanmamaranavicaaraHK-12	atheyaṃ	atha iyam 
MBjanmamaranavicaaraHK-13	janmamaraṇavicāragranthasya	janma maraṇa vicāra granthasya 
MBjanmamaranavicaaraHK-14	bhūmikā	bhūmikā 
MBjanmamaranavicaaraHK-15	(granthāṅkaḥ 19)	grantha aṅkaḥ 
MBjanmamaranavicaaraHK-16	ayaṃ granthaḥ śaivāgamagrantheṣu	ayam granthaḥ śaiva āgama grantheṣu 
MBjanmamaranavicaaraHK-17	mukhyaviṣayasvātmādvaitajñānapaddhatisārasaṃkṣepatayā	                     
MBjanmamaranavicaaraHK-18	śrībhaṭṭavāmadevākhyamahāmāheśvarācāryavareṇa viracitaḥ |	śrī bhaṭṭa vāmadeva ākhya mahā māheśvara ācārya vareṇa viracitaḥ 
MBjanmamaranavicaaraHK-19	śībhaṭṭavāmadevaśca	śībhaṭṭa vāmadevaḥ ca 
MBjanmamaranavicaaraHK-20	śrīyogīśvarāparaparyāyayogarājācāryasya śiṣyo'bhūt |	śrī yogīśvara apara paryāya yogarāja ācāryasya 
MBjanmamaranavicaaraHK-21	śrīyogarājaḥ	        
MBjanmamaranavicaaraHK-22	śrīmadabhinavaguptācāryaśiṣya-śrīkṣemarājācāryasya śiṣyaḥ	śrīmat abhinavagupta ācārya śiṣya śrī kṣemarāja ācāryasya śiṣyaḥ 
MBjanmamaranavicaaraHK-23	śrīmadabhinavaguptācāryaviracitaśaivāgamaviśeṣaparamārthasārag	śrīmat abhinavagupta ācārya viracita śaiva āgama viśeṣa parama artha sāra g
MBjanmamaranavicaaraHK-24	ranthaṭīkākṛta tadante svaguruṇāmabhikhyānādikaṃ nirdiṣṭavān	rantha ṭīkā kṛta tad ante sva guruṇām abhikhyāna ādikam nirdiṣṭavān 
MBjanmamaranavicaaraHK-25	tasmātsākṣāttayāsya granthasya viracanakālānāmnāye'pi	tasmāt sākṣāt tayā asya granthasya viracana kāla anāmnāye pi 
MBjanmamaranavicaaraHK-26	śrīmadabhinavaguptācāryāṇāṃ	śrīmat abhinavagupta ācāryāṇām 
MBjanmamaranavicaaraHK-27	kaliyugadvācatvāriṃśaśatyāntaḥ kālamabhivyāpya loke	kali yuga dvācatvāriṃśa śatyā antar kālam abhivyāpya loke 
MBjanmamaranavicaaraHK-28	sthitisattayā tacchiṣya-kṣemarājasyottarasamakālikatve'pi	sthiti sattayā tad śiṣya kṣemarājasya uttara sama kālika tve pi 
MBjanmamaranavicaaraHK-29	tacchiṣya-yogarāja-tacchiṣyaitadgranthakartṝṇāṃ	tad śiṣya yogarāja tad śiṣya etad grantha kartṝṇām 
MBjanmamaranavicaaraHK-30	viṃśativiṃśatiprāyābdottarakālagaṇanayā tathā	viṃśati viṃśati prāya abda uttara kāla gaṇanayā tathā 
MBjanmamaranavicaaraHK-31	anantadevarājasya kāśmīrasaurājyakāle	ananta devarājasya kāśmīra saurājya kāle 
MBjanmamaranavicaaraHK-32	vāmadevācāryasthitijanaśrutyā ca anumito	vāmadeva ācārya sthiti jana śrutyā ca anumitaḥ 
MBjanmamaranavicaaraHK-33	dvācatvāriṃśaśatyāntyabhāgavartī etadgranthakṛtsaṃbhavakālaḥ	dvācatvāriṃśa śatyā antya bhāga vartī etad granthakṛt saṃbhava kālaḥ 
MBjanmamaranavicaaraHK-34	saṃbhāvyate |	saṃbhāvyate 
MBjanmamaranavicaaraHK-35	atastadanusāryeva (kaliyugadvācatvāriṃśaśatyāntyabhāgakālaḥ)	atas tad anusārī eva kali yuga dvācatvāriṃśa śatyā antya bhāga kālaḥ 
MBjanmamaranavicaaraHK-36	etadgranthaviracanakālaḥ |	etad grantha viracana kālaḥ 
MBjanmamaranavicaaraHK-37	p. 2)	p 
MBjanmamaranavicaaraHK-38	asya granthasya mūlādarśapustakamekamātramevopalakṣyate,	asya granthasya mūla ādarśa pustakam eka mātram eva upalakṣyate 
MBjanmamaranavicaaraHK-39	atiprayatnavidhānenāpi kutaścanāpyanyannāvāpi |	ati prayatna vidhānena api kutaścana api anyat na avāpi 
MBjanmamaranavicaaraHK-40	tadetadekamapi tantrasāragranthabhūmikāyāṃ varṇitatadvṛttasya	tat etat ekam api tantrasāra grantha bhūmikāyām varṇita tad vṛttasya 
MBjanmamaranavicaaraHK-41	āgarāpradeśādavāptapratnataraśāradākṣarāṅkitakāśmīrikapustaka-	āgarā pradeśāt avāpta pratnatara śārada akṣara aṅkita kāśmīrika pustaka 
MBjanmamaranavicaaraHK-42	amudāyasya madhyata uktatantrasāragranthasamaikabandheṣu	am udāyasya madhyatas ukta tantra sāra grantha sama eka bandheṣu 
MBjanmamaranavicaaraHK-43	pustakeṣvekatamaṃ paṇḍitakṛṣṇasvāmināmnā	pustakeṣu ekatamam paṇḍita kṛṣṇasvāmi nāmnā 
MBjanmamaranavicaaraHK-44	kāśmīrikavidvadviśeṣeṇa 4603 samīpavartilaukikasaṃvatsare	kāśmīrika vidvas viśeṣeṇa samīpa varti laukika saṃvatsare 
MBjanmamaranavicaaraHK-45	likhitaṃ samasti iti ||	likhitam samasti iti 
MBjanmamaranavicaaraHK-46	asti cākṛtyā laghāvapyasmingranthe	asti ca ākṛtyā laghau api asmin granthe 
MBjanmamaranavicaaraHK-47	śrīsvacchandatantra-tantrālokādivistīrṇaśaivāgamagrantheṣu	śrī svacchandatantra tantrāloka ādi vistīrṇa śaiva āgama grantheṣu 
MBjanmamaranavicaaraHK-48	yathāyathaṃ vitatya nirṇītānāṃ	yathāyatham vitatya nirṇītānām 
MBjanmamaranavicaaraHK-49	mukhyaviṣayasvātmādvaitajñānasaṃsādhakapaddhatīnāṃ	mukhya viṣaya sva ātma advaita jñāna saṃsādhaka paddhatīnām 
MBjanmamaranavicaaraHK-50	yathopayogaṃ bhinnatayā sthāne sthāne pratipāditānāṃ	yathopayogam bhinna tayā sthāne sthāne pratipāditānām 
MBjanmamaranavicaaraHK-51	samagraviṣayāṇāṃ pūrṇopajñānasyaikatrasaṃgṛhya	samagra viṣayāṇām pūrṇa upajñānasya ekatra saṃgṛhya 
MBjanmamaranavicaaraHK-52	sugamasaṃkṣiptamārgapradarśanam |	sugama saṃkṣipta mārga pradarśanam 
MBjanmamaranavicaaraHK-53	tadyathā -	tat yathā 
MBjanmamaranavicaaraHK-54	(1) prathamataḥ saṃvidātmanaḥ paramaśivasya	prathamatas saṃvid ātmanaḥ paramaśivasya 
MBjanmamaranavicaaraHK-55	svātantryodbhāvitanikhilajagadātmatve'pi	svātantrya udbhāvita nikhila jagat ātma tve pi 
MBjanmamaranavicaaraHK-56	sarvottīrṇatādyotiniratiśayasvātantryādiśaktimattayā	                                    
MBjanmamaranavicaaraHK-57	prakāśasvarūpatāpratipādanam |	          
MBjanmamaranavicaaraHK-58	(2) cidānandecchājñānakriyākhyānāṃ	                    
MBjanmamaranavicaaraHK-59	paramaśivasaṃbandhipañcaśaktīnāṃ svarūpānuśāsanam |	          
MBjanmamaranavicaaraHK-60	(3) viśvaṃ sisṛkṣoḥ prakāśātmaparamaśivasya tasya svātmanaḥ	viśvam sisṛkṣoḥ prakāśa ātma paramaśivasya tasya svātmanaḥ 
MBjanmamaranavicaaraHK-61	saṃkucitarūpāvabibhāsayiṣayā aṇutvarūpāvasthānanirṇayaḥ |	                  
MBjanmamaranavicaaraHK-62	(4) uktāṇutāvasthāpattau ca deśakālādyupādhivirahitatayā	ukta aṇu tā avasthā āpattau ca deśa kāla ādi upādhi virahita tayā 
MBjanmamaranavicaaraHK-63	anuttarānandaparispandātmakasya bhagavato na kāpi kṣatiḥ pratyuta	anuttara ānanda parispanda ātmakasya bhagavataḥ na kā api kṣatiḥ pratyuta 
MBjanmamaranavicaaraHK-64	paramamahimnaḥ puṣṭiḥ - ityetatpratipādanam |	parama mahimnaḥ puṣṭiḥ iti etat pratipādanam 
MBjanmamaranavicaaraHK-65	p. 3)	p 
MBjanmamaranavicaaraHK-66	(5) tasyaiva dharāditattvānubandhinyāḥ	tasya eva dharā ādi tattva anubandhinyāḥ 
MBjanmamaranavicaaraHK-67	vijñānākalapralayākalasakalātmakatāyāḥ samāpattinirdeśaḥ |	vijñānākala pralayākala sakala ātmaka tāyāḥ samāpatti nirdeśaḥ 
MBjanmamaranavicaaraHK-68	(6) aṇoḥ svasvarūpācchādakasya	aṇoḥ sva svarūpa ācchādakasya 
MBjanmamaranavicaaraHK-69	māyākalāvidyārāgakālaniyatirūpakañcukaṣaṭkasya tatkarmaṇaśca	māyā kalā vidyā rāga kāla niyati rūpa kañcuka ṣaṭkasya tad karmaṇaḥ ca 
MBjanmamaranavicaaraHK-70	pratipādanam |	pratipādanam 
MBjanmamaranavicaaraHK-71	bhuvanatattvakalākhyaprameyatrayapadamantravarṇākhyapramāṇatrayasaṃkalita-	                                                           
MBjanmamaranavicaaraHK-72	ṣaḍadhvayogino nivṛttipratiṣṭhāvidyāśāntā	            
MBjanmamaranavicaaraHK-73	śāntyatītākhyasya pārameśaśakti (kalā) pañcakasya	śāntyatīta ākhyasya pārameśa śakti kalā pañcakasya 
MBjanmamaranavicaaraHK-74	tadadhiṣṭhānādeśca nirdeśanam |	tad adhiṣṭhāna ādeḥ ca nirdeśanam 
MBjanmamaranavicaaraHK-75	(8) anantaraṃ ca āṇavāvasthāmāśritasya bhagavato	anantaram ca āṇava avasthām āśritasya bhagavataḥ 
MBjanmamaranavicaaraHK-76	vicitrajātyāyurbhogaiḥ	vicitra jāti āyuḥ bhogaiḥ 
MBjanmamaranavicaaraHK-77	jarāyujāṇḍajodbhedajasvedajādijantujātaṃ prādurbhāvayataḥ	jarāyu ja aṇḍa ja udbheda ja sveda ja ādi jantu jātam prādurbhāvayataḥ 
MBjanmamaranavicaaraHK-78	upabhuktānnapānapākavaśādrasarūpāvasthitaraktamāṃsamedo'sthi-	upabhukta anna pāna pāka vaśāt rasa rūpa avasthita rakta māṃsa medaḥ sthi 
MBjanmamaranavicaaraHK-79	majjātmanā śukradhātau viśrāntipradarśanottaraṃ	               
MBjanmamaranavicaaraHK-80	strīpuṃsādirūpatayodbhavanmanuṣyapaśupakṣitarudaṃśādiśarīra-	strīpuṃsa ādi rūpatayā udbhavat manuṣya paśu pakṣi taru daṃśa ādi śarīra 
MBjanmamaranavicaaraHK-81	saṃbandhyanurūpanāḍyādyaṅgapratyaṅgasaṃdhitatsaṃkhyānottarottara-	saṃbandhi anurūpa nāḍī ādi aṅga pratyaṅga saṃdhi tad saṃkhyāna uttarottara 
MBjanmamaranavicaaraHK-82	tadupacayagarbhasthitijanmatadanuvartibālyādyavasthānatadanubhūyamāna-	tad upacaya garbha sthiti janma tad anuvarti bālya ādi avasthāna tad anubhūyamāna 
MBjanmamaranavicaaraHK-83	harṣaśokādinirṇayamanu	harṣa śoka ādi nirṇayam anu 
MBjanmamaranavicaaraHK-84	punarjanmasadasatkarmodarkasadasallokāvāptisamanuśāsanapūrvakaṃ	                        
MBjanmamaranavicaaraHK-85	svātmasvarūpāvāptyupāyajñānamārgaprakāśanaṃ saṃgṛhya	sva ātma svarūpa avāpti upāya jñāna mārga prakāśanam saṃgṛhya 
MBjanmamaranavicaaraHK-86	pratipāditaṃ samasti |	pratipāditam samasti 
MBjanmamaranavicaaraHK-87	tadetasya pustakasya saṃgrahaṇottaraṃ samādhānena	tat etasya pustakasya saṃgrahaṇa uttaram samādhānena 
MBjanmamaranavicaaraHK-88	vimarśanābhyāsāt tattvajñānaphalarasāsvādamadhigacchantu	vimarśana abhyāsāt tattva jñāna phala rasa āsvādam adhigacchantu 
MBjanmamaranavicaaraHK-89	sahṛdayāḥ sadvidvāṃsaḥ saphalayantu	sahṛdayāḥ sat vidvāṃsaḥ saphalayantu 
MBjanmamaranavicaaraHK-90	caitatsaṃskaraṇottaraprakāśanaprayatnaḥ māmakīnamityāśāse |	ca etad saṃskaraṇa uttara prakāśana prayatnaḥ māmakīnam iti āśāse 
MBjanmamaranavicaaraHK-91	iti nivedakaḥ ma0 ma0 paṃ0 mukundarāma śāstrī	iti nivedakaḥ ma ma paṃ mukundarāma śāstrī 
MBjanmamaranavicaaraHK-92	oṃ namaḥ śivāyāmṛtavapuṣe |	om namaḥ śivāya amṛta vapuṣe 
MBjanmamaranavicaaraHK-93	atha	atha 
MBjanmamaranavicaaraHK-94	janmamaraṇavicāragranthaḥ |	        
MBjanmamaranavicaaraHK-95	śrīmadbhaṭṭavāmadevācāryaviracitaḥ |	śrīmat bhaṭṭa vāmadeva ācārya viracitaḥ 
MBjanmamaranavicaaraHK-96	sāndrodrekakṣubhitamabhitaḥ svāntamantarniyamya prāyo dhatte	sāndra udreka kṣubhitam abhitas svāntam antar niyamya prāyas dhatte 
MBjanmamaranavicaaraHK-97	navanavarasollekhamānandakandam | bhūyo bhūyaḥ	                  
MBjanmamaranavicaaraHK-98	pralayavibhavoddāmaduḥkhāntarāyo yo'sāvantarjayati hṛdaye ko'pi	pralaya vibhava uddāma duḥkha antarāyaḥ yaḥ sau antar jayati hṛdaye kaḥ api 
MBjanmamaranavicaaraHK-99	saṃvidvikāsaḥ || 1 ||	       
MBjanmamaranavicaaraHK-100	iha khalu nikhilajagadātmā sarvottīrṇaśca sarvamayaśca	iha khalu nikhila jagat ātmā sarva uttīrṇaḥ ca sarva mayaḥ ca 
MBjanmamaranavicaaraHK-101	vikalpāsaṃkucitasaṃvitprakāśarūpaḥ	              
MBjanmamaranavicaaraHK-102	anavacchinnacidānandaviśrāntaḥ	                 
MBjanmamaranavicaaraHK-103	prasaradaviralavicitrapañcavāhavāhavāhinīmahodadhiḥ	                 
MBjanmamaranavicaaraHK-104	niratiśayasvātantryasīmani pragalbhamānaḥ sarvaśaktikhacita eka	niratiśaya svātantrya sīmani pragalbhamānaḥ sarva śakti khacitaḥ eka 
MBjanmamaranavicaaraHK-105	eva asti saṃvidātmā maheśvaraḥ | tasya prakāśarūpatā	eva asti saṃvid ātmā maheśvaraḥ tasya prakāśa rūpa tā 
MBjanmamaranavicaaraHK-106	cicchaktiḥ svātantryam ānandaśaktiḥ taccamatkāraḥ icchāśaktiḥ	                
MBjanmamaranavicaaraHK-107	āmarśātmakatā jñānaśaktiḥ sarvākārayogitvaṃ kriyāśaktiḥ	             
MBjanmamaranavicaaraHK-108	iti |	iti 
MBjanmamaranavicaaraHK-109	p. 2)	p 
MBjanmamaranavicaaraHK-110	itthaṃ sarvaśaktiyoge'pi ābhirmukhyābhiḥ śaktibhirupacaryate sa	ittham sarva śakti yoge api ābhiḥ mukhyābhiḥ śaktibhiḥ upacaryate sa 
MBjanmamaranavicaaraHK-111	ca bhagavān svātantryaśaktimahimnā svātmānaṃ saṃkucitamiva	ca bhagavān svātantrya śakti mahimnā sva ātmānam saṃkucitam iva 
MBjanmamaranavicaaraHK-112	ābhāsayan aṇuḥ iti ucyate | yathoktam -	ābhāsayan aṇuḥ iti ucyate yathoktam 
MBjanmamaranavicaaraHK-113	vyāpako hi śivaḥ svecchākḷptasaṃkocamudraṇāt |	vyāpakaḥ hi śivaḥ sva icchā kḷpta saṃkoca mudraṇāt 
MBjanmamaranavicaaraHK-114	vicitraphalakarmaughavaśāttattaccharīrabhāk ||	vicitra phala karma ogha vaśāt tad tad śarīra bhāj 
MBjanmamaranavicaaraHK-115	iti nijasvarūpagopanakelilolam evaṃ māheśaśaktiparispandaṃ	iti nija svarūpa gopana keli lolam evam māheśa śakti parispandam 
MBjanmamaranavicaaraHK-116	pravaraguravaḥ pratipedire | tathā ca āhuḥ -	pravara guravaḥ pratipedire tathā ca āhuḥ 
MBjanmamaranavicaaraHK-117	atidurghaṭakāaritvātsvācchandyānnirmalādasau |	ati durghaṭaka ari tvāt svācchandyāt nirmalāt asau 
MBjanmamaranavicaaraHK-118	svātmapracchādanakrīḍāpaṇḍitaḥ parameśvaraḥ ||	             
MBjanmamaranavicaaraHK-119	anāvṛte svarūpe'pi yadātmācchādanaṃ vibhoḥ | saivāvidyā yato	anāvṛte svarūpe api yat ātma ācchādanam vibhoḥ sā eva avidyā yatas 
MBjanmamaranavicaaraHK-120	bheda etāvānviśvavṛttikaḥ ||	bhedaḥ etāvān viśvavṛttikaḥ 
MBjanmamaranavicaaraHK-121	iti | na ca etāvatā bhagavato	iti na ca etāvatā bhagavato 
MBjanmamaranavicaaraHK-122	deśakālākāropādhivirahitaniratiśayānandaparispandātmakasya	deśa kāla ākāra upādhi virahita niratiśaya ānanda parispanda ātmakasya 
MBjanmamaranavicaaraHK-123	kācidapi kṣatiḥ pratyuta paramamahimnaḥ paripuṣṭirityuktam |	kācid api kṣatiḥ pratyuta parama mahimnaḥ paripuṣṭiḥ iti uktam 
MBjanmamaranavicaaraHK-124	asthāsyadekarūpeṇa vapuṣā cenmaheśvaraḥ | maheśvaratvaṃ	asthāsyat eka rūpeṇa vapuṣā ced maheśvaraḥ maheśvara tvam 
MBjanmamaranavicaaraHK-125	saṃvittvaṃ tadatyakṣyadghaṭādivat ||	saṃvid tvam tat atyakṣyat ghaṭa ādi vat 
MBjanmamaranavicaaraHK-126	p. 3)	p 
MBjanmamaranavicaaraHK-127	paricchinnaprakāśatvaṃ jaḍasya kila lakṣaṇam |	paricchinna prakāśa tvam jaḍasya kila lakṣaṇam 
MBjanmamaranavicaaraHK-128	jaḍādvilakṣaṇobodho yato na parimīyate ||	jaḍāt vilakṣaṇaḥ bodhaḥ yatas na parimīyate 
MBjanmamaranavicaaraHK-129	tena bodhamahāsindhorullāsinyaḥ svaśaktayaḥ | āśrayantyūrmaya	tena bodha mahā sindhoḥ ullāsinyaḥ sva śaktayaḥ āśrayanti ūrmayaḥ 
MBjanmamaranavicaaraHK-130	iva svātmasaṃghaṭṭacitratām ||	iva sva ātma saṃghaṭṭa citra tām 
MBjanmamaranavicaaraHK-131	ityādi | tadevam asau bhagavān svamāyāśaktyākhyena	ityādi tat evam asau bhagavān sva māyā śakti ākhyena 
MBjanmamaranavicaaraHK-132	avyabhicaritasvātantryaśaktimahimnā svātmanaiva ātmānaṃ	avyabhicarita svātantrya śakti mahimnā sva ātmanā eva ātmānam 
MBjanmamaranavicaaraHK-133	saṃkucitamiva avabhāsayan vijñānākalaḥ pralayākalaḥ sakalaśca	saṃkucitam iva avabhāsayan vijñānākalaḥ pralayākalaḥ sakalaḥ ca 
MBjanmamaranavicaaraHK-134	saṃpadyate | tatra āṇavena ekenaiva malena saṃyukto vijñānākala	saṃpadyate tatra āṇavena ekena eva malena saṃyuktaḥ vijñānākala 
MBjanmamaranavicaaraHK-135	ucyate dvābhyām āṇavamāyīyābhyām apavedyaḥ pralayākalaḥ	ucyate dvābhyām āṇava māyīyābhyām apavedyaḥ pralayākalaḥ 
MBjanmamaranavicaaraHK-136	tribhirāṇavamāyīyakārmaiḥ saṃvedyaḥ taireva	tribhiḥ āṇava māyīya kārmaiḥ saṃvedyaḥ taiḥ eva 
MBjanmamaranavicaaraHK-137	kalādidharaṇyantatattvamayaḥ sakalaḥ tadarthameva ayamarthasargaḥ |	kalā ādi dharaṇī anta tattva mayaḥ sakalaḥ tad artham eva ayam artha sargaḥ 
MBjanmamaranavicaaraHK-138	tatra sṛṣṭyunmukho bhagavān śuddhādhvani vartamānaḥ	tatra sṛṣṭi unmukhaḥ bhagavān śuddhādhvani vartamānaḥ 
MBjanmamaranavicaaraHK-139	svaśaktibhiḥ māyāṃ vikṣobhya kalātattvaṃ	sva śaktibhiḥ māyām vikṣobhya kalā tattvam 
MBjanmamaranavicaaraHK-140	kiṃcitkartṛtvalakṣaṇaṃ pudgalasya sṛjati tato'pi	kiṃcitkartṛtva lakṣaṇam pudgalasya sṛjati tatas api 
MBjanmamaranavicaaraHK-141	kiṃcidavabodhākhyaṃ vidyātattvaṃ kiṃcidabhilāṣarūpaṃ ca	kiṃcid avabodha ākhyam vidyā tattvam kiṃcid abhilāṣa rūpam ca 
MBjanmamaranavicaaraHK-142	rāgatattvaṃ tadetatsarāgaṃ kartṛtattvaṃ	rāga tattvam tat etat sa rāgam kartṛ tattvam 
MBjanmamaranavicaaraHK-143	bhūtabhaviṣyadvartamānatayā tridhā avacchidyate tat kālatattvaṃ	bhūta bhaviṣyat vartamāna tayā tridhā avacchidyate tat kāla tattvam 
MBjanmamaranavicaaraHK-144	tulyatve'pi rāge yena kartṛtvasya	tulya tve api rāge yena kartṛ tvasya 
MBjanmamaranavicaaraHK-145	p. 4)	p 
MBjanmamaranavicaaraHK-146	avacchedaḥ kriyate tat niyatitattvaṃ tadetat kañcukaṣaṭkam	avacchedaḥ kriyate tat niyati tattvam tat etat kañcuka ṣaṭkam 
MBjanmamaranavicaaraHK-147	antarmalāvṛtasya pudgalasya bahirācchādakam uktaṃ ca	antar mala āvṛtasya pudgalasya bahis ācchādakam uktam ca 
MBjanmamaranavicaaraHK-148	cillācakreśvaramate	          
MBjanmamaranavicaaraHK-149	māyā kalā śuddhavidyā rāgakalau niyantraṇā |	māyā kalā śuddhavidyā rāga kalau niyantraṇā 
MBjanmamaranavicaaraHK-150	ṣaḍetānyāvṛtivaśātkañcukāni mitātmanaḥ ||	ṣaḍ etāni āvṛti vaśāt kañcukāni mita ātmanaḥ 
MBjanmamaranavicaaraHK-151	evaṃ ca pudgalasyāntarmalaḥ kañcukavatsthitaḥ | tuṣavatkañcukāni	evam ca pudgalasya antar malaḥ kañcuka vat sthitaḥ tuṣa vat kañcukāni 
MBjanmamaranavicaaraHK-152	syustasmājjñānakriyojjhitaḥ ||	syuḥ tasmāt jñāna kriyā ujjhitaḥ 
MBjanmamaranavicaaraHK-153	iti | sā ca kalā puruṣasya parimitaṃ kartṛtvaṃ prakāśya	iti sā ca kalā puruṣasya parimitam kartṛ tvam prakāśya 
MBjanmamaranavicaaraHK-154	sukhaduḥkhamoharūpaṃ bhogyam avyaktatvaṃ sṛjati tato'pi	sukha duḥkha moha rūpam bhogyam avyakta tvam sṛjati tatas api 
MBjanmamaranavicaaraHK-155	aṣṭaguṇaṃ buddhitattvam utpannaṃ tato'pi	aṣṭaguṇam buddhi tattvam utpannam tatas api 
MBjanmamaranavicaaraHK-156	sāttvikarājasatāmasabhedabhinnaṃ triskandham ahaṃkāratattvam tatra	sāttvika rājasa tāmasa bheda bhinnam tri skandham ahaṃkāra tattvam tatra 
MBjanmamaranavicaaraHK-157	pūrvasmāt ahaṃkārāt mano jātaṃ aparasmāt indriyāṇi tṛtīyāt	pūrvasmāt ahaṃkārāt manaḥ jātam aparasmāt indriyāṇi tṛtīyāt 
MBjanmamaranavicaaraHK-158	tanmātrāṇi ebhyo bhūtāni - ityevamayam ekasyaiva ādidevasya	tanmātrāṇi ebhyaḥ bhūtāni iti evam ayam ekasya eva ādidevasya 
MBjanmamaranavicaaraHK-159	svātantryamahimnā saṃsāre saṃsarataḥ parimitapramātṛtām	svātantrya mahimnā saṃsāre saṃsarataḥ parimita pramātṛ tām 
MBjanmamaranavicaaraHK-160	avalambamānasya tattvaprasaraḥ uktaṃ ca -	avalambamānasya tattva prasaraḥ uktam ca 
MBjanmamaranavicaaraHK-161	bhūtāni tanmātragaṇendriyāṇi mūlaṃ pumānkañcukayuksuśuddham |	bhūtāni tanmātra gaṇa indriyāṇi mūlam pumān kañcuka yuj su śuddham 
MBjanmamaranavicaaraHK-162	vidyādiśaktyantamiyānsvasaṃvit- sindhostaraṅgaprasaraprapañcaḥ ||	vidyā ādi śakti antam iyān sva saṃvid sindhoḥ taraṅga prasara prapañcaḥ 
MBjanmamaranavicaaraHK-163	p. 5)	p 
MBjanmamaranavicaaraHK-164	tathā -	tathā 
MBjanmamaranavicaaraHK-165	sāla utta puripuṇṇa u sa-alla-utta uttiṇṇa | pari āṇaha attāṇa	sāla utta puripuṇṇa u saallautta uttiṇṇa pari āṇaha attāṇa 
MBjanmamaranavicaaraHK-166	u pari masiveṇa samāṇa u ||	u pari masiveṇa samāṇaḥ u 
MBjanmamaranavicaaraHK-167	iti | eteṣāṃ ca uktarūpāṇāṃ tattvānāṃ pramātṛbhede	iti eteṣām ca ukta rūpāṇām tattvānām pramātṛ bhede 
MBjanmamaranavicaaraHK-168	vaicitryāt prameyavaicitryaṃ bhavati iti śrīpūrvaśāstre kathitam	vaicitryāt prameya vaicitryam bhavati iti śrī pūrvaśāstre kathitam 
MBjanmamaranavicaaraHK-169	tathāhi -	tathā hi 
MBjanmamaranavicaaraHK-170	śaktimacchaktibhedena dharātattvaṃ vibhidyate | svarūpasahitaṃ	                                   
MBjanmamaranavicaaraHK-171	tacca vijñeyaṃ daśapañcadhā ||	tat ca vijñeyam daśa pañcadhā 
MBjanmamaranavicaaraHK-172	anenaiva vidhānena puṃstattvāttu kalāntikam | trayodaśavidhaṃ	anena eva vidhānena puṃs tattvāt tu kalā antikam trayodaśavidham 
MBjanmamaranavicaaraHK-173	jñeyaṃ rudravatpralayākalaḥ ||	jñeyam rudra vat pralayākalaḥ 
MBjanmamaranavicaaraHK-174	tadvanmāyāpi vijñeyā navadhā jñānakevalaḥ | mantrāḥ	tadvat māyā api vijñeyā navadhā jñāna kevalaḥ mantrāḥ 
MBjanmamaranavicaaraHK-175	saptavidhāstadvatpañcadhā mantranāyakāḥ ||	saptavidhāḥ tadvat pañcadhā mantranāyakāḥ 
MBjanmamaranavicaaraHK-176	tridhā mantreśvareśānāḥ śivaḥ sākṣānna bhidyate | yaḥ punaḥ	tridhā mantreśvara īśānāḥ śivaḥ sākṣāt na bhidyate yaḥ punar 
MBjanmamaranavicaaraHK-177	sarvatattvāni vettyetāni yathārthataḥ ||	sarva tattvāni vetti etāni yathārthataḥ 
MBjanmamaranavicaaraHK-178	sa gururmatsamaḥ prokto mantravīryaprakāśakaḥ | dṛṣṭāḥ	sa guruḥ mad samaḥ proktaḥ mantra vīrya prakāśakaḥ dṛṣṭāḥ 
MBjanmamaranavicaaraHK-179	saṃbhāṣitāstena spṛṣṭāśca prītacetasā ||	saṃbhāṣitāḥ tena spṛṣṭāḥ ca prīta cetasā 
MBjanmamaranavicaaraHK-180	narāḥ pāpaiḥ pramucyante saptajanmakṛtairapi |	narāḥ pāpaiḥ pramucyante sapta janma kṛtaiḥ api 
MBjanmamaranavicaaraHK-181	iti | tadevam anekāvasāyo'yaṃ tattvakramaḥ | eteṣāṃ ca	iti tat evam aneka avasāyaḥ yam tattva kramaḥ eteṣām ca 
MBjanmamaranavicaaraHK-182	tattvānāṃ vargaśo yadanugāmi rūpam -	tattvānām vargaśas yat anugāmi rūpam 
MBjanmamaranavicaaraHK-183	p. 6)	p 
MBjanmamaranavicaaraHK-184	ekarūpam - ekarūpakalanāsahiṣṇutvāt sā kalā kathyate | tathā hi	eka rūpam eka rūpa kalanā sahiṣṇu tvāt sā kalā kathyate tathā hi 
MBjanmamaranavicaaraHK-185	nivartante yatastattvavargāḥ sā nivṛttirnāma kalā |	nivartante yatas tattva vargāḥ sā nivṛttiḥ nāma kalā 
MBjanmamaranavicaaraHK-186	sā ca pṛthivyāmeva vyavasthitā |	sā ca pṛthivyām eva vyavasthitā 
MBjanmamaranavicaaraHK-187	kāraṇatve pūraṇāpyāyakāritvāt pratiṣṭhā nāma kalā ucyate |	kāraṇa tve pūraṇa āpyāya kāri tvāt pratiṣṭhā nāma kalā ucyate 
MBjanmamaranavicaaraHK-188	sā ca jalādimūlāntaṃ vyāpya vyavasthitā |	sā ca jala ādi mūla antam vyāpya vyavasthitā 
MBjanmamaranavicaaraHK-189	vedyavilaye saṃvidādhikyāt vidyā nāma kalā |	                 
MBjanmamaranavicaaraHK-190	sā ca pumādimāyāntam adhvānam adhyāste |	sā ca pum ādi māyā antam adhvānam adhyāste 
MBjanmamaranavicaaraHK-191	kañcukataraṅgopaśamāt śāntā nāma kalā ucyate |	kañcuka taraṅga upaśamāt śāntā nāma kalā ucyate 
MBjanmamaranavicaaraHK-192	sā ca śuddhavidyādiśaktyante sthitā iti | etadeva	sā ca śuddhavidyā ādi śakti ante sthitā iti etat eva 
MBjanmamaranavicaaraHK-193	aṇḍacatuṣṭayaṃ pārthivaprākṛtamāyīyaśāktalakṣaṇam |	aṇḍa catuṣṭayam pārthiva prākṛta māyīya śākta lakṣaṇam 
MBjanmamaranavicaaraHK-194	sarvātītatvāt śivatattve śāntyatītā |	sarva atīta tvāt śivatattve śānti atītā 
MBjanmamaranavicaaraHK-195	iti | paraṃ tu tattvaṃ svatantratvāt kalātītam āsāmeva kalānāṃ	iti param tu tattvam svatantra tvāt kalā atītam āsām eva kalānām 
MBjanmamaranavicaaraHK-196	tattvavadantarbhūtāni bhuvanānyapi boddhavyāni evaṃ	tattva vat antarbhūtāni bhuvanāni api boddhavyāni evam 
MBjanmamaranavicaaraHK-197	sthūlasūkṣmaparatvena	sthūla sūkṣma para tvena 
MBjanmamaranavicaaraHK-198	p. 7)	p 
MBjanmamaranavicaaraHK-199	bhuvanatattvakalārūpaṃ trividharūpaṃ prameyam uktam pramāṇamapi	bhuvana tattva kalā rūpam trividha rūpam prameyam uktam pramāṇam api 
MBjanmamaranavicaaraHK-200	tathaiva padamantravarṇatayā trividhameva - iti ekasyaiva	tathā eva pada mantra varṇa tayā trividham eva iti ekasya eva 
MBjanmamaranavicaaraHK-201	pūrṇapramātuḥ svātantryāt saṃsarataḥ ṣaḍvidhe adhvani	pūrṇa pramātuḥ svātantryāt saṃsarataḥ ṣaḍvidhe adhvani 
MBjanmamaranavicaaraHK-202	viśrāntiruktā | bhavanti cātra	viśrāntiḥ uktā bhavanti ca atra 
MBjanmamaranavicaaraHK-203	dīkṣāparighaṭanasaṃgrahaślokāḥ -	dīkṣā parighaṭana saṃgraha ślokāḥ 
MBjanmamaranavicaaraHK-204	padamantravarṇamekaṃ puraṣoḍaśakaṃ dhareti ca nivṛttiḥ |	pada mantra varṇam ekam pura ṣoḍaśakam dharā iti ca nivṛttiḥ 
MBjanmamaranavicaaraHK-205	tattvārṇamagninayanaṃ rasaśarapuramastramantrapadamanyā ||	tattva arṇam agni nayanam rasa śara puram astra mantra padam anyā 
MBjanmamaranavicaaraHK-206	munitattvārṇaṃ dvikapada- mantraṃ vasvakṣibhuvanamaparakalā |	muni tattva arṇam dvika pada mantram vasu akṣi bhuvanam apara kalā 
MBjanmamaranavicaaraHK-207	agnyarṇatattvamekaka- padamantraṃ saikabhuvanamiti turyā ||	agni arṇa tattvam ekaka pada mantram sa eka bhuvanam iti turyā 
MBjanmamaranavicaaraHK-208	ṣoḍaśa varṇāḥ padamantra- tattvamekaṃ ca śāntyatīteyam ||	ṣoḍaśa varṇāḥ pada mantra tattvam ekam ca śānti atītā iyam 
MBjanmamaranavicaaraHK-209	iti | tadevam āṇavīṃ vṛttim ālambya bhagavān vicitraiḥ	iti tat evam āṇavīm vṛttim ālambya bhagavān vicitraiḥ 
MBjanmamaranavicaaraHK-210	jātyāyurbhogaiḥ jarāyuja aṇḍaja udbhedaja svedajādijātaṃ	jāti āyuḥ bhogaiḥ jarāyu ja aṇḍa ja udbheda ja sveda ja ādi jātam 
MBjanmamaranavicaaraHK-211	prādurbhāvayati | tatra upabhuktasya annapānasya pākavaśāt	prādurbhāvayati tatra upabhuktasya anna pānasya pāka vaśāt 
MBjanmamaranavicaaraHK-212	rasarūpatayā sthitasya raktamāṃsamedo'sthimajjātmanā	rasa rūpa tayā sthitasya rakta māṃsa medaḥ sthi majja ātmanā 
MBjanmamaranavicaaraHK-213	śukradhātau viśrāntirbhavati taṃtra imāḥ prajāḥ prajāyante |	śukradhātau viśrāntiḥ bhavati taṃtre imāḥ prajāḥ prajāyante 
MBjanmamaranavicaaraHK-214	p. 8)	p 
MBjanmamaranavicaaraHK-215	tathā coktaṃ sauśrute -	tathā ca uktam sauśrute 
MBjanmamaranavicaaraHK-216	iha khalu pāñcabhautikasya caturvidhasya āhārasya ṣaḍrasopetasya	iha khalu pāñcabhautikasya caturvidhasya āhārasya ṣaṣ rasa upetasya 
MBjanmamaranavicaaraHK-217	dvividharasavīryasya aṣṭavidharasavīryasya anekaprakāropabhuktasya	dvividha rasa vīryasya aṣṭavidha rasa vīryasya aneka prakāra upabhuktasya 
MBjanmamaranavicaaraHK-218	pariṇatasya yastejorūpaḥ sāraḥ sūkṣmaḥ sa rasa ityucyate tasya	pariṇatasya yaḥ tejaḥ rūpaḥ sāraḥ sūkṣmaḥ sa rasaḥ iti ucyate tasya 
MBjanmamaranavicaaraHK-219	hṛdayaṃ sthānaṃ sa ca hṛdayāt caturviṃśatidhamanīranupraviśya	hṛdayam sthānam sa ca hṛdayāt caturviṃśati dhamanīḥ anupraviśya 
MBjanmamaranavicaaraHK-220	ūrdhvagā daśa daśa ca adhogāminīḥ catasraḥ tiryaggāḥ sakalaṃ	ūrdhvagāḥ daśa daśa ca adhogāminīḥ catasraḥ tiryaggāḥ sakalam 
MBjanmamaranavicaaraHK-221	śarīram aharahastarpayati jīvayati dhārayati vardhayati	śarīram aharahar tarpayati jīvayati dhārayati vardhayati 
MBjanmamaranavicaaraHK-222	adṛṣṭanimittena karmaṇā sa khalu āpyo raso yakṛtplīhādiṃ	adṛṣṭa nimittena karmaṇā sa khalu āpyaḥ rasaḥ yakṛt plīha ādim 
MBjanmamaranavicaaraHK-223	prāpya rāgamupaiti bhavanti vā atra ślokāḥ -	prāpya rāgam upaiti bhavanti vai atra ślokāḥ 
MBjanmamaranavicaaraHK-224	rañjitāstejasā tvāpaḥ śarīrasthena dehinām | avyāpannāḥ	rañjitāḥ tejasā tu āpaḥ śarīra sthena dehinām a vyāpannāḥ 
MBjanmamaranavicaaraHK-225	prasannena raktamityeva tadviduḥ ||	prasannena raktam iti eva tat viduḥ 
MBjanmamaranavicaaraHK-226	rasādeva striyo raktaṃ rajaḥsaṃjñaṃ pravartate |	rasāt eva striyaḥ raktam rajaḥ saṃjñam pravartate 
MBjanmamaranavicaaraHK-227	tadvaśāddvādaśādūrdhvaṃ yāti pañcāśatiḥ kṣitim ||	tad vaśāt dvādaśāt ūrdhvam yāti pañcāśatiḥ kṣitim 
MBjanmamaranavicaaraHK-228	ārtavaṃ śoṇitam āgneyam - agnīṣomīyatvāt garbhasya |	ārtavam śoṇitam āgneyam agnīṣomīya tvāt garbhasya 
MBjanmamaranavicaaraHK-229	rasādraktaṃ tato māṃsaṃ māṃsānmedaśca jāyate | medaso'sthi	rasāt raktam tatas māṃsam māṃsāt medaḥ ca jāyate medasaḥ usthi 
MBjanmamaranavicaaraHK-230	tato majjā majjātaḥ śukrasaṃbhavaḥ ||	tatas majjā majjātaḥ śukra saṃbhavaḥ 
MBjanmamaranavicaaraHK-231	evaṃ māṃsena śukratvaṃ raso yāti yathākramam | strīṇāṃ	evam māṃsena śukra tvam rasaḥ yāti yathākramam strīṇām 
MBjanmamaranavicaaraHK-232	tathaiva māsena bhavedārtavasaṃbhavaḥ ||	tathā eva māsena bhavet ārtava saṃbhavaḥ 
MBjanmamaranavicaaraHK-233	iti | tadevaṃ bhūte mātṛpitṛsaṃbandhasaṃbhūte agnīṣomātmake	iti tat evam bhūte mātṛ pitṛ saṃbandha saṃbhūte agnīṣoma ātmake 
MBjanmamaranavicaaraHK-234	raktaretasīi kusumasamayādanantaraṃ -	kusuma samayāt anantaram 
MBjanmamaranavicaaraHK-235	p. 9)	p 
MBjanmamaranavicaaraHK-236	jananījaṭhare retaḥ kalilībhavati tato budbudam tataḥ peśī tato	jananī jaṭhare retaḥ kalilībhavati tatas budbudam tatas peśī tatas 
MBjanmamaranavicaaraHK-237	ghanaḥ yāvadaṅgaparigrahaḥ aṅgavyaktiḥ saṃvidullāsaḥ	              
MBjanmamaranavicaaraHK-238	sarvāṅgasaṃpattirojaḥ saṃcāraḥ sukhaduḥkhasaṃvittiriti yāvat	sarva aṅga saṃpattiḥ ojaḥ saṃcāraḥ sukha duḥkha saṃvittiḥ iti yāvat 
MBjanmamaranavicaaraHK-239	prajāyate | uktaṃ śrīcillācakreśvaramate -	prajāyate                    
MBjanmamaranavicaaraHK-240	somasūryarasollāsaparasparanigharṣaṇāt | jātavedasi saṃjāte	soma sūrya rasa ullāsa paraspara nigharṣaṇāt jātavedasi saṃjāte 
MBjanmamaranavicaaraHK-241	madhyadhāmavikāsini ||	         
MBjanmamaranavicaaraHK-242	virāruṇaparīṇāmavaśādaṅkurasaṃbhavaḥ | ekarātroṣitaṃ retaḥ	virā aruṇa parīṇāma vaśāt aṅkura saṃbhavaḥ eka rātra uṣitam retaḥ 
MBjanmamaranavicaaraHK-243	siktaṃ kalilatāṃ vrajet ||	siktam kalila tām vrajet 
MBjanmamaranavicaaraHK-244	budbudaṃ saptarātreṇa peśī māsena jāyate | dvitīye māsi ca	budbudam sapta rātreṇa peśī māsena jāyate dvitīye māsi ca 
MBjanmamaranavicaaraHK-245	ghanastṛtīye'gniparigrahaḥ ||	ghanaḥ tṛtīya igni parigrahaḥ 
MBjanmamaranavicaaraHK-246	caturthe vyaṅgatāṅgānāṃ cetanā pañcame bhavet | ṣaṣṭhe	caturthe vyaṅga tā aṅgānām cetanā pañcame bhavet ṣaṣṭhe 
MBjanmamaranavicaaraHK-247	sarvāṅgasaṃbhedaḥ saptame calanodgamaḥ ||	sarva aṅga saṃbhedaḥ saptame calana udgamaḥ 
MBjanmamaranavicaaraHK-248	tejo'ṣṭame saṃcarati navame vedanaṃ bhavet | saṃpūrṇadeho	tejaḥ aṣṭame saṃcarati navame vedanam bhavet saṃpūrṇa dehaḥ 
MBjanmamaranavicaaraHK-249	daśame māsi jantuḥ prajāyate ||	daśame māsi jantuḥ prajāyate 
MBjanmamaranavicaaraHK-250	jāto'sau vāyunā spṛṣṭo yoniyantraprapīḍitaḥ | na	jātaḥ asau vāyunā spṛṣṭaḥ yoni yantra prapīḍitaḥ na 
MBjanmamaranavicaaraHK-251	smaratyugrasaṃtāpamanekabhavasaṃbhavam ||	smarati ugra saṃtāpam aneka bhava saṃbhavam 
MBjanmamaranavicaaraHK-252	krameṇa vṛddhimāyānti tasyaite dehahetavaḥ | rasaḥ sthitiṃ	krameṇa vṛddhim āyānti tasya ete deha hetavaḥ rasaḥ sthitim 
MBjanmamaranavicaaraHK-253	prakurute raktaṃ saṃjīvayatyalam ||	prakurute raktam saṃjīvayati alam 
MBjanmamaranavicaaraHK-254	māṃsaṃ vṛṃhayati prāyo medaḥ snehayati sphuṭam | dhārayanti	māṃsam vṛṃhayati prāyas medaḥ snehayati sphuṭam dhārayanti 
MBjanmamaranavicaaraHK-255	tathāsthīni majjāntaḥ sārasaṃśrayā ||	tathā asthīni majjā antar sāra saṃśrayā 
MBjanmamaranavicaaraHK-256	harṣotkarṣakaraṃ śukraṃ mūtraṃ kledavivekakṛt |	               
MBjanmamaranavicaaraHK-257	vāyvagnisaṃrodhakaraṃ purīṣaṃ parikīrtitam ||	vāyu agni saṃrodha karam purīṣam parikīrtitam 
MBjanmamaranavicaaraHK-258	p. 10)	p 
MBjanmamaranavicaaraHK-259	svedakledopakaraṇaṃ garbhaheturathārtavam | evaṃ śarīramāsādya	sveda kleda upakaraṇam garbha hetuḥ atha ārtavam evam śarīram āsādya 
MBjanmamaranavicaaraHK-260	ṣāṭkośaṃ tatparigrahāt ||	ṣāṭkośam tad parigrahāt 
MBjanmamaranavicaaraHK-261	anapekṣya nijaṃ bhāvaṃ pumānbhāvānapekṣate ||	an apekṣya nijam bhāvam pumān bhāvān apekṣate 
MBjanmamaranavicaaraHK-262	iti | ayameva ca artho niruktikṛtāpi -	iti ayam eva ca arthaḥ nirukti kṛtā api 
MBjanmamaranavicaaraHK-263	uktapārthivān aṣṭau guṇān vidyāt trīn mātṛtaḥ trīn pitṛtaḥ	ukta pārthivān aṣṭau guṇān vidyāt trīn mātṛtaḥ trīn pitṛtaḥ 
MBjanmamaranavicaaraHK-264	ityādyupakramya uktaḥ | atraiva idaṃ puṃstrīnapuṃsakalakṣaṇaṃ	ityādi upakramya uktaḥ atra eva idam pum strī napuṃsaka lakṣaṇam 
MBjanmamaranavicaaraHK-265	prakṛtitrayakāraṇam -	prakṛti traya kāraṇam 
MBjanmamaranavicaaraHK-266	somādhikyena puṃjanma sūryādhikyena yoṣitaḥ | sāmyātklībastu	soma ādhikyena pum janma sūrya ādhikyena yoṣitaḥ sāmyāt klībaḥ tu 
MBjanmamaranavicaaraHK-267	vātena bhedātsyādbahvapatyatā ||	vātena bhedāt syāt bahu apatya tā 
MBjanmamaranavicaaraHK-268	iti | avayavabhedo'pi -	iti 
MBjanmamaranavicaaraHK-269	navame daśame māsi prabalaiḥ sūtimarutaiḥ | niḥsāryate bāṇa iva	navame daśame māsi prabalaiḥ sūtimarutaiḥ niḥsāryate bāṇaḥ iva 
MBjanmamaranavicaaraHK-270	yantracchidreṇa sajvaraḥ ||	yantra chidreṇa sa jvaraḥ 
MBjanmamaranavicaaraHK-271	tasya ṣoḍhā śarīaṃ tatṣaṭ tvaco dhārayanti ca | asthnāṃ	tasya ṣoḍhā tat ṣaḍ tvacaḥ dhārayanti ca asthnām 
MBjanmamaranavicaaraHK-272	tathā ṣaṣṭyadhikaṃ vinibaddhaṃ śatatrayam ||	tathā ṣaṣṭi adhikam vinibaddham śata trayam 
MBjanmamaranavicaaraHK-273	sthūlaiḥ saha catuḥṣaṣṭirdaśanā viṃśatirnakhāḥ |	sthūlaiḥ saha catuḥṣaṣṭiḥ daśanāḥ viṃśatiḥ nakhāḥ 
MBjanmamaranavicaaraHK-274	pāṇipādaśalākāśca tāsāṃ sthāne catuṣṭayam ||	pāṇi pāda śalākāḥ ca tāsām sthāne catuṣṭayam 
MBjanmamaranavicaaraHK-275	ṣaṣṭyaṅgulīnāṃ dve pārṣṇī gulpheṣu ca catuṣṭayam |	ṣaṣṭi aṅgulīnām dve pārṣṇī gulpheṣu ca catuṣṭayam 
MBjanmamaranavicaaraHK-276	catvāryaratnikāsthīni jaṃghayostāvadeva tu | dve dve	catvāri aratnika asthīni jaṃghayoḥ tāvat eva tu dve dve 
MBjanmamaranavicaaraHK-277	jānukapoloruphalakāṃsasamudbhave | akṣisthalūṣake śroṇīphalake	jānu kapola ūru phalaka aṃsa samudbhave akṣi sthala ūṣake śroṇī phalake 
MBjanmamaranavicaaraHK-278	ca vinirdiśet ||	ca vinirdiśet 
MBjanmamaranavicaaraHK-279	bhagāsthyekaṃ tathā pṛṣṭhe catvāriṃśacca pañca ca | grīvā	bhagāsthi ekam tathā pṛṣṭhe catvāriṃśat ca pañca ca grīvā 
MBjanmamaranavicaaraHK-280	pañcadaśāsthīni jatrvekaṃ ca tathā hanuḥ ||	pañcadaśa asthīni jatru ekam ca tathā hanuḥ 
MBjanmamaranavicaaraHK-281	p. 11)	p 
MBjanmamaranavicaaraHK-282	tanmūle dve lalāṭākṣigaṇḍanāsāghanāsthikā |	tad mūle dve lalāṭa akṣi gaṇḍa nāsā ghana asthikā 
MBjanmamaranavicaaraHK-283	parśukāstalakaiḥ sārdhamarbude ca dvisaptatiḥ ||	parśukāḥ talakaiḥ sārdham arbude ca dvisaptatiḥ 
MBjanmamaranavicaaraHK-284	dvau śaṅkhakau kapālāni catvāryeva śirastathā | uraḥ	dvau śaṅkhakau kapālāni catvāri eva śiraḥ tathā uraḥ 
MBjanmamaranavicaaraHK-285	pañcadaśāsthīni puruṣasyāsthisaṃgrahaḥ ||	pañcadaśa asthīni puruṣasya asthi saṃgrahaḥ 
MBjanmamaranavicaaraHK-286	iti | eteṣveva	iti eteṣu eva 
MBjanmamaranavicaaraHK-287	kapālabharaṇaturuṇḍaruṇḍarucakanalayaṣṭīlanalakabhedena	kapāla bharaṇa turuṇḍa ruṇḍa rucaka nalaya ṣṭīla nalaka bhedena 
MBjanmamaranavicaaraHK-288	abhidhānāni śāstrāntareṣu uktāni | sthānāntarāṇi āha -	abhidhānāni śāstra antareṣu uktāni sthāna antarāṇi āha 
MBjanmamaranavicaaraHK-289	vasāvapāvahananaṃ nābhiklomayakṛtplihā | kṣudrāntravṛkśako	vasā vapā avahananam nābhi kloma yakṛt plihā 
MBjanmamaranavicaaraHK-290	vastiḥ purīṣāpāna eva ca ||	vastiḥ purīṣa apānaḥ eva ca 
MBjanmamaranavicaaraHK-291	āmāśayo'tha hṛdayaṃ sthūlāntraṃ gudameva ca | uttarau ca gudau	āmāśayaḥ utha hṛdayam sthūlāntram gudam eva ca uttarau ca gudau 
MBjanmamaranavicaaraHK-292	koṣṭhau vistāro'yamudāhṛtaḥ ||	koṣṭhau vistāraḥ yam udāhṛtaḥ 
MBjanmamaranavicaaraHK-293	kanīnike sākṣikūṭe śaṣkulī karṇaputrike | gaṇḍau śaṅkhau	kanīnike sākṣikūṭe śaṣkulī karṇaputrike gaṇḍau śaṅkhau 
MBjanmamaranavicaaraHK-294	bhruvau kaṣṭaveṣṭāvoṣṭhau kukundare ||	bhruvau kaṣṭa veṣṭau oṣṭhau kukundare 
MBjanmamaranavicaaraHK-295	vaṅkṣaṇau vṛṣaṇau vṛkkau śleṣmasaṃghātikau stanau |	vaṅkṣaṇau vṛṣaṇau vṛkkau śleṣma saṃghātikau stanau 
MBjanmamaranavicaaraHK-296	upajihvāsphijau jihvājaṃghe corū ca piṇḍike ||	upajihvā sphijau jihvā jaṃghe ca ūrū ca piṇḍike 
MBjanmamaranavicaaraHK-297	tālūdaravastiśīrṣe cibuke galaśuṇḍike | akṣipakṣmacatuṣkaṃ	tālu udara vastiśīrṣe cibuke galaśuṇḍike akṣi pakṣma catuṣkam 
MBjanmamaranavicaaraHK-298	ca paddhastahṛdayāni tu ||	ca pad hasta hṛdayāni tu 
MBjanmamaranavicaaraHK-299	avaṭuścaivamādīni sthānānyatra śarīrake | navacchidrāṇi	avaṭuḥ ca evamādīni sthānāni atra śarīrake nava chidrāṇi 
MBjanmamaranavicaaraHK-300	tānyeva prāṇasyāyatanāni ca ||	tāni eva prāṇasya āyatanāni ca 
MBjanmamaranavicaaraHK-301	dhamanīnāṃ śate dve tu pañcapeśīśatāni ca |	dhamanīnām śate dve tu pañca peśī śatāni ca 
MBjanmamaranavicaaraHK-302	iti |	iti 
MBjanmamaranavicaaraHK-303	p. 12)	p 
MBjanmamaranavicaaraHK-304	strīṇāṃ ca stanayorgartādaṣṭātriṃśadadhikāḥ sapeśyo	strīṇām ca stanayoḥ gartāt aṣṭātriṃśat adhikāḥ sa peśyaḥ 
MBjanmamaranavicaaraHK-305	dhamanyo bhavanti	dhamanyaḥ bhavanti 
MBjanmamaranavicaaraHK-306	iti sauśrutaḥ |	iti sauśrutaḥ 
MBjanmamaranavicaaraHK-307	ekānnatriṃśallakṣāṇi nava snāyuśatāni ca | ṣaṭpañcaśāni tu	eka anna triṃśat lakṣāṇi nava snāyu śatāni ca tu 
MBjanmamaranavicaaraHK-308	jñeyā sirā dhamanisantatiḥ ||	jñeyā sirā dhamani santatiḥ 
MBjanmamaranavicaaraHK-309	saptottaraṃ marmaśataṃ dve tu saṃdhiśate tathā | lomnāṃ	sapta uttaram marma śatam dve tu saṃdhi śate tathā lomnām 
MBjanmamaranavicaaraHK-310	koṭyastu pañcāśaccatasraḥ koṭya eva ca ||	koṭyaḥ tu pañcāśat catasraḥ koṭyaḥ eva ca 
MBjanmamaranavicaaraHK-311	rasasya nava vijñeyā jalasyāñjalayo daśa | sapta vai tu purīṣasya	rasasya nava vijñeyāḥ jalasya añjalayaḥ daśa sapta vai tu purīṣasya 
MBjanmamaranavicaaraHK-312	raktasyāṣṭau prakīrtitāḥ ||	raktasya aṣṭau prakīrtitāḥ 
MBjanmamaranavicaaraHK-313	śleṣmā ṣaṭvañca pittaṃ ca catvāro mūtrameva ca | vasātrayaṃ	śleṣmā pittam ca catvāraḥ mūtram eva ca vasā trayam 
MBjanmamaranavicaaraHK-314	ca dvau medo majjaikārdhaṃ ca mastake ||	ca dvau medaḥ majja eka ardham ca mastake 
MBjanmamaranavicaaraHK-315	śleṣmaujasastāvadeva retasastāvadeva ca | ityetadasthiraṃ varṣma	śleṣma ojasaḥ tāvat eva retasaḥ tāvat eva ca iti etat asthiram varṣma 
MBjanmamaranavicaaraHK-316	yasya mokṣāya kṛtyasau ||	yasya mokṣāya kṛtyasau 
MBjanmamaranavicaaraHK-317	iti svasthasya saumyadhātorevam | anyathā tu -	iti svasthasya saumyadhātoḥ evam anyathā tu 
MBjanmamaranavicaaraHK-318	vailakṣaṇyāccharīrāṇāmasvasthatvāttathaiva ca |	vailakṣaṇyāt śarīrāṇām asvastha tvāt tathā eva ca 
MBjanmamaranavicaaraHK-319	doṣadhātumalānāṃ ca parimāṇaṃ na vidyate ||	doṣa dhātu malānām ca parimāṇam na vidyate 
MBjanmamaranavicaaraHK-320	ityuktam | tadetat vibhāgena bībhatsadarśanaṃ	iti uktam tat etat vibhāgena bībhatsa darśanam 
MBjanmamaranavicaaraHK-321	vairāgyamunibhiragāyi tathā cāhuḥ -	vairāgya munibhiḥ agāyi tathā ca āhuḥ 
MBjanmamaranavicaaraHK-322	asthisthūṇaṃ snāyuyutaṃ māṃsaśoṇitalepanam | carmāvanaddhaṃ	asthi sthūṇam snāyu yutam māṃsa śoṇita lepanam carma avanaddham 
MBjanmamaranavicaaraHK-323	durgandhi pūrṇaṃ mūtrapurīṣayoḥ ||	durgandhi pūrṇam mūtra purīṣayoḥ 
MBjanmamaranavicaaraHK-324	jarāśokasamāviṣṭaṃ rogāyatanamāturam | rajasvalamanityaṃ ca	jarā śoka samāviṣṭam roga āyatanam āturam rajasvalam anityam ca 
MBjanmamaranavicaaraHK-325	bhūtāvāsamimaṃ tyajet ||	bhūtāvāsam imam tyajet 
MBjanmamaranavicaaraHK-326	p. 13)	p 
MBjanmamaranavicaaraHK-327	muniḥ pārāśaryo'pi āha -	muniḥ pārāśaryaḥ api āha 
MBjanmamaranavicaaraHK-328	sarvāśucinidhānasya kṛtaghnasya vināśinaḥ | śarīrakasyāpi	sarva aśuci nidhānasya kṛtaghnasya vināśinaḥ śarīrakasya api 
MBjanmamaranavicaaraHK-329	kṛte mūḍhāḥ pāpāni kurvate ||	kṛte mūḍhāḥ pāpāni kurvate 
MBjanmamaranavicaaraHK-330	āhārairnīyamānāya kramādduḥkhena ramyatām | ko hi nāma	āhāraiḥ nīyamānāya kramāt duḥkhena ramyatām kaḥ hi nāma 
MBjanmamaranavicaaraHK-331	śarīrāya dharmāpetaṃ samācaret ||	śarīrāya dharmāpetam samācaret 
MBjanmamaranavicaaraHK-332	iti | evaṃ śarīramuktvā śarīrisvarūpamucyate -	iti evam śarīram uktvā śarīri svarūpam ucyate 
MBjanmamaranavicaaraHK-333	dvāsaptatisahasrāṇi hṛdayādabhiniḥsṛtāḥ | hitā nāmāhitā	dvāsaptati sahasrāṇi hṛdayāt abhiniḥsṛtāḥ hitāḥ nāma ahitā 
MBjanmamaranavicaaraHK-334	nāḍyastāsāṃ madhye śaśiprabham ||	nāḍyaḥ tāsām madhye śaśi prabham 
MBjanmamaranavicaaraHK-335	maṇḍalaṃ tasya madhyastha ātmā dīpa ivācalaḥ | sa jñeyastaṃ	maṇḍalam tasya madhya sthaḥ ātmā dīpaḥ iva acalaḥ sa jñeyaḥ tam 
MBjanmamaranavicaaraHK-336	viditveha punarājāyate na tu ||	viditvā iha punar ājāyate na tu 
MBjanmamaranavicaaraHK-337	idamatra tātparyam - taṃ tathābhūtamātmānaṃ viditvā naro na	idam atra tātparyam tam tathābhūtam ātmānam viditvā naraḥ na 
MBjanmamaranavicaaraHK-338	janmakleśamanubhavati kiṃbhūtaṃ yaddhṛdayoktaṃ	janma kleśam anubhavati kiṃbhūtam yat hṛdaya uktam 
MBjanmamaranavicaaraHK-339	dvāsaptatisaṃkhyāvacchinnaṃ nāḍīcakraṃ tadantar yat	dvāsaptati saṃkhyā avacchinnam nāḍī cakram tad antar yat 
MBjanmamaranavicaaraHK-340	śaśimaṇḍalaṃ tadantaḥsthaṃ tāśca	śaśi maṇḍalam tad antar stham tāḥ ca 
MBjanmamaranavicaaraHK-341	nāḍyo'śitapītarasasaṃcaraṇādhikāratvāt puṇyopacayena hitāḥ	nāḍyā uśita pīta rasa saṃcaraṇa adhikāra tvāt puṇya upacayena hitāḥ 
MBjanmamaranavicaaraHK-342	tadabhāvena ahitāḥ tāsāṃ saṃcāraka eka eva vyavahārabhedāt	tad abhāvena ahitāḥ tāsām saṃcārakaḥ ekaḥ eva vyavahāra bhedāt 
MBjanmamaranavicaaraHK-343	pañcabhedo vāyuḥ tāsāṃ ca dve pradhāne - dakṣiṇottarasaṃbaddhe	pañca bhedaḥ vāyuḥ tāsām ca dve pradhāne dakṣiṇa uttara saṃbaddhe 
MBjanmamaranavicaaraHK-344	agnīṣomātmake taddvāreṇa prāṇasya ūrdhvagamanam	agnīṣoma ātmake tad dvāreṇa prāṇasya ūrdhva gamanam 
MBjanmamaranavicaaraHK-345	p. 14)	p 
MBjanmamaranavicaaraHK-346	ahaḥ adho'pānasya rātriḥ etena	ahar adhopānasya rātriḥ etena 
MBjanmamaranavicaaraHK-347	ardhamāsamāsartuvatsarādikālavibhāgo'pi vyākhyātaḥ	ardha māsa māsa ṛtu vatsara ādi kāla vibhāgaḥ upi vyākhyātaḥ 
MBjanmamaranavicaaraHK-348	samaprāṇacāro viṣuvat tayormadhye tṛtīyā daṇḍākārā	sama prāṇa cāraḥ viṣuvat tayoḥ madhye tṛtīyā daṇḍa ākārā 
MBjanmamaranavicaaraHK-349	brahmanāḍī sthitā tatra niruddhaprāṇo yogī dīpākāram	brahmanāḍī sthitā tatra niruddhaprāṇaḥ yogī dīpa ākāram 
MBjanmamaranavicaaraHK-350	ātmānaṃ paśyati iti ata evoktaṃ -	ātmānam paśyati iti atas eva uktam 
MBjanmamaranavicaaraHK-351	samyagdarśanasaṃpannaḥ karmabhirna sa badhyate | darśanena	samyak darśana saṃpannaḥ karmabhiḥ na sa badhyate darśanena 
MBjanmamaranavicaaraHK-352	vihīnastu saṃsāraṃ pratipadyate ||	vihīnaḥ tu saṃsāram pratipadyate 
MBjanmamaranavicaaraHK-353	iti | saṃsārapravṛttau ca tasya kalāto viṣayavibhedo munibhiruktaḥ	iti saṃsāra pravṛttau ca tasya kalātaḥ viṣaya vibhedaḥ munibhiḥ uktaḥ 
MBjanmamaranavicaaraHK-354	tathāhi	tathā hi 
MBjanmamaranavicaaraHK-355	paradravyāṇyabhidhyāyaṃstathāniṣṭāni cintayan |	para dravyāṇi abhidhyāyan tathā aniṣṭāni cintayan 
MBjanmamaranavicaaraHK-356	vitathābhiniveśī ca jāyate'ntyāsu yoniṣu ||	vitatha abhiniveśī ca jāyata intyāsu yoniṣu 
MBjanmamaranavicaaraHK-357	puruṣo'nṛtavādī ca piśunaḥ puruṣastathā | anibaddhapralāpī ca	puruṣaḥ nṛta vādī ca piśunaḥ puruṣaḥ tathā anibaddha pralāpī ca 
MBjanmamaranavicaaraHK-358	mṛgapakṣiṣu jāyate ||	mṛga pakṣiṣu jāyate 
MBjanmamaranavicaaraHK-359	adattādānanirataḥ paradāropasevakaḥ | hiṃsakaścāvidhānena	adatta ādāna nirataḥ para dāra upasevakaḥ hiṃsakaḥ ca avidhānena 
MBjanmamaranavicaaraHK-360	sthāvarepūpajāyate ||	sthāvarepu upajāyate 
MBjanmamaranavicaaraHK-361	ityādi ayaṃ tu uktayātanasya niyogaḥ advayarūpasya ātmanaḥ	ityādi ayam tu ukta yātanasya niyogaḥ advaya rūpasya ātmanaḥ 
MBjanmamaranavicaaraHK-362	kutastyo'yaṃ bhedaḥ? iti cet - māyāmahāmohavikalpakalpita ityāha	kutas tyaḥ iyam bhedaḥ iti ced māyā mahā moha vikalpa kalpitaḥ iti āha 
MBjanmamaranavicaaraHK-363	ākāśamekaṃ hi yathā ghaṭādiṣu pṛthagbhavet |	ākāśam ekam hi yathā ghaṭa ādiṣu pṛthak bhavet 
MBjanmamaranavicaaraHK-364	tathātmaiko'pyanekaśca jalādhāreṣvivāṃśumān ||	tathā ātmā ekaḥ api anekaḥ ca jala ādhāreṣu iva aṃśumān 
MBjanmamaranavicaaraHK-365	p. 15)	p 
MBjanmamaranavicaaraHK-366	iti | na ca apakvakaṣāyasya kadācidapi uktarūpam ātmajñānaṃ	iti na ca apakva kaṣāyasya kadācid api ukta rūpam ātma jñānam 
MBjanmamaranavicaaraHK-367	bhavati tathā ca -	bhavati tathā ca 
MBjanmamaranavicaaraHK-368	malino hi yathādarśo rūpālokasya na kṣamaḥ | tathā	malinaḥ hi yathā ādarśaḥ rūpa ālokasya na kṣamaḥ tathā 
MBjanmamaranavicaaraHK-369	hyapakvakaraṇa ātmajñanasya na kṣamaḥ ||	hi apakva karaṇaḥ ātma jñanasya na kṣamaḥ 
MBjanmamaranavicaaraHK-370	ityādyuktam | ityalaṃ bhūyasā uktena | evam asau bhagavān	ityādi uktam iti alam bhūyasā uktena evam asau bhagavān 
MBjanmamaranavicaaraHK-371	svātantryaśaktimahimnā paśudaśām avalambamāno	svātantrya śakti mahimnā paśu daśām avalambamānaḥ 
MBjanmamaranavicaaraHK-372	bhogopadānapravaṇaḥ saṃpūrṇadehaprāṇabalaḥ san uktena	bhoga upadāna pravaṇaḥ saṃpūrṇa deha prāṇa balaḥ san uktena 
MBjanmamaranavicaaraHK-373	ṣaḍadhvajālakrameṇa prabuddhaḥ śarīraparigraham āsādayati	ṣaḍadhva jāla krameṇa prabuddhaḥ śarīra parigraham āsādayati 
MBjanmamaranavicaaraHK-374	krameṇa bhukteṣu karmasu ṣaḍirbhāvavikārairjarārogādibhiḥ	krameṇa bhukteṣu karmasu 
MBjanmamaranavicaaraHK-375	kāyayantre vighaṭamāne dehastambho vepathurnāḍīcakrasaṃkocaḥ	kāya yantre vighaṭamāne deha stambhaḥ vepathuḥ nāḍī cakra saṃkocaḥ 
MBjanmamaranavicaaraHK-376	kvacidviparyayeṇa tadvikāso marmabhaṅgaḥ śoṣa ityādi	kvacid viparyayeṇa tad vikāsaḥ marma bhaṅgaḥ śoṣaḥ ityādi 
MBjanmamaranavicaaraHK-377	pūrvasaṃsthāpanopamardakaṃ sarvam upapadyate yāvat vinaśyati	pūrva saṃsthāpana upamardakam sarvam upapadyate yāvat vinaśyati 
MBjanmamaranavicaaraHK-378	vināśaśca kṣaṇiko'sya yadyapi tathāpi sthūlayā vṛttyā	vināśaḥ ca kṣaṇikaḥ asya yadi api tathā api sthūlayā vṛttyā 
MBjanmamaranavicaaraHK-379	daśabhirdaśabhirabhivyaktaḥ proktaḥ | tathāhi -	daśabhiḥ daśabhiḥ abhivyaktaḥ proktaḥ tathā hi 
MBjanmamaranavicaaraHK-380	bālyaṃ vṛddhirbalaṃ prajñā tvakcakṣuḥ śrotramindriyam |	bālyam vṛddhiḥ balam prajñā tvac cakṣuḥ śrotram indriyam 
MBjanmamaranavicaaraHK-381	āsanaṃ śayanaṃ puṃsāṃ daśabhirdaśabhirvrajet ||	āsanam śayanam puṃsām daśabhiḥ daśabhiḥ vrajet 
MBjanmamaranavicaaraHK-382	ityuktaṃ | tataśca tasmin śarīrayantre vighaṭite sā saṃvit	iti uktam tatas ca tasmin śarīra yantre vighaṭite sā saṃvid 
MBjanmamaranavicaaraHK-383	prāṇanātmatām avalambya āṃtivāhikena -	prāṇana ātma tām avalambya āṃtivāhikena 
MBjanmamaranavicaaraHK-384	p. 16)	p 
MBjanmamaranavicaaraHK-385	dehena dehāntaraṃ nīyate tataśca ātivāhikaṃ śarīrakaṃ	dehena deha antaram nīyate tatas ca ātivāhikam śarīrakam 
MBjanmamaranavicaaraHK-386	bhūtabhaviṣyaddehāntarāle yugyasthānīyaṃ saṃbhavati	bhūta bhaviṣyat deha antarāle yugya sthānīyam saṃbhavati 
MBjanmamaranavicaaraHK-387	yadārūḍho'sau pudgalaḥ śarīrāntarāsaṅgam anubhavati uktaṃ ca	yad ārūḍhaḥ asau pudgalaḥ śarīra antarāsaṅgam anubhavati uktam ca 
MBjanmamaranavicaaraHK-388	kośabhāṣye -	kośa bhāṣye 
MBjanmamaranavicaaraHK-389	mṛtyūpapattibhavayorantarā bhavatīha yaḥ |	mṛtyu upapatti bhavayoḥ antarā bhavati iha yaḥ 
MBjanmamaranavicaaraHK-390	gamyadeśānuṣaktatvādupapanno'ntarābhavaḥ ||	gamya deśa anuṣakta tvāt upapannaḥ antarābhavaḥ 
MBjanmamaranavicaaraHK-391	vrīhisaṃtānasādharmyādavacchinnasamudbhavaḥ |	vrīhi saṃtāna sādharmyāt avacchinna samudbhavaḥ 
MBjanmamaranavicaaraHK-392	pratibimbamasiddhitvādasāmyācca nidarśanāt ||	pratibimbam asiddhi tvāt asāmyāt ca nidarśanāt 
MBjanmamaranavicaaraHK-393	sa punarmaraṇātpūrvamupapattikṣaṇātparam |	sa punar maraṇāt pūrvam upapatti kṣaṇāt param 
MBjanmamaranavicaaraHK-394	svajātiśuddhakarmākṣadṛśyakarmavivekavān ||	sva jāti śuddha karma akṣa dṛśya karma vivekavān 
MBjanmamaranavicaaraHK-395	iti | śrutiśca -	iti śrutiḥ ca 
MBjanmamaranavicaaraHK-396	dve te cakre sūrye brahmāṇa ṛtuthā viduḥ | athaikaṃ cakraṃ	dve te cakre sūrye brahmāṇaḥ ṛtuthā viduḥ atha ekam cakram 
MBjanmamaranavicaaraHK-397	yadguhā tadaddhātaya idviduḥ ||	yat guhā tat addhātayaḥ id viduḥ 
MBjanmamaranavicaaraHK-398	iti ayamarthaḥ - he sūrye bhagavati ātmaśakte brahmāṇaḥ	iti ayam arthaḥ he sūrye bhagavati ātma śakte brahmāṇaḥ 
MBjanmamaranavicaaraHK-399	brahmavādinaḥ ṛtuthā kāle kāle te tava saṃbandhinī dve cakre	brahma vādinaḥ ṛtuthā kāle kāle te tava saṃbandhinī dve cakre 
MBjanmamaranavicaaraHK-400	viduḥ cakramiva cakraṃ parivartasādharmyāt śarīramucyate	viduḥ cakram iva cakram parivarta sādharmyāt śarīram ucyate 
MBjanmamaranavicaaraHK-401	tayordvitvaṃ vartamānabhāvibhedāt atastayorantare kathitayā yuktyā	tayoḥ dvi tvam vartamāna bhāvi bhedāt atas tayoḥ antare kathitayā yuktyā 
MBjanmamaranavicaaraHK-402	yadekamātivāhikākhyaṃ tat guhā guptam anupalakṣyam ityarthaḥ ata	yat ekam ātivāhika ākhyam tat guhā guptam anupalakṣyam iti arthaḥ 
MBjanmamaranavicaaraHK-403	eva tadaddhātayaḥ it viduḥ yogina eva jānanti iti tātparyam |	eva tadaddhātayaḥ id viduḥ yoginaḥ eva jānanti iti tātparyam 
MBjanmamaranavicaaraHK-404	p. 17)	p 
MBjanmamaranavicaaraHK-405	tathā ca jāgradavasthāyāṃ dṛḍhakaraṇasya pramāturindriyāṇi	tathā ca jāgrat avasthāyām dṛḍha karaṇasya pramātuḥ indriyāṇi 
MBjanmamaranavicaaraHK-406	śrotrādīni śabdādayaśca viṣayā bhavanti tathā prameyasamaye	śrotra ādīni śabda ādayaḥ ca viṣayāḥ bhavanti tathā prameya samaye 
MBjanmamaranavicaaraHK-407	pracalitam antaḥkaraṇamindriyaṃ yiyāsutā ca viṣayaḥ tāmeva	pracalitam antaḥkaraṇam indriyam yiyāsu tā ca viṣayaḥ tām eva 
MBjanmamaranavicaaraHK-408	yiyāsutām adhikṛtya pravaramuniḥ pārāśaryaḥ samādhitavān	yiyāsu tām adhikṛtya pravara muniḥ pārāśaryaḥ 
MBjanmamaranavicaaraHK-409	yaṃ yaṃ vāpi smaranbhāvaṃ tyajatyante kalevaram | taṃ tamevaiti	yam yam vā api smaran bhāvam tyajati ante kalevaram tam tam eva eti 
MBjanmamaranavicaaraHK-410	kaunteya sadā tadbhāvabhāvitaḥ ||	kaunteya sadā tad bhāva bhāvitaḥ 
MBjanmamaranavicaaraHK-411	iti | ayamatra saṃkṣepārthaḥ - saṃbhavabhogaḥ janmabhogaḥ	iti ayam atra saṃkṣepa arthaḥ saṃbhava bhogaḥ janma bhogaḥ 
MBjanmamaranavicaaraHK-412	sthitibhogaśca iti tisraḥ śarīrasya prāgavasthābhavanti hi	sthiti bhogaḥ ca iti tisraḥ śarīrasya prāc avasthā bhavanti hi 
MBjanmamaranavicaaraHK-413	tathāhi - jaṭhare cetanāyāṃ saṃjātāyāṃ garbhabhogaḥ	tathā hi jaṭhare cetanāyām saṃjātāyām garbha bhogaḥ 
MBjanmamaranavicaaraHK-414	prasavasamaye janmabhogaḥ prasūtasya bālyādivayaḥ parāvṛttyā	prasava samaye janma bhogaḥ prasūtasya bālya ādi vayaḥ parāvṛttyā 
MBjanmamaranavicaaraHK-415	vicitraḥ sthitibhogaḥ | mṛtibhogaḥ yiyāsutā ca dve caramāvasthe	vicitraḥ sthiti bhogaḥ mṛti bhogaḥ yiyāsu tā ca dve carama avasthe 
MBjanmamaranavicaaraHK-416	tatra mṛtibhogaḥ vicitrā śarīrapīḍā yiyāsutā	tatra mṛti bhogaḥ vicitrā śarīra pīḍā yiyāsu tā 
MBjanmamaranavicaaraHK-417	ātivāhikaśarīrasaṃbaddhā tāmeva ca yiyāsutāmuddiśya -	ātivāhika śarīra saṃbaddhā tām eva ca yiyāsu tām uddiśya 
MBjanmamaranavicaaraHK-418	yaṃ yaṃ vāpi smaranbhāvam * * * * * * * * |	yam yam vā api smaran bhāvam 
MBjanmamaranavicaaraHK-419	ityādi pravṛttaṃ ata eva bhūtabhaviṣyadarthahitārthavādinaḥ -	ityādi pravṛttam atas eva bhūta bhaviṣyat artha hita artha vādinaḥ 
MBjanmamaranavicaaraHK-420	p. 18)	p 
MBjanmamaranavicaaraHK-421	smaranniti śabdapratyayasya yathārthaḥ prayogaḥ syāt etadeva ca	smaran iti śabda pratyayasya yathā arthaḥ prayogaḥ syāt etat eva ca 
MBjanmamaranavicaaraHK-422	vitatya śrītantrāloke pratipāditam	vitatya śrī tantrāloke pratipāditam 
MBjanmamaranavicaaraHK-423	mṛtibhogaḥ samasto'yaṃ marmacchinmūḍhatākṣagaḥ |	mṛti bhogaḥ sama stoyam marma chid mūḍha tā akṣa gaḥ 
MBjanmamaranavicaaraHK-424	tatrendriyāṇāṃ saṃmohaḥ śvāsāyāsaparītatā ||	tatra indriyāṇām saṃmohaḥ śvāsa āyāsa parīta tā 
MBjanmamaranavicaaraHK-425	yastvasau kṣaṇa evaikaścaramaḥ prāṇanātmakaḥ | sā	yaḥ tu asau kṣaṇaḥ eva ekaḥ caramaḥ prāṇana ātmakaḥ sā 
MBjanmamaranavicaaraHK-426	dehatyāgakālāṃśakalā prāṇaviyoginī ||	               
MBjanmamaranavicaaraHK-427	tasyāṃ yadeva smarati prāksaṃskāraprabodhataḥ | tadeva	tasyām yat eva smarati prāk saṃskāra prabodhataḥ tat eva 
MBjanmamaranavicaaraHK-428	rūpamabhyeti sukhaduḥkhavimohitam ||	rūpam abhyeti sukha duḥkha vimohitam 
MBjanmamaranavicaaraHK-429	iti | atra ca viṣayanaiyatyena vibhāgo vyāsamuninaiva kṛtaḥ |	iti  atra ca viṣaya naiyatyena vibhāgaḥ vyāsa muninā eva kṛtaḥ 
MBjanmamaranavicaaraHK-430	yadā sattve vivṛddhe tu pralayaṃ yāti dehabhṛt |	yadā sattve vivṛddhe tu pralayam yāti dehabhṛt 
MBjanmamaranavicaaraHK-431	ityādinā granthena | tā etāḥ śarīrāvasthāḥ	ityādinā granthena tāḥ etāḥ śarīra avasthāḥ 
MBjanmamaranavicaaraHK-432	pañcāre cakre parivartamāne tasminnātasthurbhuvanāni viśvā |	pañca are cakre parivartamāne tasmin na atasthuḥ bhuvanāni viśvā 
MBjanmamaranavicaaraHK-433	ityādiśrutāvuktāḥ | anyatrāpi -	ityādi śrutau uktāḥ anyatra api 
MBjanmamaranavicaaraHK-434	saṃbhavo janma sattā ca mṛtiścātha yiyāsutā | etāḥ pañca	saṃbhavaḥ janma sattā ca mṛtiḥ ca atha yiyāsu tā etāḥ pañca 
MBjanmamaranavicaaraHK-435	śarīrasya pariṇāmavipattayaḥ ||	śarīrasya pariṇāma vipattayaḥ 
MBjanmamaranavicaaraHK-436	ityuktam | etadevamuktarūpeṇa asau ātivāhikena dehena dehāntaraṃ	iti uktam etat evam ukta rūpeṇa asau ātivāhikena dehena deha antaram 
MBjanmamaranavicaaraHK-437	nīyate so'pi dehaḥ suptotthitāt prabodham avāpya prāṇiti -	nīyate saḥ upi dehaḥ supta utthitāt prabodham avāpya prāṇiti 
MBjanmamaranavicaaraHK-438	p. 19)	p 
MBjanmamaranavicaaraHK-439	uktena cakreṇa so'pi vinaśyati yāvat araghaṭṭaghaṭīyantravat	uktena cakreṇa saḥ api vinaśyati yāvat araghaṭṭa ghaṭīyantra vat 
MBjanmamaranavicaaraHK-440	parivartamāno'ṇuḥ nānākāyanikāyaiḥ saṃsarati saṃsāre |	parivartamānā uṇuḥ nānā kāya nikāyaiḥ saṃsarati saṃsāre 
MBjanmamaranavicaaraHK-441	tathā ca śrutiḥ -	tathā ca śrutiḥ 
MBjanmamaranavicaaraHK-442	sasyamiva martyaḥ pacyate sasyamiva jāyate punaḥ |	sasyam iva martyaḥ pacyate sasyam iva jāyate punar 
MBjanmamaranavicaaraHK-443	iti |	iti 
MBjanmamaranavicaaraHK-444	vāsāṃsi jīrṇāni yathā vihāya |	vāsāṃsi jīrṇāni yathā vihāya 
MBjanmamaranavicaaraHK-445	ityādinā vyāsamunināpi etaduktam |	ityādinā vyāsa muninā api etat uktam 
MBjanmamaranavicaaraHK-446	atha kadācitparameśvarānugrahaśaktipātapavitritaḥ kenāpi	atha kadācid parameśvara anugraha śaktipāta pavitritaḥ kena api 
MBjanmamaranavicaaraHK-447	dīkṣādinā upāyena saṃvidānandaviśrāntam advayaṃ nijaṃ rūpaṃ	dīkṣā ādinā upāyena saṃvid ānanda viśrāntam advayam nijam rūpam 
MBjanmamaranavicaaraHK-448	parāmṛśati tataḥ svarūpamālambate yathoktaṃ śrīmālinīvijaye -	parāmṛśati tatas sva rūpam ālambate yathā uktam śrīmālinīvijaye 
MBjanmamaranavicaaraHK-449	evamasyātmanaḥ kāle kasmiṃścidyogyatāvaśāt |	evam asya ātmanaḥ kāle kasmiṃścid yogyatā vaśāt 
MBjanmamaranavicaaraHK-450	ityupakramya -	iti upakramya 
MBjanmamaranavicaaraHK-451	tatkṣaṇādvopabhogādvā dehapāte śivaṃ vrajet |	tad kṣaṇāt vā upabhogāt vā dehapāte śivam vrajet 
MBjanmamaranavicaaraHK-452	ityevamantena granthena | yadvā kvāpi parameśvarāyatane śarīram	iti evam antena granthena yat vā kvāpi parameśvara āyatane śarīram 
MBjanmamaranavicaaraHK-453	ativāhya pūrve vidhau krameṇa parameśvarībhavati taduktaṃ	ativāhya pūrve vidhau krameṇa parameśvarībhavati tat uktam 
MBjanmamaranavicaaraHK-454	śrīsāttvatāyām -	śrī sāttvatāyām 
MBjanmamaranavicaaraHK-455	prāsādadvāradeśācca yatra śaṅkhadhvaniścaran | prayāti sarvato	prāsāda dvāra deśāt ca yatra śaṅkha dhvaniḥ caran prayāti 
MBjanmamaranavicaaraHK-456	dikṣu tatkṣetraṃ vaiṣṇavaṃ matam ||	dikṣu tat kṣetram vaiṣṇavam matam 
MBjanmamaranavicaaraHK-457	munipraṇītāddviguṇaṃ tadeva parikīrtitam |	muni praṇītāt dviguṇam tat eva parikīrtitam 
MBjanmamaranavicaaraHK-458	siddhāvatāritāddevāttadeva triguṇaṃ smṛtam ||	siddha avatāritāt devāt tat eva triguṇam smṛtam 
MBjanmamaranavicaaraHK-459	p. 20)	p 
MBjanmamaranavicaaraHK-460	caturguṇaṃ svayaṃ vyaktāddehānte bhāvitātmanām | phalaṃ	caturguṇam svayam vyaktāt dehānte bhāvitātmanām phalam 
MBjanmamaranavicaaraHK-461	sāyujyatāpūrvaṃ vijñeyaṃ tu kramāttataḥ ||	sāyujya tā pūrvam vijñeyam tu kramāt tatas 
MBjanmamaranavicaaraHK-462	duṣṭendriyavaśāccittaṃ nṛṇāṃ yatkalmaṣeritam | tadantakāle	duṣṭa indriya vaśāt cittam nṛṇām yat kalmaṣa īritam tat antakāle 
MBjanmamaranavicaaraHK-463	saṃśuddhiṃ yāti nārāyaṇālaye ||	saṃśuddhim yāti nārāyaṇa ālaye 
MBjanmamaranavicaaraHK-464	iti | śrīmadamṛteśaśikhāyāmapi -	iti śrīmat amṛteśaśikhāyām api 
MBjanmamaranavicaaraHK-465	ye tu tattvāvatīrṇānāṃ śaṅkarājñānuvartinām |	ye tu tattva avatīrṇānām śaṅkara ājñā anuvartinām 
MBjanmamaranavicaaraHK-466	svayaṃbhūmunidevarṣimanujādibhuvāṃ gṛhe ||	svayaṃbhū muni deva ṛṣi manuja ādi bhuvām gṛhe 
MBjanmamaranavicaaraHK-467	mṛtāste tatpuraṃ prāpya pureśairdīkṣitāḥ kramāt |	mṛtāḥ te tat puram prāpya pureśaiḥ dīkṣitāḥ kramāt 
MBjanmamaranavicaaraHK-468	martye'vatīrya vā nāvā prayānti paramaṃ padam ||	martyā iva tīrya vā nāvā prayānti paramam padam 
MBjanmamaranavicaaraHK-469	tatra svayaṃbhuvo dvedhā ke'pyanugrahatatparāḥ | ke'pi	tatra svayaṃbhuvaḥ dvedhā ke pi anugraha tatparāḥ ke pi 
MBjanmamaranavicaaraHK-470	svakāryeṇāyātāḥ pūrve nirvāṇadāyinaḥ ||	sva kāryeṇa āyātāḥ pūrve nirvāṇa dāyinaḥ 
MBjanmamaranavicaaraHK-471	iti | tatrāpi na sarvasya mokṣa ityuktam -	iti tatra api na sarvasya mokṣaḥ iti uktam 
MBjanmamaranavicaaraHK-472	paśumātrasya sālokyaṃ sāmīpyaṃ dīkṣitasya tu | tatparasya tu	paśu mātrasya sālokyam sāmīpyam dīkṣitasya tu tad parasya tu 
MBjanmamaranavicaaraHK-473	sāyujyamityājñā pārameśvarī ||	sāyujyam iti ājñā pārameśvarī 
MBjanmamaranavicaaraHK-474	yastūrdhvaśāstragastatra tyaktāsthaḥ saṃśayena saḥ |	yaḥ tu ūrdhva śāstra gaḥ tatra tyakta āsthaḥ saṃśayena saḥ 
MBjanmamaranavicaaraHK-475	vrajedāyatanaṃ naiva sa phalaṃ kiṃcidaśnute ||	vrajet āyatanam nā eva sa phalam kiṃcid aśnute 
MBjanmamaranavicaaraHK-476	dīkṣāyatanavijñānadveṣiṇo ye tu cetasā | ācaranti ca tatte vai	dīkṣā āyatana vijñāna dveṣiṇaḥ ye tu cetasā ācaranti ca tat te vai 
MBjanmamaranavicaaraHK-477	sarve nirayagāminaḥ ||	sarve niraya gāminaḥ 
MBjanmamaranavicaaraHK-478	ye ca svabhyastavijñānamayāḥ śivamayā hi te | jīvanmuktā na	ye ca su abhyasta vijñāna mayāḥ śiva mayāḥ hi te jīvanmuktāḥ na 
MBjanmamaranavicaaraHK-479	teṣāṃ syānmṛtau kāpi vicāraṇā ||	teṣām syāt mṛtau kā api vicāraṇā 
MBjanmamaranavicaaraHK-480	iti | ata eva uktaṃ śrīniśāṭane	iti atas eva uktam śrī niśāṭane 
MBjanmamaranavicaaraHK-481	godohamiṣupātaṃ vā nayanonmīlanaṃ ca vā | samyagyuktaḥ pare	godoham iṣu pātam vā nayana unmīlanam ca vā samyak yuktaḥ pare 
MBjanmamaranavicaaraHK-482	tattve na bhūyo janmabhāgbhavet ||	tattve na bhūyas janma bhāj bhavet 
MBjanmamaranavicaaraHK-483	p. 21)	p 
MBjanmamaranavicaaraHK-484	yasmātpūrvaṃ pare nyasto yenātmā brahmaṇi svayam | smaraṇaṃ tu	yasmāt pūrvam pare nyastaḥ yena ātmā brahmaṇi svayam smaraṇam tu 
MBjanmamaranavicaaraHK-485	kathaṃ tasya prāṇānte samupasthite ||	katham tasya prāṇānte samupasthite 
MBjanmamaranavicaaraHK-486	iti | śrīrāmabhaṭṭārake'pi	iti śrī rāma bhaṭṭārake api 
MBjanmamaranavicaaraHK-487	tāvatkṣetraṃ tathā tīrthaṃ yāvadbrahmaṇi no viśet | tadviditvā	tāvat kṣetram tathā tīrtham yāvat brahmaṇi no viśet tat viditvā 
MBjanmamaranavicaaraHK-488	śvapāko'pi matsamo nātra saṃśayaḥ ||	śvapākaḥ api mad samaḥ na atra saṃśayaḥ 
MBjanmamaranavicaaraHK-489	iti | bhagavatā bhegipatināpi	iti bhagavatā bhegipatinā api 
MBjanmamaranavicaaraHK-490	tīrthe śvapacagṛhe vā naṣṭasmṛtirapi parityajandeham |	tīrthe śvapaca gṛhe vā naṣṭa smṛtiḥ api parityajan deham 
MBjanmamaranavicaaraHK-491	jñānasamakālamuktaḥ kaivalyaṃ yāti hataśokaḥ ||	jñāna sama kāla muktaḥ kaivalyam yāti hata śokaḥ 
MBjanmamaranavicaaraHK-492	iti | śrīmatpauṣkarāyāmapi uktam	iti śrīmat pauṣkarāyām api uktam 
MBjanmamaranavicaaraHK-493	kṣityantānāṃ ca tattvānāṃ devatvena vyavasthitaḥ | mantrajño	kṣiti antānām ca tattvānām deva tvena vyavasthitaḥ 
MBjanmamaranavicaaraHK-494	bhagavadbhaktaḥ śraddadhānaḥ sadāstikaḥ ||	bhagavat bhaktaḥ śraddadhānaḥ sadā āstikaḥ 
MBjanmamaranavicaaraHK-495	yatra yatrāśrame caiva nivasetsaṃyatendriyaḥ | svadehasthaṃ	yatra yatra āśrame ca eva nivaset saṃyata indriyaḥ sva deha stham 
MBjanmamaranavicaaraHK-496	smarennityaṃ svamantraṃ nyastavigrahaḥ ||	smaret nityam sva mantram nyasta vigrahaḥ 
MBjanmamaranavicaaraHK-497	dehasaṃnyāsakāle tu viśrānto yatra kutracit | prayāti padamādyaṃ	deha saṃnyāsa kāle tu viśrāntaḥ yatra kutracid prayāti padam ādyam 
MBjanmamaranavicaaraHK-498	vai samutkrāntaḥ svavigraham \|	vai samutkrāntaḥ sva vigraham 
MBjanmamaranavicaaraHK-499	iti | anyatrāpi	iti anyatra api 
MBjanmamaranavicaaraHK-500	śarīramevāyatanaṃ nānyadāyatanaṃ vrajet | tīrthamekaṃ	śarīram eva āyatanam na anyat āyatanam vrajet tīrtham ekam 
MBjanmamaranavicaaraHK-501	śrayenmantramanyatīrthāni varjayet ||	śrayet mantram anya tīrthāni varjayet 
MBjanmamaranavicaaraHK-502	p. 22)	p 
MBjanmamaranavicaaraHK-503	iti | tathā -	iti tathā 
MBjanmamaranavicaaraHK-504	svasthaceṣṭāśca ye martyāḥ smaranti mama nārada |	svastha ceṣṭāḥ ca ye martyāḥ smaranti mama nārada 
MBjanmamaranavicaaraHK-505	kāṣṭhapāṣāṇatulyāṃstānantakāle smarāmyaham ||	kāṣṭha pāṣāṇa tulyān tān anta kāle smarāmi aham 
MBjanmamaranavicaaraHK-506	ityuktaṃ | na ca saṃsthitasya uttamatayā adhikāriṇo	iti uktam na ca saṃsthitasya uttama tayā adhikāriṇaḥ 
MBjanmamaranavicaaraHK-507	lokayātrāprasiddhāsruvimocanādiparidevitaṃ kāryam yathoktaṃ	lokayātrā prasiddha asru vimocana ādi paridevitam kāryam yathā uktam 
MBjanmamaranavicaaraHK-508	śrīpūrvaśāsane	          
MBjanmamaranavicaaraHK-509	niṣiddhaṃ sarvaśāstrāṇāṃ rodanaṃ kāyaśāsanam |	niṣiddham sarva śāstrāṇām rodanam kāya śāsanam 
MBjanmamaranavicaaraHK-510	viśeṣādbhairave tantre śambaraṃ paśukalpitam ||	viśeṣāt bhairave tantre śambaram paśu kalpitam 
MBjanmamaranavicaaraHK-511	ayuktamimamācāraṃ tyajedvai naurdhvadaihikam |	ayuktam imam ācāram tyajet vai na aurdhvadaihikam 
MBjanmamaranavicaaraHK-512	iti | śrīmatarahasyatilake'pi uttamanayādhikāriṇāṃ	iti śrī matarahasyatilake pi uttama naya adhikāriṇām 
MBjanmamaranavicaaraHK-513	saṃvṛtanijasadācārāṇāṃ lokaprasiddhirakṣāyai	saṃvṛta nija sat ācārāṇām loka prasiddhi rakṣāyai 
MBjanmamaranavicaaraHK-514	tadācārāparityāgo'pi āmnātaḥ tathāhi	tad ācāra aparityāgaḥ upi āmnātaḥ tathā hi 
MBjanmamaranavicaaraHK-515	lokācārasya vicchedo na kartavyaḥ kadācana | guhyaṃ guhyataraṃ	loka ācārasya vicchedaḥ na kartavyaḥ kadācana guhyam guhyataram 
MBjanmamaranavicaaraHK-516	kāryaṃ bāhyaṃ bāhyāntaraṃ tathā ||	kāryam bāhyam bāhya antaram tathā 
MBjanmamaranavicaaraHK-517	iti | anayośca pakṣayorekatarapakṣāvalambane pravaragurava eva	iti anayoḥ ca pakṣayoḥ ekatara pakṣa avalambane pravara guravaḥ eva 
MBjanmamaranavicaaraHK-518	pramāṇam | pitruddeśena ca yāgajapahomopavāsādi gurumārādhya	pramāṇam pitṛ uddeśena ca yāga japa homa upavāsa ādi gurum ārādhya 
MBjanmamaranavicaaraHK-519	avaśyaṃ vidhātavyam ityuktam śrīmahākule -	avaśyam vidhātavyam iti uktam śrī mahākule 
MBjanmamaranavicaaraHK-520	p. 23)	p 
MBjanmamaranavicaaraHK-521	āsūtrite bhāgalupte yatheṣṭarajasānvite | api mantramanāhūya	āsūtrite bhāga lupte yatheṣṭa rajasā anvite api mantram an āhūya 
MBjanmamaranavicaaraHK-522	maṇḍale vidhicodite ||	maṇḍale vidhi codite 
MBjanmamaranavicaaraHK-523	saṃnidhānaṃ prakurvanti mantrāṇāṃ saptakoṭayaḥ | kiṃ punaḥ	saṃnidhānam prakurvanti mantrāṇām sapta koṭayaḥ kim punar 
MBjanmamaranavicaaraHK-524	kaulikāmnāyastatrāhūya prapūjitaḥ ||	kaulika āmnāyaḥ tatra āhūya prapūjitaḥ 
MBjanmamaranavicaaraHK-525	samuddiśya pitṝnbhadre tadānantyāya kalpate ||	samuddiśya pitṝn bhadre tat ānantyāya kalpate 
MBjanmamaranavicaaraHK-526	iti | śrīpracaṇḍabhairave'pi uktam -	iti śrī pracaṇḍabhairave api uktam 
MBjanmamaranavicaaraHK-527	tanuvittāśca ye martyā gurumantraparāyaṇāḥ | viśeṣeṇa	tanu vittāḥ ca ye martyāḥ guru mantra parāyaṇāḥ viśeṣeṇa 
MBjanmamaranavicaaraHK-528	mahāyāgapūjanaṃ prati na kṣamāḥ ||	mahā yāga pūjanam prati na kṣamāḥ 
MBjanmamaranavicaaraHK-529	siddhaliṅgaṃ tadā teṣāṃ pitrarthaṃ pūjayedbudhaḥ | ucitaṃ	siddha liṅgam tadā teṣām pitṛ artham pūjayet budhaḥ ucitam 
MBjanmamaranavicaaraHK-530	pūjanaṃ tatra devānāmapi durlabham ||	pūjanam tatra devānām api durlabham 
MBjanmamaranavicaaraHK-531	kulānyuddharate tatra daśa pūrvāparāṇyapi |	kulāni uddharate tatra daśa pūrva aparāṇi api 
MBjanmamaranavicaaraHK-532	iti | śrībhāgeśamate'pi -	iti 
MBjanmamaranavicaaraHK-533	viṣasarpāgnyapasmārakṣudhātyaśanabandhanaiḥ |	viṣa sarpa agni apasmāra kṣudhā atyaśana bandhanaiḥ 
MBjanmamaranavicaaraHK-534	caṇḍālodakanirghātarājaśāsanataskaraiḥ ||	caṇḍāla udaka nirghāta rāja śāsana taskaraiḥ 
MBjanmamaranavicaaraHK-535	nidāghaśītaśakaṭalūtoṣitamahāvrajaiḥ |	nidāgha śīta śakaṭa lūtā uṣita mahā vrajaiḥ 
MBjanmamaranavicaaraHK-536	brāhmaṇamlecchapāṣaṇḍinirmūloḍḍāmarakramaiḥ ||	brāhmaṇa mleccha pāṣaṇḍi nirmūla uḍḍāmara kramaiḥ 
MBjanmamaranavicaaraHK-537	ye hatāḥ pāpakarmāṇo mitradroharatāśca ye |	ye hatāḥ pāpa karmāṇaḥ mitra droha ratāḥ ca ye 
MBjanmamaranavicaaraHK-538	svāmidrohakṛtāścānye ye tathātmopaghātakāḥ ||	svāmi droha kṛtāḥ ca anye ye tathā ātma upaghātakāḥ 
MBjanmamaranavicaaraHK-539	gurviṇyo duścaritrāśca prasavena hatāśca yāḥ |	gurviṇyaḥ duścaritrāḥ ca prasavena hatāḥ ca yāḥ 
MBjanmamaranavicaaraHK-540	teṣāmuddharaṇopāyo nānyo'sti varavarṇini ||	teṣām uddharaṇa upāyaḥ na anyaḥ asti varavarṇini 
MBjanmamaranavicaaraHK-541	vinā yāgaṃ vinā homaṃ vinā mūrtiparigraham | vinā	vinā yāgam vinā homam vinā mūrti parigraham vinā 
MBjanmamaranavicaaraHK-542	mahājālavidhiprayogāhṛtapudgalam ||	mahā jāla vidhi prayoga āhṛta pudgalam 
MBjanmamaranavicaaraHK-543	mṛtoddharaṇasaṃjñāṃ ca dīkṣāṃ sarvādhvavartinīm |	mṛtoddharaṇa saṃjñām ca dīkṣām sarva adhva vartinīm 
MBjanmamaranavicaaraHK-544	p. 24)	p 
MBjanmamaranavicaaraHK-545	iti | tadayaṃ tāvat ūrdhvaśāsanavartināṃ kramaḥ | itareṣāṃ tu	iti tat ayam tāvat ūrdhva śāsana vartinām kramaḥ itareṣām tu 
MBjanmamaranavicaaraHK-546	svaśāstrasamayopanyastānuṣṭhānameva śreyaḥ tadalamanena | evaṃ	sva śāstra samaya upanyasta anuṣṭhānam eva śreyaḥ tat alam anena evam 
MBjanmamaranavicaaraHK-547	samanantarodīritayā nītyā janmamaraṇaprabandhasaṃbandham	samanantara udīritayā nītyā janma maraṇa prabandha saṃbandham 
MBjanmamaranavicaaraHK-548	avadhārya akṛtrimasvarūpaparāmarśanena jīvanmuktimāsādya	avadhārya akṛtrima sva rūpa parāmarśanena jīvanmuktim āsādya 
MBjanmamaranavicaaraHK-549	kṛtakṛtyatāmālambante santaḥ | yathoktam -	kṛtakṛtya tām ālambante santaḥ yathā uktam 
MBjanmamaranavicaaraHK-550	viditamatisatattvāḥ saṃvidambhonidhānā-	vidita mati sa tattvāḥ saṃvid ambhaḥ nidhānā 
MBjanmamaranavicaaraHK-551	dacalahṛdayavīryākarṣaniṣpīḍanottham | amṛtamiti nigīrṇe	amṛtam iti nigīrṇe 
MBjanmamaranavicaaraHK-552	kālakūṭe'pi devā yadi pibata tadānīṃ niścitaṃ vaḥ śivatvam	devāḥ yadi pibata tadānīm niścitam vaḥ śiva tvam 
MBjanmamaranavicaaraHK-553	iti |	iti 
MBjanmamaranavicaaraHK-554	śrīmadyogeśvarācāryaprasādāsāditasthitiḥ |	                   
MBjanmamaranavicaaraHK-555	vāmadevaścakāredaṃ janmamṛtyuvicāraṇam ||	vāmadevaḥ cakāra idam janmamṛtyuvicāraṇam 
MBjanmamaranavicaaraHK-556	abhinavamadamantharā purandhrī madhusamaye madhurāśca gītibandhāḥ	abhinava mada mantharā purandhrī madhu samaye madhurāḥ ca gīti bandhāḥ 
MBjanmamaranavicaaraHK-557	| bata bata hṛdayaṃ haranti vāco lalitapadāśca	bata bata hṛdayam haranti vācaḥ lalita padāḥ ca 
MBjanmamaranavicaaraHK-558	rahasyavastugarbhāḥ ||	rahasya vastu garbhāḥ 
MBjanmamaranavicaaraHK-559	samāpto'yaṃ janmamaraṇavicārākhyo granthaḥ ||	samāptā iyam janmamaraṇavicāra ākhyaḥ granthaḥ 
MBjanmamaranavicaaraHK-560	p. 25)	p 
MBjanmamaranavicaaraHK-561	kṛtistatrabhavanmahāmāheśvarācāryavaryaśrīmadbhaṭṭavāmadevasy	kṛtiḥ tatrabhavat mahā māheśvara ācārya varya śrīmat bhaṭṭa vāmadevasya 
MBjanmamaranavicaaraHK-562	a ||	a 
MBjanmamaranavicaaraHK-563	sadvidyānāṃ saṃśraye granthavidvad- vyūhe hrāsaṃ	sat vidyānām saṃśraye grantha vid vat vyūhe hrāsam 
MBjanmamaranavicaaraHK-564	kālavṛttyopayāte | tattatsaddharmoddidhīrṣaikatāna-	kāla vṛttyā upayāte tad tad saddharma uddidhīrṣā ekatāna 
MBjanmamaranavicaaraHK-565	satprekṣaujaḥśālinā karmavṛttyai || 2 ||	sat prekṣā ojaḥ śālinā karma vṛttyai 
MBjanmamaranavicaaraHK-566	śrīmatkaśmīrādhirājena mukhyai - rdharmodyuktairmantribhiḥ	śrīmat kaśmīra adhirājena mukhyaiḥ dharma udyuktaiḥ mantribhiḥ 
MBjanmamaranavicaaraHK-567	svairvivecya | pratyaṣṭhāpi jñānavijñānagarbha- granthoddhṛtyai	svaiḥ vivecya pratyaṣṭhāpi jñāna vijñāna garbha grantha uddhṛtyai 
MBjanmamaranavicaaraHK-568	mukhyakāryālayo yaḥ || 2 ||	mukhya kārya ālayaḥ yaḥ 
MBjanmamaranavicaaraHK-569	tatrājīvaṃ nirviśadbhirmukunda- rāmādhyakṣatvāśritaiḥ	tatra ājīvam nirviśadbhiḥ mukunda rāma adhyakṣa tva āśritaiḥ 
MBjanmamaranavicaaraHK-570	sadbhireṣaḥ | pūrtyā śuddhyā vyākhyayā saṃskṛtaḥ stāt-	sadbhiḥ eṣaḥ pūrtyā śuddhyā vyākhyayā saṃskṛtaḥ stād 
MBjanmamaranavicaaraHK-571	pūrṇo granthaḥ śreyase sajjanānām || 3 ||	pūrṇaḥ granthaḥ śreyase sat janānām 
MBjanmamaranavicaaraHK-572	tilakam ||	tilakam 
MBjanmamaranavicaaraHK-573	śrīsvātmacidamṛtavapuḥśaṃkarārpaṇaṃ bhūyāt ||	                  
MBjanmamaranavicaaraHK-574	MUKTABODHA INDOLOGICAL RESEARCH INSTITUTE©2011 Muktabodha Indological Research Institute  All Rights Reserved.E-texts may be viewed only online or downloaded for private study.E-texts may not, under any circumstances, be copied, republished,reproduced, distributed or sold, either in original or altered form, withoutthe express permission of Muktabodha Indological Research Institute in writing.Data-entered by the staff of Muktabodha under the direction of Mark S. G. Dyczkowski.	muktabodha indological research muktabodha indological research institute all rights reserved texts may be viewed only online or downloaded for private studye texts may not under any circumstances be copied republished reproduced distributed or sold either in original or altered form withoutthe express permission of muktabodha indological research institute in writing data entered by the staff of muktabodha under the direction of mark s g dyczkowski 
