segmentnr	original	analyzed
MBkaamadhenutantraHK-0	Muktabodha E-text in UTF-8	muktabodha etext in utf
MBkaamadhenutantraHK-1	###########################################################################MUKTABODHA INDOLOGICAL RESEARCH INSTITUTEwww.muktabodha.org©2011 Muktabodha Indological Research Institute  All Rights Reserved.E-texts may be viewed only online or downloaded for private study.E-texts may not, under any circumstances, be copied, republished,reproduced, distributed or sold, either in original or altered form, withoutthe express permission of Muktabodha Indological Research Institute in writing.Data-entered by the staff of Muktabodha under the direction of Mark S. G. Dyczkowski.Catalog number : M00133	muktabodha indological research muktabodha indological research institute all rights reserved texts may be viewed only online or downloaded for private studye texts may not under any circumstances be copied republished reproduced distributed or sold either in original or altered form withoutthe express permission of muktabodha indological research institute in writing data entered by the staff of muktabodha under the direction of mark s g dyczkowskicatalog number  /
MBkaamadhenutantraHK-2	Uniform title: kāmadhenutantra	uniform title kāmadhenutantra 
MBkaamadhenutantraHK-3	Editor : r m caṭṭopādhyāya	r caṭṭa upādhyāya 
MBkaamadhenutantraHK-4	Description: Transcribed by the staff of Muktabodha.	description transcribed by the staff of muktabodha 
MBkaamadhenutantraHK-5	Notes: Transcribed by the staff of Muktabodha under the supervision of Mark S. G. Dyczkowski.	notes transcribed by the staff muktabodha under the supervision of mark s g dyczkowski 
MBkaamadhenutantraHK-6	Revision 0: Sept. 22, 2008	revision 
MBkaamadhenutantraHK-7	Publisher : unknown-pree 1900 Bengali Script	publisher unknownpree bengali script 
MBkaamadhenutantraHK-8	Publication country : India	publication country india 
MBkaamadhenutantraHK-9	oṃ namaḥ paradevatāyai	om namaḥ para devatāyai 
MBkaamadhenutantraHK-10	kāmadhenutantram	kāmadhenutantram 
MBkaamadhenutantraHK-11	prathamaḥ paṭalaḥ	prathamaḥ paṭalaḥ 
MBkaamadhenutantraHK-12	śrīpārvatī uvāca	śrī pārvatī uvāca 
MBkaamadhenutantraHK-13	devadeva mahādeva sarvāgamaviśārada |	devadeva mahādeva sarva āgama viśārada 
MBkaamadhenutantraHK-14	adhunā devadeveśa pañcāśadvarṇamuttamam || 1/1 ||	adhunā devadeveśa pañcāśat varṇam uttamam 
MBkaamadhenutantraHK-15	tattvarūpaṃ mahādeva kathayasva dayānidhe |	tattva rūpam mahādeva kathayasva dayā nidhe 
MBkaamadhenutantraHK-16	kṛpayā kathayeśāna yadyahaṃ tava vallabhā || 1/2 ||	kṛpayā kathaya īśāna yadi aham tava vallabhā   
MBkaamadhenutantraHK-17	śrīmahādeva uvāca	śrī mahādevaḥ uvāca 
MBkaamadhenutantraHK-18	adhunā saṃpravakṣyāmi rahasyamatigopanam |	adhunā saṃpravakṣyāmi rahasya mati gopanam 
MBkaamadhenutantraHK-19	yena vijñātamātreṇa jīvanmukto bhavennaraḥ || 1/3 ||	yena vijñāta mātreṇa jīvanmuktaḥ bhavet naraḥ 
MBkaamadhenutantraHK-20	ajñātvā mantratattvāni mahāvidyāṃ japettu yaḥ |	a jñātvā mantra tattvāni mahāvidyām japet tu yaḥ 
MBkaamadhenutantraHK-21	sarvaṃ tasya vṛthā devi kiṃ tasya japapūjanaiḥ || 1/4 ||	sarvam tasya vṛthā devi kim tasya japa pūjanaiḥ 
MBkaamadhenutantraHK-22	dhyānāvadhāraṇe caiva tathā yogasamādhinā |	dhyāna avadhāraṇe ca eva tathā yoga samādhinā 
MBkaamadhenutantraHK-23	varṇajñānaṃ yadā nāsti kiṃ tasya japapūjanaiḥ || 1/5 ||	varṇa jñānam yadā nā asti kim tasya japa pūjanaiḥ 
MBkaamadhenutantraHK-24	mama kaṇṭhe sthitaṃ bījaṃ pañcāśadvarṇamadbhutam |	mama kaṇṭhe sthitam bījam pañcāśat varṇam adbhutam 
MBkaamadhenutantraHK-25	nānāvarṇayutaṃ śuddhaṃ tantrāṇāṃ sāramuttamam || 1/6 ||	nānā varṇa yutam śuddham tantrāṇām sāram uttamam 
MBkaamadhenutantraHK-26	pañcāśanmātṛkāṃ devīṃ nānāvidyāmayīṃ sadā |	pañcāśat mātṛkām devīm nānā vidyā mayīm sadā 
MBkaamadhenutantraHK-27	nānāvidyāmayīṃ devīṃ mahāvidyāmayīṃ tathā || 1/7 ||	nānā vidyā mayīm devīm mahā vidyā mayīm tathā 
MBkaamadhenutantraHK-28	sarvavarṇamayīṃ devīṃ sarvadevamayīṃ parām |	sarva varṇa mayīm devīm sarva deva mayīm parām 
MBkaamadhenutantraHK-29	sarvadevamayīṃ saumyāṃ brahmāṇḍajananīṃ parām || 1/8 ||	sarva deva mayīm saumyām brahmāṇḍa jananīm parām 
MBkaamadhenutantraHK-30	praṇamya bahudhā bhaktyā nigadāmi śṛṇu priye |	praṇamya bahudhā bhaktyā nigadāmi śṛṇu priye 
MBkaamadhenutantraHK-31	akārādikṣakārāntā mātṛkā bījarūpiṇī || 1/9 ||	akāra ādi kṣakāra antā mātṛkā bīja rūpiṇī 
MBkaamadhenutantraHK-32	visargaścaiva binduśca triśaktibrahmavigrahaḥ |	visargaḥ ca eva binduḥ ca tri śakti brahma vigrahaḥ 
MBkaamadhenutantraHK-33	varṇāttu jāyate brahmā tathā viṣṇuḥ prajāyate || 1/10 ||	varṇāt tu jāyate brahmā tathā viṣṇuḥ prajāyate 
MBkaamadhenutantraHK-34	rudraśca jāyate devi jagatsaṃhārakārakaḥ |	rudraḥ ca jāyate devi jagat saṃhāra kārakaḥ 
MBkaamadhenutantraHK-35	mama kaṇṭhasthitā yā sā śāradā vāmalocanā || 1/11 ||	mama kaṇṭha sthitā yā sā śāradā vāma locanā 
MBkaamadhenutantraHK-36	tasyā garbhasthitā devi bījāni vividhāni ca |	tasyāḥ garbha sthitāḥ devi bījāni vividhāni ca 
MBkaamadhenutantraHK-37	vidhṛtya kaṇṭhadeśe tu śivo'haṃ kamalānane || 1/12 ||	vidhṛtya kaṇṭha deśe tu śiva ūham kamala ānane 
MBkaamadhenutantraHK-38	śṛṇu tattvamakārasya atigopyaṃ varānane |	śṛṇu tattvam akārasya ati gopyam varānane 
MBkaamadhenutantraHK-39	śaraccandrapratīkāśaṃ pañcakoṣamayaṃ sadā || 1/13 ||	śarad candra pratīkāśam pañca koṣa mayam sadā 
MBkaamadhenutantraHK-40	pañcadevamayaṃ varṇaṃ śaktitrayasamanvitam |	pañca deva mayam varṇam śakti traya samanvitam 
MBkaamadhenutantraHK-41	nirguṇaṃ triguṇopetaṃ svayaṃ kaivalyamūrtimān ||	nirguṇam triguṇa upetam svayam kaivalya mūrtimān 
MBkaamadhenutantraHK-42	bindutattvamayaṃ varṇaṃ svayaṃ prakṛtirūpiṇī || 1/14 ||	bindu tattva mayam varṇam svayam prakṛti rūpiṇī 
MBkaamadhenutantraHK-43	iti śrīkāmadhenutantre devadevīsaṃvāde prathamaḥ paṭalaḥ ||	iti śrī kāmadhenutantre devadevī saṃvāde prathamaḥ paṭalaḥ 
MBkaamadhenutantraHK-44	dvitīyaḥ paṭalaḥ	dvitīyaḥ paṭalaḥ 
MBkaamadhenutantraHK-45	śrīmahādeva uvāca	śrī mahādevaḥ uvāca 
MBkaamadhenutantraHK-46	ākāraṃ paramāścaryaṃ śaṅkhajyotirmayaṃ priye |	ākāram parama āścaryam śaṅkha jyotiḥ mayam priye 
MBkaamadhenutantraHK-47	brahmaviṣṇumayaṃ varṇaṃ tathā rudraṃ svayaṃ priye || 2/1 ||	brahma viṣṇu mayam varṇam tathā rudram svayam priye 
MBkaamadhenutantraHK-48	pañcaprāṇamayaṃ varṇaṃ svayaṃ paramakuṇḍalī |	pañca prāṇa mayam varṇam svayam parama kuṇḍalī 
MBkaamadhenutantraHK-49	ikāraṃ paramānandaṃ sugandhakusumacchavim || 2/2 ||	ikāram parama ānandam sugandha kusuma chavim 
MBkaamadhenutantraHK-50	haribrahmamayaṃ varṇaṃ sadā rudrayutaṃ priye |	hari brahma mayam varṇam sadā rudra yutam priye 
MBkaamadhenutantraHK-51	sadā śaktimayaṃ devi gurubrahma svayaṃ tathā || 2/3 ||	sadā śakti mayam devi guru brahma svayam tathā 
MBkaamadhenutantraHK-52	sadāśivamayaṃ varṇaṃ paraṃbrahma samanvitam |	sadāśiva mayam varṇam paraṃbrahma samanvitam 
MBkaamadhenutantraHK-53	haribrahmātmakaṃ varṇaṃ guṇatrayasamanvitam || 2/4 ||	hari brahma ātmakam varṇam guṇatraya samanvitam 
MBkaamadhenutantraHK-54	ikāraṃ parameśāni mūrtirvai kuṇḍalī svayam |	ikāram parameśāni mūrtiḥ vai kuṇḍalī svayam 
MBkaamadhenutantraHK-55	īkāraṃ parameśāni svayaṃ paramakuṇḍalī || 2/5 ||	īkāram parameśāni svayam parama kuṇḍalī 
MBkaamadhenutantraHK-56	brahmaviṣṇumayaṃ varṇaṃ tathā rudramayaṃ sadā |	brahma viṣṇu mayam varṇam tathā rudra mayam sadā 
MBkaamadhenutantraHK-57	pañcadevamayaṃ varṇaṃ pītavidyullatākṛtim || 2/6 ||	pañca deva mayam varṇam pīta vidyut latā ākṛtim 
MBkaamadhenutantraHK-58	caturjñānamayaṃ varṇaṃ pañcaprāṇamayaṃ sadā |	catur jñāna mayam varṇam pañca prāṇa mayam sadā 
MBkaamadhenutantraHK-59	ukāraṃ parameśāni tāra kuṇḍalīnī svayam || 2/7 ||	ukāram parameśāni tāra kuṇḍalīnī svayam 
MBkaamadhenutantraHK-60	pītacampakasaṃkāśaṃ paṃcadevamayaṃ sadā |	pīta campaka saṃkāśam paṃca deva mayam sadā 
MBkaamadhenutantraHK-61	pañcaprāṇamayaṃ devi caturvargapradāyakam || 2/8 ||	pañca prāṇa mayam devi caturvarga pradāyakam 
MBkaamadhenutantraHK-62	akāraṃ devadeveśi bījaṃ paramadurlabham |	akāram devadeveśi bījam parama durlabham 
MBkaamadhenutantraHK-63	śaṅkhakundasamākāraṃ svayaṃ paramakuṇḍalī || 2/9 ||	śaṅkha kunda sama ākāram svayam parama kuṇḍalī 
MBkaamadhenutantraHK-64	pañcaprāṇamayaṃ varṇaṃ pañcadevamayaṃ sadā |	pañca prāṇa mayam varṇam pañca deva mayam sadā 
MBkaamadhenutantraHK-65	pañcaprāṇayutaṃ varṇaṃ tathā trayaguṇātmakam || 2/10 ||	pañca prāṇa yutam varṇam tathā traya guṇa ātmakam 
MBkaamadhenutantraHK-66	bindutrayayutaṃ varṇaṃ pītavidyullatā yathā |	bindu traya yutam varṇam pīta vidyut latā yathā 
MBkaamadhenutantraHK-67	dharmārthakāmamokṣaṃ ca sadā sukhapradāyakam || 2/11 ||	dharma artha kāma mokṣam ca sadā sukha pradāyakam 
MBkaamadhenutantraHK-68	ṛkāraṃ parameśāni kuṇḍalī mūrttimān svayam |	ṛkāram parameśāni kuṇḍalī mūrttimān svayam 
MBkaamadhenutantraHK-69	atra brahmā ca viṣṇuśca rudraścaiva varānane || 2/12 ||	atra brahmā ca viṣṇuḥ ca rudraḥ ca eva varānane  
MBkaamadhenutantraHK-70	sadāśivayutaṃ varṇaṃ sadā īśvarasaṃyutam |	sadāśiva yutam varṇam sadā īśvara saṃyutam 
MBkaamadhenutantraHK-71	pañcaprāṇamayaṃ varṇaṃ caturjñānamayaṃ sadā || 2/13 ||	pañca prāṇa mayam varṇam catur jñāna mayam sadā 
MBkaamadhenutantraHK-72	raktavidyullatākāraṃ ṛkāraṃ praṇamāmyaham |	rakta vidyut latā ākāram ṛkāram praṇamāmi aham 
MBkaamadhenutantraHK-73	ṝkāraṃ parameśāni svayaṃ paramakuṇḍalī || 2/14 ||	ṝkāram parameśāni svayam parama kuṇḍalī 
MBkaamadhenutantraHK-74	pītavidyullatākāraṃ pañcadevamayaṃ sadā |	pīta vidyut latā ākāram pañca deva mayam sadā 
MBkaamadhenutantraHK-75	caturjñānamayṃ varṇaṃ pañcaprāṇamayaṃ sadā || 2/15 ||	catur jñāna mayam varṇam pañca prāṇa mayam sadā 
MBkaamadhenutantraHK-76	triśaktisahitaṃ varṇaṃ praṇamāmi sadā priye |	tri śakti sahitam varṇam praṇamāmi sadā priye 
MBkaamadhenutantraHK-77	ḷkāraṃ cañcalāpāṅgi kuṇḍalī paradevatā || 2/16 ||	ḷkāram cañcalāpāṅgi kuṇḍalī para devatā 
MBkaamadhenutantraHK-78	atra brahmādayaḥ sarve tiṣṭhanti satataṃ priye |	atra brahma ādayaḥ sarve tiṣṭhanti satatam priye 
MBkaamadhenutantraHK-79	pañcadevamayaṃ varṇaṃ caturjñānamayaṃ sadā || 2/17 ||	pañca deva mayam varṇam catur jñāna mayam sadā 
MBkaamadhenutantraHK-80	pañcaprāṇayutaṃ varṇaṃ tathā guṇatrayātmakam |	pañca prāṇa yutam varṇam tathā guṇa traya ātmakam 
MBkaamadhenutantraHK-81	bindutrayātmakaṃ varṇaṃ pītavidyullatā yathā || 2/18 ||	bindu traya ātmakam varṇam pīta vidyut latā yathā 
MBkaamadhenutantraHK-82	ḹkāraṃ parameśāni pūrṇacandrasamapramam |	ḹkāram parameśāni pūrṇa candra sama pramam 
MBkaamadhenutantraHK-83	pañcadevātmakaṃ varṇaṃ pañcaprāṇātmakaṃ sadā || 2/19 ||	pañca deva ātmakam varṇam pañca prāṇa ātmakam sadā 
MBkaamadhenutantraHK-84	guṇatrayātmakaṃ varṇaṃ tathā bindutrayātmakam |	guṇa traya ātmakam varṇam tathā bindu traya ātmakam 
MBkaamadhenutantraHK-85	caturvargapradaṃ devi svayaṃ paramakuṇḍalī || 2/20 ||	caturvarga pradam devi svayam parama kuṇḍalī 
MBkaamadhenutantraHK-86	ekāraṃ paramaṃ divyaṃ brahmaviṣṇuśivātmakam |	ekāram paramam divyam brahma viṣṇu śiva ātmakam 
MBkaamadhenutantraHK-87	bandhūkakusumaprakhyaṃ pañcadevamayaṃ sadā || 2/21 ||	bandhūka kusuma prakhyam pañca deva mayam sadā 
MBkaamadhenutantraHK-88	pañcaprāṇātmakaṃ varṇaṃ tathā bindutrayātmakam |	pañca prāṇa ātmakam varṇam tathā bindu traya ātmakam 
MBkaamadhenutantraHK-89	caturvargapradaṃ devi svayaṃ paramakuṇḍalī || 2/22 ||	caturvarga pradam devi svayam parama kuṇḍalī 
MBkaamadhenutantraHK-90	iti śrīkāmadhenutantre dvitīyaḥ paṭalaḥ ||	iti śrī kāmadhenutantre dvitīyaḥ paṭalaḥ 
MBkaamadhenutantraHK-91	tṛtīyaḥ paṭalaḥ	tṛtīyaḥ paṭalaḥ 
MBkaamadhenutantraHK-92	aikāraṃ paramaṃ divyaṃ mahākuṇḍalinī svayam |	aikāram paramam divyam mahā kuṇḍalinī svayam 
MBkaamadhenutantraHK-93	koṭicandrapratīkāśaṃ pañcaprāṇamayaṃ sadā || 3/1 ||	koṭi candra pratīkāśam pañca prāṇa mayam sadā 
MBkaamadhenutantraHK-94	brahmaviṣṇumayaṃ varṇaṃ tathā rudramayaṃ priye |	brahma viṣṇu mayam varṇam tathā rudra mayam priye 
MBkaamadhenutantraHK-95	sadāśivamayaṃ varṇaṃ bindutrayasamanvitam || 3/2 ||	sadāśiva mayam varṇam bindu traya samanvitam 
MBkaamadhenutantraHK-96	okāraṃ cañcalāpāṅgi pañcadevamayaṃ sadā |	okāram cañcalāpāṅgi pañca deva mayam sadā 
MBkaamadhenutantraHK-97	raktavidyullatākāraṃ triguṇātmānamīśvaram || 3/3 ||	rakta vidyut latā ākāram triguṇa ātmānam īśvaram 
MBkaamadhenutantraHK-98	pañcaprāṇamayaṃ varṇaṃ namāmi devamātaram |	pañca prāṇa mayam varṇam namāmi devamātaram 
MBkaamadhenutantraHK-99	etadvarṇaṃ maheśāni svayaṃ paramakuṇḍalī || 3/4 ||	etad varṇam maheśāni svayam parama kuṇḍalī 
MBkaamadhenutantraHK-100	raktavidyullatākāraṃ aukāraṃ kuṇḍalā svayam |	rakta vidyut latā ākāram aukāram kuṇḍalā svayam 
MBkaamadhenutantraHK-101	atra brahmādayaḥ sarve tiṣṭhanti satataṃ priye || 3/5 ||	atra brahma ādayaḥ sarve tiṣṭhanti satatam priye   
MBkaamadhenutantraHK-102	pañcaprāṇamayaṃ varṇaṃ sadāśivamayaṃ sadā |	pañca prāṇa mayam varṇam sadāśiva mayam sadā 
MBkaamadhenutantraHK-103	sadā īśvarasaṃyuktaṃ caturvargapradāyakam || 3/6 ||	          
MBkaamadhenutantraHK-104	aṃkāraṃ bindusaṃyuktaṃ pītavidyutsamaprabham |	aṃkāram bindu saṃyuktam pīta vidyut sama prabham 
MBkaamadhenutantraHK-105	pañcaprāṇātmakaṃ varṇaṃ brahmādidevatāmayam || 3/7 ||	pañca prāṇa ātmakam varṇam brahma ādi devatā mayam 
MBkaamadhenutantraHK-106	sarvajñānamayaṃ varṇaṃ bindutrayasamanvitam |	sarva jñāna mayam varṇam bindu traya samanvitam 
MBkaamadhenutantraHK-107	śaktitrayamayaṃ varṇaṃ svayaṃ paramakuṇḍalī || 3/8 ||	śakti traya mayam varṇam svayam parama kuṇḍalī 
MBkaamadhenutantraHK-108	aḥkāraṃ parameśāni visargasahitaṃ sadā |	aḥkāram parameśāni visarga sahitam sadā 
MBkaamadhenutantraHK-109	aḥkāraṃ parameśāni raktavidyutprabhāmayam || 3/9 ||	aḥkāram parameśāni rakta vidyut prabhā mayam 
MBkaamadhenutantraHK-110	pañcadevamayo varṇaḥ pañcaprāṇamayaḥ sadā |	pañca deva mayaḥ varṇaḥ pañca prāṇa mayaḥ sadā 
MBkaamadhenutantraHK-111	sarvajñānamayo varṇa ātmāditattvasaṃyutaḥ || 3/10 ||	sarva jñāna mayaḥ varṇaḥ ātma ādi tattva saṃyutaḥ 
MBkaamadhenutantraHK-112	bindutrayamayo varṇaḥ śaktitrayamayaḥ sadā |	bindu traya mayaḥ varṇaḥ śakti traya mayaḥ sadā 
MBkaamadhenutantraHK-113	kiśoravayasaḥ sarvā gītavādyāditatparāḥ ||	kiśora vayasaḥ sarvāḥ gīta vādya ādi tatparāḥ 
MBkaamadhenutantraHK-114	śivasya yuvatī etā mūrttimat kuṇḍalī svayam || 3/11 ||	śivasya yuvatī etā mūrttimat kuṇḍalī svayam 
MBkaamadhenutantraHK-115	adhunā saṃpravakṣyāmi kāratattvamuttamam |	adhunā saṃpravakṣyāmi kāra tattvam uttamam 
MBkaamadhenutantraHK-116	rahasyaṃ paramāścaryaṃ trailokyānāṃ ca saṃśṛṇu || 3/12 ||	rahasyam parama āścaryam trailokyānām ca saṃśṛṇu 
MBkaamadhenutantraHK-117	vāmarekhā bhaved brahmā viṣṇurdakṣiṇavīthikā |	vāma rekhā bhavet brahmā viṣṇuḥ dakṣiṇa vīthikā 
MBkaamadhenutantraHK-118	adhorekhā bhavedrudro mātrā sākṣānmaheśvarī || 3/13 ||	adhorekhāḥ bhavet rudraḥ mātrā sākṣāt maheśvarī   
MBkaamadhenutantraHK-119	kuṇḍalī aṅkuśākārā madhye śūnyaḥ sadāśivaḥ |	kuṇḍalī aṅkuśa ākārā madhye śūnyaḥ sadāśivaḥ 
MBkaamadhenutantraHK-120	javāyāvakasaṃkāśā bāmarekhā varānane || 3/14 ||	javāya avaka saṃkāśā bāma rekhā varānane 
MBkaamadhenutantraHK-121	śaraccandrapratīkāśā dakṣarekhā ca mūrtimān |	śarad candra pratīkāśā dakṣarekhā ca mūrtimān 
MBkaamadhenutantraHK-122	adhorekhā varārohe mahāmārakatadyutiḥ || 3/15 ||	adhas rekhā varārohe mahā mārakata dyutiḥ 
MBkaamadhenutantraHK-123	śaṅkhakundasamā kīrtirmātrā sākṣāt sarasvatī |	śaṅkha kunda samā kīrtiḥ mātrā sākṣāt sarasvatī 
MBkaamadhenutantraHK-124	kuṇḍalī aṅkuśā yā tu koṭividyullatākṛtiḥ || 3/16 ||	kuṇḍalī aṅkuśā yā tu koṭi vidyut latā ākṛtiḥ 
MBkaamadhenutantraHK-125	koṭicandrapratikāśā madhye śūnyaḥ sadāśivaḥ |	koṭi candra pratikāśā madhye śūnyaḥ sadāśivaḥ 
MBkaamadhenutantraHK-126	śūnyagarbhe sthitā kālī kaivalyapadadāyinī || 3/17 ||	            
MBkaamadhenutantraHK-127	kakārājjāyate sarvaṃ kāmaṃ kaivalyameva ca |	kakārāt jāyate sarvam kāmam kaivalyam eva ca 
MBkaamadhenutantraHK-128	arthaśca jāyate devi tathā dharmaśca nānyathā || 3/18 ||	arthaḥ ca jāyate devi tathā dharmaḥ ca na anyathā 
MBkaamadhenutantraHK-129	kakāraḥ sarvavarṇānāṃ mūlaprakṛtireva ca |	kakāraḥ sarva varṇānām mūlaprakṛtiḥ eva ca 
MBkaamadhenutantraHK-130	kakāraḥ kāmadā kāmarūpiṇī sphuradavyayā || 3/19 ||	kakāraḥ kāma dā kāmarūpiṇī sphurat avyayā 
MBkaamadhenutantraHK-131	kāminī yā maheśāni svayaṃ prakṛtisundarī |	kāminī yā maheśāni svayam prakṛti sundarī 
MBkaamadhenutantraHK-132	mātā sā sarvadevānāṃ kaivalyapadadāyinī || 3/20 ||	mātā sā sarva devānām kaivalya pada dāyinī 
MBkaamadhenutantraHK-133	ūrdhvakoṇe sthitā kāmā brahmaśaktiritīritā |	ūrdhva koṇe sthitā kāmā brahmaśaktiḥ iti īritā 
MBkaamadhenutantraHK-134	vāmakoṇe sthitā jyeṣṭhā viṣṇuśaktiritīritā || 3/21 ||]	vāma koṇe sthitā jyeṣṭhā viṣṇuśaktiḥ iti īritā 
MBkaamadhenutantraHK-135	dakṣakoṇe sthito bindū raudrīsaṃhārarūpiṇī |	               
MBkaamadhenutantraHK-136	jñānārthā sātu cārvaṅgi kena catuṣṭayātmikā || 3/22 ||	jñāna arthā sā tu cāru aṅgi kena catuṣṭaya ātmikā 
MBkaamadhenutantraHK-137	icchāśaktirbhaved brahmā vipṇuśca jñānaśaktimān |	icchā śaktiḥ bhavet brahmā vipṇuḥ ca jñāna śaktimān 
MBkaamadhenutantraHK-138	kriyāśaktirbhaved rudraḥ sarvaṃ prakṛtimūrttimān || 3/23 ||	kriyāśaktiḥ bhavet rudraḥ sarvam prakṛti mūrttimān 
MBkaamadhenutantraHK-139	ātmavidyāśivaistattvaiḥ sadāsārāpratiṣṭhitaiḥ |	ātma vidyā śivaiḥ tattvaiḥ sadā sāra apratiṣṭhitaiḥ 
MBkaamadhenutantraHK-140	āsanaṃ tripurādevyāḥ kakāraṃ pañcadevatām || 3/24 ||	āsanam tripurā devyāḥ kakāram pañca devatām 
MBkaamadhenutantraHK-141	īśvaro yastu deveśi trikoṇe tasya saṃsthitiḥ |	īśvaraḥ yaḥ tu deveśi trikoṇe tasya saṃsthitiḥ 
MBkaamadhenutantraHK-142	trikoṇametat kathitaṃ yonimaṇḍalamuttamam || 3/25 ||	trikoṇam etat kathitam yoni maṇḍalam uttamam 
MBkaamadhenutantraHK-143	kevalaṃ prapade yasyāḥ kāminī sā prakīrttitā |	kevalam prapade yasyāḥ kāminī sā prakīrttitā 
MBkaamadhenutantraHK-144	oṃ śayanāgārasindūrasadṛśīṃ kāminīṃ parām || 3/26 ||	om śayana āgāra sindūra sadṛśīm kāminīm parām 
MBkaamadhenutantraHK-145	caturbhujāṃ trinetrāñca bāhuvallīvirājitām |	catur bhujām tri netrām ca bāhu vallī virājitām 
MBkaamadhenutantraHK-146	kadambakorakākārastanadvayavibhūṣitām || 3/27 ||	kadamba koraka ākāra stana dvaya vibhūṣitām 
MBkaamadhenutantraHK-147	ratnakeyūrāṅgadaiśca bhūṣaṇairupaśobhitām |	ratna keyūra aṅgadaiḥ ca bhūṣaṇaiḥ upaśobhitām 
MBkaamadhenutantraHK-148	ratnahāraiḥ puṣpahāraiḥ śobhitāṃ parameśvarīm || 3/28 ||	ratna hāraiḥ puṣpa hāraiḥ śobhitām parameśvarīm 
MBkaamadhenutantraHK-149	evaṃ hi kāminīṃ jñātvā kakāraṃ daśadhā japet |	evam hi kāminīm jñātvā kakāram daśadhā japet 
MBkaamadhenutantraHK-150	praphullañca tato dhyātvā japasya phalabhāg bhavet |	praphullañca tatas dhyātvā japasya phala bhāj bhavet 
MBkaamadhenutantraHK-151	etatte kathitaṃ devi kakāratattvamuttamam  || 3/29 ||	etat te kathitam devi kakāra tattvam uttamam 
MBkaamadhenutantraHK-152	iti śrīkāmadhenutantre devadevīsaṃvāde tṛtīyaḥ paṭalaḥ ||	iti śrī kāmadhenutantre devadevī saṃvāde tṛtīyaḥ paṭalaḥ 
MBkaamadhenutantraHK-153	caturthaḥ paṭalaḥ	caturthaḥ paṭalaḥ 
MBkaamadhenutantraHK-154	śrīmahādeva uvāca	śrī mahādevaḥ uvāca 
MBkaamadhenutantraHK-155	kakāraṃ parameśāni kuṇḍalītrayasaṃyutam |	kakāram parameśāni kuṇḍalī traya saṃyutam 
MBkaamadhenutantraHK-156	khakāraṃ paramāścaryaṃ śaṅkhakundasamaprabham || 4/1 ||	khakāram parama āścaryam śaṅkha kunda sama prabham 
MBkaamadhenutantraHK-157	koṇatrayayutaṃ śūnyaṃ bindutrayasamanvitam |	koṇa traya yutam śūnyam bindu traya samanvitam 
MBkaamadhenutantraHK-158	guṇatrayayutaṃ devi pañcadevamayaṃ sadā || 4/2 ||	guṇatraya yutam devi pañca deva mayam sadā 
MBkaamadhenutantraHK-159	triśaktisaṃyutaṃ varṇaṃ khakāraṃ praṇamāmyaham |	tri śakti saṃyutam varṇam khakāram praṇamāmi aham 
MBkaamadhenutantraHK-160	gakāraṃ parameśāni pañcadevātmakaṃ sadā || 4/3 ||	gakāram parameśāni pañca deva ātmakam sadā 
MBkaamadhenutantraHK-161	nirguṇaṃ triguṇopetaṃ nirīhaṃ nirmalaṃ sadā |	nirguṇam triguṇa upetam nirīham nirmalam sadā 
MBkaamadhenutantraHK-162	pañcaprāṇamayaṃ varṇaṃ sarvaśaktyātmakaṃ priye || 4/4 ||	pañca prāṇa mayam varṇam sarva śakti ātmakam priye 
MBkaamadhenutantraHK-163	aruṇādityasaṅkāśaṃ kuṇḍalīṃ praṇamāmyaham |	aruṇa āditya saṅkāśam kuṇḍalīm praṇamāmi aham 
MBkaamadhenutantraHK-164	ghakāraṃ cañcalāpāṅgi catuṣkoṇātmakaṃ sadā || 4/5 ||	ghakāram cañcala apāṅgi catuṣkoṇa ātmakam sadā 
MBkaamadhenutantraHK-165	pañcadevamayaṃ varṇaṃ aruṇādityasannibham |	pañca deva mayam varṇam aruṇa āditya sannibham 
MBkaamadhenutantraHK-166	nirguṇaṃ triguṇopetaṃ sadā triguṇasaṃyutam || 4/6 ||	nirguṇam triguṇa upetam sadā triguṇa saṃyutam 
MBkaamadhenutantraHK-167	sarvagaṃ sarvadaṃ śāntaṃ ghakāraṃ praṇamāmyaham |	sarvagam sarva dam śāntam ghakāram praṇamāmi aham 
MBkaamadhenutantraHK-168	ṅakāraṃ parameśāni svayaṃ paramakuṇḍalī || 4/7 ||	ṅakāram parameśāni svayam parama kuṇḍalī 
MBkaamadhenutantraHK-169	sarvadavamayaṃ varṇaṃ triguṇaṃ lolalocane |	sarva dava mayam varṇam triguṇam lola locane 
MBkaamadhenutantraHK-170	pañcaprāṇamayaṃ varṇaṃ ṅakāraṃ praṇamāmyaham || 4/8 ||	pañca prāṇa mayam varṇam ṅakāram praṇamāmi aham 
MBkaamadhenutantraHK-171	cavarṇaṃ śṛṇu suśroṇi caturvargapradāyakam |	ca varṇam śṛṇu suśroṇi caturvarga pradāyakam 
MBkaamadhenutantraHK-172	kuṇḍalīsahitaṃ devi svayaṃ paramakuṇḍalī || 4/9 ||	kuṇḍalī sahitam devi svayam parama kuṇḍalī 
MBkaamadhenutantraHK-173	satataṃ kuṇḍalīyuktaṃ pañcadevamayaṃ sadā |	satatam kuṇḍalī yuktam pañca deva mayam sadā 
MBkaamadhenutantraHK-174	pañcaprāṇamayaṃ varṇaṃ pañcaprāṇātmakaṃ sadā || 4/10 ||	pañca prāṇa mayam varṇam pañca prāṇa ātmakam sadā 
MBkaamadhenutantraHK-175	triśaktisahitaṃ varṇaṃ tribindusahitaṃ priye |	tri śakti sahitam varṇam tri bindu sahitam priye 
MBkaamadhenutantraHK-176	chakāraṃ paramāścaryaṃ svayaṃ paramakuṇḍalī || 4/11 ||	chakāram parama āścaryam svayam parama kuṇḍalī 
MBkaamadhenutantraHK-177	satataṃ kuṇḍalīyuktaṃ pañcadevamayaṃ sadā |	satatam kuṇḍalī yuktam pañca deva mayam sadā 
MBkaamadhenutantraHK-178	pañcaprāṇamayaṃ varṇaṃ triśaktisahitaṃ sadā || 4/12 ||	pañca prāṇa mayam varṇam tri śakti sahitam sadā 
MBkaamadhenutantraHK-179	tribindusahitaṃ varṇaṃ sadā īśvarasaṃyutam |	tri bindu sahitam varṇam sadā īśvara saṃyutam 
MBkaamadhenutantraHK-180	pītavidyullatākāraṃ chakāraṃ praṇamāmyaham || 4/13 ||	pīta vidyut latā ākāram śakāram praṇamāmi aham 
MBkaamadhenutantraHK-181	jakāraṃ parameśāni yā svayaṃ madhyakuṇḍalī |	jakāram parameśāni yā svayam madhya kuṇḍalī 
MBkaamadhenutantraHK-182	śaraccandrapratīkāśaṃ sadā triguṇasaṃyutam || 4/14 ||	śarad candra pratīkāśam sadā triguṇa saṃyutam 
MBkaamadhenutantraHK-183	pañcadevamayaṃ varṇaṃ pañcaprāṇamayaṃ sadā |	pañca deva mayam varṇam pañca prāṇa mayam sadā 
MBkaamadhenutantraHK-184	triśaktisahitaṃ varṇaṃ tribindusahitaṃ priye || 4/15 ||	tri śakti sahitam varṇam tri bindu sahitam priye 
MBkaamadhenutantraHK-185	jhakāraṃ parameśāni kuṇḍalī mokṣarūpiṇī |	jhakāram parameśāni kuṇḍalī mokṣa rūpiṇī 
MBkaamadhenutantraHK-186	raktavidyullatākāraṃ sadā triguṇasaṃsthitam || 4/16 ||	rakta vidyut latā ākāram sadā triguṇa saṃsthitam 
MBkaamadhenutantraHK-187	pañcadevamayaṃ varṇaṃ pañcaprāṇātmakaṃ sadā |	pañca deva mayam varṇam pañca prāṇa ātmakam sadā 
MBkaamadhenutantraHK-188	tribindusahitaṃ varṇaṃ triśaktisahitaṃ sadā || 4/17 ||	tri bindu sahitam varṇam tri śakti sahitam sadā 
MBkaamadhenutantraHK-189	sadā īśvarasaṃyuktaṃ ñakāraṃ śṛṇu sundari |	sadā īśvara saṃyuktam ñakāram śṛṇu sundari 
MBkaamadhenutantraHK-190	raktavidyullatākāraṃ svayaṃ paramakuṇḍalī || 4/18 ||	rakta vidyut latā ākāram svayam parama kuṇḍalī 
MBkaamadhenutantraHK-191	pañcadevamayaṃ varṇaṃ pañcaprāṇamayaṃ sadā |	pañca deva mayam varṇam pañca prāṇa mayam sadā 
MBkaamadhenutantraHK-192	triśaktisahitaṃ varṇaṃ tribindusahitaṃ sadā || 4/19 ||	tri śakti sahitam varṇam tri bindu sahitam sadā 
MBkaamadhenutantraHK-193	ṭakāraṃ cañcalāpāṅgi svayaṃ paramakuṇḍalī |	ṭakāram cañcalāpāṅgi svayam parama kuṇḍalī 
MBkaamadhenutantraHK-194	koṭividyullatākāraṃ pañcadevamayaṃ sadā || 4/20 ||	koṭi vidyut latā ākāram pañca deva mayam sadā 
MBkaamadhenutantraHK-195	pañcaprāṇayutaṃ varṇaṃ guṇatrayasamanvitam |	pañca prāṇa yutam varṇam guṇatraya samanvitam 
MBkaamadhenutantraHK-196	triśaktisahitaṃ varṇaṃ tribindusahitaṃ sadā || 4/21 ||	tri śakti sahitam varṇam tri bindu sahitam sadā 
MBkaamadhenutantraHK-197	ṭhakāraṃ cañcalāpāṅgi kuṇḍalī mokṣarūpiṇī |	           
MBkaamadhenutantraHK-198	pītavidyullatākāraṃ sadā triguṇasaṃyutam || 4/22 ||	pīta vidyut latā ākāram sadā triguṇa saṃyutam 
MBkaamadhenutantraHK-199	pañcaprāṇātmakaṃ varṇaṃ pañcaprāṇamayaṃ sadā |	pañca prāṇa ātmakam varṇam pañca prāṇa mayam sadā 
MBkaamadhenutantraHK-200	tribindusahitaṃ varṇaṃ triśaktisahitaṃ sādā || 4/23 ||	tri bindu sahitam varṇam tri śakti sahitam sādā 
MBkaamadhenutantraHK-201	ḍakāraṃ cañcalāpāṅgi sadā triguṇasaṃyutam |	ḍakāram cañcalāpāṅgi sadā triguṇa saṃyutam 
MBkaamadhenutantraHK-202	pañcadevamayaṃ varṇaṃ pañcaprāṇamayaṃ sadā || 4/24 ||	pañca deva mayam varṇam pañca prāṇa mayam sadā 
MBkaamadhenutantraHK-203	triśaktisahitaṃ varṇaṃ tribindusahitaṃ sadā |	tri śakti sahitam varṇam tri bindu sahitam sadā 
MBkaamadhenutantraHK-204	caturjñānamayaṃ varṇaṃ ātmāditattvasaṃyutam || 4/25 ||	catur jñāna mayam varṇam ātma ādi tattva saṃyutam 
MBkaamadhenutantraHK-205	pītavidyullatākāraṃ ḍakāraṃ praṇamāmyaham |	pīta vidyut latā ākāram ḍakāram praṇamāmi aham 
MBkaamadhenutantraHK-206	ḍhakāraṃ paramārādhyaṃ yā svayaṃ kuṇḍalī parā || 4/26 ||	ḍhakāram parama ārādhyam yā svayam kuṇḍalī parā 
MBkaamadhenutantraHK-207	pañcadevātmakaṃ varṇaṃ pañcaprāṇamayaṃ sadā |	pañca deva ātmakam varṇam pañca prāṇa mayam sadā 
MBkaamadhenutantraHK-208	sadā triguṇasaṃyuktaṃ ātmāditattvasaṃyutam |	sadā triguṇa saṃyuktam ātma ādi tattva saṃyutam 
MBkaamadhenutantraHK-209	raktavidyullatākāraṃ ḍhakāraṃ praṇamāmyaham || 4/27 ||	rakta vidyut latā ākāram ḍhakāram praṇamāmi aham 
MBkaamadhenutantraHK-210	ṇakāraṃ parameśāni svayaṃ paramakuṇḍalī |	ṇakāram parameśāni svayam parama kuṇḍalī 
MBkaamadhenutantraHK-211	pītavidyullatākāraṃ pañcadevamayaṃ sadā || 4/28 ||	pīta vidyut latā ākāram pañca deva mayam sadā 
MBkaamadhenutantraHK-212	pañcaprāṇamayaṃ devi sadā triguṇasaṃyutam |	pañca prāṇa mayam devi sadā triguṇa saṃyutam 
MBkaamadhenutantraHK-213	ātmāditattvasaṃyuktaṃ mahāmohapradāyakam || 4/29 ||	ātma ādi tattva saṃyuktam mahā moha pradāyakam 
MBkaamadhenutantraHK-214	iti śrīkāmadhenutantre devadevīsaṃvāde caturthaḥ paṭalaḥ ||	iti śrī kāmadhenutantre devadevī saṃvāde caturthaḥ paṭalaḥ 
MBkaamadhenutantraHK-215	pañcamaḥ paṭalaḥ	pañcamaḥ paṭalaḥ 
MBkaamadhenutantraHK-216	śrīmahādeva uvāca	śrī mahādevaḥ uvāca 
MBkaamadhenutantraHK-217	takāraṃ cañcalāpāṅgi svayaṃ paramakuṇḍalī |	takāram cañcalāpāṅgi svayam parama kuṇḍalī 
MBkaamadhenutantraHK-218	pañcadevātmakaṃ varṇaṃ pañcaprāṇamyaṃ tathā || 5/1 ||	pañca deva ātmakam varṇam pañca prāṇamyam tathā 
MBkaamadhenutantraHK-219	triśaktisahitaṃ varṇamātmāditattvasaṃyutam |	tri śakti sahitam varṇam ātma ādi tattva saṃyutam 
MBkaamadhenutantraHK-220	tribindusahitaṃ varṇaṃ pītavidyutsamaprabham || 5/2 ||	tri bindu sahitam varṇam pīta vidyut sama prabham 
MBkaamadhenutantraHK-221	thakāraṃ cañcalāpāṅgi kuṇḍalī mokṣarūpiṇī |	            
MBkaamadhenutantraHK-222	triśaktisahitaṃ varṇaṃ tribindusahitaṃ sadā || 5/3 ||	tri śakti sahitam varṇam tri bindu sahitam sadā 
MBkaamadhenutantraHK-223	pañcadevamayaṃ varṇaṃ pañcaprāṇātmakaṃ sadā |	pañca deva mayam varṇam pañca prāṇa ātmakam sadā 
MBkaamadhenutantraHK-224	aruṇādityasaṃkāśaṃ thakāraṃ praṇamāmyaham || 5/4 ||	aruṇa āditya saṃkāśam thakāram praṇamāmi aham 
MBkaamadhenutantraHK-225	dakāraṃ śṛṇu cārvaṅgi caturvargapradāyakam |	dakāram śṛṇu cāru aṅgi caturvarga pradāyakam 
MBkaamadhenutantraHK-226	pañcadevamayaṃ varṇaṃ pañcaprāṇamayaṃ sadā || 5/5 ||	pañca deva mayam varṇam pañca prāṇa mayam sadā 
MBkaamadhenutantraHK-227	triśaktisahitaṃ devi tribindusahitaṃ sadā |	tri śakti sahitam devi tri bindu sahitam sadā 
MBkaamadhenutantraHK-228	ātmāditattvasaṃyuktaṃ svayaṃ paramakuṇḍalī || 5/6 ||	ātma ādi tattva saṃyuktam svayam parama kuṇḍalī 
MBkaamadhenutantraHK-229	raktavidyullatākāraṃ dakāraṃ hṛdi bhāvaya |	rakta vidyut latā ākāram dakāram hṛdi bhāvaya 
MBkaamadhenutantraHK-230	dhakāraṃ parameśāni kuṇḍalī mokṣarūpiṇī || 5/7 ||	dhakāram parameśāni kuṇḍalī mokṣa rūpiṇī 
MBkaamadhenutantraHK-231	ātmāditattvasaṃyuktaṃ pañcadevamayaṃ sadā |	ātma ādi tattva saṃyuktam pañca deva mayam sadā 
MBkaamadhenutantraHK-232	pañcaprāṇamayaṃ devi triśaktisahitaṃ sadā || 5/8 ||	pañca prāṇa mayam devi tri śakti sahitam sadā 
MBkaamadhenutantraHK-233	tribindusahitaṃ varṇaṃ dhakāraṃ hṛdi bhāvaya |	tri bindu sahitam varṇam dhakāram hṛdi bhāvaya 
MBkaamadhenutantraHK-234	pītavidyullatākāraṃ caturvargapradāyakam || 5/9 ||	           
MBkaamadhenutantraHK-235	nakāraṃ śṛṇu cārvaṅgi raktavidyullatākṛtim |	nakāram śṛṇu cāru aṅgi rakta vidyut latā ākṛtim 
MBkaamadhenutantraHK-236	pañcadevamayaṃ varṇaṃ svayaṃ paramakuṇḍalī || 5/10 ||	pañca deva mayam varṇam svayam parama kuṇḍalī 
MBkaamadhenutantraHK-237	pañcaprāṇātmakaṃ varṇaṃ hṛdi bhāvaya pārvati |	pañca prāṇa ātmakam varṇam hṛdi bhāvaya pārvati 
MBkaamadhenutantraHK-238	ataḥ paraṃ pravakṣyāmi pakāraṃ mokṣadāyakam || 5/11 ||	atas param pravakṣyāmi pakāram mokṣa dāyakam 
MBkaamadhenutantraHK-239	caturvargapradaṃ varṇaṃ śaraccandrasamaprabham |	caturvarga pradam varṇam śarad candra sama prabham 
MBkaamadhenutantraHK-240	pañcadevamayaṃ varṇaṃ svayaṃ paramakuṇḍalī || 5/12 ||	pañca deva mayam varṇam svayam parama kuṇḍalī 
MBkaamadhenutantraHK-241	pañcaprāṇamayaṃ varṇaṃ triśaktisahitaṃ sadā |	pañca prāṇa mayam varṇam tri śakti sahitam sadā 
MBkaamadhenutantraHK-242	truguṇai rahitaṃ varṇamātmāditattvasaṃyutam || 5/13 ||	truguṇaiḥ rahitam varṇam ātma ādi tattva saṃyutam 
MBkaamadhenutantraHK-243	mahāmokṣapradaṃ varṇaṃ hṛdi bhāvaya pārvati |	mahāmokṣa pradam varṇam hṛdi bhāvaya pārvati 
MBkaamadhenutantraHK-244	phakāraṃ śṛṇu cārvaṅgi raktavidyullatopamam || 5/14 ||	phakāram śṛṇu cāru aṅgi rakta vidyut latā upamam 
MBkaamadhenutantraHK-245	caturvargapradaṃ varṇaṃ pañcadevamayaṃ sadā |	caturvarga pradam varṇam pañca deva mayam sadā 
MBkaamadhenutantraHK-246	pañcaprāṇamayaṃ varṇaṃ sadā triguṇasaṃyutam || 5/15 ||	pañca prāṇa mayam varṇam sadā triguṇa saṃyutam 
MBkaamadhenutantraHK-247	ātmāditattvasaṃyuktaṃ tribindusahitaṃ sadā |	ātma ādi tattva saṃyuktam tri bindu sahitam sadā 
MBkaamadhenutantraHK-248	bakāraṃ śṛṇu cārvaṅgi caturvargapradāyakam || 5/16 ||	bakāram śṛṇu cārvaṅgi caturvarga pradāyakam 
MBkaamadhenutantraHK-249	śaraccandrapratīkāśaṃ pañcadevamayaṃ sadā |	śarad candra pratīkāśam pañca deva mayam sadā 
MBkaamadhenutantraHK-250	pañcaprāṇātmakaṃ varṇaṃ tribindusahitaṃ sadā || 5/17 ||	pañca prāṇa ātmakam varṇam tri bindu sahitam sadā 
MBkaamadhenutantraHK-251	triśaktisahitaṃ varṇaṃ sadā cāmṛtanirmitam |	tri śakti sahitam varṇam sadā ca amṛta nirmitam 
MBkaamadhenutantraHK-252	svayaṃ kuṇḍalinī sākṣāt satataṃ praṇamāmyaham || 5/18 ||	svayam kuṇḍalinī sākṣāt satatam praṇamāmi aham 
MBkaamadhenutantraHK-253	bhakāraṃ śṛṇu cārvaṅgi svayaṃ paramakuṇḍalī |	bhakāram śṛṇu cāru aṅgi svayam parama kuṇḍalī 
MBkaamadhenutantraHK-254	mahāmokṣapradaṃ varṇamaruṇādityasannibham || 5/19 ||	mahāmokṣa pradam varṇam aruṇa āditya sannibham 
MBkaamadhenutantraHK-255	pañcaprāṇamayaṃ varṇaṃ pañcadevamayaṃ sadā |	pañca prāṇa mayam varṇam pañca deva mayam sadā 
MBkaamadhenutantraHK-256	triśaktisahitaṃ varṇaṃ tribindusahitaṃ priye || 5/20 ||	tri śakti sahitam varṇam tri bindu sahitam priye 
MBkaamadhenutantraHK-257	makāraṃ śṛṇu cārvaṅgi svayaṃ paramakuṇḍalī |	makāram śṛṇu cāru aṅgi svayam parama kuṇḍalī 
MBkaamadhenutantraHK-258	aruṇādityasaṃkāśaṃ caturvargapradāyakam || 5/21 ||	aruṇa āditya saṃkāśam caturvarga pradāyakam 
MBkaamadhenutantraHK-259	triśaktisahitaṃ varṇaṃ tribindusahitaṃ sadā |	tri śakti sahitam varṇam tri bindu sahitam sadā 
MBkaamadhenutantraHK-260	ātmāditattvasaṃyuktaṃ hṛdisthaṃ praṇamāmyaham || 5/22 ||	ātma ādi tattva saṃyuktam hṛdistham praṇamāmi aham 
MBkaamadhenutantraHK-261	yakāraṃ śṛṇu cārvaṅgi catuṣkoṇamayaṃ sadā |	yakāram śṛṇu cāru aṅgi catuṣkoṇa mayam sadā 
MBkaamadhenutantraHK-262	palāladhūmasaṃkāśaṃ svayaṃ paramakuṇḍalī || 5/23 ||	palāla dhūma saṃkāśam svayam parama kuṇḍalī 
MBkaamadhenutantraHK-263	pañcaprāṇamayaṃ varṇaṃ pañcadevamayaṃ sadā |	pañca prāṇa mayam varṇam pañca deva mayam sadā 
MBkaamadhenutantraHK-264	triśaktisahitaṃ varṇaṃ tribindusahitaṃ tathā || 5/24 ||	tri śakti sahitam varṇam tri bindu sahitam tathā 
MBkaamadhenutantraHK-265	praṇamāmi sadā varṇaṃ mūrtimān (?)mokṣamavyayam |	praṇamāmi sadā varṇam mūrtimān mokṣam avyayam 
MBkaamadhenutantraHK-266	iti śrīkāmadhenutantre devadvīsaṃvāde pañcamaḥ paṭalaḥ ||	iti śrī kāmadhenutantre deva dvī saṃvāde pañcamaḥ paṭalaḥ 
MBkaamadhenutantraHK-267	ṣaṣṭhaḥ paṭalaḥ	ṣaṣṭhaḥ paṭalaḥ 
MBkaamadhenutantraHK-268	śrīmahādeva uvāca	śrī mahādevaḥ uvāca 
MBkaamadhenutantraHK-269	rakāraṃ cañcalāpāṅgi kuṇḍalīdvayasaṃyutam |	rakāram cañcalāpāṅgi kuṇḍalī dvaya saṃyutam 
MBkaamadhenutantraHK-270	raktavidyullatākāraṃ pañcadevātmakaṃ sadā || 6/1 ||	rakta vidyut latā ākāram pañca deva ātmakam sadā 
MBkaamadhenutantraHK-271	pañcaprāṇamayaṃ varṇaṃ tribindusahitaṃ sadā |	pañca prāṇa mayam varṇam tri bindu sahitam sadā 
MBkaamadhenutantraHK-272	triśaktisahitaṃ devi ātmāditattvasaṃyutam || 6/2 ||	tri śakti sahitam devi ātma ādi tattva saṃyutam 
MBkaamadhenutantraHK-273	sarvatejomayaṃ varṇaṃ satataṃ praṇamāmyaham |	sarva tejaḥ mayam varṇam satatam praṇamāmi aham 
MBkaamadhenutantraHK-274	lakāraṃ cañcalāpāṅgi kuṇḍalītrayasaṃyutam || 6/3 ||	lakāram cañcalāpāṅgi kuṇḍalī traya saṃyutam 
MBkaamadhenutantraHK-275	pītavidyullatākāraṃ sarvaratnapradāyakam |	pīta vidyut latā ākāram sarva ratna pradāyakam 
MBkaamadhenutantraHK-276	pañcadevamayaṃ varṇaṃ pañcaprāṇātmakaṃ sadā || 6/4 ||	pañca deva mayam varṇam pañca prāṇa ātmakam sadā 
MBkaamadhenutantraHK-277	triśaktisahitaṃ varṇaṃ tribindusahitaṃ hi sā |	tri śakti sahitam varṇam tri bindu sahitam hi sā 
MBkaamadhenutantraHK-278	ātmāditattvasahitaṃ hṛdi bhāvaya sarvadā || 6/5 ||	ātma ādi tattva sahitam hṛdi bhāvaya sarvadā 
MBkaamadhenutantraHK-279	vakāraṃ cañcalāpāṅgi kuṇḍalī mokṣamavyayam |	vakāram cañcalāpāṅgi kuṇḍalī mokṣam avyayam 
MBkaamadhenutantraHK-280	pañcaprāṇamayaṃ varṇaṃ triśaktisahitaṃ sadā || 6/6 ||	pañca prāṇa mayam varṇam tri śakti sahitam sadā 
MBkaamadhenutantraHK-281	tribindusahitaṃ varṇamātmāditattvasaṃyutam |	tri bindu sahitam varṇam ātma ādi tattva saṃyutam 
MBkaamadhenutantraHK-282	pañcadevamayaṃ varṇaṃ pītavidyullatopamam || 6/7 ||	pañca deva mayam varṇam pīta vidyut latā upamam 
MBkaamadhenutantraHK-283	caturvargamayaṃ varṇaṃ sarvasiddhipradāyakam |	              
MBkaamadhenutantraHK-284	triśaktisahitaṃ devi triśaktisahitaṃ sadā || 6/8 ||	tri śakti sahitam devi tri śakti sahitam sadā 
MBkaamadhenutantraHK-285	śakāraṃ parameśāni svarṇavarṇaṃ śucismite |	śakāram parameśāni svarṇa varṇam śuci smite 
MBkaamadhenutantraHK-286	raktavarṇaprabhākārā svayaṃ paramakuṇḍalī || 6/9 ||	rakta varṇa prabhā ākārā svayam parama kuṇḍalī 
MBkaamadhenutantraHK-287	caturvargapradaṃ devi śakāraṃ brahmavigraham |	caturvarga pradam devi śakāram brahma vigraham 
MBkaamadhenutantraHK-288	pañcadevamayaṃ varṇaṃ pañcaprāṇātmakaṃ priye || 6/10 ||	pañca deva mayam varṇam pañca prāṇa ātmakam priye 
MBkaamadhenutantraHK-289	rajaḥsattvatamoyuktaṃ tribindusahitaṃ sadā |	rajaḥ sattva tamaḥ yuktam tri bindu sahitam sadā 
MBkaamadhenutantraHK-290	triśaktisahitaṃ varṇamātmāditattvasaṃyutam || 6/11 ||	tri śakti sahitam varṇam ātma ādi tattva saṃyutam 
MBkaamadhenutantraHK-291	ṣakāraṃ śṛṇu cārvaṅgi koṇaṣaṭkamayaṃ sadā |	ṣakāram śṛṇu cāru aṅgi koṇa ṣaṭka mayam sadā 
MBkaamadhenutantraHK-292	raktacandrapratīkāśaṃ svayaṃ paramakuṇḍalī || 6/12 ||	rakta candra pratīkāśam svayam parama kuṇḍalī 
MBkaamadhenutantraHK-293	caturvargapradaṃ varṇaṃ sudhānirmitavigraham |	caturvarga pradam varṇam sudhā nirmita vigraham 
MBkaamadhenutantraHK-294	pañcadevamayaṃ varṇaṃ pañcaprāṇamayaṃ sadā || 6/13 ||	pañca deva mayam varṇam pañca prāṇa mayam sadā 
MBkaamadhenutantraHK-295	rajaḥsattvatamoyuktaṃ tribindusahitaṃ param |	rajaḥ sattva tamaḥ yuktam tri bindu sahitam param 
MBkaamadhenutantraHK-296	sarvadevamayaṃ varṇaṃ hṛdi bhāvaya pārvati || 6/14 ||	sarva deva mayam varṇam hṛdi bhāvaya pārvati 
MBkaamadhenutantraHK-297	sakāraṃ śṛṇu cārvaṅgi śaktibījaṃ parātparam |	sakāram śṛṇu cāru aṅgi śaktibījam parātparam 
MBkaamadhenutantraHK-298	koṭividyullatākāraṃ kuṇḍalītrayasaṃyutam || 6/15 ||	koṭi vidyut latā ākāram kuṇḍalī traya saṃyutam 
MBkaamadhenutantraHK-299	pañcadevamayaṃ devi pañcaprāṇamayaṃ sadā |	pañca deva mayam devi pañca prāṇa mayam sadā 
MBkaamadhenutantraHK-300	rajaḥsattvatamoyuktaṃ tribindusahitaṃ sadā || 6/16 ||	rajaḥ sattva tamaḥ yuktam tri bindu sahitam sadā 
MBkaamadhenutantraHK-301	triśaktisahitaṃ varṇamātmāditattvasaṃyutam |	tri śakti sahitam varṇam ātma ādi tattva saṃyutam 
MBkaamadhenutantraHK-302	praṇamya satataṃ devi hṛdi bhāvaya sundari || 6/17 ||	praṇamya satatam devi hṛdi bhāvaya sundari 
MBkaamadhenutantraHK-303	hakāraṃ śṛṇu cārvaṅgi caturvargapradāyakam |	hakāram śṛṇu cāru aṅgi caturvarga pradāyakam 
MBkaamadhenutantraHK-304	kuṇḍalītrayasaṃyuktaṃ raktavidyullatopamam || 6/18 ||	kuṇḍalī traya saṃyuktam rakta vidyut latā upamam 
MBkaamadhenutantraHK-305	rajaḥsattvatamoyuktaṃ pañcadevamayaṃ sadā |	rajaḥ sattva tamaḥ yuktam pañca deva mayam sadā 
MBkaamadhenutantraHK-306	pañcaprāṇātmakaṃ varṇaṃ triśaktisahitaṃ sadā || 6/19 ||	pañca prāṇa ātmakam varṇam tri śakti sahitam sadā 
MBkaamadhenutantraHK-307	tribindusahitaṃ varṇaṃ hṛdi bhāvaya sundari |	tri bindu sahitam varṇam hṛdi bhāvaya sundari 
MBkaamadhenutantraHK-308	kṣakāraṃ śṛṇu cārvaṅgi kuṇḍalītrayasaṃyutam || 6/20 ||	kṣakāram śṛṇu cāru aṅgi kuṇḍalī traya saṃyutam 
MBkaamadhenutantraHK-309	caturvargamayaṃ varṇaṃ pañcadevamayaṃ sadā |	caturvarga mayam varṇam pañca deva mayam sadā 
MBkaamadhenutantraHK-310	pañcaprāṇātmakaṃ varṇaṃ triśaktisahitaṃ sadā || 6/21 ||	pañca prāṇa ātmakam varṇam tri śakti sahitam sadā 
MBkaamadhenutantraHK-311	tribindusahitaṃ varṇamātmāditattvasaṃyutam |	tri bindu sahitam varṇam ātma ādi tattva saṃyutam 
MBkaamadhenutantraHK-312	śaraccandrapratīkāśaṃ hṛdi bhāvaya sundari || 6/22 ||	śarad candra pratīkāśam hṛdi bhāvaya sundari 
MBkaamadhenutantraHK-313	akārādikṣakārāntaṃ svayaṃ paramakuṇḍalī |	akāra ādi kṣakāra antam svayam parama kuṇḍalī 
MBkaamadhenutantraHK-314	sarvaṃ carācaraṃ viśvaṃ varṇāttu jāyate dhruvam || 6/23 ||	sarvam carācaram viśvam varṇāt tu jāyate dhruvam 
MBkaamadhenutantraHK-315	nānāśāstraṃ purāṇañca itihāsañca sundari |	nānā śāstram purāṇam ca itihāsam ca sundari 
MBkaamadhenutantraHK-316	vedañca smṛtiśāstrañca anyāni yāni kāni ca || 6/24 ||	vedañca smṛti śāstrañca anyāni yāni kāni ca 
MBkaamadhenutantraHK-317	akṣarājjāyate sarvaṃ paraṃ brahma svayaṃ priye |	akṣarāt jāyate sarvam param brahma svayam priye 
MBkaamadhenutantraHK-318	iti kāmadhenutantre devadevīsaṃvāde ṣaṣṭhaḥ paṭalaḥ ||	iti kāmadhenutantre devadevī saṃvāde ṣaṣṭhaḥ paṭalaḥ 
MBkaamadhenutantraHK-319	saptamaḥ paṭalaḥ	saptamaḥ paṭalaḥ 
MBkaamadhenutantraHK-320	śrīmahādeva uvāca	śrī mahādevaḥ uvāca 
MBkaamadhenutantraHK-321	rahasyaṃ paramāścaryaṃ sadāa mama hṛdi sthitam |	rahasyam parama āścaryam sadā mama hṛdi sthitam 
MBkaamadhenutantraHK-322	ataḥ paraṃ pravakṣyāmi mantratattvaṃ pṛthak pṛthak || 7/1 ||	atas param pravakṣyāmi mantra tattvam pṛthak pṛthak 
MBkaamadhenutantraHK-323	mātṛkāyā varārohe sāvadhānāvadhāraya |	mātṛkāyāḥ varārohe sa avadhāna avadhāraya 
MBkaamadhenutantraHK-324	ataḥ paraṃ japenmantraṃ pañcāśanmātṛkāṃ pṛthak || 7/2 ||	atas param japet mantram pañcāśat mātṛkām pṛthak 
MBkaamadhenutantraHK-325	atastvamadhikārī syānnātra kāryā vicāraṇā |	atas tvam adhikārī syāt na atra kāryā vicāraṇā 
MBkaamadhenutantraHK-326	iti te kathitaṃ devi prayogaṃ mantramuttamam || 7/3 ||	iti te kathitam devi prayogam mantram uttamam 
MBkaamadhenutantraHK-327	etanmantraṃ vinā devi iṣṭaṃ mantraṃ japennaraḥ |	etad mantram vinā devi iṣṭam mantram japet naraḥ 
MBkaamadhenutantraHK-328	sarvaṃ tasya bhavedvyarthaṃ sarvaṃ vyarthakadarthanam || 7/4 ||	sarvam tasya bhavet vyartham sarvam vyartha kadarthanam 
MBkaamadhenutantraHK-329	etanmantraṃ prathamato daśadhā prajapet priye |	etat mantram prathamatas daśadhā prajapet priye 
MBkaamadhenutantraHK-330	tatastu praṇavaṃ dattvā mātṛkāṃ prajapet pṛthak || 7/5 ||	tatas tu praṇavam dattvā mātṛkām prajapet pṛthak 
MBkaamadhenutantraHK-331	prayogaṃ paramāścaryaṃ sāvadhānāvadhāraya |	prayogam parama āścaryam sa avadhāna avadhāraya 
MBkaamadhenutantraHK-332	tadyathā - oṃ, a/ oṃ, oṃ āṃ oṃ, oṃ i/ oṃ, oṃ ī/ oṃ, oṃ u/ oṃ, oṃ oṃ oṃ, oṃ ṛ/ oṃ, oṃ ṛ/ oṃ, oṃ	tat yathā om om om om om om om om om om om om om om om om om om om om om om om om om om om om 
MBkaamadhenutantraHK-333	ḷ/ oṃ, oṃ ḹ oṃ, oṃ e/ oṃ, oṃ ai/ oṃ, oṃ o/ oṃ, oṃ au/ oṃ, oṃ aṃ oṃ, oṃ aḥ oṃ, oṃ kaṃ oṃ |	om oṃ oṃ oṃ oṃ oṃ oṃ oṃ oṃ oṃ oṃ oṃ oṃ oṃ oṃ oṃ oṃ oṃ oṃ oṃ oṃ oṃ oṃ oṃ oṃ oṃ oṃ oṃ oṃ oṃ oṃ oṃ 
MBkaamadhenutantraHK-334	evaṃ kṣakāraparyantaṃ praṇavaiḥ puṭitaṃ sadā |	evam kṣakāra paryantam praṇavaiḥ puṭitam sadā 
MBkaamadhenutantraHK-335	pratyekamevaṃ cārvaṅgi daśadhā daśadhā japet || 7/6 ||	pratyekam evam cāru aṅgi daśadhā daśadhā japet  /
MBkaamadhenutantraHK-336	pratyekaṃ japamātreṇa pratyekaṃ dhyānamācaret |	pratyekam japa mātreṇa pratyekam dhyānam ācaret 
MBkaamadhenutantraHK-337	athavā sarvavarṇānāmekīkṛtya varānane || 7/7 ||	athavā sarva varṇānām ekīkṛtya varānane 
MBkaamadhenutantraHK-338	prajaped daśadhā mantraṃ svamantraṃ prajapettataḥ |	prajapet daśadhā mantram sva mantram prajapet tatas 
MBkaamadhenutantraHK-339	tathā ca sarvavarṇānāṃ dhyānaṃ vakṣyāmi saṃśṛṇu || 7/8 ||	tathā ca sarva varṇānām dhyānam vakṣyāmi saṃśṛṇu 
MBkaamadhenutantraHK-340	koṭicandrapatīkāśāṃ puṇḍarīkoparisthitām |	koṭi candra patīkāśām puṇḍarīka upari sthitām 
MBkaamadhenutantraHK-341	bhramadbhramaralīlābhāṃ nayanatrayarājitām || 7/9 ||	bhramat bhramara līlā ābhām nayana traya rājitām 
MBkaamadhenutantraHK-342	nānāśāstrapravaktrīṃ ca vidyābhyāsamayīṃ sadā |	nānā śāstra pravaktrīm ca vidyā abhyāsa mayīm sadā 
MBkaamadhenutantraHK-343	nānāvādyamayīṃ devīṃ śvetāṃśukapariṣkṛtām || 7/10 ||	nānā vādya mayīm devīm śveta aṃśuka pariṣkṛtām 
MBkaamadhenutantraHK-344	śuklābharaṇadīptāṅgī śuklavastrottarīyiṇīm |	śukla ābharaṇa dīpta aṅgī śukla vastra uttarīyiṇīm 
MBkaamadhenutantraHK-345	brahmāṇḍaṃ darpaṇe yasyā vāmahastasya pārvati || 7/11 ||	brahmāṇḍam darpaṇe yasyāḥ vāma hastasya pārvati  /
MBkaamadhenutantraHK-346	tadvacchukaśiśuṃ prekṣya kṣudradarpaṇamucyate |	tadvat śuka śiśum prekṣya kṣudra darpaṇam ucyate 
MBkaamadhenutantraHK-347	evaṃ dhyātvā jagaddhātrīṃ mātṛkāṃ jagadambikām || 7/12 ||	evam dhyātvā jagaddhātrīm mātṛkām jagadambikām 
MBkaamadhenutantraHK-348	prajapeddaśadhā mantramekadhā vā japettu yaḥ |	prajapet daśadhā mantram ekadhā vā japet tu yaḥ 
MBkaamadhenutantraHK-349	sarvasiddhimavāpnoti nātra kāryā vicāraṇā || 7/13 ||	sarva siddhim avāpnoti na atra kāryā vicāraṇā 
MBkaamadhenutantraHK-350	eṣā te kathitā vidyā mātṛkā paramātmikā |	eṣā te kathitā vidyā mātṛkā parama ātmikā 
MBkaamadhenutantraHK-351	yat kṛtvā sādhako yāti durlabhaṃ mokṣamavyayam || 7/14 ||	yat kṛtvā sādhakaḥ yāti durlabham mokṣam avyayam 
MBkaamadhenutantraHK-352	pratyekenāthavā devi ekaikaiva varānane |	pratyekena athavā devi ekaikā eva varānane 
MBkaamadhenutantraHK-353	rahasyaṃ śṛṇu cārvaṅgi sugopyaṃ bhuvanatraye || 7/15 ||	rahasyam śṛṇu cārvaṅgi su gopyam bhuvanatraye 
MBkaamadhenutantraHK-354	iṣṭavidyāṃ sakṛt smṛtvā manasā parameśvari |	iṣṭa vidyām sakṛt smṛtvā manasā parameśvari 
MBkaamadhenutantraHK-355	yasya mantrasya yaddhyānaṃ kṛtvā devi prayatnataḥ || 7/16 ||	yasya mantrasya yat dhyānam kṛtvā devi prayatnataḥ 
MBkaamadhenutantraHK-356	tanmantraṃ daśadhā japtvā iṣṭadhyānaṃ tataḥ priye |	tat mantram daśadhā japtvā iṣṭa dhyānam tatas priye 
MBkaamadhenutantraHK-357	iṣṭamantraṃ prajaptvā vai sarvasiddhiṃ tato labhet || 7/17 ||	iṣṭa mantram prajaptvā vai sarva siddhim tatas labhet  /
MBkaamadhenutantraHK-358	anena vidhinā devi mantraścaitanyamāpnuyāt |	anena vidhinā devi mantraḥ caitanyam āpnuyāt 
MBkaamadhenutantraHK-359	caitanyarahitaṃ mantraṃ vidyā vā surapūjite || 7/18 ||	caitanya rahitam mantram vidyā vā sura pūjite 
MBkaamadhenutantraHK-360	sarva vyarthaṃ bhaveddevi biphalaṃ sa japo bhavet |	sarva vyartham bhavet devi biphalam sa japaḥ bhavet 
MBkaamadhenutantraHK-361	śrīmāhadeva uvāca	śrī māhadevaḥ uvāca 
MBkaamadhenutantraHK-362	aparaṃ śṛṇu cārvaṅgi vargāṣṭakamanuttamam || 7/19 ||	aparam śṛṇu cārvaṅgi vargāṣṭakam anuttamam 
MBkaamadhenutantraHK-363	vargāṣṭakaṃ vinā devi koṭipuraścaraṃ yadi |	varga aṣṭakam vinā devi koṭi puraścaram yadi 
MBkaamadhenutantraHK-364	sarvaṃ tasya vṛthā devi ante ca narakaṃ brajet || 7/20 ||	sarvam tasya vṛthā devi ante ca narakam brajet  /
MBkaamadhenutantraHK-365	akacaṭatapayaśā ityetadaṣṭavargakam |	aka ca ṭa ta pa ya śāḥ iti etat aṣṭavargakam 
MBkaamadhenutantraHK-366	mantrasyādau ca ante ca akāraṃ bindusaṃyutam || 7/21 ||	mantrasya ādau ca ante ca akāram bindu saṃyutam 
MBkaamadhenutantraHK-367	dattvā tameva bhaktyā ca aṣṭottaraśataṃ japet |	dattvā tam eva bhaktyā ca aṣṭottaraśatam japet 
MBkaamadhenutantraHK-368	anena vidhinā devi ādityābhaṃ samācaret || 7/22 ||	anena vidhinā devi āditya ābham samācaret  /
MBkaamadhenutantraHK-369	tāvajjaped varārohe yāvallakṣaṃ samāpyate |	tāvat japet varārohe yāvat lakṣam samāpyate 
MBkaamadhenutantraHK-370	tato mantraṃ varārohe dhruvaṃ jīvatvamāpnuyāt || 7/23 ||	tatas mantram varārohe dhruvam jīva tvam āpnuyāt 
MBkaamadhenutantraHK-371	jīvatvaṃ hi vinā devi na puraścaraṇaṃ caret |	jīva tvam hi vinā devi na puraścaraṇam caret 
MBkaamadhenutantraHK-372	jīvatvaṃ hi vinā devi yadi kuryāt puraścaram || 7/24 ||	jīva tvam hi vinā devi yadi kuryāt puraścaram 
MBkaamadhenutantraHK-373	viphalā tasya sā sarvā pūrvapuṇyaṃ vinaśyati |	viphalā tasya sā sarvā pūrva puṇyam vinaśyati 
MBkaamadhenutantraHK-374	vargāṣṭakena sahitaṃ pratyahaṃ prajapet śatam || 7/25 ||	varga aṣṭakena sahitam pratyaham prajapet śatam 
MBkaamadhenutantraHK-375	sadaiva sahasā bhadre sarvaṃ mantrañca sidhyati |	sadā eva sahasā bhadre sarvam mantram ca sidhyati 
MBkaamadhenutantraHK-376	kiṃ tasya dhyānapūjāyāṃ puraścaryāñca kiṃ punaḥ || 7/26 ||	kim tasya dhyāna pūjāyām puraścaryām ca kim punar 
MBkaamadhenutantraHK-377	kṛtvā tu jīvaṃ mantrasya vidyāñca varavarṇinī |	kṛtvā tu jīvam mantrasya vidyām ca varavarṇinī 
MBkaamadhenutantraHK-378	vidyāyāśca tathā devi yaḥ kuryāt prāṇanirṇayam || 7/27 ||	vidyāyāḥ ca tathā devi yaḥ kuryāt prāṇa nirṇayam 
MBkaamadhenutantraHK-379	tatkṣaṇād yānti cārvaṅgi puraścaryāṃ śataṃ śatam |	tad kṣaṇāt yānti cārvaṅgi puraścaryām śatam śatam 
MBkaamadhenutantraHK-380	viśeṣataḥ kaliyuge jambūdvīpasya bhārate || 7/28 ||	viśeṣataḥ kali yuge jambūdvīpasya bhārate 
MBkaamadhenutantraHK-381	prāṇanyāsaṃ vinā devi na japet sādhakaḥ kvacit |	prāṇanyāsam vinā devi na japet sādhakaḥ kvacid 
MBkaamadhenutantraHK-382	vaiṣṇaveṣu ca mantreṣu śaiveṣu śaktimantrake || 7/29 ||	vaiṣṇaveṣu ca mantreṣu śaiveṣu śakti mantrake 
MBkaamadhenutantraHK-383	gaṇeśasauramantre ca prāṇanyāsaḥ praśasyate |	gaṇeśa saura mantre ca prāṇanyāsaḥ praśasyate 
MBkaamadhenutantraHK-384	kiṃ tasya japapūjāsu homādiṣu ca kiṃ priye || 7/30 ||	kim tasya japa pūjāsu homa ādiṣu ca kim priye 
MBkaamadhenutantraHK-385	prāṇatattvaṃ maheśāni yo jānāti sa pūjakaḥ |	prāṇa tattvam maheśāni yaḥ jānāti sa pūjakaḥ 
MBkaamadhenutantraHK-386	prāṇatattvaṃ vinā devi dehanyāsaṃ karoti yaḥ || 7/31 ||	prāṇatattvam vinā devi dehanyāsam karoti yaḥ 
MBkaamadhenutantraHK-387	sa bhraṣṭaḥ sa ca pāpiṣṭho rauravaṃ narakaṃ vrajet |	sa bhraṣṭaḥ sa ca pāpiṣṭhaḥ rauravam narakam vrajet 
MBkaamadhenutantraHK-388	ālokya tanmukhaṃ devi sūryadarśanamācaret || 7/32 ||	ālokya tad mukham devi sūrya darśanam ācaret 
MBkaamadhenutantraHK-389	iti kāmadhenutantre devadevīsaṃvāde saptamaḥ paṭalaḥ	iti kāmadhenu tantre devadevī saṃvāde saptamaḥ paṭalaḥ 
MBkaamadhenutantraHK-390	aṣṭamaḥ paṭalaḥ	aṣṭamaḥ paṭalaḥ 
MBkaamadhenutantraHK-391	śrīmahādeva uvāca	śrī mahādevaḥ uvāca 
MBkaamadhenutantraHK-392	etatte kathitaṃ bhadre rahasyaṃ paramādbhutam |	etat te kathitam bhadre rahasyam parama adbhutam 
MBkaamadhenutantraHK-393	yannoktaṃ sarvatantreṣu mātṛkāyāḥ pṛthak pṛthak || 8/1 ||	yat na uktam sarva tantreṣu mātṛkāyāḥ pṛthak pṛthak 
MBkaamadhenutantraHK-394	pañcāśadvarṇasaṃketaṃ pañcāśattattvamuttamam |	pañcāśat varṇa saṃketam pañcāśat tattvam uttamam 
MBkaamadhenutantraHK-395	sarvadevamayaṃ tattvaṃ sarvajñānamayaṃ tathā || 8/2 ||	sarva deva mayam tattvam sarva jñāna mayam tathā 
MBkaamadhenutantraHK-396	bindutattvamayaṃ devi ahaṃtattvamayaṃ tathā |	bindu tattva mayam devi aham tattva mayam tathā 
MBkaamadhenutantraHK-397	sarvaśaktimayaṃ tattvaṃ sarvaprāṇamayaṃ tathā || 8/3 ||	sarva śakti mayam tattvam sarva prāṇa mayam tathā 
MBkaamadhenutantraHK-398	garbhatattvamayaṃ devi kevalaṃ kalikā tathā |	garbha tattva mayam devi kevalam kalikā tathā 
MBkaamadhenutantraHK-399	kusumasya yadā devi kalikāṃ gandhasaṃyutām || 8/4 ||	kusumasya yadā devi kalikām gandha saṃyutām 
MBkaamadhenutantraHK-400	adṛśyaṃ sarvabhūtānāṃ tathā gandhaṃ sucismite |	adṛśyam sarva bhūtānām tathā gandham sucismite 
MBkaamadhenutantraHK-401	puṣpasya kalikāmadhye yathā jyotiḥ pradīpyate || 8/5 ||	puṣpasya kalikā madhye yathā jyotiḥ pradīpyate 
MBkaamadhenutantraHK-402	tathaiva kalikābīje navatattvañca vidyate |	tathā eva kalikā bīje navatattvam ca vidyate 
MBkaamadhenutantraHK-403	koṭividyutpratīkāśāṃ mātṛkāṃ praṇamāmyaham || 8/6 ||	koṭi vidyut pratīkāśām mātṛkām praṇamāmi aham 
MBkaamadhenutantraHK-404	nirābādhāṃ nirguṇāñca guṇānāṃ guṇamātṛkām |	nirābādhām nirguṇām ca guṇānām guṇa mātṛkām 
MBkaamadhenutantraHK-405	mātā sā sarvavidyānāṃ sarvāgamapratiṣṭhitā || 8/7 ||	mātā sā sarva vidyānām sarva āgama pratiṣṭhitā 
MBkaamadhenutantraHK-406	sarvāsāṃ vedavidyānāṃ brahmāṇḍānāñca pārvati |	sarvāsām veda vidyānām brahmāṇḍānām ca pārvati 
MBkaamadhenutantraHK-407	mātā sā gīyate devi pañcāśanmātṛkā ca sā || 8/8 ||	mātā sā gīyate devi pañcāśat mātṛkā ca sā 
MBkaamadhenutantraHK-408	mantratattvañca vidyāñca sarvavarṇaviniścayam |	mantra tattvam ca vidyām ca sarva varṇa viniścayam 
MBkaamadhenutantraHK-409	pañcāśadyuvatīrūpā mātṛkā śavamavyayā || 8/9 ||	pañcāśat yuvatī rūpā mātṛkā śavam avyayā 
MBkaamadhenutantraHK-410	mātṛkā parameśāni kālī sākṣānna saṃśayaḥ |	mātṛkā parameśāni kālī sākṣāt na saṃśayaḥ 
MBkaamadhenutantraHK-411	kuto brahmā kuto viṣṇuḥ kuto rudraśca īśvaraḥ || 8/10 ||	kutas brahmā kutas viṣṇuḥ kutas rudraḥ ca īśvaraḥ 
MBkaamadhenutantraHK-412	sadāśivaḥ kuto devi te sarve śavavat priye |	sadāśivaḥ kutas devi te sarve śava vat priye 
MBkaamadhenutantraHK-413	śavavat sarvadevāśca brahmāṇḍaṃ śavavat sadā || 8/11 ||	śava vat sarva devāḥ ca brahmāṇḍam śava vat sadā 
MBkaamadhenutantraHK-414	ata eva varārohe viṣṇumantraṃ yathā tathā |	atas eva varārohe viṣṇu mantram yathā tathā 
MBkaamadhenutantraHK-415	śivamantraṃ yathā devi gaṇeśaṃ saurameva ca || 8/12 ||	śiva mantram yathā devi gaṇeśam sauram eva ca 
MBkaamadhenutantraHK-416	śaktimantrañca vidyāñca pañcāśadyuvatīmayam |	śakti mantram ca vidyām ca pañcāśat yuvatī mayam 
MBkaamadhenutantraHK-417	purāṇañca tathā vedaṃ smṛtiśāstraṃ tathaiva ca || 8/13 ||	purāṇam ca tathā vedam smṛti śāstram tathā eva ca 
MBkaamadhenutantraHK-418	etattattvaṃ varārohe yuvatīrūpamadbhutam |	etat tattvam varārohe yuvatī rūpam adbhutam 
MBkaamadhenutantraHK-419	brahmā viṣṇuśca rudraśca īśvaraśca sadāśivaḥ || 8/14 ||	brahmā viṣṇuḥ ca rudraḥ ca īśvaraḥ ca sadāśivaḥ 
MBkaamadhenutantraHK-420	te sarve cañcalāpāṅgi mātṛkājjāyate (?) priye |	te sarve cañcalāpāṅgi mātṛkāt jāyate priye 
MBkaamadhenutantraHK-421	samastajananī devi mātṛkā jananī parā || 8/15 ||	samasta jananī devi mātṛkā jananī parā 
MBkaamadhenutantraHK-422	kaṭākṣalakṣasaṃyuktā mahāśaktiḥ pragīyate |	kaṭākṣa lakṣa saṃyuktā mahā śaktiḥ pragīyate 
MBkaamadhenutantraHK-423	mātṛkāvarṇarahitaṃ brahmāṇḍaṃ śavavat priye || 8/16 ||	mātṛkā varṇa rahitam brahmāṇḍam śava vat priye 
MBkaamadhenutantraHK-424	gītaṃ vādyaṃ śrutirnāṭyamālāpaṃ varavarṇinī |	gītam vādyam śrutiḥ nāṭyam ālāpam varavarṇinī 
MBkaamadhenutantraHK-425	sarvaṃ hi yuvatīrūpaṃ dhyānamārge pratiṣṭhitam || 8/17 ||	sarvam hi yuvatī rūpam dhyāna mārge pratiṣṭhitam 
MBkaamadhenutantraHK-426	etatte kathitaṃ devi kālikābījamuttamam |	etat te kathitam devi kālikā bījam uttamam 
MBkaamadhenutantraHK-427	ubhayoḥ saṃgamaṃ devi praphullaṃ bhavati priye || 8/18 ||	ubhayoḥ saṃgamam devi praphullam bhavati priye 
MBkaamadhenutantraHK-428	bahavaḥ saṅgame devi praphullaṃ mokṣamavyayam |	bahavaḥ saṅgame devi praphullam mokṣam avyayam 
MBkaamadhenutantraHK-429	yanna mantreṣu vidyāsu praphullaṃ bhavati dhruvam || 8/19 ||	yat na mantreṣu vidyāsu praphullam bhavati dhruvam 
MBkaamadhenutantraHK-430	praphullaṃ śṛṇu cārvaṅgi japayajñaṃ samācaret |	praphullam śṛṇu cārvaṅgi japa yajñam samācaret 
MBkaamadhenutantraHK-431	praphullarahitaṃ devi vidyāmantraṃ yadi priye || 8/20 ||	praphulla rahitam devi vidyā mantram yadi priye 
MBkaamadhenutantraHK-432	kevalaṃ kālikābījaṃ varṇairvarṇaiḥ pṛthak pṛthak |	kevalam kālikā bījam varṇaiḥ varṇaiḥ pṛthak pṛthak 
MBkaamadhenutantraHK-433	dhyātvā siddhimavāpnoti nānyathā surapūjite || 8/21 ||	dhyātvā siddhim avāpnoti na anyathā sura pūjite 
MBkaamadhenutantraHK-434	praphullāt kalikādvāpi kṛṣṇādi jāyate dhruvam |	praphullāt kalikāt vā api kṛṣṇa ādi jāyate dhruvam 
MBkaamadhenutantraHK-435	yuvatī yā samākhyātā sā mahākuṇḍalī parā || 8/22 ||	yuvatī yā samākhyātā sā mahākuṇḍalī parā 
MBkaamadhenutantraHK-436	varṇarūpamayī devī kuṇḍalī paradevatā |	varṇa rūpa mayī devī kuṇḍalī para devatā 
MBkaamadhenutantraHK-437	pañcāśadvarṇatattvaṃ ca vidyāmantraṃ japettu yaḥ || 8/23 ||	pañcāśat varṇa tattvam ca vidyāmantram japet tu yaḥ 
MBkaamadhenutantraHK-438	sarvaṃ hi viphalaṃ tasya śavavat tajjapo bhavet |	sarvam hi viphalam tasya śava vat tad japaḥ bhavet 
MBkaamadhenutantraHK-439	caitanyarahitaṃ devi tajjapaṃ śavameva tat || 8/24 ||	caitanya rahitam devi tat japam śavam eva tat 
MBkaamadhenutantraHK-440	jñātvā praṇamya kurvīta japapūjādikaṃ priye |	jñātvā praṇamya kurvīta japa pūjā ādikam priye 
MBkaamadhenutantraHK-441	harirhi nirguṇaḥ sākṣāt saguṇā parakuṇḍalī || 8/25 ||	hariḥ hi nirguṇaḥ sākṣāt sa guṇā para kuṇḍalī 
MBkaamadhenutantraHK-442	tasmāttu yuvatīdehāt harerutpattireva ca |	tasmāt tu yuvatī dehāt hareḥ utpattiḥ eva ca 
MBkaamadhenutantraHK-443	sarvāsāṃ devadevīnāṃ bījaṃ janmasthalaṃ sadā || 8/26 ||	sarvāsām devadevīnām bījam janma sthalam sadā 
MBkaamadhenutantraHK-444	bījāttu jāyate brahmā śūnyarūpī sanātanaḥ |	bījāt tu jāyate brahmā śūnya rūpī sanātanaḥ 
MBkaamadhenutantraHK-445	ata eva maheśāni brahmaṇaḥ kāraṇaṃ parā || 8/27 ||	atas eva maheśāni brahmaṇaḥ kāraṇam parā 
MBkaamadhenutantraHK-446	jñātvā tantramidaṃ devi japapūjāṃ karoti yaḥ |	jñātvā tantram idam devi japa pūjām karoti yaḥ 
MBkaamadhenutantraHK-447	prāṇanyāsavidhiṃ kṛtvā japapūjāṃ karoti yaḥ || 8/28 ||	prāṇanyāsa vidhim kṛtvā japa pūjām karoti yaḥ 
MBkaamadhenutantraHK-448	sa śivaḥ paramaṃ brahma sa eva puruṣottamaḥ |	sa śivaḥ paramam brahma saḥ eva puruṣottamaḥ 
MBkaamadhenutantraHK-449	sa eva divyo vīraśca sa eva bhairavaḥ svayam || 8/29 ||	saḥ eva divyaḥ vīraḥ ca saḥ eva bhairavaḥ svayam 
MBkaamadhenutantraHK-450	sa eva dhanyo deveśi trailokye sacarācare |	saḥ eva dhanyaḥ deveśi trailokye sa carācare 
MBkaamadhenutantraHK-451	sa sūryo devi pūjyaśca sadguruśca na cānyathā || 8/30 ||	sa sūryaḥ devi pūjyaḥ ca sat guruḥ ca na ca anyathā 
MBkaamadhenutantraHK-452	uddhartuṃ caiva saṃhartuṃ samarthaḥ so'pi nānyathā |	uddhartum ca eva saṃhartum samarthaḥ saḥ api na anyathā 
MBkaamadhenutantraHK-453	ajñātvā tantrametattu japayajñaṃ karoti yaḥ || 8/31 ||	a jñātvā tantram etat tu japa yajñam karoti yaḥ 
MBkaamadhenutantraHK-454	sarvaṃ tasya vṛthā devi paśureva na saṃśayaḥ |	sarvam tasya vṛthā devi paśuḥ eva na saṃśayaḥ 
MBkaamadhenutantraHK-455	sarveṣu ca gururdevi śiṣyo'pi paśuvat sadā || 8/32 ||	sarveṣu ca guruḥ devi śiṣyaḥ api paśu vat sadā 
MBkaamadhenutantraHK-456	śrutvā tasya mukhe vidyāṃ mantraṃ vā naganandini |	śrutvā tasya mukhe vidyām mantram vā naga nandini 
MBkaamadhenutantraHK-457	sikto bhavati cārvaṅgi kiṃ tasya japapūjanaiḥ || 8/33 ||	siktaḥ bhavati cārvaṅgi kim tasya japa pūjanaiḥ 
MBkaamadhenutantraHK-458	evaṃ vidhaṃ guruṃ tyaktvā śrutvā paśumukhāt priye |	evaṃvidham gurum tyaktvā śrutvā paśu mukhāt priye 
MBkaamadhenutantraHK-459	pūrvamantraṃ parityajya gṛhṇīyād gaṇanāparam || 8/34 ||	pūrva mantram parityajya gṛhṇīyāt gaṇanā param 
MBkaamadhenutantraHK-460	sa bhraṣṭaḥ sa ca pāpiṣṭhaḥ kathaṃ mantramupāsmahe(?) |	sa bhraṣṭaḥ sa ca pāpiṣṭhaḥ katham mantram upāsmahe 
MBkaamadhenutantraHK-461	mantrasya gaṇanāddevi yat pāpaṃ prāpnuyānnaraḥ || 8/35 ||	mantrasya gaṇanāt devi yat pāpam prāpnuyāt naraḥ 
MBkaamadhenutantraHK-462	tat pāpaṃ śṛṇu cārvaṅgi narakañcottarottaram |	tat pāpam śṛṇu cārvaṅgi narakam ca uttarottaram 
MBkaamadhenutantraHK-463	yat pāpaṃ prāpnuyād devi svayaṃbhūliṅgacālane || 8/36 ||	yat pāpam prāpnuyāt devi svayaṃbhū liṅga cālane 
MBkaamadhenutantraHK-464	tat pāpaṃ koṭiguṇitaṃ gaṇanāddevamantrayoḥ |	tat pāpam koṭi guṇitam gaṇanāt deva mantrayoḥ 
MBkaamadhenutantraHK-465	tasmāttu gaṇanāṃ devi varjayenmatimānnaraḥ || 8/37 ||	tasmāt tu gaṇanām devi varjayet matimān naraḥ 
MBkaamadhenutantraHK-466	tyaktvā śaivavaiṣṇaveṣu saure gāṇapate tathā |	tyaktvā śaiva vaiṣṇaveṣu saure gāṇapate tathā 
MBkaamadhenutantraHK-467	anyat sarvāsu vidyāsu gaṇanāṃ varjayennaraḥ || 8/38 ||	anyat sarvāsu vidyāsu gaṇanām varjayet naraḥ 
MBkaamadhenutantraHK-468	iti śrī kāmadhenutantre devadevīsaṃvāde aṣṭamaḥ paṭalaḥ ||	iti śrī kāmadhenutantre devadevī saṃvāde aṣṭamaḥ paṭalaḥ 
MBkaamadhenutantraHK-469	navamaḥ paṭalaḥ	navamaḥ paṭalaḥ 
MBkaamadhenutantraHK-470	śrīmāhādeva uvāca	śrī māhādevaḥ uvāca 
MBkaamadhenutantraHK-471	adhunā saṃpravakṣyāmi rahasyaṃ guhyamuttamam |	adhunā saṃpravakṣyāmi rahasyam guhyam uttamam 
MBkaamadhenutantraHK-472	yajjñātvā sādhako yāti durlabhaṃ brahmamandiram || 9/1 ||	yat jñātvā sādhakaḥ yāti durlabham brahma mandiram 
MBkaamadhenutantraHK-473	iḍayā pūrayed vāyuṃ suṣumnāntargataṃ tataḥ |	iḍayā pūrayet vāyum suṣumnā antargatam tatas 
MBkaamadhenutantraHK-474	recayet piṅgalāmārge prāṇāyāmakramāt priye || 9/2 ||	recayet piṅgalā mārge prāṇāyāma kramāt priye 
MBkaamadhenutantraHK-475	anulomena cārvaṅgi mātṛkāṃ yuvatīṃ smaret |	anulomena cāru aṅgi mātṛkām yuvatīm smaret 
MBkaamadhenutantraHK-476	pañcāśanmātṛkāvarṇaṃ sabinduṃ nādasaṃyutam || 9/3 ||	pañcāśat mātṛkā varṇam sa bindum nāda saṃyutam 
MBkaamadhenutantraHK-477	uccārya pūrakeṇaiva tata iṣṭaṃ samuccaret |	uccārya pūrakeṇa eva tatas iṣṭam samuccaret 
MBkaamadhenutantraHK-478	tatastu mātṛkāvarṇaṃ vilomena japet priye || 9/4 ||	tatas tu mātṛkā varṇam vilomena japet priye 
MBkaamadhenutantraHK-479	suṣumnāmadhyadeśe tu citriṇī suvarānane |	suṣumnā madhya deśe tu citriṇī suvarānane 
MBkaamadhenutantraHK-480	anulomavilomena mātṛkāṃ yuvatīṃ smaret || 9/5 ||	anuloma vilomena mātṛkām yuvatīm smaret 
MBkaamadhenutantraHK-481	iṣṭamantraṃ tato japtvā vilomaṃ kuru yatnataḥ |	iṣṭa mantram tatas japtvā vilomam kuru yatnataḥ 
MBkaamadhenutantraHK-482	anenaiva vidhānena recayet piṅgalāpathe || 9/6 ||	anena eva vidhānena recayet piṅgalā pathe 
MBkaamadhenutantraHK-483	evaṃ dvādaśadhā kṛtvā pratyahaṃ varavarṇini |	evam dvādaśadhā kṛtvā pratyaham varavarṇini 
MBkaamadhenutantraHK-484	trisandhyāṃ cañcalāpāṅgi yaḥ kuryāt kamalānane || 9/7 ||	trisandhyām cañcalāpāṅgi yaḥ kuryāt kamala ānane 
MBkaamadhenutantraHK-485	jīvanyāsaṃ bhavettasya mantrasiddhiśca nānyathā |	jīva nyāsam bhavet tasya mantra siddhiḥ ca nā anyathā 
MBkaamadhenutantraHK-486	ekadhā vā maheśāni kalau saṃkhyā caturguṇā || 9/8 ||	ekadhā vā maheśāni kalau saṃkhyā caturguṇā 
MBkaamadhenutantraHK-487	pratyahaṃ daśadhā kṛtvā śivatulyo bhavennaraḥ |	pratyaham daśadhā kṛtvā śiva tulyaḥ bhavet naraḥ 
MBkaamadhenutantraHK-488	iti śrīkāmadhenutantre devadevīsaṃvāde navamaḥ paṭalaḥ ||	iti śrī kāmadhenutantre devadevī saṃvāde navamaḥ paṭalaḥ 
MBkaamadhenutantraHK-489	daśamaḥ paṭalaḥ	daśamaḥ paṭalaḥ 
MBkaamadhenutantraHK-490	śrīmahādeva uvāca	śrī mahādevaḥ uvāca 
MBkaamadhenutantraHK-491	lalāṭatattvaṃ cārvaṅgi akāraṃ sarvadā priye |	        sarvadā   
MBkaamadhenutantraHK-492	ākāraṃ mukhatattvantu śṛṇuṣva varavarṇini || 10/1 ||	ākāram mukha tattvam tu śṛṇuṣva varavarṇini 
MBkaamadhenutantraHK-493	ikāraṃ dakṣanetrañca īkāraṃ vāmanetrake |	ikāram īkāram vāma netrake 
MBkaamadhenutantraHK-494	ukāraṃ dakṣakarṇe syādūkāraṃ vāmakarṇake || 10/2 ||	ukāram dakṣa karṇe syāt ūkāram vāma karṇake  /
MBkaamadhenutantraHK-495	ṛkāraṃ dakṣanāsā ca ṛkāraṃ vāmanāsike |	ṛkāram dakṣa nāsā ca ṛkāram vāma nāsike 
MBkaamadhenutantraHK-496	ḷkāraṃ dakṣagaṇḍaṃ syāt ḹkāraṃ vāmagaṇḍakam || 10/3 ||	ḷkāram dakṣa gaṇḍam syāt ḹkāram vāma gaṇḍakam 
MBkaamadhenutantraHK-497	ekāraṃ adharaṃ tattvaṃ aikāraṃ oṣṭha eva ca |	ekāram adharam tattvam aikāram oṣṭhe eva ca 
MBkaamadhenutantraHK-498	okāraṃ ūrdhvadantaṃ syāt aukāraścādhodantakam || 10/4 ||	okāram ūrdhva dantam syāt aukāraḥ ca adhas dantakam 
MBkaamadhenutantraHK-499	aṃkāraṃ śirasastattvaṃ aḥkāraṃ mukhamaṇḍalam |	aṃkāram śirasaḥ tattvam aḥkāram mukha maṇḍalam 
MBkaamadhenutantraHK-500	kakārādi pañcatattvaṃ dakṣabāhau praśasyate || 10/5 ||	             
MBkaamadhenutantraHK-501	vāmabāhau cakārādi pañcatattvañca tiṣṭhati |	vāma bāhau cakāra ādi pañcatattvam ca tiṣṭhati 
MBkaamadhenutantraHK-502	dakṣapāde ṭakārādi pañcatattvaṃ varānane || 10/6 ||	dakṣa pāde ṭakāra ādi pañcatattvam varānane 
MBkaamadhenutantraHK-503	takārādi pañcatattvaṃ vāmapāde paśasyate |	                
MBkaamadhenutantraHK-504	pakāraṃ dakṣapārśvañca phakāraṃ vāmapārśvake || 10/7 ||	pakāram dakṣa pārśvam ca phakāram vāma pārśvake 
MBkaamadhenutantraHK-505	bakāraṃ pṛṣṭhatattvañca bhakāraṃ nābhireva ca |	bakāram pṛṣṭhatattvam ca bhakāram nābhiḥ eva ca 
MBkaamadhenutantraHK-506	makāraṃ udaraṃ tattvaṃ yakāraṃ hṛdayaṃ tathā || 10/8 ||	makāram udaram tattvam yakāram hṛdayam tathā 
MBkaamadhenutantraHK-507	rakāraṃ skandatattvañca lakāraṃ vāmameva ca |	rakāram skanda tattvam ca lakāram vāmam eva ca 
MBkaamadhenutantraHK-508	ghaṭitattvaṃ vakārañca śakāraṃ dakṣabāhuṣu || 10/9 ||	ghaṭi tattvam vakāram ca śakāram dakṣa bāhuṣu 
MBkaamadhenutantraHK-509	vāmabāhau ṣakārañca sakāraṃ dakṣapādakam |	vāma bāhau ṣakāram ca sakāram dakṣa pādakam 
MBkaamadhenutantraHK-510	vāmapādaṃ hakārañca kṣakāraṃ śirasopari || 10/10 ||	vāma pādam hakāram ca kṣakāram śirasā upari 
MBkaamadhenutantraHK-511	akāraṃ bījatattvañca takāraṃ praṇavena ca |	akāram bīja tattvam ca takāram praṇavena ca 
MBkaamadhenutantraHK-512	makārañca sakārañca maṇḍitaṃ hi tathaiva ca || 10/11 ||	makāram ca sakāram ca maṇḍitam hi tathā eva ca 
MBkaamadhenutantraHK-513	ahaṅkāraḥ pakāraṃ syāt phakāro manasastathā |	ahaṅkāraḥ pakāram syāt phakāraḥ manasaḥ tathā 
MBkaamadhenutantraHK-514	nakāraṃ śabdatattvañca daṃ dhaṃ rūpaṃ praśasyate || 10/12 ||	nakāram śabda tattvam ca daṃ dhaṃ rūpam praśasyate 
MBkaamadhenutantraHK-515	gakāraṃ pādatattvañca chakāropasthameva ca |	gakāram pāda tattvam ca chakāra upastham eva ca 
MBkaamadhenutantraHK-516	ukāramākāśatattvañca ūkāraṃ śrotrameva ca || 10/13 ||	ukāram ākāśa tattvam ca ūkāram śrotram eva ca 
MBkaamadhenutantraHK-517	tvaktattvañca jakāraḥ syād jhakāraḥ pādameva ca |	tvac tattvam ca jakāraḥ syāt jhakāraḥ pādam eva ca 
MBkaamadhenutantraHK-518	kakāraḥ pṛthvītattvaṃ khakāro jñānatattvakam || 10/14 ||	           
MBkaamadhenutantraHK-519	śakāraṃ hṛtpuṇḍarīkaṃ ṣakāraṃ tattvamaṇḍalam |	śakāram hṛd puṇḍarīkam ṣakāram tattva maṇḍalam 
MBkaamadhenutantraHK-520	sakarāñca tathā candraṃ rakāraṃ vahnimaṇḍalam || 10/15 ||	sakarān ca tathā candram rakāram vahni maṇḍalam 
MBkaamadhenutantraHK-521	parameṣṭhi tathā tattvaṃ ṣakāraḥ surapūjite |	parameṣṭhi tathā tattvam ṣakāraḥ sura pūjite 
MBkaamadhenutantraHK-522	lakāraṃ pṛthvītattvaṃ hakārañca śirastathā || 10/16 ||	lakāram pṛthvī tattvam hakāram ca śiraḥ tathā 
MBkaamadhenutantraHK-523	yakāraṃ vāyutattvañca kakāraṃ svargameva ca |	yakāram vāyu tattvam ca kakāram svargam eva ca 
MBkaamadhenutantraHK-524	etayoryogamāsādya kṣakāraṃ tattvavigraham || 10/17 ||	etayoḥ yogam āsādya kṣakāram tattva vigraham 
MBkaamadhenutantraHK-525	tena a ta ma sa pa pha na da dha ga cha u ū ja jha ka kha śa ṣa sa ra ya la ha kṣa	tena a ta ma sa pa pha na da dha ga cha u ū ja jha ka kha śa ṣa sa ra ya la ha kṣa 
MBkaamadhenutantraHK-526	akārādikṣāntavarṇaṃ tattvañca pañcaviṃśatiḥ |	akāra ādi kṣa anta varṇam tattvam ca pañcaviṃśatiḥ 
MBkaamadhenutantraHK-527	sarvatattvamatiguhyaṃ paramātmā sulocane || 10/18 ||	sarva tattvam ati guhyam paramātmā su locane 
MBkaamadhenutantraHK-528	mātṛkāyā varārohe kramānnāmāni saṃśṛṇu |	mātṛkāyāḥ varārohe kramāt nāmāni saṃśṛṇu 
MBkaamadhenutantraHK-529	brahmāṇī caṇḍikā raudrī gaurīndrāṇī tathaiva ca || 10/19 ||	brahmāṇī caṇḍikā raudrī gaurī indrāṇī tathā eva ca 
MBkaamadhenutantraHK-530	kaumāro vaiṣṇavī durgā tathaiva nārasiṃhikā |	kaumāraḥ vaiṣṇavī durgā tathā eva nārasiṃhikā 
MBkaamadhenutantraHK-531	kālikā muṇḍamālā ca śivadūtī tathā parā || 10/20 ||	kālikā muṇḍamālā ca śivadūtī tathā parā 
MBkaamadhenutantraHK-532	varāhī kauṣikī caiva tathā māheśvarī priye |	varāhī kauṣikī ca eva tathā māheśvarī priye 
MBkaamadhenutantraHK-533	śaṅkarī ca jayantī ca maṃgalā kalimardinī || 10/21 ||	śaṅkarī ca jayantī ca maṃgalā kali mardinī 
MBkaamadhenutantraHK-534	pālikā caiva medhā ca śivarūpā ca śāmbhavī |	pālikā ca eva medhā ca śivarūpā ca śāmbhavī 
MBkaamadhenutantraHK-535	bhīmā śāntā ca ugrā ca bhrāmarī rudrarūpiṇī || 10/22 ||	    ca         
MBkaamadhenutantraHK-536	ambikā bahurūpā ca kṣemā kṣemaṅkarī tathā |	ambikā bahurūpā ca kṣemā kṣemaṅkarī tathā 
MBkaamadhenutantraHK-537	dhātrīrūpā svadhā svāhā tathaiva vahnirūpiṇī || 10/23 ||	dhātrī rūpā svadhā svāhā tathā eva vahni rūpiṇī 
MBkaamadhenutantraHK-538	aparṇā ca tathā māyā ghorarūpā priyaṃvadā |	aparṇā ca tathā māyā ghora rūpā priyaṃvadā 
MBkaamadhenutantraHK-539	brahmāṇḍavāṇī brāhmī ca pañcāśanmātṛkāḥ smṛtāḥ || 10/24 ||	brahmāṇḍa vāṇī brāhmī ca pañcāśat mātṛkāḥ smṛtāḥ 
MBkaamadhenutantraHK-540	ityetat kathitaṃ samyak kevalaṃ tava bhaktitaḥ |	iti etat kathitam samyak kevalam tava bhaktitaḥ 
MBkaamadhenutantraHK-541	etāstu mātṛkādevyo brahmāṇḍaṃ sacarācaram || 10/25 ||	etāḥ tu mātṛkā devyaḥ brahmāṇḍam sa carācaram 
MBkaamadhenutantraHK-542	vyāpya tiṣṭhanti cārvāṅgi nānāmūrttidharāvyayāḥ |	vyāpya tiṣṭhanti cāru aṅgi nānā mūrtti dharā avyayāḥ 
MBkaamadhenutantraHK-543	śaktimantre viṣṇumantre śaive saure ca pārvati || 10/26 ||	śakti mantre viṣṇu mantre śaive saure ca pārvati 
MBkaamadhenutantraHK-544	anyasarveṣu mantreṣu gaṇeśe varavarṇini |	anya sarveṣu mantreṣu gaṇeśe varavarṇini 
MBkaamadhenutantraHK-545	mātṛkā yuvatīrūpā mantravigraharūpiṇī || 10/27 ||	mātṛkā yuvatī rūpā mantra vigraha rūpiṇī 
MBkaamadhenutantraHK-546	brahmā viṣṇuśca rudraśca īśvaraśca sadāśivaḥ |	brahmā viṣṇuḥ ca rudraḥ ca īśvaraḥ ca sadāśivaḥ 
MBkaamadhenutantraHK-547	te sarve cañcalāpāṅgi niścalāśca nirindriyāḥ || 10/28 ||	te sarve cañcalāpāṅgi niścalāḥ ca nirindriyāḥ 
MBkaamadhenutantraHK-548	devādīnāṃ varārohe mantraṃ nāsti kadācana |	deva ādīnām varārohe mantram na asti kadācana 
MBkaamadhenutantraHK-549	śabdabrahma yadā yāti tantraṃ mantraṃ tadā bhavet || 10/29 ||	śabdabrahma yadā yāti tantram mantram tadā bhavet 
MBkaamadhenutantraHK-550	pañcāśadyuvatī sarvā śabdabrahmasvarūpiṇī |	pañcāśat yuvatī sarvā śabdabrahma svarūpiṇī 
MBkaamadhenutantraHK-551	brahmaṇaḥ kāraṇaṃ nāsti prakṛterasti bhāvini || 10/30 ||	brahmaṇaḥ kāraṇam na asti prakṛteḥ asti bhāvini 
MBkaamadhenutantraHK-552	prakṛteryā varārohe sā dīkṣā sarvasammatā |	prakṛteḥ yā varārohe sā dīkṣā sarva sammatā 
MBkaamadhenutantraHK-553	dīkṣāyāṃ cañcalāpāṅgi praśastā yuvatīkalā || 10/31 ||	dīkṣāyām cañcalāpāṅgi praśastā yuvatī kalā 
MBkaamadhenutantraHK-554	pañcāśanmātṛkā yā sā yuvatī parigīyate |	pañcāśat mātṛkā yā sā yuvatī parigīyate 
MBkaamadhenutantraHK-555	yuvatīrahitaṃ devi kuto vidyā kuto manuḥ |	yuvatī rahitam devi kutas vidyā kutas manuḥ 
MBkaamadhenutantraHK-556	nirguṇaṃ paramaṃ brahma pradhānā yuvatīgaṇāḥ || 10/32 ||	nirguṇam paramam brahma pradhānāḥ yuvatī gaṇāḥ 
MBkaamadhenutantraHK-557	iti śrīkāmadhenutantre devadevīsaṃvāde daśamaḥ paṭalaḥ ||	iti śrī kāmadhenutantre devadevī saṃvāde daśamaḥ paṭalaḥ 
MBkaamadhenutantraHK-558	ekādaśaḥ paṭalaḥ	ekādaśaḥ paṭalaḥ 
MBkaamadhenutantraHK-559	śrīśiva uvāca	   uvāca 
MBkaamadhenutantraHK-560	yathā jale sūryatattvaṃ tathā mantre pratiṣṭhitam |	yathā jale sūrya tattvam tathā mantre pratiṣṭhitam 
MBkaamadhenutantraHK-561	devīnāṃ jyotiṣaḥ puñjo vartante prakṛteḥ kalāḥ || 11/1 ||	devīnām jyotiṣaḥ puñjaḥ vartante prakṛteḥ kalāḥ 
MBkaamadhenutantraHK-562	athāntarātmā paramaṃ jñānātmā suvarānane |	atha antarātmā paramam jñāna ātmā suvarānane 
MBkaamadhenutantraHK-563	vartante yuvatīrūpāḥ ṣoḍaśa prakṛ(tiḥ?teḥ) parāḥ || 11/2 ||	vartante yuvatī rūpāḥ ṣoḍaśa parāḥ 
MBkaamadhenutantraHK-564	prakṛtiṃ hi vinā devi jñātā brahmā sanātanaḥ |	prakṛtim hi vinā devi jñātā brahmā sanātanaḥ 
MBkaamadhenutantraHK-565	ata eva varārohe sa eva śrīsadāśivaḥ || 11/3 ||	atas eva varārohe saḥ eva śrī sadāśivaḥ 
MBkaamadhenutantraHK-566	jāgrat svapnasuṣuptiryā turīyā varavarṇini |	jāgrat svapna suṣuptiḥ yā turīyā varavarṇini 
MBkaamadhenutantraHK-567	tāstāḥ sarvā varārohe yuvatī paramāparā || 11/4 ||	tāḥ tāḥ sarvāḥ varārohe yuvatī parama aparā 
MBkaamadhenutantraHK-568	kāryakāraṇakāle ca gaṇanīyā varānane |	kārya kāraṇa kāle ca gaṇanīyāḥ varānane 
MBkaamadhenutantraHK-569	śūnyāt śūnyaṃ paraṃ śūnyaṃ śūnyarūpaṃ nirañjanam || 11/5 ||	śūnyāt śūnyam param śūnyam śūnya rūpam nirañjanam 
MBkaamadhenutantraHK-570	koṭisūryapratīkāśaṃ nirmalaṃ jñānamuttamam |	koṭi sūrya pratīkāśam nirmalam jñānam uttamam 
MBkaamadhenutantraHK-571	hṛdi bhāvaya cārvaṅgi tejaḥpuñjaṃ mahāprabham || 11/6 ||	hṛdi bhāvaya cāru aṅgi tejaḥ puñjam mahā prabham 
MBkaamadhenutantraHK-572	dalitāñcanapuñjābhaṃ varṇarājaṃ varānane |	dalita añcana puñja ābham varṇa rājam varānane 
MBkaamadhenutantraHK-573	tribhaṅgalalitākāraṃ cārucūḍāvirājitam || 11/7 ||	tri bhaṅga lalita ākāram cāru cūḍā virājitam 
MBkaamadhenutantraHK-574	śikhipucchayutaṃ cūḍaṃ bhramaraiḥ śobhitaṃ param |	śikhi puccha yutam cūḍam bhramaraiḥ śobhitam param 
MBkaamadhenutantraHK-575	pītāṃśukaparīdhānaṃ vanamālāvibhūṣitam || 11/8 ||	pīta aṃśuka parīdhānam vanamālā vibhūṣitam 
MBkaamadhenutantraHK-576	ratnakuṇḍalasaṃyuktaṃ sphuradgaṇḍamanoharam |	ratna kuṇḍala saṃyuktam sphurat gaṇḍa manoharam 
MBkaamadhenutantraHK-577	kadambakusumopetaṃ śravaṇaṃ janamohitam || 11/9 ||	kadamba kusuma upetam śravaṇam jana mohitam 
MBkaamadhenutantraHK-578	śrīvatsakaustubhoddīptaṃ ājānubāhurājitam |	             
MBkaamadhenutantraHK-579	āraktanayanadvandvaṃ koṭividyutsamadyutim || 11/10 ||	ārakta nayana dvandvam koṭi vidyut sama dyutim 
MBkaamadhenutantraHK-580	āraktacaraṇadvandvaṃ nūpurārāvasaṃyutam |	ārakta caraṇa dvandvam nūpura ārāva saṃyutam 
MBkaamadhenutantraHK-581	āraktakaratalasvacchaṃ guñjamālāvirājitam || 11/11 ||	ārakta kara tala svaccham guñja mālā virājitam 
MBkaamadhenutantraHK-582	śabdabrahmamayaṃ viṣṇuṃ ikāraṃ śabdajalpitam |	śabdabrahma mayam viṣṇum ikāram śabda jalpitam 
MBkaamadhenutantraHK-583	evaṃrūpaṃ samutpannaṃ hṛdi madhye varānane || 11/12 ||	evaṃrūpam samutpannam hṛdi madhye varānane  /
MBkaamadhenutantraHK-584	jāyate kāmabījāttu śūnyamadhye sulocane |	jāyate kāma bījāt tu śūnya madhye su locane 
MBkaamadhenutantraHK-585	śūnyamadhye sthitā devi kāmabījasvarūpiṇī || 11/13 ||	śūnya madhye sthitā devi kāma bīja svarūpiṇī 
MBkaamadhenutantraHK-586	lakārasaṃyutā yā sā kṛṣṇamātā pragīyate |	lakāra saṃyutā yā sā kṛṣṇamātā pragīyate 
MBkaamadhenutantraHK-587	sarveṣu viṣṇumantreṣu kāmabījaṃ parātparam || 11/14 ||	sarveṣu viṣṇu mantreṣu kāmabījam parātparam 
MBkaamadhenutantraHK-588	hṛdi śūnye maheśāni viṣṇormantraṃ japet priye |	hṛdi śūnye maheśāni viṣṇoḥ mantram japet priye 
MBkaamadhenutantraHK-589	tato vai kāmabījāttu jāyate viṣṇuvigraham || 11/15 ||	tatas vai kāma bījāt tu jāyate viṣṇu vigraham 
MBkaamadhenutantraHK-590	ataṃ kāmamayaṃ viṣṇuṃ hṛdi bhāvaya pārvati |	atam kāma mayam viṣṇum hṛdi bhāvaya pārvati 
MBkaamadhenutantraHK-591	kāminī yā maheśāni viṣṇumātā pragīyate || 11/16 ||	kāminī yā maheśāni viṣṇu mātā pragīyate  /
MBkaamadhenutantraHK-592	ato viṣṇumātṛvarṇaṃ varṇarājamavāpnuyāt |	atas viṣṇu mātṛ varṇam varṇarājam avāpnuyāt 
MBkaamadhenutantraHK-593	kakāraḥ kāminī sākṣād lakāraḥ pṛthivīśvarī || 11/17 ||	kakāraḥ kāminī sākṣāt lakāraḥ pṛthivīśvarī 
MBkaamadhenutantraHK-594	ratistu mardinī sākṣād nādastu yonirūpiṇī |	ratiḥ tu mardinī sākṣāt nādaḥ tu yoni rūpiṇī 
MBkaamadhenutantraHK-595	binduḥ kuṇḍalinīrūpaṃ śivaśaktimayaṃ priye || 11/18 ||	binduḥ kuṇḍalinī rūpam śiva śakti mayam priye 
MBkaamadhenutantraHK-596	idaṃ bījaṃ maheśāni viṣṇumātā parākṣarā |	idam bījam maheśāni viṣṇumātā para akṣarā 
MBkaamadhenutantraHK-597	nirakṣaro viṣṇudevo hyakṣarājjāyate dhruvam || 11/19 ||	nirakṣaraḥ viṣṇudevaḥ hi akṣarāt jāyate dhruvam 
MBkaamadhenutantraHK-598	ata eva varārohe brahmaṇaḥ kāraṇaṃ parā |	atas eva varārohe brahmaṇaḥ kāraṇam parā 
MBkaamadhenutantraHK-599	klīṃkārabījarūpā yā sā parā parigīyate || 11/20 ||	klīṃkāra bīja rūpā yā sā parā parigīyate 
MBkaamadhenutantraHK-600	parātparatarā sā'pi vahnimaṇḍalasaṃyutā |	parātparatarā sā api vahni maṇḍala saṃyutā 
MBkaamadhenutantraHK-601	kāminī sā maheśāni pṛthivī tasya āsanam || 11/21 ||	kāminī sā maheśāni pṛthivī tasya āsanam  /
MBkaamadhenutantraHK-602	kadācit pṛthivīmadhye kadācid vahnimaṇḍale |	kadācid pṛthivī madhye kadācid vahni maṇḍale 
MBkaamadhenutantraHK-603	vasate kāminī devī bindutrayasamanvitā || 11/22 ||	vasate kāminī devī bindu traya samanvitā 
MBkaamadhenutantraHK-604	janmalabdhā mahāviṣṇuḥ kūrcabījaṃ japet priye |	janma labdhā mahā viṣṇuḥ kūrca bījam japet priye 
MBkaamadhenutantraHK-605	anena prajapenmantraṃ huṃkāraṃ varavarṇini || 11/23 ||	anena prajapet mantram huṃkāram varavarṇini 
MBkaamadhenutantraHK-606	viṣṇorvigrahaṇe tattu svayaṃ prakṛtimūrtimān |	viṣṇoḥ vigrahaṇe tat tu svayam prakṛti mūrtimān 
MBkaamadhenutantraHK-607	prakṛtiḥ paramārādhyā devānāṃ naganandini || 11/24 ||	prakṛtiḥ parama ārādhyā devānām naga nandini 
MBkaamadhenutantraHK-608	huṃkāraṃ paramāścaryaṃ bījarantaṃ śṛṇu priye |	huṃkāram parama āścaryam bīja rantam śṛṇu priye 
MBkaamadhenutantraHK-609	ṣaṣṭhasvaraḥ paricayo viyadbījaṃ śaśiprabham || 11/25 ||	ṣaṣṭha svaraḥ paricayaḥ viyadbījam śaśiprabham 
MBkaamadhenutantraHK-610	tasyopari varārohesadābinduṃ vibhāvaya |	tasya upari varārohe sadā bindum vibhāvaya 
MBkaamadhenutantraHK-611	kāmamanmathakandarpam akṣaradhvajasaṃjñakam || 11/26 ||	kāma manmatha kandarpam akṣaradhvaja saṃjñakam 
MBkaamadhenutantraHK-612	mīnaketurmaheśāni pañcabījaṃ prakīrtitam |	mīnaketuḥ maheśāni pañcabījam prakīrtitam 
MBkaamadhenutantraHK-613	māyākūrcaṃ vadhūbījaṃ lakṣmībījañca pārvati || 11/27 ||	māyā kūrcam vadhū bījam lakṣmī bījam ca pārvati 
MBkaamadhenutantraHK-614	praṇavañca maheśāni svayaṃ caturdaśaṃ tathā |	praṇavam ca maheśāni svayam caturdaśam tathā 
MBkaamadhenutantraHK-615	sapiṇḍavattathā devi yeṣu yāsu ca vidyate || 11/28 ||	sapiṇḍa vat tathā devi yeṣu yāsu ca vidyate 
MBkaamadhenutantraHK-616	tanmantramatisiddhaṃ syāt paraḥ prakṛtirūpiṇī |	tat mantra mati siddham syāt paraḥ prakṛti rūpiṇī 
MBkaamadhenutantraHK-617	evaṃ bījaṃ sakṛd dhyātvā sarvāsāṃ bhavati priyaḥ || 11/29 ||	evam bījam sakṛt dhyātvā sarvāsām bhavati priyaḥ  /
MBkaamadhenutantraHK-618	tanmantraṃ prajapeddevi bījadhyānaṃ punaḥ priye |	tat mantram prajapet devi bīja dhyānam punar priye 
MBkaamadhenutantraHK-619	evaṃ hi daśadhā kṛtvā mantrāṇāṃ bījasādhanam || 11/30 ||	evam hi daśadhā kṛtvā mantrāṇām bīja sādhanam 
MBkaamadhenutantraHK-620	tasmād bījāt samākṛṣya devatārūpamudbhavam |	tasmāt bījāt samākṛṣya devatā rūpam udbhavam 
MBkaamadhenutantraHK-621	devadhyānaṃ tataḥ kṛtvā iṣṭamantraṃ tato japet || 11/31 ||	deva dhyānam tatas kṛtvā iṣṭa mantram tatas japet  /
MBkaamadhenutantraHK-622	punardhyānaṃ devatāyāḥ punarjāpaṃ kuru priye |	punar dhyānam devatāyāḥ punar jāpam kuru priye 
MBkaamadhenutantraHK-623	evaṃ hi daśadhā kṛtvā devādhiṣṭhānameva ca || 11/32 ||	evam hi daśadhā kṛtvā deva adhiṣṭhānam eva ca 
MBkaamadhenutantraHK-624	tataḥ saptacchadāṃ japtvā kullukāṃ daśadhā japet |	tatas sapta chadām japtvā kullukām daśadhā japet 
MBkaamadhenutantraHK-625	ādyante setumantrañca datvā aṣṭottaraṃ japet |	ādi ante setu mantram ca da tvā aṣṭa uttaram japet 
MBkaamadhenutantraHK-626	tanmantraṃ prajapeddevi evaṃ siddhimupālabhe || 11/33 ||	tat mantram prajapet devi evam siddhim upālabhe 
MBkaamadhenutantraHK-627	iti kāmadhenutantre devadevīsaṃvāde ekādaśaḥ paṭalaḥ ||	iti kāmadhenu tantre devadevī saṃvāde ekādaśaḥ paṭalaḥ 
MBkaamadhenutantraHK-628	dvādaśaḥ paṭalaḥ	dvādaśaḥ paṭalaḥ 
MBkaamadhenutantraHK-629	śrīmahādeva uvāca	śrī mahādevaḥ uvāca 
MBkaamadhenutantraHK-630	aparaikaṃ pravakṣyāmi rahasyamatigopanam |	apara ekam pravakṣyāmi rahasya mati gopanam 
MBkaamadhenutantraHK-631	akṛtvā dhyānatattvañca aṣṭatattvaṃ tathaiva ca || 12/1 ||	a kṛtvā dhyāna tattvam ca aṣṭa tattvam tathā eva ca 
MBkaamadhenutantraHK-632	akṛtvā vyarthatāṃ yāti nātra kāryā vicāraṇā |	a kṛtvā vyartha tām yāti na atra kāryā vicāraṇā 
MBkaamadhenutantraHK-633	tato jīvatvamāpnoti mantraḥ sidhyati tatkṣaṇāt || 12/2 ||	tatas jīva tvam āpnoti mantraḥ sidhyati tad kṣaṇāt 
MBkaamadhenutantraHK-634	athavā parameśāni mantravarṇaṃ yathā tathā |	athavā parameśāni mantra varṇam yathā tathā 
MBkaamadhenutantraHK-635	praṇavapuṭitaṃ kṛtvā anulomavilomataḥ || 12/3 ||	        
MBkaamadhenutantraHK-636	tadaiva parameśāni jīvatvaṃ prāpyate manuḥ |	tadā eva parameśāni jīva tvam prāpyate manuḥ 
MBkaamadhenutantraHK-637	ekadhā vā tridhā kṛtvā yadi kuryād varānane || 12/4 ||	ekadhā vā tridhā kṛtvā yadi kuryāt varānane 
MBkaamadhenutantraHK-638	tadā siddhimavāpnoti nānyathā surapūjite |	tadā siddhim avāpnoti na anyathā sura pūjite 
MBkaamadhenutantraHK-639	jīvatvaṃ hi vinā devi yadi mantraṃ japet sudhīḥ || 12/5 ||	jīva tvam hi vinā devi yadi mantram japet sudhīḥ 
MBkaamadhenutantraHK-640	tajjapaṃ cañcalāpāṅgi śavameva na saṃśayaḥ |	tat japam cañcalāpāṅgi śavam eva na saṃśayaḥ 
MBkaamadhenutantraHK-641	sadā nidrāturo mantrī jīvahīnaśca pārvati || 12/6 ||	sadā nidrā āturaḥ mantrī jīva hīnaḥ ca pārvati 
MBkaamadhenutantraHK-642	śrīṃ klīṃ hrīṃ huṃ strīṃ śrīṃ om |	śrīṃ klīṃ hrīṃ hum strīṃ śrīṃ om 
MBkaamadhenutantraHK-643	kathaṃ siddhimavāpnoti nidrāyāṃ varavarṇini |	katham siddhim avāpnoti nidrāyām varavarṇini 
MBkaamadhenutantraHK-644	jīvanyāsena cārvaṅgi nidrābhaṅgo bhaved dhruvam || 12/7 ||	jīva nyāsena cāru aṅgi nidrā bhaṅgaḥ bhavet dhruvam 
MBkaamadhenutantraHK-645	bindutattvaṃ prajapyātha jñānatatvañca sundari |	bindu tattvam prajapya atha jñāna tatvam ca sundari 
MBkaamadhenutantraHK-646	prāṇatattvañca cārvaṅgi devatattvaṃ tathaiva ca || 12/8 ||	prāṇa tattvam ca cāru aṅgi deva tattvam tathā eva ca 
MBkaamadhenutantraHK-647	japatattvaṃ mantratattvaṃ dhyānatattvaṃ sulocane |	japa tattvam mantra tattvam dhyāna tattvam su locane 
MBkaamadhenutantraHK-648	akṣare akṣare devi ajñātvā prajaped yadi || 12/9 ||	akṣare akṣare devi a jñātvā prajapet yadi 
MBkaamadhenutantraHK-649	saṃyogaṃ yad bhaved yogaṃ praphullaṃ tadudāhṛtam |	saṃyogam yat bhavet yogam praphullam tat udāhṛtam 
MBkaamadhenutantraHK-650	kevalaṃ kalikābījaṃ tadvarṇaṃ surapūjite || 12/10 ||	kevalam kalikā bījam tad varṇam sura pūjite 
MBkaamadhenutantraHK-651	āgataṃ mama vaktrād yad gataṃ tava mukhe sadā |	āgatam mama vaktrāt yat gatam tava mukhe sadā 
MBkaamadhenutantraHK-652	mataṃ śrīvāsudevasya iti te kathitaṃ priye || 12/11 ||	matam śrī vāsudevasya iti te kathitam priye 
MBkaamadhenutantraHK-653	etanmantraṃ mahāguhyaṃ īśānamukhasaṃyutam |	etat mantram mahā guhyam īśāna mukha saṃyutam 
MBkaamadhenutantraHK-654	etanmantraprabhāvāddhi kālakūṭaṃ pibāmyaham || 12/12 ||	etad mantra prabhāvāt hi kālakūṭam pibāmi aham 
MBkaamadhenutantraHK-655	etāstu mātṛkā varṇāḥ suṣumnāmadhyavartinaḥ |	etāḥ tu mātṛkāḥ varṇāḥ suṣumnā madhya vartinaḥ 
MBkaamadhenutantraHK-656	ete varṇā varārohe mahāyogamayāḥ sadā || 12/13 ||	ete varṇāḥ varārohe mahā yoga mayāḥ sadā 
MBkaamadhenutantraHK-657	akṣaraṃ hi vinā devi na yogo jāyate mama |	akṣaram hi vinā devi na yogaḥ jāyate mama 
MBkaamadhenutantraHK-658	yogamārge bhaktimārge muktimārge ca sundari || 12/14 ||	yoga mārge bhakti mārge mukti mārge ca sundari 
MBkaamadhenutantraHK-659	dhyānamārge tu pūjāyāṃ japamārge tathaiva ca |	dhyāna mārge tu pūjāyām japa mārge tathā eva ca 
MBkaamadhenutantraHK-660	etāstu yuvatīvarṇāḥ kāryakāraṇarūpiṇaḥ || 12/15 ||	etāḥ tu yuvatī varṇāḥ kārya kāraṇa rūpiṇaḥ 
MBkaamadhenutantraHK-661	etanmantramavijñāya na japtavyaṃ kadācana |	etat mantram a vijñāya na japtavyam kadācana 
MBkaamadhenutantraHK-662	etanmantramavijñāya purāṇaṃ saṃhitāṃ smṛtim || 12/16 ||	etat mantram a vijñāya purāṇam saṃhitām smṛtim 
MBkaamadhenutantraHK-663	paṭhannarakamāpnoti pitṛbhiḥ saha nānyathā |	paṭhat narakam āpnoti pitṛbhiḥ saha na anyathā 
MBkaamadhenutantraHK-664	sarvadharmeṣu yatkarma sarvayajñeṣu yatphalam || 12/17 ||	sarva dharmeṣu yat karma sarva yajñeṣu yat phalam 
MBkaamadhenutantraHK-665	sarvadāneṣu tīrtheṣu yatphalaṃ prāpnuyād dvijaḥ |	sarva dāneṣu tīrtheṣu yat phalam prāpnuyāt dvijaḥ 
MBkaamadhenutantraHK-666	tatphalaṃ samavāpnoti varṇānāṃ dhyānamātrataḥ || 12/18 ||	tat phalam samavāpnoti varṇānām dhyāna mātrataḥ 
MBkaamadhenutantraHK-667	varṇadhyānamavijñāya varṇatattvaṃ tathaiva ca |	varṇa dhyānam a vijñāya varṇa tattvam tathā eva ca 
MBkaamadhenutantraHK-668	purāṇavācako yastu dhruvaṃ narakamāpnuyāt || 12/19 ||	purāṇa vācakaḥ yaḥ tu dhruvam narakam āpnuyāt 
MBkaamadhenutantraHK-669	koṭivaṃśān samādāya sa dvijo narakaṃ brajet |	koṭi vaṃśān samādāya sa dvijaḥ narakam brajet 
MBkaamadhenutantraHK-670	yathā vaktā tathā śrotā dvayorapi phalaṃ samam || 12/20 ||	yathā vaktā tathā śrotā dvayoḥ api phalam samam 
MBkaamadhenutantraHK-671	kathamajñānato mūrkho'jñātvā varṇavinirṇayam |	katham ajñānataḥ mūrkhaḥ jñātvā varṇa vinirṇayam 
MBkaamadhenutantraHK-672	purāṇāni paṭhitvā vai niścayaṃ narakaṃ vrajet || 12/21 ||	purāṇāni paṭhitvā vai niścayam narakam vrajet  /
MBkaamadhenutantraHK-673	niścayañca maheśāni dāridryaṃ ghoramāpnuyāt |	niścayam ca maheśāni dāridryam ghoram āpnuyāt 
MBkaamadhenutantraHK-674	niścayaṃ rogamāpnoti jambūdvīpasya bhārate || 12/22 ||	niścayam rogam āpnoti jambūdvīpasya bhārate 
MBkaamadhenutantraHK-675	sa syāt sanātano devo vāṇī tripurasundarī |	sa syāt sanātanaḥ devaḥ vāṇī tripurasundarī 
MBkaamadhenutantraHK-676	sarvāsāṃ yuvatīnāñca bhavānī cādhidevatā || 12/23 ||	sarvāsām yuvatīnām ca bhavānī ca adhidevatā 
MBkaamadhenutantraHK-677	dhyāyed devīṃ mahāmāyāṃ mātṛkāṃ jagadīśvarīm |	dhyāyet devīm mahāmāyām mātṛkām jagat īśvarīm 
MBkaamadhenutantraHK-678	raktapadmāsanagatāṃ raktāṃśukapariṣkṛtām || 12/24 ||	rakta padmāsana gatām rakta aṃśuka pariṣkṛtām 
MBkaamadhenutantraHK-679	raktacandanaliptāṅgīṃ raktavastrottarīyiṇīm |	raktacandana lipta aṅgīm rakta vastra uttarīyiṇīm 
MBkaamadhenutantraHK-680	raktabimbaphalābhāsāṃ rākācandramukhīṃ parām || 12/25 ||	rakta bimba phala ābhāsām rākā candra mukhīm parām 
MBkaamadhenutantraHK-681	bhramadbhramaralīlābhanayanatrayarājitām |	bhramat bhramara līlā ābha nayana traya rājitām 
MBkaamadhenutantraHK-682	kaṭākṣaśatasaṃyuktāṃ cārucūḍāvinodinīm || 12/26 ||	kaṭākṣa śata saṃyuktām cāru cūḍā vinodinīm 
MBkaamadhenutantraHK-683	raktālaṅkārasubhagāṃ tribhaṅgilalitākṛtim |	rakta alaṅkāra subhagām tri bhaṅgi lalita ākṛtim 
MBkaamadhenutantraHK-684	hāsyayuktāṃ praphullāsyāṃ jyotsnājālasamacchavim || 12/27 ||	hāsya yuktām praphulla āsyām jyotsnā jāla sama chavim 
MBkaamadhenutantraHK-685	mṛṇālasadṛśākārabāhuvallīvirājitām |	mṛṇāla sadṛśa ākāra bāhu vallī virājitām 
MBkaamadhenutantraHK-686	kañculīsaṃyutāṃ ramyāṃ kadambakorakastanīm || 12/28 ||	kañculī saṃyutām ramyām kadamba koraka stanīm 
MBkaamadhenutantraHK-687	nakhānāṃ kiraṇodyotairbhuvanaṃ parimohayan |	nakhānām kiraṇa udyotaiḥ bhuvanam parimohayan 
MBkaamadhenutantraHK-688	evaṃ dhyātvā mahāmāyāṃ bhavānīṃ śivamohinīm || 12/29 ||	evam dhyātvā mahāmāyām bhavānīm śiva mohinīm 
MBkaamadhenutantraHK-689	aparaikaṃ pravakṣyāmi rahasyaṃ pramādbhutam |	apara ekam pravakṣyāmi rahasyam 
MBkaamadhenutantraHK-690	hṛtpadme dvādaśadale varāhopari bhāvayet || 12/30 ||	              
MBkaamadhenutantraHK-691	yasyadevasya yadbījaṃ praphullakalikāṃ tathā |	yasya devasya yat bījam praphulla kalikām tathā 
MBkaamadhenutantraHK-692	dhyātvādevīṃ yathāśaktyā tasmādāvirbhavet svayam || 12/31 ||	dhyātvā devīm yathāśaktyā tasmāt āvirbhavet svayam 
MBkaamadhenutantraHK-693	śaktirvā viṣṇudevo vā śivo vā sūrya eva vā |	śaktiḥ vā viṣṇu devaḥ vā śivaḥ vā sūryaḥ eva vā 
MBkaamadhenutantraHK-694	bījādutpadyate devi paraṃbrahma nirañjanam || 12/32 ||	bījāt utpadyate devi param brahma nirañjanam 
MBkaamadhenutantraHK-695	bījadhyānaṃ vinā devi kathamutpadyate hariḥ |	bījadhyānam vinā devi katham utpadyate hariḥ 
MBkaamadhenutantraHK-696	sadāśivo mahādevaḥ kathamutpadyate svayam || 12/33 ||	sadāśivaḥ mahādevaḥ katham utpadyate svayam 
MBkaamadhenutantraHK-697	sadāśivasya jananī bījarūpā sanātanī |	sadāśivasya jananī bīja rūpā sanātanī 
MBkaamadhenutantraHK-698	iti yo vetti sa jñānī sa eva vīrasattamaḥ || 12/34 ||	iti yaḥ vetti sa jñānī saḥ eva vīra sattamaḥ 
MBkaamadhenutantraHK-699	gururyogyaḥ sa eva syāt sa eva paramaḥ śivaḥ |	guruḥ yogyaḥ saḥ eva syāt saḥ eva paramaḥ śivaḥ 
MBkaamadhenutantraHK-700	sarveṣāñcaiva bījānāmevaṃ dhyānaṃ samācaret || 12/35 ||	sarveṣām ca eva bījānām evam dhyānam samācaret 
MBkaamadhenutantraHK-701	śuklavidyutsamākārāṃ nayanatrayadhāriṇīm |	śukla vidyut sama ākārām nayana traya dhāriṇīm 
MBkaamadhenutantraHK-702	kaṭākṣaviśikhairyuktāṃ caturbāhusamanvitām || 12/36 ||	kaṭākṣa viśikhaiḥ yuktām catur bāhu samanvitām 
MBkaamadhenutantraHK-703	tribhaṅgalalitākārāṃ cārucūḍāvirājitām |	tri bhaṅga lalita ākārām cāru cūḍā virājitām 
MBkaamadhenutantraHK-704	puṇḍarīkopaviṣṭāñca rākācandramukhīṃ parām || 12/37 ||	puṇḍarīka upaviṣṭān ca rākā candra mukhīm parām 
MBkaamadhenutantraHK-705	nānāgandhapraliptāṅgīṃ sugandhimālyasaṃskṛtām |	nānā gandha pralipta aṅgīm sugandhi mālya saṃskṛtām 
MBkaamadhenutantraHK-706	nānābharaṇadīptāṅgīṃ meghāṃśukapariṣkṛtām || 12/38 ||	nānā ābharaṇa dīpta aṅgīm megha aṃśuka pariṣkṛtām 
MBkaamadhenutantraHK-707	vīṇāvādyavinodena ullasantīṃ jagattrayam |	vīṇā vādya vinodena ullasantīm jagattrayam 
MBkaamadhenutantraHK-708	ādyāṃ brahmamayīṃ devīmiṣṭabījasvarūpiṇīm || 12/39 ||	ādyām brahma mayīm devīm iṣṭa bīja svarūpiṇīm 
MBkaamadhenutantraHK-709	brahmādyā devatā yasyāścaraṇe patitā bhuvi |	brahma ādyāḥ devatāḥ yasyāḥ caraṇe patitāḥ bhuvi 
MBkaamadhenutantraHK-710	bhaje'haṃ mātṛkādevīṃ vedamātā sanātanīm || 12/40 ||	bhaja iham mātṛkā devīm vedamātā sanātanīm 
MBkaamadhenutantraHK-711	anena vidhinā dhyātvā sarvāsāṃ bhavati priyaḥ |	anena vidhinā dhyātvā sarvāsām bhavati priyaḥ 
MBkaamadhenutantraHK-712	bījametanmaheśāni prathamaṃ daśadhā japet || 12/41 ||	bījam etat maheśāni prathamam daśadhā japet 
MBkaamadhenutantraHK-713	tanmantraṃ cañcalāpāṅgi ānandapaṭale sthitam |	tat mantram cañcalāpāṅgi ānanda paṭale sthitam 
MBkaamadhenutantraHK-714	tato dhyātvā punarjaptvā daśadhā varavarṇini || 12/42 ||	tatas dhyātvā punar japtvā daśadhā varavarṇini 
MBkaamadhenutantraHK-715	etattattvamavijñāya prajaped yadi pārvati |	etat tattvam a vijñāya prajapet yadi pārvati 
MBkaamadhenutantraHK-716	sarvapāpamayaḥ so'pi bhavet śūkaravad dvijaḥ || 12/43 ||	sarva pāpa mayaḥ saḥ api bhavet śūkara vat dvijaḥ 
MBkaamadhenutantraHK-717	tattvametanmahāguhyaṃ yogamārge sthitaṃ sadā |	tattvam etat mahā guhyam yoga mārge sthitam sadā 
MBkaamadhenutantraHK-718	tava bhaktyā mayākhyātamatiguhyaṃ sulocane || 12/44 ||	tava bhaktyā mayā ākhyātam ati guhyam su locane 
MBkaamadhenutantraHK-719	tantrāṇāṃ sārametattu sarvasiddhipradāyakam |	tantrāṇām sāram etat tu sarva siddhi pradāyakam 
MBkaamadhenutantraHK-720	sa yogī yogavettā ca yogātmā yoganāyakaḥ ||	sa yogī yoga vettā ca yoga ātmā yoga nāyakaḥ 
MBkaamadhenutantraHK-721	yogācāryo yogamāyā yogānandapradāyakaḥ || 12/45 ||	            
MBkaamadhenutantraHK-722	iti śrīkāmadhenutantre devadevīsaṃvāde dvādaśaḥ paṭalaḥ ||	iti śrī kāmadhenutantre devadevī saṃvāde dvādaśaḥ paṭalaḥ 
MBkaamadhenutantraHK-723	trayodaśaḥ paṭalaḥ	trayodaśaḥ paṭalaḥ 
MBkaamadhenutantraHK-724	śrīmahādeva uvāca	śrī mahādevaḥ uvāca 
MBkaamadhenutantraHK-725	adhunā saṃpravakṣyāmi ānandapaṭalaṃ priye |	adhunā saṃpravakṣyāmi ānanda paṭalam priye 
MBkaamadhenutantraHK-726	śṛṇu tattvaṃ pravakṣyāmi sundaraṃ sumanoharam || 13/1 ||	śṛṇu tattvam pravakṣyāmi sundaram su manoharam 
MBkaamadhenutantraHK-727	hṛtpadme dvādaśadale vidyutkoṭisamanvite |	hṛd padme dvādaśa dale vidyut koṭi samanvite 
MBkaamadhenutantraHK-728	bhāvayenmantrabījāni yasya yā iṣṭadevatā || 13/2 ||	bhāvayet mantra bījāni yasya yā iṣṭadevatā 
MBkaamadhenutantraHK-729	bhāvayet prathamaṃ bījaṃ varāṭopari pārvati |	bhāvayet prathamam bījam varāṭa upari pārvati 
MBkaamadhenutantraHK-730	anyāni sarvabījāni patramadhye pṛthak pṛthak || 13/3 ||	anyāni sarva bījāni patra madhye pṛthak pṛthak 
MBkaamadhenutantraHK-731	evaṃ hi daśadhā japtvā kramād bījaṃ japet priye |	evam hi daśadhā japtvā kramāt bījam japet priye 
MBkaamadhenutantraHK-732	daśadhā daśadhā devi prajaped bījamuttamam || 13/4 ||	daśadhā daśadhā devi prajapet bījam uttamam 
MBkaamadhenutantraHK-733	tatastu bījamadhye tu dhyāyediṣṭaṃ sulocane |	tatas tu bīja madhye tu dhyāyet iṣṭam su locane 
MBkaamadhenutantraHK-734	tasmād bījād varārohe devatā jāyate dhruvam || 13/5 ||	tasmāt bījāt varārohe devatā jāyate dhruvam 
MBkaamadhenutantraHK-735	tasya devasya cārvaṅgi nirīkṣya dehasundaram |	tasya devasya cāru aṅgi nirīkṣya deha sundaram 
MBkaamadhenutantraHK-736	caraṇāt keśaparyantaṃ nānāveśamayaṃ priye || 13/6 ||	caraṇāt keśa paryantam nānā veśa mayam priye 
MBkaamadhenutantraHK-737	nirīkṣya manasā bhaktyā punardhyānaṃ samācaret |	nirīkṣya manasā bhaktyā punar dhyānam samācaret 
MBkaamadhenutantraHK-738	tatastu prajaped bījaṃ varṇānandasvarūpiṇam || 13/7 ||	tatas tu prajapet bījam varṇa ānanda svarūpiṇam 
MBkaamadhenutantraHK-739	prajapet prathamaṃ bījaṃ bījadhyānaṃ tataḥ param |	prajapet prathamam bījam bīja dhyānam tatas param 
MBkaamadhenutantraHK-740	etattu prathamaṃ bījaṃ sādhanaṃ durlabhaṃ priye || 13/8 ||	etat tu prathamam bījam sādhanam durlabham priye 
MBkaamadhenutantraHK-741	sarveṣāṃ bījavarṇānāṃ yadi jānāti sādhakaḥ |	sarveṣām bīja varṇānām yadi jānāti sādhakaḥ 
MBkaamadhenutantraHK-742	dhyānaṃ paramakalyāṇaṃ varṇe varṇe pṛthak pṛthak || 13/9 ||	dhyānam parama kalyāṇam varṇe varṇe pṛthak pṛthak 
MBkaamadhenutantraHK-743	ajñātvā cañcalāpāṅgi mātṛkādhyānamācaret |	a jñātvā cañcalāpāṅgi mātṛkā dhyānam ācaret 
MBkaamadhenutantraHK-744	tadevaṃ sahasā devi sarvāsāṃ jāyate dhruvam || 13/10 ||	tat evam sahasā devi sarvāsām jāyate dhruvam 
MBkaamadhenutantraHK-745	yasya mantrasya yadvarṇaṃ tasya dhyānaṃ pṛthak pṛthak |	yasya mantrasya yad varṇam tasya dhyānam pṛthak pṛthak 
MBkaamadhenutantraHK-746	bījāttu jāyate viṣṇuravatāravaraḥ priye || 13/11 ||	bījāt tu jāyate viṣṇuḥ avatāra varaḥ priye 
MBkaamadhenutantraHK-747	bījāttu jāyate rāmo bījāt kṛṣṇaḥ prajāyate |	bījāt tu jāyate rāmaḥ bījāt kṛṣṇaḥ prajāyate 
MBkaamadhenutantraHK-748	sthāvaraṃ jaṅgamaṃ devi sarvaṃ bījāt prajāyate || 13/12 ||	sthāvaram jaṅgamam devi sarvam bījāt prajāyate 
MBkaamadhenutantraHK-749	ājñācakre viśuddhau ca mūlādhāre tataḥ priye |	ājñācakre viśuddhau ca mūlādhāre tatas priye 
MBkaamadhenutantraHK-750	svādhiṣṭhāne tato devi maṇipūre ca pārvati || 13/13 ||	svādhiṣṭhāne tatas devi maṇipūre ca pārvati  /
MBkaamadhenutantraHK-751	anena vidhinā devi kuryāt sādhakasattamaḥ |	anena vidhinā devi kuryāt sādhaka sattamaḥ 
MBkaamadhenutantraHK-752	pratyahaṃ kurute yastu sa siddhaḥ śiva eva saḥ || 13/14 ||	pratyaham kurute yaḥ tu sa siddhaḥ śivaḥ eva saḥ 
MBkaamadhenutantraHK-753	pratyahaṃ cañcalāpāṅgi ṣaṭcakraṃ bhrāmayettu yaḥ |	pratyaham cañcalāpāṅgi ṣaṭcakram bhrāmayet tu yaḥ 
MBkaamadhenutantraHK-754	sādhanācca maheśāni tasmāt kusumavat priye || 13/15 ||	sādhanāt ca maheśāni tasmāt kusuma vat priye 
MBkaamadhenutantraHK-755	nityañca hṛdaye kuryādavaśyaṃ vada kiṃ priye |	nityam ca hṛdaye kuryāt avaśyam vada kim priye 
MBkaamadhenutantraHK-756	bījasya cañcalāpāṅgi dhyānaṃ mantraṃ pṛthak pṛthak || 13/16 ||	bījasya cañcalāpāṅgi dhyānam mantram pṛthak pṛthak 
MBkaamadhenutantraHK-757	sākṣāt śrīḥ prakṛtirdevī bījarūpā sanātanī |	sākṣāt śrīḥ prakṛtiḥ devī bīja rūpā sanātanī 
MBkaamadhenutantraHK-758	sanātanasya jananī sarvavarṇamayī priye || 13/17 ||	sanātanasya jananī sarva varṇa mayī priye 
MBkaamadhenutantraHK-759	japasya prathame kāle bījasya tattvamuccaret |	japasya prathame kāle bījasya tattvam uccaret 
MBkaamadhenutantraHK-760	tatastu prajapenmantraṃ sasetu varavarṇini || 13/18 ||	tatas tu prajapet mantram sasetu varavarṇini 
MBkaamadhenutantraHK-761	bījatattvamavijñāya prajaped yadi koṭidhā |	bīja tattvam a vijñāya prajapet yadi koṭidhā 
MBkaamadhenutantraHK-762	sarvaṃ tasya vṛthā devi araṇye rodanaṃ yathā || 13/19 ||	sarvam tasya vṛthā devi araṇye rodanam yathā 
MBkaamadhenutantraHK-763	tattvatrayaṃ pravakṣyāmi mantrāṇāṃ śṛṇu sundari |	tattva trayam pravakṣyāmi mantrāṇām śṛṇu sundari 
MBkaamadhenutantraHK-764	vibhāvya nābhipadmeṣu vāyubījaṃ sabindukam || 13/20 ||	vibhāvya nābhi padmeṣu vāyubījam sa bindukam 
MBkaamadhenutantraHK-765	mantrasya prathamaṃ vāyubījaṃ madhye vicintya vai |	mantrasya prathamam vāyubījam madhye vicintya vai 
MBkaamadhenutantraHK-766	dhyātvā bījaṃ maheśāni prajaped bījamuttamam || 13/21 ||	dhyātvā bījam maheśāni prajapet bījam uttamam 
MBkaamadhenutantraHK-767	daśadhā prajaped bījaṃ daśadhā dhyānameva ca |	daśadhā prajapet bījam daśadhā dhyānam eva ca 
MBkaamadhenutantraHK-768	daśatattvayutaṃ mantraṃ tadaiva sahasā bhavet || 13/22 ||	daśa tattva yutam mantram tadā eva sahasā bhavet 
MBkaamadhenutantraHK-769	saṃśoṣya bījaṃ cārvaṅgi vahnibīje vicintya vai |	saṃśoṣya bījam cārvaṅgi vahnibīje vicintya vai 
MBkaamadhenutantraHK-770	hṛtpadme vahnimadhye tu dhyātvā bījaṃ hutāśanam || 13/23 ||	hṛd padme vahni madhye tu dhyātvā bījam hutāśanam 
MBkaamadhenutantraHK-771	daśadhā prajapenmantraṃ daśadhā dhyānameva ca |	daśadhā prajapet mantram daśadhā dhyānam eva ca 
MBkaamadhenutantraHK-772	viṃśatattvayutaṃ mantraṃ tadaiva sahasā bhavet || 13/24 ||	viṃśa tattva yutam mantram tadā eva sahasā bhavet 
MBkaamadhenutantraHK-773	mātṛsvarāttato devi galitāmṛtadhārayā |	mātṛ svarāt tatas devi galita amṛta dhārayā 
MBkaamadhenutantraHK-774	āplāvya bījaṃ cārvaṅgi sarvāvayavasaṃyutam || 13/25 ||	āplāvya bījam cāru aṅgi sarva avayava saṃyutam 
MBkaamadhenutantraHK-775	tadaiva sahasā kṛtvā lalāṭe varuṇālaye |	tadā eva sahasā kṛtvā lalāṭe varuṇālaye 
MBkaamadhenutantraHK-776	varuṇasya tu madhye tu tadbījaṃ bhāvayet priye || 13/26 ||	varuṇasya tu madhye tu tad bījam bhāvayet priye 
MBkaamadhenutantraHK-777	daśadhā ca japitvā vai bījañca daśadhā smaret |	daśadhā ca japitvā vai bījañca daśadhā smaret 
MBkaamadhenutantraHK-778	tadāmṛtamayaṃ bījaṃ sahasā bhavati priye || 13/27 ||	tadā amṛta mayam bījam sahasā bhavati priye 
MBkaamadhenutantraHK-779	viṣṇumantreṣu deveśi candrabījeṣu bhāvayet |	viṣṇu mantreṣu deveśi candra bījeṣu bhāvayet 
MBkaamadhenutantraHK-780	anyat sarveṣu mantreṣu bhāvayed varuṇālaye || 13/28 ||	anyat sarveṣu mantreṣu bhāvayet varuṇālaye 
MBkaamadhenutantraHK-781	triṃśattattvayutaṃ mantraṃ tadaiva bhavati priye |	triṃśat tattva yutam mantram tadā eva bhavati priye 
MBkaamadhenutantraHK-782	tattvātītaṃ svadhātītaṃ vācā vidyāṃ japet priye || 13/29 ||	tattva atītam svadhā atītam vācā vidyām japet priye 
MBkaamadhenutantraHK-783	anena vidhihīnañca tajjapaṃ viphalaṃ sadā |	anena vidhi hīnam ca tat japam viphalam sadā 
MBkaamadhenutantraHK-784	tattvahīnaṃ japedyastu viphalaṃ satataṃ priye || 13/30 ||	tattva hīnam japet yaḥ tu viphalam satatam priye 
MBkaamadhenutantraHK-785	śoṣaṇaṃ dahanaṃ devi amṛtaṃ jñānasaṃjñakam |	śoṣaṇam dahanam devi amṛtam jñāna saṃjñakam 
MBkaamadhenutantraHK-786	etat tattvamayaṃ bhadre śīghraṃ siddhipradāyakam || 13/31 ||	etat tattva mayam bhadre śīghram siddhi pradāyakam 
MBkaamadhenutantraHK-787	yo japettattvarahitaṃ tasya hāniḥ pade pade |	yaḥ japet tattva rahitam tasya hāniḥ pade pade 
MBkaamadhenutantraHK-788	tasmāttattvaṃ śubhārādhya tasmānmantraṃ japet sudhīḥ || 13/32 ||	tasmāt tattvam śubha ārādhya tasmāt mantram japet sudhīḥ 
MBkaamadhenutantraHK-789	anena vidhinā devi sarvatattvamayaṃ manum |	anena vidhinā devi sarva tattva mayam manum 
MBkaamadhenutantraHK-790	kṛṣṇamantreṣu rāmeṣu avatāravareṣu ca || 13/33 ||	kṛṣṇa mantreṣu rāmeṣu avatāra vareṣu ca 
MBkaamadhenutantraHK-791	saure gaṇapatau devi śaktimantre svayaṃ priye |	saure gaṇapatau devi śakti mantre svayam priye 
MBkaamadhenutantraHK-792	śivamantreṣu cārvaṅgi anyatantre tathaiva ca || 13/34 ||	śiva mantreṣu cāru aṅgi anya tantre tathā eva ca 
MBkaamadhenutantraHK-793	triṃśattattvayutaṃ kṛtvā mantraṃ bījaṃ sulocane |	triṃśat tattva yutam kṛtvā mantram bījam su locane 
MBkaamadhenutantraHK-794	evameva vidhānena bīje jīvatvamāpnuyāt || 13/35 ||	evam eva vidhānena bīje jīva tvam āpnuyāt 
MBkaamadhenutantraHK-795	tasmād bījād varārohe rāmakṛṣṇādayaśca ye |	tasmāt bījāt varārohe rāmakṛṣṇa ādayaḥ ca ye 
MBkaamadhenutantraHK-796	utpadyante varārohe nānyathā varavarṇini || 13/36 ||	utpadyante varārohe na anyathā varavarṇini 
MBkaamadhenutantraHK-797	etanmantraṃ sakṛt kṛtvā prajapedaniśaṃ manum |	etat mantram sakṛt kṛtvā prajapet aniśam manum 
MBkaamadhenutantraHK-798	prajapedaniśaṃ vidyāṃ śaucāśaucaṃ na cācaret || 13/37 ||	prajapet aniśam vidyām śauca āśaucam na ca ācaret 
MBkaamadhenutantraHK-799	mantre akṣarabuddhiḥ syād gurau tu mānavaḥ priye |	mantre akṣara buddhiḥ syāt gurau tu mānavaḥ priye 
MBkaamadhenutantraHK-800	devatāyāṃ varārohe pratimābuddhirjāyate || 13/38 ||	devatāyām varārohe pratimā buddhiḥ jāyate 
MBkaamadhenutantraHK-801	kiṃ tasya japapūjāyāṃ sarvaṃ vyarthaṃ kadarthanam |	kim tasya japa pūjāyām sarvam vyartham kadarthanam 
MBkaamadhenutantraHK-802	iti te kathitaṃ devi bījatattvaṃ sugopanam || 13/39 ||	iti te kathitam devi bīja tattvam su gopanam 
MBkaamadhenutantraHK-803	kasyacinnaiva vaktavyaṃ yadi kalyāṇamicchasi |	kasyacid nā eva vaktavyam yadi kalyāṇam icchasi 
MBkaamadhenutantraHK-804	etajjñānamavijñāya sa kathaṃ gurutāṃ vrajet || 13/40 ||	etat jñānam a vijñāya sa katham guru tām vrajet 
MBkaamadhenutantraHK-805	iti śrīkāmadhenutantre devadevīsaṃvāde trayodaśaḥ paṭalaḥ ||	iti śrī kāmadhenutantre devadevī saṃvāde trayodaśaḥ paṭalaḥ 
MBkaamadhenutantraHK-806	caturdaśaḥ paṭalaḥ	caturdaśaḥ paṭalaḥ 
MBkaamadhenutantraHK-807	śrīmahādeva uvāca	śrī mahādevaḥ uvāca 
MBkaamadhenutantraHK-808	devadeva mahādeva saṃsārārṇavatāraka |	devadeva mahādeva saṃsāra arṇava tāraka 
MBkaamadhenutantraHK-809	kṛpayā kathayeśāna vakāratattvamuttamam || 14/1 ||	kṛpayā kathaya īśāna vakāra tattvam uttamam 
MBkaamadhenutantraHK-810	śrīmahādeva uvāca	śrī mahādevaḥ uvāca 
MBkaamadhenutantraHK-811	pūrvoktaṃ cañcalāpāṅgi gāyatrītattvamuttamam |	pūrva uktam cañcalāpāṅgi gāyatrī tattvam uttamam 
MBkaamadhenutantraHK-812	gāyatrī yā varārohe caturvakārasaṃyutā || 14/2 ||	gāyatrī yā varārohe catur vakāra saṃyutā 
MBkaamadhenutantraHK-813	kāntaṃ śeṣavakārañca varuṇaṃ hṛdi bhāvaya |	kāntam śeṣa vakāram ca varuṇam hṛdi bhāvaya 
MBkaamadhenutantraHK-814	yavargaṃ vāyubījañca hṛdi bhāvaya pārvati || 14/3 ||	yavargam vāyubījam ca hṛdi bhāvaya pārvati 
MBkaamadhenutantraHK-815	yavargaṃ yattu deveśi vāyubījaṃ taducyate |	ya vargam yat tu deveśi vāyubījam tat ucyate 
MBkaamadhenutantraHK-816	yakārasya caturtho yo vāyubījaṃ prakīrtitam || 14/4 ||	yakārasya caturthaḥ yaḥ vāyubījam prakīrtitam 
MBkaamadhenutantraHK-817	yavargañca vāyubījaṃ mayaitanniścitaṃ priye |	vāyubījam mayā etat niścitam priye 
MBkaamadhenutantraHK-818	sarvavidyāsu mantreṣu varuṇaṃ bhāvaya priye || 14/5 ||	sarva vidyāsu mantreṣu varuṇam bhāvaya priye 
MBkaamadhenutantraHK-819	vahnijāyāyutānāñca pavargaṃ hṛdi bhāvaya |	vahnijāyā ayutānām ca pavargam hṛdi bhāvaya 
MBkaamadhenutantraHK-820	gāyatrī saṃsthitā devi pāpoccāṭanakarmaṇi || 14/6 ||	gāyatrī saṃsthitā devi pāpa uccāṭana karmaṇi  /
MBkaamadhenutantraHK-821	pūrvoktadhyānamārgeṇa bhāvanā parikīrttitā |	pūrva ukta dhyāna mārgeṇa bhāvanā parikīrttitā 
MBkaamadhenutantraHK-822	dhyānabhedena cārvaṅgi vakāraṃ bhāvaya priye || 14/7 ||	dhyāna bhedena cāru aṅgi vakāram bhāvaya priye 
MBkaamadhenutantraHK-823	adhunā saṃpravakṣyāmi kakāradhyānamuttamam |	adhunā saṃpravakṣyāmi kakāra dhyānam uttamam 
MBkaamadhenutantraHK-824	viśeṣaṃ śṛṇu vakṣyāmi kakārasyātidurlabham || 14/8 ||	viśeṣam śṛṇu vakṣyāmi kakārasya ati durlabham 
MBkaamadhenutantraHK-825	yannoktamānandapaṭale adhunā kathayāmi te |	yat na uktam ānandapaṭale adhunā kathayāmi te 
MBkaamadhenutantraHK-826	tad dhyātvā sādhako yāti durlabhaṃ mokṣamavyayam || 14/9 ||	tat dhyātvā sādhakaḥ yāti durlabham mokṣam avyayam 
MBkaamadhenutantraHK-827	yena dhyānaprakāśena mantraṃ tantrañca sidhyati |	yena dhyāna prakāśena mantram tantram ca sidhyati 
MBkaamadhenutantraHK-828	evaṃ taddhyānamātreṇa śivatulyo bhavennaraḥ || 14/10 ||	evam tad dhyāna mātreṇa śiva tulyaḥ bhavet naraḥ 
MBkaamadhenutantraHK-829	kakāradhyānamātreṇa sarvavarṇaṃ hi sidhyati |	kakāra dhyāna mātreṇa sarva varṇam hi sidhyati 
MBkaamadhenutantraHK-830	kakārabhāvanāccaiva sarvāsāṃ bhāvanā bhavet || 14/11 ||	kakāra bhāvanāt ca eva sarvāsām bhāvanā bhavet 
MBkaamadhenutantraHK-831	tasmāt sarvaprayatnena kakāraṃ hṛdi bhāvaya |	tasmāt sarva prayatnena kakāram hṛdi bhāvaya 
MBkaamadhenutantraHK-832	om prātarādityasaṃkāśāṃ siṃhapṛṣṭhoparisthitām || 14/12 ||	om prātar āditya saṃkāśām siṃha pṛṣṭha upari sthitām 
MBkaamadhenutantraHK-833	raktapadmopaviṣṭāñca raktavastraparīvṛtām |	rakta padma upaviṣṭām ca rakta vastra parīvṛtām 
MBkaamadhenutantraHK-834	caturbhūjāṃ trinetrāñca pañcabāṇadhanurdharām || 14/13 ||	catur bhūjām tri netrām ca pañcabāṇa dhanuḥ dharām 
MBkaamadhenutantraHK-835	varadābhayadātrīñca pīnatuṅgapayodharām |	varada abhaya dātrīm ca pīna tuṅga payodharām 
MBkaamadhenutantraHK-836	mṛṇālasadṛśākāracaturbāhuparīvṛtām || 14/14 ||	mṛṇāla sadṛśa ākāra catur bāhu parīvṛtām 
MBkaamadhenutantraHK-837	śaṅkhakaṅkaṇakeyūrairaṅgadaiḥ pariśobhitām |	śaṅkha kaṅkaṇa keyūraiḥ aṅgadaiḥ pariśobhitām 
MBkaamadhenutantraHK-838	sugandhimallikāhāraiḥ kabarīmadhyaśobhitām || 14/15 ||	sugandhi mallikā hāraiḥ kabarī madhya śobhitām 
MBkaamadhenutantraHK-839	tribhaṅgalalitākārāṃ cārucūḍāvirājitām |	tri bhaṅga lalita ākārām cāru cūḍā virājitām 
MBkaamadhenutantraHK-840	śikhipucchayutāṃ cūḍāṃ nānāratnasamanvitām || 14/16 ||	śikhi puccha yutām cūḍām nānā ratna samanvitām 
MBkaamadhenutantraHK-841	īṣadhāsyaprasannāsyāṃ muktārañjitanāsikām |	īṣadhā āsya prasanna āsyām muktā rañjita nāsikām 
MBkaamadhenutantraHK-842	māṇikyakiraṇodyotadantapaṅktivirājitām || 14/17 ||	māṇikya kiraṇa udyota danta paṅkti virājitām 
MBkaamadhenutantraHK-843	pūrṇacandrasamābhāsanakhapaṅktimanuttamām |	pūrṇa candra sama ābhāsa nakha paṅktim anuttamām 
MBkaamadhenutantraHK-844	svarṇasūtrayutahāraratnacāruvinirmitām || 14/18 ||	svarṇa sūtra yuta hāra ratna cāru vinirmitām 
MBkaamadhenutantraHK-845	kaṭākṣaviśikhoddīptabhrūlatāpariśobhitām |	kaṭākṣa viśikha uddīpta bhrū latā pariśobhitām 
MBkaamadhenutantraHK-846	tīrthatrayayutāṃ ramyāṃ nayanatrayarājitām || 14/19 ||	tīrtha traya yutām ramyām nayana traya rājitām 
MBkaamadhenutantraHK-847	rāmarambhāsamākāra - ūrudvayavirājitām |	rāma rambhā sama ākāraḥ ūru dvaya virājitām 
MBkaamadhenutantraHK-848	bṛhallatāsusaṃyuktaratnakiñjalkaśobhitām || 14/20 ||	bṛhat latā su saṃyukta ratna kiñjalka śobhitām 
MBkaamadhenutantraHK-849	aṣṭavargaiḥ sevitāñca aṣṭavargaiḥ prapūjitām |	aṣṭavargaiḥ sevitām ca aṣṭavargaiḥ prapūjitām 
MBkaamadhenutantraHK-850	sindūratilakodīptāmañjanāṅkitalocanām || 14/21 ||	sindūra tilaka udīptām añjana aṅkita locanām 
MBkaamadhenutantraHK-851	lalāṭapaṭṭikāśubhrāmarddhacandraparīvṛtām |	lalāṭa paṭṭikā śubhrām arddhacandra parīvṛtām 
MBkaamadhenutantraHK-852	brahmādidevatāvṛndaiḥ śirasi dhāryate ca yā || 14/22 ||	brahma ādi devatā vṛndaiḥ śirasi dhāryate ca yā 
MBkaamadhenutantraHK-853	kimākhyāṃ kāminīṃ sākṣāt kakāravararūpiṇīm |	kimākhyām kāminīm sākṣāt kakāra vara rūpiṇīm 
MBkaamadhenutantraHK-854	evaṃ dhyātvā varārohe prajaped yadi sādhakaḥ || 14/23 ||	evam dhyātvā varārohe prajapet yadi sādhakaḥ 
MBkaamadhenutantraHK-855	tadaiva sahasā siddhirjāyate tasya sundari |	tadā eva sahasā siddhiḥ jāyate tasya sundari 
MBkaamadhenutantraHK-856	varṇajñānaṃ vinā devi na japet pāśavaḥ kvacit || 14/24 ||	varṇa jñānam vinā devi na japet pāśavaḥ kvacid 
MBkaamadhenutantraHK-857	kiṃ tasya dhyānapūjāyāṃ puraścaryāśataṃ śatam |	kim tasya dhyāna pūjāyām puraścaryā śatam śatam 
MBkaamadhenutantraHK-858	kiṃ tasya japahomena candrasūryasya parvaṇi || 14/25 ||	kim tasya japa homena candra sūryasya parvaṇi  /
MBkaamadhenutantraHK-859	varṇajñānaṃ vinā devi vaiṣṇavaḥ śaiva eva vā |	varṇa jñānam vinā devi vaiṣṇavaḥ śaivaḥ eva vā 
MBkaamadhenutantraHK-860	ekadā noccareddevi ajñātvā vrṇadīpanīm || 14/26 ||	ekadā na uccaret devi a jñātvā vrṇadīpanīm 
MBkaamadhenutantraHK-861	sarvāsāṃ mantravidyānāṃ dīpanī yā prakīrtitā |	sarvāsām mantra vidyānām dīpanī yā prakīrtitā 
MBkaamadhenutantraHK-862	sarveṣāṃ śāstramadhye tu praśastā varṇadīpanī || 14/27 ||	sarveṣām śāstra madhye tu praśastā varṇa dīpanī 
MBkaamadhenutantraHK-863	śaktimantre tathā saure gaṇeśamarcyate sadā |	śakti mantre tathā saure gaṇeśam arcyate sadā 
MBkaamadhenutantraHK-864	jñātvā tantraṃ prakurvīta dīkṣāṃ pūjāṃ śucismite || 14/28 ||	jñātvā tantram prakurvīta dīkṣām pūjām śuci smite 
MBkaamadhenutantraHK-865	śrīmahādeva uvāca	śrī mahādevaḥ uvāca 
MBkaamadhenutantraHK-866	rahasyaṃ tatra vakṣyāmi atyantagopanaṃ śṛṇu |	rahasyam tatra vakṣyāmi atyanta gopanam śṛṇu 
MBkaamadhenutantraHK-867	yatkṛtvā sādhako yāti paramaṃ padamuttamam || 14/29 ||	yat kṛtvā sādhakaḥ yāti paramam padam uttamam 
MBkaamadhenutantraHK-868	lalāṭe tilakaṃ kṛtvā candanena sugandhinā |	lalāṭe tilakam kṛtvā candanena sugandhinā 
MBkaamadhenutantraHK-869	karpūrāgurukastūrīrocanākuṅkumaiḥ priye || 14/30 ||	karpūra aguru kastūrī rocanā kuṅkumaiḥ priye 
MBkaamadhenutantraHK-870	tilakaṃ dhārayed yatnādekīkṛtya manoharam |	tilakam dhārayet yatnāt ekīkṛtya manoharam 
MBkaamadhenutantraHK-871	trikoṇaṃ sundaraṃ svacchaṃ tilakaṃ janamohanam || 14/31 ||	trikoṇam sundaram svaccham tilakam jana mohanam 
MBkaamadhenutantraHK-872	ekīkṛtya pṛthag vāpi nānāvastuṣu kārayet |	ekīkṛtya pṛthak vā api nānā vastuṣu kārayet 
MBkaamadhenutantraHK-873	rājyārthī raktavarṇena mokṣārthī śvetacandanaiḥ || 14/32 ||	rājya arthī rakta varṇena mokṣa arthī śveta candanaiḥ 
MBkaamadhenutantraHK-874	vaśye rocanayā devi tilakaṃ kārayet sudhīḥ |	vaśye rocanayā devi tilakam kārayet sudhīḥ 
MBkaamadhenutantraHK-875	mohane cañcalāpāṅgi agurukuṅkumādinā || 14/33 ||	mohane cañcalāpāṅgi aguru kuṅkuma ādinā 
MBkaamadhenutantraHK-876	kṛṣṇagandhaṃ varārohe śatrormāraṇakarmaṇi |	kṛṣṇa gandham varārohe śatroḥ māraṇa karmaṇi 
MBkaamadhenutantraHK-877	lalāṭe bāhumūle ca tathā skandhadvayeṣu ca || 14/34 ||	lalāṭe bāhumūle ca tathā skandha dvayeṣu ca 
MBkaamadhenutantraHK-878	hṛtpadmapārśvayugale pṛṣṭhe nābhau ca sundari |	hṛd padma pārśva yugale pṛṣṭhe nābhau ca sundari 
MBkaamadhenutantraHK-879	ūrudvaye gaṇḍayugme adhaḥ pādadvayeṣu ca || 14/35 ||	ūru dvaye gaṇḍa yugme adhas pāda dvayeṣu ca 
MBkaamadhenutantraHK-880	vilikhed yatnato devi kakāravarṇamuttamam |	vilikhet yatnatas devi kakāra varṇam uttamam 
MBkaamadhenutantraHK-881	candravinduyutaṃ kṛtvā vilikhed varavarṇini || 14/36 ||	            
MBkaamadhenutantraHK-882	tadaiva sahasā devi vidyā mantrañca sidhyati |	tadā eva sahasā devi vidyā mantram ca sidhyati 
MBkaamadhenutantraHK-883	mohayedakhilān lokān vaśayediṣṭadevatām || 14/37 ||	mohayet akhilān lokān vaśayet iṣṭadevatām 
MBkaamadhenutantraHK-884	iṣṭadevaṃ vaśaṃ kṛtvā ekadā prajaped yadi |	iṣṭadevam vaśam kṛtvā ekadā prajapet yadi 
MBkaamadhenutantraHK-885	tatkṣaṇāccañcalāpāṅgi devatvamupajāyate || 14/38 ||	tad kṣaṇāt cañcalāpāṅgi deva tvam upajāyate 
MBkaamadhenutantraHK-886	devatvaṃ hi vinā devi kutaḥ pūjā kuto japaḥ |	deva tvam hi vinā devi kutas pūjā kutas japaḥ 
MBkaamadhenutantraHK-887	anyathā pretavat pūjā vaiṣṇave ca viśeṣataḥ || 14/39 ||	anyathā preta vat pūjā vaiṣṇave ca viśeṣataḥ 
MBkaamadhenutantraHK-888	lalāṭe tilakaṃ kṛtvā rocanāsu śucismite |	lalāṭe tilakam kṛtvā rocanāsu śuci smite 
MBkaamadhenutantraHK-889	tanmadhye vilikhed varṇaṃ kakāraṃ sumanoharam || 14/40 ||	tad madhye vilikhet varṇam kakāram su manoharam 
MBkaamadhenutantraHK-890	sāmānyametat kathitaṃ tilakaṃ janamohanam |	sāmānyam etat kathitam tilakam jana mohanam 
MBkaamadhenutantraHK-891	etattu tilakañcaiva vaśayedapi keśavam || 14/41 ||	etat tu tilakam ca eva vaśayet api keśavam 
MBkaamadhenutantraHK-892	japāsanaṃ daśamyāntu tadārabhya ca pratyaham |	japa āsanam daśamyām tu tat ārabhya ca pratyaham 
MBkaamadhenutantraHK-893	etadvarṇamavijñāya viṣaye samupāsmahe |	etat varṇam a vijñāya viṣaye samupāsmahe 
MBkaamadhenutantraHK-894	sa bhraṣṭaḥ sa ca pāpiṣṭho rauravaṃ narakaṃ vrajet || 14/42 ||	sa bhraṣṭaḥ sa ca pāpiṣṭhaḥ rauravam narakam vrajet  /
MBkaamadhenutantraHK-895	iti śrīkāmadhenutantre devadevīsaṃvāde caturdaśaḥ paṭalaḥ ||	iti śrī kāmadhenutantre devadevī saṃvāde caturdaśaḥ paṭalaḥ 
MBkaamadhenutantraHK-896	pañcadaśaḥ paṭalaḥ	pañcadaśaḥ paṭalaḥ 
MBkaamadhenutantraHK-897	śrīdevī uvāca	śrī devī uvāca 
MBkaamadhenutantraHK-898	devadeva mahādeva nīlakaṇṭha trilocana |	devadeva mahādeva nīlakaṇṭha trilocana 
MBkaamadhenutantraHK-899	hṛttatvaṃ kathayeśāna yadyahaṃ tava vallabhā || 15/1 ||	kathaya īśāna yadi aham tava vallabhā  /
MBkaamadhenutantraHK-900	śrīmahādeva uvāca	śrī mahādevaḥ uvāca 
MBkaamadhenutantraHK-901	śṛṇu devi pravakṣyāmi jñānaṃ paramadurlabham |	śṛṇu devi pravakṣyāmi jñānam parama durlabham 
MBkaamadhenutantraHK-902	yena vijñānamātreṇa viṣṇuḥ syād vaiṣṇavaḥ priye || 15/2 ||	yena vijñāna mātreṇa viṣṇuḥ syāt vaiṣṇavaḥ priye   
MBkaamadhenutantraHK-903	hṛtpadme dvādaśadale svavidyāṃ bhāvayet sudhīḥ |	        bhāvayet   
MBkaamadhenutantraHK-904	kakāraṃ bhāvayedādau varāṭopari pārvati || 15/3 ||	  bhāvayet        
MBkaamadhenutantraHK-905	patre patre tato devi svavidyāṃ prajapet sudhīḥ |	patre patre tatas devi sva vidyām prajapet sudhīḥ 
MBkaamadhenutantraHK-906	mantrāṇāṃ prathamaṃ bījaṃ dhyātvādau prajapet sudhīḥ || 15/4 ||	mantrāṇām prathamam bījam dhyātvā ādau prajapet sudhīḥ 
MBkaamadhenutantraHK-907	tasmānmantrāttato devi jāyate devavigraham |	tasmāt mantrāt tatas devi jāyate deva vigraham 
MBkaamadhenutantraHK-908	devatāñca tato dhyātvā tantroktadhyānavartmanā || 15/5 ||	devatāḥ ca tatas dhyātvā tantra ukta dhyāna vartmanā 
MBkaamadhenutantraHK-909	dhyānañca trividhaṃ devi samānaphaladāyakam |	dhyānam ca trividham devi samāna phala dāyakam 
MBkaamadhenutantraHK-910	kṛtvā dhyānatrayaṃ devi hṛtpadme parameśvari || 15/6 ||	kṛtvā dhyāna trayam devi hṛd padme parameśvari  
MBkaamadhenutantraHK-911	sahasradalapadmāntarmadhyasthāne gurormukhāt |	sahasra dala padma antar madhya sthāne guroḥ mukhāt 
MBkaamadhenutantraHK-912	svavidyāṃ bhāvayeddevi koṭividyutsamākṛtim || 15/7 ||	sva vidyām bhāvayet devi koṭi vidyut sama ākṛtim 
MBkaamadhenutantraHK-913	bhāvayedaniśaṃ bhaktyā siddho bhavati tatkṣaṇāt |	bhāvayet aniśam bhaktyā siddhaḥ bhavati tad kṣaṇāt 
MBkaamadhenutantraHK-914	jāyante devi bījāttu rāmakṛṣṇādayaśca ye || 15/8 ||	jāyante devi bījāt tu rāmakṛṣṇa ādayaḥ ca ye 
MBkaamadhenutantraHK-915	te sarve cañcalāpāṅgi bījāttu prabhavanti vai |	te sarve cañcalāpāṅgi bījāt tu prabhavanti vai 
MBkaamadhenutantraHK-916	jñātvā sanātanaṃ tattvaṃ ānandapaṭale sthitam || 15/9 ||	jñātvā sanātanam tattvam ānandapaṭale sthitam 
MBkaamadhenutantraHK-917	pūjā kāryā ca cārvaṅgi sarvasiddhimayo bhavet |	pūjā kāryā ca cārvaṅgi sarva siddhi mayaḥ bhavet 
MBkaamadhenutantraHK-918	idaṃ sanātanaṃ tattvamajñātvā narakaṃ vrajet || 15/10 ||	idam sanātanam tattvam a jñātvā narakam vrajet 
MBkaamadhenutantraHK-919	śūdraḥ śūdramukhācchrutvā vidyāṃ vā mantramuttamam |	śūdraḥ śūdra mukhāt śrutvā vidyām vā mantram uttamam 
MBkaamadhenutantraHK-920	rauravaṃ narakaṃ yaṃ yaṃ taṃ tamāpnoti niścitam || 15/11 ||	rauravam narakam yam yam tam tam āpnoti niścitam 
MBkaamadhenutantraHK-921	na śūdrāya matiṃ dadyād na ca śūdraṃ kadācana |	na śūdrāya matim dadyāt na ca śūdram kadācana 
MBkaamadhenutantraHK-922	ubhayornarakaṃ devi koṭikulasamāyutam || 15/12 ||	ubhayoḥ narakam devi koṭi kula samāyutam 
MBkaamadhenutantraHK-923	anācāro dvijo yastu śūdrāṇāṃ gurureva saḥ |	anācāraḥ dvijaḥ yaḥ tu śūdrāṇām guruḥ eva saḥ 
MBkaamadhenutantraHK-924	yadi śūdro bhaveddevi satyavādī jitendriyaḥ || 15/13 ||	yadi śūdraḥ bhavet devi satya vādī jita indriyaḥ 
MBkaamadhenutantraHK-925	sa dharme nirato bhūtvā śrutvā dvijagurormukhāt |	sa dharme nirataḥ bhūtvā śrutvā dvija guroḥ mukhāt 
MBkaamadhenutantraHK-926	sarvasiddhimavāpnoti śīghraṃ devamavāpnuyāt || 15/14 ||	sarva siddhim avāpnoti śīghram devam avāpnuyāt 
MBkaamadhenutantraHK-927	yaddeśe vidyate śūdraḥ pātakī mantravikrayī |	yad deśe vidyate śūdraḥ pātakī mantra vikrayī 
MBkaamadhenutantraHK-928	taddeśaṃ patitaṃ manye tasya rājā ca pātakī || 15/15 ||	tad deśam patitam manye tasya rājā ca pātakī 
MBkaamadhenutantraHK-929	sa kathaṃ cañcalāpāṅgi jihvāyāṃ prajapenmanum |	sa katham cañcalāpāṅgi jihvāyām prajapet manum 
MBkaamadhenutantraHK-930	tasya jihvā varārohe mūtraśoṇitaviḍyathā || 15/16 ||	tasya jihvā varārohe mūtra śoṇita viś yathā 
MBkaamadhenutantraHK-931	tanmukhaṃ mūtraviṭkūpamannaṃ viṣṭhāsamaṃ sadā |	tad mukham mūtra viṣ kūpam annam viṣṭhā samam sadā 
MBkaamadhenutantraHK-932	tajjalaṃ śoṇitaṃ sākṣāccāṇḍālasamajātiṣu || 15/17 ||	tat jalam śoṇitam sākṣāt cāṇḍāla sama jātiṣu 
MBkaamadhenutantraHK-933	pṛthivyāṃ yāni tīrthāni sarvadevamayāni vai |	pṛthivyām yāni tīrthāni sarva deva mayāni vai 
MBkaamadhenutantraHK-934	ālokya tanmukhaṃtīrthaṃ tatsthānaṃ tyajya(?)gacchati || 15/18 ||	ālokya tad mukham tīrtham tad sthānam tyajya gacchati 
MBkaamadhenutantraHK-935	tīrtha koṭiḥ palāyante dṛṣṭvā tanmukhamaṇḍalam |	tīrtha koṭiḥ palāyante dṛṣṭvā tad mukha maṇḍalam 
MBkaamadhenutantraHK-936	gaṅgājalaṃ parityajya drutaṃ svasthānamavāpnuyāt || 15/19 ||	gaṅgā jalam parityajya drutam sva sthānam avāpnuyāt 
MBkaamadhenutantraHK-937	mahāpātakino ye ca brahmahatyādisaṃyutāḥ |	mahāpātakinaḥ ye ca brahmahatyā ādi saṃyutāḥ 
MBkaamadhenutantraHK-938	trailokyapāvanī gaṅgā tān punāti na saṃśayaḥ || 15/20 ||	trailokya pāvanī gaṅgā tān punāti na saṃśayaḥ 
MBkaamadhenutantraHK-939	mantravikrayiṇaḥ śūdrāḥ sadā narakagāminaḥ |	mantra vikrayiṇaḥ śūdrāḥ sadā naraka gāminaḥ 
MBkaamadhenutantraHK-940	kalau tu bhārate varṣe bhaviṣyanti na saṃśayaḥ || 15/21 ||	kalau tu bhārate varṣe bhaviṣyanti na saṃśayaḥ  
MBkaamadhenutantraHK-941	mantravikrayiṇaḥ śūdrā jāyante vyāghrayoniṣu |	mantra vikrayiṇaḥ śūdrāḥ jāyante vyāghra yoniṣu 
MBkaamadhenutantraHK-942	tatsaṃsargaśca yo vipraścarmakāraḥ sa eva hi || 15/22 ||	tad saṃsargaḥ ca yaḥ vipraḥ carmakāraḥ saḥ eva hi 
MBkaamadhenutantraHK-943	cāṇḍālasadṛśaḥ so'pi sa eva varṇasaṅkaraḥ |	cāṇḍāla sadṛśaḥ saḥ api saḥ eva varṇa saṅkaraḥ 
MBkaamadhenutantraHK-944	svadharmanirataḥ sūdro vidyāmantraṃ śṛṇoti yaḥ || 15/23 ||	svadharma nirataḥ sūdraḥ vidyā mantram śṛṇoti yaḥ 
MBkaamadhenutantraHK-945	sa dhanyaḥ pṛthivīmadhye sa eva vaiṣṇavottamaḥ |	sa dhanyaḥ pṛthivī madhye saḥ eva vaiṣṇava uttamaḥ 
MBkaamadhenutantraHK-946	sa śāktaḥ śivabhaktaśca gāṇeśaḥ saura eva ca ||	sa śāktaḥ śiva bhaktaḥ ca gāṇeśaḥ sauraḥ eva ca 
MBkaamadhenutantraHK-947	etatte kathitaṃ devi varṇajñānavinirṇayam || 15/24 ||	etat te kathitam devi varṇa jñāna vinirṇayam 
MBkaamadhenutantraHK-948	iti śrīkāmadhenutantre devadevīsaṃvāde jñānānande	iti śrī kāmadhenutantre devadevī saṃvāde jñānānande 
MBkaamadhenutantraHK-949	pañcadaśaḥ paṭalaḥ ||	pañcadaśaḥ paṭalaḥ 
MBkaamadhenutantraHK-950	ṣoḍaśaḥ paṭalaḥ	ṣoḍaśaḥ paṭalaḥ 
MBkaamadhenutantraHK-951	śrīmahādeva uvāca	śrī mahādevaḥ uvāca 
MBkaamadhenutantraHK-952	aparaikaṃ pravakṣyāmi rahasyaṃ paramādbhutam |	apara ekam pravakṣyāmi rahasyam parama adbhutam 
MBkaamadhenutantraHK-953	yatkṛtvā cañcalāpāṅgi rāvaṇādyā niśācarāḥ || 16/1 ||	yat kṛtvā cañcalāpāṅgi rāvaṇa ādyāḥ niśācarāḥ 
MBkaamadhenutantraHK-954	avāpyamativṛddhiñca trailokyādhipatiḥ prabhuḥ |	avāpya mati vṛddhiñca trailokya adhipatiḥ prabhuḥ 
MBkaamadhenutantraHK-955	sāṃketaṃ paramaṃ guhyamakṣarāṇāṃ pṛthak pṛthak || 16/2 ||	sāṃketam paramam guhyam akṣarāṇām pṛthak pṛthak 
MBkaamadhenutantraHK-956	etattattvaṃ vijānāti harirbrahmā purandaraḥ |	etat tattvam vijānāti hariḥ brahmā purandaraḥ 
MBkaamadhenutantraHK-957	pañcāśadvarṇasaṅketaṃ sāvadhānāvadhāraya || 16/3 ||	pañcāśat varṇa saṅketam sa avadhāna avadhāraya 
MBkaamadhenutantraHK-958	akṛtvā sādhako yāti rauravaṃ narakaṃ vrajet |	a kṛtvā sādhakaḥ yāti rauravam narakam vrajet 
MBkaamadhenutantraHK-959	rauravaṃ narakaṃ yāti punarāvṛttidurlabham || 16/4 ||	rauravam narakam yāti punarāvṛtti durlabham 
MBkaamadhenutantraHK-960	viśeṣaṃ viṣṇumantreṣu kuryād vaiṣṇavasattamaḥ |	viśeṣam viṣṇu mantreṣu kuryāt vaiṣṇava sattamaḥ 
MBkaamadhenutantraHK-961	akṛtvā vaiṣṇavo yāti narakaṃ koṭikoṭiśaḥ || 16/5 ||	a kṛtvā vaiṣṇavaḥ yāti narakam koṭi koṭiśas 
MBkaamadhenutantraHK-962	māsi māsi varārohe śanibhaumadine priye |	māsi māsi varārohe śani bhauma dine priye 
MBkaamadhenutantraHK-963	prātaḥ snānaṃ samāsādya kṛtvā sandhyāṃ samāpya ca || 16/6 ||	prātar snānam samāsādya kṛtvā sandhyām samāpya ca 
MBkaamadhenutantraHK-964	sūryāyārghyaṃ tato dadyāt pādaprakṣālanāya ca |	sūryāya arghyam tatas dadyāt pāda prakṣālanāya ca 
MBkaamadhenutantraHK-965	yāgamaṇḍapamāsādya bhūtaśuddhiṃ vidhāya ca || 16/7 ||	yāga maṇḍapam āsādya bhūtaśuddhim vidhāya ca 
MBkaamadhenutantraHK-966	kuryānnyāsaṃ mātṛkāyāḥ prāṇāyāmaṃ tataḥ param |	kuryāt nyāsam mātṛkāyāḥ prāṇāyāmam tatas param 
MBkaamadhenutantraHK-967	nyāsānanyāṃstataḥ kuryāttantramārgeṇa pārvati || 16/8 ||	nyāsān anyān tatas kuryāt tantra mārgeṇa pārvati 
MBkaamadhenutantraHK-968	śuklāmbaradharaḥ sragvī gandhaliptakalevaraḥ |	śukla ambara dharaḥ sragvī gandha lipta kalevaraḥ 
MBkaamadhenutantraHK-969	raktāsanaṃ samāsādya kuśāsanamathāpi vā || 16/9 ||	raktāsanam samāsādya kuśa āsanam atha api vā 
MBkaamadhenutantraHK-970	pralipya tāmrapātreṣu sindūraṃ raktacandanam |	pralipya tāmra pātreṣu sindūram raktacandanam 
MBkaamadhenutantraHK-971	vilikhya mātṛkāvarṇaṃ hyasmin pātre pṛthak pṛthak || 16/10 ||	vilikhya mātṛkā varṇam hi asmin pātre pṛthak pṛthak 
MBkaamadhenutantraHK-972	akārādikṣakārāntaṃ sabinduṃ candrasaṃyutam |	akāra ādi kṣakāra antam sa bindum candra saṃyutam 
MBkaamadhenutantraHK-973	mahāpadmāntarasthānādānīya brahmavaktrakam || 16/11 ||	mahāpadma antara sthānāt ānīya brahmavaktrakam 
MBkaamadhenutantraHK-974	vāmanāsāpathenaiva śvāsaṃ puṣpāñjalau kṣipet |	vāma nāsā pathena eva śvāsam puṣpa añjalau kṣipet 
MBkaamadhenutantraHK-975	tatpuṣpaṃ cañcalāpāṅgi kuryāt puṣpasya sañcayam || 16/12 ||	tat puṣpam cañcalāpāṅgi kuryāt puṣpasya sañcayam 
MBkaamadhenutantraHK-976	dhyātvā tu pūjayeddavīṃ krameṇaiva pṛthak pṛthak |	dhyātvā tu pūjayet davīm krameṇa eva pṛthak pṛthak 
MBkaamadhenutantraHK-977	gandhairnānāvidhairdevīṃ puṣpairnānāvidhaistathā || 16/13 ||	gandhaiḥ nānāvidhaiḥ devīm puṣpaiḥ nānāvidhaiḥ tathā 
MBkaamadhenutantraHK-978	dhūpairnānāvidhairdevi dīpairnānāvidhaistathā |	dhūpaiḥ nānāvidhaiḥ devi dīpaiḥ nānāvidhaiḥ tathā 
MBkaamadhenutantraHK-979	naivedyaṃ vividhaṃ devi caturvidhamayaṃ tathā || 16/14 ||	naivedyam vividham devi caturvidha mayam tathā 
MBkaamadhenutantraHK-980	dattvā nānāphalādīṃśca pūjayet parameśvarīm |	dattvā nānā phala ādīn ca pūjayet parameśvarīm 
MBkaamadhenutantraHK-981	nānāpuṣpamayairhāraiḥ śukrādigandhasaṃyutam || 16/15 ||	nānā puṣpa mayaiḥ hāraiḥ śukra ādi gandha saṃyutam 
MBkaamadhenutantraHK-982	mahāpadmavanāntasthamaṣṭottaraśataṃ japet |	mahāpadma vana antastham aṣṭottaraśatam japet 
MBkaamadhenutantraHK-983	prajaped mātṛkāvarṇaṃ varṇe varṇe pṛthak pṛthak || 16/16 ||	prajapet mātṛkā varṇam varṇe varṇe pṛthak pṛthak 
MBkaamadhenutantraHK-984	pratipadme japenmantraṃ yasmin padme tu yat sthitam |	prati padme japet mantram yasmin padme tu yat sthitam 
MBkaamadhenutantraHK-985	tasmin padme vanāntasthaḥ svavidyāṃ prajapecchatam || 16/17 ||	tasmin padme vana anta sthaḥ sva vidyām prajapet śatam 
MBkaamadhenutantraHK-986	suprasannā mātṛkā syāt tadaiva sahasā priye |	su prasannā mātṛkā syāt tadā eva sahasā priye 
MBkaamadhenutantraHK-987	akṛtvā mātṛkāpūjāṃ māsi māsi varānane || 16/18 ||	a kṛtvā mātṛkā pūjām māsi māsi varānane 
MBkaamadhenutantraHK-988	iṣṭavidyāṃ japedyastu tasya hāniṃ śṛṇu priye |	iṣṭavidyām japet yaḥ tu tasya hānim śṛṇu priye 
MBkaamadhenutantraHK-989	citrānāḍīgatā bhūtvā mātṛkā jagadīśvarī || 16/19 ||	citrā nāḍī gatā bhūtvā mātṛkā jagat īśvarī 
MBkaamadhenutantraHK-990	sarveṣāṃ vaiṣṇavānāñca śāktānāṃ varavarṇini |	sarveṣām vaiṣṇavānām ca śāktānām varavarṇini 
MBkaamadhenutantraHK-991	śaivānāñca maheśāni anyeṣāñcaiva sundari || 16/20 ||	śaivānām ca maheśāni anyeṣām ca eva sundari 
MBkaamadhenutantraHK-992	haranti vaiṣṇavāadīnāṃ nānyathā vacanaṃ mama |	haranti na anyathā vacanam mama 
MBkaamadhenutantraHK-993	praśastā mātṛkāpūjā dīkṣā yā matta eva hi || 16/21 ||	praśastā mātṛkā pūjā dīkṣā yā mattaḥ eva hi 
MBkaamadhenutantraHK-994	puraścaryā hi cārvaṅgi pūjanīyā pṛthak pṛthak |	puraścaryā hi cārvaṅgi pūjanīyā pṛthak pṛthak 
MBkaamadhenutantraHK-995	mātā sā sarvavidyānāṃ mantrāṇāñca pṛthak pṛthak || 16/22 ||	mātā sā sarva vidyānām mantrāṇām ca pṛthak pṛthak 
MBkaamadhenutantraHK-996	yasmādutpadyate vidyā mantrañca suravandite |	yasmāt utpadyate vidyā mantram ca suravandite 
MBkaamadhenutantraHK-997	tasmāttu yatnato devi tāsāṃ pūjā vidhīyate || 16/23 ||	tasmāt tu yatnataḥ devi tāsām pūjā vidhīyate 
MBkaamadhenutantraHK-998	nānyathā niṣphalā pūjā saṃvatsarakṛtā ca yā |	na anyathā niṣphalā pūjā saṃvatsara kṛtā ca yā 
MBkaamadhenutantraHK-999	anena vidhinā devi pūjayed yadi mātṛkām || 16/24 ||	anena vidhinā devi pūjayet yadi mātṛkām 
MBkaamadhenutantraHK-1000	prasannā mātṛkā devi putratvenānukalpate |	prasannā mātṛkā devi putra tvena anukalpate 
MBkaamadhenutantraHK-1001	rahito mātṛkāpūjāṃ japapūjanatatparaḥ || 16/25 ||	rahitaḥ mātṛkā pūjām japa pūjana tatparaḥ 
MBkaamadhenutantraHK-1002	tasya sarvaṃ mahāmāyā mātṛkā jagadīśvarī |	tasya sarvam mahāmāyā mātṛkā jagat īśvarī 
MBkaamadhenutantraHK-1003	haranti mantratejāṃsi āyurvidyāyaśobalam || 16/26 ||	haranti mantra tejāṃsi āyuḥ vidyā yaśaḥ balam 
MBkaamadhenutantraHK-1004	aparaikaṃ pravakṣyāmi rahasyaṃ paramādbhutam |	apara ekam pravakṣyāmi rahasyam parama adbhutam 
MBkaamadhenutantraHK-1005	anulomavilomena kathitaṃ śṛṇu pārvati || 16/27 ||	anuloma vilomena kathitam śṛṇu pārvati 
MBkaamadhenutantraHK-1006	anulomavilomañca tathaiva hi maheśvari |	anuloma vilomam ca tathā eva hi maheśvari 
MBkaamadhenutantraHK-1007	sarveṣāṃ japayajñānāṃ sahasā phalabhāg bhavet || 16/28 ||	sarveṣām japa yajñānām sahasā phala bhāj bhavet 
MBkaamadhenutantraHK-1008	sahasā siddhimāpnoti sahasā dharmamāpnuyāt |	sahasā siddhim āpnoti sahasā dharmam āpnuyāt 
MBkaamadhenutantraHK-1009	sahasā arthamāpnoti sahasā mokṣamāpnuyāt || 16/29 ||	sahasā artham āpnoti sahasā mokṣam āpnuyāt 
MBkaamadhenutantraHK-1010	paurṇamāsyāmamāvasyāṃ māsi māsi prayatnataḥ |	paurṇamāsyām amāvasyām māsi māsi prayatnataḥ 
MBkaamadhenutantraHK-1011	yaḥ karoti prasannātmā sa eva śrīsadāśivaḥ || 16/30 ||	yaḥ karoti prasanna ātmā saḥ eva śrī sadāśivaḥ 
MBkaamadhenutantraHK-1012	jñātvā saṃdīpanīṃ vidyāṃ ānandapaṭale sthitām |	jñātvā saṃdīpanīm vidyām ānandapaṭale sthitām 
MBkaamadhenutantraHK-1013	ajñātvā dīpanīṃ vidyāṃ caturvargaphalapradām |	a jñātvā dīpanīm vidyām caturvarga phala pradām 
MBkaamadhenutantraHK-1014	rahasyametadanyacca sarvañca viphalaṃ vrajet || 16/31 ||	rahasyam etat anyat ca sarvañca viphalam vrajet 
MBkaamadhenutantraHK-1015	iti śrīkāmadhenutantre devadevīsaṃvāde	iti śrī kāmadhenutantre devadevī saṃvāde 
MBkaamadhenutantraHK-1016	ṣoḍaśaḥ paṭalaḥ ||	ṣoḍaśaḥ paṭalaḥ 
MBkaamadhenutantraHK-1017	saptadaśaḥ paṭalaḥ	saptadaśaḥ paṭalaḥ 
MBkaamadhenutantraHK-1018	śrīmahādeva uvāca	śrī mahādevaḥ uvāca 
MBkaamadhenutantraHK-1019	etattattvamavijñāya na bhāvo jāyate priye |	etat tattvam a vijñāya na bhāvaḥ jāyate priye 
MBkaamadhenutantraHK-1020	na devo vidyate kāṣṭhe na pāṣāṇe ca pārvati || 17/1 ||	na devaḥ vidyate kāṣṭhe na pāṣāṇe ca pārvati  /
MBkaamadhenutantraHK-1021	bhāveṣu vidyate devi bhāvo mokṣasvarūpadhṛk |	bhāveṣu vidyate devi bhāvaḥ mokṣa sva rūpa dhṛk 
MBkaamadhenutantraHK-1022	divyabhāvo vīrabhāvaḥ sadaiva sahasā bhavet || 17/2 ||	divya bhāvaḥ vīra bhāvaḥ sadā eva sahasā bhavet 
MBkaamadhenutantraHK-1023	anyathā cañcalāpāṅgi paśubhāvamayaḥ sadā |	anyathā cañcalāpāṅgi paśu bhāva mayaḥ sadā 
MBkaamadhenutantraHK-1024	svabhāvena vinā devi kathaṃ siddhirbhavet priye || 17/3 ||	svabhāvena vinā devi katham siddhiḥ bhavet priye 
MBkaamadhenutantraHK-1025	tasmāt prayatnato devi vīrabhāvamayo bhavet |	tasmāt prayatnataḥ devi vīra bhāva mayaḥ bhavet 
MBkaamadhenutantraHK-1026	anenaiva vidhānena mātṛkāṃ pūjayettu yaḥ || 17/4 ||	anena eva vidhānena mātṛkām pūjayet tu yaḥ 
MBkaamadhenutantraHK-1027	sa eva divyabhāvaḥ syād vīrabhāvaḥ sa eva hi |	saḥ eva divya bhāvaḥ syāt vīra bhāvaḥ saḥ eva hi 
MBkaamadhenutantraHK-1028	sa dhanī guṇī loke mātṛkāṃ yastu pūjayet || 17/5 ||	sa dhanī guṇī loke mātṛkām yaḥ tu pūjayet 
MBkaamadhenutantraHK-1029	śrīmahādeva uvāca	śrī mahādevaḥ uvāca 
MBkaamadhenutantraHK-1030	aparaikaṃ pravakṣyāmi sāmānyaṃ varavarṇini |	apara ekam pravakṣyāmi sāmānyam varavarṇini 
MBkaamadhenutantraHK-1031	pūrvoktadhyānamācarya prajapenmātṛkāmanum || 17/6 ||	pūrva ukta dhyānam ācarya prajapet mātṛkā manum 
MBkaamadhenutantraHK-1032	kakāradhyānamātreṇa sarvasiddhiḥ prajāyate |	kakāra dhyāna mātreṇa sarva siddhiḥ prajāyate 
MBkaamadhenutantraHK-1033	japtvā kakāraṃ cārvaṅgi sarvāsāṃ bhavati priyaḥ || 17/7 ||	japtvā kakāram cāru aṅgi sarvāsām bhavati priyaḥ  /
MBkaamadhenutantraHK-1034	sarvāsāṃ mātṛkāṃ japtvā kakāraṃ kevalañca vā |	sarvāsām mātṛkām japtvā kakāram kevalam ca vā 
MBkaamadhenutantraHK-1035	kakāraṃ sarvavarṇānāṃ mūlaprakṛtirūpiṇīm || 17/8 ||	kakāram sarva varṇānām mūlaprakṛti rūpiṇīm 
MBkaamadhenutantraHK-1036	tasmāt prayatnato devi kakāraṃ pūjayet priye |	tasmāt prayatnataḥ devi kakāram pūjayet priye 
MBkaamadhenutantraHK-1037	pratyahaṃ pūjayeddevīṃ prathamaṃ pūjayet sudhīḥ || 17/9 ||	pratyaham pūjayet devīm prathamam pūjayet sudhīḥ 
MBkaamadhenutantraHK-1038	sarvāsāṃ phalamāpnoti tadā bhāvamayo bhavet |	sarvāsām phalam āpnoti tadā bhāva mayaḥ bhavet 
MBkaamadhenutantraHK-1039	kakārapūjanād bhadre sarvāsāṃ pūjanaṃ bhavet || 17/10 ||	kakāra pūjanāt bhadre sarvāsām pūjanam bhavet 
MBkaamadhenutantraHK-1040	pratyahaṃ kurute yastu pratimāsi varāanane |	pratyaham kurute yaḥ tu pratimāsi varāanane 
MBkaamadhenutantraHK-1041	divyavīraḥ sa eva syāt sarvapūjāphalaṃ labhet || 17/11 ||	divya vīraḥ saḥ eva syāt sarva pūjā phalam labhet 
MBkaamadhenutantraHK-1042	akṛtvā cañcalāpāṅgi manasāpi ca saṃsmaret |	a kṛtvā cañcalāpāṅgi manasā api ca saṃsmaret 
MBkaamadhenutantraHK-1043	sarvapūjāmayaḥ so'pi sarvabhāvamayaḥ sadā || 17/12 ||	sarva pūjā mayaḥ saḥ api sarva bhāva mayaḥ sadā 
MBkaamadhenutantraHK-1044	bhāvatattvamavijñāya viṣṇumantraṃ kathaṃ japet |	bhāva tattvam a vijñāya viṣṇu mantram katham japet 
MBkaamadhenutantraHK-1045	śaktimantraṃ maheśāni sa kathaṃ pāmaro japet || 17/13 ||	śakti mantram maheśāni sa katham pāmaraḥ japet  /
MBkaamadhenutantraHK-1046	śivamantrañca saurañca gāṇeśaṃ sa kathaṃ japet |	śiva mantram ca sauram ca gāṇeśam sa katham japet 
MBkaamadhenutantraHK-1047	bhāvatattvaṃ vinā devi prajapedyadi koṭidhā || 17/14 ||	bhāvatattvam vinā devi prajapet yadi koṭidhā 
MBkaamadhenutantraHK-1048	sarvaṃ tasya vṛthā devi narakañca pade pade |	sarvam tasya vṛthā devi narakañca pade pade 
MBkaamadhenutantraHK-1049	sa kathaṃ cañcalāpāṅgi divyavīragururbhavet || 17/15 ||	sa katham cañcalāpāṅgi divya vīra guruḥ bhavet  /
MBkaamadhenutantraHK-1050	paśuvat sarvadā devi sa eva paśuguruḥ priye |	paśu vat sarvadā devi saḥ eva paśu guruḥ priye 
MBkaamadhenutantraHK-1051	bhāvatattvena rahitaḥ sa kathaṃ pañcamaṃ yajet || 17/16 ||	bhāva tattvena rahitaḥ sa katham pañcamam yajet  /
MBkaamadhenutantraHK-1052	vaiṣṇavastu varārohe makāraṃ pañcamaṃ yajet |	vaiṣṇavaḥ tu varārohe makāram pañcamam yajet 
MBkaamadhenutantraHK-1053	devatāyā varārohe śarīraṃ jāyate dhruvam || 17/17 ||	devatāyāḥ varārohe śarīram jāyate dhruvam 
MBkaamadhenutantraHK-1054	evaṃ mantraṃ pravakṣyāmi ānandapaṭale sthitam |	evam mantram pravakṣyāmi ānanda paṭale sthitam 
MBkaamadhenutantraHK-1055	kālīṃ chinnādividyāñca triṃśadvarṇamayīṃ sadā || 17/18 ||	kālīm chinnā ādi vidyām ca triṃśat varṇa mayīm sadā 
MBkaamadhenutantraHK-1056	tadā siddhimayaṃ so'pi anyathā viphalaṃ sadā |	tadā siddhi mayam saḥ upi anyathā viphalam sadā 
MBkaamadhenutantraHK-1057	iṣṭadhyānaṃ tataḥ kṛtvā hṛdi madhye nirīkṣaṇam || 17/19 ||	iṣṭa dhyānam tatas kṛtvā hṛdi madhye nirīkṣaṇam  /
MBkaamadhenutantraHK-1058	prathamaṃ kāminīṃ dhyātvā praphullāṃ tadanantaram |	prathamam kāminīm dhyātvā praphullām tad anantaram 
MBkaamadhenutantraHK-1059	praphullādhyānamātreṇa jāyate devavigraham || 17/20 ||	praphulla adhyāna mātreṇa jāyate deva vigraham 
MBkaamadhenutantraHK-1060	paphullā jāyate devi yasya yā iṣṭadevatā |	paphullā jāyate devi yasya yā iṣṭadevatā 
MBkaamadhenutantraHK-1061	tadiṣṭaṃ bhāvayed devi mantroktadhyānavartmanā || 17/21 ||	tat iṣṭam bhāvayet devi mantra ukta dhyāna vartmanā 
MBkaamadhenutantraHK-1062	devatāyāḥ śarīrañca bījādutpadyate dhruvam |	devatāyāḥ śarīram ca bījāt utpadyate dhruvam 
MBkaamadhenutantraHK-1063	mantrasya prathamādbījājjāyate naganandini || 17/22 ||	mantrasya prathamāt bījāt jāyate naganandini 
MBkaamadhenutantraHK-1064	pañcāśanmātṛkā yā sā sarvā yuvatirūpiṇī |	pañcāśat mātṛkā yā sā sarvā yuvati rūpiṇī 
MBkaamadhenutantraHK-1065	tasmāttu yuvatīdehājjāyate kṛṣṇavigraham || 17/23 ||	tasmāt tu yuvatī dehāt jāyate kṛṣṇa vigraham 
MBkaamadhenutantraHK-1066	rāmaḥ padmapalāśākṣaḥ praphullo jāyate dhruvam |	rāmaḥ padma palāśa akṣaḥ praphullaḥ jāyate dhruvam 
MBkaamadhenutantraHK-1067	bījādutpadyate devi paraṃ brahma sanātanam || 17/24 ||	bījāt utpadyate devi param brahma sanātanam 
MBkaamadhenutantraHK-1068	bījasaṃyogamātreṇa śabdabrahma sanātanam |	bīja saṃyoga mātreṇa śabdabrahma sanātanam 
MBkaamadhenutantraHK-1069	aparaikaṃ pravakṣyāmi rahasyaṃ paramādbhutam || 17/25 ||	apara ekam pravakṣyāmi rahasyam parama adbhutam 
MBkaamadhenutantraHK-1070	pañcāśadvarṇasaṃketaṃ pañcāśattattvamadbhutam |	pañcāśat varṇa saṃketam pañcāśat tattvam adbhutam 
MBkaamadhenutantraHK-1071	varṇatattvaṃ vinā devi prajapedyadi koṭidhā || 17/26 ||	varṇa tattvam vinā devi prajapet yadi koṭidhā 
MBkaamadhenutantraHK-1072	sarvaṃ tasya vṛthā devi hānistasya pade pade |	sarvam tasya vṛthā devi hāniḥ tasya pade pade 
MBkaamadhenutantraHK-1073	hṛtpadme dvādaśadale varāṭopari kāminīm || 17/27 ||	hṛd padme dvādaśa dale varāṭa upari kāminīm 
MBkaamadhenutantraHK-1074	dhyātvā prayatnato devi tadgarbhe varṇabhāvanam |	dhyātvā prayatnataḥ devi tad garbhe varṇa bhāvanam 
MBkaamadhenutantraHK-1075	akārādikṣakārāntaṃ trikoṇamadhyamaṇḍale || 17/28 ||	akāra ādi kṣakāra antam trikoṇa madhya maṇḍale  /
MBkaamadhenutantraHK-1076	anulomavilome na kāminyā garbhapañjare |	anuloma vilome na kāminyāḥ garbha pañjare 
MBkaamadhenutantraHK-1077	ekaikaṃ bhāvayed devi prativarge pṛthak pṛthak || 17/29 ||	ekaikam bhāvayet devi prativarge pṛthak pṛthak 
MBkaamadhenutantraHK-1078	sarvāṃsāṃ devadevīnāṃ kakāraṃ surapūjite |	sarvāṃsām devadevīnām kakāram sura pūjite 
MBkaamadhenutantraHK-1079	dhyātvā prayatnato devi anulomavilomataḥ || 17/30 ||	dhyātvā prayatnataḥ devi anuloma vilomataḥ 
MBkaamadhenutantraHK-1080	pañcāśattattvasaṅketaṃ pañcāśadvarṇameva hi |	pañcāśat tattva saṅketam pañcāśat varṇam eva hi 
MBkaamadhenutantraHK-1081	yaḥ karoti naro jñātvā śīghraṃ vidyā prasīdati || 17/31 ||	yaḥ karoti naraḥ jñātvā śīghram vidyā prasīdati 
MBkaamadhenutantraHK-1082	kimasādhyaṃ varārohe yasmai vidyā prasīdati |	kim asādhyam varārohe yasmai vidyā prasīdati 
MBkaamadhenutantraHK-1083	ṣaṭcakre parameśāni rahasyaṃ sthānamuttamam || 17/32 ||	ṣaṭcakre parameśāni rahasyam sthānam uttamam 
MBkaamadhenutantraHK-1084	sahasrāre guroḥ pāde padmaṃ dhyātvā prayatnataḥ |	sahasrāre guroḥ pāde padmam dhyātvā prayatnataḥ 
MBkaamadhenutantraHK-1085	pañcāśadvarṇasaṅketaṃ yaḥ kuryānmānavaḥ priye || 17/33 ||	pañcāśat varṇa saṅketam yaḥ kuryāt mānavaḥ priye 
MBkaamadhenutantraHK-1086	keśavaṃ vaśayeddevi rahasyenādhunā dhruvam |	keśavam vaśayet devi rahasyena adhunā dhruvam 
MBkaamadhenutantraHK-1087	mohayeccañcalāpāṅgi rudraṃ kālānalaprabham || 17/34 ||	mohayet cañcalāpāṅgi rudram kāla anala prabham 
MBkaamadhenutantraHK-1088	sarvañcarācaraṃ viśvaṃ sahasā mohamānayet |	sarvan carācaram viśvam sahasā moham ānayet 
MBkaamadhenutantraHK-1089	etatte kathitaṃ devi varṇamohanamuttamam || 17/35 ||	etat te kathitam devi varṇa mohanam uttamam 
MBkaamadhenutantraHK-1090	ajñātvā mohanaṃ tattvaṃ prajaped yadi pārvati |	a jñātvā mohanam tattvam prajapet yadi pārvati 
MBkaamadhenutantraHK-1091	tasmai lokā gandharvāśca vairabhāvaṃ brajanti vai || 17/36 ||	tasmai lokāḥ gandharvāḥ ca vaira bhāvam brajanti vai 
MBkaamadhenutantraHK-1092	pratyakṣaramayaṃ devi kathitaṃ varṇamohanam |	pratyakṣara mayam devi kathitam varṇa mohanam 
MBkaamadhenutantraHK-1093	ajñātvā mohanaṃ tattvaṃ yaḥ kuryādanyamohanam || 17/37 ||	a jñātvā mohanam tattvam yaḥ kuryāt anya mohanam 
MBkaamadhenutantraHK-1094	sarvaṃ tasya vṛthā devi nānyathā tu kadācana |	sarvam tasya vṛthā devi na anyathā tu kadācana 
MBkaamadhenutantraHK-1095	etattatvaprabhāvāddhi acirāt siddhimāpnuyāt || 17/38 ||	etad tatva prabhāvāt hi acirāt siddhim āpnuyāt 
MBkaamadhenutantraHK-1096	garbhamadhye japenmantraṃ anulomavilomataḥ |	garbha madhye japet mantram anuloma vilomataḥ 
MBkaamadhenutantraHK-1097	japitvā varṇamekañca svasthānamānayecca tam || 17/39 ||	japitvā varṇam ekam ca sva sthānam ānayet ca tam 
MBkaamadhenutantraHK-1098	punarvarṇaṃ samākṛṣya kāminīgarbhamadhyataḥ |	punar varṇam samākṛṣya kāminī garbha madhyatas 
MBkaamadhenutantraHK-1099	prajapedakṣaraṃ devi candrabindusamanvitam || 17/40 ||	prajapet akṣaram devi candra bindu samanvitam 
MBkaamadhenutantraHK-1100	pañcāśadakṣarañcaiva bhāvayecca pṛthak pṛthak |	pañcāśat akṣaram ca eva bhāvayet ca pṛthak pṛthak 
MBkaamadhenutantraHK-1101	anena vidhinā devi yo japenmantramuttamam || 17/41 ||	anena vidhinā devi yaḥ japet mantram uttamam 
MBkaamadhenutantraHK-1102	tasya śīghraṃ bhavet siddhiranyathā viphalā bhavet |	tasya śīghram bhavet siddhiḥ anyathā viphalā bhavet 
MBkaamadhenutantraHK-1103	sambhāvaṃ likhitaṃ devi yathā bhavati akṣaram || 17/42 ||	likhitam devi yathā bhavati akṣaram 
MBkaamadhenutantraHK-1104	tattadeva varārohe japapūjā nirarthakam |	tat tat eva varārohe japa pūjā nirarthakam 
MBkaamadhenutantraHK-1105	viśeṣamantraṃ vakṣyāmi ānandapaṭale sthitam || 17/43 ||	viśeṣa mantram vakṣyāmi ānandapaṭale sthitam 
MBkaamadhenutantraHK-1106	mantraṃ śrīmohanaṃ nāma pañcāśadvarṇasaṃjñakam |	mantram śrī mohanam nāma pañcāśat varṇa saṃjñakam 
MBkaamadhenutantraHK-1107	jñātvā yaḥ kurute devi tasya siddhiradūrataḥ || 17/44 ||	jñātvā yaḥ kurute devi tasya siddhiḥ adūrataḥ 
MBkaamadhenutantraHK-1108	anyathā viphalaṃ sarvaṃ rahasyaṃ saphalaṃ nahi |	anyathā viphalam sarvam rahasyam sa phalam nahi 
MBkaamadhenutantraHK-1109	iti śrīkāmadhenutantre devadevīsaṃvāde saptadaśaḥ paṭalaḥ ||	iti śrī kāmadhenutantre devadevī saṃvāde saptadaśaḥ paṭalaḥ 
MBkaamadhenutantraHK-1110	aṣṭādaśaḥ paṭalaḥ	aṣṭādaśaḥ paṭalaḥ 
MBkaamadhenutantraHK-1111	śrīmahādeva uvāca	śrī mahādevaḥ uvāca 
MBkaamadhenutantraHK-1112	athānyat saṃpravakṣyāmi rahasyaṃ paramādbhutam |	atha anyat saṃpravakṣyāmi rahasyam parama adbhutam 
MBkaamadhenutantraHK-1113	ajñātvā vaiṣṇavo yāti rauravaṃ varavarṇini || 18/1 ||	a jñātvā vaiṣṇavaḥ yāti rauravam varavarṇini 
MBkaamadhenutantraHK-1114	evaṃ tattvayutaṃ devi yo japet parameśvarīm |	evam tattva yutam devi yaḥ japet parameśvarīm 
MBkaamadhenutantraHK-1115	navatattvamayīṃ vidyāṃ yadā japati pārvati || 18/2 ||	nava tattva mayīm vidyām yadā japati pārvati 
MBkaamadhenutantraHK-1116	tadaiva sahasā siddhirjāyate surasundari |	tadā eva sahasā siddhiḥ jāyate surasundari 
MBkaamadhenutantraHK-1117	navatattvayutaṃ mantraṃ jñātvā yaḥ prajapet sakṛt || 18/3 ||	nava tattva yutam mantram jñātvā yaḥ prajapet sakṛt 
MBkaamadhenutantraHK-1118	tadaiva sahasā devi viṣṇutulyo bhaved dhruvam |	tadā eva sahasā devi viṣṇu tulyaḥ bhavet dhruvam 
MBkaamadhenutantraHK-1119	prathamaṃ kāminīṃ dhyātvā hṛtpadme kamalekṣaṇe || 18/4 ||	prathamam kāminīm dhyātvā hṛd padme kamala īkṣaṇe 
MBkaamadhenutantraHK-1120	uccaret prathamaṃ bījaṃ kāminīṃ tadanantaram |	uccaret prathamam bījam kāminīm tad anantaram 
MBkaamadhenutantraHK-1121	punarbījaṃ dvitīyañca uccared yatnataḥ sudhīḥ || 18/5 ||	punar bījam dvitīyam ca uccaret yatnataḥ sudhīḥ 
MBkaamadhenutantraHK-1122	kāminīñca tato dhyātvā tṛtīyaṃ bījamuccaret |	kāminīm ca tatas dhyātvā tṛtīyam bījam uccaret 
MBkaamadhenutantraHK-1123	anena vidhinā devi kāminīdhyānasaṃpuṭam || 18/6 ||	anena vidhinā devi kāminī dhyāna saṃpuṭam 
MBkaamadhenutantraHK-1124	punardhyānaṃ kakārasya anulomena pārvati |	punar dhyānam kakārasya anulomena pārvati 
MBkaamadhenutantraHK-1125	anulomaṃ yathā devi vilomañca tathā kuru || 18/7 ||	anulomam yathā devi vilomam ca tathā kuru 
MBkaamadhenutantraHK-1126	evaṃ krameṇa deveśi yadyadakṣarakaṃ priye |	evam krameṇa deveśi yat yat akṣarakam priye 
MBkaamadhenutantraHK-1127	kṛtvā yatnād varārohe sarvasiddhīśvaro bhavet || 18/8 ||	kṛtvā yatnāt varārohe sarva siddhi īśvaraḥ bhavet 
MBkaamadhenutantraHK-1128	sarveṣāṃ mantravarṇānāṃ dhyātvā dhyātvā pṛthak pṛthak |	sarveṣām mantra varṇānām dhyātvā dhyātvā pṛthak pṛthak 
MBkaamadhenutantraHK-1129	ādyante kāminīṃ dhyātvā śivaśaktimayo bhavet || 18/9 ||	ādi ante kāminīm dhyātvā śiva śakti mayaḥ bhavet 
MBkaamadhenutantraHK-1130	athavā cañcalāpāṅgi hṛtpadme kamalānane |	athavā cañcalāpāṅgi hṛd padme kamala ānane 
MBkaamadhenutantraHK-1131	ādau madhye tathā cānte bījaṃ dattvā japet priye || 18/10 ||	ādau madhye tathā ca ante bījam dattvā japet priye 
MBkaamadhenutantraHK-1132	tadaiva sahasā devi jāyate devavigraham |	tadā eva sahasā devi jāyate deva vigraham 
MBkaamadhenutantraHK-1133	sadā nidrāturo mantraḥ kalikāle ca bhārate || 18/11 ||	sadā nidrā āturaḥ mantraḥ kali kāle ca bhārate 
MBkaamadhenutantraHK-1134	rahasyanena cārvaṅgi nidrābhaṅgo tadā bhavet |	rahasyanena cāru aṅgi tadā bhavet 
MBkaamadhenutantraHK-1135	japedādau varārohe trivāramanulomataḥ || 18/12 ||	japet ādau varārohe tri vāram anulomataḥ 
MBkaamadhenutantraHK-1136	vilomena trivārañca dhyātvā japtvā hṛdambuje |	vilomena tri vāran ca dhyātvā japtvā hṛd ambuje 
MBkaamadhenutantraHK-1137	athānyat saṃpravakṣyāmi nidrābhaṅgasya lakṣaṇam || 18/13 ||	atha anyat saṃpravakṣyāmi nidrā bhaṅgasya lakṣaṇam 
MBkaamadhenutantraHK-1138	prathamaṃ kāminīṃ dhyātvā ante ca tadanantaram |	prathamam kāminīm dhyātvā ante ca tad anantaram 
MBkaamadhenutantraHK-1139	daśadhā prajapenmantraṃ nidrābhaṅgāya pārvati || 18/14 ||	daśadhā prajapet mantram nidrā bhaṅgāya pārvati 
MBkaamadhenutantraHK-1140	tatastu prajaped devi praphullaṃ viśvamohanam |	tatas tu prajapet devi praphullam viśva mohanam 
MBkaamadhenutantraHK-1141	rahasyanena cārvaṅgi jāyate viṣṇuvigraham || 18/15 ||	rahasyanena cāru aṅgi jāyate viṣṇu vigraham 
MBkaamadhenutantraHK-1142	śaṅkhacakradharaṃ devaṃ śuddhatattvātmakaṃ priye |	śaṅkha cakra dharam devam śuddha tattva ātmakam priye 
MBkaamadhenutantraHK-1143	pītāmbaradharaṃ śāntaṃ prasannaṃ mukhapaṅkajam || 18/16 ||	pīta ambara dharam śāntam prasannam mukha paṅkajam 
MBkaamadhenutantraHK-1144	ājānulambitakaraṃ vanamālāvirājitam |	āja anulambita karam vanamālā virājitam 
MBkaamadhenutantraHK-1145	tribhaṅgalalitākāraṃ cārucūḍāvibhūṣitam || 18/17 ||	tri bhaṅga lalita ākāram cāru cūḍā vibhūṣitam 
MBkaamadhenutantraHK-1146	śrīvatsakaustubhoddīptaṃ jāyate viṣṇuvigraham |	śrīvatsa kaustubha uddīptam jāyate viṣṇu vigraham 
MBkaamadhenutantraHK-1147	avatāraṃ svayaṃ kṛṣṇaṃ lalitāñjanacikkaṇam || 18/18 ||	avatāram svayam kṛṣṇam lalitā añjana cikkaṇam 
MBkaamadhenutantraHK-1148	gopīmaṇḍalamadhyasthaṃ nānāsukhamayaṃ harim |	gopī maṇḍala madhya stham nānā sukha mayam harim 
MBkaamadhenutantraHK-1149	athavā jāyate devi tasmādbījācchucismite || 18/19 ||	athavā jāyate devi tasmāt bījāt śuci smite 
MBkaamadhenutantraHK-1150	kāminīdhyānamātreṇa devatā jāyate dhruvam |	kāminī dhyāna mātreṇa devatā jāyate dhruvam 
MBkaamadhenutantraHK-1151	rahasyametaccārvaṅgi kartavyaṃ hṛdi madhyataḥ || 18/20 ||	rahasyam etat cāru aṅgi kartavyam hṛdi madhyatas 
MBkaamadhenutantraHK-1152	rahasyānāñca sarveṣāṃ sārametanna saṃśayaḥ |	rahasyānām ca sarveṣām sāram etat na saṃśayaḥ 
MBkaamadhenutantraHK-1153	athānyat saṃpravakṣyāmi rahasyaṃ paramādbhutam || 18/21 ||	atha anyat saṃpravakṣyāmi rahasyam parama adbhutam 
MBkaamadhenutantraHK-1154	dhyātvā tu kāminīnārīṃ prathamaṃ hṛdi madhyataḥ |	dhyātvā tu kāminī nārīm prathamam hṛdi madhyatas 
MBkaamadhenutantraHK-1155	tadgarbhe bhāvayenmantraṃ manasā naganandini || 18/22 ||	tad garbhe bhāvayet mantram manasā naganandini 
MBkaamadhenutantraHK-1156	tadgarbhe bhāvayed devaṃ dhyānamārgeṇa sundari |	tad garbhe bhāvayet devam dhyāna mārgeṇa sundari 
MBkaamadhenutantraHK-1157	punaśca kāminīṃ dhyātvā tasmādāvirbhaved hariḥ || 18/23 ||	punar ca kāminīm dhyātvā tasmāt āvirbhavet hariḥ  /
MBkaamadhenutantraHK-1158	harirityupalakṣaṇaṃ devi sarveṣāmeva nirmitam |	hariḥ iti upalakṣaṇam devi sarveṣām eva nirmitam 
MBkaamadhenutantraHK-1159	nidrāyuktaṃ maheśāni vidyāmantraṃ bhavet sadā || 18/24 ||	nidrā yuktam maheśāni vidyāmantram bhavet sadā 
MBkaamadhenutantraHK-1160	tasmāttu nidrārahitaṃ prajaped yadi ekadā |	tasmāt tu nidrā rahitam prajapet yadi ekadā 
MBkaamadhenutantraHK-1161	japāt koṭiguṇaṃ bhadre sahasā labhate dhruvam || 18/25 ||	japāt koṭi guṇam bhadre sahasā labhate dhruvam 
MBkaamadhenutantraHK-1162	vāmabāhoryadā vāhastadā nidrāturo manuḥ |	vāma bāhoḥ yadā vāhaḥ tadā nidrā āturaḥ manuḥ 
MBkaamadhenutantraHK-1163	calate ca yadā bāhordakṣiṇe varavarṇini || 18/26 ||	calate ca yadā bāhoḥ dakṣiṇe varavarṇini 
MBkaamadhenutantraHK-1164	tadaiva cañcalāpāṅgi tyaktanidraḥ sadā manuḥ |	tadā eva cañcalāpāṅgi tyakta nidraḥ sadā manuḥ 
MBkaamadhenutantraHK-1165	ata eva varārohe tyaktanidraṃ japet sudhīḥ || 18/27 ||	atas eva varārohe tyakta nidram japet sudhīḥ 
MBkaamadhenutantraHK-1166	śrīdevī uvāca	śrī devī uvāca 
MBkaamadhenutantraHK-1167	pūjākāle mahādeva yadi nidrāturo bhavet |	pūjā kāle mahādeva yadi nidrā āturaḥ bhavet 
MBkaamadhenutantraHK-1168	tatkathaṃ sidhyate mantraḥ kiṃ kartavyaṃ tadā prabho || 18/28 ||	tat katham sidhyate mantraḥ kim kartavyam tadā prabho 
MBkaamadhenutantraHK-1169	prajapet kena vidhinā na japedvā vada prabho |	prajapet kena vidhinā na japet vā vada prabho 
MBkaamadhenutantraHK-1170	śrīmahādeva uvāca	śrī mahādevaḥ uvāca 
MBkaamadhenutantraHK-1171	rahasyamantraṃ vakṣyāmi ānandapaṭale sthitam || 18/29 ||	rahasya mantram vakṣyāmi ānandapaṭale sthitam 
MBkaamadhenutantraHK-1172	dvādaśārṇamayaṃ mantraṃ nidrābhaṅgasya dīpanam |	dvādaśa arṇa mayam mantram nidrā bhaṅgasya dīpanam 
MBkaamadhenutantraHK-1173	rahasyamantraṃ cārvaṅgi ajñātvā viphalaṃ bhavet || 18/30 ||	rahasya mantram cāru aṅgi a jñātvā viphalam bhavet 
MBkaamadhenutantraHK-1174	iti śrīkāmadhenutantre devadevīsaṃvāde aṣṭādaśaḥ paṭalaḥ ||	iti śrī kāmadhenutantre devadevī saṃvāde aṣṭādaśaḥ paṭalaḥ 
MBkaamadhenutantraHK-1175	ūnaviṃśaḥ paṭalaḥ	ūnaviṃśaḥ paṭalaḥ 
MBkaamadhenutantraHK-1176	śrīmahādeva uvāca	śrī mahādevaḥ uvāca 
MBkaamadhenutantraHK-1177	sandeho naiva kartavyaḥ pūjākāle śucismite |	sandehaḥ nā eva kartavyaḥ pūjā kāle śuci smite 
MBkaamadhenutantraHK-1178	sahasā kāminīṃ dhyātvā turīyakūṭamuccaret || 19/1 ||	sahasā kāminīm dhyātvā turīyakūṭam uccaret 
MBkaamadhenutantraHK-1179	tadaiva sahasā devi tyaktanidro bhavenmanuḥ |	tadā eva sahasā devi tyakta nidraḥ bhavet manuḥ 
MBkaamadhenutantraHK-1180	prajaped daśadhā devi hṛdaye manasāpi vā || 19/2 ||	prajapet daśadhā devi hṛdaye manasā api vā 
MBkaamadhenutantraHK-1181	pūjākāle maheśāni saṃtyajed yadi dakṣiṇam |	pūjā kāle maheśāni saṃtyajet yadi dakṣiṇam 
MBkaamadhenutantraHK-1182	prāyaścittaṃ bhavettasya mantrasya varavarṇini || 19/3 ||	prāyaścittam bhavet tasya mantrasya varavarṇini 
MBkaamadhenutantraHK-1183	prāyaścittamidaṃ devi kṛtvā mantraṃ japed yadi |	prāyaścittam idam devi kṛtvā mantram japet yadi 
MBkaamadhenutantraHK-1184	kiṃ tasya dakṣiṇo bāhustasya nidrātureṇa kim || 19/4 ||	kim tasya dakṣiṇaḥ bāhuḥ tasya nidrā ātureṇa kim 
MBkaamadhenutantraHK-1185	rahasyamantraṃ cārvaṅgi pūjākāle vinirṇayam |	rahasya mantram cāru aṅgi pūjā kāle vinirṇayam 
MBkaamadhenutantraHK-1186	rahasyametaccārvaṅgi sarvanidrāsu maṅglam || 19/5 ||	rahasyam etat cāru aṅgi sarva nidrāsu 
MBkaamadhenutantraHK-1187	vāmabāhoryadā vāyuryadā ca dakṣiṇāvahaḥ |	vāma bāhoḥ yadā vāyuḥ yadā ca dakṣiṇāvahaḥ 
MBkaamadhenutantraHK-1188	rahasyametaccārvaṅgi kṛtvā tu prajapenmanum || 19/6 ||	rahasyam etat cāru aṅgi kṛtvā tu prajapet manum 
MBkaamadhenutantraHK-1189	tadaiva tyaktanidrā sā vidyā mantrañca nānyathā |	tadā eva tyakta nidrā sā vidyā mantram ca nā anyathā 
MBkaamadhenutantraHK-1190	yoganidrāmayī vidyā yoganidrāmayo manuḥ || 19/7 ||	          
MBkaamadhenutantraHK-1191	viśeṣamantraṃ vakṣyāmi ānandapaṭale sthitam |	viśeṣa mantram vakṣyāmi ānandapaṭale sthitam 
MBkaamadhenutantraHK-1192	aṣṭākṣarīṃ mahāvidyāṃ dīpanīṃ mokṣarūpiṇīm || 19/8 ||	aṣṭākṣarīm mahāvidyām dīpanīm mokṣa rūpiṇīm 
MBkaamadhenutantraHK-1193	sarvasiddhimayo bhūtvā rahasyaphalamāpnuyāt |	sarva siddhi mayaḥ bhūtvā rahasya phalam āpnuyāt 
MBkaamadhenutantraHK-1194	prajaped yadi nidrāyāṃ kiṃ tasya japapūjane || 19/9 ||	prajapet yadi nidrāyām kim tasya japa pūjane 
MBkaamadhenutantraHK-1195	rahasyanena cārvaṅgi nidrāṃ tyaktvā sanātanī |	rahasyanena cāru aṅgi nidrām tyaktvā sanātanī 
MBkaamadhenutantraHK-1196	suṣumṇāmadhyamārgeṣu saṃsthitā brahmarūpiṇī || 19/10 ||	suṣumṇā madhya mārgeṣu saṃsthitā brahma rūpiṇī 
MBkaamadhenutantraHK-1197	rahasyametaccārvaṅgi ajñātvā yojapenmanum |	rahasyam etat cāru aṅgi a jñātvā yaḥ japet manum 
MBkaamadhenutantraHK-1198	tasya pāpamahaṃ vakṣye sāvadhānāvadhāraya || 19/11 ||	tasya pāpam aham vakṣye sa avadhāna avadhāraya 
MBkaamadhenutantraHK-1199	śūdreṇa likhitaṃ devi paṭalaṃ yattu paṭhyate |	śūdreṇa likhitam devi paṭalam yat tu paṭhyate 
MBkaamadhenutantraHK-1200	yaṃ yaṃ narakamāpnoti taṃ taṃ prāpnoti mānavaḥ || 19/12 ||	yam yam narakam āpnoti tam tam prāpnoti mānavaḥ 
MBkaamadhenutantraHK-1201	dvātriṃśatkoṭimadhyeṣu narakeṣu krameṇa hi |	dvātriṃśat koṭi madhyeṣu narakeṣu krameṇa hi 
MBkaamadhenutantraHK-1202	koṭivaṃśān samādāya pacyante manujādhamāḥ || 19/13 ||	koṭi vaṃśān samādāya pacyante manuja adhamāḥ 
MBkaamadhenutantraHK-1203	vipro vā kṣatriyo vāpi vaiśyo vā naganandini |	vipraḥ vā kṣatriyaḥ vā api vaiśyaḥ vā naganandini 
MBkaamadhenutantraHK-1204	pacyante narake ghore śūdrasya likhanāt priye || 19/14 ||	pacyante narake ghore śūdrasya likhanāt priye 
MBkaamadhenutantraHK-1205	tasmāttu śūdralikhitaṃ paṭalaṃ na japet sudhīḥ |	tasmāt tu śūdra likhitam paṭalam na japet sudhīḥ 
MBkaamadhenutantraHK-1206	tasmādāvaśyakaṃ devi kāminīdhyānamuccaret || 19/15 ||	tasmāt āvaśyakam devi kāminī dhyānam uccaret 
MBkaamadhenutantraHK-1207	tataḥ siddho bhaved devi vidyā mantraṃ na cānyathā |	tatas siddhaḥ bhavet devi vidyā mantram na ca anyathā 
MBkaamadhenutantraHK-1208	kāminīdhyānamātreṇa sarvasiddhimayo bhavet || 19/16 ||	kāminī dhyāna mātreṇa sarva siddhi mayaḥ bhavet 
MBkaamadhenutantraHK-1209	ekenaiva kṛtārthaṃ syād bahubhiḥ kimupāsate |	ekena eva kṛtārtham syāt bahubhiḥ kim upāsate 
MBkaamadhenutantraHK-1210	tava bhaktyā mayākhyātaṃ yadgopyaṃ bhuvanatraye || 19/17 ||	tava bhaktyā mayā ākhyātam yat gopyam bhuvanatraye  /
MBkaamadhenutantraHK-1211	kāmadhenumidaṃ jñatvā yadi pūjāṃ samācaret |	kāmadhenum idam jñatvā yadi pūjām samācaret 
MBkaamadhenutantraHK-1212	saphalā sā bhavet pūjā japañca saphalaṃ sadā || 19/18 ||	saphalā sā bhavet pūjā japan ca sa phalam sadā 
MBkaamadhenutantraHK-1213	anyathā pretavad dīkṣā pūjā ca pretavat sadā |	anyathā preta vat dīkṣā pūjā ca preta vat sadā 
MBkaamadhenutantraHK-1214	prathamaṃ kāminīṃ dhyātvā japapūjāṃ samācaret || 19/19 ||	prathamam kāminīm dhyātvā japa pūjām samācaret 
MBkaamadhenutantraHK-1215	kāmadhenoḥ phalaṃ labdhvā sadāśivamayo bhavet |	kāmadhenoḥ phalam labdhvā sadāśiva mayaḥ bhavet 
MBkaamadhenutantraHK-1216	viṣṇurūpī sa eva syānmahāmāyā sa eva hi || 19/20 ||	viṣṇu rūpī saḥ eva syāt mahāmāyā saḥ eva hi 
MBkaamadhenutantraHK-1217	śivamantre viṣṇumantre śaktimantre śucismite |	śiva mantre viṣṇu mantre śakti mantre śuci smite 
MBkaamadhenutantraHK-1218	kāmadhenumidaṃ mantraṃ praśastaṃ surapūjite || 19/21 ||	kāmadhenum idam mantram praśastam sura pūjite 
MBkaamadhenutantraHK-1219	etatte kathitaṃ devi sārātsāraṃ parātparam |	etat te kathitam devi sārāt sāram parātparam 
MBkaamadhenutantraHK-1220	yat kṛtvā sādhako yāti durlabhaṃ mokṣmandiram || 19/22 ||	yat kṛtvā sādhakaḥ yāti durlabham mokṣ mandiram 
MBkaamadhenutantraHK-1221	viśeṣamantraṃ vakṣyāmi vidyāṃ śrīkāmarūpiṇīm |	viśeṣa mantram vakṣyāmi vidyām śrī kāmarūpiṇīm 
MBkaamadhenutantraHK-1222	ajñātvā kāminīdhyānaṃ sahasā vyarthatāmiyāt || 19/23 ||	a jñātvā kāminī dhyānam sahasā vyartha tām iyāt 
MBkaamadhenutantraHK-1223	taddhyānaṃ cañcalāpāṅgi ānandapaṭale sthitam |	tat dhyānam cañcalāpāṅgi ānanda paṭale sthitam 
MBkaamadhenutantraHK-1224	tasmādavaśyaṃ japtavyaṃ satataṃ kāmadīpanīm || 19/24 ||	tasmāt avaśyam japtavyam satatam kāmadīpanīm 
MBkaamadhenutantraHK-1225	iti śrīkāmadhenutantre devadevīsaṃvāde ūnaviṃśaḥ paṭalaḥ ||	iti śrī kāmadhenutantre devadevī saṃvāde ūnaviṃśaḥ paṭalaḥ 
MBkaamadhenutantraHK-1226	viṃśatitamaḥ paṭalaḥ	viṃśatitamaḥ paṭalaḥ 
MBkaamadhenutantraHK-1227	śrīdevī uvāca	śrī devī uvāca 
MBkaamadhenutantraHK-1228	mantrasamarpaṇaṃ tattvaṃ kathyatāṃ devapūjita |	mantrasamarpaṇam tattvam kathyatām deva pūjita 
MBkaamadhenutantraHK-1229	kasmai samarpayenmantraṃ vada deva purātana || 20/1 ||	kasmai samarpayet mantram vada deva purātana 
MBkaamadhenutantraHK-1230	arpayenmantratejāṃsi deveśa yadi śūladhṛk |	arpayet mantra tejāṃsi deveśa yadi śūladhṛk 
MBkaamadhenutantraHK-1231	nistejā sādhako deva tadaiva sahasā bhavet || 20/2 ||	nistejāḥ sādhakaḥ deva tadā eva sahasā bhavet  /
MBkaamadhenutantraHK-1232	kiṃ japyena ca pūjāyāṃ puraścaryeṇa kiṃ punaḥ |	kim japyena ca pūjāyām puraścaryeṇa kim punar 
MBkaamadhenutantraHK-1233	tanme vada mahābhāga kṛpayā parameśvara || 20/3 ||	tat me vada mahābhāga kṛpayā parameśvara 
MBkaamadhenutantraHK-1234	śrīmahādeva uvāca	śrī mahādevaḥ uvāca 
MBkaamadhenutantraHK-1235	sādhu pṛṣṭaṃ tvayā bhadre adhunā kathayāmi te |	sādhu pṛṣṭam tvayā bhadre adhunā kathayāmi te 
MBkaamadhenutantraHK-1236	japitvā cañcalāpāṅgi dhyāyet paramakāminīm || 20/4 ||	japitvā cañcalāpāṅgi dhyāyet parama kāminīm 
MBkaamadhenutantraHK-1237	mantravarṇaṃ varārohe kāminīgajagahvare |	mantra varṇam varārohe kāminī gaja gahvare 
MBkaamadhenutantraHK-1238	candrabinduyutaṃ kṛtvā ekaikaṃ daśadhā japet || 20/5 ||	candra bindu yutam kṛtvā ekaikam daśadhā japet  /
MBkaamadhenutantraHK-1239	anulome yathā devi vilomena tathā kuru |	anulome yathā devi vilomena tathā kuru 
MBkaamadhenutantraHK-1240	ataḥ paraṃ varārohe jñātvā tu kāminīṃ parām || 20/6 ||	atas param varārohe jñātvā tu kāminīm parām 
MBkaamadhenutantraHK-1241	viyadbrahma maheśāni kāminīṃ daśadhā japet |	viyat brahma maheśāni kāminīm daśadhā japet 
MBkaamadhenutantraHK-1242	kāminīgarbhamadhye tu viyadvahniyutaṃ priye || 20/7 ||	kāminī garbha madhye tu viyat vahni yutam priye 
MBkaamadhenutantraHK-1243	prajaped daśadhā bhaktyā bījatattvaṃ tadā bhavet |	prajapet daśadhā bhaktyā bīja tattvam tadā bhavet 
MBkaamadhenutantraHK-1244	tatastu kāminītattvaṃ lalāṭe paricintya vai || 20/8 ||	tatas tu kāminī tattvam lalāṭe paricintya vai 
MBkaamadhenutantraHK-1245	evañca mātṛkāsthāne kāminīṃ bhāvayet priye |	evam ca mātṛkā sthāne kāminīm bhāvayet priye 
MBkaamadhenutantraHK-1246	pañcāśanmātṛkāsthāne prajapenmātṛkāmanum || 20/9 ||	pañcāśat mātṛkā sthāne prajapet mātṛkā manum 
MBkaamadhenutantraHK-1247	bījasya jyotiḥpuñjeṣu kāminīṃ satvaraṃ kuru |	bījasya jyotiḥ puñjeṣu kāminīm satvaram kuru 
MBkaamadhenutantraHK-1248	daśadhā prajaped devi kāminībījamuttamam || 20/10 ||	daśadhā prajapet devi kāminībījam uttamam 
MBkaamadhenutantraHK-1249	kāminīgarbhamadhye tu jyotistattve japaṃ kuru |	kāminī garbha madhye tu jyotiḥ tattve japam kuru 
MBkaamadhenutantraHK-1250	jyotistattvaṃ varārohe svayaṃ jīvaḥ sanātanaḥ || 20/11 ||	jyotiḥ tattvam varārohe svayam jīvaḥ sanātanaḥ 
MBkaamadhenutantraHK-1251	kāminījīvatattvaṃ ca kṛtvā vai sādhakaḥ sudhīḥ |	kāminī jīva tattvam ca kṛtvā vai sādhakaḥ sudhīḥ 
MBkaamadhenutantraHK-1252	sahasrāre mahāpadme saṃsthāpya kāminīṃ parām || 20/12 ||	sahasrāre mahā padme saṃsthāpya kāminīm parām 
MBkaamadhenutantraHK-1253	guhyātiguhyagoptrī tvamiti mantreṇa mantravit |	guhyā ati guhya goptrī tvam iti mantreṇa mantra vid 
MBkaamadhenutantraHK-1254	devasya dakṣiṇe haste bāhyapūjādi cārpayet || 20/13 ||	devasya dakṣiṇe haste bāhya pūjā ādi ca arpayet  /
MBkaamadhenutantraHK-1255	devyā vāme varārohe samarpya phalabhāg bhavet |	devyāḥ vāme varārohe samarpya phala bhāj bhavet 
MBkaamadhenutantraHK-1256	japasya sarvatejāṃsi devahaste yadi priye || 20/14 ||	japasya sarva tejāṃsi deva haste yadi priye 
MBkaamadhenutantraHK-1257	samarpya parameśāni teja(sya? svī) sādhako bhavet |	samarpya parameśāni tejasya svī sādhakaḥ bhavet 
MBkaamadhenutantraHK-1258	kiṃ tasya pūjane bhadre kiṃ jāpena varānane || 20/15 ||	kim tasya pūjane bhadre kim jāpena varānane 
MBkaamadhenutantraHK-1259	yatkiñcid dīyate devi sarvaṃ brahmaṇi līyate |	yat kiñcid dīyate devi sarvam brahmaṇi līyate 
MBkaamadhenutantraHK-1260	vidyāmantraṃ japed devi tatteja upajāyate || 20/16 ||	vidyā mantram japet devi tat tejaḥ upajāyate 
MBkaamadhenutantraHK-1261	jīvatattvaṃ vinā devi devahaste kadācana |	jīvatattvam vinā devi deva haste kadācana 
MBkaamadhenutantraHK-1262	nārpayeccañcalāpāṅgi devyā haste viśeṣataḥ || 20/17 ||	na arpayet cañcalāpāṅgi devyāḥ haste viśeṣataḥ 
MBkaamadhenutantraHK-1263	tasmāt prayatnato devi jīvatattvaṃ kuru dhruvam |	tasmāt prayatnataḥ devi jīva tattvam kuru dhruvam 
MBkaamadhenutantraHK-1264	jīvatattvaṃ vinā devi yadi devaṃ samarpayet || 20/18 ||	jīvatattvam vinā devi yadi devam samarpayet 
MBkaamadhenutantraHK-1265	japañca viphalaṃ devi pūjā ca viphalā bhavet |	japan ca viphalam devi pūjā ca viphalā bhavet 
MBkaamadhenutantraHK-1266	gandhapuṣpādikaṃ yadyat sarvaṃ deve samarpayet || 20/19 ||	gandha puṣpa ādikam yat yat sarvam deve samarpayet 
MBkaamadhenutantraHK-1267	japatattvaṃ varārohe sarvatejomayaṃ sadā |	japa tattvam varārohe sarva tejaḥ mayam sadā 
MBkaamadhenutantraHK-1268	yadi tejo varārohe devyai devāya arpayet || 20/20 ||	yadi tejaḥ varārohe devyai devāya arpayet  /
MBkaamadhenutantraHK-1269	yastejaḥ satataṃ jīvaḥ kathaṃ siddhiḥ prajāyate |	yaḥ tejaḥ satatam jīvaḥ katham siddhiḥ prajāyate 
MBkaamadhenutantraHK-1270	yastejastvarpayed devi punarāgamanaṃ priye || 20/21 ||	yaḥ tejaḥ tu arpayet devi punarāgamanam priye 
MBkaamadhenutantraHK-1271	durlabhaṃ cañcalāpāṅgi tattejaḥ sādhakasya ca |	durlabham cañcalāpāṅgi tat tejaḥ sādhakasya ca 
MBkaamadhenutantraHK-1272	vṛthā bhayaṃ varārohe kurute narapāmaraḥ || 20/22 ||	vṛthā bhayam varārohe kurute nara pāmaraḥ 
MBkaamadhenutantraHK-1273	samarpaṇamavijñāya prajaped yadi koṭi vā |	samarpaṇam a vijñāya prajapet yadi vā 
MBkaamadhenutantraHK-1274	devatātejamadhye tu tattejopaviśet priye || 20/23 ||	devatā teja madhye tu tat tejaḥ upaviśet priye 
MBkaamadhenutantraHK-1275	bhāvayed bahuyatnena yathā sarvasvasaṃpuṭam |	bhāvayet bahu yatnena yathā sarva sva saṃpuṭam 
MBkaamadhenutantraHK-1276	etatte kathitaṃ devi jīvatattvaṃ sudurlabham || 20/24 ||	etat te kathitam devi jīva tattvam su durlabham 
MBkaamadhenutantraHK-1277	yat kṛtvā sādhako yāti durlabhaṃ brahmavigraham |	yat kṛtvā sādhakaḥ yāti durlabham brahma vigraham 
MBkaamadhenutantraHK-1278	śrutvā tantramidaṃ devi rahasyaphalamāpnuyāt |	śrutvā tantram idam devi rahasya phalam āpnuyāt 
MBkaamadhenutantraHK-1279	tantrametad varārohe śṛṇuyāt sādhakaḥ priye || 20/25 ||	tantram etat varārohe śṛṇuyāt sādhakaḥ priye 
MBkaamadhenutantraHK-1280	iti kāmadhenutantre devadevīsaṃvāde viṃśatitamaḥ paṭalaḥ ||	iti kāmadhenutantre devadevī saṃvāde viṃśatitamaḥ paṭalaḥ 
MBkaamadhenutantraHK-1281	ekaviṃśatitamaḥ paṭalaḥ	ekaviṃśatitamaḥ paṭalaḥ 
MBkaamadhenutantraHK-1282	śrīmahādeva uvāca	śrī mahādevaḥ uvāca 
MBkaamadhenutantraHK-1283	candrasūryoparāge ca prajaped yadi kāminīm |	candra sūrya uparāge ca prajapet yadi kāminīm 
MBkaamadhenutantraHK-1284	tadaiva sahasā siddhirjāyate nātra saṃśayaḥ || 21/1 ||	tadā eva sahasā siddhiḥ jāyate na atra saṃśayaḥ  
MBkaamadhenutantraHK-1285	prathamaṃ kāminīṃ japtvā svavidyāḥ prajaped yadi |	prathamam kāminīm japtvā sva vidyāḥ prajapet yadi 
MBkaamadhenutantraHK-1286	tatastu kāminīṃ japtvā sarvasiddhīśvaro bhavet || 21/2 ||	tatas tu kāminīm japtvā sarva siddhi īśvaraḥ bhavet 
MBkaamadhenutantraHK-1287	ajñātvā kāminītattvaṃ na japed grahaṇe priye |	a jñātvā kāminī tattvam na japet grahaṇe priye 
MBkaamadhenutantraHK-1288	na japed grahaṇe bhadre ajñānād yadi mūḍhadhīḥ || 21/3 ||	na japet grahaṇe bhadre ajñānāt yadi mūḍha dhīḥ 
MBkaamadhenutantraHK-1289	sarvaṃ tasya vṛthā devi pūrvadharmo vinaśyati |	sarvam tasya vṛthā devi pūrvadharmaḥ vinaśyati 
MBkaamadhenutantraHK-1290	candraparva sūryaparva na vicāryaṃ kadācana || 21/4 ||	candra parva sūrya parva na vicāryam kadācana 
MBkaamadhenutantraHK-1291	sūryaparva varārohe na paśyed yadi pāmaraḥ |	sūrya parva varārohe na paśyet yadi pāmaraḥ 
MBkaamadhenutantraHK-1292	astu tāvat paro dharmaḥ pūrvadharmo vinaśyati || 21/5 ||	astu tāvat paraḥ dharmaḥ pūrva dharmaḥ vinaśyati 
MBkaamadhenutantraHK-1293	na paśyed yadi ajñānāt sarvāriṣṭamavāpnuyāt |	na paśyet yadi ajñānāt sarva ariṣṭam avāpnuyāt 
MBkaamadhenutantraHK-1294	sarvāriṣṭamayaḥ so'pi sarvapāpamayaḥ sadā || 21/6 ||	sarva ariṣṭa mayaḥ saḥ api sarva pāpa mayaḥ sadā 
MBkaamadhenutantraHK-1295	tasmādavaśyaṃ kartavyaṃ candraparvanirīkṣaṇam |	tasmāt avaśyam kartavyam candra parva nirīkṣaṇam 
MBkaamadhenutantraHK-1296	sūryaparva tathā devi nirīkṣyamokṣamāpnuyāt || 21/7 ||	sūryaparva tathā devi nirīkṣya mokṣam āpnuyāt 
MBkaamadhenutantraHK-1297	ajñātvā yadi mūḍhātmā rāśyādigaṇanaṃ priye |	a jñātvā yadi mūḍha ātmā rāśi ādi gaṇanam priye 
MBkaamadhenutantraHK-1298	vicārya cañcalāpāṅgi na paśyed grahaṇaṃ yadi || 21/8 ||	vicārya cañcalāpāṅgi na paśyet grahaṇam yadi 
MBkaamadhenutantraHK-1299	pūrvapūrvārjitaṃ puṇyaṃ tatkṣaṇādeva naśyati |	pūrva pūrva arjitam puṇyam tad kṣaṇāt eva naśyati 
MBkaamadhenutantraHK-1300	candrasūryoparāgañca tasmād yatnānnirīkṣayet || 21/9 ||	candra sūrya uparāgam ca tasmāt yatnāt nirīkṣayet 
MBkaamadhenutantraHK-1301	kiṃ tasya kāminīṃ bhadre ramyāṇi ca punaśca kim |	kim tasya kāminīm bhadre ramyāṇi ca punar ca kim 
MBkaamadhenutantraHK-1302	grāsādimuktiparyantaṃ japtvā siddhīśvaro bhavet || 21/10 ||	grāsa ādi mukti paryantam japtvā siddhīśvaraḥ bhavet 
MBkaamadhenutantraHK-1303	na japed yadi cārvaṅgi rauravaṃ narakaṃ vrajet |	na japet yadi cārvaṅgi rauravam narakam vrajet 
MBkaamadhenutantraHK-1304	tatkāle cañcalāpāṅgi paraṃbrahmasvarūpiṇī || 21/11 ||	tad kāle cañcalāpāṅgi paraṃ brahma svarūpiṇī 
MBkaamadhenutantraHK-1305	tasmin kāle varārohe kṣatrādijātibhedataḥ |	tasmin kāle varārohe kṣatra ādi jāti bhedataḥ 
MBkaamadhenutantraHK-1306	ācaṇḍālaprabhṛtayo dvijatulyā bhavanti hi || 21/12 ||	ācaṇḍāla prabhṛtayaḥ dvija tulyāḥ bhavanti hi 
MBkaamadhenutantraHK-1307	dvijāstu cañcalāpāṅgi sākṣād brahma na saṃśayaḥ |	dvijāḥ tu cañcalāpāṅgi sākṣāt brahma na saṃśayaḥ 
MBkaamadhenutantraHK-1308	tatra kā gaṇanā devi cāṇḍālānāṃ varānane || 21/13 ||	tatra kā gaṇanā devi cāṇḍālānām varānane  /
MBkaamadhenutantraHK-1309	tasmād yatnena kartavyaṃ candraparvanirīkṣaṇam |	tasmāt yatnena kartavyam candra parva nirīkṣaṇam 
MBkaamadhenutantraHK-1310	candrakoṭiguṇaṃ devi sūryo daśaguṇaṃ bhavet || 21/14 ||	candra koṭi guṇam devi sūryaḥ daśaguṇam bhavet 
MBkaamadhenutantraHK-1311	tatra yad yat kṛtaṃ karma japahomādikaṃ priye |	tatra yat yat kṛtam karma japa homa ādikam priye 
MBkaamadhenutantraHK-1312	akṣayaṃ tad bhaved devi vacanaṃ mama niścitam || 21/15 ||	akṣayam tat bhavet devi vacanam mama niścitam 
MBkaamadhenutantraHK-1313	rāśyādigaṇanaṃ tyaktvā yavanairdṛśyate yadi |	rāśi ādi gaṇanam tyaktvā yavanaiḥ dṛśyate yadi 
MBkaamadhenutantraHK-1314	yavanasya tathā siddhirjāyate pṛthivītale || 21/16 ||	yavanasya tathā siddhiḥ jāyate pṛthivī tale 
MBkaamadhenutantraHK-1315	dīkṣito'dīkṣito vāpi dṛṣṭvā snānaṃ samācaret |	dīkṣitaḥ udīkṣitaḥ vā api dṛṣṭvā snānam samācaret 
MBkaamadhenutantraHK-1316	tadevamakṣayaṃ snānaṃ gaṅgāsnānaṃ bhavet priye || 21/17 ||	tat evam akṣayam snānam gaṅgā snānam bhavet priye 
MBkaamadhenutantraHK-1317	viṣṭhākūpasthitaṃ toyaṃ gaṅgodakasamaṃ smṛtam |	viṣṭhā kūpa sthitam toyam gaṅgā udaka samam smṛtam 
MBkaamadhenutantraHK-1318	praśastaṃ grahaṇe kāle nānyathā vacanaṃ mama || 21/18 ||	praśastam grahaṇe kāle na anyathā vacanam mama 
MBkaamadhenutantraHK-1319	ṣaṣṭhamāsādhiko bālo yadi syād varavarṇini |	ṣaṣṭha māsa adhikaḥ bālaḥ yadi syāt varavarṇini 
MBkaamadhenutantraHK-1320	grahaṇe candrasūryasya tasya snānaṃ praśasyate || 21/19 ||	grahaṇe candra sūryasya tasya snānam praśasyate 
MBkaamadhenutantraHK-1321	akṛtvā snānadānañca sahasā narakaṃ brajet |	a kṛtvā snāna dānam ca sahasā narakam brajet 
MBkaamadhenutantraHK-1322	sa bhraṣṭaḥ sa ca pāpiṣṭhaḥ sahasā sūkaraḥ priye || 21/20 ||	sa bhraṣṭaḥ sa ca pāpiṣṭhaḥ sahasā sūkaraḥ priye   
MBkaamadhenutantraHK-1323	tasyānnamudakaṃ devi mūtraṃ śoṇitavat priye |	tasya annam udakam devi mūtram śoṇita vat priye 
MBkaamadhenutantraHK-1324	jāyate nātra sandeho mama vākyaṃ varānane || 21/21 ||	jāyate na atra sandehaḥ mama vākyam varānane  /
MBkaamadhenutantraHK-1325	brāhmaṇo'brāhmaṇo vāpi candraparvaṇi pārvati |	brāhmaṇaḥ brāhmaṇaḥ vā api candraparvaṇi pārvati 
MBkaamadhenutantraHK-1326	cāṇḍālaprabhṛtiḥ sarvo brahmagotre pravartate || 21/22 ||	cāṇḍāla prabhṛtiḥ sarvaḥ brahma gotre pravartate 
MBkaamadhenutantraHK-1327	brahmeti nāma sarveṣāṃ rāśyādigaṇanaṃ kutaḥ |	brahmā iti nāma sarveṣām rāśi ādi gaṇanam kutas 
MBkaamadhenutantraHK-1328	tasmāttu cañcalāpāṅgi saṃkalpaṃ naiva kārayet || 21/23 ||	tasmāt tu cañcalāpāṅgi saṃkalpam nā eva kārayet 
MBkaamadhenutantraHK-1329	māsapakṣatithīnāṃ ca nimittāni ca pārvati |	māsa pakṣa tithīnām ca nimittāni ca pārvati 
MBkaamadhenutantraHK-1330	na vicāryaṃ varārohe grahaṇe candrasūryayoḥ || 21/24 ||	na vicāryam varārohe grahaṇe candra sūryayoḥ  /
MBkaamadhenutantraHK-1331	grāsādimokṣakāle tu kuto māsaḥ kutastithiḥ |	grāsa ādi mokṣa kāle tu kutas māsaḥ kutas tithiḥ 
MBkaamadhenutantraHK-1332	sa kālaḥ paramaṃ brahma sarveṣāmakṣigocaram || 21/25 ||	sa kālaḥ paramam brahma sarveṣām akṣi gocaram  /
MBkaamadhenutantraHK-1333	tat kathaṃ pāmaro loko rāśyādigaṇanaṃ priye |	tat katham pāmaraḥ lokaḥ rāśi ādi gaṇanam priye 
MBkaamadhenutantraHK-1334	uparāgaṃ parityajya yaścānyaṃ paricintayet || 21/26 ||	uparāgam parityajya yaḥ ca anyam paricintayet 
MBkaamadhenutantraHK-1335	sa bhavedraurave magno brahmaṇaścānumānataḥ |	sa bhavet raurave magnaḥ brahmaṇaḥ ca anumānataḥ 
MBkaamadhenutantraHK-1336	rauravāt punarāgatya pāpayonau pravarttate || 21/27 ||	rauravāt punar āgatya pāpa yonau pravarttate 
MBkaamadhenutantraHK-1337	niṣkṛtirnāsti cārvaṅgi tasyāpi ca kadācana |	niṣkṛtiḥ nā asti cāru aṅgi tasya api ca kadācana 
MBkaamadhenutantraHK-1338	tasmāt sarvaṃ parityajya candraparvanirīkṣaṇam || 21/28 ||	tasmāt sarvam parityajya candra parva nirīkṣaṇam 
MBkaamadhenutantraHK-1339	candraparve yathā devi sūryaparve tathā priye |	candraparve yathā devi sūryaparve tathā priye 
MBkaamadhenutantraHK-1340	tatra śrāddhādikaṃ tyaktvā vidyāṃ mantraṃ japet priye || 21/29 ||	tatra śrāddha ādikam tyaktvā vidyām mantram japet priye 
MBkaamadhenutantraHK-1341	anyathā narakaṃ yāti pitṝn sapta nayatyadhaḥ |	anyathā narakam yāti pitṝn sapta nayati adhas 
MBkaamadhenutantraHK-1342	aparaikaṃ pravakṣyāmi rahasyaṃ śṛṇu sundari || 21/30 ||	apara ekam pravakṣyāmi rahasyam śṛṇu sundari 
MBkaamadhenutantraHK-1343	akārādikṣakārāntaṃ pratipadme nirīkṣayet |	akāra ādi kṣakāra antam prati padme nirīkṣayet 
MBkaamadhenutantraHK-1344	tatastu prajapet śūnyaṃ candrabindukasaṃyutam || 21/31 ||	tatas tu prajapet śūnyam candra binduka saṃyutam 
MBkaamadhenutantraHK-1345	tatastu hṛdayākāśe śūnye jyotirmayeṣu ca |	tatas tu hṛdaya ākāśe śūnye jyotiḥ mayeṣu ca 
MBkaamadhenutantraHK-1346	anulomavilomena mātṛkāṃ prajapet sudhīḥ || 21/32 ||	anuloma vilomena mātṛkām prajapet sudhīḥ 
MBkaamadhenutantraHK-1347	tatastu sādhakaśreṣṭho varāṭopari mātṛkām |	tatas tu sādhaka śreṣṭhaḥ varāṭa upari mātṛkām 
MBkaamadhenutantraHK-1348	padmabījaṃ yathā devi varṇabījaṃ prabhāvayet || 21/33 ||	padma bījam yathā devi varṇa bījam prabhāvayet 
MBkaamadhenutantraHK-1349	candrabījaṃ puṭaṃ kṛtvā japed varṇaṃ prasannadhīḥ |	                           
MBkaamadhenutantraHK-1350	anulomavilomena japtvā'mṛtamayo bhavet || 21/34 ||	anuloma vilomena japtvā amṛta mayaḥ bhavet 
MBkaamadhenutantraHK-1351	kevalaṃ kāminīṃ dhyātvā praphullavadanāntaram |	kevalam kāminīm dhyātvā praphulla vadana antaram 
MBkaamadhenutantraHK-1352	bījādutpadyate devo devī vā kamalekṣaṇe |	bījāt utpadyate devaḥ devī vā kamala īkṣaṇe 
MBkaamadhenutantraHK-1353	tatastu devatāṃ dhyātvā nirīkṣya devavigraham || 21/35 ||	tatas tu devatām dhyātvā nirīkṣya deva vigraham 
MBkaamadhenutantraHK-1354	iti śrīkāmadhenutantre mahādevamahādevīsaṃvāde	iti śrī kāmadhenutantre mahādeva mahādevī saṃvāde 
MBkaamadhenutantraHK-1355	ekaviṃśatitamaḥ paṭalaḥ ||	ekaviṃśatitamaḥ paṭalaḥ 
MBkaamadhenutantraHK-1356	trayoviṃśatitamaḥ paṭalaḥ	trayoviṃśatitamaḥ paṭalaḥ 
MBkaamadhenutantraHK-1357	(granthapātaḥ)	granthapātaḥ 
MBkaamadhenutantraHK-1358	....ṣyāṃ ca varārohe gaṅgāyāṃ snānamityaham || 22/10 ||	ca varārohe gaṅgāyām snānam iti aham 
MBkaamadhenutantraHK-1359	kariṣye iti saṅkalpya śiraḥsnānaṃ samācaret |	kariṣye iti saṅkalpya śiraḥsnānam samācaret 
MBkaamadhenutantraHK-1360	arko dharmapayo devi amādyarthaśca mūrtimān || 22/11 ||	arkaḥ dharma payaḥ devi ama ādi arthaḥ ca mūrtimān 
MBkaamadhenutantraHK-1361	śravaṇañca maheśāni sākṣātkāmaśca mūrtimān |	śravaṇam ca maheśāni sākṣāt kāmaḥ ca mūrtimān 
MBkaamadhenutantraHK-1362	vyatīpāte maheśāni svayaṃ muktiḥ pragīyate || 22/12 ||	vyatīpāte maheśāni svayam muktiḥ pragīyate  /
MBkaamadhenutantraHK-1363	mādyastu cañcalāpāṅgi svayameveśvaraḥ priye |	mādyaḥ tu cañcalāpāṅgi svayam evā īśvaraḥ priye 
MBkaamadhenutantraHK-1364	etattu kathitaṃ devi pañcayogaṃ parātparam || 22/13 ||	etat tu kathitam devi pañca yogam parātparam 
MBkaamadhenutantraHK-1365	kāyikaṃ vācikaṃ caiva mānasaṃ pāpamutkaṭam |	kāyikam vācikam ca eva mānasam pāpam utkaṭam 
MBkaamadhenutantraHK-1366	tatsarvaṃ nāśamāyāti gaṅgādarśanamātrataḥ || 22/14 ||	tat sarvam nāśam āyāti gaṅgā darśana mātrataḥ 
MBkaamadhenutantraHK-1367	koṭijanmārjitaṃ pāpaṃ jalasparśādvinaśyati |	koṭi janma arjitam pāpam jala sparśāt vinaśyati 
MBkaamadhenutantraHK-1368	tatastu mauśalaṃ snānaṃ koṭisūryagrahaiḥ samam || 22/15 ||	tatas tu mauśalam snānam koṭi sūrya grahaiḥ samam 
MBkaamadhenutantraHK-1369	phalamāpnoti cārvaṅgi nātra kāryā vicāraṇā |	phalam āpnoti cārvaṅgi na atra kāryā vicāraṇā 
MBkaamadhenutantraHK-1370	ācamya cañcalāpāṅgi vāsaṃ kuryād viśāladhīḥ || 22/16 ||	ācamya cañcalāpāṅgi vāsam kuryāt viśāla dhīḥ 
MBkaamadhenutantraHK-1371	iti kāmadhenutantre trayoviṃśatitamaḥ paṭalaḥ |	iti kāmadhenutantre trayoviṃśatitamaḥ paṭalaḥ 
MBkaamadhenutantraHK-1372	caturviṃśatitamaḥ paṭalaḥ	caturviṃśatitamaḥ paṭalaḥ 
MBkaamadhenutantraHK-1373	śrīmahādeva uvāca	śrī mahādevaḥ uvāca 
MBkaamadhenutantraHK-1374	mālārahasyaṃ yogendra kathayasva kṛpānidhe |	mālā rahasyam yoga indra kathayasva kṛpā nidhe 
MBkaamadhenutantraHK-1375	yadi pucchaṃ japenmantraṃ harettejāṃsi tanmukham || 23/1 ||	yadi puccham japet mantram haret tejāṃsi tad mukham 
MBkaamadhenutantraHK-1376	mukhād yadi japenmantraṃ pucchaṃ ca cañcalaṃ bhavet |	mukhāt yadi japet mantram puccham ca cañcalam bhavet 
MBkaamadhenutantraHK-1377	cañcale sati cārvaṅgi tajjapaṃ niṣphalaṃ bhavet || 23/2 ||	cañcale sati cāru aṅgi tad japam niṣphalam bhavet 
MBkaamadhenutantraHK-1378	śrī-īśvara uvāca	   uvāca 
MBkaamadhenutantraHK-1379	pañcāśadakṣaraṃ devi grathitaṃ citranāḍiṣu |	pañcāśat akṣaram devi grathitam citra nāḍiṣu 
MBkaamadhenutantraHK-1380	sthāpyākṣarāṇi pūrve vai sumeruṃ pucchaṃ tarpiṇam || 23/3 ||	sthāpya akṣarāṇi pūrve vai sumerum puccham tarpiṇam  /
MBkaamadhenutantraHK-1381	sumeruṃ ca paricāryya akarādikamājjapet |	sumerum ca paricārya 
MBkaamadhenutantraHK-1382	mālārahasyaṃ cārvaṅgi sugopyaṃ bhuvanatraye || 23/4 ||	mālā rahasyam cāru aṅgi su gopyam bhuvanatraye 
MBkaamadhenutantraHK-1383	jātibhedaṃ jīvabhedaṃ sugopyaṃ ca yathā priye |	jāti bhedam jīva bhedam su gopyam ca yathā priye 
MBkaamadhenutantraHK-1384	jīvamantraṃ pravakṣyāmi sāvadhānāvadhāraya || 23/5 ||	jīva mantram pravakṣyāmi sa avadhāna avadhāraya 
MBkaamadhenutantraHK-1385	jīvamantraṃ jātimantraṃ samānamiti nirṇayaḥ |	jīva mantram jāti mantram samānam iti nirṇayaḥ 
MBkaamadhenutantraHK-1386	yathā dhyānaṃ maheśāni samānaṃ yāti jīvane || 23/6 ||	yathā dhyānam maheśāni samānam yāti jīvane 
MBkaamadhenutantraHK-1387	taddhyānaṃ śṛṇu cārvaṅgi sāvadhānāvadhāraya |	tat dhyānam śṛṇu cāru aṅgi sa avadhāna avadhāraya 
MBkaamadhenutantraHK-1388	dvibhujāṃ svarṇagaurāṅgīṃ pītapaṭṭaparicchadām || 23/7 ||	dvi bhujām svarṇa gaura aṅgīm pīta paṭṭa paricchadām 
MBkaamadhenutantraHK-1389	nānābharaṇadīptāṅgīṃ kiśorīṃ navayauvanām |	nānā ābharaṇa dīpta aṅgīm kiśorīm nava yauvanām 
MBkaamadhenutantraHK-1390	kṛṣṇagandhapraliptāṅgīṃ sūryāsanakṛtāśrayām || 23/8 ||	kṛṣṇagandha pralipta aṅgīm sūrya āsana kṛta āśrayām 
MBkaamadhenutantraHK-1391	tanudīrghāṅgulīṃ bhāsvannakhacandravirājitām |	tanu dīrgha aṅgulīm bhāsvat nakha candra virājitām 
MBkaamadhenutantraHK-1392	kadambakorakākārastanadvayavirājitām || 23/9 ||	kadamba koraka ākāra stana dvaya virājitām 
MBkaamadhenutantraHK-1393	karpūrasakalonmiśratāmbūlapūritānanām |	karpūra sakala unmiśra tāmbūla pūrita ānanām 
MBkaamadhenutantraHK-1394	kaṭākṣalakṣasaṃyuktabhūlatāpariśobhitām || 23/10 ||	kaṭākṣa lakṣa saṃyukta bhūlatā pariśobhitām 
MBkaamadhenutantraHK-1395	sindūratilakoddīptāṃ kuṭilālakamaṇḍitām |	sindūra tilaka uddīptām kuṭila alaka maṇḍitām 
MBkaamadhenutantraHK-1396	sarvatraivaṃ maheśāni jīvaṃ tiṣṭhati sarvadā || 23/11 ||	sarvatra evam maheśāni jīvam tiṣṭhati sarvadā 
MBkaamadhenutantraHK-1397	dvijādīnāṃ ca sarveṣāmānandapaṭale sthitām |	dvija ādīnām ca sarveṣām ānanda paṭale sthitām 
MBkaamadhenutantraHK-1398	etatte kathitaṃ sarvaṃ kāmadhenormataṃ priye || 23/12 ||	etat te kathitam sarvam kāmadhenoḥ matam priye 
MBkaamadhenutantraHK-1399	iti śrīkāmadhenutantre devīśvarasaṃvāde caturviṃśatitamaḥ paṭalaḥ ||	iti śrī kāmadhenutantre devīśvara saṃvāde caturviṃśatitamaḥ paṭalaḥ 
MBkaamadhenutantraHK-1400	samāptamidaṃ kāmadhenutantram	samāptam idam kāmadhenu tantram 
MBkaamadhenutantraHK-1401	MUKTABODHA INDOLOGICAL RESEARCH INSTITUTE©2011 Muktabodha Indological Research Institute  All Rights Reserved.E-texts may be viewed only online or downloaded for private study.E-texts may not, under any circumstances, be copied, republished,reproduced, distributed or sold, either in original or altered form, withoutthe express permission of Muktabodha Indological Research Institute in writing.Data-entered by the staff of Muktabodha under the direction of Mark S. G. Dyczkowski.	muktabodha indological research muktabodha indological research institute all rights reserved texts may be viewed only online or downloaded for private studye texts may not under any circumstances be copied republished reproduced distributed or sold either in original or altered form withoutthe express permission of muktabodha indological research institute in writing data entered by the staff of muktabodha under the direction of mark s g dyczkowski 
