segmentnr	original	analyzed
MBkulanandadiHK-0	Muktabodha E-text in UTF-8	muktabodha etext in utf
MBkulanandadiHK-1	###########################################################################MUKTABODHA INDOLOGICAL RESEARCH INSTITUTEwww.muktabodha.org©2011 Muktabodha Indological Research Institute  All Rights Reserved.E-texts may be viewed only online or downloaded for private study.E-texts may not, under any circumstances, be copied, republished,reproduced, distributed or sold, either in original or altered form, withoutthe express permission of Muktabodha Indological Research Institute in writing.Data-entered by the staff of Muktabodha under the direction of Mark S. G. Dyczkowski.Catalog number : M00284	muktabodha indological research muktabodha indological research institute all rights reserved texts may be viewed only online or downloaded for private studye texts may not under any circumstances be copied republished reproduced distributed or sold either in original or altered form withoutthe express permission of muktabodha indological research institute in writing data entered by the staff of muktabodha under the direction of mark s g dyczkowskicatalog number  /
MBkulanandadiHK-2	Uniform title: kulānandādi	uniform title kula ānanda ādi 
MBkulanandadiHK-3	Manuscript : NGMCP 1-1376/ v reel number A40/6	manuscript nm co 
MBkulanandadiHK-4	Description: The manuscript called Kulānandādi contains short tracts and fragments of early Kaula works. The first is called Kulānanda covers the first seven folios. As it attributed to Matsyendranātha, it is important although short. It deals with aspects of Kaula Yoga, focused around the -piercing - (vedha) of spiritual energy through centres of the subtle body following from above and the piercing of Kuṇḍalinī upwards. The character and form of the exposition, which is in line with other Kaula tracts attributed to Matsyendranātha, supports the view that this is indeed an early Kaula work. The next 4 folios deal with the charateristics of a skull bowl (kapāla) which is said to be drawn from the Picumata (i.e. the Brahmayāmala) which is quite possible as this text does indeed deal with this topic. The rest of the manuscript contains prescriptions for Kaula ritual. The goddesses belong to the early period, including Kubjikā, Kālasaṃkarṣiṇī, Bhagamālinī and others. Notably Tripurā is absent, although Kāmeśvarī, one of her precursors is not.	description the manuscript called kulānanda ādi contains short tracts and fragments of early kaula works the first is called kulānanda covers the first seven folios as it attributed to matsyendranātha it is important although short it deals with aspects of kaula yoga focused around the piercing vedha of spiritual energy through centres of the subtle body following from above and the piercing of kuṇḍalinī upwards the character and form of the exposition which is in line with other kaula tracts attr
MBkulanandadiHK-5	Notes: In the manuscript anusvāra and visarga occur together.	notes in the manusrrpt anusvāra and visarga occur together 
MBkulanandadiHK-6	Revision 0: December 17, 2003	revision december 
MBkulanandadiHK-7	Publication country : India	publication country india 
MBkulanandadiHK-8	oṃ namo bhairavāyaḥ ||	om namaḥ bhairavaiḥ 
MBkulanandadiHK-9	kailāsaśikharāśinaṃ devadevaṃ jagadguraṃ |	            
MBkulanandadiHK-10	paripṛcchatyumādevī ekāntaṃ jñānamutamaṃḥ ||	paripṛcchati umā devī ekāntam 
MBkulanandadiHK-11	bhedanāmutamabhedaṃ yathādehe vyavasthitaṃ |	bhedana amutam abhedam yathā dehe vyavasthitam 
MBkulanandadiHK-12	kathayasva purābhedaṃ kulānaṃdeṣu cottamaṃḥ ||	kathayasva purā bhedam kula ānaṃdeṣu 
MBkulanandadiHK-13	sthānāturaviśeṣeṇa vijñānaṃ kathayasva me |	sthāna ātura viśeṣeṇa vijñānam kathayasva me 
MBkulanandadiHK-14	sadyapratyayakārakā jayā dehe vyavasthitaṃḥ ||	         
MBkulanandadiHK-15	pāsastobhañca veṣanañca dhunanaṃ kampanaṃ tathā |	pāsastobham ca veṣanam ca dhunanam kampanam tathā 
MBkulanandadiHK-16	saśvaveśaṃ samaveśaṃ divyabhāṣā pravartanaṃḥ ||	sa śvaveśam sama veśam divya bhāṣā pravartanam 
MBkulanandadiHK-17	durādveṣakramaṃ caiva mahāvyāptisthathaiva ca |	ca eva ca 
MBkulanandadiHK-18	khecaraṃ samarasa caiva valapalitanāsanaṃḥ ||	khecaram ca eva 
MBkulanandadiHK-19	sarvatāstu sureśvara kathayasva mama prabho |	sarvatā astu sureśvara kathayasva mama prabho 
MBkulanandadiHK-20	bhairava uvāca ||	bhairavaḥ uvāca 
MBkulanandadiHK-21	śṛṇu devi pravakṣyāmi pūrabhedaṃ samutamaṃḥ |	śṛṇu devi pravakṣyāmi pūra bhedam 
MBkulanandadiHK-22	1b)	b 
MBkulanandadiHK-23	etata kaulikaṃ jñānaṃ kulānaṃde cāṣṭāttama |	kaulikam jñānam kula ānaṃde 
MBkulanandadiHK-24	brahmasthāne yatakamalaṃ catuḥṣaṣṭhidalānvitaṃḥ ||	              
MBkulanandadiHK-25	tatraiva manasāropya lakṣayadvīpa śikhānvratī |	tatra eva manasā āropya lakṣayat vīpa śikhān vratī 
MBkulanandadiHK-26	pasyati sarvadehe tu divyamma?ṣṭhavarānanaḥ ||	sarva dehe tu 
MBkulanandadiHK-27	tena lakṣitamātrena jāyate siddhirutamā |	tena lakṣita mātrena jāyate siddhiḥ utamā 
MBkulanandadiHK-28	tasyoparinābhismadavadāvicakṣaṇeḥ ||	tasya upari nābhi smada vada avicakṣaṇeḥ 
MBkulanandadiHK-29	tatparoparitiṣṭhati devobhairavā jagatprabhuḥ |	tad parā upari tiṣṭhati devaḥ bhairavāḥ jagatprabhuḥ 
MBkulanandadiHK-30	tasyāgre manasā ropya dṛḍhabhutavivakṣanaḥ ||	tasya agre manasā ropya dṛḍha bhuta vivakṣanaḥ 
MBkulanandadiHK-31	jāyate dhvanibhirjātiṃ tatramarudviśeṣataḥ |	jāyate dhvanibhiḥ jātim tatra marut viśeṣataḥ 
MBkulanandadiHK-32	etat vijñānamātrena āveśaṃ kurute dhruvaṃḥ ||	etat vijñāna mātrena āveśam kurute 
MBkulanandadiHK-33	2a)	a 
MBkulanandadiHK-34	jāyate paramāṃ sthānaṃ nātrakāryavicāranāṃt |	jāyate paramām sthānam 
MBkulanandadiHK-35	athānyaṃ paramaṃ devi sadyapratyayakārakaṃḥ ||	atha anyam paramam devi 
MBkulanandadiHK-36	taṃ pravakṣāmi he devi śṛṇu svāyatalocaneḥ |	tam pravakṣāmi he devi śṛṇu su āyata locaneḥ 
MBkulanandadiHK-37	aṅgatyaṃ dvitīyaṃ devi yatpyavaṃ? kathitaṃ mayā ||	aṅgatyam dvitīyam devi kathitam mayā 
MBkulanandadiHK-38	tatraiva sthāpaye cintaṃ kathitaṃ jāyate dhruvaṃḥ |	tatra eva sthāpaye cintam kathitam jāyate 
MBkulanandadiHK-39	atītānāgata caiva vartamānaṃ tathaiva ca ||	ca eva vartamānam tathā eva ca 
MBkulanandadiHK-40	tatraivāt pādayet śṛṣṭiṃ tīvrajyotisamākṛtiḥ |	pādayet śṛṣṭim tīvra jyotiḥ sama ākṛtiḥ 
MBkulanandadiHK-41	hṛdisasthakamalaṃ bhitvā mūdhniyān prapūrayet ||	prapūrayet 
MBkulanandadiHK-42	pāsastobhaṃ karotyevaṃ yadi viśramate mana |	pāsastobham karoti evam yadi viśramate manaḥ 
MBkulanandadiHK-43	athānyaṃ paramaṃ devi divyadṛṣṭi pravartateḥ ||	atha anyam paramam devi divya dṛṣṭi pravartateḥ 
MBkulanandadiHK-44	jvalajvālan madhyasthaṃ dvijagraṃthi nirīkṣayet |	madhya stham dvija graṃthi nirīkṣayet 
MBkulanandadiHK-45	2b)	b 
MBkulanandadiHK-46	tatraiva manasārodhā cūlikāśratu mānaye |	tatra eva mānaye 
MBkulanandadiHK-47	sthānaḥ śṛṣṭiḥ pravartate deviḥ nātrakāryavicāranāt ||	sthānaḥ śṛṣṭiḥ pravartate deviḥ 
MBkulanandadiHK-48	devyuvāca ||	devī uvāca 
MBkulanandadiHK-49	tadvedhañca sadvasāra(?) rohitaṃ mayā na prakāśitaṃḥ |	rohitam mayā na 
MBkulanandadiHK-50	kathayasva viśeṣeṇa japājānāmi tatkṣanāt ||	kathayasva viśeṣeṇa japa ājānāmi tat kṣanāt 
MBkulanandadiHK-51	bhairava uvāca ||	bhairavaḥ uvāca 
MBkulanandadiHK-52	śṛṇu devi pra * kṣāmi vedhasārayathākramaḥ |	śṛṇu devi pra 
MBkulanandadiHK-53	brahmasthāne dhūnañca? padma *? bhuḥ ṣaṣṭhi dalānvitaṃ ||	brahmasthāne ṣaṣṭhi dala anvitam 
MBkulanandadiHK-54	tatraivāt pādayet sṛṣṭhiḥ daṇḍākārāgni tejasāḥ |	pādayet 
MBkulanandadiHK-55	bhedayitvā mahāgraṃthiṃ dvicakraṃ tathaiva ca ||	bhedayitvā mahāgraṃthim dvi cakram tathā eva ca 
MBkulanandadiHK-56	mūdhni kamalaṃ * *? jvalānākāraṃ viciṃtayet |	mūdhni kamalam jvalāna ākāram viciṃtayet 
MBkulanandadiHK-57	calantaṃ bhrāmaye tena niyataṃ tu mahitalaṃ ||	calantam bhrāmaye tena niyatam tu mahi talam 
MBkulanandadiHK-58	vedhaye giri vṛkṣāni kiṃ punaḥ kṣudrajaṃtuvaḥ |	vedhaye giri vṛkṣāni kim punar kṣudra jaṃtuvaḥ 
MBkulanandadiHK-59	3a)	a 
MBkulanandadiHK-60	athānyaṃ paramaṃ devi vijñānaṃ bhadrakaṃ śṛṇu |	atha anyam paramam devi vijñānam bhadrakam śṛṇu 
MBkulanandadiHK-61	bhruvoścakṣurmadhyasthaṃ ca kālāvanāviciṃtayet ||	bhruvoḥ cakṣuḥ madhya stham ca 
MBkulanandadiHK-62	vāmastrotaṃ? bhuyāvat tīvratejasamaprabhaṃ |	vāma strotam bhuyāvat tīvra teja sama prabham 
MBkulanandadiHK-63	yāvadvisramate nityaṃ bhratete cakravattaśiraḥ ||	yāvat visramate nityam cakra vatta śiraḥ 
MBkulanandadiHK-64	durāśravana vijñānaṃ bhutadetasya ciṃtayetaḥ |	vijñānam ciṃtaya itas 
MBkulanandadiHK-65	vāmaśrīttaṃ tu yāvata tīvratejasamaprabhaṃḥ ||	tu 
MBkulanandadiHK-66	devyuvāca ||	devī uvāca 
MBkulanandadiHK-67	valipalitakṣayaḥ devanvapākhyātaṃmamāgrataḥ |	vali palita kṣayaḥ devan vapākhyātam mama agratas 
MBkulanandadiHK-68	etanme saṃśayo devaṃ kathayasva mama prabho ||	etat me saṃśayaḥ devam kathayasva mama prabho 
MBkulanandadiHK-69	bhairava uvāca ||	bhairavaḥ uvāca 
MBkulanandadiHK-70	śṛṇu devi pravakṣāmi yatsurāṇāmapi durlabhaṃḥ |	śṛṇu devi pravakṣāmi yat surāṇām api 
MBkulanandadiHK-71	dvātriṃśatidalaṃ padmaṃ tiṣṭhatitamurdhni? madhyataḥ ||	dvātriṃśati dalam padmam madhyatas 
MBkulanandadiHK-72	3b)	b 
MBkulanandadiHK-73	tatraiva bhāvayedamṛtaṃ kalāṣoḍaśasamaṃnvitaṃ |	tatra eva bhāvayet amṛtam kalā ṣoḍaśa samaṃnvitam 
MBkulanandadiHK-74	hṛccakraṃ pātayedvārāṃ yāvadānābhimaṃṇḍalaṃ ||	hṛd cakram pātayet vārām yāvat ānābhi maṇḍalam 
MBkulanandadiHK-75	cintayet kṛṣṇavarṇaṃ ca bhedaṃ tu sakalaṃ puraṃḥ |	cintayet kṛṣṇa varṇam ca bhedam tu sakalam 
MBkulanandadiHK-76	palitā stambhaye devi māsamekena suvrate ||	palitā stambhaye devi māsam ekena suvrate 
MBkulanandadiHK-77	athānyaṃ paramaṃ devi śuddhasaṃśayasthiti |	athā anyam paramam devi śuddha saṃśaya sthiti 
MBkulanandadiHK-78	kārakaṃḥ yatra catuṣpathaṃ sthānaṃ tatra sarvāśurālayaḥ ||	yatra catuṣpatham sthānam tatra sarva āśuḥ ālayaḥ 
MBkulanandadiHK-79	tatraiva sthāpaye cittaṃ divyavālapravartataḥ |	tatra eva sthāpaye cittam divya vāla pravartataḥ 
MBkulanandadiHK-80	aśrutāṃ vadate vālāṃ vadetāṃ divyavarānanaḥ ||	aśrutām vadate vālām vadetām divya vara ānanaḥ 
MBkulanandadiHK-81	viṣayahāraṃ kurute jvaravyādhivināśaye |	             
MBkulanandadiHK-82	taḥ tataḥ parataraṃ sthānaṃ tatra sarve pravartataḥ ||	taḥ tatas parataram sthānam tatra sarve pravartataḥ 
MBkulanandadiHK-83	athānyaṃ paramaṃ devi durāvedhaṃ vādāmyahaṃḥ |	athā anyam paramam devi durāvedham vādāmi aham 
MBkulanandadiHK-84	jvalajvalana madhyasthaṃ tatraiva lakṣaye dve vikhātaṃmvitakoṭisamaprabhā ||	madhya stham tatra eva lakṣaye dve 
MBkulanandadiHK-85	4a)	a 
MBkulanandadiHK-86	ūrddhaśakti nipātānātaḥ vedhayed vicakṣanaḥ |	         
MBkulanandadiHK-87	vedhayitvā tu taṃ lakṣayetaḥ ||	vedhayitvā tu tam lakṣayetaḥ 
MBkulanandadiHK-88	jvalanākāstha prabhrīṅgadva śaktiṃ cakrayitvā acalaṃ bhrāmayet punaḥ |	śaktim cakrayitvā acalam bhrāmayet punar 
MBkulanandadiHK-89	vedhayet sāmanasadalastrāṇi samakāni tu kā kathāḥ ||	vedhayet sāmanasa dala strāṇi samakāni tu kā kathāḥ 
MBkulanandadiHK-90	evaṃ jñātvā vārārohe vicañca tayathā sukhaḥ devāsura manukṣānāṃ	evam jñātvā vārārohe sukhaḥ 
MBkulanandadiHK-91	durlabho bhavati sādhakaḥ |	durlabhaḥ bhavati sādhakaḥ 
MBkulanandadiHK-92	devyuvācaḥ |	devī uvācaḥ 
MBkulanandadiHK-93	dhanūnaṃ kaṃpanaṃ devī yathā khyātaṃ mamāgrataḥ |	kaṃpanam devī yathā khyātam mama agratas 
MBkulanandadiHK-94	tataścāpi saṃśayo deva kathayasva mama prabhoḥ ||	tatas ca api saṃśayaḥ deva kathayasva mama prabhoḥ 
MBkulanandadiHK-95	bhairava uvāca ||	bhairavaḥ uvāca 
MBkulanandadiHK-96	śṛṇu devi pravakṣāmi dhūnanaṃ kaṃpanaṃ sthitaṃ |	śṛṇu devi pravakṣāmi dhūnanam kaṃpanam sthitam 
MBkulanandadiHK-97	4b)	b 
MBkulanandadiHK-98	yāsā mahāvahā nāḍī kuṃṇḍalyākāraṃ saṃsthitāḥ |	mahā vahā nāḍī kuṃṇḍalī ākāram saṃsthitāḥ 
MBkulanandadiHK-99	tatraivātpādaye dṛṣṭi daṇḍākāra sutejasāḥ ||	daṇḍa ākāra 
MBkulanandadiHK-100	hṛcakre kṣurdevi tīvraśaktisuvigrahāḥ |	hṛd cakre kṣuḥ devi tīvra śakti su vigrahāḥ 
MBkulanandadiHK-101	dhūnanaṃ kaṃpanaṃ caiva nātra kāryavicāranā ||	dhūnanam kaṃpanam ca eva na atra kārya vicāranā 
MBkulanandadiHK-102	athānya paramaṃ devi khecaratvaṃ śṛṇu priyeḥ |	paramam devi khecara tvam śṛṇu priyeḥ 
MBkulanandadiHK-103	yā * * * * *? nānvā kuṃḍalyākārasaṃsthitāḥ ||	          
MBkulanandadiHK-104	padadvaye mahāsātu mūrdhnisthaṃ kamalaṃ punaḥ |	pada dvaye mahāsātu mūrdhnistham kamalam punar 
MBkulanandadiHK-105	yāvāratayetajvalanākāraṃ sutāvayed vedhaḥ sarvasaktito madhyata khecara	vedhaḥ sarva saktitaḥ khecara 
MBkulanandadiHK-106	tṛbhaveddheḥ navāhamabhutaṃ dadet |	dadet 
MBkulanandadiHK-107	5a)	a 
MBkulanandadiHK-108	athānyaṃ sampravakṣāmi mahāvyāptiṃ varānaneḥ |	atha anyam sampravakṣāmi mahāvyāptim varānaneḥ 
MBkulanandadiHK-109	yāvadvahni sthāneṣu khyātā tasya mayāgrataḥ ||	yāvadvahni sthāneṣu khyātā tasya mayā agratas 
MBkulanandadiHK-110	tathaiva manasāropya nāśāgraṃ pavanamāninaḥ |	tathā eva manasā āropya nāśa agram pavana māninaḥ 
MBkulanandadiHK-111	manasaṃ tacca vedhayitvā niṣkalaṃ yojayed budhaḥ ||	tat ca vedhayitvā niṣkalam yojayet budhaḥ 
MBkulanandadiHK-112	mahāvyāpti bhave devi tavāhamanṛtaṃ vadet ḥ |	mahāvyāpti bhave devi tava aham anṛtam vadet 
MBkulanandadiHK-113	athānyaṃ saṃpravakṣāmi yena śiddhirbhave dhruvaṃ ||	athā anyam saṃpravakṣāmi yena śiddhiḥ bhave dhruvam 
MBkulanandadiHK-114	vargātītasya dvitīyamanulomena suvrataḥ |	varga atītasya dvitīyam anulomena suvrataḥ 
MBkulanandadiHK-115	jvalanārūḍhaṃ kṛtvā caturthaṃ svarasaṃyutaṃ ||	jvalana ārūḍham kṛtvā caturtham svara saṃyutam 
MBkulanandadiHK-116	bindumastakasambhinnamādau yojayed budhaḥ |	bindu mastaka sambhinnam ādau yojayet budhaḥ 
MBkulanandadiHK-117	vargātītaṃ punardevi ṣaṣṭhasvaravibhuṣitaṃḥ ||	varga atītam punar devi 
MBkulanandadiHK-118	saśiśekharabindusaṃjñaktaṃ yojayed devi tatpunaḥ |	yojayet devi tat punar 
MBkulanandadiHK-119	5b)	b 
MBkulanandadiHK-120	yakārasya paṃcasaṃgṛhya taṃ tṛtīyasvara samanvitaṃḥ |	yakārasya tam tṛtīya svara samanvitaḥ 
MBkulanandadiHK-121	bhāraṃ dvitīyasaṃyuktaṃ kārayet punapriyeḥ ||	bhāram dvitīya saṃyuktam kārayet 
MBkulanandadiHK-122	vargasya prathamaṃ bījaṃ sṛṣṭirādyatayojayet |	vargasya prathamam bījam 
MBkulanandadiHK-123	etaddevi samākhyātā kulaṃ vidyāsamanvitaṃ ||	etat devi samākhyātā kulam vidyā samanvitam 
MBkulanandadiHK-124	nityaṃ tu yojayed devi ekacittaṃ svapaṃttitaṃ |	nityam tu yojayet devi ekacittam 
MBkulanandadiHK-125	tasya sarvaṃ bhavet siddhi sarvajñāneṣu sundarī ||	tasya sarvam bhavet sarva jñāneṣu sundarī 
MBkulanandadiHK-126	nakhedeyāmikasya citta śiṣyapyet saṃvarānaneḥ |	saṃvara ānaneḥ 
MBkulanandadiHK-127	athānya paramaṃ devi kāmena vihvalakārakāṃ ||	devi kāmena vihvala kārakām 
MBkulanandadiHK-128	bhagasya madhyastha bhagamadhyāhna tāsanaṃ |	bhagasya 
MBkulanandadiHK-129	preritā pavanaḥ śaktyā jvalanākāra tejasāḥ ||	preritā pavanaḥ śaktyā jvalana ākāra tejasāḥ 
MBkulanandadiHK-130	visaṃ tu ciṃtaye devi mūdhni(?) kamalaṃ bhayāvataḥ |	visam tu ciṃtaye devi mūdhni kamalam bhayāvataḥ 
MBkulanandadiHK-131	śravana ciṃtayedamṛtaṃ tejo mārgena yoginiḥ ||	ciṃtayet amṛtam tejaḥ mārgena 
MBkulanandadiHK-132	6a)	a 
MBkulanandadiHK-133	bhavaṃtī vi *? lānāryaḥ kṣanamekena suvratā |	bhavantī vi lānāryaḥ kṣanam ekena suvratā 
MBkulanandadiHK-134	athānyaṃ paramaṃ devi phalapuṣpākarṣanaṃñca ||	atha anyam paramam devi phala puṣpa ākarṣanam ca 
MBkulanandadiHK-135	śṛṇu pātaparamā devi ādyāghoravikramāḥ |	śṛṇu pāta paramāḥ devi ādya aghora vikramāḥ 
MBkulanandadiHK-136	ākarṣayedbudhā vāyuḥ piṃṇḍasthaṃ rūpa na rucyateḥ ||	ākarṣayet budhāḥ vāyuḥ piṃṇḍa stham na 
MBkulanandadiHK-137	tatkṣanādyojaye devi phalapuṣpaṃ tu ciṃtayet |	tad kṣanāt yojaye devi phala puṣpam tu ciṃtayet 
MBkulanandadiHK-138	tejasā kathayet taṃtu yadi citaṃ susarpataṃḥ ||	tejasā kathayet taṃtu yadi citam 
MBkulanandadiHK-139	devyuvāca ||	devī uvāca 
MBkulanandadiHK-140	sarvatraṃ tu mayājñānaṃ bhākhiṃta deva tatparāḥ |	tu mayā ajñānam deva tad parāḥ 
MBkulanandadiHK-141	adyāpi saṃsayo devi kathaya kā?mama prabho ||	adyā api saṃsayaḥ devi kathaya kāmama prabho 
MBkulanandadiHK-142	saṃśayāntau kṣatetukaṃ |	saṃśaya antau kṣatetukam 
MBkulanandadiHK-143	bhairava uvāca ||	bhairavaḥ uvāca 
MBkulanandadiHK-144	śṛṇu devi pravakṣāmi yat surerapi durlabhaṃ |	śṛṇu devi pravakṣāmi yat sureḥ api durlabham 
MBkulanandadiHK-145	6b)	b 
MBkulanandadiHK-146	āsanaṃ tu sthiraṃ kṛtvādhakati viśva anivṛntaḥ(?) |	āsanam tu sthiram 
MBkulanandadiHK-147	abhāvaṃ bhāvaye devi sarvabhāvavivarjitaṃḥ ||	abhāvam bhāvaye devi sarva bhāva vivarjitaḥ 
MBkulanandadiHK-148	citaṃtatta?sthiraṃ kṛtvā khamadhyo viniyojayet |	kṛtvā kha madhyas viniyojayet 
MBkulanandadiHK-149	bhāvayet samarasaṃ devi prabhubhṛtyaṃ vicakṣanaḥ ||	bhāvayet sama rasam devi prabhu bhṛtyam vicakṣanaḥ 
MBkulanandadiHK-150	etad vijñānamātrena gīyate tatra madhyataḥ |	etat vijñāna mātrena gīyate tatra madhyatas 
MBkulanandadiHK-151	durāśravanavijñānaṃ vedhastobhamagrataḥ ||	durāśravana vijñānam vedhastobham agratas 
MBkulanandadiHK-152	āvesaṃ daśanaṃ khāta kaṃpa stobhaṃ tathaiva caḥ |	āvesam daśanam khāta kaṃpa stobham tathā eva caḥ 
MBkulanandadiHK-153	parakā pūrvesena saṃmpravartata(?) joginaḥ(?)	saṃmpravartata joginaḥ 
MBkulanandadiHK-154	tadabhyāsena suvrataḥ ||	tad abhyāsena suvrataḥ 
MBkulanandadiHK-155	iti matsyendrapādāvatārikaṃ kulānandasamāptamitiḥ ||	iti matsyendra pāda avatārikam kula ānanda samāpta mitiḥ 
MBkulanandadiHK-156	śubhamastu sarvajagataṃ ||	śubham astu sarva jagatam 
MBkulanandadiHK-157	7a)	a 
MBkulanandadiHK-158	āadināthasya yonāthastrośca nāthayāguruḥ svagurudikṣito yena tasya pādaṃ	nāthayā guruḥ sva guru dikṣitaḥ yena tasya pādam 
MBkulanandadiHK-159	namāmyahaṃḥ ||	namāmi aham 
MBkulanandadiHK-160	7b)	b 
MBkulanandadiHK-161	ktaṃ yathāvattavaśobhane ||	ktam yathāvat tava śobhane 
MBkulanandadiHK-162	8a)	a 
MBkulanandadiHK-163	iti kapālakṣaṇaṃ picumate ||	iti kapāla lakṣaṇam picumate 
MBkulanandadiHK-164	nañcā(?) vravīt ||	nañcā vravīt 
MBkulanandadiHK-165	antajaṃ vāpiduṣṭaṃ vā sarvalakṣana varjitaṃ |	anta jam vā api duṣṭam vā sarva lakṣana varjitam 
MBkulanandadiHK-166	pātraṃ ūrddhvamukhaṃ dṛṣṭvā khaṇḍayitvānu gṛhnayet ||	pātram ūrddhva mukham dṛṣṭvā khaṇḍayitvā anu gṛhnayet 
MBkulanandadiHK-167	khecarīśātu siddhīnāmāsrayaste prakīrtitā |	             
MBkulanandadiHK-168	sarvalakṣanasaṃyuktaṃ bhavanti ye mukhaṃ sthitaṃ ||	sarva lakṣana saṃyuktam bhavanti ye mukham sthitam 
MBkulanandadiHK-169	pārthivaṃ dadate bhogā utiṣṭhe dadate na tu gṛhyayet |	pārthivam dadate bhogāḥ utiṣṭhe dadate na tu 
MBkulanandadiHK-170	adhomukhaṃ? tu yat prātraṃ śubhalakṣaṇalakṣanaṃ(?) ||	adhomukham tu yat prātram śubha lakṣaṇa lakṣanam 
MBkulanandadiHK-171	khecarīsiddhibhaṃmastu na tu? taṃ gṛhnayed budhaḥ |	na tu tam gṛhnayet budhaḥ 
MBkulanandadiHK-172	adho siddhiṃ pradaṃ taṃtu tatastaṃ parivarjayet ||	adhas siddhim pradam taṃtu tatas tam parivarjayet 
MBkulanandadiHK-173	tiryak mukhastaṃ tu yadā gṛhnāṃta sādhakaḥ |	tiryak mukhaḥ tam tu yadā sādhakaḥ 
MBkulanandadiHK-174	japecca samaśroṇi tadā siddhiṃ pradaṃ bhavet ||	japet ca sama śroṇi tadā siddhim pradam bhavet 
MBkulanandadiHK-175	mṛtyuṃjayasya maṃtrasya prāyaścita vidhiṃ kramāt ||	mṛtyuṃjayasya maṃtrasya prāyaścita vidhim kramāt 
MBkulanandadiHK-176	ettallakṣaṇasaṃyukaḥ kapālarvaravarṇini(?) |	ettad lakṣaṇa saṃyukaḥ 
MBkulanandadiHK-177	tṛnāṇi kārayet mātri pūrvaśūtroktāni tu ||	kārayet mātri pūrva śūtra uktāni tu 
MBkulanandadiHK-178	arghapātraṃ vayaṃ kuryāt sarvasiddhi pradāyakaṃ |	arghapātram vayam kuryāt sarva siddhi pradāyakam 
MBkulanandadiHK-179	kapālalakṣaṇaṃ *?	kapāla lakṣaṇam 
MBkulanandadiHK-180	8b)	b 
MBkulanandadiHK-181	unclear	unclear 
MBkulanandadiHK-182	1a)	a 
MBkulanandadiHK-183	oṃ śivādi gurubhyo namaḥ ||	om śiva ādi gurubhyaḥ namaḥ 
MBkulanandadiHK-184	dīkṣākāle pi devesi mahāyoge tathaiva ca |	dīkṣā kāle mahā yoge tathā eva ca 
MBkulanandadiHK-185	kūrmapṛṣṭhākṛtiścaiva śaktipātraṃ tathaiva ca ||	kūrma pṛṣṭha ākṛtiḥ ca eva śaktipātram tathā eva ca 
MBkulanandadiHK-186	ṣaṣṭhapadmasamākhyātaṃ kapālaṃ varavarṇani |	ṣaṣṭha padma samākhyātam kapālam varavarṇani 
MBkulanandadiHK-187	teṣāṃ ca lakṣanāni skarvakṣamāni me śṛṇu ||?	teṣām ca lakṣanāni skaru akṣamāni me śṛṇu 
MBkulanandadiHK-188	dīrghacchulaṃ tapa pṛṣṭhaṃ agraśṛṅgaṃ prajāyate |	dīrgha chulam tapa pṛṣṭham agra śṛṅgam prajāyate 
MBkulanandadiHK-189	śāṃmukhaṃ kapitaṃ devi kapālaṃ mātra * * * ||	śāṃmukham kapitam devi kapālam mātra 
MBkulanandadiHK-190	matsyasamuṃnataṃ(?) yatra kapālaṃ parimaṇḍalaṃ |	matsya samuṃnatam yatra kapālam parimaṇḍalam 
MBkulanandadiHK-191	kurmapṛṣṭhasamākāraṃ kūrmapṛṣṭhaṃ taducyate ||	kurma pṛṣṭha sama ākāram kūrma pṛṣṭham tat ucyate 
MBkulanandadiHK-192	vaśakeva? tathāpṛṣṭhe rājapṛṣṭhā kṛti bhavet ||	vaśakā iva tathāpṛṣṭhe rājapṛṣṭhā kṛti bhavet 
MBkulanandadiHK-193	rājapṛṣṭhā samākhyātaṃ metallakṣaṇasaṃyutaṃ |	rājapṛṣṭhā samākhyātam 
MBkulanandadiHK-194	pārśva unnataṃ yatra gajakumbhākṛti sthitaṃ ||	pārśve unnatam yatra gaja kumbha ākṛti sthitam 
MBkulanandadiHK-195	madhyanimna samākhyātaṃ gajaṃkumbhā kṛ *? sthitaṃ |	madhyanimna samākhyātam gajaṃkumbhā kṛ sthitam 
MBkulanandadiHK-196	lalāṭā yāvadārabhya utkaṇṭhāyāvadeva hi ||	lalāṭā yāvat ārabhya utkaṇṭhā yāvat eva hi 
MBkulanandadiHK-197	eṣāmudviśva jāyeta ṣaṭakhaṇḍaṃ bhavate tataḥ |	jāyeta ṣaṣ khaṇḍam bhavate tatas 
MBkulanandadiHK-198	1b)	b 
MBkulanandadiHK-199	śaktipātraṃ samākhyātaṃmetallakṣanasaṃyutaṃ ||	śaktipātram 
MBkulanandadiHK-200	samaṃ pṛṣṭhe tu yat padmaṃ nimnaṃ cāpi vyavasthitaṃ |	samam pṛṣṭhe tu yat padmam nimnam ca api vyavasthitam 
MBkulanandadiHK-201	padmākāraṃ bhavet pātraṃ tat padmaṃ parikīrtitaṃ ||	padma ākāram bhavet pātram tat padmam parikīrtitam 
MBkulanandadiHK-202	lakṣaṇaṃ kathitaṃ teṣāṃ jātayaḥ śṛṇu sāṃprataṃ |	lakṣaṇam kathitam teṣām jātayaḥ śṛṇu sāṃpratam 
MBkulanandadiHK-203	brāhmaṇaṃ kṣitriyaṃ vaiśyaṃ śūdraṃ vehana saṃsayaḥ |	brāhmaṇam kṣitriyam vaiśyam śūdram vehana saṃsayaḥ 
MBkulanandadiHK-204	vadhvāryo jātayaḥ proktā kapālasya na saṃśayaḥ |	vadhvāryaḥ jātayaḥ proktā kapālasya na saṃśayaḥ 
MBkulanandadiHK-205	śuṣiraṃ dṛśyate yasya śiṣāṃvaravarṇṇini ||	śuṣiram dṛśyate yasya 
MBkulanandadiHK-206	ekaṃ vā dvā dvā trīṇi catvāri kramenaiva kapālakaṃ |	ekam vā dvā dvā trīṇi catvāri kramena eva kapālakam 
MBkulanandadiHK-207	ekacchidraṃ bhavedvipraṃ dvicchidraṃ kṣitriyaḥ smṛtaṃ ||	eka chidram bhavet vipram dvi chidram kṣitriyaḥ smṛtam 
MBkulanandadiHK-208	tricchidraṃ vaiśyamityuktaṃ catuḥ cchidraṃ tu śūdrakaṃ |	tri chidram vaiśyam iti uktam catur chidram tu śūdrakam 
MBkulanandadiHK-209	paṃcaśrotaṃ vaya cchidraṃ mattajaṃ parikīrtitaṃ ||	paṃcaśrotam chidram mattajam parikīrtitam 
MBkulanandadiHK-210	paṃcaśrotādimārabhya viṃśati yāvadeva hi |	paṃcaśrota ādim ārabhya viṃśati yāvat eva hi 
MBkulanandadiHK-211	cchidrastu *?tu jātiṣu kapālāni bhavaṃti hi ||	chidraḥ tu tu jātiṣu kapālāni bhavanti hi 
MBkulanandadiHK-212	2a)	a 
MBkulanandadiHK-213	acchidraṃmattajaṃ caiva kapālāparikīrtitāḥ |	ca eva kapālā parikīrtitāḥ 
MBkulanandadiHK-214	catuvarṇaṃ tu yatpātraṃ tadgrāhyaṃ lakṣanānvitaṃ ||	catu varṇam tu yat pātram tat grāhyam lakṣanā anvitam 
MBkulanandadiHK-215	satsvajātiṣu sarvāni sādhakaḥ parivarjayet |	sat sva jātiṣu sarvāni sādhakaḥ parivarjayet 
MBkulanandadiHK-216	prakṣānyapi mahādevi lakṣanairnātrasaṃśayaḥ ||	prakṣāni api mahādevi lakṣanaiḥ na atra saṃśayaḥ 
MBkulanandadiHK-217	caturthamapi pātramaśubhaṃ parivarjayet |	caturtham api pātram aśubham parivarjayet 
MBkulanandadiHK-218	syāmavarṇa tathā hrasva kṛṣṇacchāyaṃ tathaiva ca ||	tathā hrasva kṛṣṇa chāyam tathā eva ca 
MBkulanandadiHK-219	raktavarṇaṃ tathā caiva etāni tu vivarjayet |	rakta varṇam tathā ca eva etāni tu vivarjayet 
MBkulanandadiHK-220	syāmavarṇaṃ mahāvyādhi sādhakasya ca jāyate ||	syāmavarṇam mahā vyādhi sādhakasya ca jāyate 
MBkulanandadiHK-221	kṛṣṇavarṇa bhavet mṛtyuḥ saṃtāpaṃ raktavarṇake |	bhavet mṛtyuḥ saṃtāpam rakta varṇake 
MBkulanandadiHK-222	vartulaṃ tu kapālaṃ syāt sarvalakṣanasaṃyutaṃ ||	vartulam tu kapālam syāt sarva lakṣana saṃyutam 
MBkulanandadiHK-223	agrākya ca samākhyātaṃ nātrakāryavicāranā |	ca samākhyātam 
MBkulanandadiHK-224	deśatyāgo bhavet tena saṃyukte nāpi lakṣaṇe ||	deśa tyāgaḥ bhavet tena saṃyukte nā api lakṣaṇe 
MBkulanandadiHK-225	raktavarṇaṃ tu āgneyaṃ sphuṭitaṃ sarvato bhavet |	rakta varṇam tu āgneyam sphuṭitam sarvatas bhavet 
MBkulanandadiHK-226	2b)	b 
MBkulanandadiHK-227	saṃtāpo dvegajananamaśubhaṃ parivarjayet |	saṃtāpaḥ dvega jananam aśubham parivarjayet 
MBkulanandadiHK-228	saṃkhakuṃdendusaṃkāsni svacchāyāṃ tu yadbhavet ||	svacchāyām tu yat bhavet 
MBkulanandadiHK-229	tadgrāhyaṃ sādhakendrena bhuktidaṃ tatprakīrtitaṃ |	tat grāhyam sādhaka indrena bhukti dam tat prakīrtitam 
MBkulanandadiHK-230	madhuvarṇaṃntu yatpātraṃ snigdhachāyā tu yadbhavet ||	yat pātram snigdha chāyā tu yat bhavet 
MBkulanandadiHK-231	bhuktidaṃ tadapi prottaṃ gṛhitavyaṃ tu sādhakaiḥ |	bhukti dam tat api prottam gṛhitavyam tu sādhakaiḥ 
MBkulanandadiHK-232	gonavanītasaṃkāsaṃ snigdhacchāyā tathaiva ca ||	go navanīta saṃkāsam snigdha chāyā tathā eva ca 
MBkulanandadiHK-233	bhuktidaṃ caiva saṃproktaṃ gṛhīta yatu maṃtrinā |	bhukti dam ca eva saṃproktam maṃtrinā 
MBkulanandadiHK-234	śukla tatacca? vahukṣaṃ muktetat prakīrtitaṃ ||	prakīrtitam 
MBkulanandadiHK-235	mokṣadaṃte samākhyātaṃ evaṃ bhairavo bravīt |	evam bhairavaḥ bravīt 
MBkulanandadiHK-236	vartula strī kapālaṃ syāt bhavet tasya tanunva vā ||	vartula strī kapālam syāt bhavet tasya tanunva vā 
MBkulanandadiHK-237	dvipuṭaṃ tatsamākhyātaṃ gṛhītavyaṃ tu sādhakaiḥ |	dvi puṭam tat samākhyātam gṛhītavyam tu sādhakaiḥ 
MBkulanandadiHK-238	mumukṣunāṃ tato grāhyaṃ bhuktidaṃ tatprakīrtitaṃ ||	mumukṣunām tatas grāhyam bhukti dam tat prakīrtitam 
MBkulanandadiHK-239	3a)	a 
MBkulanandadiHK-240	ekapuṭānisastāni durlabhānyathatāni tu |	tu 
MBkulanandadiHK-241	dvipuṭānyapi grāhyāni etairlakṣanakaiḥ priye ||	dvi puṭāni api grāhyāni etaiḥ lakṣanakaiḥ priye 
MBkulanandadiHK-242	ekakhaṇḍakapālaṃ tu durlabhaṃ tridaśairapi |	eka khaṇḍa kapālam tu durlabham tridaśaiḥ api 
MBkulanandadiHK-243	tena hrasva sthite naiva vidyārapadaṃ labhet ||	tena na eva vidyāra padam labhet 
MBkulanandadiHK-244	gonavanītasaṃkāsaṃ kāsaṃ bhavet tatsthalasaṃpuṭāṃ |	            
MBkulanandadiHK-245	nigūḍhajālikaṃ caiva gūḍhasadvitathaiva ca ||	nigūḍhajālikam ca eva gūḍha sat vitathā eva ca 
MBkulanandadiHK-246	durlabhaṃ tadapi tatproktaṃ sarvasiddhipradāyakaṃ |	durlabham tat api tat proktam sarva siddhi pradāyakam 
MBkulanandadiHK-247	dvimaṇḍa ca trikhaṇḍaṃ ca bhuktidau tau prakīrtitau ||	ca tri khaṇḍam ca bhukti dau tau prakīrtitau 
MBkulanandadiHK-248	paṃcakhṇḍa ṣaṭkhaṇḍa vā saptakhaṇḍa tathaiva ca |	paṃcakhṇḍa ṣaṭkhaṇḍa vā saptakhaṇḍa tathā eva ca 
MBkulanandadiHK-249	bhuktecchunānagrāhyāni muktestho sobhanāni tu ||	sobhanāni tu 
MBkulanandadiHK-250	śatakhaṇḍa bhaved yasya hastaprāptaṃ tu suvrate |	śata khaṇḍa bhavet yasya hasta prāptam tu suvrate 
MBkulanandadiHK-251	utiṣṭāṃ dadate siddhi tatkṣanā bhe	dadate tad kṣanāḥ bhe 
MBkulanandadiHK-252	jalapratiṣṭhā	jala pratiṣṭhā 
MBkulanandadiHK-253	(whole page blank)	hole page blank 
MBkulanandadiHK-254	1a)	a 
MBkulanandadiHK-255	oṃ namo varuṇāya nama |	om namaḥ varuṇāya nama 
MBkulanandadiHK-256	kārtikeyovāca ||	kārtikeyā uvāca 
MBkulanandadiHK-257	praṇamya śirasā deva śrīkaṇṭhaṃ umayā saha |	praṇamya śirasā deva śrīkaṇṭham umayā saha 
MBkulanandadiHK-258	māyāvikṣaubhyate viśvaṅkaroti vikaroti ca ||	māyā vikṣaubhyate viśvaṅkaroti vikaroti ca 
MBkulanandadiHK-259	tasmai saṃcittaparānandaṃ nāgamūrtinamo'stute |	tasmai saṃcitta para ānandam nāga mūrti namaḥ stute 
MBkulanandadiHK-260	anantavāśukī takṣaka karkoṭakapadma mahāpadma saṃkhapāla āstīka ityaṣṭa	ananta vāśukī takṣaka karkoṭakapadma mahāpadma saṃkhapālaḥ āstīkaḥ iti aṣṭa 
MBkulanandadiHK-261	nāgā prakīrtitā ||	nāgā prakīrtitā 
MBkulanandadiHK-262	svacchanda vaiṣṇavamvāpi vedikaśca mathāpi vā |	vedikaḥ ca 
MBkulanandadiHK-263	etatkarma prakartavyā varunastu yathā vidhi ||	etat karma prakartavyā 
MBkulanandadiHK-264	viluptaḥ maśni vījantu pārthiva tatra pūjayet |	viluptaḥ maśni vījantu pārthiva tatra pūjayet 
MBkulanandadiHK-265	vahni caivādikaṅkṛtvā vedoktaśca yathāvidhiḥ ||	vahni ca eva ādikam kṛtvā veda uktaḥ ca yathā vidhiḥ 
MBkulanandadiHK-266	kṛtasnānā ca manaṃ saṃdhyā devārcana vidhiṃḥ guruḥ |	kṛtasnānā ca saṃdhyā deva arcana vidhiṃḥ guruḥ 
MBkulanandadiHK-267	1b)	b 
MBkulanandadiHK-268	prakṣālyapāni pādau yāgamaṇḍapaṃ pravisya ||	prakṣālya apāni pādau yāga maṇḍapam pravisya 
MBkulanandadiHK-269	pūrvāmukha uttarāmukhaṃ vā padmāsanaṃ vadhvā ||	pūrvā mukhe uttarā mukham vā padmāsanam vadhvā 
MBkulanandadiHK-270	karannyāsādikaṅkṛtvā punavārghakarī guruḥ ||	karat nyāsa ādikam kṛtvā guruḥ 
MBkulanandadiHK-271	tatra tatraṃ śivasāstraṃ vedoktaśāstra vihitaṃ ||	tatra tatram śiva sa astram veda ukta śāstra vihitam 
MBkulanandadiHK-272	kuṇḍamaṇḍapadhvajapatākāmupasobhitañca ||	kuṇḍa maṇḍapa dhvaja patākām upasobhitañca 
MBkulanandadiHK-273	cutapalava vetrapalatraṃ vaṃsapatraprakṣādumbalicūtaprabhuḥ ||	vetra palatram 
MBkulanandadiHK-274	iti pañcapallava ||	iti pañcapallava 
MBkulanandadiHK-275	tato pūrvādi toraṇapravakṣāmi || asvastha odumbara vaṭañca palakṣaḥ ||	pūrva ādi 
MBkulanandadiHK-276	iti toraṇo ||	iti toraṇaḥ 
MBkulanandadiHK-277	vidiśeṣu ca devadāruṃ || iti digavidigatoraṇe || tato patākā kramaḥ ||	vidiśeṣu ca devadārum iti diś avidiśa toraṇe patākā kramaḥ 
MBkulanandadiHK-278	2a)	a 
MBkulanandadiHK-279	ai&drāyudhopamāraktā kṛṣṇānīlaśaśiprabhā |	aidrāyudha upamā āraktā kṛṣṇa ānīla śaśi prabhā 
MBkulanandadiHK-280	śukābhā hemavarṇā ca patākā sphaṭikopamā ||	śuka ābhā hema varṇā ca patākā sphaṭika upamā 
MBkulanandadiHK-281	adhobhāge tu dhūmrā bhāriśānyāṃ kuṃkumaprabhā ||	adhobhāge tu dhūmrā bhāriśānyām kuṃkuma prabhā 
MBkulanandadiHK-282	ūrddhantu śvetavarṇā tu || iti daśapatākā ||	ūrddhan tu śveta varṇā tu iti daśa patākā 
MBkulanandadiHK-283	oṃ tatsavitu turitityaṅganyāsamvidhāya praṇavārghaṃ karo guruḥ ||	om tat savitu tuḥ iti iti aṅganyāsam vidhāya praṇava argham karaḥ guruḥ 
MBkulanandadiHK-284	tatapūrvaṃ dvāramantra || dvāramastrena samprokṣaḥ ||	tata pūrvam dvāra mantra dvāram astrena samprokṣaḥ 
MBkulanandadiHK-285	oṃ akṣarāhvāyakitaraḥ riti pūjayet || oṃ hrīṃ śusobhakalādvārā nama ||	om r iti pūjayet om   śu sobha kalā dvārā nama 
MBkulanandadiHK-286	dvāropari ||	dvāra upari 
MBkulanandadiHK-287	ye te panthāriti dvau dvau nadī prapūjayet ||	ye te panthāḥ iti dvau dvau nadī prapūjayet 
MBkulanandadiHK-288	oṃ śubhadrāya nama ||  oṃ bhadrāya nama || iti śākhayo ||	om śubhadrāya nama   om bhadrāya namaḥ iti śākhayoḥ 
MBkulanandadiHK-289	2b)	b 
MBkulanandadiHK-290	oṃ śubhadra toranāya namaḥ ||	om śubhadra toranāya namaḥ 
MBkulanandadiHK-291	torane || oṃ kumudāya namaḥ ||  dhvajadaṇḍa || oṃ indraṃ viśvā amīriti |	torane om kumudāya namaḥ dhvaja daṇḍa om indram viśvāḥ amīḥ iti 
MBkulanandadiHK-292	patākāṃ pūjanam ||	patākām pūjanam 
MBkulanandadiHK-293	oṃ hrīṃ vajrāya hūṃ phaṭ namaḥ patākāyā ||	om hrīṃ vajrāya   phaṭ namaḥ 
MBkulanandadiHK-294	āvāhanādi pādyā camanampuṣpandatvā ||	āvāhana ādi pādyā camanam puṣpan datvā 
MBkulanandadiHK-295	tato agnikaune gatvā || oṃ hrīṃ kumudāya namaḥ || dhvaja daṇḍe ||	tatas agnikaune gatvā om hrīṃ kumudāya namaḥ dhvaja daṇḍe 
MBkulanandadiHK-296	oṃ agnāvagniriti || raktapatākāyāṃ ||	om agnau agniḥ iti rakta patākāyām 
MBkulanandadiHK-297	oṃ hrīṃ śaktaye namaḥ || patākāyāṃ || tato dakṣinadvāre gatvā ||	om hrīṃ śaktaye namaḥ patākāyām tatas dakṣi nadvāre gatvā 
MBkulanandadiHK-298	dvāramastrena samprokṣa || oṃ akṣarājāya namaḥ || oṃ śubhadra kalādvārāya	dvāram astrena samprokṣa om akṣarājāya namaḥ om śubhadra kalādvārāya 
MBkulanandadiHK-299	namaḥ || dvāropari || te panthāriti || oṃ hrīṃ amodāya namaḥ || oṃ hrīṃ	namaḥ dvāra upari te panthāḥ iti om hrīṃ amodāya namaḥ om hrīṃ 
MBkulanandadiHK-300	pramodāya namaḥ || śākhayo ||	pramodāya namaḥ śākhayo 
MBkulanandadiHK-301	3a)	a 
MBkulanandadiHK-302	oṃ hrīṃ śubhadratoraṇāya namaḥ || torane ||	om   śubhadra toraṇāya namaḥ torane 
MBkulanandadiHK-303	oṃ hrīṃ puṇḍarīkākṣāya namaḥ || dhvajadaṇḍa ||	om   puṇḍarīkākṣāya namaḥ dhvaja daṇḍa 
MBkulanandadiHK-304	oṃ hrīṃ aśiyamoriti || oṃ hrīṃ daṇḍāya hūṃ phaṭ namaḥ || kṛṣṇa	om hrīṃ om hrīṃ daṇḍāya   phaṭ namaḥ kṛṣṇaiḥ 
MBkulanandadiHK-305	patākāyāṃ || āvāhanādi pādyā ca manampuṣpaṃ datvā ||	patākāyām āvāhana ādi pādyā ca 
MBkulanandadiHK-306	tato nai-ṛtyakone || oṃ hrīṃ vāmanāya namaḥ || dhvajadaṇḍe ||	tatas naiṛtyaka ūne om   vāmanāya namaḥ dhvaja daṇḍe 
MBkulanandadiHK-307	oṃ eṣate nai-ṛte bhāgariti || oṃ hrīṃ khaḍgāya hūṃ phaṭ namaḥ ||	om naiṛte om hrīṃ khaḍgāya hūm phaṭ namaḥ 
MBkulanandadiHK-308	dhūmrapatākāyāṃ ||	dhūmrapatākāyām 
MBkulanandadiHK-309	tato paścimadvāre gatvā || astena saṃprokṣa || oṃ tretāyādi navadarśanariti ||	paścima dvāre gatvā astena saṃprokṣa om om 
MBkulanandadiHK-310	oṃ hrīṃ susamā kalādārāya nama || dvāropari ||	om   susamā kalā dārāya nama dvāra upari 
MBkulanandadiHK-311	oṃ ete panthāriti dvau dvau kumbhā prapūjayet ||	om ete panthāḥ iti dvau dvau kumbhau prapūjayet 
MBkulanandadiHK-312	oṃ hrīṃ jayāya nama || oṃ hrīṃ vijayāya nama ||	om   jayāya nama  om   vijayāya nama 
MBkulanandadiHK-313	3b)	b 
MBkulanandadiHK-314	śākhayo ||	śākhayoḥ 
MBkulanandadiHK-315	oṃ hrī& śusamokṣa toranāya nama || torane ||	om hrī toranāya nama torane 
MBkulanandadiHK-316	oṃ hrī& śaṃkhakarṇāya namaḥ || dhvajadaṇḍe || oṃ idamāyata pravahatāriti ||	om hrī śaṃkhakarṇāya namaḥ dhvaja daṇḍe om idam āyata pravahatar iti 
MBkulanandadiHK-317	oṃ hrīṃ pāśāya hūṃ phaṭ namaḥ || śuklapatākāyā || āvāhanādi pādyā	om   pāśāya   phaṭ namaḥ śukla patākāyāḥ āvāhana ādi pādyā 
MBkulanandadiHK-318	camanapuṣpaṃ datvā ||	camana puṣpam da tvā 
MBkulanandadiHK-319	to vāyu koṇe gatvā || oṃ hrīṃ sarvanetrāya namaḥ || dhvajadaṇḍe ||	to vāyu koṇe gatvā om hrīṃ sarvanetrāya namaḥ dhvaja daṇḍe 
MBkulanandadiHK-320	oṃ tadviprāso vipaṃ?nyavariti || oṃ hrīṃ dhvajāya hu& phaṭ namaḥ ||	om om om hrīṃ dhvajāya hu phaṭ namaḥ 
MBkulanandadiHK-321	haritapatākāyāṃ ||	harita patākāyām 
MBkulanandadiHK-322	tato uttaradvāre || astrena saṃprokṣa || oṃ śuhotra kalādvārāya namaḥ ||	tatas uttara dvāre astrena saṃprokṣa om śuhotra kalā dvārāya namaḥ 
MBkulanandadiHK-323	dvaropari ||	dvara upari 
MBkulanandadiHK-324	ye te paṃthāriti ||	ye te paṃthāḥ iti 
MBkulanandadiHK-325	oṃ śohottara toranāya nama || torane ||	om torane 
MBkulanandadiHK-326	oṃ hrīṃ nyāsādāya nama ||	om   nyāsa ādāya nama 
MBkulanandadiHK-327	oṃ hrīṃ samukhāya namaḥ || dhvajadaṇḍe || oṃ agne acchāvariti ||	om   samukhāya namaḥ dhvaja daṇḍe om agne acchāvar iti 
MBkulanandadiHK-328	4a)	a 
MBkulanandadiHK-329	oṃ hrī& gadāya hū& phaṭ nama ||	om hrī gadāya hū phaṭ nama 
MBkulanandadiHK-330	pītapatākāyāṃ || āvāhanādi pādyā camanapuṣpaṃ datvā ||	pīta patākāyām āvāhana ādi pādyā camana puṣpam da tvā 
MBkulanandadiHK-331	tatomīśānakone gatvā ||	gatvā 
MBkulanandadiHK-332	oṃ hrī& supratiṣṭhāya namaḥ || dhvajadaṇḍa ||	om hrī supratiṣṭhāya namaḥ dhvaja daṇḍa 
MBkulanandadiHK-333	oṃ jāte bhadraśivātanūriti || oṃ hrīṃ triśūlāya hūṃ phaṭ namaḥ ||	om jāte bhadra śivā tanūḥ iti om   triśūlāya   phaṭ namaḥ 
MBkulanandadiHK-334	patākāyāṃ || tato punaḥ ||	patākāyām punar 
MBkulanandadiHK-335	nai-ṛtyakone gatvā ||	naiṛtyaka ūne gatvā 
MBkulanandadiHK-336	oṃ hrīṃ cakrāya namaḥ || dhvaja daṇḍe ||	om hrīṃ cakrāya namaḥ dhvaja daṇḍe 
MBkulanandadiHK-337	oṃ viṣṇānukaṃ vīryāni || oṃ hrīṃ garuḍāya hūṃ phaṭ namaḥ || patākāyāṃ ||	om vīryāni om hrīṃ garuḍāya   phaṭ namaḥ patākāyām 
MBkulanandadiHK-338	punamīṣokone gatvā ||	punar īṣā uka ūne gatvā 
MBkulanandadiHK-339	oṃ hrīṃ āśāya namaḥ || dhvajadaṇḍe || oṃ brahmayajñānariti || oṃ hrīṃ	om   āśāya namaḥ dhvaja daṇḍe om om   
MBkulanandadiHK-340	padmāya hūṃ phaṭ namaḥ || patākāyāṃ || oṃ hrīṃ supatnāya namaḥ ||	padmāya hūm phaṭ namaḥ patākāyām om hrīṃ supatnāya namaḥ 
MBkulanandadiHK-341	dhvajadaṇḍe || oṃ ghṛtaṃ ghṛtapāvānariti ||	dhvaja daṇḍe om ghṛtam ghṛta pāvānaḥ iti 
MBkulanandadiHK-342	4b)	b 
MBkulanandadiHK-343	oṃ hrīṃ vyomāya namaḥ || ūrdhvapatākāyāṃ ||	om   vyomāya namaḥ ūrdhvapatākāyām 
MBkulanandadiHK-344	tato paṃcagavya śādhayet || maṇḍalapañcakaṃ kṛtvā || oṃ hrīṃ nālāya	paṃcagavya śādhayet maṇḍala pañcakam kṛtvā om   nālāya 
MBkulanandadiHK-345	namaḥ | madhye ||	namaḥ madhye 
MBkulanandadiHK-346	oṃ hrīṃ kurmāya namaḥ || pūrve ||	om   kurmāya namaḥ pūrve 
MBkulanandadiHK-347	oṃ hrī& kūkarāya namaḥ | dakṣine ||	om hrī kūkarāya namaḥ dakṣine 
MBkulanandadiHK-348	oṃ hrīṃ dhanaṃjayāya namaḥ || paścime ||	om hrīṃ dhanaṃjayāya namaḥ paścime 
MBkulanandadiHK-349	oṃ hrīṃ devadatāya namaḥ || uttare ||	om hrīṃ devadatāya namaḥ uttare 
MBkulanandadiHK-350	iti maṇḍala devatā || kṣīra | dadhi | śarpi | gomūtra | gomaya || etāni parikramena	iti maṇḍala devatā kṣīra dadhi śarpi gomūtra gomaya etāni parikramena 
MBkulanandadiHK-351	pūjayet || oṃ āyvāyeriti kṣīraṃ || pūjayet ||	pūjayet om kṣīram pūjayet 
MBkulanandadiHK-352	oṃ dadhikrāvnotidapi(?) pūjayet ||	om pūjayet 
MBkulanandadiHK-353	oṃ tejosiriti ghṛtaṃ pūjayet || oṃ gāyatrī mantrena gomūtra pūjayet ||	om tejosiḥ iti ghṛtam pūjayet om gāyatrī mantrena go mūtra pūjayet 
MBkulanandadiHK-354	oṃ gandhadvāreti gomayaṃ pūjayet ||	om gandha dvāra iti gomayam pūjayet 
MBkulanandadiHK-355	5a)	a 
MBkulanandadiHK-356	āvāhanādi pādyācamanaṃ datvā ||	āvāhana ādi pādya ācamanam da tvā 
MBkulanandadiHK-357	oṃ sambapāmīti cālotrya ||	om sambapāmi iti ca ālotrya 
MBkulanandadiHK-358	oṃ janayatveti pūjanaṃ || devajala ātmabhāgaṃ ca || tato dakṣina digbhāgaṃ	om janayatva iti pūjanam deva jale ātma bhāgam ca tatas diś bhāgam 
MBkulanandadiHK-359	bhūśuddhimupakramet || recaka pūrakaḥ kumbhakaḥ || ātma tatvādi pṛthvi	bhū śuddhim upakramet recaka pūrakaḥ kumbhakaḥ ātma tatva ādi pṛthvi 
MBkulanandadiHK-360	tatve pūjyaṃ taṃ || tatva nyāsaṃ kuryāt | bhūtaśuddhinivṛttāḥ	pūjyam tam nyāsam kuryāt bhūtaśuddhi nivṛttāḥ 
MBkulanandadiHK-361	antayāgamvidhāya || ātmānaṃ śrīkaṇṭhā dvikaṃ vibhāvya || utpāte	anta yāgam vidhāya ātmānam śrīkaṇṭhāḥ dvikam vibhāvya utpāte 
MBkulanandadiHK-362	prasamanena śivayet || oṃ *? pahatātsuśurārakṣāriti || ācamyaḥ	om ācamyaḥ 
MBkulanandadiHK-363	nyāsaṅkṛtvā sarvoṣadhīnāṃ bhiśiṃcyaḥ || āpo asmāṃmātarariti || *	sarva oṣadhīnām āpaḥ  /
MBkulanandadiHK-364	tato dhyānaṃ kṛtvā ||	tatas dhyānam kṛtvā 
MBkulanandadiHK-365	5b)	b 
MBkulanandadiHK-366	recakaṃ pūrakaḥ kumbhakaḥ ||	recakam pūrakaḥ kumbhakaḥ 
MBkulanandadiHK-367	ātmatatvādi pṛthvītatvaparyaṃtaṃ nyāsaṃ kṛtvā ||	ātma tatva ādi pṛthvī tatva paryaṃtam nyāsam kṛtvā 
MBkulanandadiHK-368	bhūtaśuddhinnivṛtyaṃ antayāgaṃ vidhāya antayāgaṃ kṛtvā ||	anta yāgam vidhāya anta yāgam kṛtvā 
MBkulanandadiHK-369	visekhārghapātraṃ prakṣālyapātra pūjayet ||	pūjayet 
MBkulanandadiHK-370	lājā candana śiddhārtha svakṣatarapi durvākuśapuṣpakṣatila ||	lājā candana śiddhārtha 
MBkulanandadiHK-371	iti aṣṭārgha sādhayet || tataḥ śrīkaṇṭhādi pasvi?bhājyaḥ ||	iti aṣṭārgha sādhayet tatas śrīkaṇṭhādi pasvibhājyaḥ 
MBkulanandadiHK-372	ātmahaste gandhamaṇḍalaṃ kṛtvā || sāgaṃ pūjayet || śiraśimāropayet ||	ātma haste gandha maṇḍalam kṛtvā sāgam pūjayet 
MBkulanandadiHK-373	viṣṇumayī bhāvayet || svata uṣṇīyaṃ śiroveṣṭayitvā ||	viṣṇu mayī bhāvayet svatas uṣṇīyam śiraḥ veṣṭayitvā 
MBkulanandadiHK-374	oṃ suparṇosi garutmāriti || tatolayāṅgamūlamuccārya svaśiro prapūjayet ||	om suparṇaḥ asi garutmān iti tatas laya aṅga mūlam uccārya sva śiraḥ prapūjayet 
MBkulanandadiHK-375	tatomaṇḍapa su *? ra kuryāt ||	kuryāt 
MBkulanandadiHK-376	6a)	a 
MBkulanandadiHK-377	oṃ saptayuṃjanniriti || tato jñānakhaḍgamādāya || lājākṣepanaṃ || oṃ	om tatas jñāna khaḍgam ādāya lājā kṣepanam om 
MBkulanandadiHK-378	sarmāsya vadhūtaguṃ rakṣamiti samājanaṃ || pañcagavyena śiṃcanam ||	sarma asya vadhūta gum rakṣam iti samājanam pañcagavyena śiṃcanam 
MBkulanandadiHK-379	arghāmbunā samprokṣaḥ || samārjana tato āsana kalpanaṃ || oṃ hrīṃ anaṃtāya	argha ambunā samprokṣaḥ samārjana tatas āsana kalpanam om hrīṃ anaṃtāya 
MBkulanandadiHK-380	namaḥ || oṃ yā idmeriti || oṃ hrīṃ vāśukiye namaḥ || oṃ namastu	namaḥ om yā idmeḥ iti  om hrīṃ vāśukiye namaḥ om namaḥ tu 
MBkulanandadiHK-381	sarpebhyaḥritiḥ || oṃ hrīṃ takṣakāya namaḥ || oṃ ye vāmīrocane manasoriti ||	sarpebhyaḥ ritiḥ om hrīṃ takṣakāya namaḥ om ye vāmīrocane manasoḥ iti 
MBkulanandadiHK-382	oṃ hrīṃ karkoṭakāya namaḥ || oṃ taduttamaṃ varuṇapāsa || oṃ hrīṃ padmāya	om   karkoṭakāya namaḥ om tat uttamam varuṇa pāsa om   padmāya 
MBkulanandadiHK-383	namaḥ || oṃ tatvājāmi brahmanā || oṃ hrīṃ mahāpadmāya namaḥ || oṃ ye te	namaḥ om brahmanā  om hrīṃ mahāpadmāya namaḥ om ye te 
MBkulanandadiHK-384	sataṃ varuṇaṃ || oṃ hrīṃ sakhapālāya nama || oṃ tvaṃ no agnaye ||	om hrīṃ sakha pālāya nama om tvam naḥ agnaye 
MBkulanandadiHK-385	6b)	b 
MBkulanandadiHK-386	oṃ hrīṃ āstīkāya namaḥ || oṃ apasvaṃtaramiti || oṃ hrīṃ kulikāya namaḥ ||	om hrīṃ āstīkāya namaḥ om apasvaṃtaram iti om hrīṃ kulikāya namaḥ 
MBkulanandadiHK-387	oṃ vanasvetambhanamasi || oṃ hrīṃ vauṃ varuṇāya namaḥ || oṃ imamme varuna	om vanasva itambha namasi om hrīṃ vaum varuṇāya namaḥ om 
MBkulanandadiHK-388	pūrvādi īśānāntaṃ madhyaparyaṃtaṃ prapūjayet || athānantare	pūrva ādi īśāna antam madhya paryantam prapūjayet atha anantare 
MBkulanandadiHK-389	lokapālārcanaṃ || adha ūrddhantu pūjayet ||	lokapāla arcanam adhas ūrddhantu pūjayet 
MBkulanandadiHK-390	oṃ ravedāya nama || oṃ agnimīḍe purohitaṃ || tato dakṣina digabhāge || oṃ iṣe	om nama om agnim īḍe purohitam tatas om iṣe 
MBkulanandadiHK-391	tūryetvā || yajuvedāya namaḥ || paścime ||	tūrya itvā yaju vedāya namaḥ paścime 
MBkulanandadiHK-392	oṃ śāmavedāya nama || oṃ agni āyāhi bhītaye || uttara ||	om śāmavedāya nama om agni āyāhi bhītaye uttara 
MBkulanandadiHK-393	atharpavedāya nama || oṃ sanno devīrabhiṣṭaye || oṃ brahmayajñānaṃ	atha ṛpa vedāya nama om san naḥ devīḥ abhiṣṭaye om 
MBkulanandadiHK-394	prathamaṃ ūrddha brahmānaṃ pūjayet ||	prathamam ūrddha brahmānam pūjayet 
MBkulanandadiHK-395	7a)	a 
MBkulanandadiHK-396	vāyavyādiśi || oṃ namo ganebhyo ganapatiṃ pūjayet || iśāne gurukalasaṃ	vāyavya ādiśi  om namaḥ ganebhyaḥ gana patim pūjayet iśāne guru kalasam 
MBkulanandadiHK-397	pūjayet || śadāśivādi svaguruprayantaṃ pūjayet ||	pūjayet pūjayet 
MBkulanandadiHK-398	āgneya diśī || oṃ śuparṇośigarutmāmantrena garuḍañca pūjayet ||	āgneya diśī om śuparṇa uśi garutmant mantrena garuḍam ca pūjayet 
MBkulanandadiHK-399	oṃ sahaśrasīriṣā puruṣamaṃtrena viṣṇukalasaṃ pūjayet ||	om puruṣa maṃtrena viṣṇu kalasam pūjayet 
MBkulanandadiHK-400	oṃ bhīśvate lakṣmī kalaśaṃ pūjayet || oṃ dyau śānti maṃtrena	om bhīśvate lakṣmī kalaśam pūjayet om dyau śānti maṃtrena 
MBkulanandadiHK-401	śāṃtikalasaṃ pūjayet || oṃ punatvāditvā ṛcena yajamāna kalaśaṃ pūjayet ||	śāṃti kalasam pūjayet om ṛcena yajamāna kalaśam pūjayet 
MBkulanandadiHK-402	tatostu varddhanīmādāya bhrāmayitvā || bho bhoḥ śakrādayo devājalayāgaṃ	tatoḥ tu varddhanīm ādāya bhrāmayitvā bho bhoḥ śakra ādayaḥ 
MBkulanandadiHK-403	rakṣikāsya vadhyanābhavantute || tatopirāsanandatvā saha	rakṣikā asya saha 
MBkulanandadiHK-404	7b)	b 
MBkulanandadiHK-405	suśīriṣā puruṣamaṃtrena astravarddhanī prapūjayet || jñāna khaḍgaṃ	suśīriṣā puruṣamaṃtrena astravarddhanī prapūjayet jñāna khaḍgaṃ 
MBkulanandadiHK-406	prapūjayet || oṃ jalabhyo svaparistvaṃ hi mūrtirekhā tavācala |	prapūjayet om sva pariḥ tvam hi mūrti rekhā tava acala 
MBkulanandadiHK-407	eṣate jñāna khaḍgāni triṃśataḥ gṛhāna svamāyudham ||	eṣate jñāna khaḍgāni triṃśataḥ gṛhāna svam āyudham 
MBkulanandadiHK-408	viṣṇustvaṃ śakti rūpena jalamūrtidharāya ca |	viṣṇuḥ tvam śakti rūpena jala mūrti dharāya ca 
MBkulanandadiHK-409	keśavāya namastubhyaṃ bhaktyanugraha kāraṇe ||	keśavāya namaḥ tubhyam bhakti anugraha kāraṇe 
MBkulanandadiHK-410	yathedaṅkṛta yatnena bhagavaṃ jalamaṇḍapaṃ |	yathā idam kṛta yatnena 
MBkulanandadiHK-411	rakṣanīyaṃ yagaṃ nātha sarvādhvaravaratvayā ||	rakṣanīyam yagam nātha sarva adhvara vara tvayā 
MBkulanandadiHK-412	rakṣāvijñāpya ||	rakṣā vijñāpya 
MBkulanandadiHK-413	oṃ athetānaṣṭavirupānāṃ labhyate kṣetrapāla pūjayet ||	om labhyate kṣetrapāla pūjayet 
MBkulanandadiHK-414	pañca vārunena jalādhi pūjayet ||	pañca vārunena jalādhi pūjayet 
MBkulanandadiHK-415	tato oṃ namo'stu sarpyebhyo nāgakuṇḍaṃ prapūjayet ||	tatas om namaḥ astu sarpyebhyaḥ nāgakuṇḍam prapūjayet 
MBkulanandadiHK-416	tato gurukalasa sthāne gatvācca prasādyaḥ bho 2 bhagavana jalayāgaṃ kuruḥ	tatas guru kalasa sthāne gatvā ca prasādyaḥ bho bhagavana jala yāgam kuruḥ 
MBkulanandadiHK-417	ājñā prasādyaḥ ||	ājñā prasādyaḥ 
MBkulanandadiHK-418	tato jalayāgaṃ kṛtvā ||	tatas jalayāgam kṛtvā 
MBkulanandadiHK-419	8a)	a 
MBkulanandadiHK-420	parisamuhanāṃdi kuṇḍavat pariśodhayet |	kuṇḍa vat pariśodhayet 
MBkulanandadiHK-421	oṃ anaṃtāya paścimārekhā ||	om anantāya paścimā rekhā 
MBkulanandadiHK-422	oṃ padmāya dakṣina rekhā || oṃ mahāpadma tathottare || varunarekhāstu	om padmāya rekhā om mahāpadma tathā uttare 
MBkulanandadiHK-423	madhyeme || āvāhanādi pādyā camanandatvā || tato varuna āvāhayet ||	madhyeme āvāhana ādi pādyā camanan datvā tatas varunaḥ āvāhayet 
MBkulanandadiHK-424	ātmanasthaṃ nāḍī trayandāvāyet ||	ātmanastham nāḍī 
MBkulanandadiHK-425	iḍāpiṅgalāsuṣumnā ceti ||	iḍā piṅgalā suṣumnā ca iti 
MBkulanandadiHK-426	gaṃgāyamunāsarasvatī ekīkṛtya || imaṃ me varuṇamaṃtrena jalañca	gaṃgā yamunā sarasvatī ekīkṛtya imam me varuṇa maṃtrena jalam ca 
MBkulanandadiHK-427	sthāpayet ||	sthāpayet 
MBkulanandadiHK-428	oṃ varuṇaso stambhanamiti pūjanaṃ ||	om stambhanam iti pūjanam 
MBkulanandadiHK-429	pūrvādi akṣavāṭanandanvā || oṃ apāśyāgneriti pūrva akṣavāṭanaṃ || oṃ	om apāśya agneḥ iti pūrva akṣavāṭanaṃ oṃ 
MBkulanandadiHK-430	imaṃ devāriti dakṣina akṣavāṭanaṃ ||	imam deva ariti akṣavāṭanam 
MBkulanandadiHK-431	8b)	b 
MBkulanandadiHK-432	āpā adyāṃnvacāniṣaṃmiti paścama ākṣavāṭanaṃ || saṃno devīriti uttara	āpaḥ sam naḥ devīḥ iti uttara 
MBkulanandadiHK-433	akṣavāṭanaṃ || bhavataṃ nariti samidhahoma || āpomauṣadhīriti nāgāsaṃmukhī	akṣavāṭanam bhavatam naḥ iti samidha homaḥ āpaḥ umā oṣadhīḥ iti nāgā saṃmukhī 
MBkulanandadiHK-434	karaṇaṃ || brahmāsana praṇītāsanaṃ || ātmāsanaṃ || hiranyagarbhariti	karaṇam brahmāsana praṇītā āsanam ātma āsanam 
MBkulanandadiHK-435	brahmāsanaṃ datvā || pratyuṣṭhaguṃ rakṣamiti praṇītapratarpyanaṃ	brahmāsanam da tvā pratyuṣṭhagum rakṣam iti praṇīta pratarpyanam 
MBkulanandadiHK-436	praṇītapūrayitvā āpo hiṣṭati || idaṃ viṣṇuriti pūjanaṃ || brahmapaktyānaṃriti	praṇīta pūrayitvā āpaḥ hiṣṭati idam viṣṇuḥ iti pūjanam 
MBkulanandadiHK-437	brahmasthāpanaṃ || viṣṇurarāṭamaśi praṇīta sthāpanaṃ || trinipadāvicakrame	brahma sthāpanam sthāpanam 
MBkulanandadiHK-438	praṇītapūjanaṃ || brahmāpranītapūjanaṃ ||	praṇīta pūjanam brahma a pranīta pūjanam 
MBkulanandadiHK-439	9a)	a 
MBkulanandadiHK-440	āvāhanādi pādyācamanaṃ datvā || kāriṣiraśiriti paristaraṇam || yathā yathā	āvāhana ādi pādya ācamanam da tvā paristaraṇam yathā yathā 
MBkulanandadiHK-441	mūrtirtena aṣṭakalasā sthāpayet || triyambakamiti īśvarañca prapūjayet ||	mūrtiḥ tena aṣṭa kalasā sthāpayet triyambakam iti īśvaram ca prapūjayet 
MBkulanandadiHK-442	athāśvāgneriti anantañca prapūjayet || oṃ nadībhyaḥ pūjiṣṭamiti |ṛcena	atha āśvāgneḥ iti anantam ca prapūjayet om nadībhyaḥ pūjiṣṭam iti ṛcena 
MBkulanandadiHK-443	prapūjayet || dau dau kumbhāprapūjayet || oṃ hrīṃ jāhnavyai nama || oṃ	prapūjayet om hrīṃ jāhnavyai nama om 
MBkulanandadiHK-444	yamunāya namaḥ || pūrve ||	yamunāya namaḥ pūrve 
MBkulanandadiHK-445	oṃ hrīṃ godāvarī namaḥ || oṃ hrīṃ narmadāyai namaḥ || dakṣiṇe ||	om   godāvarī namaḥ om   narmadāyai namaḥ dakṣiṇe 
MBkulanandadiHK-446	oṃ hrīṃ siṃdhuve namaḥ || oṃ hrīṃ saraśvatyai nama || paścime ||	om   siṃdhuve namaḥ om   saraśvatyai nama paścime 
MBkulanandadiHK-447	oṃ hrīṃ gaṇḍakī namaḥ || oṃ hrīṃ kausikī nama || uttare ||	om   gaṇḍakī namaḥ om   kausikī namaḥ uttare 
MBkulanandadiHK-448	9b)	b 
MBkulanandadiHK-449	tato vedakalasaṃ prapūjayet || oṃ trātrāramindra maṃtrena indraṃ ca pūjayet ||	tatas vedakalasam prapūjayet om trātrāram indra maṃtrena indram ca pūjayet 
MBkulanandadiHK-450	yamaṃśusanapanthena ṛcāya maṃtrena prapūjayet ||	ṛcāya maṃtrena prapūjayet 
MBkulanandadiHK-451	oṃ tatvāyyamiriti ṛcājalādhṛsthaṃ prapūjayet || oṃvayaśuṃ soma	om soma 
MBkulanandadiHK-452	ṛcādhanādhyakṣaprapūjayet || oṃ tvaṃ no agniṃ hutāsanaṃ pūjayet || oṃ	om tvam naḥ agnim hutāsanam pūjayet om 
MBkulanandadiHK-453	aśundhanti ṛcanairitye || oṃ vātovāriti ṛcānerityañca prapūjayet ||	om prapūjayet 
MBkulanandadiHK-454	oṃ tamīśānaṃ ṛcasikarapūjayet | yasminnindroṣṭhato brahmā || sonī	om tam īśānam yasmin indra uṣṭhataḥ brahmā sonī 
MBkulanandadiHK-455	pṛthvimāhariṃ pūjayet || namo ganebhyo gaṇapati pūjayet || samudrajeṣṭa ṛca	pūjayet namaḥ gaṇapati pūjayet 
MBkulanandadiHK-456	catusamudraṃ pūjayet || varuṇasvotambhanaṃriti vāśukiṃ pūjayet ||	catu samudram pūjayet 
MBkulanandadiHK-457	10a)	Ro
MBkulanandadiHK-458	satvaṃ no agneriti somaṃ ca prapūjayet || tatvāyāmiriti takṣakañca prapūjayet ||	satvam naḥ agneḥ iti somam ca prapūjayet tatvā ayāmiḥ iti takṣakam ca prapūjayet 
MBkulanandadiHK-459	apo adyāṃ?nvacāriti *? gāraṃ prapūjayet || kāriṣirasikarkoṭakaṃ	apaḥ adya anvacāriti gāram prapūjayet 
MBkulanandadiHK-460	pūjayet || varuṇasostambhaṇaṃribudhañca pūjayet || * *? devīriti	pūjayet         iti 
MBkulanandadiHK-461	padmaṃ caiva prapūjayet || āpohiṣṭāriti bṛhaspati pūjayet || devīrāpo	padmam ca eva prapūjayet āpohiṣṭār iti bṛhaspati pūjayet 
MBkulanandadiHK-462	apāṃnyapāśuṃ mahāpadmaṃ pūjayet || ambhaṃtara(?)	apāṃnyapāśum mahāpadmam pūjayet ambhaṃtara 
MBkulanandadiHK-463	śukrapūjayet || ye te varuṇaṃ saṃkhapāla pūjayet ||	ye te varuṇam pūjayet 
MBkulanandadiHK-464	āpodevāmadhumatīśanīścara pūjayet || uduhamavarunapāsakulikaṃraprapūjayet	pūjayet 
MBkulanandadiHK-465	|| ye te śatataṃ varuṇaṃ rāhoratra pūjanaṃ || bhavataṃ na samanasau varumāya	ye te śatatam varuṇam rāhoḥ atra pūjanam bhavatam na samanasau varumāya 
MBkulanandadiHK-466	namaḥ || namostu sarpebhyaḥ keto pūjayet || madhya ca varuṇaṃ imaṃ me varuna	namaḥ namaḥ astu sarpebhyaḥ pūjayet ca varuṇam imam me 
MBkulanandadiHK-467	pūjayet ||	pūjayet 
MBkulanandadiHK-468	10b)	Ro
MBkulanandadiHK-469	āvāhana sthāpanā pādyācamanaṃ datvā || tato pātrāśādhanādikaṃ kṛtvā ||	āvāhana sthāpanā pādya ācamanam pātra āśā dhana ādikam kṛtvā 
MBkulanandadiHK-470	pavitra cchedanādidārya saṃskāraṃ kṛtvā mana pūjāpataye ||	saṃskāram kṛtvā 
MBkulanandadiHK-471	aṣṭādaśasamidhahomaḥ upayamanenatibhimārjanaṃ || brahmādi devārcanaṃ	aṣṭādaśa samidha homaḥ brahma ādi deva arcanam 
MBkulanandadiHK-472	lokapālārcanaṃ || pūnītārgha brahmārgha datvā || bhū svāhāḥ bhuva svāhā ||	lokapāla arcanam bhū svāhāḥ bhuva svāhā 
MBkulanandadiHK-473	imaṃ me varuna || tatvājāmi brahmanā || ye te sataṃ varunaṃ apāścāgne ||	imam me varuna tatvā ajāmi brahmanā ye te satam varunam apāścā agne 
MBkulanandadiHK-474	udutamaṃ varuna || bhavatanna samanasaṃ || apsveṃtaratvaṃ no agnaye || satvaṃ	udutamam varuna bhavatan na samanasam apsvā iṃtaratvam naḥ agnaye satvam 
MBkulanandadiHK-475	no agnaye || uru guṃhirājo || garbhādāna puṃśravana | śīmata || jātakrama ||	naḥ agnaye uru garbhādāna puṃśravana śīmata jātakrama 
MBkulanandadiHK-476	nāmakarana ||	nāmakarana 
MBkulanandadiHK-477	11a)	Ro
MBkulanandadiHK-478	hala prāsana || anaprāsana || cuḍākarana || karṇyabheda || vratavaṃdha ||	hala prāsana anaprāsana cuḍākarana karṇyabheda vratavaṃdha 
MBkulanandadiHK-479	samāvartena || patanī saṃyoga || pratiṣṭhā || homayet mūlena pūrṇā ||	samāvartena patanī saṃyoga pratiṣṭhā homayet mūlena pūrṇā 
MBkulanandadiHK-480	paścātaseta tilena āhuti ||	tilena āhuti 
MBkulanandadiHK-481	11b)	Ro
MBkulanandadiHK-482	halapratiṣṭhā || samayavidyāḥ ||	         
MBkulanandadiHK-483	(whole page blank)	hole page blank 
MBkulanandadiHK-484	12a)	Ro
MBkulanandadiHK-485	hrīṃ śrīṃ ete? hi devī putravaṭukanāthakapilajaṭābhārabhāsura	hrīṃ śrīṃ ete hi devī putra vaṭuka nātha kapila jaṭā bhāra bhāsura 
MBkulanandadiHK-486	trinetrajvālāmukhagaṃdhapuṣpapisitavaliṃ gṛhna gṛhna sarvavighnā nāsaya	trinetra jvālāmukha gaṃdha puṣpa pisita valim gṛhna gṛhna sarva vighnāḥ nāsaya 
MBkulanandadiHK-487	nāsaya hu& phaṭ svāhā ||	nāsaya hu phaṭ svāhā 
MBkulanandadiHK-488	vaṭukavali ||	vaṭukavali 
MBkulanandadiHK-489	hrī& śrīṃ ūrddhabrahmāṇḍatovādivigamadvyatale bhūtale niṣkale vā pātāle	                                                             
MBkulanandadiHK-490	vā nale vā śalilapavanayo yatra kutrasito vā kṣetre pīṭhopapīṭho	vā nale vā śalila pavanayaḥ yatra vā kṣetre 
MBkulanandadiHK-491	dikṣuvakṛtapadādhūpadīpādikena prītā devyā sadā na guru vali vidhinā pātu	prītā devyā sadā na guru vali vidhinā pātu 
MBkulanandadiHK-492	vīrendra vaṃdyā sarvasiddhi yogibhyo sarvabhūtebhyo valiṃ gṛhna gṛhna	vīra indra yogibhyaḥ sarva bhūtebhyaḥ valim gṛhna gṛhna 
MBkulanandadiHK-493	hūṃ phaṭ svāhā ||	hūm phaṭ svāhā 
MBkulanandadiHK-494	yoginīvali ||	yoginīvali 
MBkulanandadiHK-495	hrī& śrīṃ kṣā& kṣīṃ kṣū& kṣai& kṣau& kṣaḥ svasthāna * *	hrī śrīṃ kṣā kṣīṃ kṣū kṣai kṣau kṣaḥ sva sthāna 
MBkulanandadiHK-496	hūṃ phaṭ svāhā ||	hūm phaṭ svāhā 
MBkulanandadiHK-497	hrīiṃ śrīṃ gāṃ gīṃ gūṃ geṃ goṃ gaḥ gaṇapataye	hrīiṃ śrīṃ gām gīṃ gūṃ geṃ goṃ gaḥ gaṇapataye 
MBkulanandadiHK-498	varavaradusarvajanamevasamānaya sarvavighnāṃ nāsaya sarvāpacyarasahitaṃ	sarva vighnām sarva apacī ara sahitam 
MBkulanandadiHK-499	valiṃ gṛhna gṛhna svāhā ||	valim gṛhna gṛhna svāhā 
MBkulanandadiHK-500	12b)	Ro
MBkulanandadiHK-501	gaṇapati vali || evaṃ ca validāna pūrvokta sthāneṣu aṃguṣṭha anāmikayā	gaṇapati vali evam ca validāna pūrvokta sthāneṣu aṃguṣṭha anāmikayā 
MBkulanandadiHK-502	vaṭukavali || tarjanī madhyamā anāmikā yoginī vali || tarjanyā kṣetrapāla vali ||	vaṭuka vali tarjanī madhyamā anāmikā yoginī vali tarjanyā kṣetrapāla vali 
MBkulanandadiHK-503	madhyamā gaṇapati vali || vaṭukanātha dhyānaṃ śrī siddhanātha pādairuktaṃ ||	madhyamā gaṇapati vali vaṭuka nātha dhyānam śrī siddha nātha pādaiḥ uktam 
MBkulanandadiHK-504	karakalitakapālaḥ kuṇḍalī daṇḍapānistaruṇatimira nīlaṃ vyālapadmāpavītī |	kara kalita kapālaḥ kuṇḍalī nīlam vyāla padma apavītī 
MBkulanandadiHK-505	kumasamayasaparyavighnavidhvaṃsaḥhetu japati vaṭukanāthasiddhidaḥ	japati vaṭuka nātha siddhi daḥ 
MBkulanandadiHK-506	sākānāṃ || yoginyaḥ kāmarūpāḥ pāśāṃkuśa yonimadhakapālaṃ	yoginyaḥ kāmarūpāḥ 
MBkulanandadiHK-507	gaṇanāthasya devyā devāśdheyaṇaṃ(?) devaliṃgadhātvaṃ ca ||	gaṇanāthasya devyāḥ ca 
MBkulanandadiHK-508	ubhau raktavarṇau kṣetrapālasya śūlaḍamarukapāla *? nagnaśca	ubhau rakta varṇau kṣetrapālasya nagnaḥ ca 
MBkulanandadiHK-509	tasthiśuḥ | paṃca navavāśalīgodhumādi piṣṭamamitā | sarkarāghṛtapācitā |	tasthiśuḥ paṃca nava vāśalī godhuma ādi sarkarā ghṛta pācitā 
MBkulanandadiHK-510	sa raktavartikāsugaṃdhi ghṛta *? tīḥ *? lasthāṃ dīpaṃ ca |	dīpam ca 
MBkulanandadiHK-511	13a)	Ro
MBkulanandadiHK-512	catuśramaṇḍalaṃ nirmāya tatra pratisthāpya | bhuvaneśvaryā prakṣālya	nirmāya tatra pratisthāpya bhuvaneśvaryā prakṣālya 
MBkulanandadiHK-513	guhyamālinyāsamīrādhya | raktasvarṇādi nikṣipya | jānubhyāmavanīṃ gatvā	rakta svarṇa ādi nikṣipya jānubhyām avanīm gatvā 
MBkulanandadiHK-514	karālyāmudhyabhya? samayāṃ ślokadvayaṃ paṭhana trivāraṃ	śloka dvayam tri vāram 
MBkulanandadiHK-515	paribhrāmayet | yathā |	paribhrāmayet yathā 
MBkulanandadiHK-516	aṃtatejo vahi tejo ekīkṛtvā nalatrayaṃ |	anta tejaḥ ekīkṛtvā nala trayam 
MBkulanandadiHK-517	tridhā devyā paribhramya kuladīpaṃ nivedayet ||	tridhā devyā paribhramya kuladīpam nivedayet 
MBkulanandadiHK-518	samasta cakra cakresi yute devi navātmike |	samasta cakra cakrā isi yute devi nava ātmike 
MBkulanandadiHK-519	ārātrikamidaṃ devi gṛhānamanasiddhaye ||	ārātrikam idam devi gṛha ānamana siddhaye 
MBkulanandadiHK-520	tato maṇḍala pratiṣṭhāpya |	tatas pratiṣṭhāpya 
MBkulanandadiHK-521	mūlavidyā yathāśakti śahaśrādi saṃkhyayā japaṃ vidhāya |	mūlavidyā yathāśakti śahaśra ādi saṃkhyayā japam vidhāya 
MBkulanandadiHK-522	taṃ ca japamarghodakena |	tam ca japam argha udakena 
MBkulanandadiHK-523	guhyāti guhya goptāstvaṃ gṛhānāsmatkṛtaṃ japaṃ |	guhya ati guhya goptā tvam gṛhāna asmad kṛtam japam 
MBkulanandadiHK-524	siddhirbhavatu meyeste samarpyataṃ ca japaṃ tejorūpaṃ parameśvaryādi	siddhiḥ bhavatu ca japam tejaḥ rūpam parameśvarī ādi 
MBkulanandadiHK-525	gṛhītaṃ paribhāvayet |	gṛhītam paribhāvayet 
MBkulanandadiHK-526	13b)	Ro
MBkulanandadiHK-527	tato naivedyaṃ vigṛhya hastaprakṣālanaṃ | gaṃdhodakaiḥ parikalpya	tatas naivedyam vigṛhya hasta prakṣālanam gaṃdha udakaiḥ parikalpya 
MBkulanandadiHK-528	mūlamantrena tāṃ colaṃ nivedya darpanaṃ pradarśya | cāmaraṃ ca datvā	mūlamantrena tām colam nivedya darpanam pradarśya cāmaram ca da tvā 
MBkulanandadiHK-529	punaśugaṃdhādibhirurparyca(?) mudrā daśakaṃ pradarśayet |	mudrāḥ daśakam pradarśayet 
MBkulanandadiHK-530	kiṃ kimādināstratvā culukodake nātmānaṃ saparachadaṃ parameśvaryai	culuka udake na ātmānam sa paracchadam parameśvaryai 
MBkulanandadiHK-531	parikalpya | punaḥ punaḥ pranipātena śrīnāthamātmānaṃ paribhāvayet |	parikalpya punar punar pranipātena śrīnātham ātmānam paribhāvayet 
MBkulanandadiHK-532	kṣamāparapūrvakaṃ jānubhyāmavanī gata | mahācakraṃ	kṣamā para pūrvakam jānubhyām avanī gata mahā cakram 
MBkulanandadiHK-533	rahasyavaddrśanātmakaṃ paribhāvet | mūlavidyayā tatra sthāneṣu samarcayet |	rahasya vat drūana ātmakam paribhāvet mūlavidyayā tatra sthāneṣu samarcayet 
MBkulanandadiHK-534	yathā |	yathā 
MBkulanandadiHK-535	vedāśrīti triguṇāṣṭaraṃsra pravibhedataḥ |	triguṇa aṣṭa raṃsra pravibhedataḥ 
MBkulanandadiHK-536	pūrvāmnāya kramaṃ ārcā arcayet samayāṃ nijāṃ | śakti pūrvayā hsrī&?	pūrvāmnāya kramaṃ ārcā arcayet samayām nijām śakti pūrvayā 
MBkulanandadiHK-537	hsrau&? suvī vāmathāsayuṃ malaṃ cakraṃ *?tpādi pravibhedataḥ	malam cakram pravibhedataḥ 
MBkulanandadiHK-538	dakṣiṇa samayaṃ jñātvā rudrārṇaṃ samayaṃ yajet |	dakṣiṇa samayam jñātvā rudra arṇam samayam yajet 
MBkulanandadiHK-539	14a)	Ro
MBkulanandadiHK-540	ai& kliṃ e kli& madadrave kule  hsarau& rṇṇaṃ dakṣiṇa samaye vasurāma a	ai kliṃ e kli madadrave kule dakṣiṇa samaye 
MBkulanandadiHK-541	amadhyaṃ tu saṃghārādi prabhedata ||	amadhyam tu saṃghāra ādi prabhedata 
MBkulanandadiHK-542	paścimaṃ samayaṃ jñātvā dvātriṃśārṇa yajet kramāt ||	paścimam samayam jñātvā dvātriṃśa arṇa yajet kramāt 
MBkulanandadiHK-543	hsai& hsrīṃ hsrī& hsrphreṃ hskhphre& bhagavati aṃve hskṣmlvryī&	hsai hsrīṃ hsrī hsrphreṃ hskhphre bhagavati aṃve hskṣmlvryī 
MBkulanandadiHK-544	śkṣmlvryī& kubjike hskhphre&? hskhphrī& hskhphru& ghore aghore	kubjike hskhphre hskhphrī hskhphru ghore aghore 
MBkulanandadiHK-545	aghorāmukhi cchāṃ cchīṃ kiṇi kiṇi vicce hrīṃ hskhphre& hsrī& hsphrī&	aghorā mukhi cchāṃ cchīṃ kiṇi kiṇi vicce          
MBkulanandadiHK-546	hsrī& eṣā paścimeśvarī || dvātriṃśākṣarī samayavidyā ||	eṣā paścimeśvarī dvātriṃśa akṣarī samayavidyā 
MBkulanandadiHK-547	sama * kṣanākṣavakraṃ jñātvā tathottaraṃ | tānyeva varṇasamayāṃsā	jñātvā tathā uttaram tāni eva 
MBkulanandadiHK-548	sayajet saptadaśākalāṃ | khphreṃ mahācaṇḍayogeśvari | eṣā navākṣarī	sa yajet saptadaśā kalām khphreṃ mahācaṇḍa yogeśvari eṣā nava akṣarī 
MBkulanandadiHK-549	uttarasamayavidyā || ma ekhapharamahā ca na ḍaya eṣa savari | saptādaśakalā ||	uttara samaya vidyā me ca na ḍayaḥ eṣa savari saptādaśa kalā 
MBkulanandadiHK-550	kālagrāsaṃkari | mahārayāgaprākṛtaraśadarśanātmaka paribhāvya tataḥ	paribhāvya tatas 
MBkulanandadiHK-551	samayamaṃtrerabhyarcya |	samaya maṃtreḥ abhyarcya 
MBkulanandadiHK-552	14b)	Ro
MBkulanandadiHK-553	yathā |	yathā 
MBkulanandadiHK-554	vedāśramabauddhabhedaṃ tu cārghākya vikṛti yutaṃ |	veda āśrama bauddha bhedam tu 
MBkulanandadiHK-555	jñātvā saṃpūjayet tadvadvajra adimabhrastaiḥ(?) ||	jñātvā saṃpūjayet 
MBkulanandadiHK-556	oṃ tore tutāre ture svāhā | iti bauddhasamaye tārāmaṃtra || dviraṣṭāraṃ	om tore tutāre ture svāhā iti bauddha samaye tārā maṃtra 
MBkulanandadiHK-557	vedikadarśanaṃ | jñātvā vedādi nārcayet | aṣṭadalamabhyantarāṣṭāraṃ ca	                                  
MBkulanandadiHK-558	vaiṣṇavaṃ jñātvā || oṃ namo nārāyanāya oṃ ityaṣṭākṣaraṃ nārcayet ||	vaiṣṇavam jñātvā om namaḥ nārāyanāya om iti aṣṭa akṣaram na arcayet 
MBkulanandadiHK-559	madhya triśṛṅgāṭaśāktadarśanaṃ jñātvā vāgbhavena pūjayet |	               
MBkulanandadiHK-560	tataḥ kāmeśvaryādi devīnāṃ tatra samaya vidyayā sakṛt sakṛt	tatas kāmeśvarī ādi devīnām tatra samaya vidyayā sakṛt sakṛt 
MBkulanandadiHK-561	puṣpāṃjaliṃ datvā madhya? sthāna devī tataḥ samaya vidyayā samaya	puṣpa aṃjalim da tvā madhya sthāna devī tatas samaya vidyayā samaya 
MBkulanandadiHK-562	puṣpaṃ datvā | tatra kāmeśvarī cakreśvarī bhagamālinyau samayavidye | pūrvo	puṣpam da tvā tatra kāmeśvarī cakreśvarī bhagamālinyau samayavidye 
MBkulanandadiHK-563	dhṛte aiṃ hrīṃ śrīṃ * *? trayāṃ rāṃ lāṃ vāṃ sāṃ	dhṛte aim   śrīṃ trayāṃ rāṃ lāṃ vāṃ sāṃ 
MBkulanandadiHK-564	icchākāmaphalaprade sarvasatvavaśīkaranijaśat	icchā kāma phala prade sarva satva vaśīkara nija śat 
MBkulanandadiHK-565	15a)	Ro
MBkulanandadiHK-566	kṣobhakari hū& 3 ai& drā& drī& klī& vlū& saḥ ai tripurākāmeśvaryai	kṣobhakari hū ai drā drī klī vlū saḥ ai tripurā kāmeśvaryai 
MBkulanandadiHK-567	namaḥ ||	namaḥ 
MBkulanandadiHK-568	kāmeśvarī samayavidyā ||	        
MBkulanandadiHK-569	ai& hrī& śrī& sarvakāryasādhani vajreśvari vajrapaṃjaramadhyagate hrī&	ai hrī śrī sarva kārya sādhani vajreśvari vajra paṃjara madhya gate hrī 
MBkulanandadiHK-570	kliṃne aiṃ kro& nityamadadrave hrīṃ vajrānatyāyai namaḥ ||	aim   nitya mada drave   vajra anatyāyai namaḥ 
MBkulanandadiHK-571	iti vajreśvarī samayavidyā ||	iti vajreśvarī samayavidyā 
MBkulanandadiHK-572	ai& hrīṃ śrīṃ ai& bhagabhugebhagini bhagodari bhagamāle bhagavāhe bhaga	ai hrīṃ śrīṃ ai bhaga bhuge bhagini bhaga udari bhaga māle bhaga vāhe bhaga 
MBkulanandadiHK-573	guhya bhagayoni bhaganipātani sarva bhagavaśaṃkari bhagarūpe nitya kliṃne	guhya bhaga yoni bhaga nipātani sarva bhaga vaśaṃkari bhaga rūpe nitya kliṃne 
MBkulanandadiHK-574	bhagasvarūpe sarvabhagāni ye *? naya varade retaśurate bhagakline kliṃ	bhaga svarūpe sarva bhagāni ye naya vara de retaḥ śurate bhaga kline kliṃ 
MBkulanandadiHK-575	na drave kledaya drāvaya amoghe bhagavicce kṣubhakṣobhaya sarvasatvāṃ	na drave kledaya drāvaya amoghe bhaga vicce kṣubha kṣobhaya sarva satvān 
MBkulanandadiHK-576	bhageśvari ai& vluṃ jaṃ vlū& bheṃ vlū& moṃ vlū& he& vlū& aiṃ kliṃne	bhageśvari ai vlum jaṃ vlū bheṃ vlū moṃ vlū he vlū aim kliṃne 
MBkulanandadiHK-577	sarvāni bhagāni	sarvāni bhagāni 
MBkulanandadiHK-578	15b)	Ro
MBkulanandadiHK-579	bhāvagamānaya strī& hara vlu& hrī& bhagamālinyai namaḥ ||	bhāva gama ānaya strī hara hrī bhagamālinyai namaḥ 
MBkulanandadiHK-580	bhagamālinī samayavidyā ||	        
MBkulanandadiHK-581	cchrī bhagavati *? nityākāmeśvari strī sarvasatvavaśaṃkari saḥ tripura	                                        
MBkulanandadiHK-582	bhairavi ai& vicce hrī& mahātripuraśuṃdaryai namaḥ ||	bhairavi ai vicce hrī mahā tripura śuṃdaryai namaḥ 
MBkulanandadiHK-583	mūla(?) devī samaya vidyā ||	mūla devī samaya vidyā 
MBkulanandadiHK-584	tataḥ pradakṣina namaskāraiḥ parameśvarau paritoṣya | parāṅmukhārghena	tatas namaskāraiḥ parameśvarau paritoṣya parāṅmukha arghena 
MBkulanandadiHK-585	parivāra devatā gaṇa derpuṃśamaṃ(?) yojya | devī ca	parivāra devatā gaṇa derpuṃśamam yojya devī ca 
MBkulanandadiHK-586	maṇḍalastha kuśuse nādāya saṃhāramudrayā mahāpadma vanyantastha	nādāya saṃhāra mudrayā 
MBkulanandadiHK-587	śṛṅgāṭodaraṃ pītvā(?) vāhyābhyantaraṃ bhedenaṃ	śṛṅgāṭa udaram pītvā vāhya abhyantaram 
MBkulanandadiHK-588	kāmakalādhyānaṃ binṃdusaṃkalpya | ādiśutroktaṃ | yathā |	kāmakalā dhyānam binṃdu saṃkalpya ādi śutra uktam yathā 
MBkulanandadiHK-589	khecarīmudrā varddhena sahayāvaṃ manolayaṃ |	          
MBkulanandadiHK-590	tāva *? la śṛṅgāṭe unmanī bhūya tiṣṭhet || taduktaṃ	tiṣṭhet tat uktam 
MBkulanandadiHK-591	śukramastotre | bidaṃkuraṃ kāmakalāśca rūpaṃ viṃdo va ciṃtyāmita tejase	śukram astotre bidaṃkuram kāma kalāḥ ca rūpam tejase 
MBkulanandadiHK-592	dvaṃ | anāhatau nena ninādavṛtrīṃ(?) cakrasthitaṃ	anāhatau nena cakra sthitam 
MBkulanandadiHK-593	janmavilāṃtarāle ||	      
MBkulanandadiHK-594	16a)	Ro
MBkulanandadiHK-595	tasyādhārasthaṃ śaśisūryarūpaṃ viṃdudvayaṃ pārśvayugapravāhaṃ |	tasya ādhāra stham śaśi sūrya rūpam viṃdu dvayam pārśva yuga pravāham 
MBkulanandadiHK-596	tasyāpyadho vahniśikhāgra bhāgaṃ reṣākṛtiṃ pravilāpya samyak ||	tasya api adhas vahni śikhā agra bhāgam reṣa ākṛtim pravilāpya samyak 
MBkulanandadiHK-597	tato mūlavidyāṃ bījatritayaistatvatrayāṃte svāhāṃtaiḥ prasādaṃ svīkṛtya ||	tatas mūlavidyām bīja tritayaiḥ tatva traya aṃte svāhā aṃtaiḥ prasādam svīkṛtya 
MBkulanandadiHK-598	kumārī vaṭukabhyāmarccayet | hrīṃ kumārī mantra | aiṃ hrī& ai& vaṭuka	kumārī vaṭukabhyām arccayet hrīṃ kumārī mantra aim hrī ai vaṭuka 
MBkulanandadiHK-599	mantra || trikoṇavṛtta caturaśramaṇḍalaṃ kumārī vaṭukayo purustādvidhāya |	trikoṇa vṛtta caturaśra maṇḍalam 
MBkulanandadiHK-600	ṣaḍasvara bheditaṃ hrīṃkāreṇa maṇḍalaṃ saṃpūjya || svādhāraṃ	ṣaḍasvara bheditam hrīṃkāreṇa maṇḍalam saṃpūjya svādhāram 
MBkulanandadiHK-601	svaśvamantraṃ vinyasya viśeṣārghasthaviṃduṃ nikṣipya |	su aśvamantram vinyasya viśeṣa argha stha viṃdum nikṣipya 
MBkulanandadiHK-602	śuvarṇavastrasugaṃdhapuṣpatāṃvolādyairbhakṣabhaktyā coṣya	śuvarṇa vastra su gaṃdha puṣpa tāṃvola ādyaiḥ bhakṣa bhaktyā coṣya 
MBkulanandadiHK-603	carcanādyairmadhumāśa bhedaiśca siddhāṃ nādimbhaśca sadīpaistāṃ	carcana ādyaiḥ madhumāśa bhedaiḥ ca siddhām nādimbhaḥ ca sa dīpaiḥ tām 
MBkulanandadiHK-604	arghayitvā pādavaṃdanaṃ vidhāya tripātraṃ kārayitvā || cakra devatā	arghayitvā pāda vaṃdanam vidhāya tri pātram kārayitvā 
MBkulanandadiHK-605	saṃkhyayā catuḥṣaṣṭhisaṃkhyeyā vā | dvātriṃśadviraṣāṣu?	saṃkhyayā catuḥṣaṣṭhi saṃkhyeyāḥ vā 
MBkulanandadiHK-606	catusaṃkhaparyaṃtaṃ |	catur saṃkha paryaṃtam 
MBkulanandadiHK-607	16b)	Ro
MBkulanandadiHK-608	yathāśaktyāpādaprakṣvā?lanādyarghya pratiṣṭhā purasaraṃ |	yathāśakti āpāda prakṣvālana ādi arghya pratiṣṭhā purasaram 
MBkulanandadiHK-609	vitasāṭhyavināyoginī cakraṃ nitya pūjāṃ tatvehamarcayitvā tripātraṃ	cakram pūjām tatvā iham arcayitvā tri pātram 
MBkulanandadiHK-610	kārayitvā | parameśvari bhaktyā abhiprārthya | tadanuj~ nāto mūlavidyā	kārayitvā parameśvari bhaktyā abhiprārthya tad anuj na atas mūlavidyā 
MBkulanandadiHK-611	bījatrayaṃ turīyabījaṃ tapastinva catuṣṭayāṃte svāhā | *? guru	bīja trayam turīya bījam tapaḥ tinva catuṣṭaya ante svāhā guru 
MBkulanandadiHK-612	dhyānapurasāraṃ śaktimuthāpyasamaraśa bhāvaṃ nitya | tatsiṣāyāṃ	dhyāna pura sāram bhāvam 
MBkulanandadiHK-613	pātracatuṣṭayaṃ hutvā || śrī cakrājñā purasmara valivahirvirājya(##?	pātra catuṣṭayam hutvā śrī cakra ājñā purasmara vali vahiḥ virājya 
MBkulanandadiHK-614	samaya pātramavasoṣyā? naivedyādikaṃ sarvaṃ svayaṃ prasādī kṛtvā	pātram avasoṣya naivedya ādikam sarvam svayam prasādī kṛtvā 
MBkulanandadiHK-615	vasiṣṭaṃ sāmayīṃkānāṃ datvā tatta prasāda	vasiṣṭam sāmayīṃkānām da tvā tatta prasāda 
MBkulanandadiHK-616	17a)	Ro
MBkulanandadiHK-617	pūjā yathāvat tadyogināṃ likṣate | sā yathā || svakīyālakasthāne na kriyā jāpau	pūjā yathāvat tat yoginām sā yathā svakīya alaka sthāne na kriyā jāpau 
MBkulanandadiHK-618	gaṇeśavaṭukau || svasvamaṃtrāryāṃ pratibhārūpajāpau saṃpūjyā ||	gaṇeśa vaṭukau sva sva maṃtra āryām pratibhā rūpa jāpau saṃpūjyā 
MBkulanandadiHK-619	svakīyamūlādhārādho kulakṣetrapālaviśvadhārau pratibhājapaṃ smṛtvā |	svakīya mūlādhāra adhas kula kṣetrapāla viśvadhārau pratibhājapam smṛtvā 
MBkulanandadiHK-620	dvādaśāṃte bhedābheda mahāmoha nivartasākṣinīṃ parakalāmanavasthaṃ tau	dvādaśānte bheda abheda mahā moha nivarta sākṣinīm para kalām anavastham tau 
MBkulanandadiHK-621	dvātriṃsārṇarūpāṃ smṛtvā | samastaprakaṭaśuptatara ityādi	dvātriṃsa arṇa rūpām smṛtvā samasta prakaṭa śuptataraḥ ityādi 
MBkulanandadiHK-622	pūrvasūcitamantrena mastakādi guhyāṃtaṃ catuṣaṣṭidabhiṃna yoginī samayaṃ	pūrva sūcita mantrena mastaka ādi guhya aṃtam yoginī samayam 
MBkulanandadiHK-623	paribhāvya | svakīya vāmabhāge caturaśraṣoḍaśadalau tarāle corarūpādi	paribhāvya svakīya vāma bhāge caturaśra ṣoḍaśa dalau tarāle cora rūpa ādi 
MBkulanandadiHK-624	īśānāntaṃ citprāṇavisayātmakaṃ gurukramaṃ gunāvaliṃ smṛtvā |	īśāna antam cit prāṇa visaya ātmakam guru kramam smṛtvā 
MBkulanandadiHK-625	śirālalāṭa bhrumadhya laṃvikā kaṃthahṛdayanābhimeḍhrādhāreṣu	śirā lalāṭa bhru madhya laṃvikā kaṃtha hṛdaya nābhi meḍhra ādhāreṣu 
MBkulanandadiHK-626	17b)	Ro
MBkulanandadiHK-627	ṣaḍāsanaṃ ṣaṣṭharūpaṃ vinyasya | kulaśṛṃgāṭagatamanacakaṃ kalmaṃ	ṣaṣ āsanam ṣaṣṭha rūpam vinyasya 
MBkulanandadiHK-628	kurānabja? kalāṃ kulāyāṃ tribhaṃgamudrāta trikhaṃḍāyātvā vāhana	kalām kulāyām tri bhaṃga mudrāta tri khaṃḍa āyātvā 
MBkulanandadiHK-629	vidyāṃ smaran | samarasī kṛtvā? nāparakuṇḍalinyāmekī bhūtāyāṃ ci	vidyām smaran samarasī kṛtvā na apara kuṇḍalinyām ekī bhūtāyām ci 
MBkulanandadiHK-630	svasirogatacaturaśrai cū * talādivyāpadyā vadigvikṣu aṇimādikaṃ |	sva siraḥ gata caturaśrai cū tala ādi vyāpadyāḥ va diś vikṣu aṇima ādikam 
MBkulanandadiHK-631	brahmādikaṃ mudrādaśakaṃ cāṃtaraṃ tataśṛgāṭe pūjyāhyaktaṃ	brahma ādikam mudrā daśakam ca antaram tata śṛgāṭe 
MBkulanandadiHK-632	prakāreṇa | padmarāgarasmīkadaṃbakarūpaṃ prādakṣiṇyena saṃpūjya | tata	prakāreṇa padmarāga rasmī kadaṃbaka rūpam prādakṣiṇyena saṃpūjya 
MBkulanandadiHK-633	cakreśvarī tripurāraṣāṃga nityā cakrā *? māninī smṛtvā | tatra tena	cakreśvarī tripurāraṣāṃga nityā cakrā māninī smṛtvā tatra tena 
MBkulanandadiHK-634	samarpyanaṃ mantrena parāmṛta kalāpānaṃ smṛtvā | tatraiva	samarpyanam mantrena para amṛta kalā pānam smṛtvā tatra eva 
MBkulanandadiHK-635	catuśrārbhyatare dviraṣṭadala padma lalāṭāgrāditaḥ kalāṣoḍaśaraśmi	dvis aṣṭa dala lalāṭa agra āditas kalā ṣoḍaśa raśmi 
MBkulanandadiHK-636	kadaṃbakaṃ vāmāvartena saṃcintya | taccakreśvari tripureśvarī nityau pūrvavat	kadaṃbakam vāma āvartena saṃcintya tad cakra īśvari tripureśvarī nityau pūrvavat 
MBkulanandadiHK-637	tata cakravyāpinī smṛtvā tata samarpya *?	tata cakravyāpinī smṛtvā tata samarpya 
MBkulanandadiHK-638	18a)	Ro
MBkulanandadiHK-639	satrana(?)parāmṛśrāva kṛtvā | tadanyaṃtare tatraivāṣu	kṛtvā tad anyaṃtare 
MBkulanandadiHK-640	dalapadmaṃ padmarāgopamaṃ saṃciṃtya | lalāṭābhyaṃtare hyāgneyādi ca	dala padmam padmarāga upamam saṃciṃtya lalāṭa abhyaṃtare hi āgneya ādi ca 
MBkulanandadiHK-641	digvidikṣu anaṅgādyaṣṭarasmikadaṃbakaṃ vāhyoktamatrai smṛtvā |	diś vidikṣu anaṅga ādi aṣṭa rasmi kadaṃbakam smṛtvā 
MBkulanandadiHK-642	taccakreśvarī tripurasuṃdarī nityāṃ tataḥssamarpya na maṃtraṃ ca smṛtvā |	tad cakra īśvarī tripurasuṃdarī nityām tatas samarpya na maṃtram ca smṛtvā 
MBkulanandadiHK-643	biṃdu madhyaśucakraṃ pravisya caturdaśa devī taccakreśvarī taccakra samarpya	caturdaśa samarpya 
MBkulanandadiHK-644	na maṃtra | tata pṛṣṭhādi vāmāvartena kṛtvā laṃvikāyāṃ kaṇṭhe ca	pṛṣṭha ādi vāma āvartena kṛtvā laṃvikāyām kaṇṭhe ca 
MBkulanandadiHK-645	daśadvaṃda pūrvavat kṛtvā | hṛtakamale tvaṣṭāra cakreṣu	pūrvavat kṛtvā hṛta kamale tvaṣṭāra cakreṣu 
MBkulanandadiHK-646	tadārabhyavāmāvartena vasinyāṣṭakaṃ | taccakreśvarīṃ tatsamarpya na	tat ārabhya vāma āvartena vasinyā aṣṭakam tad cakreśvarīm tat samarpya na 
MBkulanandadiHK-647	maṃtrena smṛtvā | nābhicakre trikone purastādārabhya kāmeśvaryādi devī	maṃtrena smṛtvā nābhi cakre trika ūne purastāt ārabhya kāmeśvarī ādi devī 
MBkulanandadiHK-648	trayaṃ taccakreśvarī pradakṣinena smṛtvā samarpya na mantrena samarpyanaṃ |	trayam smṛtvā samarpya na mantrena 
MBkulanandadiHK-649	mudrādhāre mūla	mudrā ādhāre mūla 
MBkulanandadiHK-650	18b)	Ro
MBkulanandadiHK-651	vidyayā samasta pātupapīṭha matrena kulakuṇḍalyāṃ smṛtvā taccakreśvarī	vidyayā kula kuṇḍalyām smṛtvā tad cakra īśvarā 
MBkulanandadiHK-652	yathā rūpāṃ smṛtvā parāmṛta culukodakena tataḥ samarpya na maṃtraṃ	yathā smṛtvā culuka udakena tatas samarpya na maṃtram 
MBkulanandadiHK-653	smaran pūjāṃ samarpyādhyaṣṭā koṭiroma nicaye | ekaikaromapratyaṣṭakaṃ	smaran pūjām nicaye ekaika roma pratyaṣṭakam 
MBkulanandadiHK-654	śṛṅgāṭasravadamṛtakaṃ smṛtvā catuṣaṣṭilakṣakoṭi mahāyoginī	śṛṅgāṭa sravat amṛtakam smṛtvā mahāyoginī 
MBkulanandadiHK-655	śrīpādukāṃ pūjayāmīti prapūjya || mūlādhāra svādhiṣṭhānasanipūrakānya	śrī pādukām pūjayāmi iti prapūjya 
MBkulanandadiHK-656	hṛtakaṇṭhalaṃvikānāsikāśu bhrumadhyantetyaṣṭakaṃ ||	hṛta kaṇṭha laṃvikā nāsikā āśu bhru madhya anta iti aṣṭakam 
MBkulanandadiHK-657	bhrumadhyādārabhya vaśiṣṭā nityāṣṭakamādvadaśītaṃ pratigaṃdhairekakaṃ	bhru madhyāt ārabhya prati gaṃdhaiḥ ekakam 
MBkulanandadiHK-658	saṃpūjya | yutisvaṃ(?) gurīyavidyāṃ parāmṛtavāhinīyī	saṃpūjya 
MBkulanandadiHK-659	samayavidyāṃ parāmṛtavāhinī tatraiva smṛtvā | śaktipaṃcakaṃ caturvahni	                                                                       
MBkulanandadiHK-660	19a)	Ro
MBkulanandadiHK-661	bhirvidrāvyadrāvakanyavena svaśarīraṃ yānyārṇavarūpaṃ	bhiḥ vidrāvya drāvaka nyavena sva śarīram 
MBkulanandadiHK-662	makulāmṛtakalayā padmarāgaṃ mayīkoṭi caṃdraśu śītayā *?	padmarāgam śītayā 
MBkulanandadiHK-663	dhvarya(?) tasmin parāmṛta hṛdaye	dhvarya tasmin parāmṛta hṛdaye 
MBkulanandadiHK-664	vimarśaśaktibhyāsaṃktenādyavarṇarūpani * * *?	          
MBkulanandadiHK-665	vījagarbhagaṃ | kṛtvā parānaṃdānubhāvātmakasthitvā pārthivaṃ	vīja garbha gam kṛtvā pārthivam 
MBkulanandadiHK-666	gunasaugaṃdhyamaśeṣaṃ puṣpādhūpabhāvena samarpyayi tatva gunamapilaṃ |	guna saugaṃdhyam aśeṣam puṣpa adhūpa bhāvena 
MBkulanandadiHK-667	prakāsadīpamālā rātrikākapūrārātrikaṃdarvā ||	            
MBkulanandadiHK-668	arpaṇamaśeṣasurasamanabhakṣakebhāśyādikannivedya |	arpaṇam aśeṣa surasa mana bhakṣaka ibha āśi ādikat nivedya 
MBkulanandadiHK-669	vāyutatvaguṇatvāśarīraceṣṭāṃ pradakṣiṇe namaskāraṃ parikalpya |	vā ayuta tva guṇa tva aśarīra ceṣṭām pradakṣiṇe namaskāram parikalpya 
MBkulanandadiHK-670	ākāśatattvaguṇaśabdapaṭhāśīvādyaṃ parikalpya | budhivibhramarūpā	ākāśa tattva guṇa śabda paṭha āśīvādyam parikalpya budhi vibhrama rūpā 
MBkulanandadiHK-671	vṛttīnatikā parikalpya manobuddhi ahaṃkārānta paśūntasarā	vṛttīnatikā 
MBkulanandadiHK-672	19b)	Ro
MBkulanandadiHK-673	gādikāsvīsasyatacchrotadhārayāṃ vidyā tadā masaṃvahuvidhaṃ	vidyā tadā 
MBkulanandadiHK-674	parameśvaryaiḥ paritoṣya | jñānakhaḍge?na malamāyākarmā	parameśvaryaiḥ paritoṣya jñāna khaḍgena mala māyā karmā 
MBkulanandadiHK-675	svāsaśa(?) gāna kṣepāṃ nivedya | kapāla śṛṅgāṭodara	nivedya 
MBkulanandadiHK-676	galitāmadyadhārāmavacchināṃ devyaiḥ samarpya | svayaṃ vimarśaśaktyā	galitā amadya dhārām avacchinām devyaiḥ samarpya svayam vimarśa śaktyā 
MBkulanandadiHK-677	sahaśṛṅgāṭādarā gatādyarvādau parama dvayapade samarasī bhāva pūjā	saha śṛṅgāṭa ādarā gata ādi arva ādau parama dvaya pade bhāva pūjā 
MBkulanandadiHK-678	manacaratatatvatā nanda mayo bhavet | punarācamanīya mukha vā sa tāṃbūla	nanda mayaḥ bhavet punarācamanīya mukha vā sa tāṃbūla 
MBkulanandadiHK-679	karpūrasaṃmiśritaṃ | mūlamantrena kuryāt ityantare pūjā || tato vakṣamāna	karpūra saṃmiśritam mūlamantrena kuryāt iti antare pūjā tatas 
MBkulanandadiHK-680	cakranyāsamācaret |	cakranyāsam ācaret 
MBkulanandadiHK-681	īśvarovāca ||	īśvarā uvāca 
MBkulanandadiHK-682	yā mantri puraśudayā cakraṃ nyāsaṃ śṛṇu priye |	yā mantri puraśudayā cakram nyāsam śṛṇu priye 
MBkulanandadiHK-683	20a)	Ro
MBkulanandadiHK-684	śrīgurubhyo namaḥ ||	śrī gurubhyaḥ namaḥ 
MBkulanandadiHK-685	jayā ca vijayāścaiva jayaṃtī cāparājitā |	jayā ca vijayāḥ ca eva jayaṃtī ca aparājitā 
MBkulanandadiHK-686	nandā bhadrā tathā bhīmā kalāścaivāṣṭaka tathā ||	nandā bhadrā tathā bhīmā kalāḥ ca eva aṣṭaka tathā 
MBkulanandadiHK-687	divya yogini mahāyogini siddhiyogini ganeśvarī |	divya yogini mahāyogini siddhiyogini ganeśvarī 
MBkulanandadiHK-688	sākinī kālarātrī ca ūrddhvakeśī nisākarī ||	         
MBkulanandadiHK-689	gambhīrā ghodyenāthūlā(?) ||	gambhīrā 
MBkulanandadiHK-690	pavanāgītalolikābhīṣanā ca mahānaṃdā jvālāmukhī tathaiva ca |	ca mahānaṃdā jvālāmukhī tathā eva ca 
MBkulanandadiHK-691	piśācī hastinaścaiva jakṣaṇī dhūrjaṭī tathā ||	piśācī hastinaḥ ca eva jakṣaṇī dhūrjaṭī tathā 
MBkulanandadiHK-692	viṣabhakṣasarvaśiddhi tuṣṭe icchā tathaiva ca |	tuṣṭe icchā tathā eva ca 
MBkulanandadiHK-693	mātaṃbha?ṣī kākadṛṣṭiśca tathālipura cāntakī ||	mātaṃbhaṣī kākadṛṣṭiḥ ca cāntakī 
MBkulanandadiHK-694	rākṣaśī ghoranādāśca raktākṣī viśvarūpinī |	rākṣaśī ghora nādāḥ ca raktākṣī viśva rūpinī 
MBkulanandadiHK-695	bhayaṃkārī raudravī bhats(?) stambhośī(?)	bhayaṃkārī raudravī stambhośī 
MBkulanandadiHK-696	narabhojanī ||	nara bhojanī 
MBkulanandadiHK-697	20b)	Ro
MBkulanandadiHK-698	nārabhadramahākālī kaṃkālī vikṛtānanā |	nārabhadra mahākālī kaṃkālī vikṛta ānanā 
MBkulanandadiHK-699	krodalī bhīmabhadrāśca vāyuvegā bhayānanā ||	krodalī bhīma bhadrāḥ ca vāyuvegā bhayānanā 
MBkulanandadiHK-700	brāhmī ca vaiṣṇavī raudrī carcikā īśvarī tathā |	brāhmī ca vaiṣṇavī raudrī carcikā īśvarī tathā 
MBkulanandadiHK-701	vārāhī nāraśiṅhī ca sivādutī catuṣṭikā ||	vārāhī nāraśiṅhī ca catuṣṭikā 
MBkulanandadiHK-702	idadevyā mahāyogini valigṛhna tu me sadā |	mahāyogini tu me sadā 
MBkulanandadiHK-703	aiṃ 5 sarvapīṭhopapīṭhādi dvāropadvārameva ca ||	aiṃ sarva pīṭha upapīṭha ādi dvāra upadvāram eva ca 
MBkulanandadiHK-704	kṣetropakṣetrasaṃdohā sarvadigbhāsaṃsthitā |	kṣetra upakṣetra saṃdohā sarva diś bhā saṃsthitā 
MBkulanandadiHK-705	mahāpātāla brahmāṇḍa sarvasthānāṃtare pare ||	            
MBkulanandadiHK-706	yoginī vīravīrendrā sarva tatraiva āgatā |	yoginī vīra vīra indrā sarva tatra eva āgatā 
MBkulanandadiHK-707	ida * rva mahācakraṃ śrīnātha varado mama ||	mahā cakram śrī nātha vara daḥ mama 
MBkulanandadiHK-708	ye bhaktyā sāsanā devī gurupūjārcane ratā |	ye bhaktyā sa āsanā devī guru pūjā arcane ratā 
MBkulanandadiHK-709	sarvasiddhi prasādaṃ tu devi teṣāṃ bhave sadā ||	sarva siddhi prasādam tu devi teṣām bhave sadā 
MBkulanandadiHK-710	vīrānāṃ yoginīnāñca ye diṣaṃti mahītale |	vīrānām yoginīnām ca ye mahī tale 
MBkulanandadiHK-711	dattau tu valiṃ devī samayācāra melake ||	dattau tu valim devī samayācāra melake 
MBkulanandadiHK-712	śrutismṛti mayī dṛṣṭi māṃsamedosthijāvitaṃ |	śruti smṛti māṃsa medaḥ sthi jāvitam 
MBkulanandadiHK-713	21a)	Ro
MBkulanandadiHK-714	vikṛṣaṃ tu duṣṭānāṃ yoginīnāṃganasaṃkulaṃ ||	vikṛṣam tu duṣṭānām yoginīnām aṃgana saṃkulam 
MBkulanandadiHK-715	śrī oṃkārastuje pīṭhābhayasārdvā prakīrtitā |	śrī prakīrtitā 
MBkulanandadiHK-716	upapīṭhāni tu sadohādiśāsu vi *? vidhāsu ca ||	upapīṭhāni tu sadohā diśāsu vi vidhāsu ca 
MBkulanandadiHK-717	mahīpātāla brahmāṇḍaṃ sarvasthānāṃtare pare |	          
MBkulanandadiHK-718	yoginīyyogayuktātmā tiṣṭhaṃ tu samayot cchaka ||	tiṣṭham tu 
MBkulanandadiHK-719	vīra krameṣu vīrendrā śiddhi krameṣu sādhakā |	vīra krameṣu vīrendrā śiddhi krameṣu sādhakā 
MBkulanandadiHK-720	śiddhi putraka ācāryā sādhusaṃkhipta samayā ||	śiddhi putraka ācāryā sādhu saṃkhipta samayā 
MBkulanandadiHK-721	nagare vā pṛthagrāme vā aṣṭavyā vā sarevare |	nagare vā pṛthagrāme vā aṣṭavyāḥ vā sarevare 
MBkulanandadiHK-722	vāpī kupa vṛko vā samasāne mātṛmaṇḍale ||	vāpī kupa vṛkaḥ vā samasāne mātṛ maṇḍale 
MBkulanandadiHK-723	nānārūpa dharā yogī vividhā vahudhāni ca |	nānārūpa dharā yogī vividhā vahudhāni ca 
MBkulanandadiHK-724	te sarvamamasaṃtuṣṭa valiṃ gṛhnaṃ tu sarvadā ||	te valim tu sarvadā 
MBkulanandadiHK-725	saranāgata ahaṃ teṣāṃ ca sarvameva phala pradā |	aham teṣām ca sarvameva phala pradā 
MBkulanandadiHK-726	prārabdhajanmayā kramaṃ yatkariṣyāmi yat kṛtiṃ vali puṣpapradā	prārabdha janmayā kramam yat kariṣyāmi yat kṛtim puṣpa pradā 
MBkulanandadiHK-727	21b)	Ro
MBkulanandadiHK-728	saṃtuṣyadāne cintakā sarvakā? *? na śiddhi tu sarvadoṣā	na tu sarva doṣā 
MBkulanandadiHK-729	praśāṃtaye śivaśakti prasaṃdatu kukṣa tu mama nityasa aiṃ 5 ||	praśāntaye śiva śakti tu mama 
MBkulanandadiHK-730	yoginī vali ||	yoginī vali 
MBkulanandadiHK-731	aiṃ 5 bhūtāntu vividhākārādivibhūmyāṃtarikṣaye pātālasaṃsthitārtheṣu	aim pātāla saṃsthita artheṣu 
MBkulanandadiHK-732	digavidiga gatāścarthe dhruvāni yāni divyāni bhūtāni teṣāṃmastu sutṛptatā	diś avidiśa gatāḥ ca arthe dhruvāni yāni divyāni bhūtāni teṣām mastu su tṛpta tā 
MBkulanandadiHK-733	svāhā | bhūta vali || ai 5 hrā& hrīṃ hrūṃ ha hauṃ haṃ haḥ oṃ	svāhā bhūta vali ai hrā hrīṃ   ha hauṃ haṃ haḥ om 
MBkulanandadiHK-734	mahāvalaprākrama kapilajaṭābhārabhāśura trinetra jvālāmukhaṃ	mahā vala prākrama kapila jaṭā bhāra bhāśura trinetra jvālā mukham 
MBkulanandadiHK-735	gaṃdhadhūpadīpa vali pūjāṃ gṛhna 2 bhairava rūpena turu 2 la 2 kha 2 he 2	gaṃdha dhūpa dīpa vali pūjām gṛhna bhairava rūpena turu la kha he 
MBkulanandadiHK-736	mahāḍāmarādhipataye vali pūjā gṛhna 2 śiddhi bhavatu svāhā ||	mahāḍāmara adhipataye vali pūjā gṛhna śiddhi bhavatu svāhā 
MBkulanandadiHK-737	bhairava vali ||	bhairava vali 
MBkulanandadiHK-738	īncomplete	īn complete 
MBkulanandadiHK-739	MUKTABODHA INDOLOGICAL RESEARCH INSTITUTE©2011 Muktabodha Indological Research Institute  All Rights Reserved.E-texts may be viewed only online or downloaded for private study.E-texts may not, under any circumstances, be copied, republished,reproduced, distributed or sold, either in original or altered form, withoutthe express permission of Muktabodha Indological Research Institute in writing.Data-entered by the staff of Muktabodha under the direction of Mark S. G. Dyczkowski.	muktabodha indological research muktabodha indological research institute all rights reserved texts may be viewed only online or downloaded for private studye texts may not under any circumstances be copied republished reproduced distributed or sold either in original or altered form withoutthe express permission of muktabodha indological research institute in writing data entered by the staff of muktabodha under the direction of mark s g dyczkowski 
