segmentnr	original	analyzed
MBniruttaravadaHK-0	Muktabodha E-text in UTF-8	muktabodha etext in utf
MBniruttaravadaHK-1	###########################################################################MUKTABODHA INDOLOGICAL RESEARCH INSTITUTEwww.muktabodha.org©2011 Muktabodha Indological Research Institute  All Rights Reserved.E-texts may be viewed only online or downloaded for private study.E-texts may not, under any circumstances, be copied, republished,reproduced, distributed or sold, either in original or altered form, withoutthe express permission of Muktabodha Indological Research Institute in writing.Data-entered by the staff of Muktabodha under the direction of Mark S. G. Dyczkowski.Catalog number : M00266	muktabodha indological research muktabodha indological research institute all rights reserved texts may be viewed only online or downloaded for private studye texts may not under any circumstances be copied republished reproduced distributed or sold either in original or altered form withoutthe express permission of muktabodha indological research institute in writing data entered by the staff of muktabodha under the direction of mark s g dyczkowskicatalog number  /
MBniruttaravadaHK-2	Uniform title: niruttaravāda	uniform title niruttara vāda 
MBniruttaravadaHK-3	Manuscript : BHU C4247	manuscript bhu 
MBniruttaravadaHK-4	Notes: Data entered by the staff of Muktabodha under the supervision of Mark S.G. Dyczkowski.	notes data entered by the staff muktabodha under the supervision of mark sg dyczkowski 
MBniruttaravadaHK-5	Revision 0: April 7, 2012	revision april 
MBniruttaravadaHK-6	Publication country : India	publication country india 
MBniruttaravadaHK-7	oṃ namo māyā dvikaṅkālakālagrāsakulānta kṛt |	om namaḥ māyā dvi kaṅkāla kāla grāsa kula anta kṛt 
MBniruttaravadaHK-8	vyomātīta nirābhāsa spandanānandavarjita || 1 ||	         
MBniruttaravadaHK-9	p. 93b) ālamba sarvamālamba nirālambanirākṛte |	ālamba sarvam ālamba nirālamba nirākṛte 
MBniruttaravadaHK-10	guṇāguṇapariśrānta niṣkrāntaḥ śaktisāgaraḥ ||  ||	guṇa aguṇa pariśrānta niṣkrāntaḥ śakti sāgaraḥ 
MBniruttaravadaHK-11	niṣkampo niṣkalaśśuddho nirānandaḥ sa bhairavaḥ |	niṣkampaḥ niṣkalaḥ śuddhaḥ nirānandaḥ sa bhairavaḥ 
MBniruttaravadaHK-12	śūnyaṃ śūnyaṃ tathā śūnyaṃ śūnyāśūnyāntarālinam || 3 ||	śūnyam śūnyam tathā śūnyam śūnyāśūnya antarālinam 
MBniruttaravadaHK-13	aśūnyaṃ sarvabhāveṣu pralayotpattikāraṇam |	a śūnyam sarva bhāveṣu pralaya utpatti kāraṇam 
MBniruttaravadaHK-14	tadgrāhyabhāvanātīta indriyātīta varjitam || 4 ||	tad grāhya bhāvanā atīta indriya atīta varjitam  /
MBniruttaravadaHK-15	vyomavyāptitvanantātma niṣedhaḥ sarvabhāvataḥ |	niṣedhaḥ sarva bhāvataḥ 
MBniruttaravadaHK-16	jāgratsvapnavinirmuktā sauṣuptāntaracāriṇī || 5 ||	jāgrat svapna vinirmuktā sauṣupta antara cāriṇī 
MBniruttaravadaHK-17	turyātītā parākāṣṭhā sā kāṣṭhā yā parāśivā |	turyātītā parā kāṣṭhā sā kāṣṭhā yā parāśivā 
MBniruttaravadaHK-18	sarvatrāvasthitaṃ devaṃ mātrātītaṃ sunirmalam || 6 ||	sarvatra avasthitam devam mātrā atītam su nirmalam 
MBniruttaravadaHK-19	bhāvābhāvavinirmuktaṃ nirmuktaṃ śaṅkayāhatam |	bhāva abhāva vinirmuktam nirmuktam śaṅkayā āhatam 
MBniruttaravadaHK-20	pramāṇapratyaṃyātītaṃ gamāgamavivarjitam || 7 ||	gama āgama vivarjitam 
MBniruttaravadaHK-21	p. 94a) prabhuṃ sarvasya deveśa niśśeṣaṃ vada me prabho || 8 ||	prabhum sarvasya deveśa niśśeṣam vada me prabho   
MBniruttaravadaHK-22	saṃśayo me mahānasti māyadhvaparivartitaḥ |	saṃśayaḥ me mahān asti māyadhva parivartitaḥ 
MBniruttaravadaHK-23	anekabhedagūḍhārthaṃ śrutaṃ yaccendrajālakam || 9 ||	aneka bheda gūḍha artham śrutam yat ca indrajālakam 
MBniruttaravadaHK-24	siddhāntaṃ tatra vai śeṣaṃ jñānabhedaṃ kulāgamam |	siddhāntam tatra vai śeṣam jñāna bhedam kula āgamam 
MBniruttaravadaHK-25	mantrārthagahanaṃ caiva tattvārthagahanaṃ tathā || 10 ||	mantra artha gahanam ca eva tattva artha gahanam tathā 
MBniruttaravadaHK-26	śabdārthaṃ naiva jānāmi padavākyapramāṇataḥ |	śabda artham nā eva jānāmi pada vākya pramāṇataḥ 
MBniruttaravadaHK-27	bhrāntabudhirahaṃ deva bhrāmitā bahudāsanaiḥ || 11 ||	bhrānta budhiḥ aham deva bhrāmitā bahu dāsanaiḥ 
MBniruttaravadaHK-28	kenopāyena deveśa jñātavyaṃ vasturūpatā |	kena upāyena deveśa jñātavyam vastu rūpa tā 
MBniruttaravadaHK-29	yena tajjñāyate satyaṃ dambhamāyāvivarjitam || 12 ||	yena tat jñāyate satyam dambha māyā vivarjitam 
MBniruttaravadaHK-30	nandiskandagaṇeśādyairdṛṅgināyoginī kulaiḥ |	nandi skanda gaṇeśa ādyaiḥ dṛṅginā yoginī kulaiḥ 
MBniruttaravadaHK-31	munibhirbrahmaviṣṇīśerindrasūryagaṇaistathā || 13 ||	munibhiḥ brahma viṣṇi īśeḥ indra sūrya gaṇaiḥ tathā 
MBniruttaravadaHK-32	kathitaṃ paramaṃ sthānaṃ yat sthānaṃ viditaṃ na tu |	kathitam paramam sthānam yat sthānam viditam na tu 
MBniruttaravadaHK-33	p. 94b) tatodhikaṃ yadastīti vadamasuranāyaka || 14 ||	tatas adhikam yat asti iti vadam asura nāyaka 
MBniruttaravadaHK-34	nityabhaktā tvahaṃdeva karmaṇā manasā girā |	nitya bhaktā tu aham deva karmaṇā manasā girā 
MBniruttaravadaHK-35	prasādaṃ kurusaṅkṣepād yenopāyena mucyate || 15 ||	prasādam kuru saṅkṣepāt yena upāyena mucyate 
MBniruttaravadaHK-36	āyāsarahitaṃ jñānaṃ prāṇāyāmavivarjitam |	āyāsa rahitam jñānam prāṇāyāma vivarjitam 
MBniruttaravadaHK-37	dhāraṇādhyānanirmuktaṃ yogatarkādidāhitam || 16 ||	dhāraṇā dhyāna nirmuktam yoga tarka ādi dāhitam 
MBniruttaravadaHK-38	vratayajñakriyāhīnaṃ niṣkriyaṃ tīrthavarjitam |	vrata yajña kriyā hīnam niṣkriyam tīrtha varjitam 
MBniruttaravadaHK-39	prasannātmā jagannātha vadetadbhaktavatsala || 17 ||	prasanna ātmā jagannātha vadetat bhakta vatsala 
MBniruttaravadaHK-40	śṛṇuṣvekāgrabhāvena yadvastu paramaṃ padam |	śṛṇuṣva ekāgra bhāvena yat vastu paramam padam 
MBniruttaravadaHK-41	naiva tat kathitaṃ bhadre guroḥ śukrasya vānyapi || 18 ||	na eva tat kathitam bhadre guroḥ śukrasya vā ani api 
MBniruttaravadaHK-42	gaṇeśasya kramānasya bhuṅginandastathaiva hi |	gaṇeśasya kramānasya bhuṅginandaḥ tathā eva hi 
MBniruttaravadaHK-43	gopitaṃ sarvaśāstrāṇāṃ pāśāṇastho yadā śikhī || 19 ||	gopitam sarva śāstrāṇām pāśāṇa sthaḥ yadā śikhī 
MBniruttaravadaHK-44	p. 95a) līnonāntaritopyeva dṛśyate yugalāhate |	līna ūna antaritā upi eva dṛśyate yugala āhate 
MBniruttaravadaHK-45	tadvacchiva manāmeyaṃ dṛśyate na ca dṛśyate || 20 ||	tadvat śiva manāmeyam dṛśyate na ca dṛśyate 
MBniruttaravadaHK-46	yathā salilamadhye tu analo viśate balāt |	yathā salila madhye tu analaḥ viśate balāt 
MBniruttaravadaHK-47	sthālikāntarayogena hyantarlīnaḥ prapadyate || 21 ||	sthālikā antara yogena hi antar līnaḥ prapadyate 
MBniruttaravadaHK-48	tadvacchivaṃ sarvagataṃ vyomābhāsaṃ yathā sthitam |	tadvat śivam sarva gatam vyoma ābhāsam yathā sthitam 
MBniruttaravadaHK-49	tile tailaṃ drume cchāyā sauṣupte kulamadhyagam || 22 ||	tile tailam drume chāyā sauṣupte kula madhya gam 
MBniruttaravadaHK-50	vaṃśelīhālaphalakaṃ śikhā vāsye śikheryathā |	vaṃśelī hāla phalakam śikhā vā āsye śikheḥ yathā 
MBniruttaravadaHK-51	vicitrapakṣapakṣāḍhyaṃ vāṣpānte naiva dṛśyate || 23 ||	vicitra pakṣa pakṣa āḍhyam vāṣpa ante na eva dṛśyate 
MBniruttaravadaHK-52	vimale vārimadhye tu saindhavaṃ yatra saṃsthitam |	vimale vāri madhye tu saindhavam yatra saṃsthitam 
MBniruttaravadaHK-53	na tasya rūpaṃ dṛśyeta āsvādaparivarjitam || 24 ||	na tasya rūpam dṛśyeta āsvāda parivarjitam 
MBniruttaravadaHK-54	nyagrodhabījaṃ nyagrodhe śūlvaṃ cāntarakāñcane |	              
MBniruttaravadaHK-55	ṣaḍrasaṃbhūmibhāge tu ākāśe vārṇasādhanam || 25 ||	ṣaṣ rasam bhūmi bhāge tu ākāśe vā arṇa sādhanam 
MBniruttaravadaHK-56	p. 95b) tadvatsamarasībhāvaṃ śivaṃ śāntaṃ jagatpatim || 26 ||	tadvat samarasībhāvam śivam śāntam jagatpatim   
MBniruttaravadaHK-57	atyadbhutaṃ mahādeva ajñānaṃ dussahaṃ mahat |	ati adbhutam mahādeva ajñānam dussaham mahat 
MBniruttaravadaHK-58	kenopāyena sogamyaḥ sarvopādhivivarjitaḥ || 27 ||	kena upāyena saḥ gamyaḥ sarva upādhi vivarjitaḥ 
MBniruttaravadaHK-59	grahaṇaṃ tasya nāstīti sphuṭaṃ meva dahe prabho |	grahaṇam tasya nā asti iti sphuṭam mā iva dahe prabho 
MBniruttaravadaHK-60	yena jñātena vai tṛptirjāyate tripurāntaka || 28 ||	yena jñātena vai tṛptiḥ jāyate tripurāntaka 
MBniruttaravadaHK-61	tūṣṇīṃ bhāvaṃ parityajya bruhivākyaṃ mahodayam ||	tūṣṇīm bhāvam parityajya bruhi vākyam mahā udayam 
MBniruttaravadaHK-62	iti śrīparamarahasye niruttaravāde bhairavaśrotovinirgata ta * de * ni * ye prathamoddeśaḥ || ||	iti śrī parama rahasye niruttara vāde prathama uddeśaḥ 
MBniruttaravadaHK-63	śrī * * ra u * ca ||	śrī   ra u ca 
MBniruttaravadaHK-64	kathayāmi yathā tathyaṃ kapaṭajñānavarjitam |	kathayāmi yathā tathyam kapaṭa jñāna varjitam 
MBniruttaravadaHK-65	bhramabhrāntiṃ parityajya grāhayet paramaṃ padam || 1 ||	bhrama bhrāntim parityajya grāhayet paramam padam 
MBniruttaravadaHK-66	p. 96a) dhyānāntaḥ karaṇairmuktaṃ snānaṃ pañcādikeṣvapi |	dhyāna antar karaṇaiḥ muktam snānam pañca ādikeṣu api 
MBniruttaravadaHK-67	cintayā rahitaṃ cittaṃ niścittaṃ paramaṃ padam || 2 ||	cintayā rahitam cittam niścittam paramam padam 
MBniruttaravadaHK-68	kumbhapūrakareśyādyaiḥ praśāntapavanaiḥ saha |	kumbhapūraka reśyā ādyaiḥ praśānta pavanaiḥ saha 
MBniruttaravadaHK-69	daśavāyu sa vṛndāni daśasāhasrakāni ca || 3 ||	daśa vāyu sa vṛndāni daśa sāhasrakāni ca 
MBniruttaravadaHK-70	pratyekaṃ tu sahasrātmā prāṇādyāstu dhanañjayaḥ |	pratyekam tu sahasra ātmā prāṇa ādyāḥ tu dhanañjayaḥ 
MBniruttaravadaHK-71	daśasāhasranāḍyoghe saṃsthitaḥ kulamadhyagaḥ || 4 ||	daśa sāhasra nāḍī oghe saṃsthitaḥ kula madhya gaḥ 
MBniruttaravadaHK-72	vāyuvṛndaṃ parityajya tatvavṛndaṃ tathaiva ca |	vāyu vṛndam parityajya tatva vṛndam tathā eva ca 
MBniruttaravadaHK-73	mantrajālaṃ mahādurgaṃ kriyājālaṃ parityaja || 5 ||	mantra jālam mahā durgam kriyā jālam parityaja 
MBniruttaravadaHK-74	śāstrajālamanekārthaṃ tyajasarvaṃ palālavat |	śāstra jālam aneka artham tyaja sarvam palāla vat 
MBniruttaravadaHK-75	ṣaṭcakraṃ ṣoḍaśādhāraṃ trilakṣyaṃ vyomapañcakam || 6 ||	           
MBniruttaravadaHK-76	lakṣasthānaṃ parityajya ghaṇṭikāgraṃ tathaiva ca |	lakṣa sthānam parityajya ghaṇṭikā agram tathā eva ca 
MBniruttaravadaHK-77	dvāsaptati sahasrāṇi nāḍivṛndaṃ parityajet || 7 ||	dvāsaptati sahasrāṇi nāḍi vṛndam parityajet 
MBniruttaravadaHK-78	vastipīḍī na kiṃ kāryaṃ meḍhrānandena kiṃ phalam |	vastipīḍī na kim kāryam meḍhra ānandena kim phalam 
MBniruttaravadaHK-79	p. 96b) gṛhyānandodbhave cakre klinnā saṃpīḍanena tu || 8 ||	gṛhya ānanda udbhave cakre klinnā saṃpīḍanena tu 
MBniruttaravadaHK-80	na tatra phalasiddhānāṃ kevalaṃ bandhanātmakam |	na tatra phala siddhānām kevalam bandhana ātmakam 
MBniruttaravadaHK-81	yoginī melakānandāttadā teṣāṃ prakāśitam || 9 ||	yoginī melaka ānandāt tadā teṣām prakāśitam 
MBniruttaravadaHK-82	nistaraṅga madonmatta madirā liṃcicātmakāt |	nistaraṅga mada unmatta madirā 
MBniruttaravadaHK-83	tatrakāle mayāproktamānandaṃ jaghanesthitam || 10 ||	tatra kāle mayā a proktam ānandam jaghane sthitam 
MBniruttaravadaHK-84	tadā nandaṃ jarātyasmin dṛṣṭyarthaṃ kathitaṃ mayā |	tadā nandam dṛṣṭi artham kathitam mayā 
MBniruttaravadaHK-85	tatrādhikaṃ tu parato yatra sṛṣṭirna jāyate || 11 ||	tatra adhikam tu paratas yatra sṛṣṭiḥ na jāyate  /
MBniruttaravadaHK-86	śaktyānandaṃ na cā nandaṃ śivānandaṃ na caiva hi |	śakti ānandam na ca ā nandam śiva ānandam na ca eva hi 
MBniruttaravadaHK-87	ānandojjhitamānandaṃ suṣupta iva saṃsthitam || 12 ||	ānanda ujjhitam ānandam suṣupte iva saṃsthitam 
MBniruttaravadaHK-88	atīndriyaṃ na ca grāhyaṃ vyomavyāpī sadāśivam |	atīndriyam na ca grāhyam vyomavyāpī sadāśivam 
MBniruttaravadaHK-89	buddhīndriyavinirmuktaṃ kālākālavivarjitam || 13 ||	buddhīndriya vinirmuktam kāla akāla vivarjitam 
MBniruttaravadaHK-90	na mano na ca vai buddhirahaṅkāraśca vidyate |	na manaḥ na ca vai buddhiḥ ahaṅkāraḥ ca vidyate 
MBniruttaravadaHK-91	p. 97a) na pramāṇaṃ prameyaśca na guṇo doṣa eva ca || 14 ||	na pramāṇam prameyaḥ ca na guṇaḥ doṣaḥ eva ca 
MBniruttaravadaHK-92	na sattvaṃ na rajo vāpi na tamo bhūmireva ca |	na sattvam na rajaḥ vā api na tamaḥ bhūmiḥ eva ca 
MBniruttaravadaHK-93	na varṇaṃ varṇajātīnāṃ na geyaṃ vedanādinām || 15 ||	na varṇam varṇa jātīnām na geyam vedanā ādinām 
MBniruttaravadaHK-94	na tarkaṃ nāḍisañcāraṃ kriyādharmavivarjitam |	na tarkam nāḍi sañcāram kriyā dharma vivarjitam 
MBniruttaravadaHK-95	na somaṃ sūryamityāhurhutāśanamapi priye || 16 ||	na somam sūryam iti āhuḥ hutāśanam api priye 
MBniruttaravadaHK-96	na vegapavane śāntairna bhūmirnāntarikṣagam |	na vega pavane śāntaiḥ na bhūmiḥ na antarikṣa gam 
MBniruttaravadaHK-97	na yakṣo na ca nāgendraṃ dharmādharmavivarjitam || 17 ||	na yakṣaḥ na ca nāga indram dharma adharma vivarjitam 
MBniruttaravadaHK-98	na kubjaṃ kā ca kuṇḍaṃ ca na hīnamuttamaṃ sthitam |	na kubjam kā ca kuṇḍam ca na hīnam uttamam sthitam 
MBniruttaravadaHK-99	na bījaṃ vanavṛkṣaṃ vā auṣadhaṃ na ca vidyate || 18 ||	na bījam vana vṛkṣam vā auṣadham na ca vidyate  /
MBniruttaravadaHK-100	rasaṃ rasāyanaṃ vāpi na dīrghaṃ hrasvameva ca |	rasam rasāyanam vā api na dīrgham hrasvam eva ca 
MBniruttaravadaHK-101	gamāgamairna lipyeta abyucchinnapravāhanam || 19 ||	gama āgamaiḥ na lipyeta abyucchinna pravāhanam 
MBniruttaravadaHK-102	śūnyaṃ śūnyaṃ tathā śūnyamānanda pada varjitam |	śūnyam śūnyam tathā śūnyam ānanda pada varjitam 
MBniruttaravadaHK-103	strīsukhānandanirmuktaṃ viṣayānandadūṣakam || 20 ||	           
MBniruttaravadaHK-104	p. 97b) nirbharānandagahanaṃ vimalānandacetasaḥ |	               
MBniruttaravadaHK-105	vyomānandarasonmattaṃ bodhānandapariplutam || 21 ||	            
MBniruttaravadaHK-106	nirānanda padaṃ śāntaṃ nirvāṇaṃ viṣayāntakam |	            
MBniruttaravadaHK-107	vyomasthaṃ vyomarūpasthaṃ vyomātmāvyomasambhavam || 22 ||	vyoma stham vyoma rūpa stham vyoma ātma a vyoma sambhavam 
MBniruttaravadaHK-108	pañcavyomātmakaṃ devamanādiṃ prabhumavyayam |	pañca vyoma ātmakam devam anādim prabhum avyayam 
MBniruttaravadaHK-109	tasya sṛṣṭiḥ sthitā cānte yo jānāti sa tatvavit || 23 ||	tasya sṛṣṭiḥ sthitā ca ante yaḥ jānāti sa tatva vid 
MBniruttaravadaHK-110	madhyāvasāna jātiṃ ca tasya hyekatra lakṣayet |	madhya avasāna jātim ca tasya hi ekatra lakṣayet 
MBniruttaravadaHK-111	kriyājñānaṃ tathecchā ca abyucchinnaṃ pravartate || 24 ||	kriyā jñānam tathā icchā ca abyucchinnam pravartate 
MBniruttaravadaHK-112	tasmāt sarvaprayatnena mṛtasaṃjñāṃ parityajet |	tasmāt sarva prayatnena mṛta saṃjñām parityajet 
MBniruttaravadaHK-113	tata evāgataṃ piṇḍaṃ tatraiva ca sa gacchati || 25 ||	tatas eva āgatam piṇḍam tatra eva ca sa gacchati 
MBniruttaravadaHK-114	śūnyālayācchakti vilādutpannamakhilaṃ jagat |	śūnya ālayāt śakti vilāt utpannam akhilam jagat 
MBniruttaravadaHK-115	p. 98a) līyate tatra vai sthāne punastatra samāgamam || 26 ||	līyate tatra vai sthāne punar tatra samāgamam   
MBniruttaravadaHK-116	samāgamairna lipyeta abyucchinnapravāhakam |	samāgamaiḥ na lipyeta a byucchinna pravāhakam 
MBniruttaravadaHK-117	ādau tu hyakhilaṃ sarvaṃ paścāt sṛṣṭiḥ pravartate || 27 ||	ādau tu hi akhilam sarvam paścāt sṛṣṭiḥ pravartate   
MBniruttaravadaHK-118	punastatraiva līyante madhyamā sā kuto dhṛtiḥ |	punar tatra eva līyante madhyamā sā kutas dhṛtiḥ 
MBniruttaravadaHK-119	śivātprasūyate piṇḍaṃ śive piṇḍaṃ punarvrajet || 28 ||	śivāt prasūyate piṇḍam śive piṇḍam punar vrajet  /
MBniruttaravadaHK-120	śaktikṣobhādbhavetpiṇḍamakṣobhācchūnyarūpiṇam |	śakti kṣobhāt bhavet piṇḍam akṣobhāt śūnya rūpiṇam 
MBniruttaravadaHK-121	yo sā vatīṃndriyagrāhyaḥ sarvavyāpī parāparaḥ || 29 ||	sarvavyāpī parāparaḥ 
MBniruttaravadaHK-122	tasmācchaktirviniṣkrāntā mātṛkācakrabodhinī |	tasmāt śaktiḥ viniṣkrāntā mātṛkā cakra bodhinī 
MBniruttaravadaHK-123	śivaśakti parityāgānna piṇḍaṃ piṇḍabandhanam || 30 ||	śiva śakti parityāgāt na piṇḍam piṇḍa bandhanam 
MBniruttaravadaHK-124	sarvaṃ pralīyate śūnye jagatsthāvarajaṅgamam |	sarvam pralīyate śūnye jagat sthāvara jaṅgamam 
MBniruttaravadaHK-125	yadā līyanti sarvetra tadā liṅgamudāhṛtam || 31 ||	yadā līyanti sarve itra tadā liṅgam udāhṛtam 
MBniruttaravadaHK-126	mano liṅgaṃ cidāśaktiḥ spandanaṃ kandamūlajam |	                 
MBniruttaravadaHK-127	p. 98b) yadā hyekatra tritayaṃ nityato yo pi bhāvayet || 32 ||	yadā hi ekatra tritayam nityatas bhāvayet   
MBniruttaravadaHK-128	sa muktaḥ sarvabandhebhyo śacanaṃ? nirmalaṃ yathā |	sa muktaḥ sarva bandhebhyaḥ śacanam nirmalam yathā 
MBniruttaravadaHK-129	na ca lipyati pāpena karmaṇā manasāgirāṃ || 33 ||	na ca lipyati pāpena karmaṇā 
MBniruttaravadaHK-130	śivaṃ sarvagataṃ dhyātvā kona mucyeta bandhanāt |	śivam sarva gatam dhyātvā mucyeta bandhanāt 
MBniruttaravadaHK-131	sarvaṃ śivātmakaṃ viśvaṃ yā kriyā sā śivātmikā || 34 ||	sarvam śiva ātmakam viśvam yā kriyā sā śiva ātmikā 
MBniruttaravadaHK-132	yo vikalpaḥ sa ghorāstraṃ yā śuddhiḥ sā parāsmṛtā |	yaḥ vikalpaḥ sa ghora astram yā śuddhiḥ sā parāsmṛtā 
MBniruttaravadaHK-133	aśuddhā nityamucchuṣmā saṅkīrṇo yaḥ sa bhairavaḥ || 35 ||	aśuddhā nityam ucchuṣmā saṅkīrṇaḥ yaḥ sa bhairavaḥ 
MBniruttaravadaHK-134	yo madyaḥ sa ca mārtāṇḍo yā surāsā umā smṛtā |	yaḥ madyaḥ sa ca mārtāṇḍaḥ yā surāsāḥ umā smṛtā 
MBniruttaravadaHK-135	brahmādyāḥ śivaparyantaṃ pañcadravyāḥ prakīrtitāḥ || 36 ||	brahma ādyāḥ śiva paryantam pañca dravyāḥ prakīrtitāḥ 
MBniruttaravadaHK-136	aśuddhomiti nāstihaṃ pañcabhūtairadhiṣṭhitāḥ |	aśuddha ūm iti pañcabhūtaiḥ adhiṣṭhitāḥ 
MBniruttaravadaHK-137	brahmāviṣṇuśca rudraśca īśvaraśśiva eva ca || 37 ||	brahmā viṣṇuḥ ca rudraḥ ca īśvaraḥ śivaḥ eva ca 
MBniruttaravadaHK-138	p. 99a) nāsā cakṣustathā śrotra māsyaṃ meḍhraṃ tu pañcamam |	nāsā cakṣuḥ tathā śrotra māsyam meḍhram tu pañcamam 
MBniruttaravadaHK-139	ete malā hyadhobhāge ūrdhvaṃ nityaṃ pradīpakaḥ || 38 ||	ete malāḥ hi adhobhāge ūrdhvam nityam pradīpakaḥ 
MBniruttaravadaHK-140	paśyate jigrate nityaṃ śrūyate ramate spṛśet |	paśyate jigrate nityam śrūyate ramate spṛśet 
MBniruttaravadaHK-141	pañcaite devatā mūle kulaliṅge pratiṣṭhitāḥ || 39 ||	pañca ete devatāḥ mūle kula liṅge pratiṣṭhitāḥ 
MBniruttaravadaHK-142	māṃsaṃ raktaṃ tathāsthīnisnāyumajjā tathāmalam |	māṃsam raktam tathā asthīni snāyu majjā tathā amalam 
MBniruttaravadaHK-143	śukraṃ śleṣmaṃ śirolomā ye cānye cāṅga santatau || 40 ||	śukram śleṣmam śiraḥ lomā ye ca anye ca aṅga santatau 
MBniruttaravadaHK-144	dvijādi mlecchaparyantaṃ gośvāpaśuṣusaṃkhyayā |	dvija ādi mleccha paryantam go śvā paśu ṣu saṃkhyayā 
MBniruttaravadaHK-145	tatrasthaṃ paramaṃ sākṣāt tṛṇakāṣṭhe viśeṣataḥ || 41 ||	tatrastham paramam sākṣāt tṛṇa kāṣṭhe viśeṣataḥ 
MBniruttaravadaHK-146	vāyūnāṃ ca tathā nāma daśānāṃ parisaṅkhyayā |	vāyūnām ca tathā nāma daśānām parisaṅkhyayā 
MBniruttaravadaHK-147	sūryānandaṃ rasānandaṃ samānandamudānataḥ || 42 ||	sūryānandam rasānandam samānandam udānataḥ 
MBniruttaravadaHK-148	vyānānandaṃ janānandaṃ kūrmānandaṃ kṛkodaram |	vyānānandam janānandam kūrmānandam kṛkodaram 
MBniruttaravadaHK-149	ahaṅkārotha navamaṃ daśamaṃ tu dhanañjayam || 43 ||	ahaṅkāraḥ utha navamam daśamam tu dhanañjayam 
MBniruttaravadaHK-150	p. 99b) prāṇopāneśvarīśaktirapāne gudarodhinī |	prāṇa upāneśvarī śaktiḥ apāne guda rodhinī 
MBniruttaravadaHK-151	sarvato devatāmārge brahmādyaṣṭau prakīrtitāḥ || 44 ||	sarvatas devatā mārge brahma ādi aṣṭau prakīrtitāḥ 
MBniruttaravadaHK-152	akalarkamalaścaṇḍaḥ puṇḍravātapanānvitāḥ |	a kala ṛkamalaḥ caṇḍaḥ puṇḍra vātapana anvitāḥ 
MBniruttaravadaHK-153	pavano yāmadaivatyaḥ śaṅkaraścāṣṭamaḥ smṛtaḥ || 45 ||	pavanaḥ yāma daivatyaḥ śaṅkaraḥ ca aṣṭamaḥ smṛtaḥ   
MBniruttaravadaHK-154	samāne samanā nāma apāne unmanī sthitā |	samāne samanā nāma apāne unmanī sthitā 
MBniruttaravadaHK-155	vyāne tu ca?krakī devī nāge tu bhujagī parā || 46 ||	vyāne tu cakrakī devī nāge tu bhujagī parā 
MBniruttaravadaHK-156	kūrme saṅkocitāśaktiḥ kṛkare karmavāhinī |	              
MBniruttaravadaHK-157	devadatte ahaṅkārī nityarūpā dhanañjaye || 47 ||	devadatte ahaṅkārī nitya rūpā dhanañjaye  /
MBniruttaravadaHK-158	daśaśakti sthitā nityā vāyumadhye khamāśritāḥ |	daśa śakti sthitāḥ nityāḥ vāyu madhye kham āśritāḥ 
MBniruttaravadaHK-159	nābhi cakre sthitāścānyāḥ koṭyo dvāsaptatiḥ kramāt || 48 ||	nābhi cakre sthitāḥ ca anyāḥ koṭyaḥ dvāsaptatiḥ kramāt 
MBniruttaravadaHK-160	madhye tu bhairavaḥ sākṣādvyomābhāso jagatguruḥ |	madhye tu bhairavaḥ sākṣāt vyoma ābhāsaḥ jagatguruḥ 
MBniruttaravadaHK-161	nirāmayaḥ paraṃ śūnyo nābhimadhye virājate || 49 ||	nirāmayaḥ param śūnyaḥ nābhi madhye virājate 
MBniruttaravadaHK-162	p. 100a) gudapadmaṃ sadābhuktyā kālarudraḥ pratiṣṭhitaḥ |	guda padmam sadā abhuktyā kālarudraḥ pratiṣṭhitaḥ 
MBniruttaravadaHK-163	rakṣamānastakaṃ piṇḍaṃ vinodārthe vijṛmbhate || 50 ||	rakṣamānaḥ takam piṇḍam vinoda arthe vijṛmbhate 
MBniruttaravadaHK-164	sarvanāḍi mayaṃdevaṃ romāvali valīkṛtam |	roma āvali valīkṛtam 
MBniruttaravadaHK-165	sahasralakṣaṃ koṭyābhamicchāśakti pradīpakam || 51 ||	sahasra lakṣam koṭi ābham icchā śakti pradīpakam 
MBniruttaravadaHK-166	adṛśyaṃ bhuvanādhāraṃ piṇḍaṃ piṇḍe vyavasthitam |	adṛśyam bhuvana ādhāram piṇḍam piṇḍe vyavasthitam 
MBniruttaravadaHK-167	aneka viśvarūpeṇa eko * * *? rañjanaḥ || 52 ||	aneka viśva rūpeṇa ekaḥ     
MBniruttaravadaHK-168	na cātra tapasā labhyo na dānaiḥ * * * * *? |	na ca atra tapasā labhyaḥ na dānaiḥ 
MBniruttaravadaHK-169	guruvaktraprayogena labhyate sarvatoditam || 53 ||	guru vaktra prayogena labhyate sarva tā uditam 
MBniruttaravadaHK-170	anyathā śāstrakoṭīnāṃ bhrāmyate na ca labhyate |	anyathā śāstra koṭīnām bhrāmyate na ca labhyate 
MBniruttaravadaHK-171	sopadeśaṃ paraṃ śāntaṃ sampradāyaṃ sunirmalam || 54 ||	sa upadeśam param śāntam sampradāyam su nirmalam 
MBniruttaravadaHK-172	mukhāgamena yuktātmā śuddhābhāvānvitena ca |	mukha āgamena yukta ātmā śuddha abhāva anvitena ca 
MBniruttaravadaHK-173	labhate nirmalaṃ bhāvaṃ madaśāṭhyaṃ vivarjitam || 55 ||	labhate nirmalam bhāvam mada śāṭhyam vivarjitam 
MBniruttaravadaHK-174	p. 100b) yadi tuṣṭo bhavecchambhuryadi janma na vidyate |	yadi tuṣṭaḥ bhavet śambhuḥ yadi janma na vidyate 
MBniruttaravadaHK-175	tadā prāpya gurusthānādvaktrāvaktrena vedayet || 56 ||	tadā prāpya guru sthānāt vaktrā vaktrena vedayet 
MBniruttaravadaHK-176	pratyakṣaṃ darśayeddevaṃ yasya viśvaṃ hṛdi sthitam |	pratyakṣam darśayet devam yasya viśvam hṛdi sthitam 
MBniruttaravadaHK-177	bhāvapūrvaprayogena dharmādharmakṣayeṇa tu || 57 ||	bhāva pūrva prayogena dharma adharma kṣayeṇa tu 
MBniruttaravadaHK-178	vikalpa dhvaṃsane devi * * * sthāpayet guruḥ |	vikalpa dhvaṃsane devi    sthāpayet guruḥ 
MBniruttaravadaHK-179	sarvāvasthaṃ śivaṃ jñātvā kona mucyeta bandhanāt? || 58 ||	sarva avastham śivam jñātvā kaḥ na mucyeta bandhanāt  
MBniruttaravadaHK-180	prasannātmā yaditvaṃ me mākhidyaḥ pa?ranāyaka |	prasanna ātmā yadi tvam me mā ākhidyaḥ para nāyaka 
MBniruttaravadaHK-181	nirupādhi vihīnātmā? kriyākāraṇavarjitam || 59 ||	        
MBniruttaravadaHK-182	upāyaṃ? kena mātreṇa grāhayetkulabhairavaḥ |	upāyam kena mātreṇa grāhayet kulabhairavaḥ 
MBniruttaravadaHK-183	antardeha gataṃ cittaṃ cañcalaṃ capalaṃ tathā || 60 ||	antar deha gatam cittam cañcalam capalam tathā 
MBniruttaravadaHK-184	bhavenniścalatā yena upadeśaṃ * *? hame |	bhavet niścala tā yena upadeśam hame 
MBniruttaravadaHK-185	p. 101a) yena vijñātamātreṇa bhavate cchinnasaṃśayaḥ || 61 ||	yena vijñāta mātreṇa bhavate chinna saṃśayaḥ 
MBniruttaravadaHK-186	na baddho na ca vā mukto naiva baddho vimocayet |	na baddhaḥ na ca vā muktaḥ na eva baddhaḥ vimocayet 
MBniruttaravadaHK-187	yadi bandhātmakaṃ viśvaṃ tadā mokṣaṃ prapadyate || 62 ||	yadi bandha ātmakam viśvam tadā mokṣam prapadyate 
MBniruttaravadaHK-188	nirmuktaḥ sarvabandhebhyaḥ svatantraḥ parameśvaraḥ |	nirmuktaḥ sarva bandhebhyaḥ svatantraḥ parameśvaraḥ 
MBniruttaravadaHK-189	baddhosau svavikalpena na ca bandhaṃ śivasya hi || 63 ||	baddhaḥ asau sva vikalpena na ca bandham śivasya hi 
MBniruttaravadaHK-190	śivaṃ śaktistathā cātmā ekībhāvena sundari |	śivam śaktiḥ tathā ca ātmā ekībhāvena sundari 
MBniruttaravadaHK-191	bandhaṃ caiva na tasyāsti vibhutvāt sarvataḥ śivaḥ || 64 ||	bandham ca eva na tasya asti vibhu tvāt sarvatas śivaḥ 
MBniruttaravadaHK-192	bandhaṃ mokṣaṃ mayā coktaṃ tritatva pada bhedakam |	bandham mokṣam mayā ca uktam tritatva pada bhedakam 
MBniruttaravadaHK-193	satyākāraṃ ca deveśi na baddho na ca mucyate || 65 ||	satya ākāram ca deveśi na baddhaḥ na ca mucyate  /
MBniruttaravadaHK-194	śāstre śāstre mayā coktaṃ gopitaṃ paramārthataḥ |	śāstre śāstre mayā ca uktam gopitam paramārthataḥ 
MBniruttaravadaHK-195	vibhīṣikā mahāraudrā narakādi bhayāvahā || 66 ||	            
MBniruttaravadaHK-196	sṛṣṭisaṃrakṣaṇārthāya kathitā tava sundari |	sṛṣṭi saṃrakṣaṇa arthāya kathitā tava sundari 
MBniruttaravadaHK-197	p. 101b) pūrvaiva kathitaṃ sarvaṃ sarvaṃ sarvagataṃ śivam || 67 ||	pūrvā eva kathitam sarvam sarvam sarva gatam śivam   
MBniruttaravadaHK-198	tāvacchaṅkā bhaveddevi yāvat tattvaṃ na vindate |	tāvat śaṅkā bhavet devi yāvat tattvam na vindate 
MBniruttaravadaHK-199	viditesmin pare tatve vicaret pavano yathā || 68 ||	vidite ismin pare tatve vicaret pavanaḥ yathā 
MBniruttaravadaHK-200	bandhaṃ nāmeti yā saṃjñāmāsaṃjñā vastu niṣphalā |	bandham nāma iti yā vastu niṣphalā 
MBniruttaravadaHK-201	sarvaṃ śivamayaṃ bhadre paunaḥ puṇyena kīrtitam || 69 ||	sarvam śiva mayam bhadre paunar puṇyena kīrtitam 
MBniruttaravadaHK-202	yā dṛśecchā anicchā yā śuddhāśuddha padadvayam |	yā dṛśā icchā anicchā yā 
MBniruttaravadaHK-203	sadāśiva mayecchā ca na kriyā parataḥ śivaḥ || 70 ||	sadāśiva mayā icchā ca na kriyā paratas śivaḥ 
MBniruttaravadaHK-204	śivaṃ kriyā kriyā bhedamekatve ca sadā naghe |	śivam kriyā kriyā bhedam eka tve ca sadā naghe 
MBniruttaravadaHK-205	yena yena hi mārgeṇa yā dṛśe tādṛśena vā || 71 ||	yena yena hi mārgeṇa yā tādṛśena vā 
MBniruttaravadaHK-206	tena te naivamārgeṇa nāsti bandhaṃ śivātmakam |	tena te na eva mārgeṇa nā asti bandham śiva ātmakam 
MBniruttaravadaHK-207	iti śrīparamarahasye niruttaravāde śabdaṃ? vaśrotasi dvitīyoddeśaḥ ||	iti śrī parama rahasye niruttara vāde śabdam dvitīya uddeśaḥ 
MBniruttaravadaHK-208	p. 102)	p 
MBniruttaravadaHK-209	śrīdevyuvāca	śrī devī uvāca 
MBniruttaravadaHK-210	satyaṃ vada mahādeva duḥkhānta parameśvara |	satyam vada mahādeva duḥkhānta parameśvara 
MBniruttaravadaHK-211	yena vijñātamātreṇa na bhūyaḥ parivartanam || 1 ||	yena vijñāta mātreṇa na bhūyaḥ parivartanam 
MBniruttaravadaHK-212	śṛṇu devi paraṃguhyaṃ yatsurairapi durlabham |	śṛṇu devi param guhyam yat suraiḥ api durlabham 
MBniruttaravadaHK-213	tadahaṃ saṃpravakṣyāmi śṛṇuṣveka manāḥ priye || 2 ||	tat aham saṃpravakṣyāmi śṛṇuṣva eka manāḥ priye 
MBniruttaravadaHK-214	bahumāṣa? prayogeṇa śāstraṃ śāstreṇa dūṣitam |	bahu māṣa prayogeṇa śāstram śāstreṇa dūṣitam 
MBniruttaravadaHK-215	bahuvādaratācāra parasparavirodhataḥ || 3 ||	bahu vāda rata ācāra paraspara virodhataḥ 
MBniruttaravadaHK-216	bahuśāstropadeśaṃ ca krīḍārthaṃ nirmitaṃ mayā |	bahu śāstra upadeśam ca krīḍā artham nirmitam mayā 
MBniruttaravadaHK-217	yadā tvekākinaṃ devi naramāmi kulāntike || 4 ||	yadā tu ekākinam devi na ramāmi kula antike 
MBniruttaravadaHK-218	tadā vividhaśāstrāṇi nirmitāni yāgatraye |	tadā vividha śāstrāṇi nirmitāni yāga traye 
MBniruttaravadaHK-219	ekākī paramo devaḥ śaktyā saha tu krīḍati || 5 ||	ekākī paramaḥ devaḥ śaktyā saha tu krīḍati 
MBniruttaravadaHK-220	p. 102b) yo sau kāmeśvaro deva utpatti layakārakam |	          
MBniruttaravadaHK-221	tena rūpaṃ svayaṃ dṛṣṭamarūpaṃ darśayet tathā || 6 ||	tena rūpam svayam dṛṣṭam arūpam darśayet tathā 
MBniruttaravadaHK-222	mantracakraṃ yogi cakraṃ koṭi koṭi parivṛtam |	mantra cakram yogi cakram koṭi koṭi parivṛtam 
MBniruttaravadaHK-223	eko devo na cānyosti kiṃ vā dvandvena kāraṇam || 7 ||	ekaḥ devaḥ na ca anyaḥ asti kim vā dvandvena kāraṇam 
MBniruttaravadaHK-224	śāstrabhedaṃ kimarthaṃ vai kiṃ vā dvaita vidhikramam |	śāstra bhedam kimartham vai kim vā dvaita vidhi kramam 
MBniruttaravadaHK-225	advaitaṃ kathitaṃ sarvaṃ dvaitaṃ nāsti mahāprabho || 8 ||	advaitam kathitam sarvam dvaitam na asti mahā prabho 
MBniruttaravadaHK-226	śrībhairava uvāca	śrī bhairavaḥ uvāca 
MBniruttaravadaHK-227	kathinā dvaitatācāre hyadyaitamupalabhyate |	kathinā dvaitatā ācāre hi adya etam upalabhyate 
MBniruttaravadaHK-228	yathā tilāṅkure bījamūrdhvaṃ dṛśyanti tāṃstilān || 9 ||	yathā tila aṅkure bījam ūrdhvam dṛśyanti tān tilān 
MBniruttaravadaHK-229	mahīkṣiptavibhāgena aṣṭadhā dṛśyate priye |	mahī kṣipta vibhāgena aṣṭadhā dṛśyate priye 
MBniruttaravadaHK-230	mūlaṃ daṇḍaṃ tathā śākhāṃ patraṃ puṣpaṃ tathaiva ca |	mūlam daṇḍam tathā śākhām patram puṣpam tathā eva ca 
MBniruttaravadaHK-231	phalaṃ bījaṃ tathā snehaṃ paśyanti tilasaṃmatam || 11 ||	phalam bījam tathā sneham paśyanti tila saṃmatam 
MBniruttaravadaHK-232	p. 103a) sarvaṃ pralīyate bīje bījaṃ de?hānuvartinam |	sarvam pralīyate bīje bījam deha anuvartinam 
MBniruttaravadaHK-233	evaṃ puryaṣṭake devi śivaṃ māyā vinaṃvibhum || 12 ||	evam puryaṣṭake devi śivam 
MBniruttaravadaHK-234	niśśeṣamakhilaṃ devi vyāptireṣā śivecchayā |	niśśeṣam akhilam devi vyāptiḥ eṣā śiva icchayā 
MBniruttaravadaHK-235	śivaṃ sarvagataṃ dhyātvā icchāvecchāntarālinam || 13 ||	śivam sarva gatam dhyātvā 
MBniruttaravadaHK-236	iti śrīparamarahasye niruttaravāde bhairavasrotasi pa * śa * tṛtīyoddeśaḥ || ||	iti śrī parama rahasye niruttara vāde bhairava srotasi pa śa  tṛtīya uddeśaḥ 
MBniruttaravadaHK-237	paśupānaṃ na caivāsti prokṣaṇaṃ samayaṃ tathā |	paśu pānam na ca eva asti prokṣaṇam samayam tathā 
MBniruttaravadaHK-238	ācāreṇa tu kiṃ kāryaṃ ke pāśāḥ kaḥ paśuḥ smṛtaḥ || 1 ||	ācāreṇa tu kim kāryam ke pāśāḥ kaḥ paśuḥ smṛtaḥ 
MBniruttaravadaHK-239	śrībhairava uvāca	śrī bhairavaḥ uvāca 
MBniruttaravadaHK-240	yāvadajñānabhedosti bhavapāśāstadutthitāḥ |	yāvat ajñāna bhedaḥ osti bhava pāśāḥ tad utthitāḥ 
MBniruttaravadaHK-241	jñātvā jñeyaṃ gurusthānāt sākṛnnirchanti lakṣaṇam || 2 ||	jñātvā jñeyam guru sthānāt sākṛt nirchanti lakṣaṇam 
MBniruttaravadaHK-242	p. 103b) tatraiva kāle yuktātmā pāśamukto yathā khagaḥ |	tatra eva kāle yukta ātmā pāśa muktaḥ yathā khagaḥ 
MBniruttaravadaHK-243	pralīyati tadābhyāsāt snehavarti kṣayāntare || 3 ||	pralīyati tadā abhyāsāt sneha varti kṣaya antare 
MBniruttaravadaHK-244	sutaptāyāsabhāṇḍeṣu kṣipejjalakaṇānvahūn |	su tapta āyāsa bhāṇḍeṣu kṣipet jala kaṇān vahūn 
MBniruttaravadaHK-245	patitāḥ pralayaṃ yānti tadvachūnye cidātmakam || 4 ||	patitāḥ pralayam yānti tadvat śūnye cit ātmakam 
MBniruttaravadaHK-246	yathādhamojjvalaṃ loha visphuliṅgānvitaṃ mahat |	yathā adhama ujjvalam visphuliṅga anvitam mahat 
MBniruttaravadaHK-247	dhāmaniryāsakāle tu kramācchītalatāṃ vrajet || 5 ||	dhāma niryāsa kāle tu kramāt śītala tām vrajet 
MBniruttaravadaHK-248	yadvannirāmaye sthāne yatrarūpaṃ na vidyate |	yadvat nirāmaye sthāne yatra rūpam na vidyate 
MBniruttaravadaHK-249	śāntendha na śikhāṃ yadvat pradīptastatra līyate || 6 ||	śānta indha na śikhām yadvat pradīptaḥ tatra līyate 
MBniruttaravadaHK-250	bhasmakīṭātpramucyeta pāvako naiva dṛśyate |	bhasma kīṭāt pramucyeta pāvakaḥ nā eva dṛśyate 
MBniruttaravadaHK-251	sauṣumṇe indriyāartheṣu nopalabdhiḥ pradṛśyate || 7 ||	sauṣumṇe indriya aartheṣu na upalabdhiḥ pradṛśyate 
MBniruttaravadaHK-252	tadvacchivaṃ samārambhe na kiñcidupalabhyate |	tadvat śivam samārambhe na kiñcid upalabhyate 
MBniruttaravadaHK-253	p. 104a) vṛddhakāle tu bālatvaṃ piṇḍasthosya na dṛśyate || 8 ||	vṛddha kāle tu bāla tvam piṇḍa sthaḥ usya na dṛśyate   
MBniruttaravadaHK-254	vilīnavṛtti niṣkrānte nirupādhi vaśānuśaḥ |	          
MBniruttaravadaHK-255	sarvaṃ vyomārṇave līnaṃ na kiñcidapi cintayet || 9 ||	sarvam vyomārṇave līnam na kiñcid api cintayet 
MBniruttaravadaHK-256	na kiñciccintanāt so hi na muhyati na naśyati |	na kiñcid cintanāt saḥ hi na muhyati na naśyati 
MBniruttaravadaHK-257	vyomākāraṃ sadābhāve tadbhāvabhāvanāśanam || 10 ||	vyoma ākāram sadā abhāve tad bhāva bhāva nāśanam 
MBniruttaravadaHK-258	ahaṅkāravaśātkṣīṇe nirabhrogagano yathā |	ahaṅkāra vaśāt kṣīṇe nirabhraḥ gaganaḥ yathā 
MBniruttaravadaHK-259	muktaścarati yuktātmā māruto gagane yathā || 11 ||	muktaḥ carati yukta ātmā mārutaḥ gagane yathā 
MBniruttaravadaHK-260	na tasya lopā vidyante kṣīṇacittānvitasya ca |	na tasya lopāḥ vidyante kṣīṇa citta anvitasya ca 
MBniruttaravadaHK-261	ka *? mala kavanmuktiḥ pratyakṣamupalabhyate || 12 ||	ka mala kavat muktiḥ pratyakṣam upalabhyate   
MBniruttaravadaHK-262	muktirmuktiḥ punarmuktirna mukti piṇḍapātanam |	muktiḥ muktiḥ punarmuktiḥ na piṇḍapātanam 
MBniruttaravadaHK-263	ūrdhvotkrāntiṃ parityajya adhaḥ saṃpīḍanaṃ tathā || 13 ||	ūrdhva utkrāntim parityajya adhas saṃpīḍanam tathā 
MBniruttaravadaHK-264	cakrabhedamanarthaṃ vai udghātaṃ mārutaissaha |	cakra bhedam anartham vai udghātam mārutaiḥ saha 
MBniruttaravadaHK-265	p. 104b) kliśyanti tena tatvajñaḥ kevalaṃ kāye śāsanam |	kliśyanti tena tatva jñaḥ kevalam kāye śāsanam 
MBniruttaravadaHK-266	akleśabhāve vijñānaṃ nityaṃ sarvagataṃ śivam || 15 ||	akleśa bhāve vijñānam nityam sarva gatam śivam 
MBniruttaravadaHK-267	śrīdevyuvāca	śrī devī uvāca 
MBniruttaravadaHK-268	bhrāmitā gahane deva bhrānti nirnāśanaṃ vada |	bhrāmitāḥ gahane deva bhrānti nirnāśanam vada 
MBniruttaravadaHK-269	vyomābhāsaṃ tvayā coktaṃ sthānoddeśena kiṃ ca vā || 16 ||	vyoma ābhāsam tvayā ca uktam sthāna uddeśena kim ca vā 
MBniruttaravadaHK-270	piṇḍastha padarūpeṇa rūpātītaṃ na kiṃ prabho |	piṇḍastha pada rūpeṇa rūpa atītam na kim prabho 
MBniruttaravadaHK-271	etanme saṃśayaṃ ghoramaghoravacanaṃ vada || 17 ||	etat me saṃśayam ghoram aghora vacanam vada 
MBniruttaravadaHK-272	śrībhairava uvāca	śrī bhairavaḥ uvāca 
MBniruttaravadaHK-273	mahāgranthi yutaṃ sthānaṃ mahāmāyā vimohitam |	mahā granthi yutam sthānam mahāmāyā vimohitam 
MBniruttaravadaHK-274	kāṇḍilīkulabhoktṛtvaṃ karmasthānā valī sthitam || 18 ||	kāṇḍilī kula bhoktṛ tvam karma sthānā valī sthitam 
MBniruttaravadaHK-275	ānandamātramātmānaṃ yāvaścecchā kulodbhavet |	ānanda mātram ātmānam yāvaḥ ca icchā kula udbhavet 
MBniruttaravadaHK-276	mucyamānaṃ tu taṃ sthānaṃ na yuktiriti niścayam || 19 ||	mucyamānam tu tam sthānam na yuktiḥ iti niścayam 
MBniruttaravadaHK-277	pada * *? ryaye kṣepi? aṣṭabhedāntarālinam |	pada kṣepi aṣṭa bheda antarālinam 
MBniruttaravadaHK-278	p. 105a) martyā?nandamayaṃ tacca icchāśaktiradhiṣṭhitam || 20 ||	             
MBniruttaravadaHK-279	icchāśaktiḥ śivelīnā padaṃ tasmāt parityajet |	icchā śaktiḥ śivā ilīnā padam tasmāt parityajet 
MBniruttaravadaHK-280	rūpasthamīśvaraṃ tatvaṃmavalambaṃ śivaṃ priye || 21 ||	rūpa stham īśvaram śivam priye 
MBniruttaravadaHK-281	arūpaṃ sarvataḥ kṣīṇaṃ gamāgamavivarjitam |	arūpam sarvatas kṣīṇam gama āgama vivarjitam 
MBniruttaravadaHK-282	nirbhrāntaṃ sarvanirmuktamagocara pade sthitam || 22 ||	nirbhrāntam sarva nirmuktam agocara pade sthitam 
MBniruttaravadaHK-283	caturdhā kathitaṃ mārgaṃ yāvat piṇḍasya lakṣaṇam |	caturdhā kathitam mārgam yāvat piṇḍasya lakṣaṇam 
MBniruttaravadaHK-284	naṣṭe dagdhātmake dehe kasya piṇḍaṃ padaṃ kramam || 23 ||	naṣṭe dagdha ātmake dehe kasya piṇḍam padam kramam 
MBniruttaravadaHK-285	yāvat piṇḍāntare dehī tāvad vijñāna lakṣaṇam |	yāvat piṇḍa antare dehī tāvat vijñāna lakṣaṇam 
MBniruttaravadaHK-286	pralīne śūnyamārgeṇa kuto dānaṃ kutaḥ kriyā || 24 ||	pralīne śūnya mārgeṇa kutas dānam kutas kriyā 
MBniruttaravadaHK-287	tāvat te caturo varṇā yāvat tatvaṃ na vindati |	tāvat te caturaḥ varṇāḥ yāvat tatvam na vindati 
MBniruttaravadaHK-288	viditesmin pare tatve sarve?vajīdvirgā?tayaḥ || 25 ||	vidite ismin pare ta tve sarva eva jī dvis gātayaḥ   
MBniruttaravadaHK-289	p. 105b) smṛtirūpā bhavecchaktirmana īśvara bhairavam |	smṛti rūpā bhavet śaktiḥ manaḥ īśvara bhairavam 
MBniruttaravadaHK-290	krodhaṃ kālāgni rudraṃ vai mohaṃ māyā tathā priye || 26 ||	krodham kālāgni rudram vai moham māyā tathā priye 
MBniruttaravadaHK-291	vṛtyācitya mayā ūrmī saṃbhogaṃ rudrakrīḍanam |	vṛtyā ācitya mayā ūrmī saṃbhogam rudra krīḍanam 
MBniruttaravadaHK-292	duḥkhaḥ saṃsārabhadhandānmaraṇaṃ? bhairavālaye || 27 ||	duḥkhaḥ saṃsāra bha dhandāt maraṇam bhairavālaye 
MBniruttaravadaHK-293	ṣāntaṃ? śīhā? tathā nanda maithunaṃ piṇḍasārathiḥ |	ṣāntam śīhā tathā nanda maithunam piṇḍasārathiḥ 
MBniruttaravadaHK-294	aṭanaṃ tu rathaṃ divyaṃ niṣṭhānta kālabhairavam || 28 ||	aṭanam tu ratham divyam niṣṭhānta kāla bhairavam 
MBniruttaravadaHK-295	yatkiñcit karmasaṅghātaṃ tatsarvaṃ śiva coditam |	yat kiñcid karma saṅghātam tat sarvam śiva coditam 
MBniruttaravadaHK-296	adṛṣṭavigrahāśaktiravyucchinna pravāhinī? || 29 ||	adṛṣṭa vigraha aśaktiḥ avyucchinna pravāhinī 
MBniruttaravadaHK-297	ubhayoḥ krīḍanārthāya saṃsthitirbhuvana traye |	ubhayoḥ krīḍana arthāya saṃsthitiḥ bhuvana traye 
MBniruttaravadaHK-298	pañce?cchā bhūtaratinī bhūtapañcakamālikā |	            
MBniruttaravadaHK-299	usvitā? pañca?rangaiśca? nānārūpaṃ vipadyate || 31 ||	pañca rangaiḥ ca nānā rūpam vipadyate 
MBniruttaravadaHK-300	p. 106a) nānātvaṃ bhedamutpannaṃ bhedāmantrānyanekaśaḥ |	nānātvam bhedam utpannam bheda amantrāni anekaśas 
MBniruttaravadaHK-301	mantrā hi devatānāma koṭī koṭirasaṅkhyayā || 32 ||	mantrāḥ hi devatā nāma koṭī koṭiḥ asaṅkhyayā 
MBniruttaravadaHK-302	pañcabhūtātmakaṃ viśvaṃ punaḥ pañcasulīyate |	pañcabhūta ātmakam viśvam punar 
MBniruttaravadaHK-303	pañcaite bhakṣayennityaṃ na pañcarahitaṃ kvacit || 33 ||	pañca ete bhakṣayet nityam na pañca rahitam kvacid 
MBniruttaravadaHK-304	pañcaraṅgena racitaṃ vicitrabhavasāgaram |	pañca raṅgena racitam vicitra bhava sāgaram 
MBniruttaravadaHK-305	ekatrapā?dataṃ sarvaṃ strīpumāṃstiyagyonayaḥ || 34 ||	sarvam 
MBniruttaravadaHK-306	auṣadhaṃ vividhaṃ ṛkṣaparvatāśca vanaspatīḥ |	auṣadham vividham ṛkṣa parvatāḥ ca vanaspatīḥ 
MBniruttaravadaHK-307	hradatīrtha nadī nadya udyānaṃ tṛṇagocaram || 35 ||	hradatīrtha nadī nadyaḥ udyānam tṛṇa gocaram 
MBniruttaravadaHK-308	sadṛśaṃ naiva dṛśyeta pañcabhūtā kriyā sadā |	sadṛśam na eva dṛśyeta pañca bhūtā kriyā sadā 
MBniruttaravadaHK-309	vaktre vaktrena sā dṛśyaṃ pituḥ putrasya bhāmini || 36 ||	vaktre vaktrena sā dṛśyam pituḥ putrasya bhāmini  /
MBniruttaravadaHK-310	mātā ca duhitā caiva bhrātaropyeka yonijāḥ |	mātā ca duhitā ca eva bhrātaraḥ api eka yoni jāḥ 
MBniruttaravadaHK-311	vṛkṣaṃ vakṣena sādṛśyaṃ toyaṃ toye tathaiva ca || 37 ||	vṛkṣam vakṣena sādṛśyam toyam toye tathā eva ca 
MBniruttaravadaHK-312	p. 106b) girikūṭe gireḥ kūṭamekarūpaṃ na dṛśyate |	giri kūṭe gireḥ kūṭam eka rūpam na dṛśyate 
MBniruttaravadaHK-313	nadī nadyānamādṛśyaṃ puṣpe puṣpaṃ tathāviduḥ || 38 ||	nadī nadyānam adṛśyam puṣpe puṣpam tathā viduḥ 
MBniruttaravadaHK-314	evaṃ pañcavidhaṃ mūle śivaśaktiradhiṣṭhitam |	evam pañcavidham mūle śiva śaktiḥ adhiṣṭhitam 
MBniruttaravadaHK-315	ramate jṛmbhate devo modate vadate kriyām || 39 ||	ramate jṛmbhate devaḥ modate vadate kriyām 
MBniruttaravadaHK-316	kvaciddāsya mayaṃ piṇḍaṃ kvacinnirdhana * *? tam |	kvacid dāsya mayam piṇḍam kvacid nirdhana tam 
MBniruttaravadaHK-317	kvacidvyādhi mayaṃ rudre kvaciddirghā * * * *?m || 40 ||	mayam rudre 
MBniruttaravadaHK-318	kvacidduśśīlatāṃ yāti suśīlatvaṃ? kvaci * *? m |	kvacid duśśīla tām yāti su śīla tvam 
MBniruttaravadaHK-319	kvacidvidyādharo rūpī kvacinmūrkha virūpiṇam? || 41 ||	kvacid vidyādharaḥ rūpī kvacid mūrkha virūpiṇam 
MBniruttaravadaHK-320	kvacit sarpaḥ kvacit kīṭaḥ kvacit pakṣī ca vānara |	kvacid sarpaḥ kvacid kīṭaḥ kvacid pakṣī ca vānara 
MBniruttaravadaHK-321	nā?cidraviśaśītejaḥ kvacinmaraṇajīvitaḥ || 42 ||	na acit ravi śaśī tejaḥ kvacid maraṇa jīvitaḥ 
MBniruttaravadaHK-322	evaṃ bahuvidhaṃ cittraṃ vicitraṃ bhūtapañjaram |	evam bahuvidham cittram vicitram bhūta pañjaram 
MBniruttaravadaHK-323	p. 107a) pañcabhūtavibhāgena avibhāgena cetasā || 43 ||	pañcabhūta vibhāgena avibhāgena cetasā  
MBniruttaravadaHK-324	yena jñātaṃ *? yo * *? hyanyathā paśubandhanaḥ |	yena jñātam yaḥ hi anyathā paśu bandhanaḥ 
MBniruttaravadaHK-325	śuddhāśuddhaṃ na va * * * * * * * *? sthitaḥ || 44 ||	śuddha aśuddham na             
MBniruttaravadaHK-326	ekataḥ sarvabhāvānāmekataḥ paramārthataḥ |	ekatas sarva bhāvānām ekatas paramārthataḥ 
MBniruttaravadaHK-327	ekato brahmapadavī eko *?va umāpatiḥ || 45 ||	ekatas brahma padavī ekaḥ vaḥ umāpatiḥ 
MBniruttaravadaHK-328	brahmasarvamayabhadre jñātavyaṃ niścayātmakam || 46 ||	brahma sarva maya bhadre jñātavyam niścaya ātmakam 
MBniruttaravadaHK-329	jñeyaṃ jñāte bhavenmuktiranyathā bhavabandhanam |	jñeyam jñāte bhavet muktiḥ anyathā bhava bandhanam 
MBniruttaravadaHK-330	na yajñadānadātṛtvairna tīrthagamanena ca || 47 ||	na yajña dāna dātṛ tvaiḥ na tīrtha gamanena ca 
MBniruttaravadaHK-331	na ca vai bhṛgupātena na ca vahni jalāntare |	na ca vai bhṛgupātena na ca vahni jala antare 
MBniruttaravadaHK-332	na ca kṛcchrāti kṛcchreṇa na ca cāndrāyaṇena vā || 48 ||	na ca kṛcchrāti kṛcchreṇa na ca cāndrāyaṇena vā 
MBniruttaravadaHK-333	p. 107b) nirāhāreṇa muktiḥ syānnamuktiḥ piṇḍapātane |	nirāhāreṇa muktiḥ syāt na muktiḥ piṇḍapātane 
MBniruttaravadaHK-334	niśā?yā * *? cittaṃ nirudvegaṃ sadākuru || 49 ||	         
MBniruttaravadaHK-335	aṣṭatītamayaṃ pi * * * * *? samanvitam |	aṣṭatīta mayam        
MBniruttaravadaHK-336	sanghe? hatapapīṭhādyairaṣṭa? * * *? bhitaṃ kulam || 50 ||	sanghe hatapa pīṭha ādyaiḥ aṣṭa kulam 
MBniruttaravadaHK-337	nāgāṣṭakagrahai yuktaṃ digaṣṭakavirūpitam |	nāga aṣṭaka grahaiḥ yuktam diś aṣṭaka virūpitam 
MBniruttaravadaHK-338	vāma?dakṣiṇamadhyasthaṃ kulakaulāntarālinam || 51 ||	vāma dakṣiṇa madhya stham kula kaula antarālinam 
MBniruttaravadaHK-339	tri triṃśatkoṭi devāḍhya * * *?cchivalī kṛtam |	kṛtam 
MBniruttaravadaHK-340	sarvaṃ dehānna *? līnaṃ yadhoktaṃ pūrvacoditam || 52 ||	sarvam dehāt na līnam yadhā uktam pūrva coditam 
MBniruttaravadaHK-341	svaliṅgaṃ pūjayennityamavikāreṇa yogavit |	sva liṅgam pūjayet nityam avikāreṇa yoga vid 
MBniruttaravadaHK-342	yaṃ yaṃ bhogāvṛtaṃ cittaṃ taṃ taṃ manasi dāpayet || 53 ||	yam yam bhoga āvṛtam cittam tam tam manasi dāpayet 
MBniruttaravadaHK-343	tasya tasya ca bhāvena śāntaṃ śānta manusmaret |	tasya tasya ca bhāvena śāntam śānta manusmaret 
MBniruttaravadaHK-344	tasya tasya na cotpatti kharūpī sarvato mukhaḥ || 54 ||	tasya tasya na ca utpatti kharūpī sarvatas mukhaḥ 
MBniruttaravadaHK-345	p. 108a) sa śivaḥ keśavatdaiva? sa brahmā sūrya eva ca |	sa śivaḥ sa brahmā sūryaḥ eva ca 
MBniruttaravadaHK-346	hṛtāśano yamaḥ so hi darśanādaghanāśanaḥ || 55 ||	hṛta aśanaḥ yamaḥ saḥ hi darśanāt agha nāśanaḥ 
MBniruttaravadaHK-347	sparśanānmucyate tasya yatra brahmavidaḥ smṛtāḥ |	sparśanāt mucyate tasya yatra brahma vidaḥ smṛtāḥ 
MBniruttaravadaHK-348	sa?dehaḥ śuddhi māyāti kiṃ? punarnikaṭānvitam || 56 ||	sa dehaḥ mā āyāti kim punar nikaṭa anvitam 
MBniruttaravadaHK-349	ālāpāṅgātrasaṃsparśānmocayet pāvakaughahā |	ālāpa aṅga ātra saṃsparśāt mocayet pāvaka ogha hā 
MBniruttaravadaHK-350	iti  śrī  ra * sye * de * *? si pa sa rṇa caturtha uddeśaḥ || 4 ||	iti śrī ra sye de   si pa sa rṇa caturthaḥ uddeśaḥ 
MBniruttaravadaHK-351	śrīdevyuvāca	śrī devī uvāca 
MBniruttaravadaHK-352	niścitaṃ sarvato deva mahābhavavināśanam |	niścitam sarvatas deva mahā bhava vināśanam 
MBniruttaravadaHK-353	sā * *? hṛdi me grāhyaṃ hyagrāhyaṃ paśu bhārataḥ? || 1 ||	sā hṛdi me grāhyam hi agrāhyam paśu bhārataḥ   
MBniruttaravadaHK-354	jñātavyaṃ parama *? vaṃ śūnyānyaṃ śūnyasaṃbhavam |	jñātavyam parama śūnya anyam śūnya saṃbhavam 
MBniruttaravadaHK-355	p. 108b) kasyecchā trividhe kāle dṛśyate ca hyanekadhā || 2 ||	kasya icchā trividhe kāle dṛśyate ca hi anekadhā 
MBniruttaravadaHK-356	śivātmakamidaṃ sarvaṃ śivo devo na dānyathā |	śiva ātmakam idam sarvam śivaḥ devaḥ na 
MBniruttaravadaHK-357	tasya bhedaṃ kathaṃ deva dṛśyate bhuvana trayaṃ || 3 ||	tasya bhedam katham deva dṛśyate bhuvana trayam 
MBniruttaravadaHK-358	nānātvaṃ gahanaṃ nātha mantratantrārtha codanāt |	nānātvam gahanam nātha mantra tantra artha codanāt 
MBniruttaravadaHK-359	nagrahaṃ nigrahaṃ krū?raṃ bhaktirvā śāṭhyameva vā || 4 ||	nagraham nigraham krūram bhaktiḥ vā śāṭhyam eva vā 
MBniruttaravadaHK-360	mṛteti saṃjñā ka?syaivaṃ ko vā nirjīvatāṃ gataḥ |	mṛta iti saṃjñā kasya evam kaḥ vā nirjīva tām gataḥ 
MBniruttaravadaHK-361	mṛtyusaṃhārakasyaivaṃ kovāmṛtyustvayādhikaḥ || 5 ||	mṛtyu saṃhārakasya evam kaḥ vā amṛtyuḥ tvayā adhikaḥ 
MBniruttaravadaHK-362	kenāsau prerayennātha kasyārthe maraṇaṃ dhruvam |	kena asau prerayet nātha kasya arthe maraṇam dhruvam 
MBniruttaravadaHK-363	nityoditasya devasya kasya buddhi?kṣayo bhavet || 6 ||	nityoditasya devasya kasya buddhi kṣayaḥ bhavet 
MBniruttaravadaHK-364	ekībhāvātma bhāvasya viruddhā vahu *? vanā |	ekībhāva ātma bhāvasya viruddhā vahu vanā 
MBniruttaravadaHK-365	śrībhairava uvāca	śrī bhairavaḥ uvāca 
MBniruttaravadaHK-366	pare śūnye tamo ghoraṃ tasyagacchanti ye mṛtāḥ |	pare śūnye tamaḥ ghoram ye mṛtāḥ 
MBniruttaravadaHK-367	sa devatāstathā tīrthā guhyāyatanasaṃsthitāḥ || 8 ||	sa devatāḥ tathā tīrthāḥ guhya āyatana saṃsthitāḥ 
MBniruttaravadaHK-368	p. 109a) parvatāśca nadī nadyo mahī?saptābdhi mekhalā |	parvatāḥ ca nadī nadyaḥ mahī sapta abdhi mekhalā 
MBniruttaravadaHK-369	sāgarā?vividhā bhūtā ye cānye krimisambhavāḥ || 9 ||	sāgarāḥ vividhāḥ bhūtāḥ ye ca anye krimi sambhavāḥ 
MBniruttaravadaHK-370	nāgā grahā *? hā dakṣāḥ khecarā bhūcarāstathā |	nāgāḥ grahāḥ hā dakṣāḥ khecarāḥ bhūcarāḥ tathā 
MBniruttaravadaHK-371	pīṭhopapīṭha sandoha nirjharānirjarāstathā || 10 ||	pīṭha upapīṭha sandoha nirjhara anirjarāḥ tathā 
MBniruttaravadaHK-372	granthī granthisahasrāṇi majjāmedhāsṛjaḥpalam |	granthī granthi sahasrāṇi majjā medhā asṛjaḥ palam 
MBniruttaravadaHK-373	mṛtadehasya piṇḍasya na kiñcidupalabhyate || 11 ||	mṛta dehasya piṇḍasya na kiñcid upalabhyate  /
MBniruttaravadaHK-374	sukhaṃ duḥkhaṃ na caivāsti ānandaṃ naiva bhāvanam |	sukham duḥkham na ca eva asti ānandam na eva bhāvanam 
MBniruttaravadaHK-375	jijñāsārahitaṃ sthānaṃ yatra devo nirākṛtiḥ || 12 ||	jijñāsā rahitam sthānam yatra devaḥ nirākṛtiḥ 
MBniruttaravadaHK-376	na kālakalanā heturnissaṅgasaṅgavarjitam |	na kāla kalanā hetuḥ nissaṅga saṅga varjitam 
MBniruttaravadaHK-377	nirālambaṃ na cotsāhaṃ śūnyabhūtaṃ śivātmakam || 13 ||	nirālambam na ca utsāham śūnya bhūtam śiva ātmakam 
MBniruttaravadaHK-378	saṃjñānāśena nirjīvaṃ sā sajñā vyomarūpiṇī |	saṃjñā nāśena nirjīvam sā sajñā vyoma rūpiṇī 
MBniruttaravadaHK-379	kṣubdhāśūnyālayāsaṃjñā tasmāt piṇḍaṃ prapadyate || 14 ||	kṣubdhā a śūnya ālaya a saṃjñā tasmāt piṇḍam prapadyate 
MBniruttaravadaHK-380	p. 109b) piṇḍajjñānopalabdhiṃ ca bodhimātreṇa saṃviśet |	piṇḍa jñāna upalabdhim ca bodhi mātreṇa saṃviśet 
MBniruttaravadaHK-381	akṣubdharūpanityasthā vyomābhāsā kulāntavit || 15 ||	             
MBniruttaravadaHK-382	akulasya sa sarvatra dṛśyate na ca dṛśyate |	akulasya sa sarvatra dṛśyate na ca dṛśyate 
MBniruttaravadaHK-383	nirbhrāntaṃ yena vā jñātaṃ tena jñātaṃ tu bhairavam || 16 ||	nirbhrāntam yena vā jñātam tena jñātam tu bhairavam 
MBniruttaravadaHK-384	yathā dhūmāvaliprāntaṃ kṣīṇaṃ dṛśyennabhontare |	yathā dhūma āvali prāntam kṣīṇam dṛśyet nabhaḥ ntare 
MBniruttaravadaHK-385	nirā?kṛti vilīnāsā tadvaddehī nabho pamaḥ || 17 ||	nirākṛti tadvat dehī pamaḥ 
MBniruttaravadaHK-386	saṃpūrṇato yaṃ mṛtviṇḍamevātraiva tu mardi?tam |	saṃpūrṇataḥ yam mṛtvā iṇḍam eva atra eva tu marditam 
MBniruttaravadaHK-387	śanaiḥ śanaista tasyaiva pariśeṣaḥ pravartate || 18 ||	śanais tasya eva pariśeṣaḥ pravartate 
MBniruttaravadaHK-388	na? jalaṃ bhāvyate? kiñcit tad vad dehī kulāntare |	na jalam bhāvyate kiñcid tat vat dehī kula antare 
MBniruttaravadaHK-389	cidarthavi?bhavaṃ sarvaṃ jñānamajñānagocaram || 19 ||	cit artha vibhavam sarvam jñānam ajñāna gocaram 
MBniruttaravadaHK-390	nirālambapade śūnye sarvārambhavivarjite |	nirālamba pade śūnye sarva ārambha vivarjite 
MBniruttaravadaHK-391	svasthire parame dhāmni śivaśakti layāntare || 20 ||	sva sthire parame dhāmni śiva śakti laya antare 
MBniruttaravadaHK-392	p. 110a) nirnāmaviṣayātīte janmamṛtyu vivarjite |	nirnāma viṣaya atīte janma mṛtyu vivarjite 
MBniruttaravadaHK-393	tatra yāti idaṃ viśvaṃ yatkiñcit pāñcabhautikam || 21 ||	tatra yāti idam viśvam yat kiñcid pāñcabhautikam 
MBniruttaravadaHK-394	niṣprapañcaḥ le?pāḍhyaṃ sthiraṃ caiva malaṃ dhruvam |	niṣprapañcaḥ lepa āḍhyam sthiram ca eva malam dhruvam 
MBniruttaravadaHK-395	ekadā bahurūpeṇa bhairavāṣṭāṣṭa cāṣṭakam || 22 ||	ekadā bahu rūpeṇa bhairava aṣṭa aṣṭa ca aṣṭakam 
MBniruttaravadaHK-396	khecarī bhūcarī caiva gocarī śākinī tathā |	khecarī bhūcarī ca eva gocarī śākinī tathā 
MBniruttaravadaHK-397	kiṅkarāgaṇagandharvā ṛṣayopsarasastathā || 23 ||	kiṅkarā gaṇa gandharvāḥ ṛṣayaḥ upsarasaḥ tathā 
MBniruttaravadaHK-398	auṣadhāstu dhātuṇḍāśca pañcalohāśca sambhavāḥ |	auṣadhāḥ tu dhātuṇḍāḥ ca pañcalohāḥ ca sambhavāḥ 
MBniruttaravadaHK-399	kinnarā bhūpiśācāśca krimikīṭasarīsṛpāḥ || 24 ||	kinnarāḥ bhū piśācāḥ ca krimi kīṭa sarīsṛpāḥ 
MBniruttaravadaHK-400	pañcabhūtā mahābhūtāstatvāḥ ṣaṭtriṃśasaṃkhyayā |	pañcabhūtāḥ mahābhūtāḥ tatvāḥ ṣaṭtriṃśa saṃkhyayā 
MBniruttaravadaHK-401	tathā cāṣṭottara śataṃ ta?tva tattvāntarālinam || 25 ||	tathā ca aṣṭottara śatam tattva antarāliṇam 
MBniruttaravadaHK-402	mūlaṃ dhātustathā bījaṃ śūnyaṃ caivāpyaśūnyataḥ |	mūlam dhātuḥ tathā bījam śūnyam ca eva api a śūnyatas 
MBniruttaravadaHK-403	evaṃ saṃsāravibhavaṃ satkṛtaṃ hyumayāmaha || 26 ||	evam saṃsāra vibhavam satkṛtam hi umayā amaha 
MBniruttaravadaHK-404	vicarāmi na ekākī kadācicchūnyarūpatā |	vicarāmi na ekākī kadācid śūnya rūpa tā 
MBniruttaravadaHK-405	p. 110b) sarvaṃ sarvamayaṃ cāhaṃ tatra madhye tvayāmaha || 27 ||	sarvam sarva mayam ca aham tatra madhye 
MBniruttaravadaHK-406	kadācidīdṛśaṃ? viśvaṃ dṛśyate paramātmani |	kadācid īdṛśam viśvam dṛśyate paramātmani 
MBniruttaravadaHK-407	sarvaṃ sa?marasaghoraṃ śaktisaṅgamasāgaram || 28 ||	sarvam samarasa ghoram śakti saṅgama sāgaram 
MBniruttaravadaHK-408	tvadīyakṣobhamātreṇa corthitaṃ viśvagolakam |	tvadīya kṣobha mātreṇa ca ūrthitam viśva golakam 
MBniruttaravadaHK-409	yadā palīyate dvābhyāṃ viśvaṃ na saha bhāmini || 29 ||	yadā palīyate dvābhyām viśvam na saha bhāmini 
MBniruttaravadaHK-410	yadā śūnyaṃ nirālambhaṃ na kiñcidapi cintayet |	yadā śūnyam nirālambham na kiñcid api cintayet 
MBniruttaravadaHK-411	na kiñciccintanāddevi na naśyati na muhyati || 30 ||	na kiñcid cintanāt devi na naśyati na muhyati 
MBniruttaravadaHK-412	tatra sthāne na cānande na śaktiḥ śivameva ca |	tatra sthāne na ca ānande na śaktiḥ śivam eva ca 
MBniruttaravadaHK-413	nopalabdhirna caivāsti nā bhāva na? vikalpanā || 31 ||	na upalabdhiḥ na ca eva asti nā bhāva na vikalpanā 
MBniruttaravadaHK-414	kevalaṃ śūnyatā nādaṃ dvitīyo nāsti niścayaḥ || 32 ||	kevalam śūnyatā na adam dvitīyaḥ nā asti niścayaḥ 
MBniruttaravadaHK-415	p. 111a) etadrahasyaṃ kathitaṃ deva dānavagopitam |	etat rahasyam kathitam deva dānava gopitam 
MBniruttaravadaHK-416	śukrasya noditaṃ pūrvamasurārthaṃ na bodhake || 33 ||	śukrasya na uditam pūrvam asura artham na bodhake  
MBniruttaravadaHK-417	kasya dīkṣā bhaveddeva kasya vā śodhayet kulam |	kasya dīkṣā bhavet deva kasya vā śodhayet kulam 
MBniruttaravadaHK-418	sarvatra saṃsthitohīśaḥ kaśśodhyaḥ kaśca siddhyati || 34 ||	sarvatra saṃsthitaḥ uhi īśaḥ kaḥ śodhyaḥ kaḥ ca siddhi ati 
MBniruttaravadaHK-419	pāśabandhaṃ na caivāsti samayācāralakṣaṇam |	pāśa bandham na ca eva asti samayācāra lakṣaṇam 
MBniruttaravadaHK-420	guruśiṣya krameṇātha kiṃ kāryaṃ kiṃ prayojanam || 35 ||	guru śiṣya krameṇa atha kim kāryam kim prayojanam 
MBniruttaravadaHK-421	bhrāntimutpādyate deva bhrāmitāṃhaṃ tu śaṅkara || 36 ||	bhrāntim utpādyate deva bhrāmita aṃham tu śaṅkara 
MBniruttaravadaHK-422	vikalpakṣīṇacittasya kiṃ dīkṣā kasya kāraṇam |	vikalpa kṣīṇa cittasya kim dīkṣā kasya kāraṇam 
MBniruttaravadaHK-423	sa vikalpasya jantośca jatrasya samalasya ca || 37 ||	sa vikalpasya jantoḥ ca jatrasya sa malasya ca 
MBniruttaravadaHK-424	rajaraṅgādi kā dīkṣā tasya bhāvaniśeśakam |	             
MBniruttaravadaHK-425	p. 111b) bhāvametā dṛśaṃ kṛtvā yā dṛśaṃ kathitaṃ tava || 38 ||	bhāvam etāḥ dṛśam kṛtvā yāḥ dṛśam kathitam tava   
MBniruttaravadaHK-426	dhyānaṃ pūjādikaṃ japyaṃ homāntaṃ nyāsameva ca |	dhyānam pūjā ādikam japyam homa antam nyāsam eva ca 
MBniruttaravadaHK-427	āhvānakāraṇaṃ sthānamārurukṣuṣu darśayet || 39 ||	āhvāna kāraṇam sthānam ārurukṣuṣu darśayet 
MBniruttaravadaHK-428	darśanādbhavate mokṣaḥ sarvago hi nirāmayaḥ |	darśanāt bhavate mokṣaḥ sarvagaḥ hi nirāmayaḥ 
MBniruttaravadaHK-429	dhyāna pūjādikaṃ tacca sarvaṃ saṅkalpasaṃbhavam || 40 ||	dhyāna pūjā ādikam tat ca sarvam saṅkalpa saṃbhavam 
MBniruttaravadaHK-430	saṅkalpa rahitā dīkṣā sā dīkṣādīkṣitā bhavet |	saṅkalpa rahitā dīkṣā sā dīkṣādīkṣitā bhavet 
MBniruttaravadaHK-431	bhāvābhāvavinirmuktaṃ muktācāreṇasañcaret || 41 ||	bhāva abhāva vinirmuktam mukta ācāreṇa sañcaret 
MBniruttaravadaHK-432	yuktigūḍhaṃ paraṃ cānyaṃ janākliṣyanti cānyathā |	yukti gūḍham param ca anyam jana ākliṣyanti ca anyathā 
MBniruttaravadaHK-433	anyathā śāstra pāṇḍityaṃ vedagarveṣu garvitāḥ || 42 ||	anyathā veda garveṣu garvitāḥ 
MBniruttaravadaHK-434	anyathā nistaraṅgātmā lokāḥ kliṣyanti cānyathā |	anyathā nistaraṅga ātmā lokāḥ kliṣyanti ca anyathā 
MBniruttaravadaHK-435	p. 112a) anyathā hyopadeśaṃ tu bhrānti yuktāstathānyathā || 43 ||	anyathā hi upadeśam tu bhrānti yuktāḥ tathā anyathā 
MBniruttaravadaHK-436	anyathā bhāvanādārḍhyaṃ kṛtvādārḍhyaṃ tu cānyathā |	anyathā bhāvanā dārḍhyam kṛtvā dārḍhyam tu ca anyathā 
MBniruttaravadaHK-437	anyathā paramāśaktirlokāḥ kliśyanti cānyathā || 44 ||	anyathā parama aśaktiḥ lokāḥ kliśyanti ca anyathā 
MBniruttaravadaHK-438	vāgvitaṇḍaṃ ca saṃskāraṃ tyajecchabdārthasīmasam |	vāc vitaṇḍam ca saṃskāram tyajet śabda artha sīmasam 
MBniruttaravadaHK-439	na tarkaṃ trāṇamityāhustrāṇārthaṃ paramaṃ śivam || 45 ||	na tarkam trāṇam iti āhuḥ trāṇa artham paramam śivam 
MBniruttaravadaHK-440	advaitaṃ caraternityaṃ dvaitaliṅgamacetanam |	advaitam carateḥ nityam dvaita liṅgam acetanam 
MBniruttaravadaHK-441	dhātu dārumayaṃ liṅgaṃ pāṣāṇorthaṃ tu hemajam || 46 ||	dhātu dāru mayam liṅgam pāṣāṇa ūrtham tu hema jam 
MBniruttaravadaHK-442	na caiva mṛṇmayaṃ devi maṇijaṃ sphaṭikādijam |	na ca eva mṛṇmayam devi maṇi jam sphaṭika ādi jam 
MBniruttaravadaHK-443	na cātra kurute trāṇaṃ caitanyasya acetanam || 47 ||	na ca atra kurute trāṇam caitanyasya acetanam 
MBniruttaravadaHK-444	sarvathā bhāvayelliṅgaṃ yasya līnaṃ carācaram |	sarvathā bhāvayet liṅgam yasya līnam carācaram 
MBniruttaravadaHK-445	p. 112b) advaitabhāvaṃ deveśi trāṇārthaṃ sarvato bhavet || 48 ||	advaita bhāvam deveśi trāṇa artham sarvatas bhavet  /
MBniruttaravadaHK-446	janmajanmāntarābhyāsādvijñānaṃ labhate sphuṭam |	janma janma antara abhyāsāt vijñānam labhate sphuṭam 
MBniruttaravadaHK-447	vināvijñānasaundaryāt guruṇājñāpito yadā || 49 ||	vinā a vijñāna saundaryāt guruṇā ājñāpitaḥ yadā 
MBniruttaravadaHK-448	tadāsau labhate mokṣamanyathā bhramaṇādbhayam |	tadā asau labhate mokṣam anyathā bhramaṇāt bhayam 
MBniruttaravadaHK-449	advaitaṃ sādhayennityaṃ sarvāvasthaṃ śivātmakam || 50 ||	advaitam sādhayet nityam sarva avastham śiva ātmakam 
MBniruttaravadaHK-450	advaitaṃ paramaṃ dharmamadvaitaṃ paramaṃ padam |	advaitam paramam dharmam advaitam paramam padam 
MBniruttaravadaHK-451	advaitaṃ suthiraṃ mokṣamadvaitaṃ bhogalakṣaṇam || 51 ||	advaitam su thiram mokṣam advaitam bhoga lakṣaṇam 
MBniruttaravadaHK-452	advaitaṃ sopadeśaṃ tu advaitaṃ kulajākulam |	advaitam sa upadeśam tu advaitam kulaja ākulam 
MBniruttaravadaHK-453	dvaitādvaitavidhirnāsti praviśecchāmbhave pade || 52 ||	dvaita advaita vidhiḥ na asti praviśet śāmbhave pade 
MBniruttaravadaHK-454	samaṃ sarvagataṃ śūnyaṃ bhāvyate vastu sādhanam |	samam sarva gatam śūnyam bhāvyate vastu sādhanam 
MBniruttaravadaHK-455	yadyapi syān mahādvaitaṃ dvaitaṃ vande kulāraṇī || 53 ||	yadi api syāt mahādvaitam dvaitam vande kula araṇī 
MBniruttaravadaHK-456	p. 113a) gurumagniṃ tathā mantraṃ vibhāgaparikalpanā |	gurum agnim tathā mantram vibhāga parikalpanā 
MBniruttaravadaHK-457	eṣāṃ madhye na cādvaitametacchāstrasya nirṇayam || 54 ||	eṣām madhye na ca advaitam etad śāstrasya nirṇayam 
MBniruttaravadaHK-458	yasmānnāmāni saṃlakṣya upadeśāni yāni ca |	yasmāt nāmāni saṃlakṣya upadeśāni yāni ca 
MBniruttaravadaHK-459	nāmaparyaṅkabhedena ekatvaṃ caivamekadhā || 55 ||	nāma paryaṅka bhedena eka tvam ca evam ekadhā 
MBniruttaravadaHK-460	bhramanti paśavaḥ sarve ye cānye gurutalpagāḥ |	bhramanti paśavaḥ sarve ye ca anye guru talpa gāḥ 
MBniruttaravadaHK-461	bhramanti jñānasandigdhā ajñānapadamohitāḥ || 56 ||	bhramanti jñāna sandigdhāḥ ajñāna pada mohitāḥ 
MBniruttaravadaHK-462	na jñāsyanti paraṃ sthānaṃ yena mukti prabandhanam |	na jñāsyanti param sthānam yena mukti prabandhanam 
MBniruttaravadaHK-463	kecidvadanti haṃsosau kecit praṇavaprāṇinam || 57 ||	kecid vadanti haṃsaḥ usau kecid praṇava prāṇinam 
MBniruttaravadaHK-464	kecidbinduṃ tathā nādaṃ kecicchakti parāmṛtam |	kecid bindum tathā nādam kecid śakti para amṛtam 
MBniruttaravadaHK-465	kecicchaktiparānandaṃ paraṃ bhāvaṃ bhajantite || 58 ||	kecid śakti para ānandam param bhāvam bhajanti te 
MBniruttaravadaHK-466	p. 113b) pañcaśūnyātmakaṃ kecit kecicchabdalayādikam |	pañca śūnya ātmakam kecid kecid śabda laya ādikam 
MBniruttaravadaHK-467	kecicchaivaṃ tathā daivaṃ kecijjyotistu golakam || 59 ||	kecid śaivam tathā daivam kecid jyotiḥ tu golakam 
MBniruttaravadaHK-468	ṣaḍūrmi rahitaṃ kecit ghaṇṭikāgraṃ tathā pare |	rahitam kecid ghaṇṭikā agram tathā pare 
MBniruttaravadaHK-469	kecit mātṛkalābindu asparśonādatastathā || 60 ||	kecid mātṛ kalā bindu asparśaḥ ūnādataḥ tathā 
MBniruttaravadaHK-470	kecidindriya hīnaṃ tu kecit sarvendriyaiḥ saha |	kecid indriya hīnam tu kecid sarva indriyaiḥ saha 
MBniruttaravadaHK-471	kecidvadanti cātmānaṃ paramātmani saṃsthitam || 61 ||	kecid vadanti ca ātmānam parama ātmani saṃsthitam 
MBniruttaravadaHK-472	prakṛtiḥ puruṣaṃ kecit kecit ṣaḍvidhameva ca |	prakṛtiḥ puruṣam kecid kecid ṣaḍvidham eva ca 
MBniruttaravadaHK-473	kecit prāṇaṃ tathā buddhiḥ keciddhairaṇyameva ca || 62 ||	kecid prāṇam tathā buddhiḥ kecid hairaṇyam eva ca 
MBniruttaravadaHK-474	kecijjvalanasaṅkāsaṃ keciccādityasannibham |	kecid jvalana saṅkāsam kecid ca āditya sannibham 
MBniruttaravadaHK-475	ūrṇātantu nibhaṃ kecit kecit khadyotameva ca || 63 ||	ūrṇā tantu nibham kecid kecid khadyotam eva ca 
MBniruttaravadaHK-476	p. 114a) kecit tat pratibhaṃ caiva kecit sphaṭikanirmalaṃ |	kecid tat pratibham ca eva kecid sphaṭika nirmalam 
MBniruttaravadaHK-477	kecidbālāgrabhāgaṃ tu keciddhra?māvalī prabham || 64 ||	kecid bāla agra bhāgam tu kecid hrama āvalī prabham 
MBniruttaravadaHK-478	kecicchāyāmayaṃ rūpaṃ kecit sūryanirākulam |	kecid chāyā mayam rūpam kecid sūrya nirākulam 
MBniruttaravadaHK-479	nirālamba sthitaṃ kecit kecidyajñaphalānvitam || 65 ||	nirālamba sthitam kecid kecid yajña phala anvitam 
MBniruttaravadaHK-480	nistaraṅgaṃ tathā kecit kecidābhogalakṣaṇam |	nistaraṅgam tathā kecid kecid ābhoga lakṣaṇam 
MBniruttaravadaHK-481	strīsukhāntāntikaṃ kecit kecinniṣṭhāntagocaram || 66 ||	strī sukha anta antikam kecid kecid niṣṭhānta gocaram 
MBniruttaravadaHK-482	bhramaṃ māyāyinaṃ kecit kecit sarvatravarjitam |	bhramam mā āyāyinam kecid kecid sarvatra varjitam 
MBniruttaravadaHK-483	lakṣaṇālakṣaṇaṃ kecit kecidicchāmanāmayam || 67 ||	lakṣaṇa alakṣaṇam kecid kecid icchām anāmayam 
MBniruttaravadaHK-484	ūṣṇībhāvaṃ tathā kecit kecidānandamutgalam |	ūṣṇībhāvam tathā kecid kecid ānanda mutgalam 
MBniruttaravadaHK-485	indriyārthasukhaṃ kecit keciccakrāntarālinam || 68 ||	indriya artha sukham kecid kecid cakra antarālinam 
MBniruttaravadaHK-486	dvādaśāntaparaṃ kecit kecitkhecakrabhūṣitam |	dvādaśānta param kecid kecid khecakra bhūṣitam 
MBniruttaravadaHK-487	anāhatamayaṃ kecit kecit ghoṣāntike padam || 69 ||	anāhata mayam kecid kecid ghoṣa antike padam 
MBniruttaravadaHK-488	ekātmānandinaṃ kecit kecinnairātmyavādinam |	eka ātma ānandinam kecid kecid nairātmya vādinam 
MBniruttaravadaHK-489	īśvarādyaṃ tathā kecit kecinneśvaravādinaḥ || 70 ||	īśvara ādyam tathā kecid kecid na īśvara vādinaḥ 
MBniruttaravadaHK-490	saṃpūrṇaṃ paramaṃ kecit kecinmantrākṣaraṃ param |	saṃpūrṇam paramam kecid kecid mantrākṣaram param 
MBniruttaravadaHK-491	pañcāśārṇa? mayaṃ kecit kecitkāśā?nalāntakam || 71 ||	pañcāśa arṇa mayam kecid kecid kāśa anala antakam 
MBniruttaravadaHK-492	helādolā mayaṃ kecit kecinnirbhrānti lakṣaṇam |	helā dolā mayam kecid kecid nirbhrānti lakṣaṇam 
MBniruttaravadaHK-493	sauṣuptarūpiṇaṃ kecit kecit turyāvalambanam || 72 ||	sauṣupta rūpiṇam kecid kecid turya avalambanam 
MBniruttaravadaHK-494	saguṇaṃ nirguṇaṃ kecit kecit pavanasannibham |	sa guṇam nirguṇam kecid kecid pavana sannibham 
MBniruttaravadaHK-495	sanatkā?nandatā kecit keciccaiva manāmayam || 73 ||	kecid kecid ca eva manāmayam 
MBniruttaravadaHK-496	p. 115a) nityānandaṃ tathā kecit kecit svātantryarūpiṇam |	nitya ānandam tathā kecid kecid svātantrya rūpiṇam 
MBniruttaravadaHK-497	kecit prabhāvanirmuktaṃ tattvaṃ tattveṣusaṃsthitam || 74 ||	kecid prabhāva nirmuktam tattvam tattva iṣu saṃsthitam 
MBniruttaravadaHK-498	kecinnārāyaṇo viṣṇurajaṃ kecidvadanti ca |	kecid nārāyaṇaḥ viṣṇuḥ ajam kecid vadanti ca 
MBniruttaravadaHK-499	kecidvai vāsudevasya jyotirūpaṃ sanātanam || 75 ||	kecid vai vāsudevasya jyotiḥ rūpam sanātanam 
MBniruttaravadaHK-500	kecid buddhaṃ tathā jñeyaṃ kecid vijñānameva ca |	kecid buddham tathā jñeyam kecid vijñānam eva ca 
MBniruttaravadaHK-501	kecichūnyaṃ tathā bhūtvā kecinnirvāṇameva ca || 76 ||	kecid śūnyam tathā bhūtvā kecid nirvāṇam eva ca 
MBniruttaravadaHK-502	dharmadhātustathā kecit trikālaparivartanam |	dharmadhātuḥ tathā kecid tri kāla parivartanam 
MBniruttaravadaHK-503	nityānandaṃ tathā kecit keciccaivamanāhatam || 77 ||	nitya ānandam tathā kecid kecid ca evam anāhatam 
MBniruttaravadaHK-504	kalpanā rahitaṃ kecit kecidbhāvaniyāminam |	kalpanāḥ rahitam kecid kecid bhāva niyāminam 
MBniruttaravadaHK-505	kecit praṇavamityuktaṃ kecit pratyakṣasaṃsthitam || 78 ||	kecid praṇavam iti uktam kecid pratyakṣa saṃsthitam 
MBniruttaravadaHK-506	p. 115b) kecidastīti nāstīti keciccobhayavarjitam |	kecid asti iti na asti iti kecid ca ubhaya varjitam 
MBniruttaravadaHK-507	īdṛśaṃ cedṛśaṃ kecit kecidānandataḥ sthitāḥ || 79 ||	īdṛśam ca īdṛśam kecid kecid ānandataḥ sthitāḥ 
MBniruttaravadaHK-508	kecid vibhustathā sākṣī kecit kṣetrajñameva ca |	kecid vibhuḥ tathā sākṣī kecid kṣetrajñam eva ca 
MBniruttaravadaHK-509	atītavyomakaṃ kecit kecicchuddhavivekajam || 80 ||	atīta vyomakam kecid kecid śuddha viveka jam 
MBniruttaravadaHK-510	taddharmadharmiṇī śaktiḥ kecidicchanti vādinam |	tad dharma dharmiṇī śaktiḥ kecid icchanti vādinam 
MBniruttaravadaHK-511	kecit *? kuṇḍalinī śaktirjanmasthānāvalambinī || 81 ||	kecid kuṇḍalinī śaktiḥ janmasthāna avalambinī 
MBniruttaravadaHK-512	śaktirvīrya balotsāhaṃ kaiścidbhāṣitamāparaḥ |	śaktiḥ vīrya bala utsāham kaiścid bhāṣitam āparaḥ 
MBniruttaravadaHK-513	janmasthāna gatā śaktistālurandhravisarpiṇī || 82 ||	janmasthāna gatā śaktiḥ tālu randhra visarpiṇī 
MBniruttaravadaHK-514	mātṛ tattvaṃ tathā kecit sarvadevopacaryate |	mātṛ tattvam tathā kecid sarvadā eva upacaryate 
MBniruttaravadaHK-515	candrārkavahnimadhyasthaṃ kecidbhāvita cetasaḥ || 83 ||	candra arka vahni madhya stham kecid bhāvita cetasaḥ 
MBniruttaravadaHK-516	p. 116a) keciccittaṃ tathā cetāḥ kecit kartāvidhīyate |	kecid cittam tathā cetāḥ kecid kartā avidhīyate 
MBniruttaravadaHK-517	evamādīni cānyāni koṭi bhedenasaṃsthitāḥ || 84 ||	evamādīni ca anyāni koṭi bhedena saṃsthitāḥ 
MBniruttaravadaHK-518	gaṇituṃ naiva śakyeta bahukoṭi śatairapi || 85 ||	gaṇitum na eva śakyeta śataiḥ api 
MBniruttaravadaHK-519	kena mārgeṇa tat grāhyaṃ sopadeśaṃ munirmalam |	kena mārgeṇa tat grāhyam sa upadeśam muniḥ malam 
MBniruttaravadaHK-520	viśrāmalakṣaṇaṃ brūhi saṅkhyābhedaṃ tyajenhara || 86 ||	viśrāma lakṣaṇam brūhi saṅkhyā bhedam 
MBniruttaravadaHK-521	graho nāsti na cotsargaṃ cittaṃ yatra na vidyate |	grahaḥ nā asti na ca utsargam cittam yatra na vidyate 
MBniruttaravadaHK-522	ānandapadasaṃprāptau nirānandapariplute || 87 ||	ānanda pada saṃprāptau nirānanda pariplute 
MBniruttaravadaHK-523	nirānandapade prāpte *? mādhirjanmahāriṇī |	nirānanda pade prāpte mādhiḥ janma hāriṇī 
MBniruttaravadaHK-524	na tasya nāmagotraṃ ca na jātirjanma eva ca || 88 ||	na tasya nāma gotram ca na jātiḥ janma eva ca 
MBniruttaravadaHK-525	na kālo bhavate cātra vicāryaṃ naiva dṛśyate |	na kālaḥ bhavate ca atra vicāryam nā eva dṛśyate 
MBniruttaravadaHK-526	yā dṛśaṃ bhavate vastu tādṛśena bhavet saha || 89 ||	yā dṛśam bhavate vastu tādṛśena bhavet saha 
MBniruttaravadaHK-527	p. 116b) dṛṅmanorucisaṅkalpayugabhāvojjhitāntaraḥ |	dṛś manaḥ ruci saṅkalpa yuga bhāva ujjhita antaraḥ 
MBniruttaravadaHK-528	labhate paramānanda pūrṇādhvāntakarānanām || 90 ||	labhate paramānanda pūrṇa adhva anta kara ānanām 
MBniruttaravadaHK-529	tatra tulyaṃ nāsti yasmāt tasmād vaktuṃ na śakyate |	tatra tulyam na asti yasmāt tasmāt vaktum na śakyate 
MBniruttaravadaHK-530	svaśāstrapālanārthāya jñānināṃ pravadanti ca || 91 ||	sva śāstra pālana arthāya jñāninām pravadanti ca 
MBniruttaravadaHK-531	sandehagahanaṃ tathyaṃ paśūnāṃ mokṣaṇe kṣamaḥ |	sandeha gahanam tathyam paśūnām mokṣaṇe kṣamaḥ 
MBniruttaravadaHK-532	labdhajñānena tajjñeyaṃ yo vindati sa paṇḍitaḥ || 92 ||	labdha jñānena tat jñeyam yaḥ vindati sa paṇḍitaḥ 
MBniruttaravadaHK-533	tasya buddhirmahāprāptiranyavaventarāṭakāḥ ||	tasya buddhiḥ mahāprāptiḥ 
MBniruttaravadaHK-534	iti śrīparamarahasye * * * *? de * ra * sro * vi * rga * u * de * ni * yo * ñca * ||	iti śrī paramarahasye 
MBniruttaravadaHK-535	samāptaṃ midaṃ niru *? ravadamiti śubham || ||	samāptam midam niḥ ravadam iti śubham 
MBniruttaravadaHK-536	MUKTABODHA INDOLOGICAL RESEARCH INSTITUTE©2011 Muktabodha Indological Research Institute  All Rights Reserved.E-texts may be viewed only online or downloaded for private study.E-texts may not, under any circumstances, be copied, republished,reproduced, distributed or sold, either in original or altered form, withoutthe express permission of Muktabodha Indological Research Institute in writing.Data-entered by the staff of Muktabodha under the direction of Mark S. G. Dyczkowski.	muktabodha indological research muktabodha indological research institute all rights reserved texts may be viewed only online or downloaded for private studye texts may not under any circumstances be copied republished reproduced distributed or sold either in original or altered form withoutthe express permission of muktabodha indological research institute in writing data entered by the staff of muktabodha under the direction of mark s g dyczkowski 
