segmentnr	original	analyzed
MBSAMBANDHASIDDHIHhk-0	Muktabodha E-text in UTF-8	muktabodha etext in utf
MBSAMBANDHASIDDHIHhk-1	###########################################################################MUKTABODHA INDOLOGICAL RESEARCH INSTITUTEwww.muktabodha.org©2011 Muktabodha Indological Research Institute  All Rights Reserved.E-texts may be viewed only online or downloaded for private study.E-texts may not, under any circumstances, be copied, republished,reproduced, distributed or sold, either in original or altered form, withoutthe express permission of Muktabodha Indological Research Institute in writing.Data-entered by the staff of Muktabodha under the direction of Mark S. G. Dyczkowski.Catalog number : M00080	muktabodha indological research muktabodha indological research institute all rights reserved texts may be viewed only online or downloaded for private studye texts may not under any circumstances be copied republished reproduced distributed or sold either in original or altered form withoutthe express permission of muktabodha indological research institute in writing data entered by the staff of muktabodha under the direction of mark s g dyczkowskicatalog number  /
MBSAMBANDHASIDDHIHhk-2	Uniform title: sambandhasiddhi	uniform title sambandha siddhi 
MBSAMBANDHASIDDHIHhk-3	Secondary title: siddhitrayī	secondara title siddhitrayī 
MBSAMBANDHASIDDHIHhk-4	Author : utpaladeva	authoḥ utpaladeva 
MBSAMBANDHASIDDHIHhk-5	Description: E-text transcribed from volume 34 of the Kashmir Series of Texts and Studies, where it is bundled together with other texts of Utpaladeva: ājaḍapramātṛsiddhi iśvarasiddhi īśvarapratyabhijñākārikāvṛtti  The sambandhasiddhi,ājaḍapramātṛsiddhī and iśvarasiddhi are collectively known as the siddhitrayī .	description etext transcribed from volume of the kashmir series of texts and studies where it is bundled together with other texts of utpaladeva ā jaḍa pramātṛ siddhi iśvarasiddhi īśvara pratyabhijñā kārikā vṛtti the sambandha siddhi ā jaḍa pramātṛ siddhī and iśvarasiddhi are collectively known as the siddhi trayī 
MBSAMBANDHASIDDHIHhk-6	Notes: This e-text was transcribed by the staff of Muktabodha under the supervision of Mark S.G. Dyczkowski.  Revision 0: Nov. 28, 2005	notes this etext was transcribed by the staff of muktabodha under the supervision or mark sg dyczkowski 
MBSAMBANDHASIDDHIHhk-7	Publisher : Research Department, Jammu and Kashmir State	publisher research depatment jammu and kashmir state 
MBSAMBANDHASIDDHIHhk-8	Publication year : 1921	publication year 
MBSAMBANDHASIDDHIHhk-9	Publication city : Srinagar	publication citi srinagar 
MBSAMBANDHASIDDHIHhk-10	Publication country : India	publication country india 
MBSAMBANDHASIDDHIHhk-11	atha	atha 
MBSAMBANDHASIDDHIHhk-12	saṃbandhasiddhiḥ	        
MBSAMBANDHASIDDHIHhk-13	śrīmadācāryotpaladevaviracitā |	śrīmat ācārya utpaladeva viracitā 
MBSAMBANDHASIDDHIHhk-14	bhedābhedātmasaṃbandhasahasarvārthasādhitā |	                           
MBSAMBANDHASIDDHIHhk-15	lokayātrā kṛtiryasya svecchayā taṃ stumaḥ śivam || 1 ||	lokayātrā kṛtiḥ yasya sva icchayā tam stumaḥ śivam 
MBSAMBANDHASIDDHIHhk-16	bhāvabhedādisaṃbandhamayena [kha. bhedātmeti pāṭhaḥ |]	bhāva bheda ādi saṃbandha mayena kha bheda ātmā iti pāṭhaḥ 
MBSAMBANDHASIDDHIHhk-17	vapuṣonmiṣan |	vapuṣā unmiṣan 
MBSAMBANDHASIDDHIHhk-18	jayatyeko'pi viśvātmā prakāśaḥ parameśvaraḥ || 2 ||	jayati ekaḥ api viśvātmā prakāśaḥ parameśvaraḥ 
MBSAMBANDHASIDDHIHhk-19	iha bhāvānāṃ saṃbandho vicāryate, -	iha bhāvānām saṃbandhaḥ vicāryate 
MBSAMBANDHASIDDHIHhk-20	kastāvatsaṃbandhaśabdārthaḥ saṃsargaḥ saṃparkaḥ saṃśleṣaḥ	kaḥ tāvat saṃbandha śabda arthaḥ saṃsargaḥ saṃparkaḥ saṃśleṣaḥ 
MBSAMBANDHASIDDHIHhk-21	saṃbandha ityapyukte na vivṛtaḥ saṃbandhārthaḥ pratīyate | kiṃ	saṃbandhaḥ iti api ukte na vivṛtaḥ saṃbandha arthaḥ pratīyate kim 
MBSAMBANDHASIDDHIHhk-22	nairantaryaṃ saṃśleṣa utānyatkiṃcit | nairantaryaṃ cet dūrasthayoḥ	nairantaryam saṃśleṣaḥ uta anyat kiṃcid nairantaryam ced dūra sthayoḥ 
MBSAMBANDHASIDDHIHhk-23	pitāputrayoḥ sa na syāt, ayaḥ - śalākayoḥ	pitāputrayoḥ sa na syāt ayaḥ śalākayoḥ 
MBSAMBANDHASIDDHIHhk-24	saṃnikṛṣṭayorvibhudravyayorapi ca syāt | atha dviṣṭhaḥ	saṃnikṛṣṭayoḥ vibhu dravyayoḥ api ca syāt atha dviṣṭhaḥ 
MBSAMBANDHASIDDHIHhk-25	(p. 2)	p 
MBSAMBANDHASIDDHIHhk-26	padārthaḥ kaścitsaṃbandhaḥ | tatrāpi dviṣṭhataiva saṃbandhatā cet	padārthaḥ kaścid saṃbandhaḥ tatra api dviṣṭha tā eva saṃbandha tā ced 
MBSAMBANDHASIDDHIHhk-27	taddvitvadvipṛthaktvāderapi sā syāt | na cāyamarthaḥ	tad dvi tva dvi pṛthak tva ādeḥ api sā syāt na ca ayam arthaḥ 
MBSAMBANDHASIDDHIHhk-28	saṃbandhaśabdasya avayavārthānurodhāduttiṣṭhati [kha.	saṃbandha śabdasya avayava artha anurodhāt uttiṣṭhati kha 
MBSAMBANDHASIDDHIHhk-29	etaduttiṣṭhatīti pāṭhaḥ |] api tu tailapāyikāśabdasyeva	etat uttiṣṭhati iti pāṭhaḥ api tu tailapāyikā śabdasya iva 
MBSAMBANDHASIDDHIHhk-30	saṃketamātrāt | atha saṃbandhaśabdārtha eva na dviṣṭhatā api tu	saṃketa mātrāt atha saṃbandha śabda arthaḥ eva na dviṣṭhatā api tu 
MBSAMBANDHASIDDHIHhk-31	so'nya eva kevalaṃ saṃbaddhayoreva [kha. pu. so'pi dvayoriti	saḥ anyaḥ eva kevalam saṃbaddhayoḥ eva kha pu saḥ api dvayoḥ iti 
MBSAMBANDHASIDDHIHhk-32	pāṭhaḥ |] saṃbhavatīti dviṣṭha ucyate, sa tarhi svarūpeṇaiva	pāṭhaḥ saṃbhavati iti dviṣṭhaḥ ucyate sa tarhi sva rūpeṇa eva 
MBSAMBANDHASIDDHIHhk-33	spaṣṭamucyatāṃ saṃbandhaḥ saṃśleṣa	spaṣṭam ucyatām saṃbandhaḥ saṃśleṣa 
MBSAMBANDHASIDDHIHhk-34	ityādiparyāyāṇāmayamartha iti | apekṣāpāratantryādirapi na	ityādi paryāyāṇām ayam arthaḥ iti apekṣā pāratantrya ādiḥ api na 
MBSAMBANDHASIDDHIHhk-35	cānyaḥ saṃbandhārtho dviṣṭhatvanyāyenaiva so'rthākṣiptaḥ syāt |	ca anyaḥ saṃbandha arthaḥ dviṣṭhatva nyāyena eva saḥ ṛtha ākṣiptaḥ syāt 
MBSAMBANDHASIDDHIHhk-36	na cāpyarthākṣiptatāsya, na hi jaḍayoḥ saṃbandhinorapekṣārtho	na ca api artha ākṣipta tā asya na hi jaḍayoḥ saṃbandhinoḥ 
MBSAMBANDHASIDDHIHhk-37	ghaṭate pāratantryārtho vā | athāpyaṅkura eva bījamapekṣate bīje vā	ghaṭate pāratantrya arthaḥ vā atha api aṅkure eva bījam apekṣate bīje vā 
MBSAMBANDHASIDDHIHhk-38	paratantro bhavati, tadāyattatvādestadātmalābhasyetyetadapi na samyak;	paratantraḥ bhavati tad āyatta tva ādeḥ tad ātmalābhasya iti etat api na samyak 
MBSAMBANDHASIDDHIHhk-39	upacāro hyayamapekṣata iva paratantra iveti syāt, na tu jaḍasya	upacāraḥ hi ayam apekṣate iva paratantraḥ iva iti syāt na tu jaḍasya 
MBSAMBANDHASIDDHIHhk-40	mukhyaivākāṅkṣā prārthanā cecchaiva viśiṣṭā apekṣā	mukhyā eva ākāṅkṣā prārthanā ca icchā eva viśiṣṭā apekṣā 
MBSAMBANDHASIDDHIHhk-41	pāratantryaṃ vā parapravaṇatā parakīyaviniyogākāṅkṣā	pāratantryam vā para pravaṇa tā parakīya viniyoga ākāṅkṣā 
MBSAMBANDHASIDDHIHhk-42	svecchācaraṇanirodhalakṣaṇaḥ saṃkalpaviśeṣa eva saṃgacchate,	sva icchā caraṇa nirodha lakṣaṇaḥ saṃkalpa viśeṣaḥ eva saṃgacchate 
MBSAMBANDHASIDDHIHhk-43	alabdhātmanaścātmalābhārthamapekṣādi [kha. arthalābheti	alabdha ātmanaḥ ca ātma lābha artham apekṣā ādi artha lābha iti 
MBSAMBANDHASIDDHIHhk-44	pāṭhaḥ |] kathyate, na ca	pāṭhaḥ kathyate na ca 
MBSAMBANDHASIDDHIHhk-45	tadānīmadviṣṭhatvātsaṃbandhārthopapattiḥ;	tadānīm adviṣṭha tvāt saṃbandha artha upapattiḥ 
MBSAMBANDHASIDDHIHhk-46	tasmānmuktakaṇṭhameva mukhyaḥ saṃbandho'bhidhātavya iti |	tasmāt mukta kaṇṭham eva mukhyaḥ saṃbandhaḥ abhidhātavyaḥ iti 
MBSAMBANDHASIDDHIHhk-47	tatrocyate saṃbandhaḥ saṃparkaḥ saṃśleṣa ityete	tatra ucyate saṃbandhaḥ saṃparkaḥ saṃśleṣaḥ iti ete 
MBSAMBANDHASIDDHIHhk-48	paryāyāstāvadbhavanti, sa ca saṃśleṣārtho'nekasyaikatā kathyate,	paryāyāḥ tāvat bhavanti sa ca saṃśleṣa arthaḥ ūna ekasya ekatā kathyate 
MBSAMBANDHASIDDHIHhk-49	na tvanekataiva nāpi ekataiva api tu ubhayāvasthāpekṣo'yamarthaḥ	na tu anekatā eva na api ekatā eva api tu ubhaya avasthā apekṣaḥ yam arthaḥ 
MBSAMBANDHASIDDHIHhk-50	[kha. pu. pekṣayeti pāṭhaḥ |] saṃbandhaḥ | ata eva na bahūnāmekaḥ	pu pekṣayā iti pāṭhaḥ saṃbandhaḥ atas eva na bahūnām ekaḥ 
MBSAMBANDHASIDDHIHhk-51	saṃbandhaḥ | yadi hi anekatvamātramekatvamātraṃ vā saṃbandhaḥ	saṃbandhaḥ yadi hi anekatva mātram ekatva mātram vā saṃbandhaḥ 
MBSAMBANDHASIDDHIHhk-52	(p. 3)	p 
MBSAMBANDHASIDDHIHhk-53	syāt, tadbahūnāmapi ekatāpattau ekatānāpattāvapi vā syāt,	syāt tat bahūnām api ekatā āpattau ekatā anāpattau api vā syāt 
MBSAMBANDHASIDDHIHhk-54	ekamātrasyāpi ca syāt | yadā punaranekasyaikatā saṃbandha	eka mātrasya api ca syāt yadā punar anekasya eka tā saṃbandha 
MBSAMBANDHASIDDHIHhk-55	ubhayāpekṣayā tadānekāpekṣaṇādekamātrasyaiva na saṃbandhaḥ,	ubhaya apekṣayā tadā aneka apekṣaṇāt eka mātrasya eva na saṃbandhaḥ 
MBSAMBANDHASIDDHIHhk-56	ekāpekṣaṇācca nānekasyaiva pṛthaksthitasya | na cāpi	eka apekṣaṇāt ca na anekasya eva pṛthak sthitasya na ca api 
MBSAMBANDHASIDDHIHhk-57	tryādīnāmekaḥ saṃbandhaḥ, trayāṇāṃ hi	tri ādīnām ekaḥ saṃbandhaḥ trayāṇām hi 
MBSAMBANDHASIDDHIHhk-58	bhinnabhedāvadhikṛtadvairāśyāśrayātparasparaṃ bhedāt, teṣāṃ	bhinna bhedau adhikṛta dvairāśya āśrayāt parasparam bhedāt teṣām 
MBSAMBANDHASIDDHIHhk-59	ca saṃbandhasvarūpasthitāvapekṣaṇāt, ekasya dvitīyena saha yaikatā	ca saṃbandha svarūpa sthitau apekṣaṇāt ekasya dvitīyena saha yā ekatā 
MBSAMBANDHASIDDHIHhk-60	na sā tṛtīyena saha, tayordvitīyatṛtīyayorbhedādapekṣaṇācca; tato	na sā tṛtīyena saha tayoḥ dvitīya tṛtīyayoḥ bhedāt apekṣaṇāt ca 
MBSAMBANDHASIDDHIHhk-61	bahūnāṃ śatādisaṃkhyānāmapi pratiyugalamevaikaḥ saṃbandha	bahūnām śata ādi saṃkhyānām api pratiyugalam eva ekaḥ saṃbandha 
MBSAMBANDHASIDDHIHhk-62	udghoṣyate, - ityevaṃ dvayorekātmeti	udghoṣyate iti evam dvayoḥ eka ātmā iti 
MBSAMBANDHASIDDHIHhk-63	saṃbandhaśabdārtho'vayavānusāreṇaiva vyavasthitaḥ | saṃśabdena	saṃbandha śabda artha uvayava anusāreṇa eva vyavasthitaḥ saṃśabdena 
MBSAMBANDHASIDDHIHhk-64	sahārthavṛttinā samānārthavṛttinā vā bandhinā ca	saha artha vṛttinā samāna artha vṛttinā vā bandhinā ca 
MBSAMBANDHASIDDHIHhk-65	deśāntaraparihārapūrvakaikadeśāvasthānārthena vispaṣṭamuktaiva	deśa antara parihāra pūrvaka eka deśa avasthāna arthena vispaṣṭam uktā eva 
MBSAMBANDHASIDDHIHhk-66	sa hyanekasyaikatā | kevalamanekasya ekatā saṃbhavennaveti	sa hi anekasya eka tā kevalam anekasya eka tā saṃbhavet na vā iti 
MBSAMBANDHASIDDHIHhk-67	paryālocyate, - tatrāyaṃ saṃbandho'nekadhā pratīyate, - pituḥ	paryālocyate tatra ayam saṃbandhaḥ ūna ekadhā pratīyate pituḥ 
MBSAMBANDHASIDDHIHhk-68	putraḥ, rājñaḥ puruṣaḥ, vṛkṣasya śākhā, dhavaśca khadiraśca,	putraḥ rājñaḥ puruṣaḥ vṛkṣasya śākhā dhavaḥ ca khadiraḥ ca 
MBSAMBANDHASIDDHIHhk-69	nīlamutpalaṃ, devadattaḥ kāṣṭhaiḥ sthālyāmodanaṃ pacati,	nīlam utpalam devadattaḥ kāṣṭhaiḥ sthālyām odanam pacati 
MBSAMBANDHASIDDHIHhk-70	ghaṭasyābhāvaḥ, asmādidamanyat, - ityevamādinā rūpeṇa | tathā	ghaṭasya abhāvaḥ asmāt idam anyat iti evamādinā rūpeṇa tathā 
MBSAMBANDHASIDDHIHhk-71	viparyayeṇāpi putrasya pitā, puruṣasya rājeti | tatra kimidaṃ	viparyayeṇa api putrasya pitā puruṣasya rājā iti tatra kim idam 
MBSAMBANDHASIDDHIHhk-72	pratītimātram uta vastveva evaṃbhūtaṃ pratīyate | tatra yadi	pratīti mātram uta vastu eva evaṃbhūtam pratīyate tatra yadi 
MBSAMBANDHASIDDHIHhk-73	pratītimātrametat vastusvarūpaṃ tarhi vaktavyam |	pratīti mātram etat vastu svarūpam tarhi vaktavyam 
MBSAMBANDHASIDDHIHhk-74	tatrācakṣate, - vastu ghaṭādi	tatra ācakṣate vastu ghaṭa ādi 
MBSAMBANDHASIDDHIHhk-75	svātmamātraparisamāptamanyonyavyāvṛttamitthameva hi	sva ātma mātra parisamāptam anyonya vyāvṛttam ittham eva hi 
MBSAMBANDHASIDDHIHhk-76	svātmāvabhāsinā pratyakṣeṇa pratīyate kalpanā kalpitaiva sā | te hi	sva ātma avabhāsinā pratyakṣeṇa pratīyate kalpanā kalpitā eva sā te hi 
MBSAMBANDHASIDDHIHhk-77	amiśrāḥ svayṃ bhāvāstānyojayati kalpanā ityāhuḥ, tathā	amiśrāḥ svayam bhāvāḥ tān yojayati kalpanā iti āhuḥ tathā 
MBSAMBANDHASIDDHIHhk-78	nīlamutpalamiti śābdyā kalpanayā paraṃ nīlotpalayorekātmatā	nīlam utpalam iti śābdyā kalpanayā param nīla utpalayoḥ eka ātma tā 
MBSAMBANDHASIDDHIHhk-79	pratīyate,	pratīyate 
MBSAMBANDHASIDDHIHhk-80	(p. 4)	p 
MBSAMBANDHASIDDHIHhk-81	na tu vastvavabhāsinā niraṃśotpalasvalakṣaṇaviśeṣālambanena	na tu vastu avabhāsinā niraṃśa utpala sva lakṣaṇa viśeṣa ālambanena 
MBSAMBANDHASIDDHIHhk-82	[kha. pu. lambanapratyakṣeti pāṭhaḥ |] pratyakṣeṇa pramāṇena |	lambana pratyakṣa iti pāṭhaḥ pratyakṣeṇa pramāṇena 
MBSAMBANDHASIDDHIHhk-83	tathā cāhuḥ	tathā ca āhuḥ 
MBSAMBANDHASIDDHIHhk-84	saṃyujyante na bhidyante svato'rthāḥ pāramārthikāḥ |	saṃyujyante na bhidyante svatas ṛthāḥ pāramārthikāḥ 
MBSAMBANDHASIDDHIHhk-85	rūpamekamanekaṃ ca teṣu buddherupaplavaḥ ||	rūpam ekam anekam ca teṣu buddheḥ upaplavaḥ 
MBSAMBANDHASIDDHIHhk-86	ityādi | naca anekasyānekatāsahabhāvinī ekatā yujyate	ityādi na ca anekasya anekatā sahabhāvinī ekatā yujyate 
MBSAMBANDHASIDDHIHhk-87	bhāvābhāvarūpatvena viruddhatvāt | anekasmādupādānādekam	bhāva abhāva rūpa tvena viruddha tvāt anekasmāt upādānāt ekam 
MBSAMBANDHASIDDHIHhk-88	ekasmādvā anekam	ekasmāt vai anekam 
MBSAMBANDHASIDDHIHhk-89	anyonyāsaṃsṛṣṭamevātmamātraparyavasitamudbhavet | yathā	anyonya asaṃsṛṣṭam eva ātma mātra paryavasitam udbhavet yathā 
MBSAMBANDHASIDDHIHhk-90	vijñānasantatau vyavasthā keṣāṃcit, tatra hi	vijñāna santatau vyavasthā keṣāṃcid tatra hi 
MBSAMBANDHASIDDHIHhk-91	śabdasparśādijñānalakṣaṇebhyaḥ samanantarapratyayebhya	śabda sparśa ādi jñāna lakṣaṇebhyaḥ samanantara pratyayebhyaḥ 
MBSAMBANDHASIDDHIHhk-92	ekamaindriyakaṃ vikalpajñānam | ekasmādvā samanantarapratyayāt	ekam aindriyakam vikalpa jñānam ekasmāt vā samanantara pratyayāt 
MBSAMBANDHASIDDHIHhk-93	pañcāpi śabdādiviṣayāṇi jāyante | yā punarekatā anekatā ca	pañca api śabda ādi viṣayāṇi jāyante yā punar ekatā anekatā ca 
MBSAMBANDHASIDDHIHhk-94	samānāśrayā sā pramāṇabādhitā, bhāvasya vābhāvatā;	samāna āśrayā sā pramāṇa bādhitā bhāvasya vā abhāva tā 
MBSAMBANDHASIDDHIHhk-95	kevalamitthaṃrūpayaiva anayā kalpanāpratītyā	kevalam itthaṃrūpayā eva anayā kalpanā pratītyā 
MBSAMBANDHASIDDHIHhk-96	sāṃsārikavyavahāranirvartanārthamarthāḥ parasparavyāvṛttā api	sāṃsārika vyavahāra nirvartana artham arthāḥ paraspara vyāvṛttāḥ api 
MBSAMBANDHASIDDHIHhk-97	kāryakāraṇarūpatvena avāstavenaiva pratipādyante |	kārya kāraṇa rūpa tvena avāstavena eva pratipādyante 
MBSAMBANDHASIDDHIHhk-98	rājapuruṣayoranyonyaṃ svarūpaviśeṣakriyaiva evaṃ nirūpyate [kha.	rāja puruṣayoḥ anyonyam svarūpa viśeṣa kriyā eva evam nirūpyate kha 
MBSAMBANDHASIDDHIHhk-99	pu. nidṛśyate iti pāṭhaḥ |] sthālyāṃ kāṣṭhairityādau ca; ata eva	nidṛśyate iti pāṭhaḥ sthālyām kāṣṭhaiḥ ityādau ca atas eva 
MBSAMBANDHASIDDHIHhk-100	pratītikāla eva sāmānyasyeva saṃbandhasyābhyupagamaḥ |	pratīti kāle eva sāmānyasya iva saṃbandhasya abhyupagamaḥ 
MBSAMBANDHASIDDHIHhk-101	vastusvarūpaviparītatvena ca pratītistadvadeva bhrāntiviṣayaiva,	vastu svarūpa viparīta tvena ca pratītiḥ tadvat eva bhrānti viṣayā eva 
MBSAMBANDHASIDDHIHhk-102	kevalaṃ bādhapravṛttāvapi	kevalam bādha pravṛttau api 
MBSAMBANDHASIDDHIHhk-103	upakāryopakārakasvarūpaviśeṣāvabhāsasaṃlagnatvādasya	upakārya upakāraka sva rūpa viśeṣa avabhāsa saṃlagna tvāt asya 
MBSAMBANDHASIDDHIHhk-104	bhramasyāvayavibhramasyevānivṛttiḥ sarpabhramavat | tata eva	bhramasya avayavi bhramasya iva anivṛttiḥ sarpa bhrama vat tatas eva 
MBSAMBANDHASIDDHIHhk-105	bhrānterapyasyāḥ saṃvṛtisaṃjñayā vyapadeśa iti |	bhrānteḥ api asyāḥ saṃvṛti saṃjñayā vyapadeśaḥ iti 
MBSAMBANDHASIDDHIHhk-106	tatrocyate pratītistāvadanekaikarūpatāyāṃ	tatra ucyate pratītiḥ tāvat aneka eka rūpa tāyām 
MBSAMBANDHASIDDHIHhk-107	saṃbandhābhidhānāya bhavadbhirapyabhyupagataiva, yenoktam	saṃbandha abhidhānāya bhavadbhiḥ api abhyupagatā eva yena uktam 
MBSAMBANDHASIDDHIHhk-108	(p. 5)	p 
MBSAMBANDHASIDDHIHhk-109	ityamiśrāḥ svayaṃ bhāvāstānyojayati kalpanā |	iti amiśrāḥ svayam bhāvāḥ tān yojayati kalpanā 
MBSAMBANDHASIDDHIHhk-110	iti | kalpanārūpatvaṃ ca nāsyā doṣaḥ | ghaṭo'yaṃ paṭo'yamityapi	iti kalpanā rūpa tvam ca na asyāḥ doṣaḥ ghaṭaḥ yam paṭaḥ yam iti api 
MBSAMBANDHASIDDHIHhk-111	vikalpaḥ kalpanaiva | athātra pratyakṣāvabhāso'pi [kha. pu. ābhāsa	vikalpaḥ kalpanā eva atha atra pratyakṣa avabhāsaḥ api 
MBSAMBANDHASIDDHIHhk-112	iti pāṭhaḥ |] tathā ghaṭapaṭādirūpa eveti na kalpanātvam | ihāpi	iti pāṭhaḥ tathā ghaṭa paṭa ādi rūpaḥ eva iti na kalpanā tvam iha api 
MBSAMBANDHASIDDHIHhk-113	rājñaḥ puruṣaḥ sthālyāmodana ityādāvapi pratyakṣāvabhāso na	rājñaḥ puruṣaḥ sthālyām odanaḥ ityādau api pratyakṣa avabhāsaḥ na 
MBSAMBANDHASIDDHIHhk-114	tatheti kuto'vagatam | avaśyameva ca pratyakṣāvabhāso'pyatra	tathā iti kutas avagatam avaśyam eva ca pratyakṣa avabhāsaḥ api atra 
MBSAMBANDHASIDDHIHhk-115	tathaivābhyupagantavyaḥ, abhyupagata eva vā bhavadbhiḥ yenoktam,	tathā eva abhyupagantavyaḥ abhyupagataḥ eva vā bhavadbhiḥ yena uktam 
MBSAMBANDHASIDDHIHhk-116	arthākārapratibhāsasaṃlagnatvādbādhakenāpi duruddharo'yaṃ	artha ākāra pratibhāsa saṃlagna tvāt bādhakena api duruddharā yam 
MBSAMBANDHASIDDHIHhk-117	bhramaḥ iti | na hi arthapratibhāsasaṃlagnatvādbādhakena api	bhramaḥ iti na hi artha pratibhāsa saṃlagna tvāt bādhakena api 
MBSAMBANDHASIDDHIHhk-118	tvarthapratibhāsasādṛśyasadbhāvamātrāt | rajatabhrame'pi	tu artha pratibhāsa sādṛśya sadbhāva mātrāt rajata bhrame pi 
MBSAMBANDHASIDDHIHhk-119	śuktikāsādṛśyasadbhāvo'pyastyeva, sādṛśyaviṣayā [kha. pu.	śuktikā sādṛśya sadbhāvaḥ api asti eva sādṛśya viṣayā 
MBSAMBANDHASIDDHIHhk-120	sadṛśeti pāṭhaḥ |] eva hi sarvā bhrāntayaḥ sādṛśyavyatirekeṇa	sadṛśa iti pāṭhaḥ eva hi sarvāḥ bhrāntayaḥ sādṛśya vyatirekeṇa 
MBSAMBANDHASIDDHIHhk-121	cānyā arthapratibhāsasaṃlagnatayaiva yuktāḥ,	ca anyāḥ artha pratibhāsa saṃlagna tayā eva yuktāḥ 
MBSAMBANDHASIDDHIHhk-122	yadarthapratibhāsaśarīramevaṃbhūtameva evaṃrūpeṇaiva [kha. pu.	yad artha pratibhāsa śarīram evaṃbhūtam eva evaṃrūpeṇa eva kha pu 
MBSAMBANDHASIDDHIHhk-123	eketi pāṭhaḥ |] vyavahārayitrā vikalpena vyavahārayitumupapannam,	eka iti pāṭhaḥ vyavahārayitrā vikalpena vyavahārayitum upapannam 
MBSAMBANDHASIDDHIHhk-124	anyathābhūtīkṛte eva arthābhāse	anyathā bhūtīkṛte eva artha ābhāse 
MBSAMBANDHASIDDHIHhk-125	parasparasvarūpānanupraviṣṭasvātmamātraparyavasitārthaniṣṭhatā	                                                           
MBSAMBANDHASIDDHIHhk-126	māpādite yadi paramayaṃ saṃbandhavikalpaḥ	mā āpādite yadi param ayam saṃbandha vikalpaḥ 
MBSAMBANDHASIDDHIHhk-127	sāmānyādivikalpavannivarteta nānyathā | na ca	sāmānya ādi vikalpa vat nivarteta na anyathā na ca 
MBSAMBANDHASIDDHIHhk-128	vikalpo'rthapratibhāsādbhinnaḥ,	vikalpaḥ ṛtha pratibhāsāt bhinnaḥ 
MBSAMBANDHASIDDHIHhk-129	nirvikalpatvadūṣaṇādīśvarapratyabhijñāyām | evaṃ rājñaḥ	nirvikalpa tva dūṣaṇāt īśvarapratyabhijñāyām  evam rājñaḥ 
MBSAMBANDHASIDDHIHhk-130	puruṣa ityādāvavabhāsa	puruṣaḥ ityādau avabhāsa 
MBSAMBANDHASIDDHIHhk-131	evānekasyaikātmatāprathārūpo'bhyupagantavyaḥ	eva anekasya eka ātmatā prathā rūpaḥ abhyupagantavyaḥ 
MBSAMBANDHASIDDHIHhk-132	sthūlapratibhāsavat, sa tūpapadyate na vetyetāvadvicāryate [kha. pu.	sthūla pratibhāsa vat sa tu upapadyate na vā iti etāvat vicāryate 
MBSAMBANDHASIDDHIHhk-133	vedyateti pāṭhaḥ |], - tatra cinmātrarūpasyaiva pāramārthikasya	vedya tā iti pāṭhaḥ tatra cit mātra rūpasya eva pāramārthikasya 
MBSAMBANDHASIDDHIHhk-134	vastuno viśvātmatā | tasyaiva cinmātrasya	vastunaḥ viśva ātma tā tasya eva cit mātrasya 
MBSAMBANDHASIDDHIHhk-135	māyāśaktiprabhāvādabhedākhyātyutthāpanena viśvasya	māyā śakti prabhāvāt abheda akhyāti utthāpanena viśvasya 
MBSAMBANDHASIDDHIHhk-136	tattvabhūtabhuvanādyātmavaicitryeṇānyonyavibhaktatā, -	tattva bhūta bhuvana ādi ātma vaicitryeṇa anyonya vibhakta tā 
MBSAMBANDHASIDDHIHhk-137	(p. 6)	p 
MBSAMBANDHASIDDHIHhk-138	itīśvarapratyabhijñāyāṃ vistareṇa pratipāditam, - iti tata eva	iti īśvarapratyabhijñāyām vistareṇa pratipāditam iti tatas eva 
MBSAMBANDHASIDDHIHhk-139	parīkṣyaṃ nehopanyasyate | asmiṃścārthe siddhe naikaikatāruapaḥ	parīkṣyam na iha upanyasyate asmin ca arthe siddhe na ekaikatāruapaḥ 
MBSAMBANDHASIDDHIHhk-140	saṃsāra eva saṃbandhaśabdārthānupraviṣṭaḥ, - iti nāstyevātra	saṃsāraḥ eva saṃbandha śabda artha anupraviṣṭaḥ iti na asti eva atra 
MBSAMBANDHASIDDHIHhk-141	dīnatā, kevalamiyadvimṛśyate - yadekacinmātrarūpatvenānekātmano	dīna tā kevalam iyat vimṛśyate yat eka cit mātra rūpa tvena aneka ātmanaḥ 
MBSAMBANDHASIDDHIHhk-142	vastubhedasyaika eva saṃbandhaḥ syāt ya eva rājapuruṣayoḥ sa eva	vastu bhedasya ekaḥ eva saṃbandhaḥ syāt yaḥ eva rāja puruṣayoḥ saḥ eva 
MBSAMBANDHASIDDHIHhk-143	pitāputrayoḥ sthālyādīnāṃ ceti, anekaśceṣyate | tadatrāpyucyate -	pitāputrayoḥ sthālī ādīnām ca iti anekaḥ ca iṣyate tat atra api ucyate 
MBSAMBANDHASIDDHIHhk-144	syādeka eva sarveṣāmiti | yadyekatāmātrameva saṃbandhaḥ syāt,	syāt ekaḥ eva sarveṣām iti yadi eka tā mātram eva saṃbandhaḥ syāt 
MBSAMBANDHASIDDHIHhk-145	yāvatānekatāṃśādaṃśenaikatā saṃbandhaḥ | tataśca	yāvatā anekatā aṃśāt aṃśena ekatā saṃbandhaḥ tatas ca 
MBSAMBANDHASIDDHIHhk-146	rājapuruṣoparaktaikatānyaḥ saṃbandhaḥ	rāja puruṣa uparakta ekatā anyaḥ saṃbandhaḥ 
MBSAMBANDHASIDDHIHhk-147	pitāputroparāgopalakṣaṇavilakṣaṇa eva; ata eva	pitāputra uparāga upalakṣaṇa vilakṣaṇaḥ eva atas eva 
MBSAMBANDHASIDDHIHhk-148	māyādaśāyāmevākhyātibhedapradhānāyāṃ	māyā daśāyām eva akhyāti bheda pradhānāyām 
MBSAMBANDHASIDDHIHhk-149	saṃbandhapadārthasadbhāvaḥ, viśvātmatāyāṃ punaḥ	saṃbandha padārtha sadbhāvaḥ viśva ātma tāyām punar 
MBSAMBANDHASIDDHIHhk-150	pūrṇaikataiva na tu saṃbandhārthaḥ kaścit | tatrāpi	pūrṇa ekatā eva na tu saṃbandha arthaḥ kaścid tatra api 
MBSAMBANDHASIDDHIHhk-151	kadācitparāparadaśāyāmaparabhāgāpekṣaṇādgauṇavṛttyā	kadācid para apara daśāyām apara bhāga apekṣaṇāt gauṇa vṛttyā 
MBSAMBANDHASIDDHIHhk-152	saṃbandhārthaḥ saṃbhavet, upakāryopakārakayoreva ca viśiṣṭayoḥ	saṃbandha arthaḥ saṃbhavet upakāryā upakārakayoḥ eva ca viśiṣṭayoḥ 
MBSAMBANDHASIDDHIHhk-153	saṃbandhaḥ viśiṣṭarūpaḥ, sa ca pratipādanīyo'vaśyameva,	saṃbandhaḥ viśiṣṭa rūpaḥ sa ca pratipādanīya uvaśyam eva 
MBSAMBANDHASIDDHIHhk-154	tadapratipādane tayorupakāryopakārakayoḥ kramikayorgaugapadyena	tad apratipādane tayoḥ upakāryā upakārakayoḥ kramikayoḥ gaugapadyena 
MBSAMBANDHASIDDHIHhk-155	pratītirhānopādānārthamanyathā na ghaṭeta, tataśca	pratītiḥ hāna upādāna artham anyathā na ghaṭeta tatas ca 
MBSAMBANDHASIDDHIHhk-156	vyavahāralopaḥ syāt | na copakāryopakārakayorapi svādhīnaḥ	vyavahāra lopaḥ syāt na ca upakāryā upakārakayoḥ api svādhīnaḥ 
MBSAMBANDHASIDDHIHhk-157	kaścidupakārārthaḥ, - ityapīśvarapratyabhijñāyāmeva vistāritam |	kaścid upakāra arthaḥ iti api īśvarapratyabhijñāyām eva vistāritam 
MBSAMBANDHASIDDHIHhk-158	tataśca cinmayeśvarecchaiva sā tādṛśī yayā [kha. pu. yatheti	tatas ca cit maya īśvara icchā eva sā tādṛśī yayā yathā iti 
MBSAMBANDHASIDDHIHhk-159	pāṭhaḥ |] padārthau tau tathopakāryopakārakau bhavata iti	pāṭhaḥ padārthau tau tathā upakāryā upakārakau bhavataḥ iti 
MBSAMBANDHASIDDHIHhk-160	tallagnayoreva tayordvayordvayorarthayoḥ kramikayorapi	tad lagnayoḥ eva tayoḥ dvayoḥ dvayoḥ arthayoḥ kramikayoḥ api 
MBSAMBANDHASIDDHIHhk-161	ekabuddhyupārūḍhayorekaparāmarśāt	eka buddhi upārūḍhayoḥ eka parāmarśāt 
MBSAMBANDHASIDDHIHhk-162	tayorevānyarūpayoryaugapadyena prakāśanaṃ vyavahārasiddhaye	tayoḥ eva anya rūpayoḥ yaugapadyena prakāśanam vyavahāra siddhaye 
MBSAMBANDHASIDDHIHhk-163	tadicchayaiva vidhīyate, - iti na kācitkhaṇḍanā |	tad icchayā eva vidhīyate iti na kācid khaṇḍanā 
MBSAMBANDHASIDDHIHhk-164	(p. 7)	p 
MBSAMBANDHASIDDHIHhk-165	sa ca saṃbandho dvayoreva bhavati na bahūnāṃ, bahūnāṃ hi	sa ca saṃbandhaḥ dvayoḥ eva bhavati na bahūnām bahūnām hi 
MBSAMBANDHASIDDHIHhk-166	kimekaikasyānyairanekasaṃkhyairyugapadeva kiṃ vā bahūnāṃ	kim ekaikasya anyaiḥ aneka saṃkhyaiḥ yugapad eva kim vā bahūnām 
MBSAMBANDHASIDDHIHhk-167	madhye ekasya ekaikena | tatra yadyekaikasyānekasaṃkhyaistatkiṃ	madhye ekasya ekaikena tatra yadi ekaikasya aneka saṃkhyaiḥ tat kim 
MBSAMBANDHASIDDHIHhk-168	te'nekasaṃkhyā eva ekaparāmarśagocarāḥ	tena ika saṃkhyāḥ eva eka parāmarśa gocarāḥ 
MBSAMBANDHASIDDHIHhk-169	athānekaparāmarśaviṣayā [ka. pu. viṣayā ekaparāmarśaviṣayā	atha aneka parāmarśa viṣayā viṣayā eka parāmarśa viṣayā 
MBSAMBANDHASIDDHIHhk-170	ityadhikaḥ |] rājñaḥ puruṣaḥ rājño hastyaśvarathapadātaya iti |	iti adhikaḥ rājñaḥ puruṣaḥ rājñaḥ hasti aśva ratha padātayaḥ iti 
MBSAMBANDHASIDDHIHhk-171	dvandve'pi hastyādyanekatve'pi parāmarśasyaikyāt dvandvākhyaḥ	dvandve api hasti ādi aneka tve pi parāmarśasya aikyāt dvandva ākhyaḥ 
MBSAMBANDHASIDDHIHhk-172	śabda eva, hastyādiśabdā varṇatulyāḥ | ekaparāmarśasthito hi	śabdaḥ eva hasti ādi śabdāḥ varṇa tulyāḥ eka parāmarśa sthitaḥ hi 
MBSAMBANDHASIDDHIHhk-173	śabda eko bhavati | tadekaśabdādhyāsādartho'pyeka eva | ata eva	śabdaḥ ekaḥ bhavati tad eka śabda adhyāsāt arthaḥ upi ekaḥ eva atas eva 
MBSAMBANDHASIDDHIHhk-174	vastuśabdabuddhaya etā, - iti dvandvārthasyaikasya strīliṅgatvāt	vastu śabda buddhayaḥ etāḥ iti dvandva arthasya ekasya strī liṅga tvāt 
MBSAMBANDHASIDDHIHhk-175	tadviśeṣo nopātta eva | etacchabdaḥ strīliṅga eva bhavati, na tu [kha.	tad viśeṣaḥ na upāttaḥ eva etad śabdaḥ strī liṅgaḥ eva bhavati na tu kha 
MBSAMBANDHASIDDHIHhk-176	pu. nanviti pāṭhaḥ |] etā ityekaśeṣanirdeśo'yaṃ yena	nanu iti pāṭhaḥ etāḥ iti ekaśeṣa nirdeśaḥ yam yena 
MBSAMBANDHASIDDHIHhk-177	napuṃsakaikaśeṣaḥ syāt | bahuvacanaṃ cātra dārā	napuṃsaka eka śeṣaḥ syāt bahuvacanam ca atra 
MBSAMBANDHASIDDHIHhk-178	itivadavayavādyapekṣayā, - ityevamatra dvayoreva saṃbandhaḥ | iha tu	iti vat avayava ādi apekṣayā iti evam atra dvayoḥ eva saṃbandhaḥ iha tu 
MBSAMBANDHASIDDHIHhk-179	rājño hastī cāśvaśca rathaśca padātiśca, -	rājñaḥ hastī ca aśvaḥ ca rathaḥ ca padātiḥ ca 
MBSAMBANDHASIDDHIHhk-180	ityanekaparāmarśaviṣayatve'pi yāvanto hastyādīnāṃ	iti aneka parāmarśa viṣaya tve pi yāvantaḥ hasti ādīnām 
MBSAMBANDHASIDDHIHhk-181	parāmarśāstāvanta eva rājñaḥ, - iti tatsamuccayārthā eva	parāmarśāḥ tāvantaḥ eva rājñaḥ iti tad samuccaya arthāḥ eva 
MBSAMBANDHASIDDHIHhk-182	caśabdāḥ | anyathā caśabdasyābhāve rājña ityanukarṣaṇaṃ vinā	caśabdāḥ anyathā caśabdasya abhāve rājñaḥ iti anukarṣaṇam vinā 
MBSAMBANDHASIDDHIHhk-183	hastītyanena sahaikaparāmarśanimañjanaikībhūte rājñi paratantre	hastī iti anena saha eka parāmarśa nimañjana ekībhūte rājñi paratantre 
MBSAMBANDHASIDDHIHhk-184	punarvivekamanāpādyamāne kena sahāśvādīnāṃ saṃbandhaḥ	punar vivekam an āpādyamāne kena saha aśva ādīnām saṃbandhaḥ 
MBSAMBANDHASIDDHIHhk-185	syāt tataścopacāreṇa hastyādīnāṃ sāmānādhikaraṇyaṃ pratīyate	syāt tatas ca upacāreṇa hasti ādīnām sāmānādhikaraṇyam pratīyate 
MBSAMBANDHASIDDHIHhk-186	| athavā [kha. pu. atha cāseti pāṭhaḥ |]	athavā kha pu atha ca asā iti pāṭhaḥ 
MBSAMBANDHASIDDHIHhk-187	sāmarthyāccaśabdābhāve'pi samuccayapratītau ekaikaṃ sa eva	sāmarthyāt caśabda abhāve pi samuccaya pratītau ekaikam saḥ eva 
MBSAMBANDHASIDDHIHhk-188	saṃbandho hastyādīnāmanyonyamapi ca sattākriyāṃ prati	saṃbandhaḥ hasti ādīnām anyonyam api ca sattā kriyām prati 
MBSAMBANDHASIDDHIHhk-189	samuccīyamānatāsaṃbandhaścaśabdenāvadyotyate |	samuccīyamāna tā saṃbandhaḥ caśabdena avadyotyate 
MBSAMBANDHASIDDHIHhk-190	arthapratibhāso'pi cāyamitthaṃ sthito'yamanyatheti	artha pratibhāsaḥ api ca ayam ittham sthitaḥ yam anyathā iti 
MBSAMBANDHASIDDHIHhk-191	(p. 8)	p 
MBSAMBANDHASIDDHIHhk-192	nāparāmṛṣṭo vyavasthāpayituṃ śakyate parāmarśavirahitasya	na aparāmṛṣṭaḥ vyavasthāpayitum śakyate parāmarśa virahitasya 
MBSAMBANDHASIDDHIHhk-193	pratibhāsasyāsaṃbhavādeva | na hi mārgagatipravṛttasyāpi	pratibhāsasya asaṃbhavāt eva na hi mārga gati pravṛttasya api 
MBSAMBANDHASIDDHIHhk-194	pārśvavartitṛṇādivastusparśarūpādipratibhāsāḥ	pārśva varti tṛṇa ādi vastu sparśa rūpa ādi pratibhāsāḥ 
MBSAMBANDHASIDDHIHhk-195	parāmarśarahitāḥ sattvenābhyupagantuṃ pāryante	parāmarśa rahitāḥ sattvena abhyupagantum pāryante 
MBSAMBANDHASIDDHIHhk-196	smaryamāṇatvābhāvāt | nāpi teṣāṃ tadā	smaryamāṇa tva abhāvāt na api teṣām tadā 
MBSAMBANDHASIDDHIHhk-197	cakṣurādikāraṇasāmagrīsadbhāvenānumānasiddhā sattā yujyate	cakṣuḥ ādi kāraṇa sāmagrī sadbhāvena anumāna siddhā sattā yujyate 
MBSAMBANDHASIDDHIHhk-198	manovadhānābhāvāt | tadbhāve'vaśyaṃbhāvī tadānīṃ	manaḥ vadhāna abhāvāt tad bhāva ivaśyaṃbhāvī tadānīm 
MBSAMBANDHASIDDHIHhk-199	tṛṇādiparāmarśa idānīṃ ca smaraṇaṃ | etacca pratyabhijñāyāṃ	tṛṇa ādi parāmarśaḥ idānīm ca smaraṇam etat ca pratyabhijñāyām 
MBSAMBANDHASIDDHIHhk-200	nirṇītam | evaṃ ca vimarśamaya evārthapratibhāsa upapannaḥ |	nirṇītam evam ca vimarśa mayaḥ eva artha pratibhāsaḥ upapannaḥ 
MBSAMBANDHASIDDHIHhk-201	vimarśaśca yathāgnirdhūme iti bhavati, tathā saṃskṛtasya	vimarśaḥ ca yathā agniḥ dhūme iti bhavati tathā saṃskṛtasya 
MBSAMBANDHASIDDHIHhk-202	pramāturasya dhūmasyāgniḥ kāraṇamasya dhūmaḥ kāryamityapi	pramātuḥ asya dhūmasya agniḥ kāraṇam asya dhūmaḥ kāryam iti api 
MBSAMBANDHASIDDHIHhk-203	bhavati, - ityevamekātmatāpattiparyanto'vabhāsanavyāpāro'rtheṣu	bhavati iti evam eka ātma tā āpatti paryanta uvabhāsana vyāpāra ūrtheṣu 
MBSAMBANDHASIDDHIHhk-204	jñānānāṃ, na tu parasparāsaṃlagnatā	jñānānām na tu paraspara asaṃlagna tā 
MBSAMBANDHASIDDHIHhk-205	prakāśamātrātparisamāpyate |	prakāśa mātrāt parisamāpyate 
MBSAMBANDHASIDDHIHhk-206	parasparaviśeṣaṇaviśeṣyabhāvaparāmarśa	            
MBSAMBANDHASIDDHIHhk-207	evānekaikatārūpasaṃbandhaparāmarśaḥ |	eva aneka eka tā rūpa saṃbandha parāmarśaḥ 
MBSAMBANDHASIDDHIHhk-208	ekaparāmarśavyāpārāviṣṭa eva sāṃsārikavyavahāreṣu māyīyaḥ	eka parāmarśa vyāpāra āviṣṭaḥ eva sāṃsārika vyavahāreṣu māyīyaḥ 
MBSAMBANDHASIDDHIHhk-209	pramātā na tadānīmeva parāmarśāntarasparśamapyarhati	pramātā na tadānīm eva parāmarśa antara sparśam api arhati 
MBSAMBANDHASIDDHIHhk-210	cidaikyākhyātibhedanibandhanavikalpanaparāmarśātmakatvānmāyā	cit aikya ākhyāti bheda nibandhana vikalpana parāmarśa ātmaka tvāt māyā 
MBSAMBANDHASIDDHIHhk-211	pramātṝṇāmityetadapi īśvarapratyabhijñāyāmeva prapañcitam |	pramātṝṇām iti etat api īśvarapratyabhijñāyām eva prapañcitam 
MBSAMBANDHASIDDHIHhk-212	vyavahāre rājā puruṣo vā prādhānyena jijñāsitaḥ	vyavahāre rājā puruṣaḥ vā prādhānyena jijñāsitaḥ 
MBSAMBANDHASIDDHIHhk-213	pratipipādayiṣitaśca bhavediti sa eva viśeṣya ucyate paraśca	bhavet iti saḥ eva viśeṣyaḥ ucyate paraḥ ca 
MBSAMBANDHASIDDHIHhk-214	viśeṣaṇamityatrāpi na kācitkṣatiḥ | dvayoścaikye'pi viśeṣaṇaṃ	viśeṣaṇam iti atra api na kācid kṣatiḥ dvayoḥ ca aikye pi viśeṣaṇam 
MBSAMBANDHASIDDHIHhk-215	viśeṣyīkṛtasvarūpaṃ viśeṣyātmanā cakāsti svarūpeṇāpi	viśeṣyīkṛta sva rūpam viśeṣya ātmanā cakāsti sva rūpeṇa api 
MBSAMBANDHASIDDHIHhk-216	cāvabhāti rājñaḥ puruṣa iti | rājapuruṣa iti tu viśeṣaṇabhūto rājā	ca avabhāti rājñaḥ puruṣaḥ iti rāja puruṣaḥ iti tu viśeṣaṇa bhūtaḥ rājā 
MBSAMBANDHASIDDHIHhk-217	sarvathā parihāritasvarūpo viśeṣyātmatāmevaikāntenāpannaḥ	sarvathā parihārita sva rūpaḥ viśeṣya ātma tām eva ekāntena āpannaḥ 
MBSAMBANDHASIDDHIHhk-218	prathate, -	prathate 
MBSAMBANDHASIDDHIHhk-219	(p. 9)	p 
MBSAMBANDHASIDDHIHhk-220	iti na tatra saṃbandhavācoyuktiḥ | nīlamutpalamityatrāpi	iti na tatra saṃbandha vācoyuktiḥ nīlam utpalam iti atra api 
MBSAMBANDHASIDDHIHhk-221	utpalāntaḥpraviṣṭaṃ nīlamiti nīlavadutpalaṃ pradhānam | sthālyāṃ	utpala antar praviṣṭam nīlam iti nīla vat utpalam pradhānam sthālyām 
MBSAMBANDHASIDDHIHhk-222	kāṣṭhairityatrāpi kartrāśritāṃ kriyāmupalīnāḥ sthālyādayaḥ	kāṣṭhaiḥ iti atra api kartrā āśritām kriyām upalīnāḥ sthālī ādayaḥ 
MBSAMBANDHASIDDHIHhk-223	prakāśante | ghaṭasyābhāva ityatrāpi abhāvo	prakāśante ghaṭasya abhāvaḥ iti atra api 
MBSAMBANDHASIDDHIHhk-224	vikalpabuddhāvantarnītaghaṭaḥ prādhānyenāvabhāti |	vikalpa buddhau antar nīta ghaṭaḥ prādhānyena avabhāti 
MBSAMBANDHASIDDHIHhk-225	ayamasmādanya	ayam asmāt anya 
MBSAMBANDHASIDDHIHhk-226	ityanyārtho'nyatvāparityāgenaivāntarnītāparānyārtho viśeṣya iti |	iti anya arthaḥ nyatva aparityāgena eva antar nīta apara anya arthaḥ viśeṣyaḥ iti 
MBSAMBANDHASIDDHIHhk-227	evaṃ sarvatrānumantavyam | kriyākārakasaṃbandhe [kha. pu.	evam sarvatra anumantavyam kriyā kāraka saṃbandhe kha pu 
MBSAMBANDHASIDDHIHhk-228	saṃbhinna iti pāṭhaḥ |]	saṃbhinnaḥ iti pāṭhaḥ 
MBSAMBANDHASIDDHIHhk-229	tātkālikopakāryopakārakabhāvamayasaṃbandhābhāsaḥ,	tātkālika upakārya upakāraka bhāva maya saṃbandha ābhāsaḥ 
MBSAMBANDHASIDDHIHhk-230	śeṣasaṃbandhe tu smaryamāṇopakāramayaḥ smaraṇāvasthāyāmapi	śeṣa saṃbandhe tu smaryamāṇa upakāra mayaḥ smaraṇa avasthāyām api 
MBSAMBANDHASIDDHIHhk-231	ca pūrvadṛṣṭārthāvabhāsa eva parāmarśaikyādityuktam | na	ca pūrva dṛṣṭa artha avabhāsaḥ eva parāmarśa aikyāt iti uktam na 
MBSAMBANDHASIDDHIHhk-232	kevalaṃ ca	kevalam ca 
MBSAMBANDHASIDDHIHhk-233	saṃbandhamayaikatāsparśiparimitamāyāmātṛparyavasāyī	saṃbandha maya eka tā sparśi parimita māyā mātṛ paryavasāyī 
MBSAMBANDHASIDDHIHhk-234	vastuprakāśanavyāpāro,	vastu prakāśana vyāpāraḥ 
MBSAMBANDHASIDDHIHhk-235	yāvadanantacinmayaśivatāvabhāsaviśrāntaiva pratikṣaṇaṃ	yāvat ananta cit maya śiva tā avabhāsa viśrāntā eva pratikṣaṇam 
MBSAMBANDHASIDDHIHhk-236	vastusaṃvitkriyā | na ca saṃvidaḥ kramo'sti ekaivaikatraiva	vastu saṃvid kriyā na ca saṃvidaḥ kramaḥ usti ekā eva ekatra eva 
MBSAMBANDHASIDDHIHhk-237	kṣaṇe'rthaprakāśanā, saiva saṃbandhaśivatāmayameva	kṣaṇa īrtha prakāśanā sā eva saṃbandha śiva tā mayam eva 
MBSAMBANDHASIDDHIHhk-238	svarūpamāviṣkaroti, - ityucyate | tathā cācāryadharmakīrtiḥ	svarūpam āviṣkaroti iti ucyate tathā ca ācārya dharmakīrtiḥ 
MBSAMBANDHASIDDHIHhk-239	bahirmukhaṃ ca tajjñānaṃ bhātyarthapratibhāsavat [kha. pu.	bahirmukham ca tat jñānam bhāti artha pratibhāsa vat kha pu 
MBSAMBANDHASIDDHIHhk-240	bhāvārtheti pāṭhaḥ |] |	bhāva artha iti pāṭhaḥ 
MBSAMBANDHASIDDHIHhk-241	buddheśca grāhikā buddhirnityamantarmukhātmani ||	buddheḥ ca grāhikā buddhiḥ nityam antarmukha ātmani 
MBSAMBANDHASIDDHIHhk-242	iti | antarmukheti, ātmanīti ca	iti antar mukhā iti ātmani iti ca 
MBSAMBANDHASIDDHIHhk-243	svasaṃvedanamarthābhāsaśūnyamapṛthagbhūtaṃ coktam | tathā	sva saṃvedanam artha ābhāsa śūnyam apṛthak bhūtam ca uktam tathā 
MBSAMBANDHASIDDHIHhk-244	pratyabhijñāyāmuktaṃ	pratyabhijñāyām uktam 
MBSAMBANDHASIDDHIHhk-245	yā caiṣā pratibhānantapadārthakramarūṣitā |	yā ca eṣā pratibhā ananta padārtha krama rūṣitā 
MBSAMBANDHASIDDHIHhk-246	akramānantacidrūpaḥ pramātā sa maheśvaraḥ || (ī. pra. 1|7|1)	akrama ananta cit rūpaḥ pramātā sa maheśvaraḥ 
MBSAMBANDHASIDDHIHhk-247	ityetattatraiva vitatya pradarśitam | yadapyuktaṃ pratītikāla	iti etat tatra eva vitatya pradarśitam yat api uktam pratīti kāla 
MBSAMBANDHASIDDHIHhk-248	(p. 10)	p 
MBSAMBANDHASIDDHIHhk-249	eva sāmānyasyeva saṃbandhasyābhyupagama iti, tanna kevalamasya	eva sāmānyasya iva saṃbandhasya abhyupagamaḥ iti tat na kevalam asya 
MBSAMBANDHASIDDHIHhk-250	yāvatsarvasyaivārthasya bodhabahirbhūtasya kasyacidabhāvāt |	yāvat sarvasya eva arthasya bodha bahis bhūtasya kasyacid abhāvāt 
MBSAMBANDHASIDDHIHhk-251	sāmānyaṃ caikamanekamayaṃ bahirapi pṛthageva	sāmānyam ca ekam aneka mayam bahis api pṛthak eva 
MBSAMBANDHASIDDHIHhk-252	sāmānyanikurambarūpebhyaḥ svalakṣaṇebhyaḥ [kha. pu. lakṣaṇaḥ	sāmānya nikuramba rūpebhyaḥ sva lakṣaṇebhyaḥ kha pu lakṣaṇaḥ 
MBSAMBANDHASIDDHIHhk-253	iti pāṭhaḥ |] | taccaikenaiva śabdenāniyatasvalakṣaṇāśrayatvena	iti pāṭhaḥ tat ca ekena eva śabdena aniyata sva lakṣaṇa āśraya tvena 
MBSAMBANDHASIDDHIHhk-254	pratipādyate, tacca	pratipādyate tat ca 
MBSAMBANDHASIDDHIHhk-255	kalpitasvalakṣaṇasaṃbandhamekaśabdapratipādyameva gauriti | ata eva	kalpita sva lakṣaṇa saṃbandham eka śabda pratipādyam eva gauḥ iti atas eva 
MBSAMBANDHASIDDHIHhk-256	samavāyākhyaḥ saṃbandha ucyate | sāmānādhikaraṇye'pi	samavāya ākhyaḥ saṃbandhaḥ ucyate sāmānādhikaraṇye pi 
MBSAMBANDHASIDDHIHhk-257	dvayorekaniṣṭhatā | tatra caikaṃ tadvastu astivākyapratipādyaṃ	dvayoḥ eka niṣṭha tā tatra ca ekam tat vastu astivākya pratipādyam 
MBSAMBANDHASIDDHIHhk-258	nīlamutpalamiti | saṃbandhaḥ punardvayorviśeṣyaikyatā na tvevaṃ	nīlam utpalam iti saṃbandhaḥ punar dvayoḥ viśeṣya aikya tā na tu evam 
MBSAMBANDHASIDDHIHhk-259	vastvantaraṃ prakāśate, - ityayaṃ viśeṣaḥ | sāmānādhikaraṇye'pi	vastu antaram prakāśate iti ayam viśeṣaḥ sāmānādhikaraṇye pi 
MBSAMBANDHASIDDHIHhk-260	vā nīlamutpalamiti viśeṣyotpalaniṣṭhataiveti saṃbandhataiva |	vā nīlam utpalam iti viśeṣya utpala niṣṭha tā eva iti saṃbandha tā eva 
MBSAMBANDHASIDDHIHhk-261	sāmānyādbhāntiviṣayaḥ saṃbandhaḥ, - ityapi yaduktaṃ	sāmānyāt bhānti viṣayaḥ saṃbandhaḥ iti api yat uktam 
MBSAMBANDHASIDDHIHhk-262	tadapyatyalpamuktam | viśvamapīdaṃ	tat api ati alpam uktam viśvam api idam 
MBSAMBANDHASIDDHIHhk-263	cidabhedākhyātimayabhrāntipadameva | bhrāntāvapi cāsyāṃ punaḥ	cit abheda akhyāti maya bhrānti padam eva bhrāntau api ca asyām punar 
MBSAMBANDHASIDDHIHhk-264	svapnadvicandrādivadbhāntatā nāsti saṃvādāditi	svapna dvi candra ādi vat bhānta tā na asti saṃvādāt iti 
MBSAMBANDHASIDDHIHhk-265	sarvametannirṇītaṃ ṭīkāyām | tadevaṃ	sarvam etat nirṇītam ṭīkāyām tat evam 
MBSAMBANDHASIDDHIHhk-266	pūrṇacitsvarūpaparyālocanākṣamāstāvanmātrābhiniveśena	pūrṇa cit svarūpa paryālocana akṣamāḥ tāvat mātra abhiniveśena 
MBSAMBANDHASIDDHIHhk-267	saṃbandhapadārthapratyākhyānakāriṇo'saṃbaddhābhidhāyina iti |	saṃbandha padārtha pratyākhyāna kāriṇaḥ saṃbaddha abhidhāyinaḥ iti 
MBSAMBANDHASIDDHIHhk-268	(tadāha)	tat āha 
MBSAMBANDHASIDDHIHhk-269	apekṣā pāratantryaṃ ca na saṃbandho jaḍātmanoḥ |	apekṣā pāratantryam ca na saṃbandhaḥ jaḍa ātmanoḥ 
MBSAMBANDHASIDDHIHhk-270	asaṃbhavādātmalābhe'pyupacāro na lakṣaṇā || 1 ||	asaṃbhavāt ātma lābhe api upacāraḥ na lakṣaṇā 
MBSAMBANDHASIDDHIHhk-271	asatāmātmalābhokterdviṣṭhataivaṃ ca hīyate |	asatām ātma lābha ukteḥ dviṣṭha tā evam ca hīyate 
MBSAMBANDHASIDDHIHhk-272	(p. 11)	p 
MBSAMBANDHASIDDHIHhk-273	rūpasaṃśleṣa evaivaṃ saṃbandhārthaḥ sthitaḥ sa ca || 2 ||	rūpa saṃśleṣaḥ eva evam saṃbandha arthaḥ sthitaḥ sa ca 
MBSAMBANDHASIDDHIHhk-274	nānantaryamasaṃbandhāttathātve'yaḥśalākayoḥ |	na ānantaryam asaṃbandhāt tathā tu iyaḥśalākayoḥ 
MBSAMBANDHASIDDHIHhk-275	tenānekasya rūpasya śleṣa aikātmyameva saḥ || 3 ||	tena anekasya rūpasya śleṣaḥ aikātmyam eva saḥ  /
MBSAMBANDHASIDDHIHhk-276	naikasyaikye'pyanekasya bādha āhuryathā pare |	na ekasya aikye api anekasya bādhaḥ āhuḥ yathā pare 
MBSAMBANDHASIDDHIHhk-277	ityamiśrāḥ svayaṃ bhāvāstānyojayati kalpanā || 4 ||	iti amiśrāḥ svayam bhāvāḥ tān yojayati kalpanā 
MBSAMBANDHASIDDHIHhk-278	yato na kalpanāmātraṃ tāvadetadavāraṇāt |	yatas na kalpanā mātram tāvat etat avāraṇāt 
MBSAMBANDHASIDDHIHhk-279	sarpabhrānterivābhāsalagnatvāttannivāraṇam || 5 ||	sarpa bhrānteḥ iva ābhāsa lagna tvāt tat nivāraṇam 
MBSAMBANDHASIDDHIHhk-280	yasmādābhāsalagnatvaṃ nābhāsasadṛśārthatā |	yasmāt ābhāsa lagna tvam na ābhāsa sadṛśa artha tā 
MBSAMBANDHASIDDHIHhk-281	kiṃ tvābhāsānusāritvaṃ bhrānta ābhāsa eva tat || 6 ||	kim tu ābhāsa anusāri tvam bhrānte ābhāse eva tat 
MBSAMBANDHASIDDHIHhk-282	itthamābhāsa evāsminnanekasyaikatādṛśi |	ittham ābhāse eva asmin anekasya eka tādṛśi 
MBSAMBANDHASIDDHIHhk-283	vācyopapattiḥ sāpyuktā pratyabhijñānaye sphuṭam || 7 ||	vācya upapattiḥ sā api uktā pratyabhijñā naye sphuṭam 
MBSAMBANDHASIDDHIHhk-284	evaṃ ca sati vastūnāṃ cinmātravapuṣāṃ satām |	evam ca sati vastūnām cit mātra vapuṣām satām 
MBSAMBANDHASIDDHIHhk-285	māyānirmitabhedānāmapyekatvamadurghaṭam || 8 ||	māyā nirmita bhedānām api eka tvam adurghaṭam 
MBSAMBANDHASIDDHIHhk-286	tatrāpi yaḥ parāmarśaviṣayo laukikasya saḥ |	tatra api yaḥ parāmarśa viṣayaḥ laukikasya saḥ 
MBSAMBANDHASIDDHIHhk-287	cidabhedaprathārūpabhedasārasya vedituḥ || 9 ||	cit abheda prathā rūpa bheda sārasya vedituḥ 
MBSAMBANDHASIDDHIHhk-288	vyāpāro'nena ruddho'sau na vikalpāntaraṃ spṛśet |	vyāpāra ūnena ruddhaḥ asau na vikalpa antaram spṛśet 
MBSAMBANDHASIDDHIHhk-289	vikalpāntarasaṃsparśe mātṛbhedaprasaṅgataḥ || 10 ||	vikalpa antara saṃsparśe mātṛ bheda prasaṅgataḥ 
MBSAMBANDHASIDDHIHhk-290	tadekāmarśavartyekaśabdādhyāsavaśādbrajet |	tat eka āmarśa varti eka śabda adhyāsa vaśāt brajet 
MBSAMBANDHASIDDHIHhk-291	aneko'pyekatāmartho yathā ghaṭapaṭāviti || 11 ||	anekaḥ upi ekatām arthaḥ yathā ghaṭa paṭau iti 
MBSAMBANDHASIDDHIHhk-292	(p. 13)	p 
MBSAMBANDHASIDDHIHhk-293	ityasti tāvadanyaśca viśeṣaṇaviśeṣyayoḥ |	iti asti tāvat anyaḥ ca viśeṣaṇa viśeṣyayoḥ 
MBSAMBANDHASIDDHIHhk-294	saṃbandha upakārārthaḥ sa jñātumupayujyate || 12 ||	saṃbandhaḥ upakāra arthaḥ sa jñātum upayujyate 
MBSAMBANDHASIDDHIHhk-295	bahutve'pi bhaveddvitvaṃ viśeṣaṇaviśeṣyayoḥ |	bahu tve api bhavet dvi tvam viśeṣaṇa viśeṣyayoḥ 
MBSAMBANDHASIDDHIHhk-296	dvivimarśabhuvo yadvadrājño'śvarathapattayaḥ || 13 ||	dvi vimarśa bhuvaḥ yadvat rājñā uśva ratha pattayaḥ 
MBSAMBANDHASIDDHIHhk-297	vimarśo rājña ityekaḥ svasāmānyonmukhaḥ paraḥ |	vimarśaḥ rājñaḥ iti ekaḥ sva sāmānya unmukhaḥ paraḥ 
MBSAMBANDHASIDDHIHhk-298	svāmisāmānyasaṃbandhasahaḥ puruṣa ityayam || 14 ||	svāmi sāmānya saṃbandha sahaḥ puruṣaḥ iti ayam 
MBSAMBANDHASIDDHIHhk-299	rājñaḥ puruṣa ityeṣa paścātsaṃbandhagocaraḥ |	rājñaḥ puruṣaḥ iti eṣa paścāt saṃbandha gocaraḥ 
MBSAMBANDHASIDDHIHhk-300	kalpyo'nenātha vā kalpyau pūrvau te sarvathā trayaḥ || 15	kalpya ūnena atha vā kalpyau pūrvau te sarvathā trayaḥ 
MBSAMBANDHASIDDHIHhk-301	ṣaṣṭhyādivācyaḥ saṃbandho viniviṣṭo viśeṣaṇe |	ṣaṣṭhī ādi vācyaḥ saṃbandhaḥ viniviṣṭaḥ viśeṣaṇe 
MBSAMBANDHASIDDHIHhk-302	viśeṣyaikatvamāpanne svaṃ ca rūpamanujjhati || 16 ||	viśeṣya eka tvam āpanne svam ca rūpam anujjhati 
MBSAMBANDHASIDDHIHhk-303	(p. 14)	p 
MBSAMBANDHASIDDHIHhk-304	ekahānyā pradhānena śuddhenānyānyayogitā |	eka hānyā pradhānena śuddhena anya anya yogi tā 
MBSAMBANDHASIDDHIHhk-305	syādguṇasya yathā rājñaḥ puruṣo brāhmaṇasya ca || 17 ||	syāt guṇasya yathā rājñaḥ puruṣaḥ brāhmaṇasya ca 
MBSAMBANDHASIDDHIHhk-306	tathānyena pradhānena yaikatānyāpareṇa vā |	tathā anyena pradhānena vā 
MBSAMBANDHASIDDHIHhk-307	saṃbandhākhyā guṇasya syādrājño'śvaḥ puruṣo	saṃbandha ākhyā guṇasya syāt rājñośvaḥ 
MBSAMBANDHASIDDHIHhk-308	yathā || 18 ||	yathā 
MBSAMBANDHASIDDHIHhk-309	iti saṃbandhagatyuktā māyīyajñātṛniṣṭhitāḥ |	iti saṃbandha gati uktāḥ māyīya jñātṛ niṣṭhitāḥ 
MBSAMBANDHASIDDHIHhk-310	dhiyo vibhinnārthadṛśo vyavahārapravartikāḥ || 19 ||	dhiyaḥ vibhinna artha dṛśaḥ vyavahāra pravartikāḥ 
MBSAMBANDHASIDDHIHhk-311	na paraṃ tāstathā bhrāntāḥ sarvā api pratikṣaṇāt |	na param tāḥ tathā bhrāntāḥ sarvāḥ api pratikṣaṇāt 
MBSAMBANDHASIDDHIHhk-312	svasaṃvitsaṃjñakānantacidvimarśapratiṣṭhitāḥ || 20 ||	             
MBSAMBANDHASIDDHIHhk-313	(p. 15)	p 
MBSAMBANDHASIDDHIHhk-314	uktaḥ svasaṃvitsiddho'yaṃ nirbādha upayogavān |	uktaḥ sva saṃvid siddhaḥ yam nirbādhaḥ upayogavān 
MBSAMBANDHASIDDHIHhk-315	saṃbandhaḥ pratyabhijñāyāṃ pūrṇaḥ parikaraḥ punaḥ	saṃbandhaḥ pratyabhijñāyām pūrṇaḥ parikaraḥ punar 
MBSAMBANDHASIDDHIHhk-316	iti śrīmadudayākaraputrotpaladevācāryaviracitā	iti śrīmat udayākara putra utpaladeva ācārya viracitā 
MBSAMBANDHASIDDHIHhk-317	saṃbandhasiddhiḥ samāptā ||	saṃbandha siddhiḥ samāptā 
MBSAMBANDHASIDDHIHhk-318	śrīmatkaśmīrabhūbharturājñayā prītaye satām |	śrīmat kaśmīra bhūbhartuḥ ājñayā prītaye satām 
MBSAMBANDHASIDDHIHhk-319	madhusūdanakaulena saṃpādyeyaṃ prakāśitā ||	madhusūdana kaulena saṃpādyā iyam prakāśitā 
MBSAMBANDHASIDDHIHhk-320	MUKTABODHA INDOLOGICAL RESEARCH INSTITUTE©2011 Muktabodha Indological Research Institute  All Rights Reserved.E-texts may be viewed only online or downloaded for private study.E-texts may not, under any circumstances, be copied, republished,reproduced, distributed or sold, either in original or altered form, withoutthe express permission of Muktabodha Indological Research Institute in writing.Data-entered by the staff of Muktabodha under the direction of Mark S. G. Dyczkowski.	muktabodha indological research muktabodha indological research institute all rights reserved texts may be viewed only online or downloaded for private studye texts may not under any circumstances be copied republished reproduced distributed or sold either in original or altered form withoutthe express permission of muktabodha indological research institute in writing data entered by the staff of muktabodha under the direction of mark s g dyczkowski 
