segmentnr	original	analyzed
MBTattvaratnaavaliiHK-0	Muktabodha E-text in UTF-8	muktabodha etext in utf
MBTattvaratnaavaliiHK-1	###########################################################################MUKTABODHA INDOLOGICAL RESEARCH INSTITUTEwww.muktabodha.org©2011 Muktabodha Indological Research Institute  All Rights Reserved.E-texts may be viewed only online or downloaded for private study.E-texts may not, under any circumstances, be copied, republished,reproduced, distributed or sold, either in original or altered form, withoutthe express permission of Muktabodha Indological Research Institute in writing.Data-entered by the staff of Muktabodha under the direction of Mark S. G. Dyczkowski.Catalog number : M00290	muktabodha indological research muktabodha indological research institute all rights reserved texts may be viewed only online or downloaded for private studye texts may not under any circumstances be copied republished reproduced distributed or sold either in original or altered form withoutthe express permission of muktabodha indological research institute in writing data entered by the staff of muktabodha under the direction of mark s g dyczkowskicatalog number  /
MBTattvaratnaavaliiHK-2	Uniform title: tattvaratnāvalī	uniform title tattvaratnāvalī 
MBTattvaratnaavaliiHK-3	Author : vimalaśiva	authoḥ vimala śiva 
MBTattvaratnaavaliiHK-4	Manuscript : NGMCP 1-1697-7/6 reel number: B 26/16	manuscript nm number b 
MBTattvaratnaavaliiHK-5	Description: Tattvaratnāvalī by Vimalaśiva a South Indian Siddhāntin. This is a brief liturgical manual for the basic rites of Siddhānta śaivism. The first chapter deals with the regular daily rite (nitya) and the second with occasional rite (naimittika) performed on special festive occasions. The third chapter deals with the worship of the basic Navanābhamaṇḍala with nine sections, eight arranged around the central one each containing nine parts of the 81 parts (pada) of the Vyomavyāpin mantra which is the standard mantra of Siddhānta śaivism which begins with invocation of Sadāśiva as Vyomavyapin, that is, as -the one who pervades the sky-(written out fully on fl. 10)	description tattvaratnāvalī by vimalaśiva a south indian siddhāntin this is a brief liturgical manual for the basic rites of siddhānta śaivism the first chapter deals with the regular daily rite nitya and the second with occasional rite naimittika performed on special festive occasions the third chapter deals with the worship of the basic navanābha maṇḍala with nine sections eight arranged around the central one each containing nine parts of the parts pada of the vyomavyāpin mantra 
MBTattvaratnaavaliiHK-6	Notes: Revision 0: December 17, 2013	notes revision december 
MBTattvaratnaavaliiHK-7	Publication country : India	publication country india 
MBTattvaratnaavaliiHK-8	tattvaratnāvalī	tattvaratnāvalī 
MBTattvaratnaavaliiHK-9	1)  unclear	unclear 
MBTattvaratnaavaliiHK-10	2a)	a 
MBTattvaratnaavaliiHK-11	ekarūpādhvarośaṃbhau kathaṃ kāmaphalapradāḥ ||	katham kāma phala pradāḥ 
MBTattvaratnaavaliiHK-12	maṃḍalasya pramāṇaṃ tu dvārakoṇasamanvitaṃ |	maṃḍalasya pramāṇam tu dvāra koṇa samanvitam 
MBTattvaratnaavaliiHK-13	garbhapadmapurā vyoma kiṃ * * * * *? dvitoḥ ||	garbha padma purāḥ vyoma kim      
MBTattvaratnaavaliiHK-14	dalopadalatānaṃta kesarāṇāṃ * * * *? |	kesarāṇām     
MBTattvaratnaavaliiHK-15	karṇīkāyāṃ pramāṇena kathyaṃte tu vyavasthitāḥ ||	karṇīkāyām pramāṇena kathyaṃte tu vyavasthitāḥ 
MBTattvaratnaavaliiHK-16	vīṣyantarapramāṇaṃ tu rajānāṃ lakṣaṇaṃ kathaṃ |	vīṣi antara pramāṇam tu rajānām lakṣaṇam katham 
MBTattvaratnaavaliiHK-17	pātanīya viśeṣeṇa puṣṭyarthe? śāṃti māraṇe ||	pātanīya viśeṣeṇa puṣṭi arthe śāṃti māraṇe 
MBTattvaratnaavaliiHK-18	sthūlaṃ sūkṣmataraṃ deva hīnāvā rekhikā yadā |	sthūlam sūkṣmataram deva rekhikā yadā 
MBTattvaratnaavaliiHK-19	guṇadoṣo bhavet tasya karmā? ca? parameśvara ||	guṇa doṣaḥ bhavet tasya karmā ca parameśvara 
MBTattvaratnaavaliiHK-20	kathaṃ dollā? prakartavyā sādhakādiṣu deśikaiḥ |	katham dollā prakartavyā sādhaka ādiṣu deśikaiḥ 
MBTattvaratnaavaliiHK-21	eka tatve? sthitāḥ? paṃca tatvā vai pārthiva? ||	eka tatve sthitāḥ paṃca tatvā vai pārthiva 
MBTattvaratnaavaliiHK-22	pṛthivyāḥ kataraṃ? tatvaṃ apāścaiva nāthāntare ||	pṛthivyāḥ katarat apāḥ ca eva na atha antare 
MBTattvaratnaavaliiHK-23	tejo vāyu svamūrtīmāṃ ke bījāḥ parikīrtitāḥ |	tejaḥ vāyu ke bījāḥ parikīrtitāḥ 
MBTattvaratnaavaliiHK-24	kathaṃ sarvāṇi tatvā * * * * * * * * *##?	katham sarvāṇi tatvā 
MBTattvaratnaavaliiHK-25	balāvalara? tattvājāka? * ? bhavati śaṃkaraḥ ||	bhavati śaṃkaraḥ 
MBTattvaratnaavaliiHK-26	sarvesarva gatāḥ proktāḥ sarvesarvajña bhāvitāḥ |	sarvesarva gatāḥ proktāḥ sarvesarvajña bhāvitāḥ 
MBTattvaratnaavaliiHK-27	aśuddhāḥ ke samuddiṣṭāḥ śuddhāvāke maheśvara |	aśuddhāḥ ke samuddiṣṭāḥ śuddhāvāke maheśvara 
MBTattvaratnaavaliiHK-28	2b)	b 
MBTattvaratnaavaliiHK-29	śaucamācamanaṃ devyā hṛdāvahniṃ prapūjayet |	śaucam ācamanam devyāḥ hṛdā vahnim prapūjayet 
MBTattvaratnaavaliiHK-30	taduktārthaṃkare? devyā vadhnīyād darbhakaṃ kaṇaṃ ||	            
MBTattvaratnaavaliiHK-31	garbhādhāne yajedagnimajena hṛdayena tu |	garbhādhāne yajet agnim ajena hṛdayena tu 
MBTattvaratnaavaliiHK-32	juhuyādāhutīstisra evaṃ puṃsavanaṃ caret ||	juhuyāt āhutīḥ tisraḥ evam puṃsavanam caret 
MBTattvaratnaavaliiHK-33	vāmadeva śirobhyāṃ ca vahnāvastrakaṇaṃ kṣipet |	vāmadeva śirobhyām ca vahnāvastra kaṇam kṣipet 
MBTattvaratnaavaliiHK-34	sīmatonnayana rūpi śikhābhyāśikhayaivat ||	sīmatonnayana rūpi śikhā abhyāśikhayā evat 
MBTattvaratnaavaliiHK-35	vaktrāṃgakalpanā kuryād vakrodghāṭana niḥkṛtī |	          
MBTattvaratnaavaliiHK-36	jātakarmaṃnu varmabhyāṃ kṛtvāgniṃ daśabāhukaṃ ||	jātakarma nu varmabhyām kṛtvā agnim daśa bāhukam 
MBTattvaratnaavaliiHK-37	paṃcāsya mantraṇaṃ dhyātvā kuśirvahniṃ pradīpayet |	paṃcāsya mantraṇam dhyātvā kuśiḥ vahnim pradīpayet 
MBTattvaratnaavaliiHK-38	snānaṃ salāpahaṃ? dhyātvā devyāḥ sauvarṇavaṃdhanaṃ ||	snānam dhyātvā devyāḥ sauvarṇa vaṃdhanam 
MBTattvaratnaavaliiHK-39	kuṃḍamastreṇa sasiṃcet sadyaḥ sūtaka śuddhaye |	kuṃḍam astreṇa sa siṃcet sadyas sūtaka śuddhaye 
MBTattvaratnaavaliiHK-40	tataḥ śastreṇa saṃtāḍya varmaṇā bhyukṣya bāhyataḥ ||	tatas śastreṇa saṃtāḍya varmaṇā bhyukṣya bāhyatas 
MBTattvaratnaavaliiHK-41	śastreṇottara pūrvāgrānva?rbhānāsnīyaṃ vinyaset |	śastreṇa uttara pūrva agrān varbhān āsnīyam vinyaset 
MBTattvaratnaavaliiHK-42	paridhīsvistarāṃstatra vyastrāllālāpanuntaye ||	paridhīḥ vistarān tatra 
MBTattvaratnaavaliiHK-43	samidhā paṃcahotavyāḥ prānte mūle ghṛtaplutāḥ |	samidhā paṃcahotavyāḥ prānte mūle ghṛta plutāḥ 
MBTattvaratnaavaliiHK-44	vidhiṃ rudraṃ hariṃ veśaṃ paridhiṃ pūrvato yajet ||	vidhim rudram harim veśam paridhim pūrvatas yajet 
MBTattvaratnaavaliiHK-45	viṣṭare lokapālāṃśca śivājñāṃ śrāvayediti |	viṣṭare lokapālān ca śiva ājñām śrāvayet iti 
MBTattvaratnaavaliiHK-46	nivāryavighnasaṃghātaṃ bālakaṃ pālapiṣyatha ||	nivārya vighna saṃghātam bālakam pālapiṣyatha 
MBTattvaratnaavaliiHK-47	yajñādhyakṣaṃ vidhi yāmye sadarbhe śuṣkagomaye |	yajña adhyakṣam yāmye sa darbhe śuṣka gomaye 
MBTattvaratnaavaliiHK-48	yajet saumye hariṃvāri pātre yajñasya rakṣaka ||	yajet saumye hariṃvāri pātre yajñasya rakṣaka 
MBTattvaratnaavaliiHK-49	tataḥ kaṅkaṇakaṃ devyā muṃcedvāmakarasthitaṃ |	tatas kaṅkaṇakam devyāḥ muṃcet vāma kara sthitam 
MBTattvaratnaavaliiHK-50	ādāya srūcchuvābūddhaṃ vadanādho mukhau tṛdhā ||	ādāya vadana adhas mukhau tṛdhā 
MBTattvaratnaavaliiHK-51	pretā pyāgnau spṛśe darbha mūlamadhyāgrakaiḥ kramāt |	pretā spṛśe darbha mūla madhya agrakaiḥ kramāt 
MBTattvaratnaavaliiHK-52	nyaset tatva trayaṃ tatra srūci śaktiḥ sruve śivaḥ ||	nyaset trayam tatra srūci śaktiḥ sruve śivaḥ 
MBTattvaratnaavaliiHK-53	trimūtrī veṣṭita grīvau svadakṣenyasya pūjayet |	trimūtrī veṣṭita grīvau pūjayet 
MBTattvaratnaavaliiHK-54	vīkṣaṇādi catuḥśuddhamādāyā hyasya bhājanaṃ ||	vīkṣaṇa ādi catur śuddham ādāya ā hi asya bhājanam 
MBTattvaratnaavaliiHK-55	dhyātvātmīyatanuṃ brāhmī kuṃḍorddhe bhrāmayet tridhā |	dhyātvā ātmīya tanum brāhmī kuṃḍa ūrddhe bhrāmayet tridhā 
MBTattvaratnaavaliiHK-56	tāpayitvāgni di * * * * * *? dvātha gajosva	tāpayitvā agni 
MBTattvaratnaavaliiHK-57	praliṃgāthavā ||?	praliṃgā athavā 
MBTattvaratnaavaliiHK-58	3a)	a 
MBTattvaratnaavaliiHK-59	bhrāṃtiḥ kuṃḍe diśo bhrāṃte mānahīne daridratā |	bhrāṃtiḥ kuṃḍe diśaḥ bhrāṃte māna hīne daridra tā 
MBTattvaratnaavaliiHK-60	sūtrādhike suhṛdveṣo vākkuṃṭhaḥ kaṃṭhavarjite ||	sūtra adhike suhṛd veṣaḥ vāc kuṃṭhaḥ kaṃṭha varjite 
MBTattvaratnaavaliiHK-61	asiddhiścāsuro bhogo nyūnādhika nikhāṃtake |	asiddhiḥ ca āsuraḥ bhogaḥ 
MBTattvaratnaavaliiHK-62	kṣapaśca vyādhivṛddhiśca mānonādhikamekhale ||	kṣapaḥ ca vyādhi vṛddhiḥ ca māna ūna adhika mekhale 
MBTattvaratnaavaliiHK-63	vībhoṣvetyādapasmāro nirnābhini bhagaṃdaraḥ |	vībhoṣva ityāt apasmāraḥ nirnābhini bhagaṃdaraḥ 
MBTattvaratnaavaliiHK-64	uccāṭaḥ sphuṭite chidra saṃkule vācyatā bhavet ||	uccāṭaḥ sphuṭite chidra saṃkule vācyatā bhavet 
MBTattvaratnaavaliiHK-65	juhuyāt sthaṃḍile yadvā harāṃtpātada? bhāvataḥ |	juhuyāt sthaṃḍile yat vā bhāvataḥ 
MBTattvaratnaavaliiHK-66	tatva dṛṣṭyādi maṃtreṇa tannirikṣya śarāṇunā ||	dṛṣṭi ādi maṃtreṇa tat nirikṣya śarāṇunā 
MBTattvaratnaavaliiHK-67	prokṣyā tāḍya tanutreṇa samabhyukṣya kuśāsinā |	prokṣya ā tāḍya tanutreṇa samabhyukṣya kuśa asinā 
MBTattvaratnaavaliiHK-68	khātvoddhṛtya pūrayitvā samīkṛtya valena tu ||	khātvā uddhṛtya pūrayitvā samīkṛtya valena tu 
MBTattvaratnaavaliiHK-69	saṃsiddhyāstreṇa saṃku * *? mārjayitvopalipya ca |	saṃsiddhyā astreṇa saṃku mārjayitvā upalipya ca 
MBTattvaratnaavaliiHK-70	kalpayitvā kalārūpaṃ trisūnyā veṣṭya varmaṇā ||	kalpayitvā kalā rūpam trisūnyā veṣṭya varmaṇā 
MBTattvaratnaavaliiHK-71	hṛdābhyarca? kuśāstreṇa rekhātraya mudaṅmukhaṃ |	hṛdā abhyarca kuśa astreṇa 
MBTattvaratnaavaliiHK-72	kuryāt prāgāna nāmekāṃ yadvā tāsāṃ viparyayaḥ ||	kuryāt nāma ekām yat vā tāsām viparyayaḥ 
MBTattvaratnaavaliiHK-73	kurvanti ka *? tādrekhāni vṛtti vṛtrame dasaḥ |	kurvanti ka tādrekhāni vṛtti vṛtrame dasaḥ 
MBTattvaratnaavaliiHK-74	kṣālanaṃ śosaṇaṃ pākaṃ kuṃḍe brahmādi daivataḥ ||	kṣālanam śosaṇam pākam kuṃḍe brahma ādi daivataḥ 
MBTattvaratnaavaliiHK-75	vajrīkṛtyāstrato darbhirhṛdā kuryāccatuḥ pathaṃ |	vajrīkṛtya astrataḥ darbhiḥ hṛdā kuryāt catuḥ patham 
MBTattvaratnaavaliiHK-76	kaṃṭhe catuḥ kuśairakṣa pāṭamādhāya varmaṇā ||	kaṃṭhe catuḥ kuśaiḥ akṣa pāṭam ādhāya varmaṇā 
MBTattvaratnaavaliiHK-77	hṛdāthavi *? ra datvā devī devau hṛdārcayet |	da tvā devī devau hṛdā arcayet 
MBTattvaratnaavaliiHK-78	vahnīmānīya satpātre kravyādāṃśa vivarjitaṃ ||	vahnīm ānīya sat pātre kravyāda aṃśa vivarjitam 
MBTattvaratnaavaliiHK-79	vīkṣaṇādi catuḥ śuddhamekīkṛtyā nalatrayaṃ |	vīkṣaṇa ādi catuḥ śuddham ekīkṛtya ā nala trayam 
MBTattvaratnaavaliiHK-80	jāṭharaṃ vaiṃdavaṃ bhautaṃ hrūṃ caitanyaṃ pravinyaset ||	jāṭharam vaiṃdavam bhautam   caitanyam pravinyaset 
MBTattvaratnaavaliiHK-81	saṃhitā maṃtritaṃ vahnimamṛtī kṛtya rakṣitaṃ |	saṃhitā maṃtritam vahnim amṛtī kṛtya rakṣitam 
MBTattvaratnaavaliiHK-82	śastreṇa varmaṇā veṣṭya pūjayitvā pradakṣiṇaṃ ||	śastreṇa varmaṇā veṣṭya pūjayitvā pradakṣiṇam 
MBTattvaratnaavaliiHK-83	kuṃḍasyorddhva tridhā bhrāmya śivabījamiti smaran |	kuṃḍasya ūrddhva tridhā bhrāmya śivabījam iti smaran 
MBTattvaratnaavaliiHK-84	hṛdātmasanmukhā potrā? nāmaṣṭamāṃśikaḥ ||	potrā nāma aṣṭama aṃśikaḥ 
MBTattvaratnaavaliiHK-85	3b)	b 
MBTattvaratnaavaliiHK-86	pathyāmātrastu bhakṣyāṇāmikṣuṇāṃ parvasaṃmitaḥ |	pathyā mātraḥ tu bhakṣyāṇām ikṣuṇām parva saṃmitaḥ 
MBTattvaratnaavaliiHK-87	grāsārddhaḥ svinnakāśānāmannānāṃ grāsamātrakaḥ ||	grāsārddhaḥ svinna kāśānām annānām grāsa mātrakaḥ 
MBTattvaratnaavaliiHK-88	prasūnaphalapatrāṇāṃ svamāno vrīhi saṃtateḥ |	prasūna phala patrāṇām sva mānaḥ vrīhi saṃtateḥ 
MBTattvaratnaavaliiHK-89	lājānāṃ cakragā pūro yadvāstuṣṭi pramāṇakaḥ ||	lājānām cakra gā pūraḥ pramāṇakaḥ 
MBTattvaratnaavaliiHK-90	prādeśakastu samiddhāṃ gugulordhadarāsthivat |	prādeśakaḥ tu samiddhām 
MBTattvaratnaavaliiHK-91	tilasakraṃkaṇādīnāṃ mṛgāmātrāhutirbhavet ||	tila sa kraṃkaṇa ādīnām mṛgā mātrā āhutiḥ bhavet 
MBTattvaratnaavaliiHK-92	śrīkhaṃḍacaṃdrakāśmīra kastūrī pakṣakardamāḥ |	śrīkhaṃḍa caṃdra kāśmīra kastūrī pakṣa kardamāḥ 
MBTattvaratnaavaliiHK-93	hotavyāścaṇakaprāyā vallīnāmaṃguladvayaṃ ||	hotavyāḥ caṇaka prāyāḥ vallīnām aṃgula dvayam 
MBTattvaratnaavaliiHK-94	isthaṃ nirvartya vidhinā homaṃ pūrṇāntato yajet |	nirvartya vidhinā homam pūrṇa antataḥ yajet 
MBTattvaratnaavaliiHK-95	datvāvāmaṃ karodvarte tāṃbūlaṃ mukhavāsanaṃ ||	kara udvarte tāṃbūlam mukha vāsanam 
MBTattvaratnaavaliiHK-96	tadgati vaṃdanaṃ kṛtvā praṇamyābhyarcya śaṃvarān |	tad gati vaṃdanam kṛtvā praṇamya abhyarcya śaṃvarān 
MBTattvaratnaavaliiHK-97	saṃhṛtya hetilādāya kṣamasveti hṛdi nyaset ||	saṃhṛtya heti lādāya kṣamasva iti hṛdi nyaset 
MBTattvaratnaavaliiHK-98	āgnepyāmupakuṇḍantu kṛte maṃḍalaka dvaye |	āgnepyām upakuṇḍantu kṛte maṃḍalaka dvaye 
MBTattvaratnaavaliiHK-99	sarvapākāgramādāya dadyādantarvadvirvalī? ||	sarva pāka agram ādāya dadyāt antar vat viḥ valī 
MBTattvaratnaavaliiHK-100	prāgdakṣiṇāparodakṣu harāgnītya nileṣu ca |	prāc dakṣiṇa apara udakṣu nileṣu ca 
MBTattvaratnaavaliiHK-101	antarīdyāvake bhīrāmantarvāyu pracetasoḥ ||	antar id yāvake bhīrām antar vāyu pracetasoḥ 
MBTattvaratnaavaliiHK-102	rudramātṛgaṇā yakṣā grahadaityāsu pāhayaḥ |	rudra mātṛ gaṇāḥ yakṣāḥ graha daityāsu pāhayaḥ 
MBTattvaratnaavaliiHK-103	ṛkṣedurāśayo viśvāḥ ṛṣayaḥ kṣetrapālakaḥ ||	viśvāḥ ṛṣayaḥ kṣetrapālakaḥ 
MBTattvaratnaavaliiHK-104	sasvāhāḥ praṇavaśceti kīrtitā tarcalemaṃnuḥ |?	sa svāhāḥ praṇavaḥ ca iti kīrtitā 
MBTattvaratnaavaliiHK-105	iṃdrādibhyo valiṃ datvā madhye kṣetra patervaliṃ ||	iṃdra ādibhyaḥ valim da tvā madhye kṣetra pateḥ valim 
MBTattvaratnaavaliiHK-106	dvitīya maṃḍale dadyādvahirvalirudīritaḥ |	dvitīya maṃḍale dadyāt vahis valiḥ udīritaḥ 
MBTattvaratnaavaliiHK-107	patitāḥ kṣamayaḥ kākāḥ śvapacāḥ samadācyutāḥ ||	patitāḥ kṣamayaḥ kākāḥ śvapacāḥ samada acyutāḥ 
MBTattvaratnaavaliiHK-108	āgatya pratigṛhṇastu svāhetyuccārato vahiḥ |	āgatya pratigṛhṇaḥ tu svāhā iti uccārataḥ vahis 
MBTattvaratnaavaliiHK-109	datvā valiṃ samācamya valimaṃtrānvisarjayet ||	da tvā valim samācamya vali maṃtrān visarjayet 
MBTattvaratnaavaliiHK-110	tato nivedapiṅgatvā śivāyārghodakānvitaṃ |	tatas śivāya argha udaka anvitam 
MBTattvaratnaavaliiHK-111	hṛdvījapūrvamūlena pūjāhomādikaṃ phalaṃ ||	hṛd vīja pūrva mūlena pūjā homa ādikam phalam 
MBTattvaratnaavaliiHK-112	śivamabhyarcya saṃstutya datvā cārghaṃ parāṅmukhaṃ |	śivam abhyarcya saṃstutya da tvā ca argham parāṅmukham 
MBTattvaratnaavaliiHK-113	4a)	a 
MBTattvaratnaavaliiHK-114	kṣamasvetya bhidhāyātha saṃtrātsaṃhṛtyaśasvataḥ |	kṣamasva itya bhidhāya atha 
MBTattvaratnaavaliiHK-115	yojayet mūrtimaṃtreṇa pīṭhagarte gurūttamaḥ ||	yojayet mūrti maṃtreṇa pīṭha garte guru uttamaḥ 
MBTattvaratnaavaliiHK-116	pratimā suhṛdi snāne netrāntarlepya citrayoḥ |	pratimā suhṛdi snāne netra antar lepya citrayoḥ 
MBTattvaratnaavaliiHK-117	pustakekṣaramālāyāṃ sthaṃḍilāt punarātmani ||	pustaka ikṣara mālāyām sthaṃḍilāt punar ātmani 
MBTattvaratnaavaliiHK-118	tataścaṃḍaṃ samabhyarcya nirmālyādi samarpya ca |	tatas caṃḍam samabhyarcya nirmālya ādi samarpya ca 
MBTattvaratnaavaliiHK-119	nyūnādhikaṃ kṛtaṃ karma tatpūrayeti vijñapet ||	nyūna adhikam kṛtam karma tat pūraya iti vijñapet 
MBTattvaratnaavaliiHK-120	caṇḍanāthavisṛjyātha gomayā cchodhayedbhavaṃ |	          
MBTattvaratnaavaliiHK-121	tataḥ saṃpūjya kapilāṃ tasyai grāsavitīrsa ca ||	tatas saṃpūjya kapilām tasyai ca 
MBTattvaratnaavaliiHK-122	vidyāmabhyarcya vidhinā yajedguru padāṃbujaṃ |	vidyām abhyarcya vidhinā yajet guru pada aṃbujam 
MBTattvaratnaavaliiHK-123	athamaṃtrāḥ prakathyaṃte śivādīnā na tu kramāt ||	atha maṃtrāḥ prakathyaṃte śiva ādīnāḥ na tu kramāt 
MBTattvaratnaavaliiHK-124	nādaḥ sabindurmūlaṃ syānmantaṣaṣṭhasamanvitaḥ |	nādaḥ sa binduḥ mūlam syāt manta ṣaṣṭha samanvitaḥ 
MBTattvaratnaavaliiHK-125	ṣaddīrgha svarasaṃ yukto jātyaṃto gātraśaṃvaraḥ ||	sva rasam yuktaḥ jāti aṃtaḥ gātra śaṃvaraḥ 
MBTattvaratnaavaliiHK-126	pacahrasvairvilomena yuktaṃ īśādiśaṃvaraḥ |	paca hrasvaiḥ vilomena yuktam īśā diśaṃvaraḥ 
MBTattvaratnaavaliiHK-127	namaḥ svāhā tathā vauṣaṭ vaṣajya? dvajātayaḥ ||	namaḥ svāhā tathā vauṣaṭ vaṣajya dva jātayaḥ 
MBTattvaratnaavaliiHK-128	anukte hṛdayaṃ yojyaṃ maṃtrāḥ sarve dhruvādikāḥ |	an ukte hṛdayam yojyam maṃtrāḥ sarve dhruva ādikāḥ 
MBTattvaratnaavaliiHK-129	namontāḥ pūjane home svāhāṃtāḥ samudīritāḥ ||	namaḥ antāḥ pūjane home svāhā aṃtāḥ samudīritāḥ 
MBTattvaratnaavaliiHK-130	caṃḍāsanāya natyantaḥ caṇḍamūrtistathā vidhā |	caṃḍāsanāya nati antaḥ caṇḍamūrtiḥ tathā vidhā 
MBTattvaratnaavaliiHK-131	dhunicaṃḍeśvarāyeti hūṃ phaṭsvāhā dyuśamvaraḥ ||	dhunicaṃḍa īśvarāya iti hūm phaṭ svāhā dyuśamvaraḥ 
MBTattvaratnaavaliiHK-132	hrasvadīrghayutaṃ cārṇaṃ brahmāṃgeṣu niyojayet |	hrasva dīrgha yutam ca arṇam brahma aṃgeṣu niyojayet 
MBTattvaratnaavaliiHK-133	cosīśānāya? hūpha? dvetyādi vakrāṇi kalpayet ||	cosi īśānāya hūpha dvā ityādi vakrāṇi kalpayet 
MBTattvaratnaavaliiHK-134	caṇḍādi huṃ phaḍantāni hṛdayādīnyanu kramāt |	caṇḍa ādi hum phaṭ antāni hṛdaya ādīni anu kramāt 
MBTattvaratnaavaliiHK-135	tanmaheśāya vidmahe vāgvidyudvāya dhīmahe tannaḥ śivaḥ pracodayād gāyatrī	tat maheśāya vidmahe vāc vidyudvāya dhīmahe tat naḥ śivaḥ pracodayāt gāyatrī 
MBTattvaratnaavaliiHK-136	yaṃ dhruvādikā ||	yam dhruva ādikā 
MBTattvaratnaavaliiHK-137	eva maṃtra? gaṇaḥ proktaḥ śivārādhana karmaṇi |	eva maṃtra gaṇaḥ proktaḥ śiva ārādhana karmaṇi 
MBTattvaratnaavaliiHK-138	iti śrīvimalācāryanirmite tyaṃtanirmale? tatvaratnāvalīgraṃthe	iti śrī vimala ācārya nirmite tyaṃtanirmale tatva ratnāvalī graṃthe 
MBTattvaratnaavaliiHK-139	nityakarmavinirṇayaḥ ||	        
MBTattvaratnaavaliiHK-140	atha naimitikaṃ vakṣye tatra sūtraṃ	atha naimitikam vakṣye tatra sūtram 
MBTattvaratnaavaliiHK-141	4b)	b 
MBTattvaratnaavaliiHK-142	iśo?nādyā hṛdādyāśca caturvaktrāstrilocanāḥ |	iśona ādyāḥ hṛd ādyāḥ ca catur vaktrāḥ tri locanāḥ 
MBTattvaratnaavaliiHK-143	śaktiśūlavarābhīti proktabāhucatuṣṭayāḥ |	śakti śūla vara abhīti prokta bāhu catuṣṭayāḥ 
MBTattvaratnaavaliiHK-144	kvacidaṣṭabhujā vidyā patayopyaṣṭa? dikprabhāḥ |	kvacid aṣṭa bhujā vidyā diś prabhāḥ 
MBTattvaratnaavaliiHK-145	brahmeśaguhavaikuṃṭhavad brāhmṇyādi? catuṣṭayaṃ ||	brahma īśa guha vaikuṃṭha vat brāhmṇī ādi catuṣṭayam 
MBTattvaratnaavaliiHK-146	yāmyā payamava? śūkarāsyā vaiṃdrīṃ dravanmatā |	yāmyā śūkara āsyā vaiṃdrīm dravat matā 
MBTattvaratnaavaliiHK-147	carcāsi śūlakhaṭvāṃga kārdvāgni tvidgaṇoṣṭamaḥ ||	śūla khaṭvāṃga kārdvāgni tvid gaṇa uṣṭamaḥ 
MBTattvaratnaavaliiHK-148	vidyesvarāngaṇānmātṝrloke śākkuliśādikān |	vidyesvarān gaṇān mātṝḥ loke śāk kuliśa ādikān 
MBTattvaratnaavaliiHK-149	saṃpūjya daśayenmudrāḥ pūraṇāya kriyāvidhiḥ ||	saṃpūjya daśayet mudrāḥ pūraṇāya kriyā vidhiḥ 
MBTattvaratnaavaliiHK-150	īśādīnāṃ surabhyabja triśūlamakarī sṛcaḥ |	īśa ādīnām surabhi abja triśūla makarī sṛcaḥ 
MBTattvaratnaavaliiHK-151	bījamudrā hṛdādīnāṃ mudrānetrāṅkaṃ pāvake ||	bīja mudrā hṛd ādīnām mudrā netra aṅkam pāvake 
MBTattvaratnaavaliiHK-152	astrasya saṃhṛtirvidyeśvarāṇāmaṃbujā hvayā |	astrasya saṃhṛtiḥ vidyeśvarāṇām aṃbujā hvayā 
MBTattvaratnaavaliiHK-153	śūlākhyagaṇanāthānāghaṃṭā mātṛgaṇasya tu ||	mātṛ gaṇasya tu 
MBTattvaratnaavaliiHK-154	disṛtāṃ na tisaṃjñāsyāntrāsanyastra? gaṇasyan |	di sṛtām na ti saṃjñā asya antrāsanya stra gaṇasyan 
MBTattvaratnaavaliiHK-155	prabhormanorathā bījāśāṃtā śaktiḥ śarānanā ||	prabhoḥ manorathāḥ śaktiḥ śara ānanā 
MBTattvaratnaavaliiHK-156	adho na darśayenmudrāṃ *? pariṣṭākṣaraṃnnayet |	adhas na darśayet mudrām 
MBTattvaratnaavaliiHK-157	tataḥ saparivārāya dhūpaṃ dīpaṃ śivāṇunā |	tatas sa parivārāya dhūpam dīpam śiva aṇunā 
MBTattvaratnaavaliiHK-158	naivedyaṃ vividhaṃ dadyāt toyamācamanīyakaṃ ||	naivedyam vividham dadyāt toyam ācamanīyakam 
MBTattvaratnaavaliiHK-159	karodvartanatāṃbūla mukhavāsaṃ ca darpaṇaṃ |	kara udvartana tāṃbūla mukha vāsam ca darpaṇam 
MBTattvaratnaavaliiHK-160	dūrvākṣatapavitraṃ ca mūrddhni dadyānmaheśituḥ ||	dūrvā akṣata pavitram ca mūrddhni dadyāt maheśituḥ 
MBTattvaratnaavaliiHK-161	pavitreṇa vināpūjā tāmasīti nigadyate |	pavitreṇa vinā apūjā tāmasī iti nigadyate 
MBTattvaratnaavaliiHK-162	paramīkaraṇaṃ kuryāt tadvinā rājasī yataḥ ||	paramīkaraṇam kuryāt tat vinā rājasī yatas 
MBTattvaratnaavaliiHK-163	ekapuṣpī dvipuṣpī vā tripuṣpī cāṣṭapuṣpikā |	ekapuṣpī dvipuṣpī vā tripuṣpī ca aṣṭapuṣpikā 
MBTattvaratnaavaliiHK-164	kartavyādeśakālādi vayonasthānurūpataḥ ||	kartavya ādeśa kāla ādi 
MBTattvaratnaavaliiHK-165	japtvā nivedayet svāṃta maṃtritaṃ varmaveṣṭitaṃ |	japtvā nivedayet svāṃta maṃtritam varma veṣṭitam 
MBTattvaratnaavaliiHK-166	rakṣitaṃ hetinā toya kuśapuṣpākṣatānvitaṃ ||	rakṣitam hetinā kuśa puṣpa akṣata anvitam 
MBTattvaratnaavaliiHK-167	6a)	a 
MBTattvaratnaavaliiHK-168	mudrayodbhavayābhautitīvarahaste paṭhannisaṃ |	mudrayā udbhavayā abhauti tīvara haste 
MBTattvaratnaavaliiHK-169	guhyātiguhyagoptātvaṃ gṛhāṇāsmat kṛtaṃ japaṃ ||	guhya ati guhya goptā tvam gṛhāṇa asmat kṛtam japam 
MBTattvaratnaavaliiHK-170	siddhirbhavati meyena tvatprasādātvayi sthite |	siddhiḥ bhavati meyena tvad prasādā tvayi sthite 
MBTattvaratnaavaliiHK-171	evaṃ nivedayenmukti kāmaḥ ślo?kadvayaṃ paṭhan ||	evam nivedayet mukti kāmaḥ śloka dvayam paṭhan 
MBTattvaratnaavaliiHK-172	yat kiṃcit kurmahe deva sadā sukṛta duḥkṛtaṃ |	yat kiṃcid kurmahe deva sadā sukṛta duḥkṛtam 
MBTattvaratnaavaliiHK-173	tanme śivapadastasya hūṃkṣākṣapaya śaṃkara ||	tat me śiva padaḥ tasya hūṃkṣā kṣapaya śaṃkara 
MBTattvaratnaavaliiHK-174	śivo dātā śivo bhoktā śivā sarvamidaṃ jagat |	śivaḥ dātā śivaḥ bhoktā śivā sarvam idam jagat 
MBTattvaratnaavaliiHK-175	śivo yajaṃti sarvatra yaḥ śivaḥ sohamaiva ca ||	śivaḥ sarvatra yaḥ śivaḥ ca 
MBTattvaratnaavaliiHK-176	japtvā daśāṃśamaṃgānāṃ pradakṣiṇanatistutīḥ |	japtvā daśa aṃśam aṃgānām pradakṣiṇa nati stutīḥ 
MBTattvaratnaavaliiHK-177	kṛtvāntarbhūvitā? vyānta? jñātaḥ kuṃḍāntikaṃ vrajet ||	jñātaḥ kuṃḍa antikam vrajet 
MBTattvaratnaavaliiHK-178	tadvat kuṃḍaṃ raktaḥ koṇaṃ vartulaṃ vāthavārijaṃ |	tadvat kuṃḍam raktaḥ koṇam vartulam vā atha vāri jam 
MBTattvaratnaavaliiHK-179	sarvakāmapradaṃ nitya dīkṣāśāṃtiṣu hāstikaṃ ||	sarva kāma pradam dīkṣā śāṃtiṣu hāstikam 
MBTattvaratnaavaliiHK-180	śatārddhe śatahome ca muṣṭyarattimitaṃ kramāt |	śata arddhe śata home ca muṣṭi aratti mitam kramāt 
MBTattvaratnaavaliiHK-181	sahasrā yuta lakṣārddhe lakṣe paṃca dvipaṃcake ||	sahasrā yuta lakṣa arddhe lakṣe paṃca dvi paṃcake 
MBTattvaratnaavaliiHK-182	paṃcāśallakṣake koṭyāṃ kṛarādaṣṭa karāṃtikaṃ |	paṃcāśat lakṣake koṭyām kara aṃtikam 
MBTattvaratnaavaliiHK-183	muṣṭyaratnimite? kaṃṭho yavairvedaiḥ rasaiḥ kramāt ||	muṣṭi aratni mite kaṃṭhaḥ yavaiḥ vedaiḥ rasaiḥ kramāt 
MBTattvaratnaavaliiHK-184	hāstikeṣṭa yavaiḥ kaṃṭho nyeṣāṃ syādyava vṛddhitaḥ |	kaṃṭhaḥ ni eṣām syāt yava vṛddhitaḥ 
MBTattvaratnaavaliiHK-185	arddhāṃgulardvitaḥ kvāpi mekhalādyeśarāṃgulā ||	kvāpi mekhalā ādyeśara aṃgulā 
MBTattvaratnaavaliiHK-186	sārddhapaṃcāṃgulā ratnau hāstike syāt ṣaḍaṃgulā |	sārddha paṃca aṃgulā ratnau hāstike syāt ṣaṣ aṃgulā 
MBTattvaratnaavaliiHK-187	mekhalaikā tadanyathāmaṃgula dvaya vṛddhitaḥ ||	mekhalā ekā tad anyathām aṃgula dvaya vṛddhitaḥ 
MBTattvaratnaavaliiHK-188	sārddhadigrudraravibhiḥ parvabhirnābhirāyatā |	sa arddha diś rudra ravibhiḥ parvabhiḥ nābhiḥ āyatā 
MBTattvaratnaavaliiHK-189	vistṛtā saptasārddhāṣṭa parvabhiḥ prathame tṛke ||	vistṛtā sapta sārddha aṣṭa parvabhiḥ prathame tṛke 
MBTattvaratnaavaliiHK-190	saptāṣṭārkayavoccāsātha saptāṣṭayavoṣṭhikā |	sapta aṣṭa arka yava uccā āsā atha sapta aṣṭa yava uṣṭhikā 
MBTattvaratnaavaliiHK-191	śeṣāṇāṃ saptakuṃḍānāmuchrāyāntiryagāyateḥ ||	śeṣāṇām sapta kuṃḍānām uchrāyān tiryak āyateḥ 
MBTattvaratnaavaliiHK-192	yavatodvyaṃgulādyoniṣtryagulādvarddhate kramat |	yavataḥ dvi aṃgulāt yoniḥ tri agulāt varddhate kramat 
MBTattvaratnaavaliiHK-193	sasyarādvṛddhitoṣvā sā kuṇḍavadvāyugāṃśrikā ||	sā 
MBTattvaratnaavaliiHK-194	6b)	b 
MBTattvaratnaavaliiHK-195	nirdhāte * *? padmābhaṃ valasya sphaṭikābjavat |	nirdhāte padma ābham valasya sphaṭika abja vat 
MBTattvaratnaavaliiHK-196	śīghrasya haritābjā?ntaṃsturṇābhaṃ nidhīśituḥ ||	śīghrasya harita abja antar turṇa ābham nidhi īśituḥ 
MBTattvaratnaavaliiHK-197	vidyeśasyasitābjābhaṃ śaṃbhoḥ pītābja saprabhaṃ |	vidyeśasya asita abja ābham śaṃbhoḥ pīta abja sa prabham 
MBTattvaratnaavaliiHK-198	iṃdranīlaprabhaṃ vṛttaṃ vīrabhadrapuraṃ mahan ||	iṃdranīla prabham vṛttam vīrabhadra puram mahan 
MBTattvaratnaavaliiHK-199	paṃcāṣṭakaṃ sitārakta pītālīṃ dvātakūrmavat |	         
MBTattvaratnaavaliiHK-200	amareśaḥ prabhāsaśca naimiṣaḥ puṣkare'ṣaḍhi ||	amareśaḥ prabhāsaḥ ca naimiṣaḥ puṣkareṣaṭ hi 
MBTattvaratnaavaliiHK-201	diṃḍiśca bhārabhūtiśca lākulirguhyamastakam |	diṃḍiḥ ca bhārabhūtiḥ ca lākuliḥ guhya mastakam 
MBTattvaratnaavaliiHK-202	hariścaṃdraśca śrīśailo jalmeśāṃmrātikeśvarau ||	hariścaṃdraḥ ca śrīśailaḥ jalma īśāṃmrātikeśvarau 
MBTattvaratnaavaliiHK-203	mahākālo madhyameśaḥ kedārobhiravoṣṭamaḥ |	mahākālaḥ madhyameśaḥ 
MBTattvaratnaavaliiHK-204	gayā caiva kurukṣetraṃ nākhalākanakhalastathā ||	gayā ca eva kurukṣetram nākhalākanakhalaḥ tathā 
MBTattvaratnaavaliiHK-205	vimalaścāṭṭahāsaśca maheṃdrobhīma ityapi |	vimalaḥ ca aṭṭahāsaḥ ca maheṃdraḥ bhīmaḥ iti api 
MBTattvaratnaavaliiHK-206	vastrāpadaṃ rudrakoṭiravimukto mahālahāḥ ||	vastrā padam rudra koṭiḥ avimuktaḥ mahā lahāḥ 
MBTattvaratnaavaliiHK-207	gokarṇo bhadrakarṇaśca dvarlakṣaḥ sthāṇurahamaḥ |	gokarṇaḥ bhadrakarṇaḥ ca dvarlakṣaḥ sthāṇuḥ ahamaḥ 
MBTattvaratnaavaliiHK-208	cchagalaṇḍo dviraṇḍaśca mākoṭo manḍaleśvaraḥ ||	cchagalaṇḍaḥ dviraṇḍaḥ ca mākoṭaḥ manḍaleśvaraḥ 
MBTattvaratnaavaliiHK-209	kālaṃjaraḥ śaṃkukarṇaḥ sthaleśākhyaḥ sthaleśvaraḥ |	          
MBTattvaratnaavaliiHK-210	jalādigarvaparyantaṃ sthitaṃ paṃcāntakaṃ smā? *? ||	jala ādi garva paryantam sthitam paṃca antakam 
MBTattvaratnaavaliiHK-211	paiśācaṃ rākṣasaṃ pākṣaṃ gāṃdharvaṃ śākramaidavaṃ |	paiśācam rākṣasam pākṣam gāṃdharvam śākra maidavam 
MBTattvaratnaavaliiHK-212	buddhau prājeśvaraṃ brāhyaṃ? vṛttametat purāstakam ||	buddhau prājeśvaram brāhyam vṛttam etat purā astakam 
MBTattvaratnaavaliiHK-213	śoṇāli svarṇapīteṃdu kuṇḍacitrasita prabhaṃ |	prabham 
MBTattvaratnaavaliiHK-214	sutaṃdaśca karālaśca subhadraśca surūpavān ||	sutaṃdaḥ ca karālaḥ ca subhadraḥ ca surūpavān 
MBTattvaratnaavaliiHK-215	vibhūṃtirasṛtākhyaśca prajedbrahmādhipāḥ kramāt |	vibhūṃtiḥ asṛta ākhyaḥ ca prajet brahma adhipāḥ kramāt 
MBTattvaratnaavaliiHK-216	guṇe'kṛtaṃ kṛtākhyaṃ caribhavaṃ brāhmamacyutaṃ ||	guṇekṛtam kṛta ākhyam cari bhavam brāhmam acyutam 
MBTattvaratnaavaliiHK-217	kaumāra * * *? kaṃṭhaṃ nākṛti śaśi prabhaṃ |	kaumāra kaṃṭham nākṛti śaśi prabham 
MBTattvaratnaavaliiHK-218	puruṣe vāmabhī * * * *? śānaika vīrakāḥ ||	puruṣe vāmabhī 
MBTattvaratnaavaliiHK-219	vicitra kūrmasaṃkāśāḥ puraḥ ṣaṭparikīrtitāḥ |	vicitra kūrma saṃkāśāḥ puraḥ ṣaḍ parikīrtitāḥ 
MBTattvaratnaavaliiHK-220	pracaṇḍomādhavojaśca anaṃtaika śivāviti ||	pracaṇḍaḥ mādhavaḥ ujaḥ ca anaṃta eka śivau iti 
MBTattvaratnaavaliiHK-221	7a)	a 
MBTattvaratnaavaliiHK-222	raktātapatrasaṃkāśāḥ rāge paṃcapuro matāḥ |	rakta ātapatra saṃkāśāḥ rāge paṃca puraḥ matāḥ 
MBTattvaratnaavaliiHK-223	kro * * *? vidyāyāṃ sphāṭika cchatravat purau ||	vidyāyām sphāṭika chatravat purau 
MBTattvaratnaavaliiHK-224	pūrvavacca kalātatve saṃvartā jyotiṣau purau |	pūrvavat ca kalā tatve saṃvartāḥ jyotiṣau purau 
MBTattvaratnaavaliiHK-225	niyatau śūrapaṃcāṃtau hemaṃ kūrmasviṣau purau ||	niyatau śūra paṃcāṃtau hemam kūrma su iṣau purau 
MBTattvaratnaavaliiHK-226	ekavīraśikhe deśa śrīkaṃthāḥ kā *? tatvagāḥ |	deśa śrīkaṃthāḥ 
MBTattvaratnaavaliiHK-227	trayaḥ kūrmanibhālokāḥ śuddhasphaṭikavarddhasaḥ ||	trayaḥ kūrma nibha ālokāḥ śuddha sphaṭika varddhasaḥ 
MBTattvaratnaavaliiHK-228	bhuvaneśa mahādeva vāmadeva bhavodbhavāḥ |	bhuvaneśa mahādeva vāmadeva bhavodbhavāḥ 
MBTattvaratnaavaliiHK-229	ekapiṃge kṣaṇepsānāṃguṣṭha mātrāśca bhāsvarāḥ ||	eka piṃge kṣaṇa īpsā āna aṃguṣṭha mātrāḥ ca bhāsvarāḥ 
MBTattvaratnaavaliiHK-230	cakrākārāḥ purovyaṣṭai bhogasaundaryasaṃpadaḥ |	cakra ākārāḥ bhoga saundarya saṃpadaḥ 
MBTattvaratnaavaliiHK-231	vidyāyāṃ paṃcapadmābhāḥ purohālāhalastathā ||	vidyāyām paṃca padma ābhāḥ puras hālāhalaḥ tathā 
MBTattvaratnaavaliiHK-232	rudrakrodhāṃvikā ghorā vāmadevīti kīrtitāḥ |	           
MBTattvaratnaavaliiHK-233	īśvarenaṃta sūkṣmau ca śivontamaikanedakau ||	sūkṣmau ca śiva untama eka nedakau 
MBTattvaratnaavaliiHK-234	ekaścaṃdraṃstrimūrtiśca śrīkaṃṭhaśca śikhaṇḍikaḥ |	ekaḥ caṃdran trimūrtiḥ ca śrīkaṃṭhaḥ ca śikhaṇḍikaḥ 
MBTattvaratnaavaliiHK-235	puraḥ śatadalākārā madhyāhnārka samanvithaḥ ||	śata dala ākārāḥ 
MBTattvaratnaavaliiHK-236	raudrī jyeṣṭhā ca vāmā ca tathā śakti sadāśivau |	raudrī jyeṣṭhā ca vāmā ca tathā śakti sadāśivau 
MBTattvaratnaavaliiHK-237	sādākhye sarvato bhadrāḥ puraścaṃdrārbuda prabhāḥ ||	sādākhye sarvatas bhadrāḥ puras caṃdra arbuda prabhāḥ 
MBTattvaratnaavaliiHK-238	śāktaṃ padmavaduddīptaṃ śāṃbhavaṃ ca tathā vidhaṃ |	śāktam padma vat uddīptam śāṃbhavam ca tathā vidham 
MBTattvaratnaavaliiHK-239	evaṃ sarveṣu tatveṣu viṃśatyā sahitaṃ śataṃ ||	evam sarveṣu tatveṣu viṃśatyā sahitam śatam 
MBTattvaratnaavaliiHK-240	bhuvanārciti saṃkṣepādananto vistarādayaṃ |	bhuvanārciti saṃkṣepāt anantaḥ vistarāt ayam 
MBTattvaratnaavaliiHK-241	avāṃtarāśya saṃkhyāni nairaṃ tarpasthitāni ca ||	saṃkhyāni ca 
MBTattvaratnaavaliiHK-242	kalāgnyādi śivāṃtāni nānāvarṇā kṛtīni ca |	kalā agni ādi śiva aṃtāni nānā varṇā kṛtīni ca 
MBTattvaratnaavaliiHK-243	tadvarṇā bhuvaneśānāstattatpuranivāsinaḥ ||	tad varṇāḥ bhuvana īśānāḥ tad tad pura nivāsinaḥ 
MBTattvaratnaavaliiHK-244	rudrāṇī sahitā * * * * syādaśavāhavaḥ |	rudrāṇī sahitā      syāt daśa vāhavaḥ 
MBTattvaratnaavaliiHK-245	sadāśivasamāḥ śyāma kaṃṭhājuṭeṃdu maṇḍitāḥ ||	          
MBTattvaratnaavaliiHK-246	kālavahniścaturvaktro brahmādyāstu svavanmatāḥ |	kāla vahniḥ caturvaktraḥ brahma ādyāḥ tu sva vat matāḥ 
MBTattvaratnaavaliiHK-247	atha tatvāni ṣaṭviṃśatkathyaṃte svasvarūpataḥ ||	atha tatvāni ṣaṭviṃśat kathyaṃte sva svarūpataḥ 
MBTattvaratnaavaliiHK-248	pṛthvī lobhavetyuktvā kuryācchītābhīghārakaṃ |	pṛthvī lobhavā iti uktvā kuryāt śīta abhī ghārakam 
MBTattvaratnaavaliiHK-249	7b)	b 
MBTattvaratnaavaliiHK-250	sakṛtsakṛdvaṣaṭyuktaiḥ saṃhitā mantabhiḥ kramāt |	sakṛt sakṛt vaṣaṭī uktaiḥ saṃhitāḥ mantabhiḥ kramāt 
MBTattvaratnaavaliiHK-251	ṣadunnāsanake nyasya kuṃḍapaścima maṃḍale ||	nyasya kuṃḍa paścima maṃḍale 
MBTattvaratnaavaliiHK-252	saṃpātaśodhitaṃ kuryāt sakṛtsaṃhitayā tataḥ |	saṃpāta śodhitam kuryāt sakṛt saṃhitayā tatas 
MBTattvaratnaavaliiHK-253	sakṛdālabhya carukaṃ tapaiva ca ṣaḍantapā ||	sakṛt ālabhya carukam tapa eva ca ṣaḍantapā 
MBTattvaratnaavaliiHK-254	devāgnyātma kṛte darpyātavibhajya tridhābudhaḥ |	kṛte tridhā budhaḥ 
MBTattvaratnaavaliiHK-255	madhvājya miśritau deyau bhāgau deva hutāśayoḥ ||	madhvājya miśritau deyau bhāgau deva hutāśayoḥ 
MBTattvaratnaavaliiHK-256	ghṛtāktamātmano bhāgaṃ saṃrañca vidhivat tataḥ |	ghṛta aktam ātmanaḥ bhāgam saṃran ca vidhivat tatas 
MBTattvaratnaavaliiHK-257	paṃcāmṛtādibhirdevaṃ snapayitvā samarpya ca ||	paṃcāmṛta ādibhiḥ devam snapayitvā samarpya ca 
MBTattvaratnaavaliiHK-258	narāvā varmaṇādanta dhāvanaprāci dakṣiṇe |	narāvā varmaṇā adanta dhāvana prāci dakṣiṇe 
MBTattvaratnaavaliiHK-259	bhasmādheyamaghoreṇa śikhayā vātha paścime ||	bhasmādheyam aghoreṇa śikhayā vā atha paścime 
MBTattvaratnaavaliiHK-260	sadyojena hṛdā cāmṛśaumye dhātrī phalaṃ jalaṃ |	sadyojena hṛdā ca āmṛśa aumye dhātrī phalam jalam 
MBTattvaratnaavaliiHK-261	vāmena śirasā vātha dhāmnā veśāsu vāsitam ||	vāmena śirasā vā atha dhāmnā veśāsu vāsitam 
MBTattvaratnaavaliiHK-262	jalaṃ ca paṃcagavyaṃ ca palāśa puṭikāhitam |	jalam ca paṃcagavyam ca palāśa puṭikā hitam 
MBTattvaratnaavaliiHK-263	prasūnaṃ ca harāśāyāmāgneyā śubharocanāṃ ||	prasūnam ca hara āśāyām āgneyā śubha rocanām 
MBTattvaratnaavaliiHK-264	deyo gurustu nair-ṛtyāṃ vāyavyāṃ ca catuḥsamaṃ |	deyaḥ guruḥ tu nairṛtyām vāyavyām ca catur samam 
MBTattvaratnaavaliiHK-265	havyadravyāṇi darbhāṃśca sadyojāyopaḍhaukayet ||	havya dravyāṇi darbhān ca sadyojāya upaḍhaukayet 
MBTattvaratnaavaliiHK-266	daṃḍākṣasūtrakau pītabhikṣāpātrāṇi rūpiṇe |	daṃḍa akṣasūtrakau pīta bhikṣā pātrāṇi rūpiṇe 
MBTattvaratnaavaliiHK-267	tāṃbūlaṃ kuṃkumaṃ gaṃdhaṃ taijamaṃjana rocate ||	tāṃbūlam kuṃkumam gaṃdham taijam aṃjana rocate 
MBTattvaratnaavaliiHK-268	guhyakā paśalākāṃ ca darpaṇaṃ keśaśodhanaṃ |	ca darpaṇam keśa śodhanam 
MBTattvaratnaavaliiHK-269	varāṃganopayogāni vastūnyanyāni cārpayet ||	vara aṃganā upayogāni vastūni anyāni ca arpayet 
MBTattvaratnaavaliiHK-270	ccharuṃ siṃhāsanaṃ pātraṃ pāduke *?ga paṭṭakam |	ccharum siṃhāsanam pātram pāduke ga paṭṭakam 
MBTattvaratnaavaliiHK-271	8a)	a 
MBTattvaratnaavaliiHK-272	īśānāyāthasāṃdrādi carukaṃ saghṛtaṃ nare |	carukam sa ghṛtam nare 
MBTattvaratnaavaliiHK-273	yadasvaṃ? unnameteṣāṃ manasā tatprakalpayet ||	yat asvam unnam eteṣām manasā tat prakalpayet 
MBTattvaratnaavaliiHK-274	pavitrāṇyarghasiktāni saṃhitā maṃtritāni ca |	pavitrāṇi argha siktāni saṃhitāḥ maṃtritāni ca 
MBTattvaratnaavaliiHK-275	kṛṣṇājinādinā cchādya nītvā pāvakasaṃnidhiṃ ||	kṛṣṇājina ādinā chādya nītvā pāvaka saṃnidhim 
MBTattvaratnaavaliiHK-276	smarat kālātmakaṃ śaṃbhuṃ saṃpātaṃ saṃhitāṇubhiḥ |	smarat kāla ātmakam śaṃbhum saṃpātam saṃhita aṇubhiḥ 
MBTattvaratnaavaliiHK-277	trisaptavāraṃ kṛtvātha varmajaptena veṣṭayet ||	tri sapta vāram kṛtvā atha varma japtena veṣṭayet 
MBTattvaratnaavaliiHK-278	sūtreṇa kārakavrātāṃ śivānala vṛthāśrayān |	sūtreṇa kāraka vrātām śiva anala vṛthak āśrayān 
MBTattvaratnaavaliiHK-279	tato bhānuṃ samabhyarcya datvā gaṃdha pavitrakaṃ ||	tatas bhānum samabhyarcya da tvā gaṃdha pavitrakam 
MBTattvaratnaavaliiHK-280	ācamya dvārapālebhyo dadyādvājñadhipāya ca |	ācamya dvārapālebhyaḥ dadyāt vājñadhipāya ca 
MBTattvaratnaavaliiHK-281	lokeśa śivakuṃbhāstra varddhanyādi svanaṃtaraṃ ||	            
MBTattvaratnaavaliiHK-282	gaṇeśakamalā svāmi pādebhyaḥ svātmanepi ca |	gaṇeśa kamalā svāmi pādebhyaḥ sva ātmane api ca 
MBTattvaratnaavaliiHK-283	atha gaṃdha pavitrākhyameka graṃthyalpataṃtukaṃ ||	atha gaṃdha pavitra ākhyam eka graṃthi alpa taṃtukam 
MBTattvaratnaavaliiHK-284	sarvauṣaḍhi viliptaṃ ca vidhāyāṃjali madhyagaṃ |	sarva oṣaḍhi viliptam ca vidhāya aṃjali madhya gam 
MBTattvaratnaavaliiHK-285	prasūnākṣatadūrvāḍhyamāmaṃtraṇa padaṃ paṭhet ||	prasūna akṣata dūrvā āḍhyam āmaṃtraṇa padam paṭhet 
MBTattvaratnaavaliiHK-286	uṃ samasta vaidhicchidra pūraṇeśa satmaṃ? prati |	um samasta pūraṇa īśa satmam prati 
MBTattvaratnaavaliiHK-287	prabhavāmaṃtrayāminvātva dicchāvāpti kārakaṃ ||	kārakam 
MBTattvaratnaavaliiHK-288	tacchiddhimanujānīhi yajanaścida cityate |	tat śiddhim anujānīhi yajanaḥ cida cityate 
MBTattvaratnaavaliiHK-289	sarvathā sarvadā śaṃbho namastestu prasīdame ||	sarvathā sarvadā śaṃbho namaḥ teḥ tu 
MBTattvaratnaavaliiHK-290	iti devaṃ samāmaṃtrya recakenāmṛtī kṛtaṃ |	iti devam samāmaṃtrya recakena amṛtī kṛtam 
MBTattvaratnaavaliiHK-291	śivāṃtaṃ maṃtramuccārya tacchivāyārthayet tataḥ ||	śiva aṃtam maṃtram uccārya tat śivāya arthayet tatas 
MBTattvaratnaavaliiHK-292	japastotrādi nirvartya śivāgnau caruke hute |	japa stotra ādi nirvartya śiva agnau caruke hute 
MBTattvaratnaavaliiHK-293	pavitraṃ śivavaddatvā rudrādeśca tato vahiḥ ||	pavitram śiva vat da tvā rudra ādeḥ ca tatas vahis 
MBTattvaratnaavaliiHK-294	8b)	b 
MBTattvaratnaavaliiHK-295	bhūtādityo valiṃ datvā pūraṇāya vidhistataḥ |	bhūta ādityaḥ valim da tvā pūraṇāya vidhiḥ tatas 
MBTattvaratnaavaliiHK-296	hutvā pūrṇāhutiṃ bhrāntaṃ datvāhuti catuṣṭayaṃ ||	hutvā pūrṇāhutim bhrāntam catuṣṭayam 
MBTattvaratnaavaliiHK-297	vahnisthaṃ yojayecchaṃbhuṃ maṃḍalābhyarcite śive |	vahni stham yojayet śaṃbhum maṃḍala abhyarcite śive 
MBTattvaratnaavaliiHK-298	vahniṃ saṃrakṣya vidyāyāṃ gurau bhaktyādadītatat ||	vahnim saṃrakṣya vidyāyām gurau bhaktyā ādadīta tat 
MBTattvaratnaavaliiHK-299	vaṃdhyādipāve vinyasta śastrakaṃ kaṭa mānase |	vaṃdhyā ādi pāve vinyasta śastrakam mānase 
MBTattvaratnaavaliiHK-300	pavitrāṇi samārodhya dhāmnā cāṃgaiḥ kalāṇubhiḥ ||	pavitrāṇi samārodhya dhāmnā ca aṃgaiḥ kalā aṇubhiḥ 
MBTattvaratnaavaliiHK-301	brahmabhirvābhimaṃtryorddhe hṛddharmaṇi yojayet |	brahmabhiḥ vā abhimaṃtrya ūrddhe hṛd dharmaṇi yojayet 
MBTattvaratnaavaliiHK-302	piddhāya varmaṇā veṣṭya sūcairaṃgaiḥ samarcayet ||	piddhāya varmaṇā veṣṭya sūcaiḥ aṃgaiḥ samarcayet 
MBTattvaratnaavaliiHK-303	kuṃbhaśaṃbhau samarpyātha vahimaṃḍilakatraye |	kuṃbha śaṃbhau samarpya atha vahi maṃḍilaka traye 
MBTattvaratnaavaliiHK-304	paṃcagavyaṃ caruṃ dantadhāvanaṃ cakramādbhajet ||	paṃcagavyam carum dantadhāvanam ca kramāt bhajet 
MBTattvaratnaavaliiHK-305	ācamya sakalī kṛtya saṃgitādi mahotsavaṃ |	ācamya 
MBTattvaratnaavaliiHK-306	kārayitvā svapedrakṣāṃ kṛtvā śivamanusmaran ||	kārayitvā svapet rakṣām kṛtvā śivam anusmaran 
MBTattvaratnaavaliiHK-307	atha prātaḥ kṛtasnānaṃ saṃdhyātarpaṇa satkriyaḥ |	atha prātar kṛta snānam saṃdhyā tarpaṇa satkriyaḥ 
MBTattvaratnaavaliiHK-308	avisarjitamādāya devāhuṃdhapavitrakaṃ ||	a visarjitam ādāya 
MBTattvaratnaavaliiHK-309	aiśānyāṃ maṇḍale śuddha pātre saṃsthāpya deśikaḥ |	aiśānyām maṇḍale śuddha pātre saṃsthāpya deśikaḥ 
MBTattvaratnaavaliiHK-310	devaṃ visṛjya nirmālyamapāsyasumahītale ||	devam visṛjya nirmālyam apāsya su mahī tale 
MBTattvaratnaavaliiHK-311	kṛtvā nityāhnikīṃ pūjāṃ kuryān naimitikīṃ tataḥ |	kṛtvā nitya āhnikīm pūjām kuryāt naimitikīm tatas 
MBTattvaratnaavaliiHK-312	ravidvārapatiśrīṣu vāstudikpālapaṃktiṣu ||	              
MBTattvaratnaavaliiHK-313	śivakuṃbhāstra varddhanyo lagnodara śivāgniṣu |	śiva kuṃbha astra lagna udara śiva agniṣu 
MBTattvaratnaavaliiHK-314	maṃtrasaṃtarpaṇaṃ prāyaścittaṃ kṛtvā śarāṇunā ||	maṃtra saṃtarpaṇam prāyaścittam kṛtvā śara aṇunā 
MBTattvaratnaavaliiHK-315	pavitraṃ bhānave datvā dvārapālādiṣu kramāt |	pavitram bhānave da tvā dvārapāla ādiṣu kramāt 
MBTattvaratnaavaliiHK-316	datvā pavitrakaṃ śaṃbho japaviśyasamīpataḥ ||	da tvā pavitrakam śaṃbho japa viśya samīpataḥ 
MBTattvaratnaavaliiHK-317	nijamūrtau gaṇādhīśe kamalā svāmi pādayoḥ |	nija mūrtau gaṇādhīśe kamalā svāmi pādayoḥ 
MBTattvaratnaavaliiHK-318	pavitraṃ śakterārabhya yāvadvidyā kalevaraṃ ||	pavitram śakteḥ ārabhya yāvat vidyā kalevaram 
MBTattvaratnaavaliiHK-319	9a)	a 
MBTattvaratnaavaliiHK-320	dadyāt pavitramādāya kiṃcitkalaśasaṃmukhaḥ |	dadyāt pavitram ādāya kiṃcid kalaśa saṃmukhaḥ 
MBTattvaratnaavaliiHK-321	smarat kālātmakaṃ śaṃbhuṃ vijāpanapadaṃ paṭhet ||	smarat kāla ātmakam śaṃbhum vijāpana padam paṭhet 
MBTattvaratnaavaliiHK-322	uṃkālātmanā tvayā deva paṭṭaṣṭaṃ māmake vidhai |	uṃ kāla ātmanā tvayā deva māmake 
MBTattvaratnaavaliiHK-323	kṛtaṃ kliṣṭaṃ samutsṛṣṭaṃ dhṛtaṃ guptaṃ camatkṛtaṃ ||	kṛtam kliṣṭam samutsṛṣṭam dhṛtam guptam camatkṛtam 
MBTattvaratnaavaliiHK-324	tadastu kliṣṭamakliṣṭaṃ kṛtaṃ pruṣṭamasatkṛtaṃ |	tat astu kliṣṭam akliṣṭam kṛtam pruṣṭam asatkṛtam 
MBTattvaratnaavaliiHK-325	sarvātmanāmunā śaṃbho pavitreṇa tvadicchayā ||	sarva ātmanā amunā śaṃbho pavitreṇa tvad icchayā 
MBTattvaratnaavaliiHK-326	pūrayeti dviruccāraṃ makhavrata padaṃ tataḥ |	pūraya iti dvis uccāram makhavrata padam tatas 
MBTattvaratnaavaliiHK-327	niyametīśvarāyeti svāhāṃtaṃ namasāyutaṃ ||	niyama iti īśvarāya iti svāhā aṃtam namasā ayutam 
MBTattvaratnaavaliiHK-328	mūlaṃ māyāntamuccārya ātmatatvādhipāya ca |	mūlam māyā antam uccārya ātma tatva adhipāya ca 
MBTattvaratnaavaliiHK-329	śivāya svāhayā yuktaṃ pavitramadhiropayet ||	śivāya svāhayā yuktam pavitram adhiropayet 
MBTattvaratnaavaliiHK-330	evaṃ vidyā hvayetatve śivatatve ca deśikaḥ |	evam vidyāḥ ca deśikaḥ 
MBTattvaratnaavaliiHK-331	īśvarāṃtaṃ śivāṃtaṃ coccārya dadyāt pavitrakam ||	īśvara aṃtam śiva aṃtam ca uccārya dadyāt pavitrakam 
MBTattvaratnaavaliiHK-332	mūlaṃ layāṃtamuccārya sarvatatvādhipāya ca |	mūlam laya aṃtam uccārya sarva tatva adhipāya ca 
MBTattvaratnaavaliiHK-333	caturthaṃ śaṃbhave dadyād bhuktikāmaḥ śivāditaḥ ||	caturtham śaṃbhave dadyāt bhukti kāmaḥ śiva āditas 
MBTattvaratnaavaliiHK-334	vaktrāṃgā varaṇebhyaśca tato dadyāt pavitrakam |	vaktra aṃgāḥ varaṇebhyaḥ ca tatas dadyāt pavitrakam 
MBTattvaratnaavaliiHK-335	dhūpārātrikanaivedya japastuti natikriyāḥ ||	dhūpa ārātrika naivedya japa stuti nati kriyāḥ 
MBTattvaratnaavaliiHK-336	nirvartya vidhinānyeṣāṃ svatithau vidadhītatat |	nirvartya vidhinā anyeṣām sva tithau vidadhīta tat 
MBTattvaratnaavaliiHK-337	tataśca śivavadvahnau pavitraka catuṣṭayaṃ ||	tatas ca śiva vat vahnau pavitraka catuṣṭayam 
MBTattvaratnaavaliiHK-338	aṃtarvaliṃ pavitaṃ ca rudrādibhyo nivedayet |	antar valim pavitam ca rudra ādibhyaḥ nivedayet 
MBTattvaratnaavaliiHK-339	tato vidyāṃ guruṃ veṣṭvā bhaktyā datvā pavitrakaṃ ||	tatas vidyām gurum vā iṣṭvā bhaktyā da tvā pavitrakam 
MBTattvaratnaavaliiHK-340	tataḥ śivāṃtikaṃ gatvā kṣamasvetya bhidhāya ca |	tatas śiva aṃtikam gatvā kṣamasva iti abhidhāya ca 
MBTattvaratnaavaliiHK-341	catustridvyeka māsaṃ vā pakṣaṃ vātha tadarddhakam ||	māsam vā pakṣam vā atha tad arddhakam 
MBTattvaratnaavaliiHK-342	paṃcāhaṃ tryahnamekāhnaṃ karmāṃtaṃ vā gurorgirā |	paṃca aham tri ahnam eka ahnam karmāṃtam vā guroḥ girā 
MBTattvaratnaavaliiHK-343	gṛhītvā niyamaṃ śaktyā praṇamya kṣamayecchivaṃ ||	gṛhītvā niyamam śaktyā praṇamya kṣamayet śivam 
MBTattvaratnaavaliiHK-344	tataḥ parasparaṃ dadyādupavītaṃ tapasvināṃ |	tatas parasparam dadyāt upavītam tapasvinām 
MBTattvaratnaavaliiHK-345	navasaptasaraṃgbhāge dhyātvā viṣṇumayīntataḥ ||	nava sapta sa raṃk bhāge dhyātvā viṣṇu mayīn tatas 
MBTattvaratnaavaliiHK-346	9a)	a 
MBTattvaratnaavaliiHK-347	dhṛtveśakoṇe juhuyācchira sā viṣṇave layaṃ |	dhṛtvā īśa koṇe juhuyāt śira sā viṣṇave layam 
MBTattvaratnaavaliiHK-348	raudrīṃ dhyātvā tanuṃ svīyāṃ nābhau dhṛtvāt plaveta tat ||	raudrīm dhyātvā tanum svīyām nābhau dhṛtvā at plaveta tat 
MBTattvaratnaavaliiHK-349	prādeśamātra darbhābhyāṃ madhyagraṃthi pavitrakaṃ |	prādeśa mātra darbhābhyām madhya graṃthi pavitrakam 
MBTattvaratnaavaliiHK-350	aṃguṣṭhānāmikāgreṇa dhṛtvāgni saṃmukha tṛdhā ||	aṃguṣṭha anāmikā agreṇa tṛdhā 
MBTattvaratnaavaliiHK-351	śastreṇotplavanaṃ tadvaddhṛdātma mukhasaṃplavaṃ |	śastreṇa utplavanam tadvat hṛd ātma mukha saṃplavam 
MBTattvaratnaavaliiHK-352	kṛtvā pavitrayedastra dagdhadarbholmukena tu ||	kṛtvā pavitrayet astra dagdha darbha ulmukena tu 
MBTattvaratnaavaliiHK-353	dīptanānyena nīrājyaṃ punaranyena dīpayet |	dīptanā anyena nīrājyam punar anyena dīpayet 
MBTattvaratnaavaliiHK-354	astramaṃtreṇa nirdagdhaṃ vahnau darbhaṃ vinikṣipet ||	astramaṃtreṇa nirdagdham vahnau darbham vinikṣipet 
MBTattvaratnaavaliiHK-355	madhyagraṃthi kuśaṃpāre nyasya prādeśasaṃmitaṃ |	madhya graṃthi kuśaṃpāre nyasya prādeśa saṃmitam 
MBTattvaratnaavaliiHK-356	ekadvayaṃ trināḍīṃ ca kalpayitvā hyupātrake ||	eka dvayam tri nāḍīm ca kalpayitvā hi upātrake 
MBTattvaratnaavaliiHK-357	svetyagnau heti tadbhāge kramādājyalavaṃ kṣipet |	svā iti agnau ha iti tad bhāge kramāt ājya lavam kṣipet 
MBTattvaratnaavaliiHK-358	dajādomagnaye svāhā vāmātsomāya pūrvavat ||	svāhā vāmāt somāya pūrvavat 
MBTattvaratnaavaliiHK-359	madhyādomagnīṣomābhyāṃ hutvāsaṃṇatamīdṛśaṃ |	madhyā dom agnīṣomābhyām hutvā a saṃṇatam īdṛśam 
MBTattvaratnaavaliiHK-360	dṛśāṃ vyaktau mukhokhāde caturthīmāhutiṃ kṣipet ||	dṛśām vyaktau caturthīm āhutim kṣipet 
MBTattvaratnaavaliiHK-361	oṃ magnaye sviṣṭa kṛtaṃ ye svāheti sitapakṣake |	om magnaye su iṣṭa kṛtam ye svāhā iti sita pakṣake 
MBTattvaratnaavaliiHK-362	kṛṣṇapakṣe tu somasya sthāne sūryaniyojayet ||	kṛṣṇa pakṣe tu somasya sthāne 
MBTattvaratnaavaliiHK-363	atimaṃtryaṣaḍaṃgena dhenumudrā mṛtī kṛtaṃ |	ati maṃtrya ṣaṣ aṃgena dhenumudrā kṛtam 
MBTattvaratnaavaliiHK-364	kavavetāvaguṃṭhyātha heti maṃtreṇa rakṣayet ||	maṃtreṇa rakṣayet 
MBTattvaratnaavaliiHK-365	praddājyasya lavajye pādadyājyamapi śodhayet |	lavajye śodhayet 
MBTattvaratnaavaliiHK-366	ājātādiśapayatamekaikāhuti dānataḥ ||	ājāta ādi śapa yatam ekaika āhuti dānataḥ 
MBTattvaratnaavaliiHK-367	vaśābhighānannirvartya tato vakrāṇi saṃdhayet |	tatas vakrāṇi saṃdhayet 
MBTattvaratnaavaliiHK-368	sadyojātaṃ guhyakena vāmadevaṃdarūpiṇā ||	sadyojātam guhyakena 
MBTattvaratnaavaliiHK-369	aghoraṃ putraṣeṇāthavaramīsāṃ sakudvrateḥ |	aghoram sakudvrateḥ 
MBTattvaratnaavaliiHK-370	sadyavāmāghoranareṣṭobhyaḥ svāhetyudīraṇāt ||	sadyas vāma aghora nareṣṭobhyaḥ svāhā iti udīraṇāt 
MBTattvaratnaavaliiHK-371	agnito nītayā vāyumītairīśaṃ ca nītayā |	agnitaḥ nītayā vāyum ītaiḥ īśam ca nītayā 
MBTattvaratnaavaliiHK-372	vaktrāṇāmekatāṃ kuryāt sruvastu vājyadhārayā ||	vaktrāṇām eka tām kuryāt sruvaḥ tu vā ājya dhārayā 
MBTattvaratnaavaliiHK-373	kuṃḍamānatvamekaṃtvaveṣṭenyeṣāṃ vyavasthitiḥ |	kuṃḍa māna tvam ekaṃtva veṣṭeni eṣām vyavasthitiḥ 
MBTattvaratnaavaliiHK-374	9a)	a 
MBTattvaratnaavaliiHK-375	ūrddhāsye homato muktiḥ pūrvāsye sarvasiddhayaḥ |	ūrddha āsye homataḥ muktiḥ pūrva āsye sarva siddhayaḥ 
MBTattvaratnaavaliiHK-376	dakṣāsye māradāhādyaḥ śāṃtiḥ saubhāgyamuttare ||	dakṣa āsye māra dāha ādyaḥ śāṃtiḥ saubhāgyam uttare 
MBTattvaratnaavaliiHK-377	paścime nityakarmādi svakaverjuhuyādbudhaḥ |	paścime nityakarma ādi sva kaveḥ juhuyāt budhaḥ 
MBTattvaratnaavaliiHK-378	tataḥ īśena śastre pūjane havane kṛte ||	tatas īśena śastre pūjane havane kṛte 
MBTattvaratnaavaliiHK-379	nāmaṃ kuryāddhṛdāvahneḥ śivāgni svahutāśana |	nāmam kuryāt hṛdā vahneḥ śiva agni sva hutāśana 
MBTattvaratnaavaliiHK-380	athāgneḥ saptajihvānāṃ kathyete rūpasaṃsthitā ||	atha agneḥ sapta jihvānām kathyete rūpa saṃsthitā 
MBTattvaratnaavaliiHK-381	hūṃhiraṇyā vaśākṛṣṭā vaiśyātā madhyatarpayet |	hūm hiraṇyā vaśā ākṛṣṭā vaiśyātā madhyatarpayet 
MBTattvaratnaavaliiHK-382	staṃbhe lrūṃ kanakāprācyāṃ śruṃraktāgnaunu tāpane ||	staṃbhe lrūm kanakā prācyām tāpane 
MBTattvaratnaavaliiHK-383	prūṃ kṛṣṇā tāraṇe setau puṣṭye vrūṃ suprabhā pare |	prūm kṛṣṇā tāraṇe setau puṣṭye vrūm su prabhā pare 
MBTattvaratnaavaliiHK-384	prūṃ māruteti raktāsyāduccāṭe dhūmravigrahā ||	prūm māruta iti rakta āsyāt uccāṭe dhūmra vigrahā 
MBTattvaratnaavaliiHK-385	madhye sūṃ vahurūpānu dakṣiṇottara gāminī |	madhye sūm vahu rūpā anu dakṣiṇa uttara gāminī 
MBTattvaratnaavaliiHK-386	sāsarvakāmadāsarvāḥ svanāma sadṛśa tviṣaḥ ||	sāsarva kāma dā sarvāḥ sva nāma sadṛśa tviṣaḥ 
MBTattvaratnaavaliiHK-387	rājyadā dāghajavanī mṛtyudāśavukārikā |	           
MBTattvaratnaavaliiHK-388	vaśīkṛtirathoccāṭā arthadā mukti dāyikā ||	artha dā mukti 
MBTattvaratnaavaliiHK-389	sarvasiddhi pradājihvā yadvā pūrvādi madhyagāḥ |	yat vā pūrva ādi madhya gāḥ 
MBTattvaratnaavaliiHK-390	hṛhṛdārcyapitarau vahnervisṛjyavidhi pūraṇīṃ ||	vahneḥ visṛjya vidhi pūraṇīm 
MBTattvaratnaavaliiHK-391	vauṣaḍaṃtena mūlena pūrṇādadyādyathā vidhi |	vauṣaṭ aṃtena mūlena pūrṇā dadyāt yathā vidhi 
MBTattvaratnaavaliiHK-392	yadvāpyomānalokāra ṣaṣṭabiṃdu yutāṇunā ||	ṣaṣṭa biṃdu yuta aṇunā 
MBTattvaratnaavaliiHK-393	paratejīśa vinyāsācchivāgnirjāyate drutaṃ |	           
MBTattvaratnaavaliiHK-394	tato hṛdaṃbuje vahneḥ pūrvokta vidhinā śivaṃ ||	tatas hṛd aṃbuje vahneḥ pūrva ukta vidhinā śivam 
MBTattvaratnaavaliiHK-395	samabhyarcya prakurvīta saṃdhimīśāgni vaktrayo |	samabhyarcya prakurvīta saṃdhim īśa agni 
MBTattvaratnaavaliiHK-396	yāgāgni śivayoḥ kṛtvā nāḍīsaṃdhānamātmanā ||	yāga agni śivayoḥ kṛtvā nāḍī saṃdhānam ātmanā 
MBTattvaratnaavaliiHK-397	kuryānmūlāṇunāhomaṃmaṃgānāṃ ca daśāṃśataḥ |	kuryāt mūla aṇunā ahomaṃmaṃgānām ca daśa aṃśataḥ 
MBTattvaratnaavaliiHK-398	homadravyaviśeṣasya jñātvāhutimitiṃ budhaḥ ||	homa dravya viśeṣasya jñātvā āhuti mitim budhaḥ 
MBTattvaratnaavaliiHK-399	vidheyaḥ kārṣiko homaḥ kṣaudragokṣīrasarpiṣāṃ |	vidheyaḥ kārṣikaḥ homaḥ kṣaudra go kṣīra sarpiṣām 
MBTattvaratnaavaliiHK-400	śuktimānāhutirdadhnaḥ prasṛtiḥ pāyasya tu ||	śuktimān āhutiḥ dadhnaḥ prasṛtiḥ pāyasya tu 
MBTattvaratnaavaliiHK-401	tṛtīyāṃśastu mūlānāṃ kajādikaṃ sarvamitye tatparvadā mataṃ |	tṛtīya aṃśaḥ tu mūlānām kaja ādikam sarvam iti e tad parva dāḥ matam 
MBTattvaratnaavaliiHK-402	9b)	b 
MBTattvaratnaavaliiHK-403	atocyaṃteṃ tarāyaghnā mudrārudrasya śaktayaḥ |	tarāya ghnāḥ mudrārudrasya śaktayaḥ 
MBTattvaratnaavaliiHK-404	valite madhyamāṃgulyau pacīyasyau ca hastayoḥ ||	valite madhyamā aṃgulyau pacīyasyau ca hastayoḥ 
MBTattvaratnaavaliiHK-405	tadaṃtare khatalage tarjanyau saṃgate punaḥ |	tad aṃtare kha tala ge tarjanyau saṃgate punar 
MBTattvaratnaavaliiHK-406	tanmūlaparvaṇoragre niṣṭhāyāṃguṣṭhayoriyaṃ ||	tad mūla parvaṇoḥ agre niṣṭhāyāḥ aṃguṣṭhayoḥ iyam 
MBTattvaratnaavaliiHK-407	manoramā samākhyātā kaniṣṭhānāmikā dvayaṃ |	manoramā samākhyātā kaniṣṭhā anāmikā dvayam 
MBTattvaratnaavaliiHK-408	vidhvānyonyaṃ ca karayoskaṃṣvābhyāmākramet(?) tataḥ ||	vidhvā anyonyam ca tatas 
MBTattvaratnaavaliiHK-409	śeṣāścorddhaṃ ghanāḥ kāryā bījamudreti kīrtitā |	śeṣāḥ ca ūrddham ghanāḥ kāryāḥ bījamudrā iti kīrtitā 
MBTattvaratnaavaliiHK-410	niviḍordvyaṃgulirhastaḥ śaktimudreti kīrtitā ||	nibiḍoḥ dvi aṃguliḥ hastaḥ śaktimudrā iti kīrtitā 
MBTattvaratnaavaliiHK-411	karayormadhyamānā me anyonyaṃguṣṭhasaṃgate |	karayoḥ madhyamānāḥ me anyonya aṃguṣṭha saṃgate 
MBTattvaratnaavaliiHK-412	kaniṣṭhāṃguṣṭhagorddhasthā tajrādyo saṃgate same ||	saṃgate same 
MBTattvaratnaavaliiHK-413	praśāntā kathitāmudrā hastayoḥ pṛṣṭhato dvayoḥ |	praśāntā kathitā amudrā hastayoḥ pṛṣṭhatas dvayoḥ 
MBTattvaratnaavaliiHK-414	anyonyāṃtaritāḥ śākhāḥ kaniṣṭhe jyeṣṭhapīḍite ||	anyonya aṃtaritāḥ śākhāḥ kaniṣṭhe jyeṣṭha pīḍite 
MBTattvaratnaavaliiHK-415	madhyame deśinī ruddhe anāme vocchṛte yute |	madhyame deśinī ruddhe anāme vā ucchṛte yute 
MBTattvaratnaavaliiHK-416	mudrāpaṃcānanākhyātā srugajāta priyocyate ||	mudrā paṃcānana ākhyātā sruc ajāta priyā ucyate 
MBTattvaratnaavaliiHK-417	kanyasākanyasāṃgulyā vidhāṃnantarayostayoḥ |	kanyasā kanyasā aṃgulyā vidhām anantarayoḥ tayoḥ 
MBTattvaratnaavaliiHK-418	vyastayormadhyamāṃgulyau prasāryāgre tu saṃgate ||	vyastayoḥ madhyamā aṃgulyau prasārya agre tu saṃgate 
MBTattvaratnaavaliiHK-419	athorddhamāsāṃsaṃ sakte tarjanyaṃguṣṭha yugmake |	atha ūrddham āsa aṃsam sakte tarjanī aṃguṣṭha yugmake 
MBTattvaratnaavaliiHK-420	srugecorddhārddhasaṃkoca prasāraṇa vibhāgataḥ ||	sruc eca ūrddha arddha saṃkoca prasāraṇa vibhāgataḥ 
MBTattvaratnaavaliiHK-421	maka?madhyayoḥ pārṇi kuṃbhite tarjanī dvaye |	          
MBTattvaratnaavaliiHK-422	triśūlaṃ padmavatpadmā surabhirgāstanā kṛtiḥ ||	triśūlam padmavat padmā surabhiḥ gāstanā kṛtiḥ 
MBTattvaratnaavaliiHK-423	liṃgamudrocchatāguṣṭa dakṣagujñiḥ(?) prakīrtitā |	prakīrtitā 
MBTattvaratnaavaliiHK-424	dakṣiṇetara posusyāḥ(?) sanmukhā * * * *	sat mukhā   
MBTattvaratnaavaliiHK-425	kālakarṇāmahāmudrā pādāgrānmastakāvadhi |	              
MBTattvaratnaavaliiHK-426	hastābhyāṃ sparśanāt proktā kaniṣṭhāṃguṣṭhayogataḥ ||	hastābhyām sparśanāt proktā kaniṣṭhā aṃguṣṭha yogataḥ 
MBTattvaratnaavaliiHK-427	madhyamaprasāryatetrākhyāṃ saṃhṛtiḥ kanyasāditaḥ |	madhyama prasārya tetra ākhyām saṃhṛtiḥ kanyasa āditaḥ 
MBTattvaratnaavaliiHK-428	10a)	Ro
MBTattvaratnaavaliiHK-429	śākhā * * * *? tādbhavākhyātadviparyayān ||	            
MBTattvaratnaavaliiHK-430	vāmādhomukhahastāṃtardakṣatarjāpracālanāt |	vāma adhomukha hasta antar dakṣa tarjā pracālanāt 
MBTattvaratnaavaliiHK-431	ghaṃṭānati karaulagnau saṃmukhau prasṛtāṃgulī ||	ghaṃṭā nati karau lagnau saṃmukhau prasṛta aṃgulī 
MBTattvaratnaavaliiHK-432	dakṣamupbhistha tarjanyā vāmabhyata *? tāḍanāt |	tarjanyāḥ tāḍanāt 
MBTattvaratnaavaliiHK-433	trāsanīvartulānyonya tarjāṃguṣṭhāgrayogrataḥ ||	trāsanī vartula anyonya tarja aṃguṣṭha agrayā ugratas 
MBTattvaratnaavaliiHK-434	nimbāmuṣṭistu yostarjā? madhyayoḥ sphārasāraṇāt? |	nimbāmuṣṭiḥ tu madhyayoḥ sphāra sāraṇāt 
MBTattvaratnaavaliiHK-435	govṛṣāvakraśākhāgra hastorddheṅguṣṭha cālanāt ||	govṛṣa vakraśākhā agra hasta ūrddha iṅguṣṭha cālanāt 
MBTattvaratnaavaliiHK-436	visphurā *? rayorajalpanāmā mūlaparvaṇi |	visphurā mūla parvaṇi 
MBTattvaratnaavaliiHK-437	jyeṣṭhoṃvediyamāvāhā matāsthāpanyadho mukhī ||	matā āsthāpanī adhas mukhī 
MBTattvaratnaavaliiHK-438	muṣṭī samucchatāṃguṣṭhau sannidhānā hvayā matā |	muṣṭī sannidhānā hvayā matā 
MBTattvaratnaavaliiHK-439	tāvedagarbhagāṃguṣṭhau saṃnirodho?ti kīrtitā ||	tau edagarbha ga aṃguṣṭhau saṃnirodhā uti kīrtitā 
MBTattvaratnaavaliiHK-440	muṣṭeḥ prasṛta tarjanyā veptanādavaguṃṭhanī |	muṣṭeḥ 
MBTattvaratnaavaliiHK-441	paṃcāṃguli samāyogāt sūkarī mukulā kṛtiḥ ||	paṃcāṃguli samāyogāt sūkarī mukulā kṛtiḥ 
MBTattvaratnaavaliiHK-442	anāmāṃguṣṭhamadhyāgra yogānmudrāmṛgī matā |	            
MBTattvaratnaavaliiHK-443	śaṃkhābhottānamuṣṭiḥ syācchaṃkhamudrāhutādiṣu ||	śaṃkha ābha uttāna muṣṭiḥ syāt śaṃkha mudrā huta ādiṣu 
MBTattvaratnaavaliiHK-444	mudrāṇāṃ vācakaścāmoṃ hrīnnāma tato mamaḥ |	mudrāṇām vācakaḥ ca ām om hrīt nāma tatas mamaḥ 
MBTattvaratnaavaliiHK-445	iti śrīvimalācāryanirmite tyantanirmale tatvaratnāvalīgraṃthe naimittikavinirṇayaḥ ||	iti śrī vimala ācārya nirmite tyanta nirmale tatva ratnāvalī graṃthe naimittika vinirṇayaḥ 
MBTattvaratnaavaliiHK-446	ratnāvalīyate yatratha dvidho dhvāti bhāsvaraḥ |	ratnā avalīyate dvidhaḥ bhāsvaraḥ 
MBTattvaratnaavaliiHK-447	tasmai sukhasudhābodha siṃdhaveśaṃ bhave mamaḥ ||	tasmai sukha sudhā bodha siṃdhaveśam bhave mamaḥ 
MBTattvaratnaavaliiHK-448	aprasaṃkte(?) gatodīkṣā vidhirvyāhṛyatedhunā |	gata udīkṣāḥ vidhiḥ vyāhṛyate idhunā 
MBTattvaratnaavaliiHK-449	sacādhvapūrvakastasmādādāvadhvābhidhīyate ||	sacā adhva pūrvakaḥ tasmāt ādau adhvā abhidhīyate 
MBTattvaratnaavaliiHK-450	maṃtrāḥ padāni varṇāśca lokāstatvāni śaktayaḥ |	maṃtrāḥ padāni varṇāḥ ca lokāḥ tatvāni śaktayaḥ 
MBTattvaratnaavaliiHK-451	adhvānaḥ mudramīvyāpya vyāpyakatvena saṃsthitāḥ ||	adhvānaḥ mudramī vyāpya vyāpyaka tvena saṃsthitāḥ 
MBTattvaratnaavaliiHK-452	10b)	Ro
MBTattvaratnaavaliiHK-453	ajātavāmāghorākhyaṃ puruṣe mānahṛcchiraḥ |	ajāta vāma aghora ākhyam puruṣe māna hṛd śiraḥ 
MBTattvaratnaavaliiHK-454	śikhācaryāstu dṛgmūlaṃ maṃtrāddheti prakīrtitāḥ ||	śikhācaryāḥ tu dṛś mūlam maṃtrāt ha iti prakīrtitāḥ 
MBTattvaratnaavaliiHK-455	hṛcchiraśca śikhā varma mūlaṃ veti kvacinmataḥ |	hṛd śiraḥ ca śikhā varma mūlam vā iti kvacid mataḥ 
MBTattvaratnaavaliiHK-456	ekāsītipadānyatra vyomavyāpi mahāmanoḥ ||	ekā asi iti padāni atra vyoma vyāpi mahā manoḥ 
MBTattvaratnaavaliiHK-457	padādhvāḥ kapidhaḥ kvāpi navatmakapadānyapi |	pada adhvāḥ kapidhaḥ kvāpi nava tmaka padāni api 
MBTattvaratnaavaliiHK-458	vyomavyāpine | vyomarūpāyā | sarvavyāpine | śivāya | anantāyā | anārāya |	vyomavyāpine vyoma rūpāyāḥ sarvavyāpine śivāya anantāyāḥ anārāya 
MBTattvaratnaavaliiHK-459	anāśritāyā | dhruvāya | śāśvatāya | yogapīṭhasaṃsthitāya | nityaṃyogine |	anāśritāyāḥ dhruvāya śāśvatāya yoga pīṭha saṃsthitāya nityaṃyogine 
MBTattvaratnaavaliiHK-460	dhyānāhārāya | oṃ namaḥ śivāya | sarvaprabhave śivāya | īśāna mūrddhāya |	dhyāna āhārāya om namaḥ śivāya sarva prabhave śivāya īśāna mūrddhāya 
MBTattvaratnaavaliiHK-461	tatpuruṣavaktrāya | aghora hṛdayāya | vāmadeva guhyāya | sadyojātamūrtāya |	tatpuruṣa vaktrāya aghora hṛdayāya vāmadeva guhyāya sadyojāta mūrtāya 
MBTattvaratnaavaliiHK-462	vratamodhamaḥ guhyāti guhyāya | godhve nidhanāya | sarvavidyādhipāya |	vratamaḥ udhamaḥ guhyāti guhyāya godhve nidhanāya sarva vidyā adhipāya 
MBTattvaratnaavaliiHK-463	sarvavidyādhipāya | jyotirūpāya | parameśvaraparāya | acetanācetana | vyomin 2 |	sarva vidyā adhipāya jyotiḥ rūpāya parameśvara parasmai acetana acetana vyomin 
MBTattvaratnaavaliiHK-464	vyāpin 2 | vyāpi *? | adrūpa 2 | prathama 2 | teja 2 | jyotiḥ 2 | arūpaṃ |	vyāpin vyāpi adrūpa prathama teja jyotiḥ arūpam 
MBTattvaratnaavaliiHK-465	anagni | adhūma | abhasā? | anādi | nā 3 | dhū 3 || oṃ bhūḥ | oṃ bhuvaḥ | oṃ	om bhūḥ om bhuvaḥ om 
MBTattvaratnaavaliiHK-466	svaḥ | anidhana | nidhana | nidhanodbhava | śiva | śarva| paramātman | ma *	svar anidhana nidhana nidhana udbhava śiva śarva paramātman ma 
MBTattvaratnaavaliiHK-467	pramatha 2 || sarva 2 || bhava 2 || bhavodbhava | sarvabhūtasukha	                                              
MBTattvaratnaavaliiHK-468	11a)	Ro
MBTattvaratnaavaliiHK-469	prada | sarvasānnidhya kara | brahmaviṣṇurudrapara | anarcita || 2 || * * ta 2 |	prada sarva sānnidhya kara brahma viṣṇu rudra para anarcita        
MBTattvaratnaavaliiHK-470	pūrvasthita 2 || sākṣin 2 || nuru 2 || pataṃga 2 | piṃga 2 || jñāna 2 || śabda 2 ||	co sākṣin nuru co pataṃga piṃga co 
MBTattvaratnaavaliiHK-471	sūkṣma 2 || śiva | śarva | sarvadā | oṃ namo namaḥ | oṃ namo namaḥ | oṃ śivāya	sūkṣma  śiva śarva sarvadā om namaḥ namaḥ om namaḥ namaḥ om śivāya 
MBTattvaratnaavaliiHK-472	| namo namaḥ | oṃ oṃ hara kṣamalairvarṇai * * kukāra sadutaiḥ? ||	namaḥ namaḥ om om hara kṣamalaiḥ varṇaiḥ 
MBTattvaratnaavaliiHK-473	madhyādīśānta patrasthaiḥ kramādekaika madhyagaiḥ |	madhya ādi īśa anta pattra sthaiḥ kramāt ekaika madhya gaiḥ 
MBTattvaratnaavaliiHK-474	ekāsīti padaṃ kuryān madhyagasya pade bhavāt ||	ekā asi iti padam kuryāt madhya gasya pade bhavāt 
MBTattvaratnaavaliiHK-475	kvacit padāni paṃcaiva atamabindunāyakāḥ |	kvacid padāni paṃca eva atama bindu nāyakāḥ 
MBTattvaratnaavaliiHK-476	ādikṣāṃtotra varṇā *? ādikāntaṃ kvacinmataḥ ||	ādi kṣāntaḥ utra varṇāḥ ādika antam kvacid mataḥ 
MBTattvaratnaavaliiHK-477	a ā | i ī | u ū | ṛ ṝ | ḷ ḹ | e ai | o au | aṃ aḥ | kṣa ha sa ṣa śa va la ra ya ma bha	a ā i ī u ū ṛ ṝ   ḷ ḷ e ai o au aṃ aḥ ha sa ṣa śa va la ra ya ma bha 
MBTattvaratnaavaliiHK-478	ba pha pa | na dha da tha ta | ṇa ḍha ḍa ṭha ṭa | ña jha ja cha ca | ṅa gha ga kha ka |	ba pha pa na dha da tha ta  ṇa ḍha ḍa ṭha ṭa  ña jha ja cha ca  ṅa gha ga kha ka 
MBTattvaratnaavaliiHK-479	varṇā eva kvacidvarga bhedātmaṃśaḥ padāni ca |	varṇāḥ eva padāni ca 
MBTattvaratnaavaliiHK-480	kvacillavarayāhaśca varṇārciti prakīrtitaḥ ||	kvacid lavarayā ahar ca varṇa arciti prakīrtitaḥ 
MBTattvaratnaavaliiHK-481	maṃtrāḥ padāni varṇāśca prasphurat kiraṇojvalāḥ ||	maṃtrāḥ padāni varṇāḥ ca prasphurat kiraṇa ujvalāḥ 
MBTattvaratnaavaliiHK-482	asaṃkhyatvepi lokānāṃ tatra mukhyāḥ samāsataḥ |	asaṃkhya tve pi lokānām tatra mukhyāḥ samāsatas 
MBTattvaratnaavaliiHK-483	kathyante vidhisiddhyartha kālavahnyāditaḥ kramāt ||	kathyante vidhi siddhi artha kāla vahni ādeḥ kramāt 
MBTattvaratnaavaliiHK-484	jvalattrikoṇaṃ kālāgneḥ kuṣmāṃḍasya tathā puraṃ |	jvalat trikoṇam kālāgneḥ kuṣmāṃḍasya tathā puram 
MBTattvaratnaavaliiHK-485	chatrābhaṃ hāṭakeśasya nānārasvasamujvalaṃ ||	chatra ābham hāṭakeśasya nānā rasva samujvalam 
MBTattvaratnaavaliiHK-486	padmarāgābja vadbrāhmaṃ viṣṇornilotpalaprabhaṃ |	padmarāga abja vat brāhmam viṣṇoḥ nilotpala prabham 
MBTattvaratnaavaliiHK-487	rudrasya sārvato bhadraṃ caṃḍābhaṃ vaddha? bhūmikam ||	rudrasya bhadram caṃḍa ābham bhūmikam 
MBTattvaratnaavaliiHK-488	anaṃtasyāsitābjātaṃ hemābjābhaṃ kapālinaḥ |	anaṃtasya asita abjātam hema abja ābham kapālinaḥ 
MBTattvaratnaavaliiHK-489	raktābjanibhaṃ vahneryā dṛḍhaṃ samaṃ ||	rakta abja nibham vahneḥ yā dṛḍham samam 
MBTattvaratnaavaliiHK-490	11b)	Ro
MBTattvaratnaavaliiHK-491	akeśādi sada? graṃthi kṛtaṃ vahva? ca kantyayā |	a keśa ādi graṃthi kṛtam ca kantyayā 
MBTattvaratnaavaliiHK-492	dhautaṃ sūtramajātena śodhayedatha rūpiṇā |	dhautam sūtram ajātena śodhayet atha rūpiṇā 
MBTattvaratnaavaliiHK-493	graṃthayedvāma devena jñātvā sūtrasya saṃpadaṃ ||	graṃthayet vāma devena jñātvā sūtrasya saṃpadam 
MBTattvaratnaavaliiHK-494	padavarṇakalāṃ tattva taṃtubhirvā pavitravaṃ ||	pada varṇa kalām tattva taṃtubhiḥ vā 
MBTattvaratnaavaliiHK-495	dvāda * * * *? parvajānaṃ vāśigamānakaṃ |	dvāda 
MBTattvaratnaavaliiHK-496	kartavyaṃ maulivat sarvaṃ samagraṃthyaṃtaṃrālakam ||	kartavyam mauli vat sarvam sama graṃthi aṃtaṃrālakam 
MBTattvaratnaavaliiHK-497	daśavāgraṃthayaḥ kāryā athavā taṃ tu saṃkhyayā |	kāryāḥ athavā tam tu saṃkhyayā 
MBTattvaratnaavaliiHK-498	oṃkāraḥ śarābhṛdvahniḥ svabhūrgāgo yuhau kramāt ||?	oṃkāraḥ śarābhṛt vahniḥ sva bhūḥ gāgaḥ yu hau kramāt 
MBTattvaratnaavaliiHK-499	prakṛtiḥ pauruṣī vīryā turyā syādaparājitā ||	prakṛtiḥ pauruṣī vīryā turyā syāt aparājitā 
MBTattvaratnaavaliiHK-500	jayā ca vijayā tadvadajitān sadāśivā |	jayā ca vijayā tadvat ajitān sadāśivā 
MBTattvaratnaavaliiHK-501	mano * *? ca navamī daśamī sarvajñājñāmī ||	ca navamī daśamī 
MBTattvaratnaavaliiHK-502	graṃthapadmasamākhyātā adhikāvā? samāprabhāḥ |	graṃtha padma samākhyātāḥ samā prabhāḥ 
MBTattvaratnaavaliiHK-503	sthaṃḍile ratnaje rauhe cale vāṇe svayaṃbhuvi ||	sthaṃḍile ratna je rauhe cale vāṇe svayaṃbhuvi 
MBTattvaratnaavaliiHK-504	pathodita pavitrāṇāmekaṃ kārpaṃ pathā ruci |	pathā udita pavitrāṇām ekam kārpam pathā ruci 
MBTattvaratnaavaliiHK-505	śivavat sūtrasaṃpannauravidhadeśa vahniṣu ||	vahniṣu 
MBTattvaratnaavaliiHK-506	ekaikamanyathā teṣāṃ vidadhīta pavitrakaṃ |	ekaikam anyathā teṣām vidadhīta pavitrakam 
MBTattvaratnaavaliiHK-507	nijamūrtyaṃgahe raṃvanukapādeṣṭra pustatstau? tathaikaika pavitraṃ	pavitram 
MBTattvaratnaavaliiHK-508	dvārdikpālakalaśādiṣu ||	dvār dikpāla kalaśa ādiṣu 
MBTattvaratnaavaliiHK-509	liṃgepi sadābhūyasseṣṭa? vamekanatrāpidā? |	liṃge pi 
MBTattvaratnaavaliiHK-510	hajādi? navaliṃgānāṃ dvādaśabhyorka vṛddhitaḥ ||	ha c ādi nava liṃgānām dvādaśabhyaḥ ṛ ka vṛddhitaḥ 
MBTattvaratnaavaliiHK-511	aṣṭāviṃśatitaḥ paṃkti vṛddhyāvāṣṭauntaraśataṃ |	aṣṭāviṃśatitaḥ 
MBTattvaratnaavaliiHK-512	aṣṭottaraśaṃtāntantoradhekana pavaikāgagāvanā ||	pava ekāgagāvanā 
MBTattvaratnaavaliiHK-513	kajuṣāṃtpiṃḍikātyaśiśobhana triṣyaṣṭādaśakādūrddhadgraṃthi dvitaya	triṣu aṣṭādaśakāt ūrddhat graṃthi dvitaya 
MBTattvaratnaavaliiHK-514	vṛddhitaḥ |	vṛddhitaḥ 
MBTattvaratnaavaliiHK-515	gaṃgādhatārake graṃthi niyamaḥ karmasādiṣu |	graṃthi niyamaḥ karmasa ādiṣu 
MBTattvaratnaavaliiHK-516	12a)	Ro
MBTattvaratnaavaliiHK-517	calācaleṣṭavyakteṣu jānvaṃtaṃ sārva daivatam |	cala acala iṣ vyakteṣu jānu aṃtam daivatam 
MBTattvaratnaavaliiHK-518	śṛṃgapṛṣṭhatpuragrīvā spṛgyadyādvṛṣabhe tathā ||	spṛś yat yāt vṛṣabhe tathā 
MBTattvaratnaavaliiHK-519	raktacaṃdana kāśmīra kastūrī rocaneṃdrubhiḥ |	raktacaṃdana kāśmīra kastūrī rocanā iṃdrubhiḥ 
MBTattvaratnaavaliiHK-520	haridrāgairikādyairvāraṃ jayennavamaṃtaḥ(?) ||	               
MBTattvaratnaavaliiHK-521	suptejanāddīnamāsatraya evasitāsite |	supta ijanāt dīna māsa traye eva sita asite 
MBTattvaratnaavaliiHK-522	pakṣedhivāsākartavyaḥ smara syārkasravātithau ||	            
MBTattvaratnaavaliiHK-523	saṃpūjya?yāgasūdanaṃ vānāvastra tritānakaiḥ |	saṃpūjya yāga sūdanam 
MBTattvaratnaavaliiHK-524	kṛtanimittika snāna saṃdhyātarpaṇa sakriyaḥ ||	kṛtanimittika snāna saṃdhyā tarpaṇa sakriyaḥ 
MBTattvaratnaavaliiHK-525	sūtrite sadane sūryamiṣṭvādvārārcanāditaḥ |	sūtrite sadane sūryam iṣṭvā dvāra arcana āditas 
MBTattvaratnaavaliiHK-526	vakṣyamāṇavidhānena maṃtrasaṃtarpaṇāvidhi ||	vakṣyamāṇa vidhānena 
MBTattvaratnaavaliiHK-527	carusthālīṃ tataḥ śastrakṣālitāṃ bala veṣṭitāṃ |	carusthālīm tatas śastra kṣālitām 
MBTattvaratnaavaliiHK-528	varmāstha japtasadvartasūddhaveṣṭitakaṇṭhikāṃ ||	japta sat varta sūddha veṣṭita kaṇṭhikām 
MBTattvaratnaavaliiHK-529	caṃdanādi samālabdhāṃ ṣaṭkāsanamaṇḍale |	caṃdana ādi samālabdhām ṣaṭka āsana maṇḍale 
MBTattvaratnaavaliiHK-530	vinyasya pūjayet tatra śivaṃ bhāvopahārakaiḥ ||	vinyasya pūjayet tatra śivam bhāva upahārakaiḥ 
MBTattvaratnaavaliiHK-531	vastrācchannamukhāyāṃ vā vāhyairgandhādibhiryajet |	vastra ācchanna mukhāyām vā vāhyaiḥ gandha ādibhiḥ yajet 
MBTattvaratnaavaliiHK-532	dīkṣaṇādi viśuddhāyāṃ tulyaḥ pūrvānanaḥ svayaṃ ||	dīkṣaṇa ādi viśuddhāyām tulyaḥ pūrva ānanaḥ svayam 
MBTattvaratnaavaliiHK-533	vyastahaṃkārabījāyāṃ sthitāyāṃ kuṇḍadakṣiṇe |	vyasta haṃkāra bījāyām sthitāyām kuṇḍa dakṣiṇe 
MBTattvaratnaavaliiHK-534	sthālīmāropayet tasyāmastragavyājyamārjitā ||	sthālīm āropayet tasyām astra gavya ājya mārjitā 
MBTattvaratnaavaliiHK-535	astraśuddhapayogavyaṃ mūlena śatamaṃtritaṃ |	astra śuddha payaḥ gavyam mūlena śata maṃtritam 
MBTattvaratnaavaliiHK-536	yājñīyataṃdulānāṃ ca catuḥprasṛtibhiryutam ||	yājñīya taṃdulānām ca catur prasṛtibhiḥ yutam 
MBTattvaratnaavaliiHK-537	dīkṣāvidhāne śiṣyārthaṃ? prasṛti varddhayet kramāt |	dīkṣā vidhāne śiṣya artham prasṛti varddhayet kramāt 
MBTattvaratnaavaliiHK-538	pacecchivāgnau carukaṃbūlamaṃtramudīrayan ||	pacet śiva agnau caru kaṃbūla maṃtram udīrayan 
MBTattvaratnaavaliiHK-539	cālayannastha maṃtreṇa pidhāyakavacāṇunā |	maṃtreṇa pidhāya kavaca aṇunā 
MBTattvaratnaavaliiHK-540	asvinne caruke vyādhi dīgvasyānmaraṇaṃ tataḥ ||	asvinne caruke vyādhi dīk vasyāt maraṇam tatas 
MBTattvaratnaavaliiHK-541	susvinne saṃhitā maṃtrairdatvā taptābhi ghārakaṃ |	su svinne saṃhitāḥ maṃtraiḥ da tvā 
MBTattvaratnaavaliiHK-542	uttārya sthāpayet sthālī sadarbhāstrāṇumaṇḍale ||	uttārya sthāpayet sthālī sa darbha astra aṇu maṇḍale 
MBTattvaratnaavaliiHK-543	dhruveṇosyasaṃmāryallahanaṃ hṛdayāṇunā ||	dhruveṇa usya saṃmāryat lahanam hṛdayāṇunā 
MBTattvaratnaavaliiHK-544	saśīta * * * * * * * * * * *	ro-0 
MBTattvaratnaavaliiHK-545	12b)	Ro
MBTattvaratnaavaliiHK-546	gṛhasthānāṃ dvijādīnāṃ ṣadvidvyekasaraṃ kramāt |	gṛhasthānām dvija ādīnām ṣa dvi dvi eka saram kramāt 
MBTattvaratnaavaliiHK-547	nyūnāni doṣamoṣārthaṃ hutvā pūrṇāṃ pradāya ca ||	nyūnāni doṣa moṣa artham hutvā pūrṇām pradāya ca 
MBTattvaratnaavaliiHK-548	śivaṃ visṛjyavahnisthaṃ hutvā vyāhṛtibhistataḥ |	śivam visṛjya vahni stham hutvā vyāhṛtibhiḥ tatas 
MBTattvaratnaavaliiHK-549	vahnyādityasta * * * * * * * * cakṣam ||	vahni āditya sta        cakṣam 
MBTattvaratnaavaliiHK-550	sa pavitraṃ tato dadyāddikpatibhyo vahirvaliṃ |	sa pavitram tatas dadyāt dikpatibhyaḥ vahis valim 
MBTattvaratnaavaliiHK-551	liṃgino bhojayedviśandīnāndhakṛpaṇānapi ||	liṃginaḥ bhojayet viśan dīna andha kṛpaṇān api 
MBTattvaratnaavaliiHK-552	śaktyādhvadakṣiṇā datvā dānenānena saṃkara |	śaktyā adhva dakṣiṇāḥ da tvā dānena anena saṃkara 
MBTattvaratnaavaliiHK-553	kṛtyādi kārayet ||	kṛtyā ādi kārayet 
MBTattvaratnaavaliiHK-554	prātaḥ snānādi nirvartya pavitrāṇyo hared vibhoḥ |	prātar snāna ādi nirvartya pavitrāṇi yaḥ haret vibhoḥ 
MBTattvaratnaavaliiHK-555	aṣṭapuṣpikayaḥ deva marcayitvā visarjayet ||	aṣṭapuṣpikayaḥ deva marcayitvā visarjayet 
MBTattvaratnaavaliiHK-556	nityaṃ naimittikaṃ prā * * * * * * * * *	nityam naimittikam 
MBTattvaratnaavaliiHK-557	prāyaścittestu maṃtreṇa hune pūrṇāṃ pradāya ca |	prāyaścitteḥ tu maṃtreṇa hune pūrṇām pradāya ca 
MBTattvaratnaavaliiHK-558	mumukṣuraśi bhargāya kuryāt karma samarpaṇaṃ ||	mumukṣuḥ aśi bhargāya kuryāt karma samarpaṇam 
MBTattvaratnaavaliiHK-559	tvat prasādena * * * * * * * * * *	tvad prasādena 
MBTattvaratnaavaliiHK-560	phalasādhakaṃ |	        
MBTattvaratnaavaliiHK-561	maṃtravrātaṃ hṛdinyasya śivāgniṃ ca visarjayet |	maṃtra vrātam hṛdi nyasya śiva agnim ca visarjayet 
MBTattvaratnaavaliiHK-562	valimaṃtrā dṛśā ca sṛṣṭi * * * * * * *	vali maṃtrāḥ 
MBTattvaratnaavaliiHK-563	śive saṃyojyasāpekṣaṃ kṣamasveti visṛjyat |	śive saṃyojya sāpekṣam kṣamasva iti visṛjyat 
MBTattvaratnaavaliiHK-564	dvārvāstu(?) gaṇalokeśānnirapekṣaṃ visarjayet ||	dvārvāstu gaṇa lokeśān nirapekṣam visarjayet 
MBTattvaratnaavaliiHK-565	tataścaṃḍraṃ samabhyarcya datvā tasmai pavitrakam |	tatas caṃḍram samabhyarcya da tvā tasmai pavitrakam 
MBTattvaratnaavaliiHK-566	dadyāddeva * * * * * * * *? gurumnataḥ ||	dadyāt devaiḥ       gurum nataḥ 
MBTattvaratnaavaliiHK-567	tadadyuparipūrṇāṃga caḍanātha tavājñayā ||	tat adi upari pūrṇa aṃga caḍanātha tava ājñayā 
MBTattvaratnaavaliiHK-568	iti vijñapi tannatvāstutvā sārghavisarjyaṃ ca |	iti vijñapi tat natvā a stutvā sa argha visarjyam ca 
MBTattvaratnaavaliiHK-569	aṃdhakūpedbhavātoye tannirmālyādikaṃ kṣipet ||	tat nirmālya ādikam kṣipet 
MBTattvaratnaavaliiHK-570	13a)	Ro
MBTattvaratnaavaliiHK-571	bhūmiṃ saṃśodhya deveśaṃ snapayitvā samarcayet |	bhūmim saṃśodhya deveśam snapayitvā samarcayet 
MBTattvaratnaavaliiHK-572	vrataṃ samarpayet prāṃte bhojayennayatīśvarāt ||	vratam samarpayet prāñci bhojayet nayati īśvarāt 
MBTattvaratnaavaliiHK-573	dasamotśavaparvaṇyaṇyatha eva vidhismṛtaḥ |	eva vidhi smṛtaḥ 
MBTattvaratnaavaliiHK-574	tatra pūrvadite māya gacchedamalakāṃtikaṃ ||	tatra pūrva dite gacchet amalaka antikam 
MBTattvaratnaavaliiHK-575	dūrevedvemapātrādāvārovyā? maṃtra * *? he |	he 
MBTattvaratnaavaliiHK-576	haraprasādasaṃbhūtatvamatryabhisukhī bhava |	hara prasāda saṃbhūta tvam atri abhisukhī bhava 
MBTattvaratnaavaliiHK-577	śivakāryaṃ samuddiśya netajyosiśivājñayā ||	śiva kāryam samuddiśya 
MBTattvaratnaavaliiHK-578	pavanāmaṃtrayitvādi kāmarūdrāṃ? * *? tā |	kāma rūdrām 
MBTattvaratnaavaliiHK-579	pavitravidhivatkṛtvā sūryaśānalapūjanaṃ ||	pavitra vidhivat kṛtvā 
MBTattvaratnaavaliiHK-580	mūlanalaṃ tavāpatraṃ puṣpaṃ phalamanukramāt |	mūla nalam tava a patram puṣpam phalam anukramāt 
MBTattvaratnaavaliiHK-581	mṛddhātrī bhasmarādantakāṣṭhagaṃdhasamanvitaṃ ||	            
MBTattvaratnaavaliiHK-582	ajānādyairhṛdādairvāpaścimādiṣu vinyaset |	aja an ādyaiḥ hṛd ādaiḥ vā apaścima ādiṣu vinyaset 
MBTattvaratnaavaliiHK-583	paṃcāṃgamaṃjalau jvalā? śivasya maṃtrayet tataḥ ||	paṃcāṃgam aṃjalau jvalā śivasya maṃtrayet tatas 
MBTattvaratnaavaliiHK-584	āmaṃtritosi deveśa prātaḥkāle mayā prabhoḥ |	āmaṃtritaḥ asi deveśa prātaḥkāle mayā prabhoḥ 
MBTattvaratnaavaliiHK-585	kriyate dāmanaṃ parvatatratvaṃ sannidhī bhava ||	kriyate dāmanam sannidhī bhava 
MBTattvaratnaavaliiHK-586	mūlamuccārya devasya gaṃghakeṣṭā(?) sutāṃjaliṃ |	mūlam uccārya devasya gaṃghakeṣṭā suta aṃjalim 
MBTattvaratnaavaliiHK-587	vinyasya śiṣṭaṃ tatpātre pavitrakavidhānataḥ ||	vinyasya śiṣṭam tat pātre pavitraka vidhānataḥ 
MBTattvaratnaavaliiHK-588	prātarnimittikīṃ pūjāṃ damanairacikhaṃḍitaiḥ ||	prātar nimittikīm pūjām damanaiḥ a cikhaṃḍitaiḥ 
MBTattvaratnaavaliiHK-589	cikapāṃjali vādāyadāmaṃdūrvādi saṃyutaṃ |	saṃyutam 
MBTattvaratnaavaliiHK-590	tritatvaśaṃvarairda * * * * *? yamaṃ bhuliṃ mūlaṃ na	yamam mūlam na 
MBTattvaratnaavaliiHK-591	kheśvarāyeti makhaṃdvi | pūrayo caret |	kha īśvarāya iti caret 
MBTattvaratnaavaliiHK-592	sūlapāṇiṃ caturthyataṃ namo yuktaṃ bhavādikaṃ |	sūlapāṇim namaḥ yuktam bhava ādikam 
MBTattvaratnaavaliiHK-593	dadyādanena maṃtreṇa śeṣaṃ prāgukta vaccaret ||	dadyāt anena maṃtreṇa śeṣam prāc ukta vat caret 
MBTattvaratnaavaliiHK-594	gururpū? * * * *? rṇātaṃ vedāstaṃ vakṣalāṃ sthitaṃ ||	rṇātam sthitam 
MBTattvaratnaavaliiHK-595	13b)	Ro
MBTattvaratnaavaliiHK-596	arddhataṃdranibhaṃśceta saptakhaṃ padmalāṃsthitaṃ |	saptakham 
MBTattvaratnaavaliiHK-597	raktavarṇaṃ trikoṇaṃ ca tejaḥ svahikacihnavat ||	rakta varṇam tri koṇam ca tejaḥ sva hika cihnavat 
MBTattvaratnaavaliiHK-598	kṛṣṇaṃ ca vartulaṃ vāyu tatvaṃ mudritaṃ(?) saṃyutaṃ |	kṛṣṇam ca vartulam mudritam saṃyutam 
MBTattvaratnaavaliiHK-599	hemābhaṃ gaṃdhatanmātraṃ yadvasphu * *? vadrasaḥ |	hema ābham gaṃdha tanmātram vat rasaḥ 
MBTattvaratnaavaliiHK-600	japākusuma vadrūpa sparśo rūkṣāṃ tu? tasthati? ||	japā kusuma vat rūpa sparśaḥ rūkṣām tu tasthati 
MBTattvaratnaavaliiHK-601	śabdatanmātrakaṃ ābhramupasthaṃ harita prabhāṃ |	śabda tanmātrakam ābhram upastham harita 
MBTattvaratnaavaliiHK-602	pā *? pītā * * * * * *? ṇaḥ pāṇiḥ sitā ca	pā pītā         ṇaḥ pāṇiḥ sitā ca 
MBTattvaratnaavaliiHK-603	cākra ||	cākra 
MBTattvaratnaavaliiHK-604	sitā * * * * * * *? tvidrūpacchādikaṃ kvacit |	       
MBTattvaratnaavaliiHK-605	ghrāṇamuttaprā?hemābhaṃ jihvācaṃdrasamaprabhā ||	jihvā caṃdra sama prabhā 
MBTattvaratnaavaliiHK-606	rasthaddīna(?) śavacca kṛṣṇa kṛṣṇaṃ kajjala prabhaṃ |	kṛṣṇa kṛṣṇam kajjala prabham 
MBTattvaratnaavaliiHK-607	caitadbhūtavatpaṃcakavidhāṃ ||	ca etat bhūta vat paṃcakavidhām 
MBTattvaratnaavaliiHK-608	hṛtam |	hṛtam 
MBTattvaratnaavaliiHK-609	sa dhūmāgni prabhogarvaḥ prodatsārābjasaṃnibhaḥ ||?	sa dhūma agni prabhaḥ garvaḥ prodat sāra abja saṃnibhaḥ 
MBTattvaratnaavaliiHK-610	rūdvirastalaḥbjā *? prodyaddinakaṃ |	prodyat dinakam 
MBTattvaratnaavaliiHK-611	? tāṃ guṇātmakaṃ ||	tām guṇa ātmakam 
MBTattvaratnaavaliiHK-612	puṃ * * pra * * * * * rakṣiraṇabhāsvaram |	pum   pra    
MBTattvaratnaavaliiHK-613	rāghoraktā ca vadvidyā proḍasāvyakṣathatsivā ||?	ca vadvidyā 
MBTattvaratnaavaliiHK-614	kalā raktābjasaṃkrāśāniyati *? lakajavaśa kālaḥ kṛṣṇābja *	kalā kālaḥ 
MBTattvaratnaavaliiHK-615	tatvamaiśvara * * *? |	tatvam aiśvara 
MBTattvaratnaavaliiHK-616	caṃdrakoṭipratīkāśaṃ bhadrākhyaṃ ta * * jvalaṃ |	caṃdra koṭi pratīkāśam bhadra ākhyam 
MBTattvaratnaavaliiHK-617	koṭivālārka saṃkā * * * * * ḍulavigrahā ||	      
MBTattvaratnaavaliiHK-618	a * * * * * * * * * * * *	ad-2 ro-0
MBTattvaratnaavaliiHK-619	tatvādhipāśca kṛṣyaṃte pṛthivyādi śivāvadhi ||	tatva adhipāḥ ca kṛṣyaṃte pṛthivī ādi śiva avadhi 
MBTattvaratnaavaliiHK-620	śarvota * *? paśupatirīśobhīmaḥ prajāpatiḥ ||	śarva uta paśupatiḥ īśaḥ bhīmaḥ prajāpatiḥ 
MBTattvaratnaavaliiHK-621	14a)	Ro
MBTattvaratnaavaliiHK-622	nitroviddhiradradaha * *? pṛthvīvaruṇabhāskaraḥ |	pṛthvī varuṇa bhāskaraḥ 
MBTattvaratnaavaliiHK-623	vāyurdigdevatā caṃdro rudro brahmāgaṇoṃdikā ||	vāyuḥ diś devatā caṃdraḥ rudraḥ brahmā gaṇa uṃdikā 
MBTattvaratnaavaliiHK-624	śrīkaṃṭhomanmathaḥ krodhaḥ saṃvartaḥ sūrasaṃjñaka |	śrīkaṃṭhaḥ manmathaḥ krodhaḥ saṃvartaḥ sūra saṃjñaka 
MBTattvaratnaavaliiHK-625	ekavīro hyanaṃtaśca śuddhavidye sadāśivaḥ ||	ekavīraḥ hi anaṃtaḥ ca śuddhavidye sadāśivaḥ 
MBTattvaratnaavaliiHK-626	vyāpinyamāśritaśceti tatvādhipatayo matāḥ |	vyāpinyam āśritaḥ ca iti tatva adhipatayaḥ matāḥ 
MBTattvaratnaavaliiHK-627	kādikṣāntāścatustriṃśaccaturtha prathamasvarauḥ ||	ka ādi kṣa antāḥ catustriṃśat caturtha prathama svarauḥ 
MBTattvaratnaavaliiHK-628	biṃdunādānvitāḥ sarve ṣaṭtriṃśattatva? śaṃvarāḥ |	biṃdu nāda anvitāḥ sarve śaṃvarāḥ 
MBTattvaratnaavaliiHK-629	pṛthivyādi prakṛtyante kukāro vācake mataḥ ||	pṛthivī ādi prakṛti ante kukāraḥ vācake mataḥ 
MBTattvaratnaavaliiHK-630	kakārā pauruṣe tantre rāgādi catuṣṭaye |	kakārā pauruṣe tantre rāga ādi catuṣṭaye 
MBTattvaratnaavaliiHK-631	laḥkṛti namaḥ smṛto *? nauvidyāyāṃkṣaḥ smṛto manu ||	laḥ kṛti namaḥ smṛtaḥ 
MBTattvaratnaavaliiHK-632	ra? īśa?haḥ sadā śubhau śaktau śabhau bhavaḥ kvacit |	raḥ īśa haḥ sadā śubhau śaktau śa bhau bhavaḥ kvacid 
MBTattvaratnaavaliiHK-633	ātmatatva catuḥkoṇaṃ raktaṃ brahmādhi daivataṃ ||	catur koṇam raktam brahma adhi daivatam 
MBTattvaratnaavaliiHK-634	vidyātatvaṃ suvarṇābhamaṣṭāṣṭaṃ viṣṇu daivataṃ |	suvarṇa ābham aṣṭa aṣṭam viṣṇu daivatam 
MBTattvaratnaavaliiHK-635	śuddhasphaṭika tadvṛttaṃ sāṃdavaṃ bhadradaivatan ||	śuddha sphaṭika tad vṛttam sāṃdavam bhadra daivatan 
MBTattvaratnaavaliiHK-636	caturvaktraṃ bhujaṃmpītamātmatatvaṃ kvacinmataṃ |	catur vaktram kvacid matam 
MBTattvaratnaavaliiHK-637	nīlamaṣṭabhujāvidyā tatvāsaumyaṃ prakīrtitam ||	nīlam aṣṭa bhujā avidyā tatvā asaumyam prakīrtitam 
MBTattvaratnaavaliiHK-638	śivatatvaśaśāṃkātaṃ paṃcavaktraṃ caturbhujaṃ |	             
MBTattvaratnaavaliiHK-639	sabindudīrghanitayaṃ kramāttatvaṃdagne manuḥ ||	sa bindu dīrgha nitayam kramāt ta tvam agne manuḥ 
MBTattvaratnaavaliiHK-640	nivṛttiśca pratiṣṭhā ca vidyāśāntiśca jātasī |	nivṛttiḥ ca pratiṣṭhā ca vidyā śāntiḥ ca 
MBTattvaratnaavaliiHK-641	kalārthiti samākhyātāḥ pacaitāḥ śivaśaktayaḥ ||	samākhyātāḥ paca etāḥ śiva śaktayaḥ 
MBTattvaratnaavaliiHK-642	paṃcabhūtasamākārā mūrtirvā sā pṛthak pṛthak |	paṃcabhūta sama ākārā mūrtiḥ vā sā pṛthak pṛthak 
MBTattvaratnaavaliiHK-643	vijākṣamālinī dakṣi vāme sā bhaya vārijā ||	vijā akṣamālinī dakṣi vāme sā bhaya vāri jā 
MBTattvaratnaavaliiHK-644	sarvālaṃkāriṇī tryakṣā vivṛttiḥ parikīrtitā |	           
MBTattvaratnaavaliiHK-645	śvetādvidala * * * * * * * * * *	    
MBTattvaratnaavaliiHK-646	14b)	Ro
MBTattvaratnaavaliiHK-647	ūnclear	ūnclear 
MBTattvaratnaavaliiHK-648	15a)	Ro
MBTattvaratnaavaliiHK-649	sākṣamālā bhayādakṣe vāme pāśasarauruhā ||	sa akṣamālā bhayā dakṣe vāme pāśa sarauruhā 
MBTattvaratnaavaliiHK-650	pratiṣṭhā kīrtitāścetā sarvālaṃkārabhūṣitā |	pratiṣṭhā sarva alaṃkāra bhūṣitā 
MBTattvaratnaavaliiHK-651	tryakṣāpaṃcānanāraktā tricchadābje caturbhujā ||	               
MBTattvaratnaavaliiHK-652	sākṣasūtrā bhayā dakṣe vidyā vāmebja śaktibhṛt |	sākṣasūtrā bhayā dakṣe vidyā vāma ibja śaktibhṛt 
MBTattvaratnaavaliiHK-653	kapardedukalā vahni prabhā'laṃkāramaṇḍitā ||	            
MBTattvaratnaavaliiHK-654	ṣaṭpatrābja sthitā dhūmrā caturvāhuḥ śarānanā |	dhūmrā catur vāhuḥ śara ānanā 
MBTattvaratnaavaliiHK-655	sākṣasūtrābhayā dakṣe vāmeṃbuja patākinī ||	          
MBTattvaratnaavaliiHK-656	sarpopavītinī tryakṣāśāṃtiruktā mahāvalā |	sarpa upavītinī tri akṣā śāṃtiḥ uktā mahāvalā 
MBTattvaratnaavaliiHK-657	astārābja sthitā tryakṣā paṃcavaktrā caturbhujā ||	           
MBTattvaratnaavaliiHK-658	sākṣasūtrā bhayādakṣe vāme savaravārijā |	sa akṣasūtrā bhayā dakṣe vāme sa vara vāri jā 
MBTattvaratnaavaliiHK-659	viśvarūpamaṇi prakhyā śāṃtyatītā prakīrtitā ||	            
MBTattvaratnaavaliiHK-660	kvacit paṃcānanāḥ sarvā daśavāhā trilocanāḥ |	kvacid paṃca ānanāḥ sarvāḥ daśa vāhā tri locanāḥ 
MBTattvaratnaavaliiHK-661	maṃtrāḥ kalānāṃ hlāṃ hkīṃ hrūṃ hyai hrauṃ? vyāptirathocyate ||	maṃtrāḥ kalānām hlām hkīṃ hrūm hyai hraum vyāptiḥ atha ucyate 
MBTattvaratnaavaliiHK-662	nivṛttau pārthivaṃ tatvaṃ puraṣoḍaśakānvitaṃ |	nivṛttau pārthivam pura ṣoḍaśaka anvitam 
MBTattvaratnaavaliiHK-663	varṇa ekaḥ padānyaṣṭā viṃśatiśca vilomataḥ ||	varṇaḥ ekaḥ padāni aṣṭa viṃśatiḥ ca vilomataḥ 
MBTattvaratnaavaliiHK-664	śaṃvarau hṛdayājātau bīje cākāralaumatau |	śaṃvarau hṛdaya ajātau bīje ca ākāra laumatau 
MBTattvaratnaavaliiHK-665	īḍāpiṃge smṛte nāḍyau prāṇāpānau ca mārutau ||	īḍā piṃge smṛte nāḍyau prāṇa apānau ca mārutau 
MBTattvaratnaavaliiHK-666	prāṇopasthe ca khegaṃdho viṣayoguṇapaṃcakaṃ |	prāṇopasthe ca khegaṃdhaḥ viṣayaḥ guṇa paṃcakam 
MBTattvaratnaavaliiHK-667	avasthā sarvato bhadrā kāraṇaṃ kamalāsanaḥ ||	avasthā sarvatas bhadrā kāraṇam kamalāsanaḥ 
MBTattvaratnaavaliiHK-668	pratiṣṭhāyāmavādīni varṇāśca guṇapakṣatiḥ |	pratiṣṭhāyām avādīni varṇāḥ ca guṇa pakṣatiḥ 
MBTattvaratnaavaliiHK-669	ṣaṭpaṃcāśatpurāṇyetra padānāmekaviṃśatiḥ ||	ṣaṭpaṃcāśat purāṇi etra padānām ekaviṃśatiḥ 
MBTattvaratnaavaliiHK-670	śiro vāmau manūproktau dve vījenuvakārakau |	śiraḥ vāmau manū proktau dve 
MBTattvaratnaavaliiHK-671	nājau? suṣumnā gāṃdhāryau kāvudānasamānakau ||	na ajau suṣumnā gāṃdhāryau kau udāna samānakau 
MBTattvaratnaavaliiHK-672	khaṃpāyujihvaṃ viṣayorasoguṇa catuṣṭayaṃ |	catuṣṭayam 
MBTattvaratnaavaliiHK-673	svapnāvasthā mukundo * * * * * * * *	      
MBTattvaratnaavaliiHK-674	15b)	Ro
MBTattvaratnaavaliiHK-675	ūnclear	ūnclear 
MBTattvaratnaavaliiHK-676	16a)	Ro
MBTattvaratnaavaliiHK-677	saṃnadhīḥ |	saṃnadhīḥ 
MBTattvaratnaavaliiHK-678	guruḥ śiṣyaṃ samāhūya śivānuvyānasaṃyutaṃ |	guruḥ śiṣyam samāhūya śiva anuvyāna saṃyutam 
MBTattvaratnaavaliiHK-679	ācāṃtā paśuvaudeśe pradadyāddantadhāvanaṃ ||	ācāntā pradadyāt dantadhāvanam 
MBTattvaratnaavaliiHK-680	kṣīravṛkṣasamudbhūtaṃ praśastaṃ dvādaśāṃgulaṃ |	kṣīravṛkṣa samudbhūtam praśastam dvādaśa aṃgulam 
MBTattvaratnaavaliiHK-681	hṛdāsāṃgena dhāmnā vā taddanta spṛṣṭamaṃbhasā ||	dhāmnā vā tat danta spṛṣṭam aṃbhasā 
MBTattvaratnaavaliiHK-682	dhautamūrddha mukhaṃ kṣepāt tatastatpātamunnayet |	mukham kṣepāt tatas tad pātam unnayet 
MBTattvaratnaavaliiHK-683	prāgudakpaścime śorddha vadanaṃ pātamuttamaṃ ||	prāc udak paścime vadanam pātam uttamam 
MBTattvaratnaavaliiHK-684	tataḥ śiṣyaṃ samācāṃtaṃ sakalī kṛta vigrahaṃ |	tatas śiṣyam samācāṃtam sakalī kṛta vigraham 
MBTattvaratnaavaliiHK-685	svāpayecca śucau deśe svapnamāṇavakaṃ japan ||	svāpayet ca śucau deśe svapnamāṇavakam japan 
MBTattvaratnaavaliiHK-686	tataḥ prātaḥ samucchāya guruḥ svapnaṃ vicārayet |	tatas prātar samucchāya guruḥ svapnam vicārayet 
MBTattvaratnaavaliiHK-687	vilaṃvetā śubhe svapnai śubhe dīkṣāṃ samārabhet ||	śubhe śubhe dīkṣām samārabhet 
MBTattvaratnaavaliiHK-688	atha dīkṣā vidhistatra nityanirvartya deśikaḥ |	atha dīkṣā vidhiḥ tatra nitya nirvartya deśikaḥ 
MBTattvaratnaavaliiHK-689	kṛtārghaḥ pūjaye dvāre dvāraṇa? tyajva? maṇḍape ||	kṛtārghaḥ pūjaye dvāre dvāraṇa tyajva maṇḍape 
MBTattvaratnaavaliiHK-690	praviśya vidhinābhyanta rūpa viśyontarānanaḥ |	praviśya vidhinā abhyantara rūpa 
MBTattvaratnaavaliiHK-691	kurvītadehasaṃśuddhimaṃtaryāgārgha pūjane ||	kurvīta deha saṃśuddhim antaryāga argha pūjane 
MBTattvaratnaavaliiHK-692	dravya śuddhiṃ ca tilakaṃ pūjāṃ ca svāsanātmanoḥ |	dravya śuddhim ca tilakam pūjām ca sva āsana ātmanoḥ 
MBTattvaratnaavaliiHK-693	maṃtraśuddhi tataḥ paṃcagavyaṃ ca vikirāṃ tataḥ ||	tatas paṃcagavyam ca tatas 
MBTattvaratnaavaliiHK-694	saptāstu maṃtritāt kuryād jñānakhaḍgaṃ ca maṃtravit |	sapta astu maṃtritāt kuryāt jñāna khaḍgam ca maṃtra vid 
MBTattvaratnaavaliiHK-695	śiva sṛṣṭi kramācchodhyamadhvānaṃ niṣkalaṃ tataḥ ||	śiva sṛṣṭi kramāt śodhyam adhvānam niṣkalam tatas 
MBTattvaratnaavaliiHK-696	mūlajaptasitoṣṇī śamalaṃ kārāṃśca vinyaset |	mūla japta sitoṣṇī śamalam kārān ca vinyaset 
MBTattvaratnaavaliiHK-697	śivahasta ca saṃpādya jñānakhaḍga samanvitaḥ ||	śivahasta ca saṃpādya jñāna khaḍga samanvitaḥ 
MBTattvaratnaavaliiHK-698	śivohamityahaṃkārī paṃcādhikāraṇa sthitaḥ |	śivaḥ ham iti ahaṃkārī sthitaḥ 
MBTattvaratnaavaliiHK-699	kuryānmaṇḍapasaṃskāraṃ nair-ṛtyādīśadiṅmukhaḥ ||	kuryāt maṇḍapa saṃskāram nairṛtyāt īśa diś mukhaḥ 
MBTattvaratnaavaliiHK-700	arghābunokṣapetpaṃcagavyena tadanaṃtaraṃ |	arghābunā ukṣapet paṃcagavyena tat anantaram 
MBTattvaratnaavaliiHK-701	catuḥpathāntasaṃskārai vīkṣaṇādyairviśodhite ||	catuḥpatha anta saṃskāraiḥ vīkṣaṇa ādyaiḥ viśodhite 
MBTattvaratnaavaliiHK-702	vikirānvikṣipet tatra kuśakurvyāpasaṃharet |	vikirān vikṣipet tatra kuśa kurvyā apasaṃharet 
MBTattvaratnaavaliiHK-703	vāstu vṛndārakāniṣṭvā nair-ṛte kṛtamaṇḍale ||	vāstu vṛndārakān iṣṭvā nairṛte kṛta maṇḍale 
MBTattvaratnaavaliiHK-704	16b)	Ro
MBTattvaratnaavaliiHK-705	pūjayet paścimadvāre lakṣmīṃ ratnaughavarṣiṇīṃ |	pūjayet paścima dvāre lakṣmīm ratna ogha varṣiṇīm 
MBTattvaratnaavaliiHK-706	īśāne sarvadhānyasthe ratnagandhāmbupūrite ||	īśāne sarva dhānya sthe ratna gandha ambu pūrite 
MBTattvaratnaavaliiHK-707	vastrādiśobhite kuṃbhe śaṃbhumiṣṭvā valāsanaṃ |	vastra ādi śobhite kuṃbhe śaṃbhum iṣṭvā valāsanam 
MBTattvaratnaavaliiHK-708	taddakṣiṇe samabhyarcya varddhanī vikirāsane ||	tad dakṣiṇe samabhyarcya varddhanī vikira āsane 
MBTattvaratnaavaliiHK-709	dikṣu śakrādi viṣṇvaṃtāndigīśānvidhinārcayet |	dikṣu śakra ādi viṣṇu aṃtān digīśān vidhinā arcayet 
MBTattvaratnaavaliiHK-710	varddhanīṃ bhrāmayedagre vāridhārāṃ pradakṣiṇaṃ ||	varddhanīm bhrāmayet agre vāri dhārām pradakṣiṇam 
MBTattvaratnaavaliiHK-711	śivakuṃbhānvitāṃ pṛṣṭhe śivājñāṃ śrāvayedatha |	śiva kuṃbha anvitām pṛṣṭhe śiva ājñām śrāvayet atha 
MBTattvaratnaavaliiHK-712	bho bho śakrādayaḥ svasyāṃ diśivighna praśāntaye ||	bho bho śakra ādayaḥ svasyām diśi vighna praśāntaye 
MBTattvaratnaavaliiHK-713	sāvadhānena yāgāntaṃ bhavitavyaṃ śivājñayā |	sāvadhānena yāga antam bhavitavyam śiva ājñayā 
MBTattvaratnaavaliiHK-714	ādau svāsanake kuṃbhaṃ dharettadanu varddhanīṃ ||	ādau sva āsanake kuṃbham dharet tadanu varddhanīm 
MBTattvaratnaavaliiHK-715	kuṃbhe sthirāsanaṃ śaṃbuṃmiṣṭvādhvāptaṃ? ca vinyaset |	kuṃbhe sthirāsanam ca vinyaset 
MBTattvaratnaavaliiHK-716	varddhanyāśastamabhyarcya siṃhasthaṃ pralayārkabhaṃ ||	varddhanya āśaḥ tam abhyarcya siṃha stham pralaya arka bham 
MBTattvaratnaavaliiHK-717	saṃdhānaṃ ca tayoḥ kuryān mudrayāliṃgasaṃjñayā |	saṃdhānam ca tayoḥ kuryāt mudrayā aliṃga saṃjñayā 
MBTattvaratnaavaliiHK-718	aṃguṣṭhena spṛśet kuṃbhaṃ hṛdāmuṣṭyānuvarddhanīṃ ||	aṃguṣṭhena spṛśet kuṃbham hṛdāmuṣṭyā anuvarddhanīm 
MBTattvaratnaavaliiHK-719	bhuktaye muktaye tvādau muṣṭinā varddhanīṃ spṛśet |	bhuktaye muktaye tu ādau muṣṭinā varddhanīm spṛśet 
MBTattvaratnaavaliiHK-720	japtvāni vedyarakṣārthaṃ jñānakhaḍgaṃ samarpayet ||	japtvāni vedya rakṣā artham jñāna khaḍgam samarpayet 
MBTattvaratnaavaliiHK-721	vighnanāthaṃ samabhyarcya vāyavyāṃ vighnaśāntaye |	vighnanātham samabhyarcya vāyavyām vighna śāntaye 
MBTattvaratnaavaliiHK-722	sthaṇḍileśaṃ yajenmadhye gaṃdhāṃ *? kṛtamaṇḍale ||	sthaṇḍila īśam yajet madhye gaṃdhām kṛta maṇḍale 
MBTattvaratnaavaliiHK-723	vinyasya śodhyamadhvānaṃ kuṃḍāntika manu vrajen |	vinyasya śodhyam adhvānam kuṃḍa antika manu vrajet 
MBTattvaratnaavaliiHK-724	vinyasya dakṣiṇe bhāge samiddarbha tilādikaṃ ||	vinyasya dakṣiṇe bhāge samidh darbha tila ādikam 
MBTattvaratnaavaliiHK-725	gaṃdhājyārghādikaṃ vāme niveṣṭastadanaṃtaraṃ |	gaṃdha ājya argha ādikam vāme niveṣṭaḥ tad anantaram 
MBTattvaratnaavaliiHK-726	kuṇḍavahnistu saṃjyādi? saṃskṛtyāgnau śivaṃ yajet ||	kuṇḍa vahniḥ tu saṃjyā ādi saṃskṛtya agnau śivam yajet 
MBTattvaratnaavaliiHK-727	17a)	Ro
MBTattvaratnaavaliiHK-728	nyasyādhvānaṃ gururdvyāpe dīśavaktrasya mukhyatāṃ |	nyasya adhvānam guruḥ dvi āpe dīśa vaktrasya mukhya tām 
MBTattvaratnaavaliiHK-729	aṣṭottaraśataṃ hutvā mūlenāṃgairdaśāṃśataḥ ||	aṣṭottaraśatam hutvā mūlena aṃgaiḥ daśa aṃśataḥ 
MBTattvaratnaavaliiHK-730	datvā pūrṇāṃ tathā śiṣya praveśāya śataṃ yajet |	da tvā pūrṇām tathā śiṣya praveśāya śatam yajet 
MBTattvaratnaavaliiHK-731	śataṃ śataṃ ca hotavyaṃ saṃpannau deśakālayoḥ ||	śatam śatam ca hotavyam saṃpannau deśa kālayoḥ 
MBTattvaratnaavaliiHK-732	durnimittāya sārāya sunimitta kṛte tathā |	durnimittāya sārāya sunimitta kṛte tathā 
MBTattvaratnaavaliiHK-733	maṃtrāṇāṃ tarpaṇaṃ kuryāt sakṛdāhuti dānataḥ ||	maṃtrāṇām tarpaṇam kuryāt sakṛdāhuti dānataḥ 
MBTattvaratnaavaliiHK-734	hūṃkārasaṃpuṭairmaṃtrairhuṃ phaḍaṃtaiśca dīpanaṃ |	hūṃkāra saṃpuṭaiḥ maṃtraiḥ hum phaṭ aṃtaiḥ ca dīpanam 
MBTattvaratnaavaliiHK-735	caruṃ nirvartya tasyāṃśaṃ śivāgnibhyāṃ nivedya ca ||	carum nirvartya tasya aṃśam śiva agnibhyām nivedya ca 
MBTattvaratnaavaliiHK-736	hutvāstreṇa śataṃ paścādyadaṃtarvaliṃ budhaḥ |	hutvā astreṇa śatam paścāt yat antar valim budhaḥ 
MBTattvaratnaavaliiHK-737	tato maheśamadhyeṣya labdhvānujo vahirgataḥ ||	tatas maheśam adhyeṣya labdhvā anujaḥ vahis gataḥ 
MBTattvaratnaavaliiHK-738	nyastapūrvāgra saddarbhe śastrāṇu kṛtamaṃḍale |	nyasta pūrva agra sat darbhe 
MBTattvaratnaavaliiHK-739	prāṇavekamaleśiṣyamūrddhakāyaṃ niveśayet ||	niveśayet 
MBTattvaratnaavaliiHK-740	snānaṃ caturbhiḥ kalaśairvastrasuckaṃdanācchitaiḥ |	snānam caturbhiḥ kalaśaiḥ vastra su ckaṃdana ācchitaiḥ 
MBTattvaratnaavaliiHK-741	bhūtiniṣṭhā prasiddhyarthe prāgudagdhadanaṃ guruḥ ||	bhūti niṣṭhā prasiddhi arthe guruḥ 
MBTattvaratnaavaliiHK-742	vilokayetka?toṃ ghryāṃtaṃ bhuktaye muktaye nyathā |	vilokayet katoṃ ghrya aṃtam bhuktaye muktaye nyathā 
MBTattvaratnaavaliiHK-743	cakṣuṣā nyasta mūlena śaivaṃ tejo vimuṃcatā ||	cakṣuṣā nyasta mūlena śaivam tejaḥ vimuṃcatā 
MBTattvaratnaavaliiHK-744	astrodakena saṃprokṣyatāḍayedastra bhasmanā |	astra udakena saṃprokṣya tāḍayet astra bhasmanā 
MBTattvaratnaavaliiHK-745	punarastrāṃbunābhyukṣyollikhedarbhāgra mūlakaiḥ ||	punar astra aṃbunā abhyukṣya ullikhet arbha agra mūlakaiḥ 
MBTattvaratnaavaliiHK-746	nābherūrddhvamadhastredhā bhuktya muktyai viparyayāt |	nābheḥ ūrddhvam adhas tredhā bhuktyai muktyai viparyayāt 
MBTattvaratnaavaliiHK-747	taddehe vinyaset maṃtrātmastake śiva marcayet ||	tad dehe vinyaset maṃtra ātma stake śiva marcayet 
MBTattvaratnaavaliiHK-748	śodhyādhvānaṃ ca vinyasya netre netreṇa cāhṛdā |	śodhya adhvānam ca vinyasya netre netreṇa ca ahṛdā 
MBTattvaratnaavaliiHK-749	17b)	Ro
MBTattvaratnaavaliiHK-750	sitenānupayuktena sadeśenāpareṇa vā |	sitena anupayuktena sa deśena apareṇa vā 
MBTattvaratnaavaliiHK-751	samācchādya praveśyāntaḥ śivadakṣiṇamaṃḍale ||	samācchādya praveśya antar śiva dakṣiṇa maṃḍale 
MBTattvaratnaavaliiHK-752	ṣaducchāsanake śiṣyamupaveśya tato guruḥ |	ṣad ucchāsanake śiṣyam upaveśya tatas guruḥ 
MBTattvaratnaavaliiHK-753	saṃhāramudrayātmānaṃ mūrtimaṃtreṇa taddhṛdi ||	saṃhāra mudrayā ātmānam mūrtimaṃtreṇa tad hṛdi 
MBTattvaratnaavaliiHK-754	nirodhya?śodhite kāye kṛtvā nyāsaṃ samarcayet |	nirodhya śodhite kāye kṛtvā nyāsam samarcayet 
MBTattvaratnaavaliiHK-755	sāṃgamiṣṭvākare śaṃbhuṃ mūlamaṃtreṇa mastake ||	sa aṃgam iṣṭvā ākare śaṃbhum mūlamaṃtreṇa mastake 
MBTattvaratnaavaliiHK-756	nidhāya maṃtrarocibhirbhāvayedgata kalmaṣam |	nidhāya maṃtra rocibhiḥ bhāvayet gata kalmaṣam 
MBTattvaratnaavaliiHK-757	rudreśvara padaprāptau biṃdunādānta yoginā ||	rudra īśvara pada prāptau biṃdu nāda anta yoginā 
MBTattvaratnaavaliiHK-758	tadvaste puṣpamāropya śive prakṣepayet tataḥ |	tat vaḥ te puṣpam āropya śive prakṣepayet tatas 
MBTattvaratnaavaliiHK-759	udghā?dyanetre deveśaṃ darśayenmukti bhuktidam ||	deveśam darśayet mukti bhukti dam 
MBTattvaratnaavaliiHK-760	puṣpapāta vaśānnāma śivadeveṅgaṇāṃtikaṃ |	puṣpapāta vaśāt nāma śivadeva iṅgaṇa antikam 
MBTattvaratnaavaliiHK-761	viprādīnāṃ kramāt kuryādathavā svecchayā guruḥ ||	vipra ādīnām kramāt kuryāt athavā sva icchayā guruḥ 
MBTattvaratnaavaliiHK-762	śive kuṃbhāstra varddhanyoḥ praṇamayyānalāṃtike |	śive kuṃbha astra varddhanyoḥ praṇamayya anala aṃtike 
MBTattvaratnaavaliiHK-763	svadakṣiṇāsane śiṣyamupavi'syottarānanaṃ ||	sva dakṣiṇāsane śiṣyam upavisya uttarānanam 
MBTattvaratnaavaliiHK-764	gurujaṃghāniviṣṭāgra kuśamūlakṛta grahaṃ |	guru jaṃghā niviṣṭa agra kuśa mūla kṛta 
MBTattvaratnaavaliiHK-765	kuśacchalena tannāḍī gurunāḍyālayaṃ gatā ||	kuśa chalena tad nāḍī guru nāḍī ālayam gatā 
MBTattvaratnaavaliiHK-766	gatvā śiṣyasya hṛdayaṃ recakena śivāṇunā |	gatvā śiṣyasya hṛdayam recakena śiva aṇunā 
MBTattvaratnaavaliiHK-767	pūrakeṇa samāgatya svakīyaṃ hṛdayāṃbujaṃ ||	pūrakeṇa samāgatya svakīyam hṛdaya aṃbujam 
MBTattvaratnaavaliiHK-768	icchaṃśivāgninā kuryānnāḍīsaṃdhānamātmanā |	iccham śiva agninā kuryāt nāḍī saṃdhānam ātmanā 
MBTattvaratnaavaliiHK-769	tisrastadanusaṃvyarthamāhutīrmūlato yajet ||	tisraḥ tadanu saṃvyartham āhutīḥ mūlataḥ yajet 
MBTattvaratnaavaliiHK-770	śiṣyottamāṃ?ge saṃpātaṃ vidaddhyāt saṃhitāṇubhiḥ |	śiṣya uttama aṃge saṃpātam vidaddhyāt saṃhitā aṇubhiḥ 
MBTattvaratnaavaliiHK-771	śivahasta sthiratvārthaṃ śataṃ mūlena homayet ||	śivahasta sthira tva artham śatam mūlena homayet 
MBTattvaratnaavaliiHK-772	upavītaṃ tato dadyānmūlamaṃtrābhimaṃtritaṃ |	upavītam tatas dadyāt mūlamaṃtra abhimaṃtritam 
MBTattvaratnaavaliiHK-773	icchaṃ sāmānya dīkṣāto bhavedyogyo * * * *? ||	dīkṣātaḥ 
MBTattvaratnaavaliiHK-774	Folio 18 - 27 unclear	folio 
MBTattvaratnaavaliiHK-775	End	end 
MBTattvaratnaavaliiHK-776	MUKTABODHA INDOLOGICAL RESEARCH INSTITUTE©2011 Muktabodha Indological Research Institute  All Rights Reserved.E-texts may be viewed only online or downloaded for private study.E-texts may not, under any circumstances, be copied, republished,reproduced, distributed or sold, either in original or altered form, withoutthe express permission of Muktabodha Indological Research Institute in writing.Data-entered by the staff of Muktabodha under the direction of Mark S. G. Dyczkowski.	muktabodha indological research muktabodha indological research institute all rights reserved texts may be viewed only online or downloaded for private studye texts may not under any circumstances be copied republished reproduced distributed or sold either in original or altered form withoutthe express permission of muktabodha indological research institute in writing data entered by the staff of muktabodha under the direction of mark s g dyczkowski 
