segmentnr	original	analyzed
MBtrisikhibrahmanopanisatHK-0	Muktabodha E-text in UTF-8	muktabodha etext in utf
MBtrisikhibrahmanopanisatHK-1	###########################################################################MUKTABODHA INDOLOGICAL RESEARCH INSTITUTEwww.muktabodha.org©2011 Muktabodha Indological Research Institute  All Rights Reserved.E-texts may be viewed only online or downloaded for private study.E-texts may not, under any circumstances, be copied, republished,reproduced, distributed or sold, either in original or altered form, withoutthe express permission of Muktabodha Indological Research Institute in writing.Data-entered by the staff of Muktabodha under the direction of Mark S. G. Dyczkowski.Catalog number : M00297	muktabodha indological research muktabodha indological research institute all rights reserved texts may be viewed only online or downloaded for private studye texts may not under any circumstances be copied republished reproduced distributed or sold either in original or altered form withoutthe express permission of muktabodha indological research institute in writing data entered by the staff of muktabodha under the direction of mark s g dyczkowskicatalog number  /
MBtrisikhibrahmanopanisatHK-2	Uniform title: triśikhibrāhmaṇopaniṣat	uniform title triśikhibrāhmaṇopaniṣad 
MBtrisikhibrahmanopanisatHK-3	Main title: yoga upaniṣads with the commentary of śrī upaniṣad brahmayogin	main title yoga upaniṣads with the commentary of śrī upaniṣad brahmayogin 
MBtrisikhibrahmanopanisatHK-4	Secondary title: triśikhibrāhmaṇa upaniṣat	secondary title triśikhibrāhmaṇa upaniṣad 
MBtrisikhibrahmanopanisatHK-5	Commentator : brahmayogin	commentatoḥ brahmayogin 
MBtrisikhibrahmanopanisatHK-6	Alternate name : śrī upaniṣad brahmayogin	alternate name śrī upaniṣad brahmayogin 
MBtrisikhibrahmanopanisatHK-7	Editor : śāstrī mahādeva	e t itoḥ śāstrī mahādeva 
MBtrisikhibrahmanopanisatHK-8	Notes: Data entered by the staff of Muktabodha under the direction of Mark S. G. Dyczkowski.	notes data entered by the staff muktabodha under the direction of mark s g dyczkowski 
MBtrisikhibrahmanopanisatHK-9	Revision 0: January 6, 2014	revision january 
MBtrisikhibrahmanopanisatHK-10	Publisher : Adyar library and research centre	publisher adyar library and research centre 
MBtrisikhibrahmanopanisatHK-11	Publication year : 1920	publication year 
MBtrisikhibrahmanopanisatHK-12	Publication city : Madras	publication citi madras 
MBtrisikhibrahmanopanisatHK-13	Publication country : India	publication country india 
MBtrisikhibrahmanopanisatHK-14	triśikhibrāhmaṇopaniṣat	triśikhibrāhmaṇa upaniṣad 
MBtrisikhibrahmanopanisatHK-15	pūrṇamadaḥ- iti śāntiḥ	pūrṇamadaḥ iti śāntiḥ 
MBtrisikhibrahmanopanisatHK-16	brāhmaṇabhāgaḥ	brāhmaṇa bhāgaḥ 
MBtrisikhibrahmanopanisatHK-17	ātmabrahmaviṣaye praśnāḥ	ātma brahma viṣaye praśnāḥ 
MBtrisikhibrahmanopanisatHK-18	triśikhī brāhmaṇa ādityalokaṃ jagāma | taṃ gatvovāca | bhagavan kiṃ	triśikhī brāhmaṇaḥ āditya lokam jagāma tam gatvā uvāca bhagavan kim 
MBtrisikhibrahmanopanisatHK-19	dehaḥ kiṃ prāṇaḥ kiṃ kāraṇaṃ kimātmā || 1 ||	dehaḥ kim prāṇaḥ kim kāraṇam kim ātmā 
MBtrisikhibrahmanopanisatHK-20	vivaraṇam	vivaraṇam 
MBtrisikhibrahmanopanisatHK-21	yogajñānaikasaṃsiddhaśivatattvatayojjvalam |	yoga jñāna eka saṃsiddha śiva tattva tayā ujjvalam 
MBtrisikhibrahmanopanisatHK-22	pratiyogivinirmuktaṃ paraṃ brahma bhavāmyaham ||	pratiyogi vinirmuktam param brahma bhavāmi aham 
MBtrisikhibrahmanopanisatHK-23	iha khalu śuklayajurvedapravibhakteyaṃ triśikhibrāhmaṇopaniṣat	iha khalu śuklayajurveda pravibhaktā iyam triśikhibrāhmaṇa upaniṣad 
MBtrisikhibrahmanopanisatHK-24	niṣpratiyogikabrahmamātraparyavasannā	              
MBtrisikhibrahmanopanisatHK-25	tadupāyāṣṭāṅgayogaprapañcaprakāśinī vijṛmbhate | tasyāḥ	tad upāya aṣṭāṅga yoga prapañca prakāśinī vijṛmbhate tasyāḥ 
MBtrisikhibrahmanopanisatHK-26	svalpagranthato vivaraṇamārabhyate |	su alpa granthataḥ vivaraṇam ārabhyate 
MBtrisikhibrahmanopanisatHK-27	triśikhibrāhmaṇādityapraśnaprativacanarūpeyamākhyāyikā	triśikhi brāhmaṇa āditya praśna prativacana rūpā iyam ākhyāyikā 
MBtrisikhibrahmanopanisatHK-28	vidyāstutyarthā | keyamākhyāyikā ityata āha- triśikhīti | nāmataḥ	vidyā stuti arthā kā iyam ākhyāyikā iti atas āha triśikhī iti nāmataḥ 
MBtrisikhibrahmanopanisatHK-29	triśikhī, brahmaṇo'patyaṃ brāhmaṇaḥ, sanātano nāma muniḥ,	triśikhī brahmaṇopatyam brāhmaṇaḥ sanātanaḥ nāma muniḥ 
MBtrisikhibrahmanopanisatHK-30	ādityalokāsanam ādityaṃ vidhivat upasaṃgamya dehaprāṇādikaṃ	āditya loka āsanam ādityam vidhivat upasaṃgamya deha prāṇa ādikam 
MBtrisikhibrahmanopanisatHK-31	tatkāraṇaṃ kiṃ, svayaṃ vā kīdṛśa iti papraccha || 1 ||	tad kāraṇam kim svayam vā kīdṛśaḥ iti papraccha 
MBtrisikhibrahmanopanisatHK-32	"p. 117) 			sarvasya śivatvam"	sarvasya śiva tvam 
MBtrisikhibrahmanopanisatHK-33	sa hovāca sarvamidaṃ śiva eva vijānīha | kiṃ tu nityaḥ śuddho	sa ha uvāca sarvam idam śivaḥ eva vijānīha kim tu nityaḥ śuddhaḥ 
MBtrisikhibrahmanopanisatHK-34	nirañjano vibhuradvayānandaḥ śiva ekaḥ svena bhāsedaṃ sarvaṃ sṛṣṭvā	nirañjanaḥ vibhuḥ advaya ānandaḥ śivaḥ ekaḥ svena bhāsā idam sarvam sṛṣṭvā 
MBtrisikhibrahmanopanisatHK-35	taptāyaḥpiṇḍavat aikyaṃ bhinnavat avabhāsate | tadbhāsakaṃ kimiti cet-	tapta ayaḥ piṇḍa vat aikyam bhinna vat avabhāsate tad bhāsakam kim iti ced 
MBtrisikhibrahmanopanisatHK-36	ucyate | sacchabdavācyam avidyāśabalaṃ brahma || 2 ||	ucyate sat śabda vācyam avidyā śabalam brahma  
MBtrisikhibrahmanopanisatHK-37	tatpraśnam aṅgīkṛtya taṃ hovāca bhagavān | kimiti ?	tad praśnam aṅgīkṛtya tam ha uvāca bhagavān kim iti 
MBtrisikhibrahmanopanisatHK-38	sarvamidamityādi | tvayā kiṃ deha ityādi yat pṛṣṭaṃ tat śiva eveti	sarvam idam ityādi tvayā kim dehe ityādi yat pṛṣṭam tat śive eva iti 
MBtrisikhibrahmanopanisatHK-39	vijānīhi, sarvasya śivājñānavikalpitatvāt | vikalpādhikaraṇatve	vijānīhi sarvasya śiva ajñāna vikalpita tvāt vikalpa adhikaraṇa tve 
MBtrisikhibrahmanopanisatHK-40	anityatvādi syāt ityatra āha- kiṃ tviti | svājñasvavikalpitavikalpajālaṃ	anitya tva ādi syāt iti atra āha kim tu iti sva ajña sva vikalpita vikalpa jālam 
MBtrisikhibrahmanopanisatHK-41	anityatvādidoṣaduṣṭameva | kiṃtu tadvikalpanādhāro	anitya tva ādi doṣa duṣṭam eva kiṃtu 
MBtrisikhibrahmanopanisatHK-42	nityatvādiviśeṣaṇaviśiṣṭaḥ advaitātmā śiva eka eva, na kadāpi	nitya tva ādi viśeṣaṇa viśiṣṭaḥ advaita ātmā śivaḥ ekaḥ eva na kadāpi 
MBtrisikhibrahmanopanisatHK-43	dvaitabhāvamupaitītyarthaḥ | vikalpajātaṃ kena vikalpitaṃ sadekatāṃ	dvaita bhāvam upaiti iti arthaḥ vikalpa jātam kena vikalpitam sat ekatām 
MBtrisikhibrahmanopanisatHK-44	gataṃ, tadbhāsakaṃ kim ityāśaṅkāyāṃ ya ekaḥ śivaḥ sa svena	gatam tat bhāsakam kim iti āśaṅkāyām yaḥ ekaḥ śivaḥ sa svena 
MBtrisikhibrahmanopanisatHK-45	tejasā sarvamidaṃ sṛṣṭvā tena taptāyaḥpiṇḍavat ekībhūya	tejasā sarvam idam sṛṣṭvā tena tapta ayaḥ piṇḍa vat ekībhūya 
MBtrisikhibrahmanopanisatHK-46	tadvailakṣaṇyenāpi bhāsata ityāha- sveneti | aikyaṃ prāpya	tad vailakṣaṇyena api bhāsate iti āha svena iti aikyam prāpya 
MBtrisikhibrahmanopanisatHK-47	svajñadṛṣṭyā bhinnavat avabhāsate | kiṃ tadityatra kiṃ deha ityādi	svajña dṛṣṭyā bhinna vat avabhāsate kim tat iti atra kim dehaḥ ityādi 
MBtrisikhibrahmanopanisatHK-48	triśikhipraśnaprativacane sarvamidaṃ śiva eveti yat pratijñātaṃ tatra	triśikhi praśna prativacane sarvam idam śivaḥ evā iti yat pratijñātam tatra 
MBtrisikhibrahmanopanisatHK-49	svavikalpitakāryāpekṣayā svasya kāraṇatvaṃ svātiriktāvyaktādeḥ	sva vikalpita kārya apekṣayā svasya kāraṇatvam sva atirikta avyakta ādeḥ 
MBtrisikhibrahmanopanisatHK-50	kāryatvaṃ ca viśadīkaroti- saditi | sadeva somyedamagra āsīt iti	kārya tvam ca viśadīkaroti sat iti sat eva somya idam agre āsīt iti 
MBtrisikhibrahmanopanisatHK-51	svāvidyāyogāt śabalatvaṃ svena rūpeṇa brahmatvaṃ siddhamityarthaḥ || 2 ||	sva avidyā yogāt śabala tvam svena rūpeṇa brahma tvam siddham iti arthaḥ 
MBtrisikhibrahmanopanisatHK-52	brahmaṇaḥ akhilajagadutpattiḥ	brahmaṇaḥ akhila jagat utpattiḥ 
MBtrisikhibrahmanopanisatHK-53	brahmaṇo'vyaktam | avyaktānmahat | mahato'haṃkāraḥ | ahaṃkārāt	brahmaṇaḥ vyaktam avyaktāt mahat mahataḥ uhaṃkāraḥ ahaṃkārāt 
MBtrisikhibrahmanopanisatHK-54	pañcatanmātrāṇi | pañcatanmātrebhyaḥ pañcamahābhūtāni |	pañca tanmātrāṇi pañca tanmātrebhyaḥ pañca mahābhūtāni 
MBtrisikhibrahmanopanisatHK-55	pañcamahābhūtebhyo'khilaṃ jagat || 3 ||	pañca mahābhūtebhyaḥ akhilam jagat 
MBtrisikhibrahmanopanisatHK-56	p. 118) kevalabrahmaṇaḥ kalpanānadhikaraṇatvena	            
MBtrisikhibrahmanopanisatHK-57	niṣpratiyogikanirvikalpatvāt tat tiṣṭhatu, śabalabrahmaṇaḥ kiṃ	niṣpratiyogika nirvikalpa tvāt tat tiṣṭhatu śabalabrahmaṇaḥ kim 
MBtrisikhibrahmanopanisatHK-58	vikalpitam ityata āha- brahmaṇo'vyaktamiti | tataḥ kim ityatra	vikalpitam iti atas āha tatas kim iti atra 
MBtrisikhibrahmanopanisatHK-59	guṇasāmyabhāvamāpannāvyaktāt mahat | satvabhāvamāpannamahataḥ	guṇa sāmya bhāvam āpanna avyaktāt mahat satva bhāvam āpanna mahataḥ 
MBtrisikhibrahmanopanisatHK-60	ahaṃkāraḥ | rajobhāvamāpannāhaṃkārāt pañcatanmātrāṇi |	ahaṃkāraḥ rajaḥ bhāvam āpanna ahaṃkārāt pañca tanmātrāṇi 
MBtrisikhibrahmanopanisatHK-61	tamaḥpradhānapañcatanmātrebhyaḥ pañcamahābhūtāni,	tamaḥ pradhāna pañca tanmātrebhyaḥ pañca mahābhūtāni 
MBtrisikhibrahmanopanisatHK-62	pañcīkṛtānītyarthaḥ |	pañcīkṛtāni iti arthaḥ 
MBtrisikhibrahmanopanisatHK-63	tamastamaḥpradhānatriguṇopasarjanapañcīkṛtapañcamahābhūtebhyaḥ	tamaḥ tamaḥ pradhāna triguṇa upasarjana pañcīkṛta pañca mahābhūtebhyaḥ 
MBtrisikhibrahmanopanisatHK-64	akhilaṃ jagat || 3 ||	akhilam jagat 
MBtrisikhibrahmanopanisatHK-65	ekasya piṇḍasya bahudhā vibhāgaḥ	ekasya piṇḍasya bahudhā vibhāgaḥ 
MBtrisikhibrahmanopanisatHK-66	tadakhilaṃ kimiti | bhūtavikāravibhāgāditi | ekasmin piṇḍe kathaṃ	tat akhilam kim iti bhūta vikāra vibhāgāt iti ekasmin piṇḍe katham 
MBtrisikhibrahmanopanisatHK-67	bhūtavikāravibhāga iti | tatkāryakāraṇabhedarūpeṇa	bhūta vikāra vibhāgaḥ iti tad kārya kāraṇa bheda rūpeṇa 
MBtrisikhibrahmanopanisatHK-68	aṃśatattvavācakavācyasthānabhedaviṣayadevatākośabhedavibhāgā	aṃśa tattva vācaka vācya sthāna bheda viṣaya devatā kośa bheda vibhāgā 
MBtrisikhibrahmanopanisatHK-69	bhavanti || 4 ||	bhavanti 
MBtrisikhibrahmanopanisatHK-70	ekasya piṇḍātmano jagataḥ kathamakhilatvam ityatra	ekasya piṇḍa ātmanaḥ jagataḥ katham akhila tvam iti atra 
MBtrisikhibrahmanopanisatHK-71	pañcīkṛtapañcamahābhūtavikāravibhāgāditi | tatrāpyākṣipati-	pañcīkṛta pañca mahābhūta vikāra vibhāgāt iti tatra api ākṣipati 
MBtrisikhibrahmanopanisatHK-72	ekasminniti | tatprakāramāha- taditi | pṛthivyādeḥ ākāśakāryatvaṃ	ekasmin iti tad prakāram āha tat iti pṛthivī ādeḥ ākāśa kārya tvam 
MBtrisikhibrahmanopanisatHK-73	ākāśādeḥ pṛthivyādikāraṇatvamiti tattadbhūtakāryakāraṇabhedarūpeṇa	ākāśa ādeḥ pṛthivī ādi kāraṇa tvam iti tad tad bhūta kārya kāraṇa bheda rūpeṇa 
MBtrisikhibrahmanopanisatHK-74	pṛthivyādipañcabhūtavibhāgaḥ | ākāśādyaṃśaśrotrāditattvabhedena	                        
MBtrisikhibrahmanopanisatHK-75	teṣāmabhidhānābhidheyabhedena tattadgolakasthānabhedena	teṣām abhidhāna abhidheya bhedena tad tad golaka sthāna bhedena 
MBtrisikhibrahmanopanisatHK-76	śabdādiviṣayabhedena degādidevatābhedena ānandamāyādikośabhedena ca	śabda ādi viṣaya bhedena ānanda māyā ādi kośa bhedena ca 
MBtrisikhibrahmanopanisatHK-77	bahudhā vibhāgā bhavanti | ekasmin avidyāṇḍapiṇḍe	bahudhā vibhāgāḥ bhavanti ekasmin avidyā aṇḍa piṇḍe 
MBtrisikhibrahmanopanisatHK-78	bhūtabhautikavikāravibhāgā upapadyanta ityarthaḥ || 4 ||	bhūta bhautika vikāra vibhāgāḥ upapadyante iti arthaḥ 
MBtrisikhibrahmanopanisatHK-79	ākāśādīnāmaṃśabhedāḥ	ākāśa ādīnām aṃśa bhedāḥ 
MBtrisikhibrahmanopanisatHK-80	athākāśaḥ antaḥkaraṇamanobuddhicittāhaṃkārāḥ | vāyuḥ	atha ākāśaḥ antaḥkaraṇa manaḥ buddhi citta ahaṃkārāḥ vāyuḥ 
MBtrisikhibrahmanopanisatHK-81	samānodānavyānapānaprāṇāḥ | vahniḥ śrotratvakcakṣurjihvāghrāṇāḥ |	samāna udāna vyāna pāna prāṇāḥ vahniḥ śrotra tvac cakṣuḥ jihvā ghrāṇāḥ 
MBtrisikhibrahmanopanisatHK-82	āpaḥ śabdasparśarūparasagandhāḥ | pṛthivī vākpāṇipādapāyūpasthāḥ	āpaḥ śabda sparśa rūpa rasa gandhāḥ pṛthivī vāc pāṇi pāda pāyu upasthāḥ 
MBtrisikhibrahmanopanisatHK-83	p. 119) evaṃ yat sūtritaṃ tadarthaṃ ākāśādikrameṇa viśadīkaroti-	evam yat sūtritam tad artham ākāśa ādi krameṇa viśadīkaroti 
MBtrisikhibrahmanopanisatHK-84	athetyādinā || ākāśāṃśā ityarthaḥ | atha vāyvādyaṃśā ucyante-	atha ityādinā ākāśa aṃśāḥ iti arthaḥ atha vāyu ādi aṃśāḥ ucyante 
MBtrisikhibrahmanopanisatHK-85	vāyuriti || 5 ||	vāyuḥ iti 
MBtrisikhibrahmanopanisatHK-86	teṣāṃ viṣayabhedāḥ	teṣām viṣaya bhedāḥ 
MBtrisikhibrahmanopanisatHK-87	jñānasaṃkalpaniścayānusaṃdhānābhimānā	jñāna saṃkalpa niścaya anusaṃdhāna abhimānā 
MBtrisikhibrahmanopanisatHK-88	ākāśakāryāntaḥkaraṇaviṣayāḥ |	ākāśa kārya antaḥkaraṇa viṣayāḥ 
MBtrisikhibrahmanopanisatHK-89	samīkaraṇonnayanagrahaṇaśrapaṇocchvāsā vāyukāryāpraṇādiviṣayāḥ |	samīkaraṇa unnayana grahaṇa śrapaṇa ucchvāsāḥ vāyu kārya apraṇa ādi viṣayāḥ 
MBtrisikhibrahmanopanisatHK-90	śabdasparśarūparasagandhā agnikāryajñānendriyaviṣayā abāśritāḥ |	śabda sparśa rūpa rasa gandhāḥ agni kārya jñāna indriya viṣayāḥ ap āśritāḥ 
MBtrisikhibrahmanopanisatHK-91	vacanādānagamanavisargānandāḥ pṛthivīkāryakarmendriyaviṣayāḥ |	vacana ādāna gamana visarga ānandāḥ pṛthivī kārya karma indriya viṣayāḥ 
MBtrisikhibrahmanopanisatHK-92	karmajñānendriyaviṣayeṣu prāṇatanmātraviṣayā antarbhūtāḥ |	karma jñāna indriya viṣayeṣu prāṇa tanmātra viṣayāḥ antarbhūtāḥ 
MBtrisikhibrahmanopanisatHK-93	manobuddhyościttāhaṃkārau cāntarbhūtau || 6 ||	manaḥ buddhyoḥ citta ahaṃkārau ca antarbhūtau 
MBtrisikhibrahmanopanisatHK-94	aṃśabhedānuktvā viṣayabhedānāha- jñāneti || 6 ||	aṃśa bhedān uktvā viṣaya bhedān āha jñāna iti 
MBtrisikhibrahmanopanisatHK-95	sūkṣmabhūtamātrāḥ	sūkṣma bhūtamātrāḥ 
MBtrisikhibrahmanopanisatHK-96	avakāśavidhūtadarśanapiṇḍīkaraṇadhāraṇāḥ sūkṣmatamā	avakāśa vidhūta darśana piṇḍīkaraṇa dhāraṇāḥ sūkṣmatamā 
MBtrisikhibrahmanopanisatHK-97	jaivatanmātraviṣayāḥ || 7 ||	         
MBtrisikhibrahmanopanisatHK-98	sūkṣmabhūtamātrā ucyante- avakāśeti || 7 ||	sūkṣma bhūtamātrāḥ ucyante avakāśa iti 
MBtrisikhibrahmanopanisatHK-99	ādhyātmikādivibhāgaḥ	ādhyātmika ādi vibhāgaḥ 
MBtrisikhibrahmanopanisatHK-100	evaṃ dvādaśāṅgāni ādhyātmikānyādhibhautikānyādhidaivikāni |	evam dvādaśa aṅgāni ādhyātmikāni ādhibhautikāni ādhidaivikāni 
MBtrisikhibrahmanopanisatHK-101	atra niśākaracaturmukhadigvātārkavaruṇāśvyagnīndropendraprajāpatiyamā	atra 
MBtrisikhibrahmanopanisatHK-102	akṣādhidevatārūpairdvādaśanāḍyantaḥpravṛttāḥ prāṇā evāṅgāni	akṣa adhidevatā rūpaiḥ dvādaśa nāḍī antar pravṛttāḥ prāṇāḥ eva aṅgāni 
MBtrisikhibrahmanopanisatHK-103	aṅgajñānaṃ tadeva jñāteti || 8 ||	aṅga jñānam tat eva jñātā iti 
MBtrisikhibrahmanopanisatHK-104	p. 120) aṃśādibhedena evam ityādi | atra ātmānaṃ dehaṃ bhūtajātaṃ	aṃśa ādi bhedena evam ityādi atra ātmānam deham bhūta jātam 
MBtrisikhibrahmanopanisatHK-105	devatājātaṃ ca adhikṛtya bhavantīti ādhyātmikāni ityādi | tatra	devatā jātam ca adhikṛtya bhavanti iti ādhyātmikāni ityādi tatra 
MBtrisikhibrahmanopanisatHK-106	ādhyātmikāni ādhibhautikāni uktāni | atra adhidaivikavivakṣayā	ādhyātmikāni ādhibhautikāni uktāni atra adhidaivika vivakṣayā 
MBtrisikhibrahmanopanisatHK-107	karaṇādhipā ucyante- atreti | iḍādi dvādaśanāḍī | yat	karaṇa adhipāḥ ucyante atra iti iḍā ādi dvādaśa nāḍī yat 
MBtrisikhibrahmanopanisatHK-108	sarvāṅgajñānam antaḥkaraṇaṃ tadeva upādhitvena yo'bhimanyate sa eva	sarva aṅga jñānam antaḥkaraṇam tat eva upādhi tvena yaḥ abhimanyate saḥ eva 
MBtrisikhibrahmanopanisatHK-109	jñātā jīvo bhavatītyarthaḥ || 8 ||	jñātā jīvaḥ bhavati iti arthaḥ 
MBtrisikhibrahmanopanisatHK-110	jñātṛvyāpārābhivyaktiḥ	        
MBtrisikhibrahmanopanisatHK-111	atha vyomānilānalajalānnānāṃ pañcīkaraṇamiti | jñātṛtvaṃ	atha vyoma anila anala jala annānām pañcīkaraṇam iti jñātṛ tvam 
MBtrisikhibrahmanopanisatHK-112	samānayogena śrotradvārā śabdaguṇo vāgadhiṣṭhita ākāśe tiṣṭhati	samāna yogena śrotra dvārā śabda guṇaḥ vāc adhiṣṭhitaḥ ākāśe tiṣṭhati 
MBtrisikhibrahmanopanisatHK-113	ākāśastiṣṭhati | mano vyānayogena tvagdvārā sparśaguṇaḥ	ākāśaḥ tiṣṭhati manaḥ vyāna yogena tvac dvārā sparśa guṇaḥ 
MBtrisikhibrahmanopanisatHK-114	pāṇyadhiṣṭhito vāyau tiṣṭhati vāyustiṣṭhati | buddhirudānayogena	pāṇi adhiṣṭhitaḥ vāyau tiṣṭhati vāyuḥ tiṣṭhati buddhiḥ udāna yogena 
MBtrisikhibrahmanopanisatHK-115	caturdvārā rūpaguṇaḥ pādādhiṣṭhito'gnau tiṣṭhatyagnistiṣṭhati |	catur dvārā rūpa guṇaḥ pāda dhiṣṭhita ugnau tiṣṭhati agniḥ tiṣṭhati 
MBtrisikhibrahmanopanisatHK-116	cittamapānayogena jihvādvārā rasaguṇa upasthādhiṣṭhito'psu	cittam apāna yogena jihvā dvārā rasa guṇaḥ upastha adhiṣṭhita upsu 
MBtrisikhibrahmanopanisatHK-117	tiṣṭhatyāpastiṣṭhanti | ahaṃkāraḥ prāṇayogena ghrāṇadvārā gandhaguṇo	tiṣṭhati āpaḥ tiṣṭhanti ahaṃkāraḥ prāṇa yogena ghrāṇa dvārā gandha guṇaḥ 
MBtrisikhibrahmanopanisatHK-118	gudādhiṣṭhitaḥ pṛthivyāṃ tiṣṭhati pṛthivī tiṣṭhatītyevaṃ veda || 9 ||	guda adhiṣṭhitaḥ pṛthivyām tiṣṭhati pṛthivī tiṣṭhati iti evam veda  /
MBtrisikhibrahmanopanisatHK-119	evamādhyātmikāditāpatrayaṃ nirūpya atha	evam ādhyātmika ādi tāpa trayam nirūpya atha 
MBtrisikhibrahmanopanisatHK-120	pañcīkaraṇābhivyaktajñātṛvyāpṛtiṃ vyaktīkaroti- atheti |	pañcīkaraṇa abhivyakta jñātṛ vyāpṛtim vyaktīkaroti atha iti 
MBtrisikhibrahmanopanisatHK-121	pañcīkaraṇamiti pañcīkaraṇaniṣpannaṃ jñātuḥ jñātṛtvamityarthaḥ |	pañcīkaraṇam iti pañcīkaraṇa niṣpannam jñātuḥ jñātṛ tvam iti arthaḥ 
MBtrisikhibrahmanopanisatHK-122	vyaṣṭisamaṣṭiprapañcāropādhikaraṇajīveśvarayoḥ vyāpṛtiṃ	vyaṣṭi samaṣṭi prapañca āropa adhi karaṇa jīva īśvarayoḥ vyāpṛtim 
MBtrisikhibrahmanopanisatHK-123	bhūtatatkāryānupraveśaṃ cāha- jñātṛtvamiti | jīveśāvavaṣṭabhya	bhūta tatkārya anupraveśam ca āha jñātṛ tvam iti jīva īśau avaṣṭabhya 
MBtrisikhibrahmanopanisatHK-124	jñātṛtvam ityādi | ākāśastiṣṭhati ākāśādau ākāśādiḥ bhūtvā	jñātṛ tvam ityādi ākāśaḥ tiṣṭhati ākāśa ādau ākāśa ādiḥ bhūtvā 
MBtrisikhibrahmanopanisatHK-125	tiṣṭhatītyarthaḥ | evaṃ veda ya evaṃ	tiṣṭhati iti arthaḥ evam veda yaḥ evam 
MBtrisikhibrahmanopanisatHK-126	pañcabhūtatatkāryāsaṅgāntaryāmiṇaṃ veda so'ntaryāmī bhavatīti śeṣaḥ	pañcabhūta tad kārya asaṅga antaryāmiṇam veda saḥ ntaryāmī bhavati iti śeṣaḥ 
MBtrisikhibrahmanopanisatHK-127	"p. 121) 			mantrabhāgaḥ"	mantra bhāgaḥ 
MBtrisikhibrahmanopanisatHK-128	brahmaṇaḥ sakāśāt pañcīkaraṇāntā sṛṣṭiḥ	brahmaṇaḥ sakāśāt pañcīkaraṇa antā sṛṣṭiḥ 
MBtrisikhibrahmanopanisatHK-129	atraite ślokā bhavanti-	atra ete ślokāḥ bhavanti 
MBtrisikhibrahmanopanisatHK-130	pṛthagbhūte ṣoḍaśa kalāḥ svārdhabhāgān parān kramāt |	pṛthak bhūte ṣoḍaśa kalāḥ sva ardha bhāgān parān kramāt 
MBtrisikhibrahmanopanisatHK-131	antaḥkaraṇavyānākṣirasapāyunabhaḥkramāt || 1 ||	antaḥkaraṇa vyāna akṣi rasa pāyu nabhaḥ kramāt 
MBtrisikhibrahmanopanisatHK-132	mukhyān pūrvottarairbhāgairbhūtebhūte catuścatuḥ |	mukhyān pūrva uttaraiḥ bhāgaiḥ bhūte bhūte catuḥ catuḥ 
MBtrisikhibrahmanopanisatHK-133	pūrvamākāśamāśritya pṛthivyādiṣu saṃsthitaḥ || 2 ||	pūrvam ākāśam āśritya pṛthivī ādiṣu saṃsthitaḥ 
MBtrisikhibrahmanopanisatHK-134	mukhyā ūrdhve parā jñeyā nā[a] parānuttarān viduḥ |	mukhyā ūrdhve parā jñeyā nāa parān uttarān viduḥ 
MBtrisikhibrahmanopanisatHK-135	evamaṃśo abhūt tasmāt tebhyaścāṃśo abhūt tathā || 3 ||	evam aṃśaḥ abhūt tasmāt tebhyaḥ ca aṃśaḥ abhūt tathā 
MBtrisikhibrahmanopanisatHK-136	tasmādanyonyamāśritya hyotaṃ protamanukramāt |	tasmāt anyonyam āśritya hi otam protam anukramāt 
MBtrisikhibrahmanopanisatHK-137	brāhmaṇena yo'rtho'bhihitaḥ tametamarthaṃ mantrā	brāhmaṇena yaḥ ṛthaḥ abhihitaḥ tam etam artham mantrāḥ 
MBtrisikhibrahmanopanisatHK-138	apyanuvadantītyāha- atreti |	api anuvadanti iti āha atra iti 
MBtrisikhibrahmanopanisatHK-139	svājñavikalpitasvātiriktaṣoḍaśakalātatkāryajātāt svajñadṛṣṭyā	                                   
MBtrisikhibrahmanopanisatHK-140	pṛthagbhūte niṣkale brahmaṇi nirbīje	pṛthak bhūte niṣkale brahmaṇi nirbīje 
MBtrisikhibrahmanopanisatHK-141	sakalakalanānirvāhakasvājñadṛṣṭyā	                
MBtrisikhibrahmanopanisatHK-142	praśnopaniṣatparipaṭhitaprāṇādināmāntakalā bījarūpeṇa ādau vikalpitāḥ	                                                     
MBtrisikhibrahmanopanisatHK-143	satyaḥ svāropādhikaraṇeśvarayogāt īśvaro bhūtvā | antaḥkaraṇaśabdena	satyaḥ svāropa adhi karaṇa īśvara yogāt īśvaraḥ bhūtvā antaḥkaraṇa śabdena 
MBtrisikhibrahmanopanisatHK-144	tatkāraṇam ākāśamucyate, vyānaśabdena vāyuḥ, akṣiśabdena	tad kāraṇam ākāśam ucyate vyāna śabdena vāyuḥ akṣi śabdena 
MBtrisikhibrahmanopanisatHK-145	agniḥ- akṣṇaḥ taijasatvāt rasaśabdena āpaḥ, pāyuśabdena	agniḥ akṣṇaḥ taijasa tvāt rasa śabdena āpaḥ pāyu śabdena 
MBtrisikhibrahmanopanisatHK-146	pṛthivī, ityevaṃ nabhaḥkramāt ākāśādikramāt parān	pṛthivī iti evam nabhaḥ kramāt ākāśa ādi kramāt parān 
MBtrisikhibrahmanopanisatHK-147	svārdhabhāgān pañcabhūtānāṃ mukhyān aṃśān kramāt tattadbhūte	sva ardha bhāgān pañcabhūtānām mukhyān aṃśān kramāt tad tad bhūte 
MBtrisikhibrahmanopanisatHK-148	nikṣipya || 1 || pūrvottaraiḥ akāśādipṛthivyantaiḥ bhāgaiḥ	nikṣipya    pūrva uttaraiḥ akāśa ādi pṛthivī antaiḥ bhāgaiḥ 
MBtrisikhibrahmanopanisatHK-149	tattadbhūtārdhāṃśānāṃ tattadbhūte nikṣiptatvāt śiṣṭārdhāṃśān	tad tad bhūta ardha aṃśānām tad tad bhūte nikṣipta tvāt śiṣṭa ardha aṃśān 
MBtrisikhibrahmanopanisatHK-150	catuṣcaturdhā vidhāya ākāśaḥ svāṃśetarārdhāṃśān	catuḥ caturdhā vidhāya ākāśaḥ sva aṃśa itara ardha aṃśān 
MBtrisikhibrahmanopanisatHK-151	vāyvādibhūtacatuṣṭaye nikṣipya, tathā vāyuḥ svāṃśetarārdhāṃśān	vāyu ādi bhūta catuṣṭaye nikṣipya tathā vāyuḥ sva aṃśa itara ardha aṃśān 
MBtrisikhibrahmanopanisatHK-152	ākāśāgnijalapṛthivīṣu	ākāśa agni jala pṛthivīṣu 
MBtrisikhibrahmanopanisatHK-153	p. 122) nikṣipetyādi samānam | evaṃ pañcīkṛte sati pūrvam	nikṣipa ityādi samānam evam pañcīkṛte sati pūrvam 
MBtrisikhibrahmanopanisatHK-154	ākāśamāśritya yoṃ'śo'sti so'yaṃ pañcīkaraṇānantaraṃ pṛthivyādiṣu	ākāśam āśritya yaḥ oṃśoḥ asti saḥ uyam pañcīkaraṇa anantaram pṛthivī ādiṣu 
MBtrisikhibrahmanopanisatHK-155	saṃsthito bhavati || 2 || ūrdhve pūrvaṃ tattadbhūtamukhyāṃśā eva parāḥ	saṃsthitaḥ bhavati ūrdhve pūrvam tad tad bhūta mukhya aṃśāḥ eva parāḥ 
MBtrisikhibrahmanopanisatHK-156	śreṣṭhāḥ iti jñeyāḥ | pañcīkṛte'pi vaiśeṣyāttu tadvādastadvādaḥ iti	śreṣṭhāḥ iti jñeyāḥ pañcīkṛte api vaiśeṣyāt tu tad vādaḥ tad vādaḥ iti 
MBtrisikhibrahmanopanisatHK-157	vaiyāsikasūtrānurodhena tattadbhūtavyapadeśāt paratvaṃ yujyate | uttarān	vaiyāsika sūtra anurodhena tad tad bhūta vyapadeśāt paratvam yujyate uttarān 
MBtrisikhibrahmanopanisatHK-158	mukhyāṃśetarān aṃśān aparān gauṇān vuduḥ tadvida ityarthaḥ | yasmāt	mukhya aṃśa itarān aṃśān aparān gauṇān vuduḥ tad vidaḥ iti arthaḥ yasmāt 
MBtrisikhibrahmanopanisatHK-159	evaṃ pañcabhūtāṃśaḥ abhūt tasmāt tebhyaḥ mukhyāṃśebhyaḥ tathā	evam pañcabhūta aṃśaḥ abhūt tasmāt tebhyaḥ mukhya aṃśebhyaḥ tathā 
MBtrisikhibrahmanopanisatHK-160	gauṇāṃśaḥ abhūt | pañcabhūtāṃśā abhūt gauṇāṃśā abhūt iti pāṭhe	gauṇa aṃśaḥ abhūt pañcabhūtāṃśā abhūt gauṇa aṃśā abhūt iti pāṭhe 
MBtrisikhibrahmanopanisatHK-161	abhūvannityarthe abhūditi vacanavyatyayaḥ || 3 || yasmāt evaṃ tasmāt	abhūvan iti arthe abhūt iti vacana vyatyayaḥ yasmāt evam tasmāt 
MBtrisikhibrahmanopanisatHK-162	anukramāt otaṃ protaṃ yathā bhavati tathā pañcabhūteṣu	anukramāt otam protam yathā bhavati tathā pañcabhūteṣu 
MBtrisikhibrahmanopanisatHK-163	mukhyāṃśojjvaleṣu gauṇāṃśāḥ anyonyamāśritya vartantaḥ ityarthaḥ ||	mukhya aṃśa ujjvaleṣu gauṇa aṃśāḥ anyonyam āśritya vartantaḥ iti arthaḥ 
MBtrisikhibrahmanopanisatHK-164	carācarātmakaviśvasṛṣṭiḥ	            
MBtrisikhibrahmanopanisatHK-165	pañcabhūtamayā bhūmiḥ sā cetanasamanvitā || 4 ||	pañcabhūta mayā bhūmiḥ sā cetana samanvitā 
MBtrisikhibrahmanopanisatHK-166	tata oṣadhayo'nnaṃ ca tataḥ piṇḍāścaturvidhāḥ |	tatas oṣadhayaḥ unnam ca tatas piṇḍāḥ caturvidhāḥ 
MBtrisikhibrahmanopanisatHK-167	rasāsṛṅmāṃsamedo'sthimajjāśuklāni dhātavaḥ || 5 ||	rasa asṛj māṃsa medaḥ sthi majjā śuklāni dhātavaḥ 
MBtrisikhibrahmanopanisatHK-168	kecit tadyogataḥ piṇḍā bhūtebhyaḥ saṃbhavāḥ kvacit |	kecid tad yogataḥ piṇḍāḥ bhūtebhyaḥ saṃbhavāḥ kvacid 
MBtrisikhibrahmanopanisatHK-169	tasminnannamayaḥ piṇḍo nābhimaṇḍalasaṃsthitaḥ || 6 ||	tasmin anna mayaḥ piṇḍaḥ nābhi maṇḍala saṃsthitaḥ 
MBtrisikhibrahmanopanisatHK-170	asya madhye'sti hṛdayaṃ sanālaṃ padmakośavat |	asya madhye asti hṛdayam sa nālam padma kośavat 
MBtrisikhibrahmanopanisatHK-171	sattvāntarvartino devāḥ kartrahaṃkāracetanāḥ || 7 ||	sattva antarvartinaḥ devāḥ kartṛ ahaṃkāra cetanāḥ 
MBtrisikhibrahmanopanisatHK-172	asya bīja tamaḥpiṇḍaṃ moharūpaṃ jaḍaṃ ghanam |	asya tamaḥ piṇḍam moha rūpam jaḍam ghanam 
MBtrisikhibrahmanopanisatHK-173	vartate kaṇṭhamāśritya miśrībhūtamidaṃ jagat || 8 ||	vartate kaṇṭham āśritya miśrībhūtam idam jagat 
MBtrisikhibrahmanopanisatHK-174	pratyāgānandarūpātmā mūrdhni sthāne paraṃpade |	pratyāk ānanda rūpa ātmā mūrdhni sthāne paraṃpade 
MBtrisikhibrahmanopanisatHK-175	anantaśaktisaṃyukto jagadrūpeṇa bhāsate || 9 ||	ananta śakti saṃyuktaḥ jagat rūpeṇa bhāsate 
MBtrisikhibrahmanopanisatHK-176	p. 123) evaṃ pañcīkṛtabhūtataḥ cetanayuktāt jāyate ityatra	evam pañcīkṛta bhūtataḥ cetana yuktāt jāyate iti atra 
MBtrisikhibrahmanopanisatHK-177	carācarātmakaṃ viśvaṃ jāyate ityāha- pañceti || 4 || cetanādhiṣṭhitāt	carācara ātmakam viśvam jāyate iti āha pañca iti    cetanā dhiṣṭhitāt 
MBtrisikhibrahmanopanisatHK-178	tataḥ, caitanyādhiṣṭhitānnāt, jarāyujādibhedena caturvidhāḥ	tatas caitanya adhiṣṭhita annāt jarāyu ja ādi bhedena caturvidhāḥ 
MBtrisikhibrahmanopanisatHK-179	piṇḍāḥ saṃjātāḥ ityarthaḥ | dhātavo'pyannādeva jāyanta ityāha- raseti	piṇḍāḥ saṃjātāḥ iti arthaḥ dhātavaḥ api annāt eva jāyante iti āha rasa iti 
MBtrisikhibrahmanopanisatHK-180	|| 5 || kecideva vadantītyāha- keciditi | tadyogataḥ śuklaśoṇitayogataḥ	  eva vadanti iti āha   iti        
MBtrisikhibrahmanopanisatHK-181	piṇḍāḥ bhuktānnapuruṣabhūtebhyaḥ saṃjātaśuklaśoṇitasaṃbhavāḥ	piṇḍāḥ bhukta anna puruṣa bhūtebhyaḥ saṃjāta śukla śoṇita saṃbhavāḥ 
MBtrisikhibrahmanopanisatHK-182	piṇḍāḥ iti kecidāhuḥ | sarvathā annamayā ityarthaḥ | annasāraḥ piṇḍaḥ kva	piṇḍāḥ iti kecid āhuḥ sarvathā anna mayāḥ iti arthaḥ anna sāraḥ piṇḍaḥ kva 
MBtrisikhibrahmanopanisatHK-183	āsanamarhati ityata āha- tasminniti | tasmin bhūtakadambe, tasya	āsanam arhati iti atas āha tasmin iti tasmin bhūta kadambe tasya 
MBtrisikhibrahmanopanisatHK-184	sarvaprāṇijīvananimittatvāt || 6 || tanmadhye kiṃ vartate ityata āha- asyeti |	sarva prāṇi jīvana nimitta tvāt   tad madhye kim vartate iti atas āha asya iti 
MBtrisikhibrahmanopanisatHK-185	annamayasya | tadāśritya ke vartante ityata āha- sattveti |	anna mayasya tat āśritya ke vartante iti atas āha sattva iti 
MBtrisikhibrahmanopanisatHK-186	sattvāntarvartinaḥ sattvaguṇapradhānāḥ indrādayo brahmādayaśca devāḥ	sattva antarvartinaḥ sattva guṇa pradhānāḥ indra ādayaḥ brahma ādayaḥ ca devāḥ 
MBtrisikhibrahmanopanisatHK-187	vartante | yadvā- kartrahaṃkāracetanāḥ antaḥkaraṇaviśiṣṭāḥ devāḥ	vartante yat vā kartṛ ahaṃkāra cetanāḥ antaḥkaraṇa viśiṣṭāḥ devāḥ 
MBtrisikhibrahmanopanisatHK-188	indriyāṇi vidyante ityarthaḥ || 7 || hṛdayabījaṃ kim ityata āha- asyeti |	indriyāṇi vidyante iti arthaḥ 
MBtrisikhibrahmanopanisatHK-189	ghanaṃ svājñānamityarthaḥ | tat kutra vartate ityata āha- vartate iti |	ghanam sva ajñānam iti arthaḥ tat kutra vartate iti atas āha vartate iti 
MBtrisikhibrahmanopanisatHK-190	svājñānaṃ manaḥsthānaṃ galāntam iti śrutyanurodhena kaṇṭhaṃ	sva ajñānam manaḥ sthānam gala antam iti śruti anurodhena kaṇṭham 
MBtrisikhibrahmanopanisatHK-191	kaṇṭhāsanaṃ manaḥ sāśritya vartate | tena svājñānakabalitamanasā idaṃ	kaṇṭhāsanam manaḥ sa āśritya vartate tena sva ajñāna kabalita manasā idam 
MBtrisikhibrahmanopanisatHK-192	jagat miśrībhūtaṃ vyāptaṃ bhavati || 8 || jagataḥ svājñānamiśritatve	jagat miśrībhūtam vyāptam bhavati jagataḥ sva ajñāna miśrita tve 
MBtrisikhibrahmanopanisatHK-193	jagadrūpeṇa bhānaṃ kim ityata āha- pratyagiti | jagataḥ	jagat rūpeṇa bhānam kim iti atas āha pratyak iti jagataḥ 
MBtrisikhibrahmanopanisatHK-194	svajñānavyāptatve'pi turīyaṃ mūrdhni saṃsthitam iti śrutyā	sva jñāna vyāpta tve api turīyam mūrdhni saṃsthitam iti śrutyā 
MBtrisikhibrahmanopanisatHK-195	svājñānāspṛṣṭamūrdhni sthāne paraṃpade pratyagānandarūpātmā	sva ajñāna a spṛṣṭa mūrdhni sthāne paraṃpade pratyagānanda rūpa ātmā 
MBtrisikhibrahmanopanisatHK-196	sthirāsano bhūtvā īśvarātmanā anantaśaktiyuktaḥ san jagadrūpeṇa bhāsate	sthira āsanaḥ bhūtvā īśvara ātmanā ananta śakti yuktaḥ san jagat rūpeṇa bhāsate 
MBtrisikhibrahmanopanisatHK-197	| yataḥ evam ataḥ jagadrūpeṇāpi bhānaṃ pratyagātmaniṣṭhaṃ na	yatas evam atas jagat rūpeṇa api bhānam pratyagātma niṣṭham na 
MBtrisikhibrahmanopanisatHK-198	svājñānatatkāryajaganniṣṭhamityarthaḥ || 9 ||	sva ajñāna tad kārya jagat niṣṭham iti arthaḥ 
MBtrisikhibrahmanopanisatHK-199	avasthācatuṣṭayam	          
MBtrisikhibrahmanopanisatHK-200	sarvatra vartate jāgrat svapnaṃ jāgrati vartate |	sarvatra vartate jāgrat svapnam jāgrati vartate 
MBtrisikhibrahmanopanisatHK-201	suṣuptaṃ ca turīyaṃ ca nānyāvasthāsu kutracit || 10 ||	suṣuptam ca turīyam ca na anya avasthāsu kutracid 
MBtrisikhibrahmanopanisatHK-202	p. 124) sarvadeśeṣvanusyūtaścatūrūpaḥ śivātmakaḥ |	sarva deśeṣu anusyūtaḥ catur rūpaḥ śiva ātmakaḥ 
MBtrisikhibrahmanopanisatHK-203	yathā mahāphale sarve rasāḥ sarvapravartakāḥ || 11 ||	yathā mahā phale sarve rasāḥ sarva pravartakāḥ 
MBtrisikhibrahmanopanisatHK-204	tathaivānnamaye kośe kośāstiṣṭhanti cāntare |	tathā eva anna maye kośe kośāḥ tiṣṭhanti ca antare 
MBtrisikhibrahmanopanisatHK-205	yathā kośastathā jīvo yathā jīvastathā śivaḥ || 12 ||	yathā kośaḥ tathā jīvaḥ yathā jīvaḥ tathā śivaḥ   
MBtrisikhibrahmanopanisatHK-206	savikārastathā jīvo nirvikārastathā śivaḥ |	sa vikāraḥ tathā jīvaḥ nirvikāraḥ tathā śivaḥ 
MBtrisikhibrahmanopanisatHK-207	kośāstasya vikārāste hyavasthāṣu pravartakāḥ || 13 ||	kośāḥ tasya vikārāḥ te hi avasthāṣu pravartakāḥ 
MBtrisikhibrahmanopanisatHK-208	yathā rasāśaye phenaṃ mathanādeva jāyate |	yathā rasa āśaye phenam mathanāt eva jāyate 
MBtrisikhibrahmanopanisatHK-209	manonirmathanādeva vikalpā bahavastathā || 14 ||	manaḥ nirmathanāt eva vikalpāḥ bahavaḥ tathā 
MBtrisikhibrahmanopanisatHK-210	jagatkalanānirvartyāvasthācatuṣṭayeyattāṃ	            
MBtrisikhibrahmanopanisatHK-211	tadbhāsakaciddhātusvarūpaṃ cāha- sarvatreti | sākṣibhāsyaprapañce	tad bhāsaka cit dhātu svarūpam ca āha sarvatra iti sākṣi bhāsya prapañce 
MBtrisikhibrahmanopanisatHK-212	sarvatra jāgradavasthā vartate, karaṇagrāmavyāpṛteḥ	sarvatra jāgrat avasthā vartate karaṇa grāma vyāpṛteḥ 
MBtrisikhibrahmanopanisatHK-213	sphuṭamavagantu śakyatvāt | annamayakośe prāṇādikośavat jāgrati	sphuṭam avagantu śakya tvāt anna maya kośe prāṇa ādi kośa vat jāgrati 
MBtrisikhibrahmanopanisatHK-214	svapnāditrayaṃ vartate, nānyāvasthāsvityarthaḥ || 10 ||	svapna ādi trayam vartate na anya avasthāsu iti arthaḥ 
MBtrisikhibrahmanopanisatHK-215	jāgradavasthāyāḥ svapnādyādhāratvaṃ	           
MBtrisikhibrahmanopanisatHK-216	svāropādhāreśvaraniṣṭhamityāha- sarveti |	svāra upādhāra īśvara niṣṭham iti āha sarva iti 
MBtrisikhibrahmanopanisatHK-217	viśvavirāḍotrādidvituryāvikalpāntarūpeṇa	viśva virāj otra ādi dvi turya avikalpa anta rūpeṇa 
MBtrisikhibrahmanopanisatHK-218	vyaṣṭisamaṣṭyātmakajāgradādisarvadeśeṣvanusyūtaḥ pratyagātmā sadā	vyaṣṭi samaṣṭi ātmaka jāgrat ādi sarva deśeṣu anusyūtaḥ pratyagātmā sadā 
MBtrisikhibrahmanopanisatHK-219	vartata ityarthaḥ | kathaṃ punaḥ pratīcaḥ sarvānusyūtatvam ityatra vikāravat	vartate iti arthaḥ katham punar pratīcaḥ sarva anusyūta tvam iti atra vikāra vat 
MBtrisikhibrahmanopanisatHK-220	kośajīvadṛṣṭāntena sarvānusyūtatvaṃ sādhayati- yatheti | yathā	kośa jīva dṛṣṭāntena sarva anusyūta tvam sādhayati yathā iti yathā 
MBtrisikhibrahmanopanisatHK-221	annamayakośaḥ sarvakośādhāro vyāpakaśca bhavati tathā jīvaḥ yathā	anna maya kośaḥ sarva kośa ādhāraḥ vyāpakaḥ ca bhavati tathā jīvaḥ yathā 
MBtrisikhibrahmanopanisatHK-222	kṛtsnakośavikāraṃ ātmātmīyābhimānapūrvakaṃ vyāpya vartate tathā	kṛtsna kośa vikāram ātma ātmīya abhimāna pūrvakam vyāpya vartate tathā 
MBtrisikhibrahmanopanisatHK-223	tadvikārāspṛṣṭaḥ san śivo'pi vartate | jīvaśivayoḥ savikāranirvikāratvaṃ	tad vikāra a spṛṣṭaḥ san śivaḥ api vartate jīva śivayoḥ sa vikāra nirvikāra tvam 
MBtrisikhibrahmanopanisatHK-224	kośābhimānabhāvābhāvaniṣṭham || 11-13 || ya(ka?)smāt	kośa abhimāna bhāva abhāva niṣṭham 
MBtrisikhibrahmanopanisatHK-225	avasthātrayataddhetupañcakośādivikalpaḥ saṃjāta ityatra-	avasthā traya tad hetu pañca kośa ādi vikalpaḥ saṃjātaḥ iti atra 
MBtrisikhibrahmanopanisatHK-226	mathanasaṃjātarasāśayaphenavat evaṃ manonirmathanāt jāgradādi vidyate	mathana saṃjāta rasa āśaya phena vat evam manaḥ nirmathanāt jāgrat ādi vidyate 
MBtrisikhibrahmanopanisatHK-227	iti | saṃkalpāt evamādibahavo vikalpāḥ jāyante, manaḥsaṃkalpābhāve	iti saṃkalpāt evamādi bahavaḥ vikalpāḥ jāyante manaḥ saṃkalpa abhāve 
MBtrisikhibrahmanopanisatHK-228	kimapi nāstītyarthaḥ || 14 ||	kim api na asti iti arthaḥ 
MBtrisikhibrahmanopanisatHK-229	"p. 125) 			dakṣiṇottarāyaṇagatiḥ"	dakṣiṇa uttarāyaṇa gatiḥ 
MBtrisikhibrahmanopanisatHK-230	karmaṇā vartate karmī tattyāgāchāntimāpnuyāt |	karmaṇā vartate karmī tad tyāgāt śāntim āpnuyāt 
MBtrisikhibrahmanopanisatHK-231	anaye dakṣiṇe prāpte prapañcābhimukhaṃ gataḥ || 15 ||	anaye dakṣiṇe prāpte prapañca abhimukham gataḥ  /
MBtrisikhibrahmanopanisatHK-232	ahaṃkārābhimānena jīvaḥ syāddhi sadāśivaḥ |	ahaṃkāra abhimānena jīvaḥ syāt hi sadāśivaḥ 
MBtrisikhibrahmanopanisatHK-233	sa cāvivekaprakṛtisaṃgatyā tatra muhyate || 16 ||	sa ca aviveka prakṛti saṃgatyā tatra muhyate 
MBtrisikhibrahmanopanisatHK-234	nānāyoniśataṃ gatvā śete'sau vāsanāvaśāt |	nānā yoni śatam gatvā śeta asau vāsanā vaśāt 
MBtrisikhibrahmanopanisatHK-235	vimokṣāt saṃcaratyeva matsyaḥ kūladvayaṃ yathā || 17 ||	vimokṣāt saṃcarati eva matsyaḥ kūla dvayam yathā 
MBtrisikhibrahmanopanisatHK-236	tataḥ kālavaśādeva hyātmajñānavivekataḥ |	tatas kāla vaśāt eva hi ātma jñāna vivekataḥ 
MBtrisikhibrahmanopanisatHK-237	uttarābhimukho bhūtvā sthānāt sthānāntaraṃ kramāt || 18 ||	uttara abhimukhaḥ bhūtvā sthānāt sthāna antaram kramāt 
MBtrisikhibrahmanopanisatHK-238	mūrdhnyādhāyātmanaḥ prāṇān yogābhyāsaṃ sthitaścaran |	mūrdhni ādhāya ātmanaḥ prāṇān yoga abhyāsam sthitaḥ caran 
MBtrisikhibrahmanopanisatHK-239	evaṃ saṃkalpasaṃjātanānāvidhakarmaṇā karmī jīvo	evam saṃkalpa saṃjāta nānāvidha karmaṇā karmī jīvaḥ 
MBtrisikhibrahmanopanisatHK-240	manaḥkalpitasaṃsārapāśena niruchvāsaṃ baddhaḥ san vartate | yāvat	manaḥ kalpita saṃsāra pāśena niruchvāsam baddhaḥ san vartate yāvat 
MBtrisikhibrahmanopanisatHK-241	svajñānena svabhāvāpattiḥ tāvat saṃsarati | yadāyaṃ svajñānena	sva jñānena svabhāva āpattiḥ tāvat saṃsarati yadā ayam sva jñānena 
MBtrisikhibrahmanopanisatHK-242	svajñānatatkāryaṃ tyajati tadā svātiriktavibhramaśāntimāpnuyāt | śivasya	                                                                                   
MBtrisikhibrahmanopanisatHK-243	jīvatvaṃ jīvasya śivatvaṃ kathaṃ bhavatītyāśaṅkya anātmani	jīva tvam jīvasya śiva tvam katham bhavati iti āśaṅkya anātmani 
MBtrisikhibrahmanopanisatHK-244	ātmābhimānāt śivasya jīvatvaṃ tadabhimatityāgāt jīvasya śivatvaṃ ca	ātma abhimānāt śivasya jīva tvam tad abhimati tyāgāt jīvasya śiva tvam ca 
MBtrisikhibrahmanopanisatHK-245	syādityāha- ayana iti |	syāt iti āha ayane iti 
MBtrisikhibrahmanopanisatHK-246	jñānagandhavikalakāmasaṃkalpādighaṭiteṣṭāpūrtādikarmaṇā ayane	jñāna gandha vikala kāma saṃkalpa ādi ghaṭita iṣṭāpūrta ādi karmaṇā ayane 
MBtrisikhibrahmanopanisatHK-247	dakṣiṇe prāpte || 15-17 || kadā jīvaḥ śivo bhavati? svabhāvāptau	dakṣiṇe prāpte    kadā jīvaḥ śivaḥ bhavati svabhāva āptau 
MBtrisikhibrahmanopanisatHK-248	kiṃ sādhanam ? ityata āha- tata iti | tato niṣkāmabuddhyā	kim sādhanam iti atas āha tatas iti tatas niṣkāma buddhyā 
MBtrisikhibrahmanopanisatHK-249	anuṣṭhitasatkarmaphalasamarpaṇeśvaraprasādāt uttarābhimukho bhūtvā	anuṣṭhita sat karma phala samarpaṇa īśvara prasādāt uttara abhimukhaḥ bhūtvā 
MBtrisikhibrahmanopanisatHK-250	te'rciṣamabhisaṃbhavanti ityādisthānāt sthānāntaraṃ prāpya	tāḥ ṛciṣam abhisaṃbhavanti ityādi sthānāt sthāna antaram prāpya 
MBtrisikhibrahmanopanisatHK-251	śabalabrahmapadaṃ kramāt prāpnotītyarthaḥ || 18 || kiṃ kurvan	śabalabrahma padam kramāt prāpnoti iti arthaḥ    kim kurvan 
MBtrisikhibrahmanopanisatHK-252	uttarābhimukho bhavati ityata āha-	uttara abhimukhaḥ bhavati iti atas āha 
MBtrisikhibrahmanopanisatHK-253	p. 126) mūrdhnīti | siddhādyāsanastho yogī svātmanaḥ prāṇān	mūrdhni iti siddha ādi āsana sthaḥ yogī sva ātmanaḥ prāṇān 
MBtrisikhibrahmanopanisatHK-254	suṣumnādvāreṇa mūrdhni ādhāya sadā eva yogābhyāsaṃ caran	suṣumnā dvāreṇa mūrdhni ādhāya sadā eva yoga abhyāsam caran 
MBtrisikhibrahmanopanisatHK-255	yathoktakāle mūrdhānaṃ bhittvā devayānena pathā brahmalokametya na	yathā ukta kāle mūrdhānam bhittvā deva yānena pathā brahma lokam etya na 
MBtrisikhibrahmanopanisatHK-256	punarāvartata ityarthaḥ ||	punar āvartate iti arthaḥ 
MBtrisikhibrahmanopanisatHK-257	sadyomuktiprāpakaṃ jñānam	          
MBtrisikhibrahmanopanisatHK-258	yogāt saṃjāyate jñānaṃ jñānādyogaḥ pravartate || 19 ||	yogāt saṃjāyate jñānam jñānāt yogaḥ pravartate 
MBtrisikhibrahmanopanisatHK-259	yogajñānaparo nityaṃ sa yogī na praṇaśyati |	yoga jñāna paraḥ nityam sa yogī na praṇaśyati 
MBtrisikhibrahmanopanisatHK-260	vikārasthaṃ śivaṃ paśyedvikāraśca śive na tu || 20 ||	vikāra stham śivam paśyet vikāraḥ ca śive na tu 
MBtrisikhibrahmanopanisatHK-261	yogaprakāśakaṃ yogairdhyāyeccānanyabhāvanaḥ |	yoga prakāśakam yogaiḥ dhyāyet ca ananya bhāvanaḥ 
MBtrisikhibrahmanopanisatHK-262	kevalakarmānuṣṭhānaphalaṃ cāndrapadaṃ,	kevala karma anuṣṭhāna phalam cāndra padam 
MBtrisikhibrahmanopanisatHK-263	karmajñānasamuccayānuṣṭhānaphalaṃ tu brahmalokāvāptiḥ ityuktvā	                                      
MBtrisikhibrahmanopanisatHK-264	sadyaḥkaivalyaprāpakanirviśeṣajñānaṃ sopāyamāha- yogāditi |	sadyas kaivalya prāpaka nirviśeṣa jñānam sa upāyam āha yogāt iti 
MBtrisikhibrahmanopanisatHK-265	svāśramācārasakṛtanityādisādhanacatuṣṭayavadanuṣṭhitasarvavedānta##	                                                                                          
MBtrisikhibrahmanopanisatHK-266	-##śravaṇayogāt nirviśeṣajñānaṃ saṃjāyate |	śravaṇa yogāt nirviśeṣa jñānam saṃjāyate 
MBtrisikhibrahmanopanisatHK-267	yathoktamananābhivardhitajñānāt yogo nididhyāso brahmātiriktaṃ na	yathā ukta manana abhivardhita jñānāt yogaḥ nididhyāsaḥ brahma atiriktam na 
MBtrisikhibrahmanopanisatHK-268	kiṃcidastīti samyagjñānaṃ pravartate prādurbhavati || 19 || nityamevaṃ	kiṃcid asti iti samyak jñānam pravartate prādurbhavati nityam evam 
MBtrisikhibrahmanopanisatHK-269	yogajñānaparo yogī tvājñavat svātiriktāstitvadhiyā na kadāpi praṇaśyati	yoga jñāna paraḥ yogī tu ājña vat sva atirikta astitva dhiyā na kadāpi praṇaśyati 
MBtrisikhibrahmanopanisatHK-270	samyagjñānasamakālaṃ	samyak jñāna sama kālam 
MBtrisikhibrahmanopanisatHK-271	sarvāpahnavasiddhaniṣpratiyogikabrahmamātrabhāvāpanno bhavatītyarthaḥ |	sarva apahnava siddha niṣpratiyogika brahma mātra bhāva āpannaḥ bhavati iti arthaḥ 
MBtrisikhibrahmanopanisatHK-272	samyagjñānopāyastu- sarvaṃ khalvidaṃ brahma iti śrutyanurodhena	samyak jñāna upāyaḥ tu sarvam khalu idam brahma iti śruti anurodhena 
MBtrisikhibrahmanopanisatHK-273	svājñadṛṣṭiprasaktasarvavikārasthaṃ śivaṃ paśyet | evaṃ sarvaṃ	sva ajña dṛṣṭi prasakta sarva vikāra stham śivam paśyet evam sarvam 
MBtrisikhibrahmanopanisatHK-274	brahmeti bodhe siddhe sarvavikārajātaṃ śive na kiṃcidastīti vijñānaṃ	brahma iti bodhe siddhe sarva vikāra jātam śive na kiṃcid asti iti vijñānam 
MBtrisikhibrahmanopanisatHK-275	jāyate || 20 || tato vijñānayogī sarvavikārāsaṃbhavasiddhaṃ brahma	jāyate                    
MBtrisikhibrahmanopanisatHK-276	niṣpratiyogikasvamātram iti ananyabhāvanaḥ samyagjñānī bhūtvā	niṣpratiyogika sva mātram iti ananya bhāvanaḥ samyak jñānī bhūtvā 
MBtrisikhibrahmanopanisatHK-277	paroditaśravaṇādiyogaiḥ saṃjātasamyagjñānayogaprakāśakam ātmānaṃ	para udita śravaṇa ādi yogaiḥ saṃjāta samyak jñāna yoga prakāśakam ātmānam 
MBtrisikhibrahmanopanisatHK-278	brahmamātraṃ dhyāyet | evaṃ dhyānātmakasamyagjñānasamakālaṃ	brahma mātram dhyāyet evam dhyāna ātmaka samyak jñāna sama kālam 
MBtrisikhibrahmanopanisatHK-279	kṛtakṛtyo bhavatītyarthaḥ ||	kṛtakṛtyaḥ bhavati iti arthaḥ 
MBtrisikhibrahmanopanisatHK-280	"p. 127) 			jñānopāyabhūto yogaḥ"	         
MBtrisikhibrahmanopanisatHK-281	yogajñāne na vidyete tasya bhāvo na sidhyati || 21 ||	yoga jñāne na vidyete tasya bhāvaḥ na sidhyati 
MBtrisikhibrahmanopanisatHK-282	tasmādabhyāsayogena manaḥ prāṇān nirodhayet |	tasmāt abhyāsa yogena manaḥ prāṇān nirodhayet 
MBtrisikhibrahmanopanisatHK-283	yogī niśitadhāreṇa kṣureṇaiva nikṛntayet || 22 ||	yogī niśita dhāreṇa kṣureṇa eva nikṛntayet  /
MBtrisikhibrahmanopanisatHK-284	śikhā prāṇamayī vṛttiryamādyaṣṭāṅgasādhanaiḥ |	śikhā prāṇa mayī vṛttiḥ yama ādi aṣṭa aṅga sādhanaiḥ 
MBtrisikhibrahmanopanisatHK-285	yadi śravaṇādhikārī na bhavati tasya svapne'pi yogajñāne na	yadi śravaṇa adhikārī na bhavati tasya svapne pi yoga jñāne na 
MBtrisikhibrahmanopanisatHK-286	vidyete, samyagjñānabhāvo'pi na sidhyati || 21 || yasmāt evaṃ tasmāt |	vidyete samyak jñāna bhāvaḥ api na sidhyati    yasmāt evam tasmāt 
MBtrisikhibrahmanopanisatHK-287	evam abhyāsayogataḥ brahmāptipratibandhakājñānaṃ yogī niśitadhāreṇa	evam abhyāsa yogataḥ brahma āpti pratibandhaka ajñānam yogī niśita dhāreṇa 
MBtrisikhibrahmanopanisatHK-288	abhyāsayogakṣureṇaiva nikṛntayediti || 22 || evam abhyāsayogaḥ	abhyāsa yoga kṣureṇa eva nikṛntayet iti          
MBtrisikhibrahmanopanisatHK-289	kenopāyena jāyate ityata āha- śikheti |	kena upāyena jāyate iti atas āha śikhā iti 
MBtrisikhibrahmanopanisatHK-290	vakṣyamāṇayamādyaṣṭāṅgayogasādhanaiḥ prāṇamayī vṛttiḥ	vakṣyamāṇa yama ādi aṣṭa aṅga yoga sādhanaiḥ prāṇa mayī vṛttiḥ 
MBtrisikhibrahmanopanisatHK-291	yogaśikhā abhyāsayogaphalaprāpikā saṃjāyata ityarthaḥ ||	                 
MBtrisikhibrahmanopanisatHK-292	karmajñānayogau	karma jñāna yogau 
MBtrisikhibrahmanopanisatHK-293	jñānayogaḥ karmayoga iti yogo dvidhā mataḥ || 23 ||	jñāna yogaḥ karma yogaḥ iti yogaḥ dvidhā mataḥ 
MBtrisikhibrahmanopanisatHK-294	kriyāyogamathedānīṃ śṛṇu brāhmaṇasattama |	kriyā yogam atha idānīm śṛṇu brāhmaṇa sattama 
MBtrisikhibrahmanopanisatHK-295	avyākulasya cittasya bandhanaṃ viṣaye kvacit || 24 ||	a vyākulasya cittasya bandhanam viṣaye kvacid 
MBtrisikhibrahmanopanisatHK-296	yatsaṃyogo dvijaśreṣṭha sa ca dvaividhyamaśnute |	yad saṃyogaḥ dvijaśreṣṭha sa ca dvaividhyam aśnute 
MBtrisikhibrahmanopanisatHK-297	karma kartavyamityeva vihiteṣveva karmasu || 25 ||	karma kartavyam iti eva vihiteṣu eva karmasu 
MBtrisikhibrahmanopanisatHK-298	bandhanaṃ manaso nityaṃ karmayogaḥ sa ucyate |	bandhanam manasaḥ nityam karma yogaḥ saḥ ucyate 
MBtrisikhibrahmanopanisatHK-299	yattu cittasya satatamarthe śreyasi bandhanam || 26 ||	yat tu cittasya satatam arthe śreyasi bandhanam 
MBtrisikhibrahmanopanisatHK-300	p. 128) jñānayogaḥ sa vijñeyaḥ sarvasiddhikaraḥ śivaḥ |	jñāna yogaḥ sa vijñeyaḥ sarva siddhi karaḥ śivaḥ 
MBtrisikhibrahmanopanisatHK-301	yasyoktalakṣaṇe yoge dvividhe'pyavyayaṃ manaḥ || 27 ||	yasya ukta lakṣaṇe yoge dvividhe api avyayam manaḥ 
MBtrisikhibrahmanopanisatHK-302	sa yāti paramaṃ śreyo mokṣalakṣaṇamañjasā |	sa yāti paramam śreyaḥ mokṣa lakṣaṇam añjasā 
MBtrisikhibrahmanopanisatHK-303	jñānakarmabhedena yogadvaividhyaṃ tadiyattāmāha- jñāneti ||	jñāna karma bhedena yoga dvaividhyam tad iyat tām āha jñāna iti 
MBtrisikhibrahmanopanisatHK-304	23 || tatra kriyāyogam ityādi | kiṃ tat ? avyākulasya ityādi || 24 ||	            
MBtrisikhibrahmanopanisatHK-305	kriyāyogasya kathaṃ dvaividhyam ityatra karma kartavyam ityādi |	kriyā yogasya katham dvaividhyam iti atra karma kartavyam ityādi 
MBtrisikhibrahmanopanisatHK-306	īśvarārādhanadhiyā niṣkāmakarmānuṣṭhānābhiniveśa eva karmayoga	īśvara ārādhana dhiyā niṣkāma karma anuṣṭhāna abhiniveśaḥ eva karmayoga 
MBtrisikhibrahmanopanisatHK-307	ityarthaḥ || 25 || śreyomārgābhiniveśa eva jñānayoga ityāha- yattviti ||	iti arthaḥ     śreyaḥ mārga abhiniveśaḥ eva jñāna yogaḥ iti āha yat tu iti 
MBtrisikhibrahmanopanisatHK-308	26 || evaṃ upāyopeyadvividhayogānuṣṭhānataḥ śreyo bhavatītyāha-	evam upāya upeya dvividha yoga anuṣṭhānāt śreyaḥ bhavati iti āha 
MBtrisikhibrahmanopanisatHK-309	yasyeti || 27 ||	yasya iti 
MBtrisikhibrahmanopanisatHK-310	nirviśeṣabrahmajñānopāyaḥ aṣṭāṅgayogaḥ	             
MBtrisikhibrahmanopanisatHK-311	dehendriyeṣu vairāgyaṃ yama ityucyate budhaiḥ || 28 ||	deha indriyeṣu vairāgyam yamaḥ iti ucyate budhaiḥ 
MBtrisikhibrahmanopanisatHK-312	anuraktiḥ pare tattve satataṃ niyamaḥ smṛtaḥ |	anuraktiḥ pare tattve satatam niyamaḥ smṛtaḥ 
MBtrisikhibrahmanopanisatHK-313	sarvavastunyudāsīnabhāva āsanamuttamam || 29 ||	sarva vastuni udāsīna bhāvaḥ āsanam uttamam 
MBtrisikhibrahmanopanisatHK-314	jagat sarvamidaṃ mithyāpratītiḥ prāṇasaṃyamaḥ |	jagat sarvam idam mithyā pratītiḥ prāṇa saṃyamaḥ 
MBtrisikhibrahmanopanisatHK-315	cittasyāntarmukhībhāvaḥ pratyāhārastu sattama || 30 ||	cittasya antar mukhībhāvaḥ pratyāhāraḥ tu sattama 
MBtrisikhibrahmanopanisatHK-316	cittasya niścalībhāvo dhāraṇā dhāraṇaṃ viduḥ |	cittasya niścalībhāvaḥ dhāraṇā dhāraṇam viduḥ 
MBtrisikhibrahmanopanisatHK-317	so'haṃ cinmātrameveti cintanaṃ dhyānamucyate || 31 ||	saḥ uham cit mātram eva iti cintanam dhyānam ucyate 
MBtrisikhibrahmanopanisatHK-318	dhyānasya vismṛtiḥ samyak samādhirabhidhīyate |	dhyānasya vismṛtiḥ samyak samādhiḥ abhidhīyate 
MBtrisikhibrahmanopanisatHK-319	pūrvoktanirviśeṣabrahmajñānopāyatayā	                     
MBtrisikhibrahmanopanisatHK-320	saṃkṣepavistarābhyāmaṣṭāṅgayogam upadiśati- deheti || 28-31 ||	saṃkṣepa vistarābhyām aṣṭāṅga yogam upadiśati deha iti 
MBtrisikhibrahmanopanisatHK-321	"p. 129) 			daśavidhayamaniyamāḥ"	daśavidha yama niyamāḥ 
MBtrisikhibrahmanopanisatHK-322	ahiṃsā satyamasteyaṃ brahmacaryaṃ dayārjavam || 32 ||	ahiṃsā satyam asteyam brahmacaryam dayā ārjavam 
MBtrisikhibrahmanopanisatHK-323	kṣamā dhṛtirmitāhāraḥ śaucaṃ ceti yamā daśa |	kṣamā dhṛtiḥ mita āhāraḥ śaucam ca iti yamāḥ daśa 
MBtrisikhibrahmanopanisatHK-324	tapaḥ saṃtuṣṭirāstikyaṃ dānamārādhanaṃ hareḥ || 33 ||	tapaḥ saṃtuṣṭiḥ āstikyam dānam ārādhanam hareḥ 
MBtrisikhibrahmanopanisatHK-325	vedāntaśravaṇaṃ caiva hrīrmatiśca japo vratam |	vedānta śravaṇam ca eva hrīḥ matiḥ ca japaḥ vratam 
MBtrisikhibrahmanopanisatHK-326	iti |	iti 
MBtrisikhibrahmanopanisatHK-327	uttamādhikāriṇāṃ brahmajñānasādhanatayā aṣṭāṅgayogo	uttama adhikāriṇām brahma jñāna sādhana tayā aṣṭāṅga yogaḥ 
MBtrisikhibrahmanopanisatHK-328	nirūpitaḥ | tatra yamo daśadhā bhidyate ityāha- ahiṃseti || 32 || tathā	nirūpitaḥ tatra yamaḥ daśadhā bhidyate iti āha ahiṃsā iti    tathā 
MBtrisikhibrahmanopanisatHK-329	niyamo'pītyāha- tapa iti || 33 ||	niyamaḥ api iti āha tapaḥ iti 
MBtrisikhibrahmanopanisatHK-330	haṭhayogarītyāha āsanāni	haṭha yoga rītyā āha āsanāni 
MBtrisikhibrahmanopanisatHK-331	āsanāni tadaṅgāni svatikādīni vai dvija || 34 ||	āsanāni tad aṅgāni svatika ādīni vai dvija 
MBtrisikhibrahmanopanisatHK-332	varṇyate svastikaṃ pādatalayorubhayorapi |	varṇyate svastikam pāda talayoḥ ubhayoḥ api 
MBtrisikhibrahmanopanisatHK-333	pūrvottare jānunī dve kṛtvāsanamudīritam || 35 ||	pūrva uttare jānunī dve kṛtvā āsanam udīritam 
MBtrisikhibrahmanopanisatHK-334	savye dakṣiṇagulphaṃ tu pṛṣṭhapārśve niyojayet |	savye dakṣiṇa gulpham tu pṛṣṭha pārśve niyojayet 
MBtrisikhibrahmanopanisatHK-335	dakṣiṇe'pi tathā savyaṃ gomukhaṃ gomukhaṃ yathā || 36 ||	dakṣiṇe api tathā savyam gomukham gomukham yathā 
MBtrisikhibrahmanopanisatHK-336	ekaṃ caraṇamanyasminnūrāvāropya niścalaḥ |	ekam caraṇam anyasmin ūrau āropya niścalaḥ 
MBtrisikhibrahmanopanisatHK-337	āste yadidamenoghnaṃ vīrāsanamudīritam || 37 ||	āste yat idam enaḥ ghnam vīrāsanam udīritam 
MBtrisikhibrahmanopanisatHK-338	gudaṃ niyamya gulphābhyāṃ vyutkrameṇa samāhitaḥ |	gudam niyamya gulphābhyām vyutkrameṇa samāhitaḥ 
MBtrisikhibrahmanopanisatHK-339	yogāsanaṃ bhavedetaditi yogavido viduḥ || 38 ||	yoga āsanam bhavet etat iti yoga vidaḥ viduḥ 
MBtrisikhibrahmanopanisatHK-340	p. 130) ūrvorupari vai dhatte yadā pādatale nume |	ūrvoḥ upari vai dhatte yadā pāda tale 
MBtrisikhibrahmanopanisatHK-341	padmāsanaṃ bhavedetat sarvavyādhiviṣāpaham || 39 ||	padmāsanam bhavet etat sarva vyādhi viṣa apaham 
MBtrisikhibrahmanopanisatHK-342	padmāsanaṃ susaṃsthāpya tadaṅguṣṭhadvayaṃ punaḥ |	padmāsanam su saṃsthāpya tad aṅguṣṭha dvayam punar 
MBtrisikhibrahmanopanisatHK-343	vyutkrameṇaiva hastābhyāṃ baddhapadmāsanaṃ bhavet || 40 ||	vyutkrameṇa eva hastābhyām baddha padmāsanam bhavet 
MBtrisikhibrahmanopanisatHK-344	padmāsanaṃ susaṃsthāpya nānūrvorantare karau |	padmāsanam su saṃsthāpya na an ūrvoḥ antare karau 
MBtrisikhibrahmanopanisatHK-345	niveśya bhūmāvātiṣṭhedvyomasthaḥ kukkuṭāsanaḥ || 41 ||	niveśya bhūmau ātiṣṭhet vyoma sthaḥ kukkuṭāsanaḥ 
MBtrisikhibrahmanopanisatHK-346	kukkuṭāsanabandhastho dorbhyāṃ saṃbadhya kaṃdharam |	kukkuṭāsana bandha sthaḥ dorbhyām saṃbadhya kaṃdharam 
MBtrisikhibrahmanopanisatHK-347	śete kūrmavaduttāna etaduttānakūrmakam || 42 ||	śete kūrma vat uttānaḥ etat uttānakūrmakam  /
MBtrisikhibrahmanopanisatHK-348	pādāṅguṣṭhau tu pāṇibhyāṃ gṛhītvā śravaṇāvadhi |	pādāṅguṣṭhau tu pāṇibhyām gṛhītvā śravaṇa avadhi 
MBtrisikhibrahmanopanisatHK-349	dhanurākarṣakākṛṣṭaṃ dhanurāsanamīritam || 43 ||	dhanuḥ ākarṣaka ākṛṣṭam dhanurāsanam īritam 
MBtrisikhibrahmanopanisatHK-350	sīvanīṃ gulphadeśebhyo nipīḍya vyutkrameṇa tu |	sīvanīm gulpha deśebhyaḥ nipīḍya vyutkrameṇa tu 
MBtrisikhibrahmanopanisatHK-351	prasārya jānunorhastāvāsanaṃ siṃharūpakam || 44 ||	prasārya jānunoḥ hastau āsanam siṃha rūpakam 
MBtrisikhibrahmanopanisatHK-352	gulphau ca vṛṣaṇasyādhaḥ sīvinyubhayapārśvayoḥ |	gulphau ca vṛṣaṇasya adhas sīvinī ubhaya pārśvayoḥ 
MBtrisikhibrahmanopanisatHK-353	niveśya bhūmau hastābhyāṃ baddhvā bhadrāsanaṃ bhavet || 45 ||	niveśya bhūmau hastābhyām baddhvā bhadrāsanam bhavet 
MBtrisikhibrahmanopanisatHK-354	sīvanīpārśvamubhayaṃ gulphābhyāṃ vyutkrameṇa tu |	sīvanī pārśvam ubhayam gulphābhyām vyutkrameṇa tu 
MBtrisikhibrahmanopanisatHK-355	nipīḍyāsanametacca muktāsanamudīritam || 46 ||	nipīḍya āsanam etat ca muktāsanam udīritam 
MBtrisikhibrahmanopanisatHK-356	p. 131) avaṣṭabhya dharāṃ samyak talābhyāṃ hastayordvayoḥ |	avaṣṭabhya dharām samyak talābhyām hastayoḥ dvayoḥ 
MBtrisikhibrahmanopanisatHK-357	kūrparau nābhipārśve tu sthāpayitvā mayūravat || 47 ||	kūrparau nābhi pārśve tu sthāpayitvā mayūra vat 
MBtrisikhibrahmanopanisatHK-358	samunnataśiraḥpādo mayūrāsanamiṣyate |	samunnata śiraḥ pādaḥ mayūrāsanam iṣyate 
MBtrisikhibrahmanopanisatHK-359	vāmorumūle dakṣāṅghriṃ jānvorveṣṭitapāṇinā || 48 ||	vāma ūru mūle dakṣa aṅghrim jānvoḥ veṣṭita pāṇinā 
MBtrisikhibrahmanopanisatHK-360	vāmena vāmāṅguṣṭhaṃ tu gṛhītaṃ matsyapīṭhakam |	vāmena vāma aṅguṣṭham tu gṛhītam matsya pīṭhakam 
MBtrisikhibrahmanopanisatHK-361	yoni vāmena saṃpīḍya meḍhrādupari dakṣiṇam || 49 ||	yoni vāmena saṃpīḍya meḍhrāt upari dakṣiṇam 
MBtrisikhibrahmanopanisatHK-362	ṛjukāyaḥ samāsīnaḥ siddhāsanamudīritam |	ṛju kāyaḥ samāsīnaḥ siddhāsanam udīritam 
MBtrisikhibrahmanopanisatHK-363	prasārya bhuvi pādau tu dorbhyāmaṅguṣṭhamādarāt || 50 ||	prasārya bhuvi pādau tu dorbhyām aṅguṣṭham ādarāt   
MBtrisikhibrahmanopanisatHK-364	jānūpari lalāṭaṃ tu paścimaṃ tāṇamucyate |	jānu upari lalāṭam tu paścimam tāṇam ucyate 
MBtrisikhibrahmanopanisatHK-365	yena kena prakāreṇa sukhaṃ dhāryaṃ ca jāyate || 51 ||	yena kena prakāreṇa sukham dhāryam ca jāyate 
MBtrisikhibrahmanopanisatHK-366	tat sukhāsanamityuktamaśaktastat samācaret |	tat sukha āsanam iti uktam aśaktaḥ tat samācaret 
MBtrisikhibrahmanopanisatHK-367	āsanaṃ vijitaṃ yena jitaṃ tena jagattrayam || 52 ||	āsanam vijitam yena jitam tena jagattrayam 
MBtrisikhibrahmanopanisatHK-368	atha madhyamādhikāriṇāṃ haṭhayogarītyā āsanādyaṅgāni	atha madhyama adhikāriṇām haṭhayoga rītyā āsana ādi aṅgāni 
MBtrisikhibrahmanopanisatHK-369	upadiśati- āsanānīti || 34 || tatra svastikāsanalakṣaṇamāha- varṇyata	upadiśati āsanāni iti  tatra svastika āsana lakṣaṇam āha varṇyata 
MBtrisikhibrahmanopanisatHK-370	iti || 35 || gomukhāsanalakṣaṇamucyate- savya iti || 36 ||	iti gomukha āsana lakṣaṇam ucyate savyaḥ iti 
MBtrisikhibrahmanopanisatHK-371	vīrāsanalakṣaṇamācaṣṭe- ekamiti || 37 || yogāsanalakṣaṇaṃ vyanakti##-	vīrāsana lakṣaṇam ācaṣṭe ekam iti yoga āsana lakṣaṇam vyanakti 
MBtrisikhibrahmanopanisatHK-372	baddhapadmāsanalakṣaṇaṃ viśadayati- padmāsanamiti | hastābhyāṃ	baddha padmāsana lakṣaṇam viśadayati padmāsanam iti hastābhyām 
MBtrisikhibrahmanopanisatHK-373	baddhveti yat tat baddhapadmāsanaṃ bhavet || 40 || kukkuṭāsanaprakāraṃ	baddhvā iti yat tat baddha padmāsanam bhavet kukkuṭāsana prakāram 
MBtrisikhibrahmanopanisatHK-374	vyaktīkaroti- padmeti || 41 || uttānakūrmalakṣaṇamāha- kukkuṭeti ||	vyaktīkaroti padma iti    uttānakūrma lakṣaṇam āha kukkuṭa iti 
MBtrisikhibrahmanopanisatHK-375	42 || anurāsanamāha-	anurāsanam āha 
MBtrisikhibrahmanopanisatHK-376	p. 132) pādeti || 43 || siṃhāsanaṃ darśayati- sīvinīmiti || 44 ||	pāda iti    siṃhāsanam darśayati sīvinīm iti 
MBtrisikhibrahmanopanisatHK-377	bhadrāsanalakṣaṇamāha- gulphāviti || 45 || muktāsanasvarūpamāha-	bhadrāsana lakṣaṇam āha gulphau iti     muktāsana svarūpam āha 
MBtrisikhibrahmanopanisatHK-378	sīvinīti || 46 || mayūrāsanaprakāramāha- avaṣṭabhyeti || 47 ||	sīvinī iti    mayūrāsana prakāram āha avaṣṭabhya iti 
MBtrisikhibrahmanopanisatHK-379	matsyāsanalakṣaṇamācaṣṭe- vāmeti || 48 || siddhāsanalakṣaṇamāha##-	matsyāsana lakṣaṇam ācaṣṭe vāmā iti siddhāsana lakṣaṇam āha 
MBtrisikhibrahmanopanisatHK-380	aśaktopayogyāsanamāha- yeneti || 51 || āsanaphalamāha- āsanamiti ||	aśakta upayogi āsanam āha yena iti  āsana phalam āha āsanam iti 
MBtrisikhibrahmanopanisatHK-381	nāḍīśuddhipūrvakaprāṇāyāmavidhiḥ	            
MBtrisikhibrahmanopanisatHK-382	yamaiśca niyamaiścaiva hyāsanaiśca susaṃyataḥ |	yamaiḥ ca niyamaiḥ ca eva hi āsanaiḥ ca su saṃyataḥ 
MBtrisikhibrahmanopanisatHK-383	nāḍīśuddhiṃ ca kṛtvādau prāṇāyāmaṃ samācaret || 53 ||	nāḍī śuddhim ca kṛtvā ādau prāṇāyāmam samācaret 
MBtrisikhibrahmanopanisatHK-384	dehamānaṃ svāṅgulibhiḥ ṣaṇṇavatyaṅgulāyatam |	deha mānam sva aṅgulibhiḥ ṣaṇṇavati aṅgula āyatam 
MBtrisikhibrahmanopanisatHK-385	prāṇaḥ śarīrādadhiko dvādaśāṅgulamānataḥ || 54 ||	prāṇaḥ śarīrāt adhikaḥ dvādaśa aṅgula mānataḥ  /
MBtrisikhibrahmanopanisatHK-386	dehasthamanilaṃ dehasamudbhūtena vahninā |	deha stham anilam deha samudbhūtena vahninā 
MBtrisikhibrahmanopanisatHK-387	nyūnaṃ samaṃ vā yogena kurvan brahmavidiṣyate || 55 ||	nyūnam samam vā yogena kurvan brahma vid iṣyate 
MBtrisikhibrahmanopanisatHK-388	yamādyaṅgatrayaviśiṣṭayoginonāḍīśuddhipūrvakaṃ	yama ādi aṅga traya viśiṣṭa yoginaḥ nāḍī śuddhi pūrvakam 
MBtrisikhibrahmanopanisatHK-389	prāṇāyāmakramamāha- yamaiśceti | pūrvoktaiḥ || 53 ||	prāṇāyāma kramam āha yamaiḥ ca iti pūrva uktaiḥ 
MBtrisikhibrahmanopanisatHK-390	abhyāsānukūladehaprāṇamānaṃ tatra prāṇābhyāsaphalaṃ cāha-	abhyāsa anukūla deha prāṇa mānam tatra prāṇa abhyāsa phalam ca āha 
MBtrisikhibrahmanopanisatHK-391	dehamānamiti || 54-55 ||	deha mānam iti 
MBtrisikhibrahmanopanisatHK-392	agnimaṇḍalasvarūpam	agni maṇḍala svarūpam 
MBtrisikhibrahmanopanisatHK-393	dehamadhye śikhisthānaṃ taptajāmbūnadaprabham |	deha madhye śikhi sthānam tapta jāmbūnada prabham 
MBtrisikhibrahmanopanisatHK-394	trikoṇaṃ dvipadāmanyaccaturaśraṃ catuṣpadām || 56 ||	tri koṇam dvipadām anyat caturaśram catuṣpadām 
MBtrisikhibrahmanopanisatHK-395	vṛttaṃ vihaṅgamānāṃ tu ṣaḍaśraṃ sarpajanmanām |	vṛttam vihaṅgamānām tu sarpa janmanām 
MBtrisikhibrahmanopanisatHK-396	aṣṭāśraṃ svedajānāṃ tu tasmin dīpavadujjvalam || 57 ||	sveda jānām tu tasmin dīpa vat ujjvalam 
MBtrisikhibrahmanopanisatHK-397	p. 133) mūlāgnimaṇḍalasvarūpamāha- deheti || 56 ||	            
MBtrisikhibrahmanopanisatHK-398	tattajjantvagnimaṇḍale tasmin ujjvalaṃ vahniṃ viddhītyarthaḥ || 57 ||	tad tad jantu agni maṇḍale tasmin ujjvalam vahnim viddhi iti arthaḥ 
MBtrisikhibrahmanopanisatHK-399	nābhisthānam	nābhi sthānam 
MBtrisikhibrahmanopanisatHK-400	kandasthānaṃ manuṣyāṇāṃ dehamadhyaṃ navāṅgulam |	kanda sthānam manuṣyāṇām deha madhyam nava aṅgulam 
MBtrisikhibrahmanopanisatHK-401	caturaṅgulamutsedhaṃ caturaṅgulamāyatam || 58 ||	catur aṅgulam utsedham catur aṅgulam āyatam 
MBtrisikhibrahmanopanisatHK-402	aṇḍākṛti tiraścāṃ ca dvijānāṃ ca catuṣpadām |	aṇḍa ākṛti tiraścām ca dvijānām ca catuṣpadām 
MBtrisikhibrahmanopanisatHK-403	tundamadhyaṃ tadiṣṭaṃ vai tanmadhyaṃ nābhiriṣyate || 59 ||	tunda madhyam tat iṣṭam vai tat madhyam nābhiḥ iṣyate  /
MBtrisikhibrahmanopanisatHK-404	manuṣyādi dehamadhyaṃ viśadayati- kandeti || 58-59 ||	             
MBtrisikhibrahmanopanisatHK-405	nāḍīcakre jīvabhramaṇam	nāḍī cakre jīva bhramaṇam 
MBtrisikhibrahmanopanisatHK-406	tatra cakraṃ dvādaśāraṃ teṣu viṣṇvādimūrtayaḥ |	tatra cakram dvādaśa aram teṣu viṣṇu ādi mūrtayaḥ 
MBtrisikhibrahmanopanisatHK-407	ahaṃ tatra sthitaścakraṃ bhrāmayāmi svamāyayā || 60 ||	aham tatra sthitaḥ cakram bhrāmayāmi sva māyayā 
MBtrisikhibrahmanopanisatHK-408	areṣu bhramate jīvaḥ krameṇa dvijasattama |	areṣu bhramate jīvaḥ krameṇa dvijasattama 
MBtrisikhibrahmanopanisatHK-409	tantupañjaramadhyasthā yathā bhramati lūtikā || 61 ||	tantu pañjara madhya sthā yathā bhramati lūtikā 
MBtrisikhibrahmanopanisatHK-410	prāṇādhirūḍhaścarati jīvastena vinā na hi |	prāṇa adhirūḍhaḥ carati jīvaḥ tena vinā na hi 
MBtrisikhibrahmanopanisatHK-411	tatrasthanāḍīcakraṃ viṣṇvādibhiradhiṣṭhitaṃ sat vartate |	tatrastha nāḍī cakram viṣṇu ādibhiḥ adhiṣṭhitam sat vartate 
MBtrisikhibrahmanopanisatHK-412	tatrāhamantaryāmyātmanā sthitvā taccālayāmītyāha- tatreti | tatra	tatra aham antaryāmī ātmanā sthitvā tat cālayāmi iti āha tatra iti tatra 
MBtrisikhibrahmanopanisatHK-413	nābhimadhye nāḍīcakram |	nābhi madhye nāḍī cakram 
MBtrisikhibrahmanopanisatHK-414	īśvaraḥ sarvabhūtānāṃ hṛddeśe'rjuna tiṣṭhati |	īśvaraḥ sarva bhūtānām hṛd deśeḥ juna tiṣṭhati 
MBtrisikhibrahmanopanisatHK-415	bhrāmayan sarvabhūtāni yantrārūḍhāni māyayā ||	bhrāmayan sarva bhūtāni yantra ārūḍhāni māyayā 
MBtrisikhibrahmanopanisatHK-416	iti smṛtyanurodhena aham ityādi || 60 || ko vā tvayā bhrāmyate ityata āha##-	iti smṛti anurodhena aham ityādi     kaḥ vā tvayā bhrāmyate iti atas āha 
MBtrisikhibrahmanopanisatHK-417	| lūtikā urṇanābhiḥ kīṭaviśeṣaḥ | tathā jīvaḥ calanametītyarthaḥ || 61 ||	lūtikā urṇanābhiḥ kīṭa viśeṣaḥ tathā jīvaḥ calanam eti iti arthaḥ   
MBtrisikhibrahmanopanisatHK-418	"p. 134) 		kuṇḍalinīsthānaṃ tadvyāpāraśca"	kuṇḍalinī sthānam tad vyāpāraḥ ca 
MBtrisikhibrahmanopanisatHK-419	tasyordhve kuṇḍalīsthānaṃ nābhestiryagathordhvataḥ || 62 ||	tasya ūrdhve kuṇḍalī sthānam nābheḥ tiryak atha ūrdhvatas 
MBtrisikhibrahmanopanisatHK-420	aṣṭaprakṛtirūpā sā cāṣṭadhā kuṇḍalīkṛtā |	aṣṭa prakṛti rūpā sā ca aṣṭadhā kuṇḍalīkṛtā 
MBtrisikhibrahmanopanisatHK-421	yathāvadvāyusaṃcāraṃ jalānnādi ca nityaśaḥ || 63 ||	yathāvat vāyu saṃcāram jala anna ādi ca nityaśas 
MBtrisikhibrahmanopanisatHK-422	paritaḥ kandapārśve tu nirudhyaiva sadā sthitā |	paritas kanda pārśve tu nirudhya eva sadā sthitā 
MBtrisikhibrahmanopanisatHK-423	mukhenaiva samāveṣṭya brahmarandhramukhaṃ tathā || 64 ||	mukhena eva samāveṣṭya brahmarandhra mukham tathā 
MBtrisikhibrahmanopanisatHK-424	yogakālena marutā sāgninā bodhitā satī |	yoga kālena marutā sā agninā bodhitā satī 
MBtrisikhibrahmanopanisatHK-425	sphuritā hṛdayākāśe nāgarūpā mahojjvalā || 65 ||	sphuritā hṛdaya ākāśe nāga rūpā mahā ujjvalā 
MBtrisikhibrahmanopanisatHK-426	tadūrdhvavilasitakuṇḍalinīsthānaṃ tadvyāpāraṃ cāha- tasyeti |	tad ūrdhva vilasita kuṇḍalinī sthānam tad vyāpāram ca āha tasya iti 
MBtrisikhibrahmanopanisatHK-427	nāḍīcakrasya tasya || 62 ||	nāḍī cakrasya tasya 
MBtrisikhibrahmanopanisatHK-428	bhūmirāpo'nalo vāyuḥ khaṃ mano buddhireva ca |	bhūmiḥ āpaḥ unalaḥ vāyuḥ kham manaḥ buddhiḥ eva ca 
MBtrisikhibrahmanopanisatHK-429	ahaṃkāra itīyaṃ me bhinnā prakṛtiraṣṭadhā ||	ahaṃkāraḥ iti iyam me bhinnā prakṛtiḥ aṣṭadhā 
MBtrisikhibrahmanopanisatHK-430	iti smṛtyanurodhena aṣṭaprakṛtirūpā vāyusaṃcāraṃ	iti smṛti anurodhena aṣṭa prakṛti rūpāḥ vāyu saṃcāram 
MBtrisikhibrahmanopanisatHK-431	prāṇāpānayoraikyamityarthaḥ | bhuktajalānnādi || 63 || kiṃ kurvatī sthitetyatra	prāṇa apānayoḥ aikyam iti arthaḥ bhukta jala anna ādi    kim kurvatī sthitā iti atra 
MBtrisikhibrahmanopanisatHK-432	mukhenaiva ityādi || 64 || sā kadā ūrdhvaṃ prasaratītyatra yogakālena ityādi ||	mukhena eva ityādi    sā kadā ūrdhvam prasarati iti atra yoga kālena ityādi 
MBtrisikhibrahmanopanisatHK-433	dehamadhyasthanāḍīkandasvarūpam	            
MBtrisikhibrahmanopanisatHK-434	apānāddvyaṅgulādūrdhvamadho meḍhrasya tāvatā |	apānāt dvi aṅgulāt ūrdhvam adhas meḍhrasya tāvatā 
MBtrisikhibrahmanopanisatHK-435	dehamadhyaṃ manuṣyāṇāṃ hṛnmadhyaṃ tu catuṣpadām || 66 ||	deha madhyam manuṣyāṇām hṛd madhyam tu catuṣpadām 
MBtrisikhibrahmanopanisatHK-436	p. 135) itareṣāṃ tundamadhyaṃ nānānāḍīsamāvṛtam |	itareṣām tunda madhyam nānā nāḍī samāvṛtam 
MBtrisikhibrahmanopanisatHK-437	catuṣprakāradvyayute dehamadhye suṣumnayā || 67 ||	catuṣprakāra dvi ayute deha madhye suṣumnayā 
MBtrisikhibrahmanopanisatHK-438	kandamadhye sthitā nāḍī suṣumnā supratiṣṭhitā |	kanda madhye sthitā nāḍī suṣumnā su pratiṣṭhitā 
MBtrisikhibrahmanopanisatHK-439	padmasūtrapratīkāśā ṛjurūrdhvapravartinī || 68 ||	padma sūtra pratīkāśā ṛjuḥ ūrdhva pravartinī 
MBtrisikhibrahmanopanisatHK-440	brahmaṇo vivaraṃ yāvadvidyudābhāsanālakam |	brahmaṇaḥ vivaram yāvat vidyut ābhāsa nālakam 
MBtrisikhibrahmanopanisatHK-441	vaiṣṇavī brahmanāḍī ca nirvāṇaprāptipaddhatiḥ || 69 ||	         
MBtrisikhibrahmanopanisatHK-442	iḍā ca piṅgalā caiva tasyāḥ savyetare sthite |	iḍā ca piṅgalā ca eva tasyāḥ savyetare sthite 
MBtrisikhibrahmanopanisatHK-443	iḍā samutthitā kandādvāmanāsāpuṭāvadhiḥ || 70 ||	iḍā samutthitā kandāt vāma nāsā puṭa avadhiḥ 
MBtrisikhibrahmanopanisatHK-444	piṅgalā cotthitā tasmāddakṣanāsāpuṭāvadhiḥ |	piṅgalā ca utthitā tasmāt dakṣa nāsā puṭa avadhiḥ 
MBtrisikhibrahmanopanisatHK-445	gāndhārī hastijihvā ca dve cānye nāḍike sthite || 71 ||	gāndhārī hastijihvā ca dve ca anye nāḍike sthite  /
MBtrisikhibrahmanopanisatHK-446	purataḥ pṛṣṭhatastasyā vāmetaradṛśau prati |	puratas pṛṣṭhatas tasyāḥ vāmetara dṛśau prati 
MBtrisikhibrahmanopanisatHK-447	pūṣāyaśasvinīnāḍyau tasmādeva samutthite || 72 ||	pūṣā yaśasvinī nāḍyau tasmāt eva samutthite  /
MBtrisikhibrahmanopanisatHK-448	savyetaraśrutyavadhi pāyumūlāvalambusā |	savyetaraśruti avadhi pāyu mūla avalambusā 
MBtrisikhibrahmanopanisatHK-449	adhogatā śubhā nāḍī meḍhrāntāvadhirāyatā || 73 ||	adhas gatā śubhā nāḍī meḍhra anta avadhiḥ āyatā  /
MBtrisikhibrahmanopanisatHK-450	pādāṅguṣṭhāvadhiḥ kandādadhoyātā ca kauśikī |	pādāṅguṣṭha avadhiḥ kandāt adhas yātā ca kauśikī 
MBtrisikhibrahmanopanisatHK-451	daśaprakārabhūtāstāḥ kathitāḥ kandasaṃbhavāḥ || 74 ||	daśa prakāra bhūtāḥ tāḥ kathitāḥ kanda saṃbhavāḥ 
MBtrisikhibrahmanopanisatHK-452	p. 136)  tanmūlā bahavo nāḍyaḥ sthūlāḥ sūkṣmāśca nāḍikāḥ |	tad mūlāḥ bahavaḥ nāḍyaḥ sthūlāḥ sūkṣmāḥ ca nāḍikāḥ 
MBtrisikhibrahmanopanisatHK-453	dvāsaptatisahasrāṇi sthūlāḥ sūkṣmāśca nāḍayaḥ || 75 ||	dvāsaptati sahasrāṇi sthūlāḥ sūkṣmāḥ ca nāḍayaḥ 
MBtrisikhibrahmanopanisatHK-454	saṃkhyātuṃ naiva śakyante sthūlamūlāḥ pṛthagvidhāḥ |	saṃkhyātum nā eva śakyante sthūla mūlāḥ pṛthagvidhāḥ 
MBtrisikhibrahmanopanisatHK-455	yathāśvatthadale sūkṣmāḥ sthūlāśca vitatāstathā || 76 ||	yathā aśvattha dale sūkṣmāḥ sthūlāḥ ca vitatāḥ tathā 
MBtrisikhibrahmanopanisatHK-456	dehamadhyaṃ tadāśrayanāḍīkandasvarūpamāha- apānāditi ||	deha madhyam tad āśraya nāḍī kanda svarūpam āha apānāt iti 
MBtrisikhibrahmanopanisatHK-457	66-67 || tatra keyaṃ pradhānanāḍī ? tadāśritya kati nāḍyo vartante	tatra kā iyam pradhānanāḍī tat āśritya kati nāḍyaḥ vartante 
MBtrisikhibrahmanopanisatHK-458	? ityatrocyate- kandeti | vīṇādaṇḍamāśritya ṛjurūrdhvapravartinī	iti atra ucyate kanda iti vīṇā daṇḍam āśritya ṛjuḥ ūrdhva pravartinī 
MBtrisikhibrahmanopanisatHK-459	|| 68 || kiyatparyantam ūrdhvaṃ pravṛttetyatra brahmarandhrāntamityāha##-	                                           
MBtrisikhibrahmanopanisatHK-460	brahmarandhraṃ tāvat, mūlādhāramārabhya brahmarandhraparyantaṃ	brahmarandhram tāvat mūlādhāram ārabhya brahmarandhra paryantam 
MBtrisikhibrahmanopanisatHK-461	pravartate ityarthaḥ | tasyā nāma nirdiśati- vaiṣṇavīti |	pravartate iti arthaḥ tasyāḥ nāma nirdiśati vaiṣṇavī iti 
MBtrisikhibrahmanopanisatHK-462	viṣṇvadhiṣṭhitatvāt | brahmanāḍī brahmalokaprāpakatvāt,	viṣṇu adhiṣṭhita tvāt brahmanāḍī brahma loka prāpaka tvāt 
MBtrisikhibrahmanopanisatHK-463	tadantargatakaivalyanāḍī | nirvāṇaprāptipaddhatiḥ kaivalyasṛtitvāt || 69 ||	               
MBtrisikhibrahmanopanisatHK-464	tadāśrayanāḍyaḥ ucyante- iḍā ceti || 70-75 || asaṃkhyeyatve	tad āśraya nāḍyaḥ ucyante iḍā ca iti asaṃkhyeya tve 
MBtrisikhibrahmanopanisatHK-465	dṛṣṭāntamāha- yatheti || 76 ||	dṛṣṭāntam āha yathā iti 
MBtrisikhibrahmanopanisatHK-466	nāḍīcarāḥ vāyavaḥ	nāḍī carāḥ vāyavaḥ 
MBtrisikhibrahmanopanisatHK-467	prāṇāpānau samānaśca udāno vyāna eva ca |	prāṇa apānau samānaḥ ca udānaḥ vyānaḥ eva ca 
MBtrisikhibrahmanopanisatHK-468	nāgaḥ kūrmaśca kṛkaro devadatto dhanaṃjayaḥ || 77 ||	nāgaḥ kūrmaḥ ca kṛkaraḥ devadattaḥ dhanaṃjayaḥ 
MBtrisikhibrahmanopanisatHK-469	caranti daśanāḍīṣu daśa prāṇādivāyavaḥ |	caranti daśa nāḍīṣu daśa prāṇa ādi vāyavaḥ 
MBtrisikhibrahmanopanisatHK-470	prāṇādipañcakaṃ teṣu pradhānaṃ tatra ca dvayam || 78 ||	prāṇa ādi pañcakam teṣu pradhānam tatra ca dvayam 
MBtrisikhibrahmanopanisatHK-471	prāṇa evāthavā jyeṣṭho jīvātmānaṃ bibharti yaḥ |	prāṇaḥ eva athavā jyeṣṭhaḥ jīvātmānam bibharti yaḥ 
MBtrisikhibrahmanopanisatHK-472	āsyanāsikayormadhyaṃ hṛdayaṃ nābhimaṇḍalam || 79 ||	āsya nāsikayoḥ madhyam hṛdayam nābhi maṇḍalam 
MBtrisikhibrahmanopanisatHK-473	p. 137) pādāṅguṣṭhamiti prāṇasthānāni dvijasattama |	pādāṅguṣṭham iti prāṇa sthānāni dvijasattama 
MBtrisikhibrahmanopanisatHK-474	apānaścarati brahman gudameḍhrorujānuṣu || 80 ||	apānaḥ carati brahman guda meḍhra ūru jānuṣu 
MBtrisikhibrahmanopanisatHK-475	samānaḥ sarvagātreṣu sarvavyāpī vyavasthitaḥ |	samānaḥ sarva gātreṣu sarva vyāpī vyavasthitaḥ 
MBtrisikhibrahmanopanisatHK-476	udānaḥ sarvasaṃdhisthaḥ pādayorhastayorapi || 81 ||	udānaḥ sarva saṃdhi sthaḥ pādayoḥ hastayoḥ api 
MBtrisikhibrahmanopanisatHK-477	vyānaḥ śrotrorukaṭyāṃ ca gulphaskandhagaleṣu ca |	vyānaḥ śrotra ūru kaṭyām ca gulpha skandha galeṣu ca 
MBtrisikhibrahmanopanisatHK-478	nāgādivāyavaḥ pañca tvagasthyādiṣu saṃsthitāḥ || 82 ||	nāga ādi vāyavaḥ pañca tvac asthi ādiṣu saṃsthitāḥ 
MBtrisikhibrahmanopanisatHK-479	tundasthaṃ jalamannaṃ ca rasādi ca samīkṛtam |	tunda stham jalam annam ca rasa ādi ca samīkṛtam 
MBtrisikhibrahmanopanisatHK-480	tundamadhyagataḥ prāṇastāni kuryāt pṛthak pṛthak || 83 ||	tunda madhya gataḥ prāṇaḥ tāni kuryāt pṛthak pṛthak 
MBtrisikhibrahmanopanisatHK-481	ityādiceṣṭanaṃ prāṇaḥ karoti ca pṛthak sthitaḥ |	iti ādi ceṣṭanam prāṇaḥ karoti ca pṛthak sthitaḥ 
MBtrisikhibrahmanopanisatHK-482	apānavāyurmūtrādeḥ karoti ca visarjanam || 84 ||	apāna vāyuḥ mūtra ādeḥ karoti ca visarjanam 
MBtrisikhibrahmanopanisatHK-483	prāṇāpānādiceṣṭādi vyānavāyunā |	prāṇa apāna ādi ceṣṭā ādi vyāna vāyunā 
MBtrisikhibrahmanopanisatHK-484	ujjīryate śarīrasthamudānena nabhasvatā || 85 ||	ujjīryate śarīra stham udānena nabhasvatā 
MBtrisikhibrahmanopanisatHK-485	poṣaṇādi śarīrasya samānaḥ kurute sadā |	poṣaṇa ādi śarīrasya samānaḥ kurute sadā 
MBtrisikhibrahmanopanisatHK-486	udgārādikriyo nāgaḥ kūrmo'kṣyādinimīlanaḥ || 86 ||	            
MBtrisikhibrahmanopanisatHK-487	kṛkaraḥ kṣapayoḥ kartā datto nidrādikarmakṛt |	             
MBtrisikhibrahmanopanisatHK-488	mṛtagātrasya śobhādi dhanaṃjaya udāhṛtaḥ || 87 ||	mṛta gātrasya śobhā ādi dhanaṃjayaḥ udāhṛtaḥ 
MBtrisikhibrahmanopanisatHK-489	nāḍīcarā vāyavaḥ katisaṃkhyākā ityatra prāṇāpānau ityādi || 77 ||	nāḍī carāḥ vāyavaḥ kati saṃkhyākāḥ iti atra prāṇa apānau ityādi  
MBtrisikhibrahmanopanisatHK-490	teṣu kaḥ pradhāna ityata āha- prāṇādīti || 78 || teṣāṃ sthānāni	teṣu kaḥ pradhānaḥ iti atas āha prāṇa ādi iti teṣām sthānāni 
MBtrisikhibrahmanopanisatHK-491	nirdiśati- āsyeti || 79-82 || prāṇādivyāpāramāha- tundasthamiti	nirdiśati āsya iti 
MBtrisikhibrahmanopanisatHK-492	|| 83-86 || kṣapayoḥ nimeṣonmeṣayoḥ || 87 ||	     
MBtrisikhibrahmanopanisatHK-493	"p. 138) 		nāḍījñānapuraḥsarā nāḍīśuddhiḥ"	         
MBtrisikhibrahmanopanisatHK-494	nāḍībhedaṃ marudbhedaṃ marutāṃ sthānameva ca |	nāḍī bhedam marut bhedam marutām sthānam eva ca 
MBtrisikhibrahmanopanisatHK-495	ceṣṭāśca vividhāsteṣāṃ jñātvaivaṃ dvijasattam || 88 ||	ceṣṭāḥ ca vividhāḥ teṣām jñātvā evam dvijasattam 
MBtrisikhibrahmanopanisatHK-496	śuddhau yateta nāḍīnāṃ pūrvoktajñānasaṃyutaḥ |	śuddhau yateta nāḍīnām pūrva ukta jñāna saṃyutaḥ 
MBtrisikhibrahmanopanisatHK-497	evaṃ nāḍībhedasthānādikaṃ jñātvā tacchuddhyarthaṃ	evam nāḍī bheda sthāna ādikam jñātvā tad śuddhi artham 
MBtrisikhibrahmanopanisatHK-498	yatetetyāha- nāḍīti || 88 ||	yateta iti āha nāḍī iti 
MBtrisikhibrahmanopanisatHK-499	yogābhyāsasthalaṃ tadvidhiśca	yoga abhyāsa sthalam tad vidhiḥ ca 
MBtrisikhibrahmanopanisatHK-500	viviktadeśamāsthāya sarvasambandhavarjitaḥ || 89 ||	vivikta deśam āsthāya sarva sambandha varjitaḥ 
MBtrisikhibrahmanopanisatHK-501	yogāṅgadravyasaṃpūrṇaṃ tatra dārumaye śubhe |	yoga aṅga dravya saṃpūrṇam tatra dāru maye śubhe 
MBtrisikhibrahmanopanisatHK-502	āsane kalpite darbhakuśakṛṣṇājinādibhiḥ || 90 ||	āsane kalpite darbha kuśa kṛṣṇājina ādibhiḥ 
MBtrisikhibrahmanopanisatHK-503	tāvadāsanamutsedhe tāvaddvayasamāyate |	tāvat āsanam utsedhe tāvat dvaya samāyate 
MBtrisikhibrahmanopanisatHK-504	upaviśyāsanaṃ samyak svastikādi yathāruci || 91 ||	upaviśya āsanam samyak svastika ādi yathāruci 
MBtrisikhibrahmanopanisatHK-505	yogasthalaṃ yogavidhiṃ cāha- vivikteti || 89-91 ||	yoga sthalam yoga vidhim ca āha vivikta iti 
MBtrisikhibrahmanopanisatHK-506	cinmudrāsahitakevalakumbhakam	           
MBtrisikhibrahmanopanisatHK-507	baddhvā prāgāsanaṃ vipra ṛjukāyaḥ samāhitaḥ |	baddhvā prāc āsanam vipraḥ ṛju kāyaḥ samāhitaḥ 
MBtrisikhibrahmanopanisatHK-508	nāsāgranyastanayano dantairdantānasaṃspṛśan || 92 ||	nāsā agra nyasta nayanaḥ dantaiḥ dantān a saṃspṛśan 
MBtrisikhibrahmanopanisatHK-509	rasanāṃ tāluni nyasya svasthacitto nirāmayaḥ |	rasanām tāluni nyasya svastha cittaḥ nirāmayaḥ 
MBtrisikhibrahmanopanisatHK-510	ākuñcitaśiraḥ kiṃcinnibadhnan yogamudrayā || 93 ||	ākuñcita śiraḥ kiṃcid nibadhnan yoga mudrayā 
MBtrisikhibrahmanopanisatHK-511	hastau yathoktavidhinā prāṇāyāmaṃ samācaret |	hastau yathā ukta vidhinā prāṇāyāmam samācaret 
MBtrisikhibrahmanopanisatHK-512	p. 139) prāṇāyāmalakṣaṇaṃ vaktuṃ bhūmikāṃ racayati-	prāṇāyāma lakṣaṇam vaktum bhūmikām racayati 
MBtrisikhibrahmanopanisatHK-513	baddhveti | nāsikābandhanaṃ bandhatrayaṃ vā yogamudretyarthaḥ || 92##-	baddhvā iti nāsikābandhanam bandha trayam vā yogamudrā iti arthaḥ 
MBtrisikhibrahmanopanisatHK-514	kevalakumbhakaprāṇāyāmaṃ kuryādityarthaḥ ||	           
MBtrisikhibrahmanopanisatHK-515	sahitaprāṇāyāmaḥ	            
MBtrisikhibrahmanopanisatHK-516	recanaṃ pūraṇaṃ vāyoḥ śodhanaṃ recanaṃ tathā || 94 ||	recanam pūraṇam vāyoḥ śodhanam recanam tathā 
MBtrisikhibrahmanopanisatHK-517	caturbhiḥ kleśanaṃ vāyoḥ prāṇāyāma udīryate |	caturbhiḥ kleśanam vāyoḥ prāṇāyāmaḥ udīryate 
MBtrisikhibrahmanopanisatHK-518	sahitaprāṇāyāmalakṣaṇamāha- recanamiti || 94 ||	sahita prāṇāyāma lakṣaṇam āha recanam iti 
MBtrisikhibrahmanopanisatHK-519	prāṇāyāmārambhasamaye śarīragataduṣṭavāyurecanaṃ tataḥ pūraṇaṃ	prāṇāyāma ārambha samaye śarīra gata duṣṭa vāyu recanam tatas pūraṇam 
MBtrisikhibrahmanopanisatHK-520	tataḥ kumbhakena vāyoḥ śodhanaṃ punaḥ niḥśeṣato recanam, evaṃ	tatas kumbhakena vāyoḥ śodhanam punar niḥśeṣataḥ recanam evam 
MBtrisikhibrahmanopanisatHK-521	caturbhiḥ paryāyaiḥ vāyoḥ kleśanam upakramaprāṇāyāmaḥ udīryate |	caturbhiḥ paryāyaiḥ vāyoḥ kleśanam upakramaprāṇāyāmaḥ udīryate 
MBtrisikhibrahmanopanisatHK-522	evaṃ prāṇāyāmatraye kṛte sati atha yathoktaprāṇāyāmayogyaṃ śarīraṃ	evam prāṇāyāma traye kṛte sati atha yathā ukta prāṇāyāma yogyam śarīram 
MBtrisikhibrahmanopanisatHK-523	bhavatītyarthaḥ ||	bhavati iti arthaḥ 
MBtrisikhibrahmanopanisatHK-524	nāḍīśodhakaprāṇāyāmaḥ	          
MBtrisikhibrahmanopanisatHK-525	hastena dakṣiṇenaiva pīḍayennāsikāpuṭam || 95 ||	hastena dakṣiṇena eva pīḍayet nāsikā puṭam 
MBtrisikhibrahmanopanisatHK-526	śanaiḥ śanairatha bahiḥ prakṣipet piṅgalānilam |	śanais śanais atha bahis prakṣipet piṅgala anilam 
MBtrisikhibrahmanopanisatHK-527	iḍayā vāyumāpūrya brahman ṣoḍaśamātrayā || 96 ||	iḍayā vāyum āpūrya brahman ṣoḍaśa mātrayā 
MBtrisikhibrahmanopanisatHK-528	pūritaṃ kumbhayet paścāccatuḥṣaṣṭyā tu mātrayā |	pūritam kumbhayet paścāt catuḥṣaṣṭyā tu mātrayā 
MBtrisikhibrahmanopanisatHK-529	dvātriṃśanmātrayā samyag recayet piṅgalānilam || 97 ||	           
MBtrisikhibrahmanopanisatHK-530	evaṃ punaḥ punaḥ kāryaṃ vyutkramānukrameṇa tu |	evam punar punar kāryam vyutkrama anukrameṇa tu 
MBtrisikhibrahmanopanisatHK-531	saṃpūrṇakumbhavaddehaṃ kumbhayenmātariśvanā || 98 ||	saṃpūrṇa kumbha vat deham kumbhayet mātariśvanā 
MBtrisikhibrahmanopanisatHK-532	pūraṇānnāḍayaḥ sarvāḥ pūryante mātariśvanā |	pūraṇāt nāḍayaḥ sarvāḥ pūryante mātariśvanā 
MBtrisikhibrahmanopanisatHK-533	evaṃ kṛte sati brahmaṃścaranti daśa vāyavaḥ || 99 ||	evam kṛte sati brahman caranti daśa vāyavaḥ 
MBtrisikhibrahmanopanisatHK-534	p. 140) hṛdayāmbhoruhaṃ cāpi vyākocaṃ bhavati sphuṭam |	hṛdaya ambhoruham ca api vyākocam bhavati sphuṭam 
MBtrisikhibrahmanopanisatHK-535	tatra paśyet parātmānaṃ vāsudevamakalmaṣam || 100 ||	tatra paśyet parātmānam vāsudevam akalmaṣam 
MBtrisikhibrahmanopanisatHK-536	prātarmādhyaṃdine sāyamardharātre ca kumbhakān |	prātar mādhyaṃdine sāyam ardharātre ca kumbhakān 
MBtrisikhibrahmanopanisatHK-537	śanairaśītiparyantaṃ caturvāraṃ samabhyaset || 101 ||	śanais aśīti paryantam catur vāram samabhyaset 
MBtrisikhibrahmanopanisatHK-538	ekāhamātraṃ kurvāṇaḥ sarvapāpaiḥ pramucyate |	eka aha mātram kurvāṇaḥ sarva pāpaiḥ pramucyate 
MBtrisikhibrahmanopanisatHK-539	saṃvatsaratrayādūrdhvaṃ prāṇāyāmaparo naraḥ || 102 ||	saṃvatsara trayāt ūrdhvam prāṇāyāma paraḥ naraḥ 
MBtrisikhibrahmanopanisatHK-540	yogasiddho bhavedyogī vāyujidvijitendriyaḥ |	yogasiddhaḥ bhavet yogī vāyu jit vijita indriyaḥ 
MBtrisikhibrahmanopanisatHK-541	alpāśī svalpanidraśca tejasvī balavān bhavet || 103 ||	alpa āśī su alpa nidraḥ ca tejasvī balavān bhavet 
MBtrisikhibrahmanopanisatHK-542	apamṛtyumapakramya dīrghamāyuravāpnuyāt |	apamṛtyum apakramya dīrgham āyuḥ avāpnuyāt 
MBtrisikhibrahmanopanisatHK-543	nāḍīśodhanahetutayā abhyasanīyaprāṇāyāmakrama ucyate-	            ucyate 
MBtrisikhibrahmanopanisatHK-544	hasteneti | anukramastu, iḍayā āpūrya kumbhitvā piṅgalayā recanam |	hastena iti anukramaḥ tu iḍayā āpūrya kumbhitvā piṅgalayā recanam 
MBtrisikhibrahmanopanisatHK-545	vyutkramastu, piṅgalayā āpūrya kumbhitvā iḍayā recanam || 95-97	vyutkramaḥ tu piṅgalayā āpūrya kumbhitvā iḍayā recanam 
MBtrisikhibrahmanopanisatHK-546	|| evamaharahaḥ caturvāraṃ dinaikamātrāvṛddhipūrvakam	evam aharahar catur vāram dina eka mātrā vṛddhi pūrvakam 
MBtrisikhibrahmanopanisatHK-547	aśītiprāṇāyāmamabhyaset ityāha- saṃpūrṇeti || 98-99 || vyākocaṃ	aśīti prāṇāyāmam abhyaset iti āha saṃpūrṇa iti       
MBtrisikhibrahmanopanisatHK-548	vikāsam || 100-103 ||	vikāsam 
MBtrisikhibrahmanopanisatHK-549	prāṇāyāmaphalam	        
MBtrisikhibrahmanopanisatHK-550	prasvedajananaṃ yasya prāṇāyāmeṣu so'dhamaḥ || 104 ||	prasveda jananam yasya prāṇāyāmeṣu saḥ adhamaḥ 
MBtrisikhibrahmanopanisatHK-551	kampanaṃ vapuṣo yasya prāṇāyāmeṣu madhyamaḥ |	kampanam vapuṣaḥ yasya prāṇāyāmeṣu madhyamaḥ 
MBtrisikhibrahmanopanisatHK-552	utthānaṃ vapuṣo yasya sa uttama udāhṛtaḥ || 105 ||	utthānam vapuṣaḥ yasya saḥ uttamaḥ udāhṛtaḥ 
MBtrisikhibrahmanopanisatHK-553	adhame vyādhipāpānāṃ nāśaḥ syānmadhyame punaḥ |	adhame vyādhi pāpānām nāśaḥ syāt madhyame punar 
MBtrisikhibrahmanopanisatHK-554	pāparogamahāvyādhināśaḥ syāduttame punaḥ || 106 ||	pāpa roga mahā vyādhi nāśaḥ syāt uttame punar 
MBtrisikhibrahmanopanisatHK-555	p. 141) alpamūtro'lpaviṣṭhaśca laghudeho mitāśanaḥ |	alpa mūtra ulpa viṣṭhaḥ ca laghu dehaḥ mita aśanaḥ 
MBtrisikhibrahmanopanisatHK-556	paṭvindriyaḥ paṭumatiḥ kālatrayavidātmavān || 107 ||	          
MBtrisikhibrahmanopanisatHK-557	recakaṃ pūrakaṃ muktvā kumbhīkaraṇameva yaḥ |	recakam pūrakam muktvā kumbhīkaraṇam eva yaḥ 
MBtrisikhibrahmanopanisatHK-558	karoti triṣu kāleṣu naiva tasyāsti durlabham || 108 ||	karoti triṣu kāleṣu na eva tasya asti durlabham 
MBtrisikhibrahmanopanisatHK-559	prathamābhyāsakāle svedakampanotthānādisiddhiṃ tatphalaṃ cāha##-	prathama abhyāsa kāle sveda kampana utthāna ādi siddhim tad phalam ca āha 
MBtrisikhibrahmanopanisatHK-560	vāñchitārthasiddhiḥ syādityāha- recakamiti || 108 ||	vāñchita artha siddhiḥ syāt iti āha recakam iti 
MBtrisikhibrahmanopanisatHK-561	prāṇadhāraṇādroganāśaḥ	prāṇadhāraṇāt roga nāśaḥ 
MBtrisikhibrahmanopanisatHK-562	nābhikande ca nāsāgre pādāṅguṣṭhe ca yatnavān |	nābhi kande ca nāsā agre pādāṅguṣṭhe ca yatnavān 
MBtrisikhibrahmanopanisatHK-563	dhārayenmanasā prāṇān saṃdhyākāleṣu vā sadā || 109 ||	dhārayet manasā prāṇān saṃdhyā kāleṣu vā sadā 
MBtrisikhibrahmanopanisatHK-564	sarvarogairvinirmukto jīvedyogī gataklamaḥ |	sarva rogaiḥ vinirmuktaḥ jīvet yogī gata klamaḥ 
MBtrisikhibrahmanopanisatHK-565	kukṣirogavināśaḥ syānnābhikandeṣu dhāraṇāt || 110 ||	kukṣi roga vināśaḥ syāt nābhi kandeṣu dhāraṇāt 
MBtrisikhibrahmanopanisatHK-566	nāsāgradhāraṇāddīrghamāyuḥ syāddehalāghavaḥ |	nāsā agra dhāraṇāt dīrgham āyuḥ syāt deha lāghavaḥ 
MBtrisikhibrahmanopanisatHK-567	brāhme muhūrte saṃprāpte vāyumākṛṣya jihvayā || 111 ||	brāhme muhūrte saṃprāpte vāyum ākṛṣya jihvayā 
MBtrisikhibrahmanopanisatHK-568	pibatastriṣu māseṣu vāksiddhirmahatī bhavet |	pibataḥ triṣu māseṣu vāc siddhiḥ mahatī bhavet 
MBtrisikhibrahmanopanisatHK-569	abhyasyatuśca ṣaṇmāsānmahārogavināśanam || 112 ||	abhyasyatuḥ ca ṣaṣ māsāt mahā roga vināśanam 
MBtrisikhibrahmanopanisatHK-570	yatra yatra dhṛto vāyuraṅge rogādidūṣite |	yatra yatra dhṛtaḥ vāyuḥ aṅge roga ādi dūṣite 
MBtrisikhibrahmanopanisatHK-571	dhāraṇādeva marutastattadārogyamaśnute || 113 ||	dhāraṇāt eva marutaḥ tat tat ārogyam aśnute 
MBtrisikhibrahmanopanisatHK-572	p. 142) yadyadaṅgaṃ rogadūṣitaṃ bhavati tattadaṅgavāyudhāraṇāt	yat yat aṅgam roga dūṣitam bhavati tad tad aṅga vāyu dhāraṇāt 
MBtrisikhibrahmanopanisatHK-573	tattadroganivṛttidvārā āyurvṛddhiḥ syādityāha- nābhīti |	tad tad roga nivṛtti dvārā āyuḥ vṛddhiḥ syāt iti āha nābhi iti 
MBtrisikhibrahmanopanisatHK-574	kevalakumbhakābhyāsasiddho yogī nābhikande ityādi || 109-113 ||	kevala kumbhaka abhyāsa siddhaḥ yogī nābhi kande ityādi 
MBtrisikhibrahmanopanisatHK-575	ṣaṇmukhīmudrayā manojayaḥ	          
MBtrisikhibrahmanopanisatHK-576	manaso dhāraṇādeva pavano dhārito bhavet |	manasaḥ dhāraṇāt eva pavanaḥ dhāritaḥ bhavet 
MBtrisikhibrahmanopanisatHK-577	manasaḥ sthāpane heturucyate dvijapuṅgava || 114 ||	manasaḥ sthāpane hetuḥ ucyate dvija puṅgava 
MBtrisikhibrahmanopanisatHK-578	karaṇāni samāhṛtya viṣayebhyaḥ samāhitaḥ |	karaṇāni samāhṛtya viṣayebhyaḥ samāhitaḥ 
MBtrisikhibrahmanopanisatHK-579	apānamūrdhvamākṛṣyedudaropari dhārayet || 115 ||	apānam ūrdhvam ākṛṣyet udara upari dhārayet 
MBtrisikhibrahmanopanisatHK-580	badhnan karābhyāṃ śrotrādikaraṇāni yathātatham |	badhnan karābhyām śrotra ādi karaṇāni yathātatham 
MBtrisikhibrahmanopanisatHK-581	yuñjānasya yathoktena vartmanā svavaśaṃ manaḥ || 116 ||	yuñjānasya yathā uktena vartmanā sva vaśam manaḥ 
MBtrisikhibrahmanopanisatHK-582	manovaśāt prāṇavāyuḥ svavaśe sthāpyate sadā |	manaḥ vaśāt prāṇa vāyuḥ sva vaśe sthāpyate sadā 
MBtrisikhibrahmanopanisatHK-583	manaḥprāṇayoravinābhāvāt manovaśārthaṃ ṣaṇmukhīmudrāṃ	manaḥ prāṇayoḥ avinābhāvāt manaḥ vaśa artham ṣaṇmukhī mudrām 
MBtrisikhibrahmanopanisatHK-584	darśayati- manasa iti || 114 || kiṃ tat ? kāraṇāni ityādi || 115-116	darśayati manasaḥ iti    kim tat kāraṇāni ityādi 
MBtrisikhibrahmanopanisatHK-585	|| manovaśataḥ prāṇo'pi svavaśo bhavatītyāha- mana iti ||	manaḥ vaśataḥ prāṇaḥ api sva vaśaḥ bhavati iti āha manaḥ iti 
MBtrisikhibrahmanopanisatHK-586	prāṇagatiḥ	prāṇa gatiḥ 
MBtrisikhibrahmanopanisatHK-587	nāsikāpuṭayoḥ prāṇaḥ paryāyeṇa pravartate || 117 ||	nāsikā puṭayoḥ prāṇaḥ paryāyeṇa pravartate 
MBtrisikhibrahmanopanisatHK-588	tisraśca nāḍikāstāsu sa yāvantaścaratyayam |	tisraḥ ca nāḍikāḥ tāsu sa yāvantaḥ carati ayam 
MBtrisikhibrahmanopanisatHK-589	śaṅkhinīvivare yāmye prāṇaḥ prāṇabhṛtāṃ satām || 118 ||	śaṅkhinī vivare yāmye prāṇaḥ prāṇabhṛtām satām 
MBtrisikhibrahmanopanisatHK-590	tāvantaṃ ca punaḥ kālaṃ saumye carati saṃtatam |	tāvantam ca punar kālam saumye carati saṃtatam 
MBtrisikhibrahmanopanisatHK-591	p. 143) prāṇagatiṃ vivṛṇoti- nāsiketi || 117 ||	prāṇa gatim vivṛṇoti nāsikā iti 
MBtrisikhibrahmanopanisatHK-592	mūlādhāramārabhya bhrūmadhyāntamiḍāpiṅgalādibhedena tisraśca	mūlādhāram ārabhya bhrū madhya antam iḍā piṅgalā ādi bhedena tisraḥ ca 
MBtrisikhibrahmanopanisatHK-593	ityādi | iḍādibhedena tisro nāḍikāḥ santi | tāsu suṣumnāyāṃ prāṇagatiḥ	ityādi iḍā ādi bhedena tisraḥ nāḍikāḥ santi tāsu suṣumnāyām prāṇa gatiḥ 
MBtrisikhibrahmanopanisatHK-594	prāṇabhṛtāṃ madhye satāṃ yogināmeva bhavati | ayogināṃ tu so'yaṃ	prāṇabhṛtām madhye satām yoginām eva bhavati ayoginām tu saḥ uyam 
MBtrisikhibrahmanopanisatHK-595	prāṇaḥ śaṅkhavat antarāvartatrayaviśiṣṭeyaṃ śaṅkhinī nāsikā tasyā	prāṇaḥ śaṅkha vat antarāvarta traya viśiṣṭā iyam śaṅkhinī nāsikā tasyāḥ 
MBtrisikhibrahmanopanisatHK-596	yāmye vivare  piṅgaletiviśrutadakṣiṇanāsāpuṭe yāvantaṃ kālaṃ carati ||	yāmye vivare piṅgala iti viśruta dakṣiṇa nāsāpuṭe yāvantam kālam carati 
MBtrisikhibrahmanopanisatHK-597	118 || punaḥ tāvantaṃ kālaṃ saumye vāmanāsāpuṭe carati | evaṃ	punar tāvantam kālam saumye vāma nāsā puṭe carati evam 
MBtrisikhibrahmanopanisatHK-598	prāṇagatiḥ piṅgaleḍayoḥ saṃtataṃ bhavatītyarthaḥ ||	prāṇa gatiḥ piṅgalā iḍayoḥ saṃtatam bhavati iti arthaḥ 
MBtrisikhibrahmanopanisatHK-599	prāṇagatijñānena yogāvāptiḥ	          
MBtrisikhibrahmanopanisatHK-600	itthaṃ krameṇa caratā vāyunā vāyujinnaraḥ || 119 ||	ittham krameṇa caratā vāyunā vāyu jit naraḥ 
MBtrisikhibrahmanopanisatHK-601	ahaśca rātriṃ pakṣaṃ ca māsaṃ matvāyanādikam |	ahar ca rātrim pakṣam ca māsam matvā ayana ādikam 
MBtrisikhibrahmanopanisatHK-602	antarmukho vijānīyāt kālabhedaṃ samāhitaḥ || 120 ||	antar mukhaḥ vijānīyāt kāla bhedam samāhitaḥ 
MBtrisikhibrahmanopanisatHK-603	aṅguṣṭhādi svāvayavāsphuraṇādarśanairapi |	aṅguṣṭha ādi sva avayava āsphuraṇa adarśanaiḥ api 
MBtrisikhibrahmanopanisatHK-604	ariṣṭairjīvitasyāpi jānīyāt kṣayamātmanaḥ || 121 ||	ariṣṭaiḥ jīvitasya api jānīyāt kṣayam ātmanaḥ 
MBtrisikhibrahmanopanisatHK-605	jñātvā yateta kaivalyaprāptaye yogavittamaḥ |	jñātvā yateta kaivalya prāptaye yoga vittamaḥ 
MBtrisikhibrahmanopanisatHK-606	pādāṅguṣṭhe karāṅguṣṭhe sphuraṇaṃ yasya naśyati || 122 ||	pādāṅguṣṭhe kara aṅguṣṭhe sphuraṇam yasya naśyati 
MBtrisikhibrahmanopanisatHK-607	tasya saṃvatsarādūrdhvaṃ jīvitavyakṣayo bhavet |	tasya saṃvatsarāt ūrdhvam jīvitavya kṣayaḥ bhavet 
MBtrisikhibrahmanopanisatHK-608	maṇibandhe tathā gulphe sphuraṇaṃ yasya naśyati || 123 ||	maṇibandhe tathā gulphe sphuraṇam yasya naśyati 
MBtrisikhibrahmanopanisatHK-609	ṣaṇmāsāvadhiretasya jīvitasya sthitirbhavet |	ṣaṣ māsa avadhiḥ etasya jīvitasya sthitiḥ bhavet 
MBtrisikhibrahmanopanisatHK-610	kūrparāsphuraṇaṃ yasya tasya traimāsikī sthitiḥ || 124 ||	kūrpara āsphuraṇam yasya tasya traimāsikī sthitiḥ 
MBtrisikhibrahmanopanisatHK-611	p. 144) kakṣe mehanapārśve ca sphuraṇānupalambhane |	kakṣe mehana pārśve ca sphuraṇa anupalambhane 
MBtrisikhibrahmanopanisatHK-612	māsāvadhi jīvitaṃ syāt tadardhaṃ sattvadarśane || 125 ||	māsa avadhi jīvitam syāt tad ardham sattva darśane 
MBtrisikhibrahmanopanisatHK-613	āśrite jaṭhare dvāre dināni daśa jīvitam |	āśrite jaṭhare dvāre dināni daśa jīvitam 
MBtrisikhibrahmanopanisatHK-614	jyotiḥ khadyotavadyasya tasya jīvitam || 126 ||	jyotiḥ khadyota vat yasya tasya jīvitam 
MBtrisikhibrahmanopanisatHK-615	jihvāgrādarśane trīṇi dināni sthitirātmanaḥ |	jihvā agra adarśane trīṇi dināni sthitiḥ ātmanaḥ 
MBtrisikhibrahmanopanisatHK-616	jvālayā darśane mṛtyurdvidine bhavati dhruvam || 127 ||	jvālayā darśane mṛtyuḥ dvi dine bhavati dhruvam 
MBtrisikhibrahmanopanisatHK-617	evamādīnyariṣṭāni dṛṣṭvāyuḥkṣarakāraṇam |	evamādīni ariṣṭāni dṛṣṭvā āyuḥ kṣara kāraṇam 
MBtrisikhibrahmanopanisatHK-618	niḥśreyasāya yuñjīta japadhyānaparāyaṇaḥ || 128 ||	niḥśreyasāya yuñjīta japa dhyāna parāyaṇaḥ 
MBtrisikhibrahmanopanisatHK-619	manasā paramātmānaṃ dhyātvā tadrūpatāmiyāt |	manasā paramātmānam dhyātvā tad rūpa tām iyāt 
MBtrisikhibrahmanopanisatHK-620	yadyevaṃ vāyugatijño yogī bhavati tadā svaraśāstrānurodhena	yadi evam vāyu gati jñaḥ yogī bhavati tadā svara śāstra anurodhena 
MBtrisikhibrahmanopanisatHK-621	svakālagatiṃ viditvā jñaṭiti mānasaṃ niḥśreyasāya yuñjan	sva kāla gatim viditvā jñaṭiti mānasam niḥśreyasāya yuñjan 
MBtrisikhibrahmanopanisatHK-622	anātmāpahnavasiddhaṃ paramātmānaṃ svamātramiti jñātvā	anātma apahnava siddham paramātmānam svamātram iti jñātvā 
MBtrisikhibrahmanopanisatHK-623	tadbhāvāpanno bhavedityāha- itthamiti || 119-120 ||	tad bhāva āpannaḥ bhavet iti āha ittham iti 
MBtrisikhibrahmanopanisatHK-624	kālabhedajñānopāyamāha- aṅguṣṭhādītyādinā || 121 || svavākyaṃ	kāla bheda jñāna upāyam āha aṅguṣṭha ādi ityādinā sva vākyam 
MBtrisikhibrahmanopanisatHK-625	svayameva vivṛṇoti- pādāṅguṣṭha iti || 122-128 ||	svayam eva vivṛṇoti pādāṅguṣṭhaḥ iti 
MBtrisikhibrahmanopanisatHK-626	marmasthāneṣu prāṇasya pratyāhāraḥ	marma sthāneṣu prāṇasya pratyāhāraḥ 
MBtrisikhibrahmanopanisatHK-627	yadyaṣṭādaśabhedeṣu marmasthāneṣu dhāraṇam || 129 ||	yadi aṣṭādaśa bhedeṣu marma sthāneṣu dhāraṇam 
MBtrisikhibrahmanopanisatHK-628	sthānāt sthānaṃ samākṛṣya pratyāhāraḥ sa ucyate |	sthānāt sthānam samākṛṣya pratyāhāraḥ saḥ ucyate 
MBtrisikhibrahmanopanisatHK-629	pādāṅguṣṭhaṃ tathā gulphaṃ jaṅghāmadhyaṃ tathaiva ca || 130 ||	pādāṅguṣṭham tathā gulpham jaṅghā madhyam tathā eva ca 
MBtrisikhibrahmanopanisatHK-630	madhyamūrvośca mūlaṃ ca pāyurhṛdayameva ca |	madhyam ūrvoḥ ca mūlam ca pāyuḥ hṛdayam eva ca 
MBtrisikhibrahmanopanisatHK-631	mehanaṃ dehamadhyaṃ ca nābhiṃ ca galakūrparam || 131 ||	mehanam deha madhyam ca nābhim ca galakūrparam 
MBtrisikhibrahmanopanisatHK-632	p. 145) tālumūlaṃ ca mūlaṃ ca ghrāṇasyākṣṇośca maṇḍalam |	tālu mūlam ca mūlam ca ghrāṇasya akṣṇoḥ ca maṇḍalam 
MBtrisikhibrahmanopanisatHK-633	bhrūvormadhyaṃ lalāṭaṃ ca mūlamūrdhvaṃ ca jānunī || 132 ||	bhrūvoḥ madhyam lalāṭam ca mūlam ūrdhvam ca jānunī 
MBtrisikhibrahmanopanisatHK-634	mūlaṃ ca karayormūlaṃ mahāntyetāni vai dvija |	mūlam ca karayoḥ mūlam mahānti etāni vai dvija 
MBtrisikhibrahmanopanisatHK-635	pratyāhāraprakāramāha- yadīti || 129 || kāni marmasthānānītyata	pratyāhāra prakāram āha yadi iti    kāni marma sthānāni iti atas 
MBtrisikhibrahmanopanisatHK-636	āha- pādāṅguṣṭhamiti | pādāṅguṣṭhādyaṣṭādaśasthāneṣu	āha pādāṅguṣṭham iti pādāṅguṣṭha ādi aṣṭādaśa sthāneṣu 
MBtrisikhibrahmanopanisatHK-637	ārohāvarohaṇakrameṇa prāṇaṃ pratyāharedityarthaḥ || 130-132 ||	āroha avarohaṇa krameṇa prāṇam pratyāharet iti arthaḥ 
MBtrisikhibrahmanopanisatHK-638	dhāraṇāprakāraḥ	dhāraṇā prakāraḥ 
MBtrisikhibrahmanopanisatHK-639	pañcabhūtamaye dehe bhūteṣveteṣu pañcasu || 133 ||	pañcabhūta maye dehe bhūteṣu eteṣu pañcasu 
MBtrisikhibrahmanopanisatHK-640	manaso dhāraṇaṃ yattadyuktasya ca yamādibhiḥ |	manasaḥ dhāraṇam yat tat yuktasya ca yama ādibhiḥ 
MBtrisikhibrahmanopanisatHK-641	dhāraṇā sā ca saṃsārasāgarottārakāraṇam || 134 ||	dhāraṇā sā ca saṃsāra sāgara uttāra kāraṇam 
MBtrisikhibrahmanopanisatHK-642	saṃkṣepavistārābhyāṃ dhāraṇāprakāramāha-	saṃkṣepa vistārābhyām dhāraṇā prakāram āha 
MBtrisikhibrahmanopanisatHK-643	pravibhaktapañcabhūteṣu || 133-134 ||	pravibhakta pañcabhūteṣu 
MBtrisikhibrahmanopanisatHK-644	dehāvayaveṣu pañcabhūtadhāraṇam	deha avayaveṣu pañcabhūta dhāraṇam 
MBtrisikhibrahmanopanisatHK-645	ājānupādaparyantaṃ pṛthivīsthānamiṣyate |	ājānu pāda paryantam pṛthivī sthānam iṣyate 
MBtrisikhibrahmanopanisatHK-646	pītalā caturasrā ca vasudhā vajralāñchitā || 135 ||	pītalā catur asrā ca vasudhā vajra lāñchitā 
MBtrisikhibrahmanopanisatHK-647	smartavyā pañcaghaṭikā tatrāropya prabhañjanam |	smartavyā pañca ghaṭikā tatra āropya prabhañjanam 
MBtrisikhibrahmanopanisatHK-648	ajānukaṭiparyantamapāṃ sthānaṃ prakīrtitam || 136 ||	ajānu kaṭi paryantam apām sthānam prakīrtitam 
MBtrisikhibrahmanopanisatHK-649	ardhacandrasamākāraṃ śvetamarjunalāñchitam |	ardhacandra sama ākāram śvetam arjuna lāñchitam 
MBtrisikhibrahmanopanisatHK-650	smartavyamambhaḥ śvasanamāropya daśanāḍikā || 137 ||	smartavyam ambhaḥ śvasanam āropya daśa nāḍikā 
MBtrisikhibrahmanopanisatHK-651	p. 146) ādehamadhyakaṭyantamagnisthānamudāhṛtam |	ā deha madhya kaṭi antam agni sthānam udāhṛtam 
MBtrisikhibrahmanopanisatHK-652	tatra sindūravarṇo'gnirjvalanaṃ daśa pañca ca || 138 ||	tatra sindūra varṇa ugniḥ jvalanam daśa pañca ca 
MBtrisikhibrahmanopanisatHK-653	smartavyā ghaṭikā prāṇaṃ kṛtvā kumbhe tatheritam |	smartavyā ghaṭikā prāṇam kṛtvā kumbhe tathā īritam 
MBtrisikhibrahmanopanisatHK-654	nābherupari nāsāntaṃ vāyusthānaṃ tu tatra vai || 139 ||	nābheḥ upari nāsā antam vāyusthānam tu tatra vai 
MBtrisikhibrahmanopanisatHK-655	vedikākāravaddhūmro balavān bhūtamārutaḥ |	vedikā ākāra vat dhūmraḥ balavān bhūta mārutaḥ 
MBtrisikhibrahmanopanisatHK-656	smartavyaḥ kumbhakenaiva prāṇamāropya mārutam || 140 ||	smartavyaḥ kumbhakena eva prāṇam āropya mārutam 
MBtrisikhibrahmanopanisatHK-657	ghaṭikāviṃśatistasmād ghrāṇād brahmavilāvadhi |	ghaṭikā viṃśatiḥ tasmāt ghrāṇāt 
MBtrisikhibrahmanopanisatHK-658	vyomasthānaṃ nabhastatra bhinnāñjanasamaprabham || 141 ||	vyoma sthānam nabhaḥ tatra bhinnāñjana sama prabham 
MBtrisikhibrahmanopanisatHK-659	vyomni mārutamāropya kumbhakenaiva yatnavān |	vyomni mārutam āropya kumbhakena eva yatnavān 
MBtrisikhibrahmanopanisatHK-660	svadehāvayave pṛthivyādipañcabhūtadhāraṇaṃ tatphalaṃ cāha##-	sva deha avayave pṛthivī ādi pañcabhūta dhāraṇam tad phalam ca āha 
MBtrisikhibrahmanopanisatHK-661	pañcabhūtabhautikajayaḥ | tatra mṛtyurapi na vidyate ityarthaḥ |	                        
MBtrisikhibrahmanopanisatHK-662	ābādidhāraṇākramamāha- ājānviti || 136-141 ||	āpa ādi dhāraṇā kramam āha ājānu iti 
MBtrisikhibrahmanopanisatHK-663	pṛthivyādiṣu aniruddhādidhyānaṃ tatphalaṃ ca	                  
MBtrisikhibrahmanopanisatHK-664	pṛthivyaṃśe tu dehasya caturbāhuṃ kirīṭinam || 142 ||	pṛthivī aṃśe tu dehasya catur bāhum kirīṭinam 
MBtrisikhibrahmanopanisatHK-665	aniruddhaṃ hariṃ yogī yateta bhavamuktaye |	aniruddham harim yogī yateta bhava muktaye 
MBtrisikhibrahmanopanisatHK-666	abaṃśe pūrayedyogī nārāyaṇamudagradhīḥ || 143 ||	pūrayet yogī nārāyaṇam udagra dhīḥ 
MBtrisikhibrahmanopanisatHK-667	pradyumnamagnau vāyvaṃśe saṃkarṣaṇamataḥ param |	pradyumnam agnau vāyu aṃśe saṃkarṣaṇam atas param 
MBtrisikhibrahmanopanisatHK-668	vyomāṃśe paramātmānaṃ vāsudevaṃ sadā smaret || 144 ||	vyoma aṃśe paramātmānam vāsudevam sadā smaret  /
MBtrisikhibrahmanopanisatHK-669	acirādeva tatprāptiryuñjānasya na saṃśayaḥ |	acirāt eva tad prāptiḥ yuñjānasya na saṃśayaḥ 
MBtrisikhibrahmanopanisatHK-670	p. 147) evam ādau pañcabhūtadhāraṇāṃ kṛtvā atha	evam ādau pañcabhūta dhāraṇām kṛtvā atha 
MBtrisikhibrahmanopanisatHK-671	pṛthivyādyaṃśeṣu aniruddhādīn dhyāyedityāha- pṛthivīti || 142##-	pṛthivī ādi aṃśeṣu aniruddha ādīn dhyāyet iti āha pṛthivī iti 
MBtrisikhibrahmanopanisatHK-672	paramātmadhyānaṃ tatphalaṃ ca	paramātma dhyānam tad phalam ca 
MBtrisikhibrahmanopanisatHK-673	baddhvā yogāsanaṃ pūrvaṃ hṛddeśe hṛdayāñjaliḥ || 145 ||	baddhvā yoga āsanam pūrvam hṛd deśe hṛdaya añjaliḥ 
MBtrisikhibrahmanopanisatHK-674	nāsāgranyastanayano jihvāṃ kṛtvā na tāluni |	nāsā agra nyasta nayanaḥ jihvām kṛtvā na tāluni 
MBtrisikhibrahmanopanisatHK-675	dantairdantānasaṃspṛśya ūrdhvakāyaḥ samāhitaḥ || 146 ||	dantaiḥ dantān a saṃspṛśyaḥ ūrdhva kāyaḥ samāhitaḥ 
MBtrisikhibrahmanopanisatHK-676	saṃyameccendriyagrāmamātmabuddhyā viśuddhayā |	saṃyamet ca indriya grāmam ātma buddhyā viśuddhayā 
MBtrisikhibrahmanopanisatHK-677	cintanaṃ vāsudevasya parasya paramātmanaḥ || 147 ||	cintanam vāsudevasya parasya paramātmanaḥ   
MBtrisikhibrahmanopanisatHK-678	svarūpavyāptarūpasya dhyānaṃ kaivalyasiddhidam |	sva rūpa vyāpta rūpasya dhyānam kaivalya siddhi dam 
MBtrisikhibrahmanopanisatHK-679	yāmamātraṃ vāsudevaṃ cintayet kumbhakena yaḥ || 148 ||	          
MBtrisikhibrahmanopanisatHK-680	saptajanmārjitaṃ pāpaṃ tasya naśyati yoginaḥ |	sapta janma arjitam pāpam tasya naśyati yoginaḥ 
MBtrisikhibrahmanopanisatHK-681	paramātmadhyānopāyaṃ tatphalaṃ cāha- baddhveti || 145-147	paramātma dhyāna upāyam tad phalam ca āha baddhvā iti 
MBtrisikhibrahmanopanisatHK-682	|| evaṃ dhyānāvāntaraphalamāha- yāmamātramiti || 148 || pāpaṃ	evam dhyāna avāntara phalam āha yāma mātram iti    
MBtrisikhibrahmanopanisatHK-683	tadupalakṣitāgāmyādikarmatrayam ||	            
MBtrisikhibrahmanopanisatHK-684	turīyātītaṃ vāsudevacaitanyam	            
MBtrisikhibrahmanopanisatHK-685	nābhikandāt samārabhya yāvaddhṛdayagocaram || 149 ||	nābhi kandāt samārabhya yāvat hṛdaya gocaram 
MBtrisikhibrahmanopanisatHK-686	jāgradvṛttiṃ vijānīyāt kaṇṭhasthaṃ svapnavartanam |	jāgrat vṛttim vijānīyāt kaṇṭha stham svapna vartanam 
MBtrisikhibrahmanopanisatHK-687	suṣuptaṃ tālumadhyasthaṃ turyaṃ bhrūmadhyasaṃsthitam || 150 ||	suṣuptam tālu madhya stham turyam bhrū madhya saṃsthitam 
MBtrisikhibrahmanopanisatHK-688	p. 148) turyātītaṃ paraṃ brahma brahmarandhre tu lakṣayet |	turyātītam param brahma brahmarandhre tu lakṣayet 
MBtrisikhibrahmanopanisatHK-689	jāgradvṛttiṃ samārabhya yāvadbrahmabilāntaram || 151 ||	jāgrat vṛttim samārabhya yāvat brahmabila antaram 
MBtrisikhibrahmanopanisatHK-690	tatrātmāyaṃ turīyaḥ syāt turyānte viṣṇurucyate |	tatra ātmā ayam turīyaḥ syāt turya ante viṣṇuḥ ucyate 
MBtrisikhibrahmanopanisatHK-691	vāsudevāpekṣayā turyātītaṃ bhinnam ityāśaṅkya	vāsudeva apekṣayā turyātītam bhinnam iti āśaṅkya 
MBtrisikhibrahmanopanisatHK-692	turyātītabhūmikāpradarśanapūrvakaṃ vāsudevacaitanyameva	turyātīta bhūmikā pradarśana pūrvakam vāsudeva caitanyam eva 
MBtrisikhibrahmanopanisatHK-693	turyātītamityāha- nābhīti || 149 || brahmarandhrādyasaṃbhavaprabodhataḥ	turyātītam iti āha nābhi iti brahmarandhra ādi asaṃbhava prabodhataḥ 
MBtrisikhibrahmanopanisatHK-694	turyātītameva viṣṇutattvaṃ netaradityarthaḥ || 150-151 ||	turyātītam eva viṣṇu tattvam na itarat iti arthaḥ 
MBtrisikhibrahmanopanisatHK-695	saguṇadhyānam	sa guṇa dhyānam 
MBtrisikhibrahmanopanisatHK-696	dhyānenaiva samāyukto vyomni cātyantanirmale || 152 ||	dhyānena eva samāyuktaḥ vyomni ca atyanta nirmale 
MBtrisikhibrahmanopanisatHK-697	sūryakoṭidyutidharaṃ nityoditamadhokṣajam |	sūrya koṭi dyuti dharam nitya uditam adhokṣajam 
MBtrisikhibrahmanopanisatHK-698	hṛdayāmburuhāsīnaṃ dhyāyedvā viśvarūpiṇam || 153 ||	hṛdaya amburuha āsīnam dhyāyet vā viśva rūpiṇam 
MBtrisikhibrahmanopanisatHK-699	anekākārakhacitamanekavadanānvitam |	aneka ākāra khacitam aneka vadana anvitam 
MBtrisikhibrahmanopanisatHK-700	anekabhujasaṃyuktamanekāyudhamaṇḍitam || 154 ||	aneka bhuja saṃyuktam aneka āyudha maṇḍitam 
MBtrisikhibrahmanopanisatHK-701	nānāvarṇadharaṃ devaṃ śāntamugramudāyudham |	nānā varṇa dharam devam śāntam ugram udāyudham 
MBtrisikhibrahmanopanisatHK-702	anekanayanākīrṇaṃ sūryakoṭisamaprabham || 155 ||	aneka nayana ākīrṇam sūrya koṭi sama prabham 
MBtrisikhibrahmanopanisatHK-703	dhyāyato yoginaḥ sarvamanovṛttirvinaśyati |	dhyāyataḥ yoginaḥ sarva manaḥ vṛttiḥ vinaśyati 
MBtrisikhibrahmanopanisatHK-704	saguṇanirguṇadhyānaprakāramāha- dhyāneneti || 152 || dhyāyet	sa guṇa nirguṇa dhyāna prakāram āha dhyānena iti    dhyāyet 
MBtrisikhibrahmanopanisatHK-705	yadvā virājaṃ viśvarūpiṇam || 153 || anekākārakhacitaṃ	yat vā virājam viśva rūpiṇam aneka ākāra khacitam 
MBtrisikhibrahmanopanisatHK-706	sthiracarātmakamityarthaḥ || 154-155 || vairājapadadhyānaphalamāha##-	sthira cara ātmakam iti arthaḥ 
MBtrisikhibrahmanopanisatHK-707	paryavasannatvāt mano manastvaṃ vihāya vairājapadameva bhavatītyarthaḥ ||	paryavasanna tvāt manaḥ manaḥ tvam vihāya vairāja padam eva bhavati iti arthaḥ 
MBtrisikhibrahmanopanisatHK-708	"p. 149) 				nirguṇadhyānam"	nirguṇa dhyānam 
MBtrisikhibrahmanopanisatHK-709	hṛtpuṇḍarīkamadhyasthaṃ caitanyajyotiravyayam || 156 ||	hṛd puṇḍarīka madhya stham caitanya jyotiḥ avyayam 
MBtrisikhibrahmanopanisatHK-710	kadambagolakākāraṃ turyātītaṃ parātparam |	kadamba golaka ākāram turyātītam parātparam 
MBtrisikhibrahmanopanisatHK-711	anantamānandamayaṃ cinmayaṃ bhāskaraṃ vibhum || 157 ||	anantam ānanda mayam cit mayam bhāskaram vibhum 
MBtrisikhibrahmanopanisatHK-712	nivātadīpasadṛśamakṛtrimamaṇiprabham |	nivāta dīpa sadṛśam akṛtrima maṇi prabham 
MBtrisikhibrahmanopanisatHK-713	dhyāyato yoginastasya muktiḥ karatale sthitā || 158 ||	dhyāyataḥ yoginaḥ tasya muktiḥ kara tale sthitā 
MBtrisikhibrahmanopanisatHK-714	nirguṇadhyānamāha- hṛditi | hṛtpuṇḍarīkamadhye	nirguṇa dhyānam āha hṛd iti hṛd puṇḍarīka madhye 
MBtrisikhibrahmanopanisatHK-715	pratyagrūpeṇa tiṣṭhatīti hṛtpuṇḍarīkamadhyastham | hṛtsaṃbandhāt	pratyak rūpeṇa tiṣṭhati iti hṛd puṇḍarīka madhya stham hṛd saṃbandhāt 
MBtrisikhibrahmanopanisatHK-716	jaḍatvaprasaktau caitanyajyotiḥ | tasya vāśrayanāśāt vyayaprasaktau	jaḍa tva prasaktau caitanya jyotiḥ tasya vā āśraya nāśāt vyaya prasaktau 
MBtrisikhibrahmanopanisatHK-717	avyayam || 156 || kadambagolakavat ākāro yasya sahasrārasya tat	avyayam    kadamba golaka vat ākāraḥ yasya sahasrārasya tat 
MBtrisikhibrahmanopanisatHK-718	kadambagolakākāram | turīyaṃ mūrdhni saṃsthitam iti śrutyanurodhena tatra	kadamba golaka ākāram turīyam mūrdhni saṃsthitam iti śruti anurodhena tatra 
MBtrisikhibrahmanopanisatHK-719	upalabhyamānaturīyasya tadākṛtītvaṃ yujyata evetyarthaḥ |	upalabhyamāna turīyasya tad ākṛti tvam yujyate eva iti arthaḥ 
MBtrisikhibrahmanopanisatHK-720	tadupādhyabhāve tadeva turīyātītaṃ parāt turīyādapi param, anantaṃ	tad upādhi abhāve tat eva turīya atītam parāt turīyāt api param anantam 
MBtrisikhibrahmanopanisatHK-721	paricchedatrayābhāvāt, deśataḥ kālato vastutaḥ paricchedarahitaṃ	pariccheda traya abhāvāt deśataḥ kālataḥ vastutas pariccheda rahitam 
MBtrisikhibrahmanopanisatHK-722	brahma iti śruteḥ | ānandamayaṃ, paramānandasvarūpatvāt |	brahma iti śruteḥ ānanda mayam paramānanda svarūpa tvāt 
MBtrisikhibrahmanopanisatHK-723	cinmayaṃ, cinmātratvāt | khadyotādisūryāntabhāsāmapi	cit mayam cit mātra tvāt khadyota ādi sūrya anta bhāsām api 
MBtrisikhibrahmanopanisatHK-724	bhāsakākāratvāt bhāskaram | vidvaddṛṣṭyā brahmamātraṃ bhavatīti	bhāsaka ākāra tvāt bhāskaram vidvat dṛṣṭyā brahma mātram bhavati iti 
MBtrisikhibrahmanopanisatHK-725	vibhum || 157 || nivātadīpasadṛśam, ākāśavadacalatvāt |	vibhum    nivāta dīpa sadṛśam ākāśa vat acala tvāt 
MBtrisikhibrahmanopanisatHK-726	akṛtrimakaustubhādimaṇiprabhaṃ prakāśamātramityarthaḥ | ya	akṛtrima kaustubha ādi maṇi prabham prakāśa mātram iti arthaḥ yaḥ 
MBtrisikhibrahmanopanisatHK-727	evaṃviśeṣaṇaviśiṣṭaṃ brahma svamātradhiyā dhyāyati tasya eva evaṃ	evam viśeṣaṇa viśiṣṭam brahma sva mātra dhiyā dhyāyati tasya eva evam 
MBtrisikhibrahmanopanisatHK-728	dhyāyato yogino muktiḥ videhamuktiḥ kare sthitā,	dhyāyataḥ yoginaḥ muktiḥ videha muktiḥ kare sthitā 
MBtrisikhibrahmanopanisatHK-729	tadbhāvāpannatvādityarthaḥ || 158 ||	tad bhāva āpanna tvāt iti arthaḥ 
MBtrisikhibrahmanopanisatHK-730	saviśeṣajñānasyāpi muktihetutvam	           
MBtrisikhibrahmanopanisatHK-731	viśvarūpasya devasya rūpaṃ yatkiṃcideva hi |	viśva rūpasya devasya rūpam yat kiṃcid eva hi 
MBtrisikhibrahmanopanisatHK-732	sthavīyaḥ sūkṣmamanyadvā paśyan hṛdayapaṅkaje || 159 ||	sthavīyaḥ sūkṣmam anyat vā paśyan hṛdaya paṅkaje 
MBtrisikhibrahmanopanisatHK-733	p. 150) dhyāyato yogino yastu sākṣādeva prākāśate |	dhyāyataḥ yoginaḥ yaḥ tu sākṣāt eva prākāśate 
MBtrisikhibrahmanopanisatHK-734	aṇimādiphalaṃ caiva sukhenaivopajāyate || 160 ||	aṇima ādi phalam ca eva sukhena eva upajāyate 
MBtrisikhibrahmanopanisatHK-735	jīvātmanaḥ parasyāpi yadyevamubhayorapi |	jīvātmanaḥ parasya api yadi evam ubhayoḥ api 
MBtrisikhibrahmanopanisatHK-736	ahameva paraṃ brahma brahmāhamiti saṃsthitiḥ || 161 ||	aham eva param brahma brahma aham iti saṃsthitiḥ 
MBtrisikhibrahmanopanisatHK-737	samādhiḥ sa tu vijñeyaḥ sarvavṛttivivarjitaḥ |	samādhiḥ sa tu vijñeyaḥ sarva vṛtti vivarjitaḥ 
MBtrisikhibrahmanopanisatHK-738	brahma saṃpadyate yogī na bhūyaḥ saṃsṛtiṃ brajet || 162 ||	brahma saṃpadyate yogī na bhūyas saṃsṛtim brajet   
MBtrisikhibrahmanopanisatHK-739	evaṃ viśodhya tattvāni yogī niḥspṛhacetasā |	evam viśodhya tattvāni yogī niḥspṛha cetasā 
MBtrisikhibrahmanopanisatHK-740	yathā nirindhano vahniḥ svayameva praśāmyati || 163 ||	yathā nirindhanaḥ vahniḥ svayam eva praśāmyati 
MBtrisikhibrahmanopanisatHK-741	grāhyābhāve manaḥprāṇo niścayajñānasaṃyutaḥ |	grāhya abhāve manaḥ prāṇaḥ niścaya jñāna saṃyutaḥ 
MBtrisikhibrahmanopanisatHK-742	śuddhatattve pare līno jīvaḥ saindhavapiṇḍavat || 164 ||	śuddha tattve pare līnaḥ jīvaḥ saindhava piṇḍa vat 
MBtrisikhibrahmanopanisatHK-743	mohajālakasaṃghātaṃ viśvaṃ paśyati svapnavat |	moha jālaka saṃghātam viśvam paśyati svapna vat 
MBtrisikhibrahmanopanisatHK-744	suṣuptivadyaścarati svabhāvapariniścalaḥ || 165 ||	suṣupti vat yaḥ carati svabhāva pariniścalaḥ 
MBtrisikhibrahmanopanisatHK-745	nirvāṇapadamāśritya yogī kaivalyamaśnute ||	nirvāṇa padam āśritya yogī kaivalyam aśnute 
MBtrisikhibrahmanopanisatHK-746	ityupaniṣat ||	iti upaniṣad 
MBtrisikhibrahmanopanisatHK-747	nirviśeṣajñānina eva muktiḥ na hi saviśeṣajñāninaḥ ityāśaṅkya	nirviśeṣa jñāninaḥ eva muktiḥ na hi saviśeṣa jñāninaḥ iti āśaṅkya 
MBtrisikhibrahmanopanisatHK-748	saviśeṣajñānasya nirviśeṣajñānahetutayā tasyāpi muktihetutvaṃ	                   
MBtrisikhibrahmanopanisatHK-749	siddhimityāha- viśvarūpaśyeti || 159 || aṇimādiphalaṃ	siddhim iti āha aṇima ādi phalam 
MBtrisikhibrahmanopanisatHK-750	sakāmasyetyarthaḥ | yadi niṣkāmaḥ tadā tasya	sa kāmasya iti arthaḥ yadi niṣkāmaḥ tadā tasya 
MBtrisikhibrahmanopanisatHK-751	pratyagabhinnabrahmanirvikalpakasamādhiḥ syāditi || 160 ||	             
MBtrisikhibrahmanopanisatHK-752	samādhilakṣaṇamapyāha- jīveti | abrahmatvānātmatvaprasaktau	samādhi lakṣaṇam api āha jīva iti abrahmatva anātmatva prasaktau 
MBtrisikhibrahmanopanisatHK-753	tannirasanāya tayoḥ ekatvaprabodhāya ca vyatihāreṇa ahameva paraṃ brahma	tad nirasanāya tayoḥ ekatva prabodhāya ca vyatihāreṇa aham eva param brahma 
MBtrisikhibrahmanopanisatHK-754	brahmāhamiti pratyagabhinnabrahmarūpeṇa	brahma aham iti pratyagabhinna brahma rūpeṇa 
MBtrisikhibrahmanopanisatHK-755	p. 151) avasthānāsaṃprajñātanirvikalpakasamādhiḥ | evaṃ	            
MBtrisikhibrahmanopanisatHK-756	nirvikalpakasamādhibalāt	         
MBtrisikhibrahmanopanisatHK-757	parāksāpekṣapratyagabhinnabrahmagataviśeṣāsaṃbhavaprabodhasiddhaṃ	                                              
MBtrisikhibrahmanopanisatHK-758	brahma saṃpadyate || 161-162 || kena brahma saṃpadyate ityatra-	brahma saṃpadyate    kena brahma saṃpadyate iti atra 
MBtrisikhibrahmanopanisatHK-759	evamiti | svātiriktaspṛhāviralacetasā brahma saṃpadyate ityarthaḥ | mana##-	evam iti sva atirikta spṛhā virala cetasā brahma saṃpadyate iti arthaḥ 
MBtrisikhibrahmanopanisatHK-760	viṣpratiyogikabrahmamātraprabodhasamakālam ābhāsato vāpi	viṣpratiyogika brahma mātra prabodha sama kālam ābhāsataḥ vā api 
MBtrisikhibrahmanopanisatHK-761	karaṇagrāmo'stīti yadi bhrāntiḥ tadā tacchāntiḥ bhavediti	karaṇa grāmaḥ asti iti yadi bhrāntiḥ tadā tad śāntiḥ bhavet iti 
MBtrisikhibrahmanopanisatHK-762	sadṛṣṭāntamāha- yatheti | praśāmyate śāmyati || 163 || kutaḥ ?	sa dṛṣṭāntam āha yathā iti praśāmyate śāmyati        kutas 
MBtrisikhibrahmanopanisatHK-763	svātirekeṇa grāhyābhāve prāṇopādhikaḥ śuddhasatve pare līno jīvaḥ	sva atirekeṇa grāhya abhāve prāṇa upādhikaḥ śuddha satve pare līnaḥ jīvaḥ 
MBtrisikhibrahmanopanisatHK-764	salilasaindhavapiṇḍavat jīvabhāvaṃ vihāya brahmībhūto bhavatītyarthaḥ ||	salila saindhava piṇḍa vat jīva bhāvam vihāya brahmībhūtaḥ bhavati iti arthaḥ 
MBtrisikhibrahmanopanisatHK-765	164 || yadi svātiriktaviśvasphūrtiḥ syāt tadā tatsphūrtau moha ityādi |	                  
MBtrisikhibrahmanopanisatHK-766	tadasphūrtau suṣuptivadyaścarati saḥ svabhāvapariniścalaḥ || 165 ||	tad asphūrtau suṣupti vat yaḥ carati saḥ svabhāva pariniścalaḥ 
MBtrisikhibrahmanopanisatHK-767	svātiriktaviśvasphūrtyapahnavasiddhaniṣpratiyogikabrahmamātratayā	                                                                                                                               
MBtrisikhibrahmanopanisatHK-768	avasthānaṃ yat tat nirvāṇapadam | evaṃ brahmamātrajñānayogī	avasthānam yat tat nirvāṇa padam evam brahma mātra jñāna yogī 
MBtrisikhibrahmanopanisatHK-769	jñānasamakālaṃ kaivalyarūpeṇa avaśiṣyate ityarthaḥ | ityupaniṣacchabdaḥ	jñāna sama kālam kaivalya rūpeṇa avaśiṣyate iti arthaḥ iti upaniṣad śabdaḥ 
MBtrisikhibrahmanopanisatHK-770	triśikhibrāhmaṇopaniṣatsamāptyarthaḥ ||	             
MBtrisikhibrahmanopanisatHK-771	śrīvāsudevendraśiṣyopaniṣadbrahmayoginā |	              
MBtrisikhibrahmanopanisatHK-772	prakṛtopaniṣadvyākhyā likhitā sphuṭato laghu ||	prakṛta upaniṣad vyākhyā likhitā sphuṭataḥ laghu 
MBtrisikhibrahmanopanisatHK-773	prakṛtopaniṣadvyākhyā ṣaṣṭyuttaraśatatrayam ||	prakṛtā upaniṣad vyākhyā ṣaṣṭi uttara śata trayam 
MBtrisikhibrahmanopanisatHK-774	iti śrīmadīśādyaṣṭottaraśatopaniṣacchāstravivaraṇe	iti śrīmat īśa ādi aṣṭottaraśata upaniṣad śāstra vivaraṇe 
MBtrisikhibrahmanopanisatHK-775	catuścatvāriṃśatsaṃkhyāpūrakaṃ triśikhibrāhmaṇopaniṣadvivaraṇaṃ	catuścatvāriṃśat saṃkhyā pūrakam triśikhibrāhmaṇa upaniṣad vivaraṇam 
MBtrisikhibrahmanopanisatHK-776	saṃpūrṇam	saṃpūrṇam 
MBtrisikhibrahmanopanisatHK-777	MUKTABODHA INDOLOGICAL RESEARCH INSTITUTE©2011 Muktabodha Indological Research Institute  All Rights Reserved.E-texts may be viewed only online or downloaded for private study.E-texts may not, under any circumstances, be copied, republished,reproduced, distributed or sold, either in original or altered form, withoutthe express permission of Muktabodha Indological Research Institute in writing.Data-entered by the staff of Muktabodha under the direction of Mark S. G. Dyczkowski.	muktabodha indological research muktabodha indological research institute all rights reserved texts may be viewed only online or downloaded for private studye texts may not under any circumstances be copied republished reproduced distributed or sold either in original or altered form withoutthe express permission of muktabodha indological research institute in writing data entered by the staff of muktabodha under the direction of mark s g dyczkowski 
