segmentnr	original	analyzed
MBvyomavyaapistavaHK-0	Muktabodha E-text in UTF-8	muktabodha etext in utf
MBvyomavyaapistavaHK-1	###########################################################################MUKTABODHA INDOLOGICAL RESEARCH INSTITUTEwww.muktabodha.org©2011 Muktabodha Indological Research Institute  All Rights Reserved.E-texts may be viewed only online or downloaded for private study.E-texts may not, under any circumstances, be copied, republished,reproduced, distributed or sold, either in original or altered form, withoutthe express permission of Muktabodha Indological Research Institute in writing.Data-entered by the staff of Muktabodha under the direction of Mark S. G. Dyczkowski.Catalog number : M00059	muktabodha indological research muktabodha indological research institute all rights reserved texts may be viewed only online or downloaded for private studye texts may not under any circumstances be copied republished reproduced distributed or sold either in original or altered form withoutthe express permission of muktabodha indological research institute in writing data entered by the staff of muktabodha under the direction of mark s g dyczkowskicatalog number  /
MBvyomavyaapistavaHK-2	Uniform title: vyomavyāpistava	uniform title vyomavyāpi tava 
MBvyomavyaapistavaHK-3	Main title: vyomavyāpistava with the commentary laghuṭīkā	main title vyomavyāpi stava with the commentary laghuṭīkā 
MBvyomavyaapistavaHK-4	Author : bhaṭṭarāmakaṇṭha	authoḥ bhaṭṭa rāmakaṇṭha 
MBvyomavyaapistavaHK-5	Commentator : vedajñāna	veda jñāna 
MBvyomavyaapistavaHK-6	Manuscript : IFP transcript T0128 which itself is copied from a paper manuscript of vyomavyaapistavam belonging to tiruvavaduthurai adheenam. tiruvavaduthurai	manuscript ifp transcript  which itself is copied from a paper manuscript of vyomavyaapistavam belonging to tiruvavaduthurai adheenam tiruvavaduthurai 
MBvyomavyaapistavaHK-7	Notes: Data entered by the staff of Muktabodha under the supervision of Mark S. G. Dyczkowski.	notes data entered by the staff muktabodha under the supervision of mark s g dyczkowski 
MBvyomavyaapistavaHK-8	Revision 0 February 13, 2009	revision february 
MBvyomavyaapistavaHK-9	Publication country : India	publication country india 
MBvyomavyaapistavaHK-10	vyomavyāpistavaḥ	        
MBvyomavyaapistavaHK-11	37) vyomavyāpistavam	        
MBvyomavyaapistavaHK-12	|| śrībhaṭṭāraka praṇītaṃ vyomavyāpistavam ||	śrī bhaṭṭāraka praṇītam vyomavyāpi stavam 
MBvyomavyaapistavaHK-13	|| śrīvedajñāna racita laghuṭippaṇīyutam ||	           
MBvyomavyaapistavaHK-14	kapola syandi dānaugha lolākeli samākulam |	kapola syandi dāna ogha lolākeli samākulam 
MBvyomavyaapistavaHK-15	cirācalamudaṃ vande cirācalagajānanam || 1 ||	         
MBvyomavyaapistavaHK-16	ādau darśitamāśumuktidatayā hastena cālambinā	ādau darśitam āśu mukti da tayā hastena ca ālambinā 
MBvyomavyaapistavaHK-17	viśvāsaṃtviha sābhayena gamitaṃ satyāvataṃ sāgninā ||	viśvāsam tu iha sa abhayena gamitam satyāvatam sa agninā 
MBvyomavyaapistavaHK-18	indraṃ bhaḍḍamarū svanena mahatā saṃghena taṃ yatpunasta-	indram bhaṭ ḍamarū svanena mahatā saṃghena tam yat punar ta 
MBvyomavyaapistavaHK-19	tsauvarṇa sabhāpate khatunaśśrīmatpadāṃbhoruham || 2 ||	tsauvarṇa sabhāpate khatunaḥ śrīmat pada aṃbhoruham 
MBvyomavyaapistavaHK-20	guruṇā rāmakaṇṭhena kṛtasya śiśu bodhinīm |	guruṇā rāmakaṇṭhena kṛtasya śiśu bodhinīm 
MBvyomavyaapistavaHK-21	vyomavyāpistavasyaikāṃ laghuṭīkāṃ samārabhe || 3 ||	vyomavyāpi stavasya ekām laghu ṭīkām samārabhe 
MBvyomavyaapistavaHK-22	atra hi etatstotrapadāni viduṣāṃ sammativacanapradarśanamātreṇa spaṣṭā	atra hi etad stotra padāni viduṣām sammati vacana pradarśana mātreṇa spaṣṭā 
MBvyomavyaapistavaHK-23	bhavanti | tādṛśa vacanāni sarvāṇi pratyāryādaśakaṃ ekayāhelayā	bhavanti tādṛśa vacanāni sarvāṇi pratyāryādaśakam ekayāhelayā 
MBvyomavyaapistavaHK-24	p. 2) tattadghaṭakānteṣu bṛhaṭṭīkāyāṃ krameṇa sammatiṃ	               
MBvyomavyaapistavaHK-25	darśayiṣyāmaḥ |	darśayiṣyāmaḥ 
MBvyomavyaapistavaHK-26	idānīntu śiśu bodhāya anvayamātra pradarśana mātratayā	idānīntu śiśu bodhāya anvaya mātra pradarśana mātra tayā 
MBvyomavyaapistavaHK-27	diṅmātrameva tāni stotra padāni vyākhyāyante | tathā hi	diś mātram eva tāni stotra padāni vyākhyāyante tathā hi 
MBvyomavyaapistavaHK-28	ihatāvadanavarata vighṛta śivāgama svarṇa dāma kaṇṭhaḥ rāmakaṇṭho	ihatāvat anavarata vighṛta śivāgama svarṇa dāma kaṇṭhaḥ rāmakaṇṭhaḥ 
MBvyomavyaapistavaHK-29	nāma deśikaṃ puṃgavaḥ rurugīta nava nābhamaṇḍalavartiṣu	nāma deśikam puṃgavaḥ nava nābha maṇḍala vartiṣu 
MBvyomavyaapistavaHK-30	madhyādīśānteṣu nava pada samāhārātmakeṣu navakamala pīṭheṣu	madhya ādi īśa anteṣu nava pada samāhāra ātmakeṣu nava kamala pīṭheṣu 
MBvyomavyaapistavaHK-31	sakalapāśa jāla hanana karaṇabhūtasya acintya mahimākārasya	sakala pāśa jāla hanana karaṇa bhūtasya acintya mahima ākārasya 
MBvyomavyaapistavaHK-32	sāṣṭaṣaṣṭitriśata varṇātmaka vyomavyāpimantra rājasya	varṇa ātmaka vyomavyāpimantra rājasya 
MBvyomavyaapistavaHK-33	avayavabhūtānāṃ ekāśīti saṃkhyakānāṃ padānāṃ pūjanāya	avayava bhūtānām ekāśīti saṃkhyakānām padānām pūjanāya 
MBvyomavyaapistavaHK-34	pareṣāmapi tadupāsakānāṃ tādṛśa pūjā siddhaye paramaśiva	pareṣām api tad upāsakānām pūjā siddhaye paramaśiva 
MBvyomavyaapistavaHK-35	vācakatva sphorakatayā pratipadaṃ ekaikayā āryayā vyomavyāpistava	pratipadam ekaikayā āryayā vyomavyāpiḥ tava 
MBvyomavyaapistavaHK-36	nāmakaṃ stuti bandhamāracayati oṃkāravācyamityādina	nāmakam stuti bandham āracayati oṃkāra vācyam ityādinā 
MBvyomavyaapistavaHK-37	navatisaṃkhyābhiḥ āryābhiḥ |	navati saṃkhyābhiḥ āryābhiḥ 
MBvyomavyaapistavaHK-38	atredaṃ boddhavyam | ruruvarṇitaṃ navanābhamekaṃ maṇḍalaṃ	atra idam boddhavyam ruru varṇitam nava nābham ekam maṇḍalam 
MBvyomavyaapistavaHK-39	tanmadhye madhyakarṇikaṃ aṣṭadalayuktaṃ kamalaṃ ekapīṭhaṃ	tad madhye madhya karṇikam aṣṭadala yuktam kamalam eka pīṭham 
MBvyomavyaapistavaHK-40	tatpūrvādīśānāntā sudikṣu tādṛśaṃ kamalaṃ ekamekaṃ evaṃ	tad pūrva ādi īśāna antā su dikṣu tādṛśam kamalam ekam ekam evam 
MBvyomavyaapistavaHK-41	navakamalapīṭhāni bhavanti | tatra kamalapīṭhe karṇikādīśāna dalānteṣu	nava kamala pīṭhāni bhavanti tatra kamala pīṭhe karṇikā ādi īśāna dala anteṣu 
MBvyomavyaapistavaHK-42	navapadeṣu mantrarājasya oṃkārādīni nava padāni krameṇa	nava padeṣu mantrarājasya oṃkāra ādīni nava padāni krameṇa 
MBvyomavyaapistavaHK-43	pūjanīyānīti | tatpūjāyāṃ āryānavakasya krameṇa viniyogaḥ evaṃ	pūjanīyāni iti tad pūjāyām āryā navakasya krameṇa viniyogaḥ evam 
MBvyomavyaapistavaHK-44	pūrvādīśāntakamalapīṭheṣvapi pratipīṭhaṃ ekaikamāryādaśakaṃ	pūrva ādi īśa anta kamala pīṭheṣu api pratipīṭham ekaikam āryā daśakam 
MBvyomavyaapistavaHK-45	viniyojyam | evaṃ navati saṃkhyānāṃ āryāṇāṃ upayogaḥ |	viniyojyam evam navati saṃkhyānām āryāṇām upayogaḥ 
MBvyomavyaapistavaHK-46	evaṃ navanābhamaṇḍalasvarūpaṃ kalottarādau varṇitam | tadyathā 	evam nava nābha maṇḍala svarūpam kalā uttara ādau varṇitam tat yathā 
MBvyomavyaapistavaHK-47	athācāryābhiṣekārthaṃ navanābhaṃ vivartayet |	atha ācārya abhiṣeka artham nava nābham vivartayet 
MBvyomavyaapistavaHK-48	kāmyānāmapi sarveṣāṃ navanābhaṃ phalapradam || 4 ||	kāmyānām api sarveṣām nava nābham phala pradam 
MBvyomavyaapistavaHK-49	mataṃge 	mataṃge 
MBvyomavyaapistavaHK-50	anyadguhyatamaṃ vakṣye kramādaśraṃ samaṃ śubham |	anyat guhyatamam vakṣye samam śubham 
MBvyomavyaapistavaHK-51	vibhajya saptabhirbhāgairmadhye padmaṃ prakalpayet || 5 ||	vibhajya saptabhiḥ bhāgaiḥ madhye padmam prakalpayet 
MBvyomavyaapistavaHK-52	dvātriṃśadaṅgulasamaṃ suvibhaktantu pūrvavat |	dvātriṃśat aṅgula samam pūrvavat 
MBvyomavyaapistavaHK-53	p. 4) bhāgamekaṃ parityajya dikṣvaṣṭasu yathākramam || 6 ||	bhāgam ekam parityajya dikṣu aṣṭasu yathākramam 
MBvyomavyaapistavaHK-54	madhyāṃbuja pramāṇāni padānyaṣṭau samālikhet |	madhya aṃbuja pramāṇāni padāni aṣṭau samālikhet 
MBvyomavyaapistavaHK-55	caturdikṣudvayaṃ bhāgaṃ aṣṭadvāramathoditaiḥ || 7 ||	catur dikṣu dvayam bhāgam aṣṭa dvāram atha uditaiḥ 
MBvyomavyaapistavaHK-56	rajobhiḥ pūrayet samyagyathābhavati śobhanam |	rajobhiḥ pūrayet samyak yathā bhavati śobhanam 
MBvyomavyaapistavaHK-57	ekāśītipadaṃ devaṃ nava parvoktidarśanāt || 8 ||	ekāśīti padam devam nava parva ukti darśanāt 
MBvyomavyaapistavaHK-58	pūjayettantramantrajñaśśiva vaktokti vartmanā |	pūjayet tantra mantra jñaḥ śiva vartmanā 
MBvyomavyaapistavaHK-59	39) tatsvarūpaṃ kālottare spaṣṭamuktam |	tad svarūpam kālottare spaṣṭam uktam 
MBvyomavyaapistavaHK-60	madhye tu kamalaṃ śuklaṃ pītantatpūrvagocare || 9 ||	madhye tu kamalam śuklam pītam tat pūrva gocare 
MBvyomavyaapistavaHK-61	āgneryāṃ raktavarṇantu nīlabjaṃ dakṣiṇesthitam |	āgneryām nīla bjam dakṣiṇe sthitam 
MBvyomavyaapistavaHK-62	naiṛtyāṃ pītavarṇantu śuklaṃ varuṇadiksthitam || 10 ||	naiṛtyām śuklam varuṇa diś sthitam 
MBvyomavyaapistavaHK-63	ādhūmraṃ vāyukoṇe tu raktapītaṃ tathottare |	ādhūmram vāyu koṇe tu rakta pītam tathā uttare 
MBvyomavyaapistavaHK-64	īśāne mauktikaprakhyaṃ śuklaṃ vā dik sthitaṃ nava || 11 ||	īśāne mauktika prakhyam śuklam vā diś sthitam nava 
MBvyomavyaapistavaHK-65	p. 5) padmarāgamathovāpi raktagauramathāpi vā |	padmarāgam atha u vā api rakta gauram atha api vā 
MBvyomavyaapistavaHK-66	vyomavyāpi śivasyaiva navādhvaravidhauhitam || 12 ||	vyoma vyāpi śivasya eva nava adhvara vidhau hitam 
MBvyomavyaapistavaHK-67	navanābhaṃ samākhyātaṃ prāsādākhya śivasya tu |	nava nābham samākhyātam śivasya tu 
MBvyomavyaapistavaHK-68	madhyapadme śivaḥ pūjyaḥ lokeśāśca pareṣu ca || 13 ||	madhya padme śivaḥ pūjyaḥ lokeśāḥ ca pareṣu ca 
MBvyomavyaapistavaHK-69	astrāṇi bāhya vīdhau tu bhaktyā saṃpūjayettataḥ |	astrāṇi bāhya vīdhau tu bhaktyā saṃpūjayet tatas 
MBvyomavyaapistavaHK-70	nāsau liṃpati pāvena padmapatramivāṃbhasā || 14 ||	na asau liṃpati pāvena padma patram iva aṃbhasā 
MBvyomavyaapistavaHK-71	nitye naimittike kāmye kartavyaṃ bhuktimuktaye |	nitye naimittike kāmye kartavyam bhukti muktaye 
MBvyomavyaapistavaHK-72	tathā trilocana śivācāryairapyuktam 	tathā trilocana śiva ācāryaiḥ api uktam 
MBvyomavyaapistavaHK-73	kṣetre saptapadīkṛte śaśipadaṃ vidhīssamantāptadaiḥ (vīthī-)	kṣetre saptapadīkṛte śaśi padam vidhīḥ samanta āpta daiḥ vīthī 
MBvyomavyaapistavaHK-74	dikṣvāṣṭasu ca paṃkajāni parito vīthīndubhāgena ca |	dikṣu ā aṣṭasu ca paṃkajāni paritas vīthi indu bhāgena ca 
MBvyomavyaapistavaHK-75	dvārāṇyaṣṭa kajāntara sthitapadairantasthito gātrakaṃ	dvārāṇi aṣṭa kaja antara sthita padaiḥ antasthitaḥ gātrakam 
MBvyomavyaapistavaHK-76	padmaṃ syānnavanābhamaṇḍalamidaṃ śrīmanmataṃgoditam || 15 ½ ||	padmam syāt nava nābha maṇḍalam idam śrīmat mataṃga uditam 
MBvyomavyaapistavaHK-77	p. 6)	p 
MBvyomavyaapistavaHK-78	nanu sāṣṭaṣaṣṭi triśatākṣarādhika sahasrākṣara kayutākṣarādi	nanu sa aṣṭaṣaṣṭi tri śata akṣara adhika sahasra akṣara ka yuta akṣara ādi 
MBvyomavyaapistavaHK-79	mantreṣu vyomavyāpipadastuti bandhaḥ kimarthamācāryeṇa kṛtamiti	mantreṣu vyoma vyāpi pada stuti bandhaḥ kimartham ācāryeṇa kṛtam iti 
MBvyomavyaapistavaHK-80	cenmaivam | saptakoṭi mahāmantreṣvapi vyomavyāpi padamantresyaivamantra	ced mā evam mahāmantreṣu api vyoma vyāpi 
MBvyomavyaapistavaHK-81	rājatayā āgameṣu mahāmahima varṇanāt | tathaiva kālottare mantrādhva	rājatayā āgameṣu mahā mahima varṇanāt tathā eva kālottare mantrādhva 
MBvyomavyaapistavaHK-82	paṭale mantra rājatvaṃ asyaiva varṇitam | tadyathā 	paṭale mantra rāja tvam asya eva varṇitam tat yathā 
MBvyomavyaapistavaHK-83	mantrādhvānamahaṃ vakṣye sāṃprataṃ śṛṇu ṣaṇmukha ||	mantrādhvānam aham vakṣye sāṃpratam śṛṇu ṣaṇmukha 
MBvyomavyaapistavaHK-84	saptakoṭi sahasrāṇi koṭilakṣaṃ tathaiva ca |	sapta koṭi sahasrāṇi koṭi lakṣam tathā eva ca 
MBvyomavyaapistavaHK-85	ayutāni ca ṣaṭtriṃśatsadyojātādvinirgatāḥ || 17 ||	ayutāni ca ṣaṭtriṃśat sadyojātāt vinirgatāḥ 
MBvyomavyaapistavaHK-86	viṃśatkoṭi sahasrāṇi koṭilakṣantathaiva ca |	viṃśat koṭi sahasrāṇi ca 
MBvyomavyaapistavaHK-87	niyutāni catuṣṣaṣṭiḥ vāmadevādviniṣkṛtāḥ || 18 ||	niyutāni catuḥṣaṣṭiḥ vāmadevāt viniṣkṛtāḥ 
MBvyomavyaapistavaHK-88	catvāriṃśatkakoṭistu sahasrāṇi tathaiva ca |	catvāriṃśatka koṭiḥ tu sahasrāṇi tathā eva ca 
MBvyomavyaapistavaHK-89	trikoṭi lakṣaṃ vai vatsa aghorācca vinirgatāḥ || 19 ||	trikoṭi lakṣam vai vatsa aghorāt ca vinirgatāḥ 
MBvyomavyaapistavaHK-90	p. 7) aśītikoṭi sāhasraṃ catasraṃ koṭi lakṣakam |	p 
MBvyomavyaapistavaHK-91	tatpuruṣādviniṣkrāntaṃ mantrabhedaṃ ṣaḍānana || 20 ||	tatpuruṣāt viniṣkrāntam mantra bhedam ṣaḍānana 
MBvyomavyaapistavaHK-92	kalpakoṭisahasrāṇi kalpakoṭiśatāni ca |	kalpa koṭi sahasrāṇi kalpa koṭi śatāni ca 
MBvyomavyaapistavaHK-93	īśānasya mukhājjātaṃ anantaṃ mantrajālakam || 21 ||	īśānasya mukhāt jātam anantam mantra jālakam 
MBvyomavyaapistavaHK-94	īśānamukhaniṣkrāntaṃ mantrajātaṃ sudurlabham |	īśāna mukha niṣkrāntam mantra jātam su durlabham 
MBvyomavyaapistavaHK-95	ekāśīti padaṃhyetattantrarājaṃtvanuttamam || 22 ||	ekāśīti padam hi etat tantra rājam tu anuttamam 
MBvyomavyaapistavaHK-96	triśataṃ piṣṭyadhikākṣaraṃ vyomavyāpīti saṃjñitam |	tri śatam piṣṭi adhika akṣaram vyomavyāpi iti saṃjñitam 
MBvyomavyaapistavaHK-97	īśāna mūrdhni saṃjātaṃ vyomavyāpipadaṃ mahat || 23 ||	īśāna mūrdhni saṃjātam vyoma vyāpi padam mahat 
MBvyomavyaapistavaHK-98	40) ekāśīti padammantraṃ sarvamantrottamottamam |	ekāśīti sarva mantra uttamottamam 
MBvyomavyaapistavaHK-99	akṣarāṇāṃ śatatrayaṃ ṣaṣṭyadhikamanuttamam || 24 ||	akṣarāṇām śata trayam ṣaṣṭi adhikam anuttamam 
MBvyomavyaapistavaHK-100	arcane homakāle ca snānakāle japedguha |	arcane homa kāle ca snāna kāle japet guha 
MBvyomavyaapistavaHK-101	pratiṣṭhā prokṣaṇekāle dīkṣākāle tu vai japet || 25 ||	pratiṣṭhā prokṣaṇe kāle dīkṣā kāle tu vai japet  /
MBvyomavyaapistavaHK-102	p. 8) vasordhāre bhūmidāhe tathācodbhuta śāntike |	vasordhāre bhūmi dāhe śāntike 
MBvyomavyaapistavaHK-103	anāvṛṣṭau bhūmikaṃpe sarvotpātau tu vai japet || 26 ||	anāvṛṣṭau bhūmikaṃpe sarva utpātau tu vai japet 
MBvyomavyaapistavaHK-104	duḥsvapne durjana sparśe sakṛjjaptvāpramucyati |	duḥsvapne durjana sparśe sakṛt japtvā apramucyati 
MBvyomavyaapistavaHK-105	īśānamantro vaivatsa vyomavyāpi vinirgataḥ || 27 ||	īśāna mantraḥ vaivat sa vyoma vyāpi vinirgataḥ 
MBvyomavyaapistavaHK-106	īśānamūrdhamantraistu makuṭādīṃśca pūjayet |	īśāna mūrdha mantraiḥ tu makuṭa ādīn ca pūjayet 
MBvyomavyaapistavaHK-107	tatpuruṣavaktraja sahasrākṣaramantraja tatpuruṣamantrasya	tatpuruṣa vaktra ja sahasra akṣara mantra ja tatpuruṣa mantrasya 
MBvyomavyaapistavaHK-108	naivedyadhūpadīpādau upayogaḥ | aghoravaktraja ayutākṣara	naivedya dhūpa dīpa ādau upayogaḥ aghora vaktra ja ayuta akṣara 
MBvyomavyaapistavaHK-109	aghoramantrasya kaṭaka keyūrādau upayogaḥ | itthamīśānamukha jātatvāt	aghora mantrasya kaṭaka keyūra ādau upayogaḥ ittham īśāna mukha jāta tvāt 
MBvyomavyaapistavaHK-110	vyomavyāpi padātmakatvāt mantrarājatvāt makuṭādi pūjopayogi īśāna	vyoma vyāpi pada ātmaka tvāt mantrarāja tvāt makuṭa ādi pūjā upayogi īśāna 
MBvyomavyaapistavaHK-111	mantrajanakatvācca aghoramukha janmavadbhyaḥ aṃgapūjopayogi mantra	mantra janaka tvāt ca aghora mukha janmavadbhyaḥ aṃga pūjā upayogi 
MBvyomavyaapistavaHK-112	janakebhyaḥ sahasrākṣara ayutākṣara arbudākṣaramantrebhyassakāśāt	janakebhyaḥ sahasra akṣara ayuta akṣara arbuda akṣara mantrebhyaḥ sakāśāt 
MBvyomavyaapistavaHK-113	sāṣṭaṣaṣṭi triśatākṣara vyomavyāpimantrasya sarvamantrottamottama	sa aṣṭaṣaṣṭi tri śata akṣara vyoma vyāpi mantrasya sarva mantra uttama uttama 
MBvyomavyaapistavaHK-114	varṇanāt	varṇanāt 
MBvyomavyaapistavaHK-115	p. 9) tatpadastutau rāmakaṇṭhācārya pravṛttiriti |	            
MBvyomavyaapistavaHK-116	asya ca stavarājasya rauravānusāreṇa kṛtatvāt tatpāṭhāpekṣayāstava	asya ca stavarājasya raurava anusāreṇa kṛta tvāt tad pāṭha apekṣayā a stava 
MBvyomavyaapistavaHK-117	kartrā uttaratra aṣṭaṣaṣṭyadhika triśatākṣarātmakatvena mantrasya	kartrā uttaratra aṣṭaṣaṣṭi adhika tri śata akṣara ātmaka tvena mantrasya 
MBvyomavyaapistavaHK-118	varṇitam | ataḥ kalottarādi pāṭhasiddha saṃkhyayā virodhaḥ | taduktaṃ	varṇitam atas kalā uttara ādi pāṭha siddha saṃkhyayā virodhaḥ tat uktam 
MBvyomavyaapistavaHK-119	raurave 	raurave 
MBvyomavyaapistavaHK-120	atha saṃkhyā śivasyoktā akṣarāṇāṃ śatatrayam || 28 ||	atha saṃkhyā śivasya uktā akṣarāṇām śata trayam 
MBvyomavyaapistavaHK-121	aṣṭaṣaṣṭyadhikaṃ śaṃbhorguhyamantraṃ vinirgatam |	aṣṭaṣaṣṭi adhikam śaṃbhoḥ guhya mantram vinirgatam 
MBvyomavyaapistavaHK-122	mataṃge 	mataṃge 
MBvyomavyaapistavaHK-123	ekatraiva samastāni ekāśītipadāni  tu ||	ekatra eva samastāni ekāśīti padāni tu 
MBvyomavyaapistavaHK-124	aṣṭaṣaṣṭyadhikaṃ śaṃbhorvāmānāntu śatatrayam |	aṣṭaṣaṣṭi adhikam śaṃbhoḥ vāmā nāntu śata trayam 
MBvyomavyaapistavaHK-125	ityupodghātanirṇayaḥ ||	iti upodghāta nirṇayaḥ 
MBvyomavyaapistavaHK-126	itthaṃ bhūtasya vyomavyāpimantrarājasya prathamapadastavaprakāraṃ	ittham bhūtasya vyoma vyāpi mantrarājasya prathama pada stava prakāram 
MBvyomavyaapistavaHK-127	prathamaṃ stauti oṃkāreti 	prathamam stauti oṃkāra iti 
MBvyomavyaapistavaHK-128	oṃkāravācyamādyaṃ śivamanavacchinna dṛkkriyopetam |	oṃkāra vācyam ādyam śivam anavacchinna dṛkkriyā upetam 
MBvyomavyaapistavaHK-129	p. 10) pañca mahāpraṇava tanuṃ śreyodaṃnaumi sarvalokasya || 29 ||	pañca mahāpraṇava tanum sarva lokasya 
MBvyomavyaapistavaHK-130	ṭippaṇī  oṃkāravācyaṃ ādyaṃ śivaṃ naumi ityanvayaḥ |	ṭippaṇī oṃkāra vācyam ādyam śivam naumi iti anvayaḥ 
MBvyomavyaapistavaHK-131	anavacchinnābhyāṃ asaṃkucitābhyāṃ dṛkkriyābhyāṃ	anavacchinnābhyām asaṃkucitābhyām dṛkkriyābhyām 
MBvyomavyaapistavaHK-132	jñānakriyātmaka aiśvaryābhyāṃ upetaṃ yuktam |	jñāna kriyā ātmaka aiśvaryābhyām upetam yuktam 
MBvyomavyaapistavaHK-133	pañcamahāpraṇavāḥ pañcabrahmamantrāḥ tā eva tanuḥ yasya taṃ	pañca mahā praṇavāḥ pañca brahma mantrāḥ tāḥ eva tanuḥ yasya taṃ 
MBvyomavyaapistavaHK-134	sarvalokasya nikhila jagataḥ śreyodaṃ bhuktimuktirūpasya śreyasaḥ	sarva lokasya jagataḥ śreyaḥ dam bhukti mukti rūpasya śreyasaḥ 
MBvyomavyaapistavaHK-135	puruṣārthasya sādhakaṃ śivaṃ ādyapadena (41) muktapadasya nirāsaḥ |	                  
MBvyomavyaapistavaHK-136	asya śivasya oṃkāravācyatvaṃ prasiddhameva taṃ naumi stautītyarthaḥ |	asya śivasya oṃkāra vācya tvam prasiddham eva tam naumi stauti iti arthaḥ 
MBvyomavyaapistavaHK-137	atra vācyabhūta śivastutyā vācakabhūtaṃ oṃkāra padameva stūyate	atra vācya bhūta śiva stutyā vācaka bhūtam oṃkāra padam eva stūyate 
MBvyomavyaapistavaHK-138	vācya vācakayorabhedāt | evamuttaratra sarvatrāpi vācyastutyā vācaka	vācya vācakayoḥ abhedāt evam uttaratra sarvatra api vācya stutyāḥ vācaka 
MBvyomavyaapistavaHK-139	padānāmeva stutikhagantavyā | dvitīya padastavamāha vyomavyāpakamiti 	padānām eva stuti kha gantavyā 
MBvyomavyaapistavaHK-140	vyomavyāpakamamitaṃ māyā pāśupāśanāśināthaṃ yat |	vyoma vyāpakam amitam māyā pāśu pāśa nāśi nātham yat 
MBvyomavyaapistavaHK-141	p. 11) vyāpnoti śaktibhiryastadvomavyāmavyāpine namastasmai || 2 ||	vyāpnoti śaktibhiḥ yaḥ tat voma vyāma vyāpine namaḥ tasmai   
MBvyomavyaapistavaHK-142	māyā paśupāśa rāśināthaṃ amitaṃ vyāpakaṃ yadvyoma tat yaḥ	māyā paśu pāśa rāśi nātham amitam vyāpakam yat vyoma tat yaḥ 
MBvyomavyaapistavaHK-143	śaktibhiḥ vyāpnoti tasmai vyomavyāpine nama ityanvayaḥ | māyayā	śaktibhiḥ vyāpnoti tasmai vyomavyāpine namaḥ iti anvayaḥ māyayā 
MBvyomavyaapistavaHK-144	paśunā pāśarāśinā ca nāthaṃ sahitaṃ amitaṃ iyattārahitaṃ	paśunā pāśa rāśinā ca nātham sahitam amitam iyattā rahitam 
MBvyomavyaapistavaHK-145	vyāpakaṃ vibhuyadvyoma ākāśaṃ bhūtapañcamaṃ dṛśyamāna	vyāpakam vibhu yat vyoma ākāśam bhūta pañcamam dṛśyamāna 
MBvyomavyaapistavaHK-146	sarvavastūnāmapi ākāśāntarhitatvāt asyapāvakatvaṃ sphaṭam | tat	sarva vastūnām api ākāśa antarhita tvāt sphaṭam tat 
MBvyomavyaapistavaHK-147	ākāśamapi yaḥ śivaḥ śaktibhiḥ vyāpnoti vyāpya tiṣṭhati tasmai	ākāśam api yaḥ śivaḥ śaktibhiḥ vyāpnoti vyāpya tiṣṭhati tasmai 
MBvyomavyaapistavaHK-148	tasyāpyākāśasya vyāpakāya tasmai vyomavyāpine namaḥ iti	tasya api ākāśasya vyāpakāya tasmai vyoma vyāpine namaḥ iti 
MBvyomavyaapistavaHK-149	vyomavyāpnotīti vyutpatyā vyomavyāpi pada vācyāya namaḥ namaskāra	vyoma vyāpnoti iti vyutpatyā vyoma vyāpi pada vācyāya namaḥ namaskāra 
MBvyomavyaapistavaHK-150	ityarthaḥ ||	iti arthaḥ 
MBvyomavyaapistavaHK-151	tṛtīyapadastavamāha tadvaditi 	tṛtīya pada stavam āha tadvat iti 
MBvyomavyaapistavaHK-152	tadvadvyāpakamamalaṃ vyomaparaṃ yasya niṣkalaṃ rūpam |	tadvat vyāpakam amalam vyoma param yasya niṣkalam rūpam 
MBvyomavyaapistavaHK-153	p. 12) sarvajñatādi tasmai namo'stu te vyomarūpāya || 3 ||	sarvajña tā ādi tasmai namaḥ astu te vyoma rūpāya 
MBvyomavyaapistavaHK-154	yasya paraṃ vyoma niṣkalaṃ sarvajñatādi rūpaṃ tadvat vyāpakaṃ	yasya param vyoma niṣkalam sarvajña tā ādi rūpam tadvat vyāpakam 
MBvyomavyaapistavaHK-155	amalaṃ tasmai vyomarūpāya namaḥ astu ityanvayaḥ | yasya śivasya vyoma	amalam tasmai vyoma rūpāya namaḥ astu iti anvayaḥ yasya śivasya vyom 
MBvyomavyaapistavaHK-156	paraṃ vyomnaḥ śakāśāt paraṃ bṛhat niṣkalaṃ kalārahitaṃ	param vyomnaḥ śakāśāt param bṛhat niṣkalam kalā rahitam 
MBvyomavyaapistavaHK-157	sarvajñatādi sarvakartṛtā nityatṛpti bodhādi svabhāvaṃ rūpaṃ vapuḥ |	               
MBvyomavyaapistavaHK-158	tadvat ākāśavyāpakaṃ vibhukamalaṃ nirmalaṃ tasmai śivāya	tadvat ākāśa vyāpakam vibhu kamalam nirmalam tasmai śivāya 
MBvyomavyaapistavaHK-159	vyomarūpāya vyomavat rūpaṃ yasya iti vyutpatyā vyomarūpa te tubhyaṃ	vyoma rūpāya vyomavat rūpam yasya iti vyutpatyā vyoma rūpa te tubhyam 
MBvyomavyaapistavaHK-160	namaḥ astvityarthaḥ ||	namaḥ astu iti arthaḥ 
MBvyomavyaapistavaHK-161	caturthapadastavamāha vyomeneti 	caturtha pada stavam āha vyomena iti 
MBvyomavyaapistavaHK-162	vyomenānyatsarvaṃ yadvadathastatvabhāvabhuvanāni |	vyomena anyat sarvam yadvat athas tatva bhāva bhuvanāni 
MBvyomavyaapistavaHK-163	paraparayacuttayākhyaṃ tatsarva vyāpinepi namaḥ || 4 ||	tat sarva vyāpine api namaḥ 
MBvyomavyaapistavaHK-164	he parapara vyomena saha anyatsarvaṃ tvadadhaḥ yat tattva bhāvabhuvanāni	he para para vyomena saha anyat sarvam tvad adhas yat tattva bhāva bhuvanāni 
MBvyomavyaapistavaHK-165	śaktyākhyaṃ yattat sarvavyāpine namaḥ ityanvayaḥ |	śakti ākhyam yat tat sarvavyāpine namaḥ iti anvayaḥ 
MBvyomavyaapistavaHK-166	p. 3) parapara parasmādapi paraḥ parātpara ityarthaḥ | śivasaṃbodhanametat	para para parasmāt api paraḥ parātparaḥ iti arthaḥ śiva saṃbodhanam etat 
MBvyomavyaapistavaHK-167	vyomena akārānta vyoma śabdopyastīti anena naivā'vagamyate | sahārthe	vyomena akāra anta vyoma śabdaḥ api asti iti anena na eva avagamyate saha arthe 
MBvyomavyaapistavaHK-168	tṛtīyeyaṃ ākāśena saha anyatsarvaṃ itaradviśvaṃtvadathaḥ	tṛtīyā iyam ākāśena saha anyat sarvam itarat viśvaṃtvat atha 
MBvyomavyaapistavaHK-169	tvadvyāpyamityarthaḥ | yat yasmātkāraṇāt tatvabhāvabhuvanāni tatvāni	tvad vyāpyam iti arthaḥ yat yasmāt kāraṇāt tatva bhāva bhuvanāni tatvāni 
MBvyomavyaapistavaHK-170	ṣaṭtriṃśat bhāvāḥ pañcāśadbhuvanāni caturviṃśatyadhikādviśataṃ	ṣaṭtriṃśat bhāvāḥ pañcāśat bhuvanāni caturviṃśati adhikā dviśatam 
MBvyomavyaapistavaHK-171	(42) etāni śaktyākhyaṃ tvacchaktirūpaṃ yatkāraṇāt tat tasmāt	etāni śakti ākhyam tvad śakti rūpam yatkāraṇāt tat tasmāt 
MBvyomavyaapistavaHK-172	sarvavyāpine sarvaṃ vyāpnotīti vyutpatyā sarvavyāpi padavācyāya	sarvavyāpine sarvam vyāpnoti iti vyutpatyā sarvavyāpi pada vācyāya 
MBvyomavyaapistavaHK-173	tubhyaṃ nama ityarthaḥ ||	tubhyam namaḥ iti arthaḥ 
MBvyomavyaapistavaHK-174	pañcamapadastavamāha rāgāditi 	pañcama pada stavam āha rāgāt iti 
MBvyomavyaapistavaHK-175	rāgādi doṣayogā'saṃbhavato anādikālasaṃsiddhāt |	rāga ādi doṣa yoga asaṃbhavataḥ anādi kāla saṃsiddhāt 
MBvyomavyaapistavaHK-176	yasya sadā śāntatvācchivatā tasmai namaśśivāyāpi || 5 ||	yasya sadā śānta tvāt śiva tā tasmai namaḥ śivāya api 
MBvyomavyaapistavaHK-177	p. 14)	p 
MBvyomavyaapistavaHK-178	yasya rāgādi doṣa yogā saṃbhavataḥ anādi kāla saṃsiddhāt sadā	yasya rāga ādi doṣa yogā saṃbhavataḥ anādi kāla saṃsiddhāt sadā 
MBvyomavyaapistavaHK-179	śāntatvāt śivatā tasmai śivāya nama ityanvayaḥ | yasya śivasya rāgādi	śānta tvāt śivatā tasmai śivāya namaḥ iti anvayaḥ yasya śivasya rāga ādi 
MBvyomavyaapistavaHK-180	doṣa rahitaḥ anādikāla saṃsiddhāt bhāvapradhāno nirdeśaḥ siddhatvāt	doṣa rahitaḥ anādi kāla saṃsiddhāt bhāva pradhānaḥ nirdeśaḥ siddha tvāt 
MBvyomavyaapistavaHK-181	anāditvādevetyarthaḥ sadā śāntatvāt saumyatvācca śivatā śuddhatā	anādi tvāt eva iti arthaḥ sadā śānta tvāt saumya tvāt ca śiva tā śuddha tā 
MBvyomavyaapistavaHK-182	tasmai śivāya namaḥ śivapadavācyāya namaḥ ityarthaḥ ||	tasmai śivāya namaḥ śiva pada vācyāya namaḥ iti arthaḥ 
MBvyomavyaapistavaHK-183	ṣaṣṭhapadastavamāha antariti 	ṣaṣṭha pada stavam āha antar iti 
MBvyomavyaapistavaHK-184	antaḥ pūrvākoṭiḥ prāthamyādatra janma kathitoyaḥ |	antar pūrvā koṭiḥ prāthamyāt atra janma kathitaḥ yaḥ 
MBvyomavyaapistavaHK-185	yasya kadācinnāsau śivasya tasmai namostvanantāya || 6 ||	yasya kadācid na asau śivasya tasmai namaḥ ustu anantāya 
MBvyomavyaapistavaHK-186	yasya śivasya yo'ntaḥ yo pūrvā koṭiḥ yo janmā kathitaḥ asau	yasya śivasya yontaḥ yo pūrvā koṭiḥ yo janmā kathitaḥ asau 
MBvyomavyaapistavaHK-187	prāthamyāt kadācit na tasmai anantāya namaḥ astu ityanvayaḥ | antaḥ	prāthamyāt kadācid na tasmai anantāya namaḥ astu iti anvayaḥ antaḥ 
MBvyomavyaapistavaHK-188	pradhvaṃsaḥ pūrvā koṭiḥ prāgabhāvaḥ janma kathitaḥ udbhavaḥ |	pradhvaṃsaḥ pūrvā koṭiḥ prāgabhāvaḥ janma kathitaḥ udbhavaḥ 
MBvyomavyaapistavaHK-189	p. 15) ādimadhyānta varjita iti yāvat | kutaḥ prāthamyāt sarvakāryebhyaḥ	ādi madhya anta varjitaḥ iti yāvat kutas prāthamyāt sarva kāryebhyaḥ 
MBvyomavyaapistavaHK-190	pūrvavartitvādityarthaḥ | ādimadhyāntavataḥ tādṛśa pūrvavartitvaṃ	pūrva varti tvāt iti arthaḥ ādi madhya antavataḥ 
MBvyomavyaapistavaHK-191	nā'vagamyata iti bhāvaḥ | anantāya anantaśabdastu ādimadhyayorapi	na avagamyate iti bhāvaḥ anantāya ananta śabdaḥ tu ādi madhyayoḥ api 
MBvyomavyaapistavaHK-192	upalakṣukaḥ | na vidyate yasya iti vyutpatyā anantapadavācyāya nama	upalakṣukaḥ na vidyate yasya iti vyutpatyā ananta pada vācyāya nama 
MBvyomavyaapistavaHK-193	ityarthaḥ ||	iti arthaḥ 
MBvyomavyaapistavaHK-194	saptamapadastavamāha nātha-iti 	saptama pada stavam āha nātha eti 
MBvyomavyaapistavaHK-195	nāthassvāmīmitraṃ bandudyoktassanāstiyasyeva |	nāthaḥ svāmī mitram 
MBvyomavyaapistavaHK-196	nityātsarvaiśvaryātkathitāttasmai namo stvanāthāya || 7 ||	nityāt sarva aiśvaryāt kathitāt tasmai namaḥ stu anāthāya 
MBvyomavyaapistavaHK-197	svāmī mitraṃ banduśca nātha uktaḥ saḥ yasya nāstyeva nityātkathitāt	svāmī mitram banduḥ ca nāthaḥ uktaḥ saḥ yasya na asti eva nityāt kathitāt 
MBvyomavyaapistavaHK-198	sarvaisvaryāt hetoḥ tasmai anāthāya namostu ityanvayaḥ | śivasya	sarva aisvaryāt hetoḥ tasmai anāthāya namaḥ astu iti anvayaḥ śivasya 
MBvyomavyaapistavaHK-199	śivāgama kathita sārvakālīna sarveśvaratvaguṇasatvāt asau	                      
MBvyomavyaapistavaHK-200	svāmyādimānnabhavatītyarthaḥ | nāthāḥ svāmyādayaḥ yasya na	svāmi ādimān na bhavati iti arthaḥ nāthāḥ svāmi ādayaḥ yasya na 
MBvyomavyaapistavaHK-201	vidyante iti vyutpatyā anāthapadavācyāya namo'stu ityarthaḥ ||	vidyante iti vyutpatyā anātha pada vācyāya namaḥ astu iti arthaḥ 
MBvyomavyaapistavaHK-202	p. 16) aṣṭamapadastavamāha sṛṣṭyādīti 	aṣṭama pada stavam āha sṛṣṭi ādi iti 
MBvyomavyaapistavaHK-203	sṛṣṭyādi kārya karaṇe nānyo yenāśrito hi sahakārī |	sṛṣṭi ādi kārya karaṇe na anyaḥ yena āśritaḥ hi sahakārī 
MBvyomavyaapistavaHK-204	muktaśśivādimocyā namo'stu tasmaitvanāśritāyāpi || 8 ||	muktaḥ śiva ādi mocyā namaḥ astu tasmai tu anāśritāya api 
MBvyomavyaapistavaHK-205	yena sṛṣṭyādi kāryakaraṇe muktaḥ śivādimocyaḥ sahakārī anyo	yena sṛṣṭi ādi kārya karaṇe muktaḥ śiva ādi mocyaḥ sahakārī 
MBvyomavyaapistavaHK-206	hi na āśritaḥ tasmai anāśritāya namaḥ astu ityanvayaḥ | yena śivena	hi na āśritaḥ tasmai anāśritāya namaḥ astu iti anvayaḥ yena śivena 
MBvyomavyaapistavaHK-207	sṛṣṭyādi pañcakṛtyakaraṇe svānyaḥ kvacinmuktaḥ puruṣo vā sahakārī	sṛṣṭi ādi pañcakṛtya karaṇe sva anyaḥ kvacid muktaḥ puruṣaḥ vā sahakārī 
MBvyomavyaapistavaHK-208	nā'śritaḥ tasmai anāśritapada vācyāya nama ityarthaḥ ||	na āśritaḥ tasmai anāśrita pada vācyāya namaḥ iti arthaḥ 
MBvyomavyaapistavaHK-209	943) navamapada stavamāha adhruvamiti 	navama pada stavam āha adhruvam iti 
MBvyomavyaapistavaHK-210	adhruvametatprāyo vastu pumarthapradaṃ dhruvastena |	adhruvam etat prāyas vastu pumartha pradam dhruvaḥ tena 
MBvyomavyaapistavaHK-211	śaṃbhuḥ kathito yotra tu tasmai namo dhruvāyāstu || 9 ||	śaṃbhuḥ kathitaḥ yaḥ tra tu tasmai namaḥ dhruvāya astu 
MBvyomavyaapistavaHK-212	pumarthapradaṃ etadvastu prāyaḥ adhruvaṃ tena yaḥ śaṃbhuḥ nityaḥ	pumartha pradam etat vastu prāyas adhruvam tena yaḥ śaṃbhuḥ nityaḥ 
MBvyomavyaapistavaHK-213	dhruvaḥ kathitaḥ tasmai dhruvāya namaḥ astu ityanvayaḥ |	dhruvaḥ kathitaḥ tasmai dhruvāya namaḥ astu iti anvayaḥ 
MBvyomavyaapistavaHK-214	p. 17) puruṣārthapradaṃ etatparidṛśyamānaṃ kāminyādikaṃ vastu	puruṣa artha pradam etat paridṛśyamānam kāminī ādikam vastu 
MBvyomavyaapistavaHK-215	prāyaḥ niścayataḥ adhruvaṃ naśvarameva tena kāraṇena yaḥ śaṃbhuḥ	prāyas niścayataḥ adhruvam naśvaram eva tena kāraṇena yaḥ śaṃbhuḥ 
MBvyomavyaapistavaHK-216	sukhakaraḥ śivatākaraḥ nityaḥ nāśarahitaḥ śivāgama kathitaḥ tasmai	sukha karaḥ śiva tā karaḥ nityaḥ nāśa rahitaḥ śiva āgama kathitaḥ tasmai 
MBvyomavyaapistavaHK-217	dhruvapadavācyāya nama ityarthaḥ ||	dhruva pada vācyāya namaḥ iti arthaḥ 
MBvyomavyaapistavaHK-218	atha navānāṃ padānāṃ pūjāprakāramāha padanavakamiti 	atha navānām padānām pūjā prakāram āha pada navakam iti 
MBvyomavyaapistavaHK-219	padanavakannavanābhe pañcatriṃśārṇametadatha pūjyam |	pada navakan nava nābhe pañcatriṃśa arṇam etat atha pūjyam 
MBvyomavyaapistavaHK-220	madhyastha pīṭhamadhya prāgādīśānta digdala niviṣṭam || 10 ||	            
MBvyomavyaapistavaHK-221	pañcatriṃśārṇapadanavakaṃ etat navanābhe pūjyaṃ ityanvayaḥ |	pañcatriṃśa arṇa pada navakam etat nava nābhe pūjyam iti anvayaḥ 
MBvyomavyaapistavaHK-222	madhyakamalapīṭha navapadeṣu karṇikādīśānta daleṣu oṃkārādi	                        
MBvyomavyaapistavaHK-223	navapadāni pūjyānītyarthaḥ ||	nava padāni pūjyāni iti arthaḥ 
MBvyomavyaapistavaHK-224	atha pūrvapīṭhapadanavakastuvamāha yo'sāvityādinā daśabhiḥ	atha pūrva pīṭha pada navaka stuvam āha yaḥ sau ityādinā daśabhiḥ 
MBvyomavyaapistavaHK-225	āryābhiḥ |	āryābhiḥ 
MBvyomavyaapistavaHK-226	p. 18) tatra prathama padastavamāha yo'sāviti 	tatra prathama pada stavam āha yaḥ asau iti 
MBvyomavyaapistavaHK-227	yo'sau sadāptaśāstro hitādi śāstāhyanāmayatvena |	yaḥ sau sat āpta śāstraḥ hita ādi śāstā ahi anāmaya tvena 
MBvyomavyaapistavaHK-228	bhavati narāṇāṃ dayayā parāya tasmai tu śāśvatāya namaḥ || 11 ||	bhavati narāṇām dayayā parāya tasmai tu śāśvatāya namaḥ  /
MBvyomavyaapistavaHK-229	sadāpta śāstraḥ yaḥ asau anāmayatvena dayayā narāṇāṃ hitādi śāstā	sat āpta śāstraḥ yaḥ asau anāmaya tvena dayayā narāṇām hita ādi śāstā 
MBvyomavyaapistavaHK-230	bhavati tasmai parāya śaśvatāya nama ityanvayaḥ | sārvakālaṃ śāstreṣu	bhavati tasmai parāya śaśvatāya namaḥ iti anvayaḥ sārvakālam śāstreṣu 
MBvyomavyaapistavaHK-231	vyāptaḥ yathārtha vādītyarthaḥ | āmayo rāgādiḥ tadrahitatvena hitādi	vyāptaḥ yathārtha vādi iti arthaḥ āmayaḥ rāga ādiḥ tad rahita tvena hita ādi 
MBvyomavyaapistavaHK-232	ityādi śabdena ahitaṃ gṛhyate | hitā'hitopadeṣṭā ityarthaḥ | śasta	ityādi śabdena ahitam gṛhyate hita ahita upadeṣṭā iti arthaḥ śasta 
MBvyomavyaapistavaHK-233	anuśiṣṭau iti dhātorvyutpatyā śāśvata padavācyāya nama ityarthaḥ ||	anuśiṣṭau iti dhātoḥ vyutpatyā śāśvata pada vācyāya namaḥ iti arthaḥ 
MBvyomavyaapistavaHK-234	dvitīya pada stavamāha yoga-iti 	dvitīya pada stavam āha yogā iti 
MBvyomavyaapistavaHK-235	yogassadāśiva vapu śaktistasthaḥ karoti sarvaṃ yat |	yogaḥ sadāśiva śaktiḥ tasthaḥ karoti sarvam yat 
MBvyomavyaapistavaHK-236	tena yasya pīṭhaṃ tasmai taptīṭha saṃsthitāya namaḥ || 12 ||	tena yasya pīṭham tasmai tap tīṭha saṃsthitāya namaḥ  /
MBvyomavyaapistavaHK-237	p. 19) sadāśiva vapuḥ śaktiḥ yogaḥ tatsthaḥ sarvaṃ karoti iti yat tat asya	sadāśiva vapuḥ śaktiḥ yogaḥ tad sthaḥ sarvam karoti iti yat tat asya 
MBvyomavyaapistavaHK-238	pīṭhaṃ tatpīṭha saṃsthitāya tasmai namaḥ ityanvayaḥ | sadāśivasya	pīṭham tad pīṭha saṃsthitāya tasmai namaḥ iti anvayaḥ sadāśivasya 
MBvyomavyaapistavaHK-239	śarīrabhūtā śaktiḥ yogaśakti vācyā bhavati tatra sthitvā śivaḥ sarvaṃ	śarīra bhūtā śaktiḥ yogaśakti vācyā bhavati tatra sthitvā śivaḥ sarvam 
MBvyomavyaapistavaHK-240	kṛtyaṃ karotīti taccharīraṃ pīṭhamityucyate | tena yogarūpe pīṭhe sthitaḥ	kṛtyam karoti iti tat śarīram pīṭham iti ucyate tena yoga rūpe pīṭhe sthitaḥ 
MBvyomavyaapistavaHK-241	iti vyutpatyā yogapīṭha saṃsthita śabda vācyāya nama ityarthaḥ ||	iti vyutpatyā yogapīṭha saṃsthita śabda vācyāya namaḥ ityarthaḥ 
MBvyomavyaapistavaHK-242	tṛtīya padastavamāha nityamiti 	tṛtīya pada stavam āha nityam iti 
MBvyomavyaapistavaHK-243	nityaṃ sadaiva yogaḥ proktaṃ vapurasti yasya no nāśaḥ |	nityam sadā eva yogaḥ proktam vapuḥ asti yasya no nāśaḥ 
MBvyomavyaapistavaHK-244	śaktīnāmapi tasmai te nityaṃ yogine'pi namaḥ || 13 ||	śaktīnām api tasmai te nityam yogine api namaḥ 
MBvyomavyaapistavaHK-245	yasya proktaṃ vapuḥ yogaḥ nityaṃ sadaiva asti yasya śaktīnāṃ nonāśaḥ	yasya proktam vapuḥ yogaḥ nityam sadā eva asti yasya śaktīnām nonāśaḥ 
MBvyomavyaapistavaHK-246	(44) nityaṃ yogine tasmai nama ityanvayaḥ | nityaṃ yogaḥ śaktirasya astīti	nityam yogine tasmai namaḥ iti anvayaḥ nityam yogaḥ śaktiḥ asya asti iti 
MBvyomavyaapistavaHK-247	vyutpatyā nityaṃ yogipada vācyāya nama ityarthaḥ ||	vyutpatyā nityam yogi pada vācyāya namaḥ iti arthaḥ 
MBvyomavyaapistavaHK-248	p. 20) caturthapadastavamāha dhyānamiti 	            
MBvyomavyaapistavaHK-249	dhyānañcittecchā tanmātreṇā'haraṇameva bhāvānām |	dhyānam citta icchā tad mātreṇa āharaṇam eva bhāvānām 
MBvyomavyaapistavaHK-250	iti tatraptyai yasya dhyāna hārāya tubhyamapi namaḥ || 14 ||	iti yasya dhyāna hārāya tubhyam api namaḥ 
MBvyomavyaapistavaHK-251	yasya dhyānaṃ cittecchā tanmātreṇaiva yasya bhāvānāṃ āharaṇaṃ iti	yasya dhyānam citta icchā tanmātreṇa eva yasya bhāvānām āharaṇam iti 
MBvyomavyaapistavaHK-252	yasya tattṛptyai tasmai dhyāna hārāya tubhyaṃ nama ityanvayaḥ |	yasya tad tṛptyai tasmai dhyāna hārāya tubhyam namaḥ iti anvayaḥ 
MBvyomavyaapistavaHK-253	cittecchāḥ saṃkalpabhāvāḥ sarvakāryāṇi āharaṇaṃ saṃpādanaṃ	citta icchāḥ saṃkalpa bhāvāḥ sarva kāryāṇi āharaṇam saṃpādanam 
MBvyomavyaapistavaHK-254	tṛptiḥ paramānandaḥ dhyānenaiva paramānando yasyeti vyutpatyā	tṛptiḥ parama ānandaḥ dhyānena eva parama ānandaḥ yasya iti vyutpatyā 
MBvyomavyaapistavaHK-255	dhyānahārāya padavācyāya nama ityarthaḥ ||	dhyāna hārāya pada vācyāya namaḥ iti arthaḥ 
MBvyomavyaapistavaHK-256	pañcamapadastavamāha mantreti 	pañcama pada stavam āha mantra iti 
MBvyomavyaapistavaHK-257	mantrapadānāmmadhyātphalārthibhiryassmaryate padenaiva |	mantra padānām madhyāt phala arthibhiḥ yaḥ smaryate padena eva 
MBvyomavyaapistavaHK-258	sarvakriyāsu pūrvaṃ yattasmaitvonnamaśśivāyeti || 15 ||	sarva kriyāsu pūrvam yat tasmai tvā unnamaḥ śivāya iti 
MBvyomavyaapistavaHK-259	mantrapadānāṃ madhyāt onnamaśśivāyeti padenaiva sarvakriyāsu	mantra padānām madhyāt onnamaḥ śivāya iti padena eva sarva kriyāsu 
MBvyomavyaapistavaHK-260	p. 21) pūrvaṃ phalārthibhiḥ yaḥ smaryate tasmai nama ityanvayaḥ |	pūrvam phala arthibhiḥ yaḥ smaryate tasmai namaḥ iti anvayaḥ 
MBvyomavyaapistavaHK-261	karmārambha kāleṣu puruṣaiḥ phalasidhyarthaṃ pūrvaṃ onnamaśśivāya	karma ārambha kāleṣu puruṣaiḥ phala sidhi artham pūrvam onnamaḥ śivāya 
MBvyomavyaapistavaHK-262	pada smaryamāṇāya nama ityarthaḥ | smārya śivastutyā smāraka	smaryamāṇāya namaḥ iti arthaḥ smārya śiva stutyā smāraka 
MBvyomavyaapistavaHK-263	stutiravagantavyā ||	stutiḥ avagantavyā 
MBvyomavyaapistavaHK-264	ṣaṣṭhapadastavamāha kṛtvā'pīti 	ṣaṣṭha pada stavam āha kṛtvā api iti 
MBvyomavyaapistavaHK-265	kṛtvāpi sarvabhāvānsanāyakāṃ stava bhuvanānyaḥ |	kṛtvā api sarva bhāvān sa nāyakām stava bhuvanānyaḥ 
MBvyomavyaapistavaHK-266	teṣāṃ prabhutvayuktassarva prabhave namostu tubhyamapi || 16 ||	teṣām prabhu tva yuktaḥ sarva prabhave namaḥ astu tubhyam api 
MBvyomavyaapistavaHK-267	tatva pūrvabhuvanān sa nāyakān sarvabhāvānapi kṛtvā yaḥ teṣāṃ	tatva pūrva bhuvanān sa nāyakān sarva bhāvān api kṛtvā yaḥ teṣām 
MBvyomavyaapistavaHK-268	prabhutvayuktaḥ tasmai sarvaprabhave tubhyaṃ namo'stu ityanvayaḥ |	prabhu tva yuktaḥ tasmai sarva prabhave tubhyam namaḥ astu iti anvayaḥ 
MBvyomavyaapistavaHK-269	tatvabhuvanādhipayuktasya svakṛtaprapañcasya prabhutayā	tatva bhuvana adhipa yuktasya sva kṛta prapañcasya prabhu tayā 
MBvyomavyaapistavaHK-270	sarvaprabhuśabdavācyāya nama ityarthaḥ ||	sarva prabhu śabda vācyāya namaḥ iti arthaḥ 
MBvyomavyaapistavaHK-271	saptama padastavamāha proktairiti 	saptama pada stavam āha proktaiḥ iti 
MBvyomavyaapistavaHK-272	p. 22) proktairguṇairabhinnaḥ kalito yo tena śivapadenātra |	proktaiḥ guṇaiḥ abhinnaḥ kalitaḥ tena śiva padena atra 
MBvyomavyaapistavaHK-273	saguṇassaśaktimūrtirmāntrastasmai namostvatha śivāya || 17 ||	sa guṇaḥ sa śakti mūrtiḥ māntraḥ tasmai namaḥ astu atha śivāya 
MBvyomavyaapistavaHK-274	proktaiḥ guṇaiḥ abhinnaḥ saguṇaḥ saśaktimūrtiḥ māntraḥ yaḥ	proktaiḥ guṇaiḥ abhinnaḥ sa guṇaḥ sa śakti mūrtiḥ māntraḥ yaḥ 
MBvyomavyaapistavaHK-275	śivapadena kalitaḥ tasmai śivāya namo'stvityanvayaḥ | suguṇasya	śiva padena kalitaḥ tasmai śivāya namaḥ astu iti anvayaḥ suguṇasya 
MBvyomavyaapistavaHK-276	nirguṇasya śaktivigrahasya mantra vigrahasya vā sarvasya śiva svarūpasya	nirguṇasya śaktivigrahasya mantra vigrahasya vā sarvasya śiva svarūpasya 
MBvyomavyaapistavaHK-277	vācaka pada śivapadavācyāya nama ityarthaḥ ||	vācaka pada śiva pada vācyāya namaḥ iti arthaḥ 
MBvyomavyaapistavaHK-278	aṣṭamapadastavamāha īṣṭe iti 	aṣṭama pada stavam āha īṣṭe iti 
MBvyomavyaapistavaHK-279	īṣṭe savyasyeśona tu dharmeṇa so'taṃ īśānaḥ |	īṣṭe savyasya īśaḥ na tu dharmeṇa saḥ ūtam īśānaḥ 
MBvyomavyaapistavaHK-280	mūrdhanyādau yasya tu namostvaśeśānamūrdhnete || 18 ||	mūrdhani ādau yasya tu 
MBvyomavyaapistavaHK-281	īśaḥ yena tu dharmeṇa sarvasya īṣṭe ataḥ īśānaḥ saḥ yasya mūrdhani	īśaḥ yena tu dharmeṇa sarvasya īṣṭe ataḥ īśānaḥ saḥ yasya mūrdhani 
MBvyomavyaapistavaHK-282	(45) ādau tasmai īśānamūrdhne te namostu ityanvayaḥ | īśvarasya	ādau tasmai īśāna mūrdhne te namaḥ astu iti anvayaḥ īśvarasya 
MBvyomavyaapistavaHK-283	sarveśvara hetvīśāna dharmo mūrdhni yasya iti vyatpatyā	sarva īśvara dharmaḥ mūrdhni yasya iti 
MBvyomavyaapistavaHK-284	īśānapadavācyāya nama ityarthaḥ ||	īśāna pada vācyāya namaḥ iti arthaḥ 
MBvyomavyaapistavaHK-285	p. 23) navamapadastavamāha tasminniti 	navama pada stavam āha tasmin iti 
MBvyomavyaapistavaHK-286	tasminśaive jñāne paramātpuruṣa eva vācyeta |	tasmin śaive jñāne paramāt puruṣaḥ eva vācyeta 
MBvyomavyaapistavaHK-287	vaktramiva yasya śaktirnamostu tatpuruṣa vaktrāya || 19 ||	vaktram iva yasya śaktiḥ namaḥ astu tatpuruṣa vaktrāya 
MBvyomavyaapistavaHK-288	tasmin śaive jñāne parama eva tatpuruṣo vācyeta tadrūpāśaktiḥ yasya	tasmin śaive jñāne paramaḥ eva tatpuruṣaḥ vācyeta tad rūpa aśaktiḥ yasya 
MBvyomavyaapistavaHK-289	vaktramiva tasmai tatpuruṣavaktrāya namostu ityanvayaḥ | tacchabdena	vaktram iva tasmai tatpuruṣa vaktrāya namaḥ astu iti anvayaḥ tad śabdena 
MBvyomavyaapistavaHK-290	śaivajñānavivakṣāyāṃ puruṣaśabdena paramavivakṣāyāṃ tatpuruṣa	               
MBvyomavyaapistavaHK-291	śabdaśaktidharmo vaktraṃ yasyeti vyutpatyā tatpuruṣavaktrapadavācyāya	śabda śakti dharmaḥ vaktram yasya iti vyutpatyā tatpuruṣa vaktra pada vācyāya 
MBvyomavyaapistavaHK-292	nama ityarthaḥ ||	namaḥ iti arthaḥ 
MBvyomavyaapistavaHK-293	atha śāśvatādi tatpuruṣānta nava padānāṃ eṣāṃ pūjāprakāramāha	atha śāśvata ādi tatpuruṣa anta nava padānām eṣām pūjā prakāram āha 
MBvyomavyaapistavaHK-294	etaditi 	etat iti 
MBvyomavyaapistavaHK-295	etattatpuruṣāntaṃ padanavakaṃ pūrva pīṭha padaniviṣṭam |	etad tatpuruṣa antam pada navakam pada niviṣṭam 
MBvyomavyaapistavaHK-296	aṣṭācatvāriṃśatsaṃkhyairvarṇairūpetamatha pūjyam || 20 ||	aṣṭācatvāriṃśat saṃkhyaiḥ varṇaiḥ ūpetam atha pūjyam 
MBvyomavyaapistavaHK-297	p. 24) pūrvapīṭha padaniviṣṭaṃ aṣṭācatvāriṃśatsaṃkhyaiḥ varṇaiḥ	pūrva pīṭha pada niviṣṭam aṣṭācatvāriṃśat saṃkhyaiḥ varṇaiḥ 
MBvyomavyaapistavaHK-298	upetaṃ tatpuruṣāntaṃ etatpadanavakaṃ pūjyamityanvayaḥ |	upetam tatpuruṣa antam etat pada navakam pūjyam iti anvayaḥ 
MBvyomavyaapistavaHK-299	pūrvakamalapīṭha navapadeṣu karṇikādīśāntadaleṣu śāśvatādīni	pūrva kamala pīṭha nava padeṣu karṇikā ādi īśa anta daleṣu śāśvata ādīni 
MBvyomavyaapistavaHK-300	pūjanīyānītyarthaḥ ||	pūjanīyāni iti arthaḥ 
MBvyomavyaapistavaHK-301	atha āgneyapīṭha padanavakastutimāha doṣetyādibhiḥ daśabhiḥ	atha āgneya pīṭha pada navaka stutim āha doṣa ityādibhiḥ daśabhiḥ 
MBvyomavyaapistavaHK-302	āryābhiḥ | tatra prathamapada stavamāha doṣa iti 	āryābhiḥ tatra prathama pada stavam āha doṣaḥ iti 
MBvyomavyaapistavaHK-303	doṣahīnamaghoraṃ doṣakṣayakṛccayacca bhaktānām |	doṣa hīnam aghoram bhaktānām 
MBvyomavyaapistavaHK-304	hṛdayantatsadbhāvo namo'stu tasmaitvaghorahṛdayāya || 21 ||	hṛdayam tad sadbhāvaḥ namaḥ ustu tasmai tu aghora hṛdayāya 
MBvyomavyaapistavaHK-305	doṣavihīnaṃ bhaktānāṃ doṣakṣayakṛcca aghoraṃ yasya tatsadbhāvo	doṣa vihīnam bhaktānām doṣa kṣaya kṛt ca aghoram yasya tad sadbhāvaḥ 
MBvyomavyaapistavaHK-306	hṛdayaṃ tasmai aghora hṛdayāya namostu ityanvayaḥ | sva doṣarahitaṃ	hṛdayam tasmai aghora hṛdayāya namaḥ astu iti anvayaḥ sva doṣa rahitam 
MBvyomavyaapistavaHK-307	bhaktānāṃ doṣanāśakaḥ aghoramantraḥ yasya sadbhāvarūpahṛdayamiti	bhaktānām doṣa nāśakaḥ aghora mantraḥ yasya sadbhāva rūpa hṛdayam iti 
MBvyomavyaapistavaHK-308	vyutpatyā aghorahṛdayapadavācyāya nama ityarthaḥ ||	vyutpatyā aghora hṛdaya pada vācyāya namaḥ iti arthaḥ 
MBvyomavyaapistavaHK-309	vāmo vilakṣaṇo yaḥ krīḍāvāndeva eṣa guhyopi |	vāmaḥ vilakṣaṇaḥ yaḥ krīḍāvān devaḥ eṣa guhyaḥ api 
MBvyomavyaapistavaHK-310	p. 25) prasavānumatastasmai namo'stute vāmadeva guhyāya || 22 ||	prasava anumataḥ tasmai namaḥ stu te vāmadeva guhyāya  /
MBvyomavyaapistavaHK-311	yaḥ eṣaḥ vāmaḥ vilakṣaṇaḥ ya eṣa devaḥ krīḍāvān yaḥ eṣaḥ guhyaḥ	yaḥ eṣaḥ vāmaḥ vilakṣaṇaḥ yaḥ eṣa devaḥ krīḍāvān yaḥ eṣaḥ guhyaḥ 
MBvyomavyaapistavaHK-312	prasavānumataḥ tasmai vāmadeva guhyāya namo'stu ityanvayaḥ |	prasava anumataḥ tasmai vāmadeva guhyāya namaḥ astu iti anvayaḥ 
MBvyomavyaapistavaHK-313	krīḍārthaka dividhātoḥ niṣpanno devaśabdaḥ vāmaścāsau devaśca	niṣpannaḥ deva śabdaḥ vāmaḥ ca asau devaḥ ca 
MBvyomavyaapistavaHK-314	guhyaśceti vyatpatyā vāmadeva guhyapadavācyāya nama ityarthaḥ ||	guhyaḥ ca iti vāmadeva guhya pada vācyāya namaḥ iti arthaḥ 
MBvyomavyaapistavaHK-315	tṛtīyapada stavamāha sadya iti 	tṛtīya pada stavam āha sadyas iti 
MBvyomavyaapistavaHK-316	sadyo jhaṭityajātā hata janmādyā nṛttamūrtayoyasmāt |	sadyas jhaṭiti ajātāḥ hata janma ādyāḥ nṛtta mūrtayaḥ yasmāt 
MBvyomavyaapistavaHK-317	muktābhavanti tasmai te sadyojāta mūrtaye namaḥ || 23 ||	muktāḥ bhavanti tasmai te sadyojāta mūrtaye namaḥ 
MBvyomavyaapistavaHK-318	yasmātsadyaḥ jhaṭiti, ajātā hatajanmādyāḥ nṛttamūrtayaḥ muktāḥ	yasmāt sadyas jhaṭiti ajātāḥ hata janma ādyāḥ nṛtta mūrtayaḥ muktāḥ 
MBvyomavyaapistavaHK-319	bhavanti tasmai sadyojāta mūrtaye nama ityanvayaḥ | (46) sadya ityasya	bhavanti tasmai sadyojāta mūrtaye namaḥ iti anvayaḥ sadyas iti asya 
MBvyomavyaapistavaHK-320	vyākhyā jhaṭiti, ajātā ityasyavyākhyā hatajanmādyā iti |	vyākhyā jhaṭiti ajātāḥ iti asya vyākhyā hata janma ādyāḥ iti 
MBvyomavyaapistavaHK-321	mūrtipadavyākhyā nṛmūrtaya iti | tathā ca sadyaḥ ajātā mūrtayo	mūrti pada vyākhyā nṛ mūrtayaḥ iti tathā ca sadyas ajātāḥ mūrtayaḥ 
MBvyomavyaapistavaHK-322	yasmāditi vyutpatyā sadyojātamūrtipadavācyāya nama ityarthaḥ ||	yasmāt iti vyutpatyā sadyojāta mūrti pada vācyāya namaḥ iti arthaḥ 
MBvyomavyaapistavaHK-323	p. 26) caturthapadastavamāha omiti 	caturtha pada stavam āha om iti 
MBvyomavyaapistavaHK-324	omityatra purastādvāstavamaikyaṃ hi lakṣayati vācye |	om iti atra purastāt vāstavam aikyam hi lakṣayati vācye 
MBvyomavyaapistavaHK-325	sakala śivoyamabhinno yo niṣkalato'pyatho || 24 ||	sakala śivaḥ yam abhinnaḥ yaḥ niṣkala tā api atho 
MBvyomavyaapistavaHK-326	atra omiti purastāt vācye vāstavaṃ ai ---- namastubhyam || kyaṃ lakṣayati hi	atra om iti purastāt vācye vāstavam ai namaḥ tubhyam kyam lakṣayati hi 
MBvyomavyaapistavaHK-327	yo'yaṃ sakala śivaḥ saniṣkalataḥ abhinnaḥ ityanuṣaṃgaḥ | athā'pi oṃ	yaḥ yam sakala śivaḥ abhinnaḥ iti anuṣaṃgaḥ atha api om 
MBvyomavyaapistavaHK-328	tubhyaṃ nama ityanvayaḥ | atra asmin śivaśāsane omiti padaṃ purastāt	tubhyam namaḥ iti anvayaḥ atra asmin śiva śāsane om iti padam purastāt 
MBvyomavyaapistavaHK-329	prathamaṃ aikyaṃ lakṣayatīti vācya vācakayorubhayorapi omityevakārayo	prathamam aikyam lakṣayati iti vācya vācakayoḥ ubhayoḥ api om iti evakārayoḥ 
MBvyomavyaapistavaHK-330	yasmāt tasmāt sakala niṣkalayorabhinna eva oṃ ityākāro yasmāt athāpi	yasmāt tasmāt sakala niṣkalayoḥ abhinnaḥ eva om iti ākāraḥ yasmāt atha api 
MBvyomavyaapistavaHK-331	tasmādapi ityarthaḥ | hetu dvayenāpi saṃbodhanametat he oṃkāra rūpa	tasmāt api iti arthaḥ hetu dvayena api saṃbodhanam etat he oṃkāra rūpa 
MBvyomavyaapistavaHK-332	ityarthaḥ tubhyannama ityarthaḥ ||	iti arthaḥ tubhyan namaḥ iti arthaḥ 
MBvyomavyaapistavaHK-333	p. 27) pañcamapada stavamāha guhyā iti 	pañcama pada stavam āha guhyāḥ iti 
MBvyomavyaapistavaHK-334	guhyāḥ parairadṛṣṭerarthāgopyāśca paśuṣumāyādyāḥ |	guhyāḥ paraiḥ adṛṣṭeḥ arthāḥ a gopyāḥ ca paśu ṣu māyā ādyāḥ 
MBvyomavyaapistavaHK-335	tebhyo guhyebhyo'pyati guhyāya namo'stu rahasi labhyāya || 25 ||	tebhyaḥ guhyebhyaḥ api ati guhyāya namaḥ astu rahasi labhyāya  /
MBvyomavyaapistavaHK-336	paśuṣumāyādyāḥ arthāśca paraiḥ adṛṣṭaiḥ guhyāḥ gopyāḥ | tebhye	arthāḥ ca paraiḥ adṛṣṭaiḥ guhyāḥ gopyāḥ tebhyaḥ 
MBvyomavyaapistavaHK-337	guhyebhyo'pi ati guhyāya rahasi labhyāya namostu ityanvayaḥ | guhyapada	guhyebhyaḥ api ati guhyāya rahasi labhyāya namaḥ astu iti anvayaḥ guhya pada 
MBvyomavyaapistavaHK-338	vyākhyā gopyā iti parairadarśanaḥ gopyatvahetuḥ | atiguhyapadavyākhyā	vyākhyā gopyā iti paraiḥ adarśanaḥ gopya tva hetuḥ ati guhya pada vyākhyā 
MBvyomavyaapistavaHK-339	rahasi labhyāya iti dhyanai agamyāya ityarthaḥ | tathāca guhyebhyo'pi	rahasi labhyāya iti agamyāya iti arthaḥ tathā ca guhyebhyaḥ api 
MBvyomavyaapistavaHK-340	atiguhya iti pañcamī samāsena guhyātiguhyapadavācyāya nama ityarthaḥ ||	ati guhyaḥ iti pañcamī samāsena guhya ati guhya pada vācyāya namaḥ iti arthaḥ 
MBvyomavyaapistavaHK-341	ṣaṣṭhapada stavamāha eketi 	ṣaṣṭha padaḥ stavam āha eka iti 
MBvyomavyaapistavaHK-342	eka nṛmūrtinimittaṃ yo māyāṃ sarvathā'pi vihantyapi tu |	nṛ mūrti nimittam yaḥ māyām sarvathā api vihanti api tu 
MBvyomavyaapistavaHK-343	anyeṣāṃ bhavasidhyai tadgoptāyo namostu goptrepi || 26 ||	anyeṣām bhava sidhyai tat goptā ayaḥ namaḥ astu goptre api 
MBvyomavyaapistavaHK-344	p. 28) yaḥ eka nṛmūrtinimittaṃ māyāṃ sarvathā no vihanti | api tu	yaḥ nṛ mūrti nimittam māyām sarvathā no vihanti api tu 
MBvyomavyaapistavaHK-345	anyeṣāṃ bhavasidhyai tadgoptā tasmai goptre namaḥ astvityanvayaḥ |	anyeṣām bhava sidhyai tad goptā tasmai goptre namaḥ astu iti anvayaḥ 
MBvyomavyaapistavaHK-346	bhavaḥ saṃsāraṃ ekasya muktāvapi, anyasaṃsārāya māyāyāḥ gopteti	bhavaḥ saṃsāram ekasya muktau api anya saṃsārāya māyāyāḥ goptā iti 
MBvyomavyaapistavaHK-347	kalpanayā goptṛ padavācyāya nama ityarthaḥ ||	kalpanayā goptṛ pada vācyāya namaḥ iti arthaḥ 
MBvyomavyaapistavaHK-348	saptama padastavamāha muktimiti 	saptama pada stavam āha muktim iti 
MBvyomavyaapistavaHK-349	muktiṃ kurvanpuṃsaḥ tatsaṃsārasya kārya karaṇādeḥ |	muktim kurvan puṃsaḥ tat saṃsārasya kārya karaṇa ādeḥ 
MBvyomavyaapistavaHK-350	nidhanaṃ karoti yo'sau tasmai nidhanāya tubhyamapi namaḥ || 27 ||	nidhanam karoti yaḥ asau tasmai nidhanāya tubhyam api namaḥ 
MBvyomavyaapistavaHK-351	(47) puṃsaḥ muktiṃ kurvan kārya karaṇādeḥ tatsaṃsārasya yo'sau	puṃsaḥ muktim kurvan kārya karaṇa ādeḥ tad saṃsārasya yaḥ asau 
MBvyomavyaapistavaHK-352	nidhanaṃ karoti tasmai nidhanāya tubhyaṃ nama ityanvayaḥ | mohārthaṃ	nidhanam karoti tasmai nidhanāya tubhyam namaḥ iti anvayaḥ moha artham 
MBvyomavyaapistavaHK-353	saṃsārarūpa kārya karaṇādi nidhanatvāt nidhanakara eva nidhana	saṃsāra rūpa kārya karaṇa ādi nidhana tvāt nidhana karaḥ eva nidhana 
MBvyomavyaapistavaHK-354	kalpanayā nidhana śabda vācyāya nama ityarthaḥ ||	kalpanayā nidhana śabda vācyāya namaḥ ityarthaḥ 
MBvyomavyaapistavaHK-355	aṣṭamapadastavamāha sarveti 	aṣṭama pada stavam āha sarva iti 
MBvyomavyaapistavaHK-356	p. 29) sarvā vidyāmantrāḥ koṭyassaptādhipāstvanantādyāḥ |	sarvāḥ vidyā mantrāḥ koṭyaḥ sapta adhipāḥ tu ananta ādyāḥ 
MBvyomavyaapistavaHK-357	yasmādbhavanti tasmai tu sarva vidyādhipāya namaḥ || 28 ||	yasmāt bhavanti tasmai tu sarva vidyā adhipāya namaḥ 
MBvyomavyaapistavaHK-358	saptakoṭyaḥ mantrāḥ sarvāḥ vidyāḥ anantādyāḥ adhipāḥ	saptakoṭyaḥ mantrāḥ sarvāḥ vidyāḥ ananta ādyāḥ adhipāḥ 
MBvyomavyaapistavaHK-359	yasmādbhavanti tasmai sarva vidyādhipāya nama ityanvayaḥ | sarvavidyāḥ	yasmāt bhavanti tasmai sarva vidyā adhipāya namaḥ iti anvayaḥ sarva vidyāḥ 
MBvyomavyaapistavaHK-360	adhipāśca yasmāditi vyutpatyā sarvavidyādhipa pada vācyāya nama	adhipāḥ ca yasmāt iti vyutpatyā sarva vidyā adhipa pada vācyāya nama 
MBvyomavyaapistavaHK-361	ityarthaḥ ||	iti arthaḥ 
MBvyomavyaapistavaHK-362	navamapada stavamāha jyotiriti 	navama pada stavam āha jyotiḥ iti 
MBvyomavyaapistavaHK-363	jyotissakalaṃ yatprāk puṃsāṃ rūpayati tattu muktoyaḥ |	jyotiḥ sakalam yat prāk puṃsām rūpayati tat tu muktaḥ yaḥ 
MBvyomavyaapistavaHK-364	sarvārtha citkriyābhyāṃ jyotīrūpāya tubhyamapi namaḥ || 29 ||	sarva artha cit kriyābhyām jyotiḥ rūpāya tubhyam api namaḥ 
MBvyomavyaapistavaHK-365	puṃsāṃ prāk yat sakalaṃ jyātiḥ tanmuktau tu sarvārtha citkriyābhyāṃ	puṃsām prāk yat sakalam jyātiḥ tad muktau tu sarvārtha cit kriyābhyām 
MBvyomavyaapistavaHK-366	yaḥ rūpayati tasmai jyotīrūpāya tubhyaṃ nama ityanvayaḥ | jyotiḥ	yaḥ rūpayati tasmai jyotiḥ rūpāya tubhyam namaḥ iti anvayaḥ jyotiḥ 
MBvyomavyaapistavaHK-367	rūpayati vyaṃjayati iti vyutpatyā jyotirūpapadavācyāya tubhyaṃ nama	rūpayati vyaṃjayati iti vyutpatyā jyotiḥ ūpa pada vācyāya tubhyam nama 
MBvyomavyaapistavaHK-368	ityarthaḥ ||	iti arthaḥ 
MBvyomavyaapistavaHK-369	p. 30) atheṣāṃ navapadānāṃ pūjāvidhimāha padanavakamiti 	atha iṣām nava padānām pūjā vidhim āha pada navakam iti 
MBvyomavyaapistavaHK-370	padanavakametadāhuḥ kramatasvāgneya pīṭhaniviṣṭam |	pada navakam etat āhuḥ kramatasva āgneya pīṭha niviṣṭam 
MBvyomavyaapistavaHK-371	aṣṭācatvāriṃśadvarṇayutaṃ pūrvavattu saṃpūjyam || 30 ||	aṣṭācatvāriṃśat varṇa yutam pūrvavat tu saṃpūjyam 
MBvyomavyaapistavaHK-372	āgneya pīṭha niviṣṭaṃ aṣṭācatvāriṃśadvarṇayutaṃ etatpadanavakaṃ	āgneya pīṭha niviṣṭam aṣṭācatvāriṃśat varṇa yutam etat pada navakam 
MBvyomavyaapistavaHK-373	kramataḥ pūrvavatpūjyaṃ ityanvayaḥ | atra pīṭhe aghorahṛdayādīni	kramatas pūrvavat pūjyam iti anvayaḥ atra pīṭhe aghora hṛdaya ādīni 
MBvyomavyaapistavaHK-374	navāni padāni pūjanīyānītyarthaḥ ||	navāni padāni pūjanīyāni iti arthaḥ 
MBvyomavyaapistavaHK-375	athaprathamapadastavamāha prameśā iti 	atha prathama pada stavam āha prameśāḥ iti 
MBvyomavyaapistavaHK-376	parameśā vidyeśāḥ pūrvoddiṣṭāḥ parastu teṣāṃ yaḥ |	parameśāḥ vidyeśāḥ pūrva uddiṣṭāḥ paraḥ tu teṣām yaḥ 
MBvyomavyaapistavaHK-377	sva samatva kṛtestasmai te parameśvara parāya namaḥ || 31 ||	sva samatva kṛteḥ tasmai te parameśvara parāya namaḥ  /
MBvyomavyaapistavaHK-378	pūrvoddiṣṭāḥ vidyeśāḥ sva samatvakṛteḥ parameśāḥ teṣāṃ tu yaḥ	pūrva uddiṣṭāḥ vidyeśāḥ sva samatva kṛteḥ parameśāḥ teṣām tu yaḥ 
MBvyomavyaapistavaHK-379	paraḥ tasmai parameśvara parāya te nama ityanvayaḥ |	paraḥ tasmai parameśvara parāya te namaḥ iti anvayaḥ 
MBvyomavyaapistavaHK-380	parameśvarebhyo'nantādībhyaḥ para iti vyutpatyā parameśvara	parameśvarebhyaḥ ananta ādībhyaḥ paraḥ iti vyutpatyā parameśvara 
MBvyomavyaapistavaHK-381	parapadavācyāya namaḥ ityarthaḥ ||	para pada vācyāya namaḥ iti arthaḥ 
MBvyomavyaapistavaHK-382	p. 31) dvitīyapadastavamāha paśuvaditi 	dvitīya pada stavam āha paśu vat iti 
MBvyomavyaapistavaHK-383	paśuvannoyasyāsti dveṣādiyutā tu cetanā bauddhī |	paśu vat na ūyasya asti dveṣa ādi yutā tu cetanā bauddhī 
MBvyomavyaapistavaHK-384	muktaśśivavaccetanā nāsīdacetanā cetana namaste || 32 ||	muktaḥ śiva vat cetanā na āsīt acetanā cetana namaḥ te   
MBvyomavyaapistavaHK-385	he acetanācetana yasya paśuvat dveṣādiyutā bauddhī cetanā tu no asti	he acetana acetana yasya paśu vat dveṣa ādi yutā bauddhī cetanā tu no asti 
MBvyomavyaapistavaHK-386	mukta śivavacca cetanā nāsīt tasmai te nama ityanvayaḥ | paśu cetanā yasya	mukta śiva vat ca cetanā na āsīt tasmai te namaḥ iti anvayaḥ paśu cetanā yasya 
MBvyomavyaapistavaHK-387	navidyate saḥ acetanaḥ | (48) mukta cetanā yasya navidyate sopyacetanaḥ iti	na vidyate saḥ acetanaḥ mukta cetanā yasya na vidyate saḥ api acetanaḥ iti 
MBvyomavyaapistavaHK-388	vyutpatyā acetanācetana padavācyāya nama ityarthaḥ ||	vyutpatyā acetana acetana pada vācyāya namaḥ iti arthaḥ 
MBvyomavyaapistavaHK-389	tṛtīyapada stavamāha niṣkaleti 	tṛtīya pada stavam āha niṣkala iti 
MBvyomavyaapistavaHK-390	niṣkala vatsakalākhyā tanmūrttivyoma yasya rūpeṇa |	tad mūrtti vyoma yasya rūpeṇa 
MBvyomavyaapistavaHK-391	vyāptyādi naiva niyatā vyomāstu te namastasmai || 33 ||	vyāpti ādi nā eva niyatā vyom astu te namaḥ tasmai 
MBvyomavyaapistavaHK-392	he vyomavyoma yasya tava sakalākhyā mūrttiḥ niṣkalavat vyāptādinā	he vyoma vyoma yasya tava sakala ākhyā mūrttiḥ niṣkala vat vyāpta ādinā 
MBvyomavyaapistavaHK-393	rūpeṇaiva vyomaniyatā niścayārthaḥ dviruttayā tasmai te nama ityanvayaḥ	rūpeṇa eva vyoma niyatā niścaya arthaḥ dvis uttayā tasmai te namaḥ iti anvayaḥ 
MBvyomavyaapistavaHK-394	p. 32) vyoma śabdasya nitya napuṃsakatvāt mūrti śabdena strīliṃgena	vyoma śabdasya nitya napuṃsaka tvāt mūrti śabdena strīliṃgena 
MBvyomavyaapistavaHK-395	sāmānādhikaraṇyaṃ nā'nupapannam | vyomedaṃ vyomedamiti	sāmānādhikaraṇyam na anupapannam vyoma idam vyoma idam iti 
MBvyomavyaapistavaHK-396	dvirūktyā vyomavyomapadavācyāya nama ityarthaḥ ||	dvis ūktyā vyoma vyoma pada vācyāya namaḥ iti arthaḥ 
MBvyomavyaapistavaHK-397	caturthapadastavamāha tadvaditi 	caturtha pada stavam āha tadvat iti 
MBvyomavyaapistavaHK-398	tadvaccayasya mūrtissakalārthavyāpikaiva nāvyāptiḥ |	tadvat cayasya mūrtiḥ sakala artha vyāpikā eva na avyāptiḥ 
MBvyomavyaapistavaHK-399	prāṅmuktavattu tasmai vyāpinyāpinnamo'stu tubhyamapi ||	prāk mukta vat tu tasmai tubhyam api 
MBvyomavyaapistavaHK-400	yasya ca mūrtistadvat sakalārtha vyāpikaiva muktavat prāgavyāptiḥ na	yasya ca mūrtiḥ tadvat sakala artha vyāpikā eva mukta vat prāk avyāptiḥ na 
MBvyomavyaapistavaHK-401	tasmai tubhyaṃ he vyāpinyāpin namo'stu tadvat vyomavat ityarthaḥ | atra	tasmai tubhyam he vyāpin yāpin namaḥ astu tadvat vyoma vat iti arthaḥ atra 
MBvyomavyaapistavaHK-402	vyāpikaiva nāvyāptiriti niyamāt vyāptinyāpinpadavācyāya nama	  eva na   iti           
MBvyomavyaapistavaHK-403	ityarthaḥ ||	iti arthaḥ 
MBvyomavyaapistavaHK-404	pañcamapadastavamāha varṇeti 	pañcama pada stavam āha varṇa iti 
MBvyomavyaapistavaHK-405	p. 33) varṇaracane hi rūpaṃ paśumūrtau tadrasādisahitañca |	varṇa racane hi rūpam paśu mūrtau tad rasa ādi sahitam ca 
MBvyomavyaapistavaHK-406	mūrtau na vidyate yasya tu tasmaitvarūpya rūpinnamaḥ || 35 ||	mūrtau na vidyate yasya tu tasmai tu arūpya rūpin namaḥ 
MBvyomavyaapistavaHK-407	paśumūrtau varṇa racanehi rūpaṃ tadrasādi sahitaṃ ca yasya te mūrtau tat	paśu mūrtau rūpam tad rasa ādi sahitam ca yasya te mūrtau tat 
MBvyomavyaapistavaHK-408	na vidyate tasmai te nama ityanvayaḥ | varṇaḥ brāhmaṇatvādiḥ racanā	na vidyate tasmai te namaḥ iti anvayaḥ varṇaḥ brāhmaṇa tva ādiḥ racanā 
MBvyomavyaapistavaHK-409	avayava vinyāsa viśeṣaḥ rasādiḥ madhura gandhādiḥ varṇātmakañca	avayava vinyāsa viśeṣaḥ rasa ādiḥ madhura gandha ādiḥ varṇa ātmakañca 
MBvyomavyaapistavaHK-410	rūpaṃ racanātmakañca rūpaṃ ubhayaṃ nāsti | kalpanayā arūpyarūpi	rūpam racanā ātmakam ca rūpam ubhayam na asti kalpanayā arūpi arūpi 
MBvyomavyaapistavaHK-411	padavācyāya nama ityarthaḥ |	pada vācyāya namaḥ iti arthaḥ 
MBvyomavyaapistavaHK-412	ṣaṣṭhapada stavamāha prathameti 	ṣaṣṭha padaḥ stavam āha prathamā iti 
MBvyomavyaapistavaHK-413	prathamā ca prathamāna dvitīyādi yutaiva mūrtiryat |	prathamā ca dvitīya ādi yutā eva mūrtiḥ yat 
MBvyomavyaapistavaHK-414	mūrtiryasyā preryā prathama prathamāstu te namastasmai || 36 ||	mūrtiḥ yasyā preryā prathama prathamā astu te namaḥ tasmai 
MBvyomavyaapistavaHK-415	he prathama prathama sarvamūrti prathamā ca prathamānā bhūtvā	he prathama prathama sarvamūrti prathamā ca prathamānā bhūtvā 
MBvyomavyaapistavaHK-416	dvitīyādi yutaiva iti yat tasmāddhetoḥ sā prathama	dvitīya ādi yutā eva iti yat tasmāt hetoḥ sā prathama 
MBvyomavyaapistavaHK-417	prathamānetyadhyāhāraḥ yasya tavamūrtiḥ prathamā apreryā satī	prathamānā iti adhyāhāraḥ yasya tava mūrtiḥ prathamā a preryā satī 
MBvyomavyaapistavaHK-418	prathamāna dvitīyādi sahitā tasmai te namostvityanvayaḥ prathama	tasmai te namaḥ ustu iti anvayaḥ prathama 
MBvyomavyaapistavaHK-419	dvitīyāvasthā bhedaḥ śiva mūrtirnityatvāt nāvasthā bheda iti bhāvaḥ ||	dvitīya avasthā bhedaḥ śiva mūrtiḥ nitya tvāt na avasthā bhedaḥ iti bhāvaḥ 
MBvyomavyaapistavaHK-420	p. 34) saptamapadastavamāha sarveti 	saptama pada stavam āha sarva iti 
MBvyomavyaapistavaHK-421	sarvajñataiva tejastanmūrtau yasya rūpamathanānyat |	sarvajña tā eva tejaḥ tad mūrtau yasya rūpa mathana anyat 
MBvyomavyaapistavaHK-422	pūrvaniṣedhāttasmai tejastejo namo'stu tubhyamapi || 37 ||	pūrva niṣedhāt tasmai tejaḥ tejaḥ namaḥ astu tubhyam api 
MBvyomavyaapistavaHK-423	(49) yasya tanmūrtau sarvajñatā teja eva rūpaṃ athānyanna kutaḥ	yasya tad mūrtau sarvajña tā tejaḥ eva rūpam atha anyat na kutas 
MBvyomavyaapistavaHK-424	pūrvaniṣedhāt tasmai tubhyaṃ he tejastejaḥ namo'stvityanvayaḥ |	pūrva niṣedhāt tasmai tubhyam he tejaḥ tejaḥ namaḥ astu iti anvayaḥ 
MBvyomavyaapistavaHK-425	arūpītyatra rūpaniṣedhaḥ pūrva niṣedhaḥ teja eva rūpamiti niyamāt	arūpi iti atra rūpa niṣedhaḥ niṣedhaḥ tejaḥ eva rūpam iti niyamāt 
MBvyomavyaapistavaHK-426	dvirūttayā tejastejaḥ pada vācyāya nama ityarthaḥ ||	tejaḥ tejaḥ pada vācyāya namaḥ iti arthaḥ 
MBvyomavyaapistavaHK-427	aṣṭama padastavamāha jyotiriti 	aṣṭama pada stavam āha jyotiḥ iti 
MBvyomavyaapistavaHK-428	jyotistu sarvakṛtyaṃ rūpadāhādi kartṛ lakṣaṇayā |	jyotiḥ tu sarva kṛtyam rūpa dāha ādi kartṛ lakṣaṇayā 
MBvyomavyaapistavaHK-429	tadapi ca mūrtau yasya jyātirjyotirnamostu tasmai te || 38 ||	tat api ca mūrtau yasya jyātiḥ jyotiḥ namaḥ astu tasmai te 
MBvyomavyaapistavaHK-430	p. 35) dāhādi kartṛlakṣaṇayā sarva kṛtyantu jyotīrūpaṃ tadapi yasya	dāha ādi kartṛ lakṣaṇayā jyotīrūpam tat api yasya 
MBvyomavyaapistavaHK-431	mūrtau tasmai te namo'stvityanvayaḥ | atra jyotistviti śabdasya evakārārtha	mūrtau tasmai te namaḥ ustu iti anvayaḥ atra jyotiḥ tu iti śabdasya eva kāra artha 
MBvyomavyaapistavaHK-432	tayā niyamasphuraṇāt dvirūktyā jyotirjotiḥ padavācyāya nama ityarthaḥ ||	tayā niyama sphuraṇāt dvirūktyā jyotiḥ jotiḥ pada vācyāya namaḥ iti arthaḥ 
MBvyomavyaapistavaHK-433	navamapadastavamāha taditi 	navama pada stavam āha tat iti 
MBvyomavyaapistavaHK-434	taccārkasomaśikhimaṇi tejorūpaṃ na kiñcana hi bhāvyam |	tat ca arka soma śikhimaṇi tejaḥ rūpam na kiñcana hi bhāvyam 
MBvyomavyaapistavaHK-435	sadaiva tava vimalaṃ yasya tu tasmaitvarūpate'stu namaḥ || 39 ||	sadā eva tava vimalam yasya tu tasmai tu arūpateḥ tu namaḥ 
MBvyomavyaapistavaHK-436	arka soma śikhimaṇi tejorūpaṃ kiñcana sadā bhāvyaṃ nahi yasya tava	arka soma śikhimaṇi tejaḥ rūpam kiñcana sadā bhāvyam nahi yasya tava 
MBvyomavyaapistavaHK-437	vimalaṃ rūpaṃ sadaiva bhāvyaṃ taddhetoḥ he arūpa tasmai te	vimalam rūpam sadā eva bhāvyam tad hetoḥ he arūpa tasmai te 
MBvyomavyaapistavaHK-438	namo'stvityanvayaḥ | śikhī vahniḥ vīryāditejasāṃ rūpaṃ	namaḥ astu iti anvayaḥ śikhī vahniḥ vīrya ādi tejasām rūpam 
MBvyomavyaapistavaHK-439	sadānabhāsate malinastvasambhavāt śivatejastu malinatvā'saṃbhavāt	malinaḥ tu asaṃbhavāt śiva tejaḥ tu malina tva asaṃbhavāt 
MBvyomavyaapistavaHK-440	bhāsate | tasmāt malina rūpa rahitatayā arūpa pada vācyāya nama	bhāsate tasmāt malina rūpa rahitatayā arūpa pada vācyāya nama 
MBvyomavyaapistavaHK-441	ityarthaḥ ||	iti arthaḥ 
MBvyomavyaapistavaHK-442	p. 36) atheṣāṃ navānāṃ padānāṃ pūjāprakāramāha rurugīteti 	atha iṣām navānām padānām pūjā prakāram āha ruru gīta iti 
MBvyomavyaapistavaHK-443	rurugītā rūpāntyaṃ dakṣiṇapīṭhasthametadatha pūjyam |	ruru gītā rūpa antyam dakṣiṇa pīṭha stham etat atha pūjyam 
MBvyomavyaapistavaHK-444	padanavakaṃ pañcādhikacatvāriṃśatpramāṇavarṇayutam || 40 ||	pada navakam pañca adhika catvāriṃśat pramāṇa varṇa yutam 
MBvyomavyaapistavaHK-445	rurugītā rūpāntyaṃ dakṣiṇapīṭhasthaṃ pañcādhika	rurugītā rūpa antyam dakṣiṇa pīṭha stham pañca adhika 
MBvyomavyaapistavaHK-446	catvāriṃśadvarṇayutaṃ etatpada navakaṃ atha pūjyamityanvayaḥ |	catvāriṃśat varṇa yutam etat pada navakam atha pūjyam iti anvayaḥ 
MBvyomavyaapistavaHK-447	asminpīṭhe parameśvara parādīni nava padāni pūjanīyānītyarthaḥ ||	asmin pīṭhe parameśvara para ādīni nava padāni pūjanīyāni iti arthaḥ 
MBvyomavyaapistavaHK-448	naiṛta pīṭha padastavamāha agnerityādinā navabhirāryābhiḥ |	naiṛta pīṭha pada stavam āha agneḥ ityādinā navabhiḥ āryābhiḥ 
MBvyomavyaapistavaHK-449	tatra prathama padastvamāha 	tatra prathama padastvam āha 
MBvyomavyaapistavaHK-450	agneraindhanaṭhevadyutakālānala lakṣaṇādidañcānyat |	agneḥ aindhana ṭheva dyuta kāla anala lakṣaṇāt idam ca anyat 
MBvyomavyaapistavaHK-451	sakala mala dahana heturjyotiryasya tu namostvanagne te ||	sakala mala dahana hetuḥ jyotiḥ yasya tu namaḥ ustu anagne te 
MBvyomavyaapistavaHK-452	aindhana vaidyuta kālānala lakṣaṇāt agneḥ anyat sakalamala dahana hetuḥ	aindhana vaidyuta kālānala lakṣaṇāt agneḥ anyat sakala mala dahana hetuḥ 
MBvyomavyaapistavaHK-453	jyotiḥ yasya tu bhavati tasmai te he anagne namo'stvityanvayaḥ |	jyotiḥ yasya tu bhavati tasmai te he anagne namaḥ astu iti anvayaḥ 
MBvyomavyaapistavaHK-454	svajyoti rūpāt anyo'gni navidyate yasyeti vyutpatyā anagnipada vācyāya	svajyoti rūpāt anyogni na vidyate yasya iti vyutpatyā anagni pada vācyāya 
MBvyomavyaapistavaHK-455	nama ityarthaḥ ||	namaḥ iti arthaḥ 
MBvyomavyaapistavaHK-456	dvitīyapadastavamāha taditi 	dvitīya pada stavam āha tat iti 
MBvyomavyaapistavaHK-457	tajjyotiṣassadhūmādrāgadveṣādi citprakaṃpayujaḥ |	tad jyotiṣaḥ sa dhūmāt rāga dveṣa ādi cit prakaṃpa yujaḥ 
MBvyomavyaapistavaHK-458	pudgalakādapyanyajjyotiryasyatvadhūmate'stu namaḥ || 42 ||	pudgalakāt api anyat jyotiḥ yasya tva dhūmateḥ tu namaḥ 
MBvyomavyaapistavaHK-459	(50) yasya jyotiḥ sadhūmāt tajjyotiṣaḥ rāgadveṣādi citprakaṃpayujaḥ	yasya jyotiḥ sa dhūmāt tad jyotiṣaḥ rāga dveṣa ādi cit prakaṃpa yujaḥ 
MBvyomavyaapistavaHK-460	pudgalakādapi jyotiṣaḥ anyat tasmai te he adhūma te namo'stu ityanvayaḥ |	pudgalakāt api jyotiṣaḥ anyat tasmai te he adhūma te namaḥ astu iti anvayaḥ 
MBvyomavyaapistavaHK-461	na vidyate jyotiḥ yasyeti vyutpatyā adhūmapadavācyāya nama ityarthaḥ |	na vidyate jyotiḥ yasya iti vyutpatyā a dhūma pada vācyāya namaḥ iti arthaḥ 
MBvyomavyaapistavaHK-462	tṛtīyapadastavamāha tadvaditi 	tṛtīya pada stavam āha tadvat iti 
MBvyomavyaapistavaHK-463	tadvacca bhasmayuktāttadasārajyotiṣo nṛkartṛkatvāt |	tadvat ca bhasma yuktāt tat asāra jyotiṣaḥ nṛ kartṛka tvāt 
MBvyomavyaapistavaHK-464	sarvārthamanyaduktaṃ jyotiryasya tu namostvabhasma tava || 43 ||	sarva artham anyat uktam jyotiḥ yasya tu namaḥ ustu abhasma tava  /
MBvyomavyaapistavaHK-465	yasya tava anyat uktaṃ sarvārthaṃ jyotiḥ tadvat bhasmayuktāt tadasāra	yasya tava anyat uktam sarva artham jyotiḥ tadvat bhasma yuktāt 
MBvyomavyaapistavaHK-466	nṛkartṛkatvāt jyotiṣo anyat tasmai te he abhasma namo'stvityanvayaḥ |	nṛ kartṛka tvāt jyotiṣaḥ anyat tasmai te he abhasma namaḥ astu iti anvayaḥ 
MBvyomavyaapistavaHK-467	p. 38) na vidyate jyotiḥ bhasma yasyetivyutpatyā abhasmapadavācyāya nama	na vidyate jyotiḥ bhasma yasya iti vyutpatyā abhasma pada vācyāya nama 
MBvyomavyaapistavaHK-468	ityarthaḥ ||	iti arthaḥ 
MBvyomavyaapistavaHK-469	caturthapadastavamāha taditi 	caturtha pada stavam āha tat iti 
MBvyomavyaapistavaHK-470	tajjyotirūpāsau mūrtissaiṣā svabhāvato vimalā |	tad jyotiḥ rūpā asau mūrtiḥ sā eṣā svabhāvataḥ vimalā 
MBvyomavyaapistavaHK-471	sakalaśreyo heturyasyānādi namo'stvanādete || 44 ||	sakala śreyaḥ hetuḥ yasya anādi namaḥ stu anāde te  
MBvyomavyaapistavaHK-472	yasya asau mūrtiḥ tajjyotirūpā svabhāvato vimalā saiṣā	yasya asau mūrtiḥ tad jyotiḥ rūpā svabhāvataḥ vimalā sā eṣā 
MBvyomavyaapistavaHK-473	sakalaśreyohetuḥ anādiḥ tasmai te he anade namo'stvityanvayaḥ |	sakala śreyaḥ hetuḥ anādiḥ tasmai te he anade namaḥ astu iti anvayaḥ 
MBvyomavyaapistavaHK-474	śivamūrtesnāditvāt śivasyāpi anāditvāt anādipadavācyāya nama	śiva mūrteḥ snādi tvāt śivasya api anādi tvāt anādi pada vācyāya nama 
MBvyomavyaapistavaHK-475	ityarthaḥ ||	iti arthaḥ 
MBvyomavyaapistavaHK-476	pañcamapadastavamāha nāpuruṣa iti 	pañcama pada stavam āha na a puruṣaḥ iti 
MBvyomavyaapistavaHK-477	nāpuruṣatritayaṃ haraharikamalodbhavaṃ hi poṣayati |	                           
MBvyomavyaapistavaHK-478	nā nā nā tvaktokta striyātmā yo namastasmai || 45 ||	nā nā nā tvakta uktaḥ striyā ātmā yaḥ namaḥ tasmai 
MBvyomavyaapistavaHK-479	p. 39) nāpuruṣa tritayaṃ harahari kamalodbhavaṃ poṣayati hi tataḥ atra	na apuruṣa tritayam hara hari kamala udbhavam poṣayati hi tatas atra 
MBvyomavyaapistavaHK-480	śāsane yaḥ tritayātmāsan nā nā nā uktaḥ tasmai nama ityanvayaḥ |	śāsane yaḥ tritaya ātmā āsan nā nā nā uktaḥ tasmai namaḥ iti anvayaḥ 
MBvyomavyaapistavaHK-481	haraharibrahmaṇāṃ nṝṇāṃ trayāṇāṃ vācakatayā nā nā nā	hara hari brahmaṇām nṝṇām trayāṇām vācaka tayā nā nā nā 
MBvyomavyaapistavaHK-482	padavācyāya nama ityarthaḥ ||	pada vācyāya namaḥ iti arthaḥ 
MBvyomavyaapistavaHK-483	ṣaṣṭhapadastavamāha saṃhāreti 	ṣaṣṭha pada stavam āha saṃhāra iti 
MBvyomavyaapistavaHK-484	saṃhāresvatritayaṃ kaṃpayati yena tena guṇavṛtyā |	saṃhāre sva tritayam kaṃpayati yena tena guṇa vṛtyā 
MBvyomavyaapistavaHK-485	dhūkāratraya vācyo yotra tu tasmai namo'stu tubhyamapi || 46 ||	dhūkāra traya vācyaḥ yaḥ tra tu tasmai namaḥ ustu tubhyam api 
MBvyomavyaapistavaHK-486	sva tritayaṃ saṃhāre vartate yena kāraṇena tena hetunā dhūkaṃpana	tritayam saṃhāre vartate yena kāraṇena tena hetunā dhūkaṃpana 
MBvyomavyaapistavaHK-487	ityarthamavalaṃbhya kaṃpayatīti guṇavṛtyā yaḥ dhūkāratrayavācyaḥ	iti artham avalaṃbhya kaṃpayati iti guṇa vṛtyā yaḥ dhūkāra traya vācyaḥ 
MBvyomavyaapistavaHK-488	tasmai tubhyaṃ namo'stvityanvayaḥ | pralayeṣu kaṃpana saṃbhavāt	tasmai tubhyam namaḥ astu iti anvayaḥ pralayeṣu kaṃpana saṃbhavāt 
MBvyomavyaapistavaHK-489	kaṃpana śabdasya saṃhāra lakṣakatve sati susādhya pralayatraya vācaka	kaṃpana śabdasya saṃhāra lakṣaka tve sati susādhya pralaya traya vācaka 
MBvyomavyaapistavaHK-490	dhū dhū dhū pada vācyāya nama ityarthaḥ ||	dhū dhū dhū pada vācyāya namaḥ iti arthaḥ 
MBvyomavyaapistavaHK-491	saptama padastavamāha stutiriti 	saptama pada stavam āha stutiḥ iti 
MBvyomavyaapistavaHK-492	p. 40) stutirūpamasatyamarthaṃ manujātannaitaditi ya āliṅgya |	stuti rūpam asatyam artham manu jāta na etat iti yaḥ āliṅgya 
MBvyomavyaapistavaHK-493	oṃbhūriti satyārthai mantrapadairucyate namostvoṃbhūḥ || 47 ||	om bhūḥ iti mantra padaiḥ ucyate namaḥ astu om bhūḥ 
MBvyomavyaapistavaHK-494	etat manujātaṃ lokapaṭhyamāna mantrajālaṃ stutirūpaṃ asatyārthaṃ	etat manu jātam loka paṭhyamāna mantra jālam stuti rūpam asatya artham 
MBvyomavyaapistavaHK-495	(51) neti oṃbhūḥ ityāliṅgya vācyaḥ yaḥ śivaḥ satyārthaiḥ mantrapadaiḥ	na iti om bhūḥ iti āliṅgya vācyaḥ yaḥ śivaḥ satya arthaiḥ mantra padaiḥ 
MBvyomavyaapistavaHK-496	ucyate tasmai tubhyaṃ oṃbhūḥ namo'stvityanvayaḥ | ayaṃ bhāvaḥ oṃ	ucyate tasmai tubhyam oṃ bhūḥ namaḥ astu iti anvayaḥ ayam bhāvaḥ om 
MBvyomavyaapistavaHK-497	śabdena śiva ucyate bhūḥ lokaḥ oṃ bhūrityanena lokeśayorabhedaḥ	śabdena śivaḥ ucyate bhūḥ lokaḥ om bhūḥ iti anena lokeśayoḥ abhedaḥ 
MBvyomavyaapistavaHK-498	sphurati tataśca vedāntibhiḥ lokānāmasatya varṇanāt	sphurati tatas ca vedāntibhiḥ lokānām asatya varṇanāt 
MBvyomavyaapistavaHK-499	tatpratipādakamantrāṇāṃ asatyārtha śaṃkānirastā | lokasya satyabhūta	tad pratipādaka mantrāṇām asatya artha lokasya satya bhūta 
MBvyomavyaapistavaHK-500	śivābheda varṇanayā satvasaṃbhavāt | ata eva satyārthā eva sarve	śiva abheda varṇanayā sattva saṃbhavāt atas eva satya arthāḥ eva sarve 
MBvyomavyaapistavaHK-501	mantrāḥ iti pratīti phalaka oṃbhūḥpada vācyāya nama ityarthaḥ ||	mantrāḥ iti prati iti phalaka oṃ bhūḥ pada vācyāya namaḥ iti arthaḥ 
MBvyomavyaapistavaHK-502	aṣṭamapadastavamāha omiti 	aṣṭama pada stavam āha om iti 
MBvyomavyaapistavaHK-503	omiti ceśassabhuvo bhuvanasametasya tatvabhāvādeḥ |	om iti ca īśaḥ sabhuvaḥ bhuvana sametasya ta tva bhāva ādeḥ 
MBvyomavyaapistavaHK-504	p. 41) sakalopi yo'tra kathitastvoṃbhuva iti namo'stu tasmai ca || 48 ||	sakalaḥ api yaḥ tra kathitaḥ tvoṃbhuve iti namaḥ astu tasmai ca 
MBvyomavyaapistavaHK-505	omiti asmin śāsane omiti yaḥ īśaḥ kathitaḥ sa eva bhuvana sametasya tatva	omiti asmin śāsane omiti yaḥ īśaḥ kathitaḥ saḥ eva bhuvana sametasya 
MBvyomavyaapistavaHK-506	bhāvādeḥ sakalo'pibhuvaḥ sa eva kathitaḥ oṃbhuva iti kathitaḥ tasmai	bhāva ādeḥ sakala upi bhuvaḥ saḥ eva kathitaḥ om bhuvaḥ iti kathitaḥ tasmai 
MBvyomavyaapistavaHK-507	namoṃ'stvityanvayaḥ | īśa bhuvarlokā'bheda bodhaka oṃbhuvaḥ	namaḥ om tu iti anvayaḥ īśa bhuvarloka abheda bodhakaḥ om bhuvaḥ 
MBvyomavyaapistavaHK-508	padavācyāya nama ityarthaḥ ||	pada vācyāya namaḥ iti arthaḥ 
MBvyomavyaapistavaHK-509	navama padastvamāha omiti 	om iti 
MBvyomavyaapistavaHK-510	paramā prīti svariti paramasukhātmikaiva yasyoktam |	paramā svar iti parama sukha ātmikā eva yasya uktam 
MBvyomavyaapistavaHK-511	rūpaṃ mukhyaṃ kṛtakaṃ hmoṃ svaritītthaṃ namo'stu tasmai te || 49 ||	rūpam mukhyam kṛtakam hmoṃ svar iti ittham namaḥ astu tasmai te 
MBvyomavyaapistavaHK-512	omiti paramā prītiḥ svariti paramasukhātmikaiva itthaṃ kṛtakaṃ rūpaṃ	om iti paramā prītiḥ svar iti parama sukha ātmikā eva ittham kṛtakam rūpam 
MBvyomavyaapistavaHK-513	parama prītiḥ parama sukhākāraṃ rūpaṃ yasya oṃ svaḥ ityuktaṃ tasmai	parama prītiḥ parama sukha ākāram rūpam yasya om svar iti uktam tasmai 
MBvyomavyaapistavaHK-514	te namo'stvityanvayaḥ | parama premāspada paramānandabodhaka oṃ svaḥ	te namaḥ astu iti anvayaḥ parama prema āspada paramānanda bodhaka om svar 
MBvyomavyaapistavaHK-515	pada vācyāya nama ityarthaḥ ||	pada vācyāya namaḥ iti arthaḥ 
MBvyomavyaapistavaHK-516	p. 42) eṣāṃ padānāṃ pūjāprakāramāha padanavakamiti 	eṣām padānām pūjā prakāram āha pada navakam iti 
MBvyomavyaapistavaHK-517	padanavakametaditthaṃ rurugītaṃ sarvadaiva navanābhe |	pada navakam etat ittham ruru gītam sarvadā eva nava nābhe 
MBvyomavyaapistavaHK-518	naiṛta pīṭhe pūjyaṃ yuktaṃ varṇaistu paṃcaviṃśatyā || 50 ||	naiṛta pīṭhe pūjyam yuktam varṇaiḥ tu paṃcaviṃśatyā 
MBvyomavyaapistavaHK-519	itthaṃ rurugītaṃ pañcaviṃśatyā varṇaistu yuktaṃ etatpadanavakaṃ	ittham ruru gītam pañcaviṃśatyā varṇaiḥ tu yuktam etat pada navakam 
MBvyomavyaapistavaHK-520	navanābhe naiṛtapīṭhe sarvadaiva pūjyamityanvayaḥ | naiṛtapīṭhe anagne	nava nābhe naiṛta pīṭhe sarvadā eva pūjyam iti anvayaḥ naiṛta pīṭhe anagne 
MBvyomavyaapistavaHK-521	ityādi navapadāni pūjyānītyarthaḥ |	ityādi nava padāni pūjyāni iti arthaḥ 
MBvyomavyaapistavaHK-522	paścimapīṭha padanavakastavamāha śambhurityādibhiḥ	paścima pīṭha pada navaka stavam āha śambhuḥ ityādibhiḥ 
MBvyomavyaapistavaHK-523	navabhirāryābhiḥ | tatra prathamapadastavamāha śambhuriti 	navabhiḥ āryābhiḥ tatra prathama pada stavam āha śambhuḥ iti 
MBvyomavyaapistavaHK-524	śambhuranidhano gīto māyācakra pravāhataḥ kintu |	śambhuḥ anidhanaḥ gītaḥ māyā cakra pravāhataḥ kintu 
MBvyomavyaapistavaHK-525	kūṭastha tayā yosau namo'stu tepyanidhanā nidhanatasmai || 51 ||	tayā yaḥ asau namaḥ astu tasmai 
MBvyomavyaapistavaHK-526	yo'sau śaṃbhuḥ māyācakrapravāhataḥ māyā ca kṛsya prapañcasya	yaḥ asau śaṃbhuḥ māyā cakra pravāhataḥ māyā ca prapañcasya 
MBvyomavyaapistavaHK-527	anāditayā pravāhāt hetoḥ tatkartā anidhanaḥ nidhanaṃ nāśaḥ tadrahitaḥ	anādi tayā pravāhāt hetoḥ tad kartā anidhanaḥ nidhanam nāśaḥ tad rahitaḥ 
MBvyomavyaapistavaHK-528	anāśaḥ karturabhāve pravāhānupapatteḥ |	anāśaḥ kartuḥ abhāve pravāha anupapatteḥ 
MBvyomavyaapistavaHK-529	p. 43) kiñca kūṭasthatayā ca anidhanaḥ kūṭasthasyā'vikāritva	kiñca kūṭastha tayā ca anidhanaḥ 
MBvyomavyaapistavaHK-530	lakṣaṇatvāt nāśarahitaḥ (52) tasmai te he anidhanā'nidhana	lakṣaṇa tvāt nāśa rahitaḥ tasmai te he anidhana anidhana 
MBvyomavyaapistavaHK-531	namo'stvityanvayaḥ | ubhayathāpi nāśarahitatvāt	namaḥ astu iti anvayaḥ ubhayathā api nāśa rahita tvāt 
MBvyomavyaapistavaHK-532	anidhanānidhanapadavācyāya nama ityarthaḥ ||	a nidhana a nidhana pada vācyāya namaḥ iti arthaḥ 
MBvyomavyaapistavaHK-533	dvitīyapadastavamāha nidhaneti 	dvitīya pada stavam āha nidhana iti 
MBvyomavyaapistavaHK-534	nidhanodbhavādi yasmād bhavati śivād vīrabhadramukhyānām |	nidhana udbhava ādi yasmāt bhavati śivāt vīrabhadra mukhyānām 
MBvyomavyaapistavaHK-535	māyāgarbheśānānnidhanodbhavate namo'stu tasmai ca || 52 ||	māyā garbha īśānāt nidhana udbhavate namaḥ astu tasmai ca 
MBvyomavyaapistavaHK-536	yasmāt śivāt vīrabhadramukhyānāṃ māyāgarbheśānāṃ	yasmāt śivāt vīrabhadra mukhyānām māyā garbha īśānām 
MBvyomavyaapistavaHK-537	nidhanodbhavādi bhavati saṃhāra sṛṣṭyādi bhavantītyarthaḥ tasmai te he	nidhana udbhava ādi bhavati saṃhāra sṛṣṭi ādi bhavanti iti arthaḥ tasmai te he 
MBvyomavyaapistavaHK-538	nidhanodbhava namo'stu ityanvayaḥ | vīrabhadrādīnāṃ	nidhana udbhava namaḥ astu iti anvayaḥ vīrabhadra ādīnām 
MBvyomavyaapistavaHK-539	nidhanodbhavakartṛtvāt nidhanodbhavapadavācyāya nama ityarthaḥ ||	nidhanodbhava kartṛ tvāt nidhanodbhava pada vācyāya namaḥ iti arthaḥ 
MBvyomavyaapistavaHK-540	tṛtīyapadastavamāha aśiva iti 	tṛtīya pada stavam āha aśivaḥ iti 
MBvyomavyaapistavaHK-541	p. 44) aśivo śivapadatvācchivona yo bhavati karmarūpaṃ yat |	aśivaḥ śiva pada tvāt śivaḥ na yaḥ bhavati karma rūpam yat 
MBvyomavyaapistavaHK-542	guruvatkevalamaśubhaṃ vyanaktiyastena namo'stu śiva tasmai || 53 ||	guru vat kevalam aśubham vyanakti yaḥ tena namaḥ astu śiva tasmai 
MBvyomavyaapistavaHK-543	yaḥ śivaḥ na bhavati saḥ aśivaḥ aśiva pradatvāt kevalaṃ aśubhaṃ	yaḥ śivaḥ na bhavati saḥ aśivaḥ aśiva prada tvāt kevalam aśubham 
MBvyomavyaapistavaHK-544	vyanakti tadvavatirekeṇa tu yaḥ aśivaḥ na saḥ śivaḥ śiva pradatvāt	vyanakti tu yaḥ aśivaḥ na saḥ śivaḥ śiva prada tvāt 
MBvyomavyaapistavaHK-545	śaktirūpaṃ kevalaṃ śubhaṃ vyanaktīti yat tatkāraṇāt he śiva tasmai	śakti rūpam kevalam śubham vyanakti iti yat tad kāraṇāt he śiva tasmai 
MBvyomavyaapistavaHK-546	namo'stvityanvayaḥ | aśiva haratayā śiva pradatayā ca śiva padavācyāya	namaḥ astu iti anvayaḥ aśiva hara tayā śiva prada tayā ca śiva pada vācyāya 
MBvyomavyaapistavaHK-547	nama ityarthaḥ ||	namaḥ iti arthaḥ 
MBvyomavyaapistavaHK-548	caturthapadastavamāha sarvasyeti 	caturtha pada stavam āha sarvasya iti 
MBvyomavyaapistavaHK-549	sarvasya sarvadā tatsarvaṃ sarvatra karmahetuphalam |	sarvasya sarvadā tat sarvam sarvatra karma hetu phalam 
MBvyomavyaapistavaHK-550	janayan sarvaḥ kathitaḥ yo'tu tasmai namo'sarvāpi || 54 ||	janayan sarvaḥ kathitaḥ tasmai 
MBvyomavyaapistavaHK-551	sarvasya sarvajanasya sarvadā sarvakālaṃ sarvatra sarvadeśe sarvaṃ	sarvasya sarva janasya sarvadā sarvakālam sarvatra sarva deśe sarvam 
MBvyomavyaapistavaHK-552	sakalaṃ karmahetu karmakāraṇakaṃ karmajamityarthaḥ | phalaṃ janayan yat	sakalam karma hetu karma kāraṇakam karma jam iti arthaḥ phalam janayan yat 
MBvyomavyaapistavaHK-553	tatkāraṇāt atra śivaśāsane yaḥ sarvaḥ kathitaḥ he sarva tasmai nama	tad kāraṇāt atra śiva śāsane yaḥ sarvaḥ kathitaḥ he sarva tasmai nama 
MBvyomavyaapistavaHK-554	ityanvayaḥ |	iti anvayaḥ 
MBvyomavyaapistavaHK-555	p. 45) sarvaphalapradatayā sarvapadavācyāya nama ityarthaḥ ||	sarva phala prada tayā sarva pada vācyāya namaḥ iti arthaḥ 
MBvyomavyaapistavaHK-556	pañcamapadastavamāha parama iti 	pañcama pada stavam āha paramaḥ iti 
MBvyomavyaapistavaHK-557	paramaścāsāvātmā kāraṇamuktastu kāraṇānāṃ yaḥ |	paramaḥ ca asau ātmā kāraṇam uktaḥ tu kāraṇānām yaḥ 
MBvyomavyaapistavaHK-558	cidacidvibhedabhājāṃ sarveṣānte namo'stu paramātman || 55 ||	cit acit vibheda bhājām sarveṣām ante namaḥ astu paramātman   
MBvyomavyaapistavaHK-559	yo'sau paramaścāsau ātmā ca cidacidvibhedabhājāṃ kāraṇānāṃ	yaḥ asau paramaḥ ca asau ātmā ca cit acit vibheda bhājām kāraṇānām 
MBvyomavyaapistavaHK-560	kāraṇaṃ uktaḥ tasmai te he paramātman namostvityanvayaḥ |	kāraṇam uktaḥ tasmai te he paramātman namaḥ astu iti anvayaḥ 
MBvyomavyaapistavaHK-561	utkṛṣṭātmavācaka paramātmapada vācyāya nama ityarthaḥ ||	utkṛṣṭa ātma vācaka paramātma pada vācyāya namaḥ iti arthaḥ 
MBvyomavyaapistavaHK-562	ṣaṣṭhapadastavamāha pūjyānāmiti 	ṣaṣṭha pada stavam āha pūjyānām iti 
MBvyomavyaapistavaHK-563	pūjyānāmapi pūjyo vidyeśānāmananta mukhyānām |	pūjyānām api pūjyaḥ vidyeśānām ananta mukhyānām 
MBvyomavyaapistavaHK-564	muktyai maheśvaratvādyastu tasmai maheśvara namaste || 56 ||	muktyai maheśvara tvāt yaḥ tu tasmai maheśvara namaḥ te 
MBvyomavyaapistavaHK-565	yastu maheśvaratvāt pūjyānāṃ anantamukhyānāṃ vidyeśānāmapi	yaḥ tu maheśvara tvāt pūjyānām ananta mukhyānām vidyeśānām api 
MBvyomavyaapistavaHK-566	muktyai mokṣa phalāya pūjyaḥ tasmai te he maheśvara nama ityanvayaḥ |	muktyai mokṣa phalāya pūjyaḥ tasmai te he maheśvara namaḥ iti anvayaḥ 
MBvyomavyaapistavaHK-567	mahatāmanantādīnāmapi īśvara iti vyutpatyā maheśvara pada vācyāya	mahatām ananta ādīnām api īśvaraḥ iti vyutpatyā maheśvara pada vācyāya 
MBvyomavyaapistavaHK-568	nama ityarthaḥ ||	namaḥ iti arthaḥ 
MBvyomavyaapistavaHK-569	saptamapadastavamāha mukta iti 	saptama pada stavam āha muktaḥ iti 
MBvyomavyaapistavaHK-570	muktaśśivebhyopi mahān devaśśāntatvato hi yassākṣāt |	muktaḥ śivebhyaḥ api mahān devaḥ śānta tvataḥ hi yaḥ sākṣāt 
MBvyomavyaapistavaHK-571	tepyarcitāyadarcā tasya tu tasmai namo mahādeva || 57 ||	te api arcitā ayat arcā tasya tu tasmai namaḥ mahādeva 
MBvyomavyaapistavaHK-572	(53) yaśśivaḥ sākṣāt parānapekṣayā śāntatvataḥ rāgadveṣa	yaḥ śivaḥ sākṣāt para anapekṣayā śānta tvataḥ rāga dveṣa 
MBvyomavyaapistavaHK-573	rāgadveṣarahitatvataḥ svatassiddha rāgādi rāhityavatvādityarthaḥ muktaḥ	rāga dveṣa rahita tvataḥ svatas siddha rāga ādi rāhityavat tvāt iti arthaḥ muktaḥ 
MBvyomavyaapistavaHK-574	śivebhyo'pi mahān devaḥ te'pi muktāḥ śivā'pītyarthaḥ	śivebhyaḥ api mahān devaḥ te api muktāḥ śiva api iti arthaḥ 
MBvyomavyaapistavaHK-575	yadarcāyacchivaviṣayā arcā yeṣāṃ te tathoktāssantaḥ tasya arcitā	yad arcā ayat śiva viṣayā arcā yeṣām te tathā uktāḥ santaḥ tasya arcitā 
MBvyomavyaapistavaHK-576	bhavanti | he mahādeva tasmai te nasmo'stvityanvayaḥ | mahān cā'sau	bhavanti he mahādeva tasmai te mahān ca asau 
MBvyomavyaapistavaHK-577	devaśceti vyatpatyā mahādeva padavācyāya nama ityarthaḥ |	devaḥ ca iti mahādeva pada vācyāya namaḥ iti arthaḥ 
MBvyomavyaapistavaHK-578	p. 47) aṣṭamapadastavamāha paśviti? 	aṣṭama pada stavam āha paśu iti 
MBvyomavyaapistavaHK-579	paśudrakṣūttāḥ prāntaiḥ paśupāśāstvīśvarassvatantretaḥ |	paśu drakṣu uttāḥ prāntaiḥ paśu pāśāḥ tu īśvaraḥ svatantrā itas 
MBvyomavyaapistavaHK-580	sadbhāvena yaduktaḥ sadbhāveśvara namo'stu tasmai te || 58 ||	sadbhāvena yat uktaḥ sadbhāva īśvara namaḥ astu tasmai te 
MBvyomavyaapistavaHK-581	paśupāśāḥ paśudrakṣu paśudarśaneṣu paśu śāstreṣvityarthaḥ prāntai	paśu pāśāḥ paśu drakṣu paśu darśaneṣu paśu śāstreṣu iti arthaḥ 
MBvyomavyaapistavaHK-582	pradeśyaiḥ uktāḥ ye īśvarastu svatantre śivaśāstre sadbhāvena	pradeśyaiḥ uktāḥ ye īśvaraḥ tu svatantre śiva śāstre sadbhāvena 
MBvyomavyaapistavaHK-583	samyaktvena uktaḥ tasmai tubhyaṃ he sadbhāveśvara nama ityanvayaḥ |	samyaktvena uktaḥ tasmai tubhyam he sadbhāva īśvara namaḥ iti anvayaḥ 
MBvyomavyaapistavaHK-584	śivaśāstre sadbhāvena uktaḥ īśvaraḥ sadbhāveśvara iti	śivaśāstre sadbhāvena uktaḥ īśvaraḥ sadbhāva īśvaraḥ iti 
MBvyomavyaapistavaHK-585	madhyamapadalopi samāsena sadbhāveśvara padavācyāya nama ityarthaḥ ||	madhyama pada lopi samāsena sadbhāva īśvara pada vācyāya namaḥ iti arthaḥ 
MBvyomavyaapistavaHK-586	navamapadastavamāha sarveti 	navama pada stavam āha sarva iti 
MBvyomavyaapistavaHK-587	sarvārtha kṛnmahattattejassādāśivaṃ vapuryasya |	sarva artha kṛt mahat tat tejaḥ sādāśivam vapuḥ yasya 
MBvyomavyaapistavaHK-588	prāguktamapradhṛṣyaṃ sadaiva tasmai namo mahātejaḥ || 59 ||	prāc uktam apradhṛṣyam sadā eva tasmai namaḥ mahā tejaḥ 
MBvyomavyaapistavaHK-589	sarvārthakṛt sādāśivaṃ vapuḥ sadaivāpradhṛṣyaṃ prāguktaṃ mahat	sarva artha kṛt sādāśivam vapuḥ sadā eva apradhṛṣyam prāc uktam mahat 
MBvyomavyaapistavaHK-590	tejaḥ yasya tasmai te he mahātejaḥ tubhyaṃ nama ityanvayaḥ |	tejaḥ yasya tasmai te he mahā tejaḥ tubhyam namaḥ iti anvayaḥ 
MBvyomavyaapistavaHK-591	p. 48) mahat tejaḥ yasya saḥ mahātejā iti vyutpatyā mahāteja śabda	mahat tejaḥ yasya saḥ mahātejāḥ iti vyutpatyā mahāteja śabda 
MBvyomavyaapistavaHK-592	vācyāya nama ityarthaḥ ||	vācyāya namaḥ iti arthaḥ 
MBvyomavyaapistavaHK-593	atheṣāṃ navānāṃ padānāṃ pūjāprakāramāha paścimeti 	atha iṣām navānām padānām pūjā prakāram āha paścima iti 
MBvyomavyaapistavaHK-594	paścimapīṭhe pūjyaṃ padanavakañcetadukta paripāṭyā |	paścima pīṭhe pūjyam pada navakam ca itat ukta paripāṭyā 
MBvyomavyaapistavaHK-595	saptatriṃśatsaṃkhyairyuktaṃ varṇaissadaivanavanābhe || 60 ||	saptatriṃśat saṃkhyaiḥ yuktam varṇaiḥ sadā eva nava nābhe   
MBvyomavyaapistavaHK-596	saptatriṃśadvarṇaiḥ yuktaṃ etatpadanavakaṃ ukta paripāṭyā navanābhe	saptatriṃśat varṇaiḥ yuktam paripāṭyā nava nābhe 
MBvyomavyaapistavaHK-597	paścimapīṭhe sadaiva pūjyamityanvayaḥ | paścima pīṭhe anidhanānidhana	paścima pīṭhe sadā eva pūjyam iti anvayaḥ paścima pīṭhe 
MBvyomavyaapistavaHK-598	padādīni navapadāni pūjanīyānītyarthaḥ ||	pada ādīni nava padāni pūjanīyāni iti arthaḥ 
MBvyomavyaapistavaHK-599	vāyavyapīṭhapadanavakastutimāha yegā iti navabhirāryābhiḥ | tatra	vāyavya pīṭha pada navaka stutim āha iti navabhiḥ āryābhiḥ tatra 
MBvyomavyaapistavaHK-600	prathamapadastavamāha yogā iti 	prathama pada stavam āha yogāḥ iti 
MBvyomavyaapistavaHK-601	yogā vimuktadehāḥ proktāssādāśivāśśivasteṣām |	yogāḥ vimukta dehāḥ proktāḥ sādāśivāḥ śivaḥ teṣām 
MBvyomavyaapistavaHK-602	p. 49) adhipaḥ pitṛvajjanako yo yogādhipa namo'stu tasmai te || 61 ||	adhipaḥ pitṛ vat janakaḥ yaḥ yoga adhipa namaḥ astu tasmai te   
MBvyomavyaapistavaHK-603	muktadehāḥ sadāśivāḥ sadāśiva eva sadāśivāḥ paśu sadāśivā	mukta dehāḥ sadāśivāḥ sadāśivaḥ eva sadāśivāḥ sadāśivā 
MBvyomavyaapistavaHK-604	ityarthaḥ | svarthe'ṇ pratyayaḥ paśu sadāśivānāṃ vijñāna	iti arthaḥ pratyayaḥ 
MBvyomavyaapistavaHK-605	kalarūpāṇāṃ sakalabandhavimuktatayā vimukta dehatvamityarthaḥ yogāḥ	kala rūpāṇām sakala bandha vimukta tayā vimukta deha tvam iti arthaḥ yogāḥ 
MBvyomavyaapistavaHK-606	iti proktāḥ yaśśivaḥ teṣāṃ adhipāḥ pitṛvajjanakaḥ adhipaḥ samarthaḥ |	iti proktāḥ yaḥ śivaḥ teṣām adhipāḥ pitṛ vat janakaḥ adhipaḥ samarthaḥ 
MBvyomavyaapistavaHK-607	tasmai te he yogādhipa namo'stvityanvayaḥ | yogānāmadhipaḥ yogādhipa	tasmai te he yoga adhipa namaḥ astu iti anvayaḥ yogānām adhipaḥ yoga adhipa 
MBvyomavyaapistavaHK-608	iti vyutpatyā yogādhipa padavācyāya nama ityarthaḥ ||	iti vyutpatyā yoga adhipa pada vācyāya namaḥ iti arthaḥ 
MBvyomavyaapistavaHK-609	dvitīyapadastavamāha gurubhiriti 	dvitīya pada stavam āha gurubhiḥ iti 
MBvyomavyaapistavaHK-610	gurubhirmaṇḍalaveṣo dīkṣāyāmarthyate bhiyādinān |	gurubhiḥ maṇḍala veṣaḥ dīkṣāyām arthyate bhiyā dinān 
MBvyomavyaapistavaHK-611	(54) bhaktānvā sacchiṣyāṃstu muñca muñceti yo namastasmai || 62 ||	bhaktān vā sat śiṣyān tu muñca muñca iti yaḥ namaḥ tasmai 
MBvyomavyaapistavaHK-612	maṇḍalaveṣoyaḥ śiṣyapaḥ gurubhiḥ dīkṣāyāṃ bhiyā sasmārabhayena	maṇḍala veṣa ūyaḥ śiṣya paḥ gurubhiḥ dīkṣāyām bhiyā sa smāra bhayena 
MBvyomavyaapistavaHK-613	dīnān bhaktān sacchiṣyān muñcamuñca iti kathyate prārthyate |	dīnān bhaktān sat śiṣyān muñca muñcaḥ iti kathyate prārthyate 
MBvyomavyaapistavaHK-614	p. 50) tasmai te namostvityanvayaḥ | saṃsāramokṣa pratipādaka	tasmai te namaḥ astu iti anvayaḥ saṃsāra mokṣa pratipādaka 
MBvyomavyaapistavaHK-615	muñcamuñcapadasaṃbodhyāya nama ityarthaḥ ||	muñcamuñca pada saṃbodhyāya namaḥ iti arthaḥ 
MBvyomavyaapistavaHK-616	tṛtīyapadastavamāha madhnātīti 	tṛtīya pada stavam āha madhnāti iti 
MBvyomavyaapistavaHK-617	madhnātītaḥ pāśādīn dīkṣābhiryogurūnadhiṣṭhāya |	madhnāti itas pāśa ādīn dīkṣābhiḥ yaḥ gurūn adhiṣṭhāya 
MBvyomavyaapistavaHK-618	pakvamalānāṃ puṃsāṃ prathama prathamāstu te namastasmai || 63 ||	pakva malānām puṃsām prathama prathama astu te namaḥ tasmai 
MBvyomavyaapistavaHK-619	itaḥ prārthanānantaraṃ gurūnadhiṣṭhāya pakvamalānāṃ puṃsāṃ	itas prārthanā anantaram gurūn adhiṣṭhāya pakva malānām puṃsām 
MBvyomavyaapistavaHK-620	dīkṣābhiḥ yaḥ madhnāti tasmai te he prathama prathama	dīkṣābhiḥ yaḥ madhnāti tasmai te he prathama prathama 
MBvyomavyaapistavaHK-621	namo'stvityanvayaḥ | niyamena pāśamathanāt dvirūktyā prathama	namaḥ astu iti anvayaḥ niyamena pāśa mathanāt dvirūktyā 
MBvyomavyaapistavaHK-622	prathama padavācyāya nama ityarthaḥ ||	prathama pada vācyāya namaḥ iti arthaḥ 
MBvyomavyaapistavaHK-623	caturthapadastavamāha puṃsa iti 	caturtha pada stavam āha puṃsaḥ iti 
MBvyomavyaapistavaHK-624	puṃso bandhanabhayataśśaraṇaṃ prāptānvṛṇoti gurusaṃsthaḥ |	puṃsaḥ bandhana bhayataḥ śaraṇam prāptān vṛṇoti guru saṃsthaḥ 
MBvyomavyaapistavaHK-625	dīkṣābhyupagamato yastu śarvaśarvā'stute namastasmai || 64 ||	dīkṣā abhyupagamataḥ yaḥ tu śarva śarva astute namaḥ tasmai 
MBvyomavyaapistavaHK-626	bandhanabhayataḥ śaraṇaṃ prāptavān puṃsaḥ gurusaṃstho bhūtvā	bandhana bhayataḥ śaraṇam prāptavān puṃsaḥ guru saṃsthaḥ bhūtvā 
MBvyomavyaapistavaHK-627	dīkṣābhyupagamena yastu vṛṇoti tasmai te he	dīkṣā abhyupagamena yaḥ tu vṛṇoti tasmai te he 
MBvyomavyaapistavaHK-628	śarvaśarvanamo'stvityanvayaḥ |	śarva śarva namaḥ astu iti anvayaḥ 
MBvyomavyaapistavaHK-629	p. 51) śaraśabdaḥ śaraṇadyotakaḥ | vaśabdo varaṇadyotakaḥ | niyamataḥ	śara śabdaḥ śaraṇa dyotakaḥ va śabdaḥ varaṇa dyotakaḥ niyamataḥ 
MBvyomavyaapistavaHK-630	śaraṇaprāptapuruṣavaraṇakadyotakatayā dvirūktyā	śaraṇa prāpta puruṣa varaṇaka dyotaka tayā dvis ūktyā 
MBvyomavyaapistavaHK-631	śarvaśarvapadadyotyāya nama ityarthaḥ ||	śarva śarva pada dyotyāya namaḥ iti arthaḥ 
MBvyomavyaapistavaHK-632	pañcamapadastavamāha aṇviti 	pañcama pada stavam āha aṇu iti 
MBvyomavyaapistavaHK-633	aṇuśaktipātamādau gurvādyabhigamanato bhavatipuṃsām |	aṇu śaktipātam ādau guru ādi abhigamanataḥ bhavati puṃsām 
MBvyomavyaapistavaHK-634	śivaśaktibhāvakatayā yaste bhava bhava namo'stu tasmai ca || 65 ||	śiva śakti bhāvaka tayā yaḥ te bhava bhava namaḥ astu tasmai ca 
MBvyomavyaapistavaHK-635	yeṣāmityadhyāhāraḥ | yeṣāṃ puṃsāṃ gurvādyabhigamanato ādau	yeṣām iti adhyāhāraḥ yeṣām puṃsām guru ādi abhigamanataḥ ādau 
MBvyomavyaapistavaHK-636	aṇuśaktipātaṃ bhavati | aṇuśabdo bhāvapradhānaḥ aṇutvaśakteḥ	aṇu śaktipātam bhavati aṇu śabdaḥ bhāva pradhānaḥ aṇu tva śakteḥ 
MBvyomavyaapistavaHK-637	āṇavamalaśakteḥ pātaḥ kṣayaḥ liṅgavyatyāsaḥ cintyaḥ teṣāṃ	āṇava mala śakteḥ pātaḥ kṣayaḥ liṅga vyatyāsaḥ cintyaḥ teṣām 
MBvyomavyaapistavaHK-638	puṃsāṃ yaḥ śivaśaktibhāvakatayā śivatvavyañjakatayā bhavati tasmai	puṃsām yaḥ śiva śakti bhāvaka tayā śiva tva vyañjaka tayā bhavati tasmai 
MBvyomavyaapistavaHK-639	te he bhavabhava namo'stvityanvayaḥ |	te he bhava bhava namaḥ astu iti anvayaḥ 
MBvyomavyaapistavaHK-640	āṇavakṣayabhavanaśivatvavyaktibhavanahetutayā bhavabhavapadavācyāya	āṇava kṣaya bhavana śiva tva vyakti bhavana hetutayā bhava bhava pada vācyāya 
MBvyomavyaapistavaHK-641	nama ityarthaḥ ||	namaḥ iti arthaḥ 
MBvyomavyaapistavaHK-642	p. 52) ṣaṣṭhapadastavamāha pūrvamiti 	ṣaṣṭha pada stavam āha pūrvam iti 
MBvyomavyaapistavaHK-643	pūrvaṃ pramathitapāśābhavanti ye dīkṣayā bhavāsteṣām |	pūrvam pramathita pāśāḥ bhavanti ye dīkṣayā bhavāḥ teṣām 
MBvyomavyaapistavaHK-644	śivatā tadūrdhvabhavanaṃ bhavati yatastadbhavodbhava namastasmai || 66 ||	śivatā tad ūrdhva bhavanam bhavati yatas tat bhava udbhava namaḥ tasmai 
MBvyomavyaapistavaHK-645	dīkṣayā pūrvaṃ pramathita pāśāḥ ye bhavanti te bhavāḥ teṣāṃ	dīkṣayā pūrvam pramathita pāśāḥ ye bhavanti te bhavāḥ teṣām 
MBvyomavyaapistavaHK-646	bhavānāṃ tadūrdhvabhavanaṃ tasyaiva vivaraṇatayā yatobhavati tasmai te	bhavānām tad ūrdhva bhavanam tasya eva vivaraṇa tayā yatas bhavati tasmai te 
MBvyomavyaapistavaHK-647	tatkāraṇāt he bhavodbhava nama ityanvayaḥ | bhavānāṃ udbhavanaṃ	tad kāraṇāt he bhavodbhava namaḥ iti anvayaḥ bhavānām udbhavanam 
MBvyomavyaapistavaHK-648	yasmāditi vyutpatyā bhavodbhava pada vācyāya nama ityarthaḥ ||	yasmāt iti vyutpatyā bhavodbhava pada vācyāya namaḥ iti arthaḥ 
MBvyomavyaapistavaHK-649	saptamapadastavamāha jātīti 	saptama pada stavam āha jāti iti 
MBvyomavyaapistavaHK-650	jātiniyamenaitān muktisukhaṃ pūrṇatāndadātyapi tu |	jāti niyamena etān mukti sukham pūrṇa tān dadāti api tu 
MBvyomavyaapistavaHK-651	sarvebhyobhūtebhyassukhapradoyo namo'stu tasmai te || 67 ||	sarvebhyaḥ bhūtebhyaḥ sukha pradaḥ yaḥ namaḥ astu tasmai te 
MBvyomavyaapistavaHK-652	yaḥ jātiniyamena brāhmaṇatvādijāti niyamena etanmuktisukhaṃ karoti tat	yaḥ jāti niyamena brāhmaṇa tva ādi jāti niyamena etad mukti sukham karoti tat 
MBvyomavyaapistavaHK-653	p. 53) prasiddhaṃ muktisukhaṃ pūrṇatāṃ muktisukhasya paripūrṇaṃ tu	prasiddham mukti sukham pūrṇa tām mukti sukhasya paripūrṇam tu 
MBvyomavyaapistavaHK-654	aṇoḥ dadāti apitu sarvebhyo bhūtebhyaḥ sukhaprada tasmai te	aṇoḥ dadāti apitu sarvebhyaḥ bhūtebhyaḥ sukha prada tasmai te 
MBvyomavyaapistavaHK-655	namo'stvityanvayaḥ | sarvabhūtānāṃ sukhaṃ pradātīti	namaḥ astu iti anvayaḥ sarva bhūtānām sukham pradāti iti 
MBvyomavyaapistavaHK-656	sarvabhūtasukhaprada vācyāya nama ityarthaḥ ||	sarva bhūta sukha prada vācyāya namaḥ iti arthaḥ 
MBvyomavyaapistavaHK-657	aṣṭamapadastavamāha sarvatreti 	aṣṭama pada stavam āha sarvatra iti 
MBvyomavyaapistavaHK-658	sarvatra sannidhānaṃ karoti yo nottarāyaṇādi vaśaḥ |	sarvatra sannidhānam karoti yaḥ na uttarāyaṇa ādi vaśaḥ 
MBvyomavyaapistavaHK-659	muktyarthandīkṣādau sarvasānnidhyakara namo'stu || 68 ||	mukti arthan dīkṣā ādau sarva sānnidhya kara namaḥ astu 
MBvyomavyaapistavaHK-660	yastu dīkṣādau muktyarthaṃ sarvatra sarvadeśe sānnidhyaṃ karoti	yaḥ tu dīkṣā ādau mukti artham sarvatra sarva deśe sānnidhyam karoti 
MBvyomavyaapistavaHK-661	uttarāyaṇādikālavaśo na bhavati tasmai te sarvasānnidhyakara	uttarāyaṇa ādi kāla vaśaḥ na bhavati tasmai te sarva sānnidhya kara 
MBvyomavyaapistavaHK-662	namo'stvityanvayaḥ | sarvadeśe sarvakāle ca sānnidhyakaraḥ	namaḥ astu iti anvayaḥ sarva deśe sarva kāle ca sānnidhya karaḥ 
MBvyomavyaapistavaHK-663	sarvasānnidhyakara iti vyutpatyā sarvasānnidhyakarapadavācyāya nama	sarva sānnidhya karaḥ iti vyutpatyā sarva sānnidhya kara pada vācyāya nama 
MBvyomavyaapistavaHK-664	ityarthaḥ ||	iti arthaḥ 
MBvyomavyaapistavaHK-665	navamapadastavamāha vidyeti 	navama pada stavam āha vidyā iti 
MBvyomavyaapistavaHK-666	p. 54) vidyeśa preraṇayā brahmādīnāntu sāṃjanānāṃ yaḥ |	vidyeśa preraṇayā brahma ādīnām tu sāṃjanānām yaḥ 
MBvyomavyaapistavaHK-667	sṛṣṭyādi kṛtparasmin namo'stu te brahmaviṣṇurudrapara || 69 ||	sṛṣṭi ādi kṛt parasmin namaḥ astu te brahma viṣṇu rudra para 
MBvyomavyaapistavaHK-668	vidyeśapreraṇayā sāñjanānāṃ sāṇavānāṃ brahmādīnāṃ	vidyeśa preraṇayā sa añjanānām sa āṇavānām brahma ādīnām 
MBvyomavyaapistavaHK-669	brahmaviṣṇurudrāṇāñca sṛṣṭikṛt yaḥ tvaṃ paraḥ tasmai te he	brahma viṣṇu rudrāṇām ca sṛṣṭi kṛt yaḥ tvam paraḥ tasmai te he 
MBvyomavyaapistavaHK-670	brahmaviṣṇurudrapara namo'stvityanvayaḥ | yaḥ brahmādibhyaḥ paratayā	brahma viṣṇu rudra para namaḥ astu iti anvayaḥ yaḥ brahma ādibhyaḥ para tayā 
MBvyomavyaapistavaHK-671	brahmaviṣṇurudraparapadavācyāya nama ityarthaḥ ||	brahma viṣṇu rudra para pada vācyāya namaḥ iti arthaḥ 
MBvyomavyaapistavaHK-672	eṣāṃ navapadānāṃ pūjāprakāramāha vāyavyamiti 	eṣām nava padānām pūjā prakāram āha vāyavyam iti 
MBvyomavyaapistavaHK-673	vāyavyapīṭha etatpadanavakaṃ pūrvavattu saṃpūjyam |	vāyavya pīṭhe etat pada navakam pūrvavat tu saṃpūjyam 
MBvyomavyaapistavaHK-674	ekonaiḥ pañcāśatsaṃkhyairvarṇairūpetamathaparamam || 70 ||	ekonaiḥ pañcāśat saṃkhyaiḥ varṇaiḥ ūpetam atha paramam 
MBvyomavyaapistavaHK-675	atha paścimapīṭhapūjānantaraṃ ekonapañcāśadvarṇayutaṃ paraṃ	atha paścima pīṭha pūjā anantaram ekonapañcāśat varṇa yutam param 
MBvyomavyaapistavaHK-676	etatpadanavakaṃ pūrvavatpūjyamityanvayaḥ | vāyavya kamalapīṭhe	etat pada navakam pūrvavat pūjyam iti anvayaḥ vāyavya kamala pīṭhe 
MBvyomavyaapistavaHK-677	yogādhipādīni nava padāni pūjanīyānītyarthaḥ ||	yoga adhipa ādīni nava padāni pūjanīyāni iti arthaḥ 
MBvyomavyaapistavaHK-678	p. 55) saumyapīṭhapadanavakastutimāha paśvityādibhiḥ navabhirāryābhiḥ	saumya pīṭha pada navaka stutim āha paśu ityādibhiḥ navabhiḥ āryābhiḥ 
MBvyomavyaapistavaHK-679	tatra prathamapadastavamāha 	tatra prathama pada stavam āha 
MBvyomavyaapistavaHK-680	paśudṛṣṭyadṛṣṭitoyohyanarcitaḥ paśubhireva natvanyaiḥ |	paśu dṛṣṭi adṛṣṭi toyaḥ hi anarcitaḥ paśubhiḥ eva na tu anyaiḥ 
MBvyomavyaapistavaHK-681	śreyo hetuśśaivairanarcitā'narcitatvatha namaste || 71 ||	śreyaḥ hetuḥ śaivaiḥ anarcita anarcita tu atha namaḥ te 
MBvyomavyaapistavaHK-682	śreyo hetuḥ yo hi paśudṛṣṭyadṛṣṭitaḥ paśudṛṣṭīnāmadarśanataḥ	śreyaḥ hetuḥ yaḥ hi paśu dṛṣṭi adṛṣṭitaḥ paśu dṛṣṭīnām adarśanataḥ 
MBvyomavyaapistavaHK-683	paśubhireva anarcitaḥ natvanyaiśśaivairanarcitaḥ tasmai te he anarcitānarcita	paśubhiḥ eva anarcitaḥ na tu anyaiḥ śaivaiḥ anarcitaḥ tasmai te he anarcita anarcita 
MBvyomavyaapistavaHK-684	namostvityanvayaḥ paśubhireveti niyamādviruktayā anarcitānacita	namaḥ astu iti anvayaḥ paśubhiḥ eva iti niyamāt viruktayā 
MBvyomavyaapistavaHK-685	padavācyāya nama ityarthaḥ ||	pada vācyāya namaḥ iti arthaḥ 
MBvyomavyaapistavaHK-686	dvitīyapadastavamāha tadvaditi 	dvitīya pada stavam āha tadvat iti 
MBvyomavyaapistavaHK-687	tadvacca na stutoyaḥ paśubhirapaśubhistu tastu mantrapadaiḥ |	tadvat ca na stutaḥ yaḥ paśubhiḥ apaśubhiḥ tu mantra padaiḥ 
MBvyomavyaapistavaHK-688	svaviracitairvāstotrairasaṃstutā'saṃstutāpi ca namaste ||	sva viracitaiḥ vā a stotraiḥ asaṃstutā asaṃstutā api ca namaḥ te 
MBvyomavyaapistavaHK-689	tadvacca anarcitavacca paśubhiḥ yaḥ na stutaḥ apaśubhiḥ stutimantraiḥ	tadvat ca anarcita vat ca paśubhiḥ yaḥ na stutaḥ apaśubhiḥ stuti mantraiḥ 
MBvyomavyaapistavaHK-690	padairvā svaviracitaiḥ stotrapadairvāstutaḥ tasmaiḥ te he	padaiḥ vā sva viracitaiḥ stotra padaiḥ vā a stutaḥ tasmaiḥ te he 
MBvyomavyaapistavaHK-691	asaṃstutā'saṃstuta nama ityanvayaḥ |	asaṃstuta asaṃstuta namaḥ iti anvayaḥ 
MBvyomavyaapistavaHK-692	p. 56) asaṃstutāsaṃstutapadavācyāya nama ityarthaḥ ||	a saṃstuta a saṃstuta pada vācyāya namaḥ iti arthaḥ 
MBvyomavyaapistavaHK-693	tṛtīyapadastavamāha pūrveti 	tṛtīya pada stavam āha pūrva iti 
MBvyomavyaapistavaHK-694	pūrvasthita pūrvasthita sarvatrāvāhanādi yasyoktam |	pūrva sthita pūrva sthita sarvatra āvāhana ādi yasya uktam 
MBvyomavyaapistavaHK-695	sannidhiviśeṣacintyaṃ phalāya nityaṃ namo'stu tasmai te || 73 ||	sannidhi viśeṣa cintyam phalāya nityam namaḥ astu tasmai te 
MBvyomavyaapistavaHK-696	he pūrvasthita pūrvasthita sannidhiviśeṣacintyaṃ āvāhanādi (56) sarvatra	he pūrva sthita pūrva sthita sannidhi viśeṣa cintyam āvāhana ādi sarvatra 
MBvyomavyaapistavaHK-697	yasya tava phalāya uktaṃ tasmai te nityaṃ namo'stvityanvayaḥ | sarvadeśa	yasya tava phalāya uktam tasmai te nityam namaḥ astu iti anvayaḥ sarva deśa 
MBvyomavyaapistavaHK-698	sarvakālavartamānasya śivasya āvāhanaṃ sannidhi viśeṣāya bhavatīti |	sarva kāla vartamānasya śivasya āvāhanam sannidhi viśeṣāya bhavati iti 
MBvyomavyaapistavaHK-699	tathā ca niyamena dviruktyā pūrvasthita pūrvasthitapadavācyāya nama	tathā ca niyamena dviruktyā pūrva sthita pūrva sthita pada vācyāya 
MBvyomavyaapistavaHK-700	ityarthaḥ ||	iti arthaḥ 
MBvyomavyaapistavaHK-701	caturthapadastavamāha sākṣāditi 	caturtha pada stavam āha sākṣāt iti 
MBvyomavyaapistavaHK-702	p. 57) sākṣātpaśyati sarvaṃ sarvajñatvāttunā'numānādeḥ |	sākṣāt paśyati sarvam sarvajña tvāt tunā anumāna ādeḥ 
MBvyomavyaapistavaHK-703	sākṣavyapekṣapātātsākṣinnamostu tasmai ca || 74 ||	sākṣa vyapekṣa pātāt sākṣin namaḥ astu tasmai ca 
MBvyomavyaapistavaHK-704	yastu sarvajñatvāt sarvaṃ sākṣāt pratyakṣaṃ paśyati	yaḥ tu sarvajña tvāt sarvam sākṣāt pratyakṣam paśyati 
MBvyomavyaapistavaHK-705	sākṣavyapekṣapātāt akṣasya pratyakṣasya vyapekṣāt apekṣatayā sahitaṃ	sa akṣa vyapekṣa pātāt akṣasya pratyakṣasya vyapekṣāt apekṣa tayā sahitam 
MBvyomavyaapistavaHK-706	sākṣavyapekṣaḥ pātoyasya tat tathoktānumānādeḥ na paśyati tasmai te he	sākṣa vyapekṣaḥ pātaḥ yasya tat tathā ukta anumāna ādeḥ na paśyati tasmai te he 
MBvyomavyaapistavaHK-707	sākṣin sākṣin tubhyaṃ namo'stvityanvayaḥ | paśyati paśyatīti dviruktyā	sākṣin sākṣin tubhyam namaḥ ustu iti anvayaḥ paśyati paśyati iti dviruktyā 
MBvyomavyaapistavaHK-708	sākṣinpada vācyāya nama ityarthaḥ ||	sākṣin pada vācyāya namaḥ iti arthaḥ 
MBvyomavyaapistavaHK-709	pañcamapadastavamāha sadya iti 	pañcama pada stavam āha sadyas iti 
MBvyomavyaapistavaHK-710	sadyomuktau sādhanamatulandīkṣākhyameva yastvaritam |	sadyomuktau sādhanam atulan dīkṣā ākhyam eva yaḥ tvaritam 
MBvyomavyaapistavaHK-711	racayannamostumuktasturuturvitthaṃ namo'stu tasmai te || 75 ||	racayan namaḥ stumuktaḥ turu turu ittham namaḥ astu tasmai te 
MBvyomavyaapistavaHK-712	sadyomuktau atulaṃ dīkṣākhyameva sādhanaṃ racayan yastvaṃ bhakteḥ iti	sadyomuktau atulam dīkṣā ākhyam eva sādhanam racayan yaḥ tvam bhakteḥ iti 
MBvyomavyaapistavaHK-713	śeṣaḥ namasturuturu itthamuttaḥ tasmai te namo'stvityanvayaḥ |	śeṣaḥ namaḥ turu turu ittham uttaḥ tasmai te namaḥ astu iti anvayaḥ 
MBvyomavyaapistavaHK-714	p. 58) dīkṣākhyameveti niyamādviruktyā avyayapratirūpaka	dīkṣā ākhyam eva iti niyamāt viruktyā avyaya pratirūpaka 
MBvyomavyaapistavaHK-715	śaighrapratipādaka turuturupadabodhyāya nama ityarthaḥ ||	śaighra pratipādaka turu turu pada bodhyāya namaḥ iti arthaḥ 
MBvyomavyaapistavaHK-716	ṣaṣṭhapadastavamāha pratīti 	ṣaṣṭha pada stavam āha prati iti 
MBvyomavyaapistavaHK-717	pratibhuvanamarkavadyonipatanmāyāndhakārataḥ puṃsaḥ |	pratibhuvanam arka vat yoni patat māyā andhakārataḥ puṃsaḥ 
MBvyomavyaapistavaHK-718	harati pataṃgaca dīkṣā saṃyojanena namastasmai || 76 ||	harati dīkṣā saṃyojanena namaḥ tasmai 
MBvyomavyaapistavaHK-719	arkavat pratibhuvanam nipatan yaḥ puṃsaḥ māyāndhakārataḥ	arkavat pratibhuvanam nipatan yaḥ puṃsaḥ māyā andhakārataḥ 
MBvyomavyaapistavaHK-720	sārvavibhaktikasta siliti vacanāt māyārūpaṃ andhakāraṃ	sārvavibhaktikaḥ sta sil iti vacanāt māyā rūpam andhakāram 
MBvyomavyaapistavaHK-721	dīkṣāsaṃyojanena harati ca tasmai te he pataṃga pataṃga	dīkṣā saṃyojanena harati ca tasmai te he pataṃga pataṃga 
MBvyomavyaapistavaHK-722	namo'stvityanvayaḥ | harati ca iti cakārasya evakārārthatayā	namaḥ astu iti anvayaḥ harati ca iti cakārasya eva kāra arthatayā 
MBvyomavyaapistavaHK-723	niyamasphuraṇāt patan gamayati tamaḥ utsārayatīti kalpanayā dviruktyā	niyama sphuraṇāt patan gamayati tamaḥ utsārayati iti kalpanayā dviruktyā 
MBvyomavyaapistavaHK-724	pataṃga pataṃga padavācyāya nama ityarthaḥ ||	pataṃga pataṃga pada vācyāya namaḥ iti arthaḥ 
MBvyomavyaapistavaHK-725	saptamapadastavamāha piṃgala iti 	saptama pada stavam āha piṃgalaḥ iti 
MBvyomavyaapistavaHK-726	p. 59) piṅgovahniḥstadvadyaḥ pāśāndahati sarvathā kāṃścit |	piṅgaḥ vahniḥ tadvat yaḥ pāśān dahati sarvathā kāṃścid 
MBvyomavyaapistavaHK-727	kāṃścitva sarvathā'pi ca namo'stu te piṃgapiṃgatasmai ca || 77 ||	sarvathā api ca namaḥ astu te ca 
MBvyomavyaapistavaHK-728	piṃgaḥ vahniḥ piṃgapadavācyo vahniḥ tadvat vahnivat yaḥ śivaḥ	                    
MBvyomavyaapistavaHK-729	kāṃścit pāśān sarvathā dahati | kāṃścitvasarvathāpi ca dahati | malasya	kāṃścid pāśān sarvathā dahati kāṃścid tu asarvathā api ca dahati malasya 
MBvyomavyaapistavaHK-730	īṣatpākādhika pākābhyāṃ sarvāsarvadāhakatvaṃ upapadyate tadvaditi	īṣat pāka adhika pākābhyām sarva asarva dāhaka tvam upapadyate tadvat iti 
MBvyomavyaapistavaHK-731	bhāvaḥ he piṃgapiṃga namo'stvityanvayaḥ |	bhāvaḥ he piṃga piṃga namaḥ astu iti anvayaḥ 
MBvyomavyaapistavaHK-732	sarvāsarvadāhadvayavarṇaṇena dviruktyā vahnivācaka	sarva asarva dāha dvaya varṇaṇena dviruktyā vahni vācaka 
MBvyomavyaapistavaHK-733	piṃgapigapadalakṣyāya nama ityarthaḥ ||	piṃga piga pada lakṣyāya namaḥ iti arthaḥ 
MBvyomavyaapistavaHK-734	aṣṭamapadastavamāha taditi 	aṣṭama pada stavam āha tat iti 
MBvyomavyaapistavaHK-735	tatsaktyanugrahātsvātmani baddhādya gocare puṃsām |	tad sakti anugrahāt sva ātmani baddhā adya gocare puṃsām 
MBvyomavyaapistavaHK-736	janayatyamitejñepi jñānajñānāstute namastasmai || 78 ||	janayati amita ijñe pi jñāna jñānā stute namaḥ tasmai 
MBvyomavyaapistavaHK-737	(57) yaḥ śaktyanugrahāt hetoḥ baddhādyagocare amite aprameyejñe sva	yaḥ śakti anugrahāt hetoḥ baddha ādi agocare amite aprameya ijñe sva 
MBvyomavyaapistavaHK-738	prakāśe svātmani viṣaya saptamīyaṃ puṃsāṃ anugraha yukta puṃsāṃ	prakāśe svātmani viṣaya saptamīyaṃ puṃsām anugraha yukta puṃsām 
MBvyomavyaapistavaHK-739	tat jñānaṃ janayati api evakārārthaḥ tasmai te he jñānajñāna	tat jñānam janayati api eva kāra arthaḥ tasmai te he jñāna jñāna 
MBvyomavyaapistavaHK-740	namo'stvityanvayaḥ | atrāpi niyamāt jñānajñānapadavācyāya nama	namaḥ astu iti anvayaḥ atra api niyamāt jñāna jñāna pada vācyāya 
MBvyomavyaapistavaHK-741	ityarthaḥ ||	iti arthaḥ 
MBvyomavyaapistavaHK-742	navamapadastavamāha vikṣobhya iti 	navama pada stavam āha vikṣobhyaḥ iti 
MBvyomavyaapistavaHK-743	vikṣobhya nādaśaktiṃ racayatibindukrameṇa yaśśabdān |	vikṣobhya nāda śaktim racayati bindu krameṇa yaḥ śabdān 
MBvyomavyaapistavaHK-744	puṃvaktreṇaprathamaṃ namo'stu te śabda śabda tasmai ca || 79 ||	puṃvaktreṇa prathamam namaḥ astu te śabda śabda tasmai ca 
MBvyomavyaapistavaHK-745	nādaśaktiṃ kuṇḍalinī rūpāṃ vikṣobhya bindukrameṇa nāda bindvādi	nāda śaktim kuṇḍalinī rūpām vikṣobhya bindu krameṇa nāda bindu ādi 
MBvyomavyaapistavaHK-746	krameṇa ityarthaḥ | yaḥ śabdān sūkṣmā paśyantī madhyamā vaikharī	krameṇa iti arthaḥ yaḥ śabdān sūkṣmā paśyantī madhyamā vaikharī 
MBvyomavyaapistavaHK-747	rūpān pumarthaṃ puruṣasya prayojanāya puṃvaktreṇa puruṣa vaktreṇa	rūpān pumartham puruṣasya prayojanāya puṃvaktreṇa puruṣa vaktreṇa 
MBvyomavyaapistavaHK-748	racayati | tasmai te he śabdaśabda namo'stvityanvayaḥ | śabdotpādakatayā	racayati tasmai te he śabda śabda namaḥ astu iti anvayaḥ śabda utpādaka tayā 
MBvyomavyaapistavaHK-749	śabdaśabdapadavācyāya nama ityarthaḥ ||	śabda śabda pada vācyāya namaḥ iti arthaḥ 
MBvyomavyaapistavaHK-750	eṣāṃ navapadānāṃ pūjāvidhānamāha etaditi 	eṣām nava padānām pūjā vidhānam āha etat iti 
MBvyomavyaapistavaHK-751	p. 61) etaduttarapīṭhe padanavakaṃ yadrūktapāṭhena |	etat uttara pīṭhe pada navakam 
MBvyomavyaapistavaHK-752	aṣṭācatvāriṃśatsaṃkhyairvarṇairūpetamatha pūjyam || 80 ||	aṣṭācatvāriṃśat saṃkhyaiḥ varṇaiḥ ūpetam atha pūjyam 
MBvyomavyaapistavaHK-753	rurūktapāṭhena aṣṭācatvāriṃśatsaṃkhyaiḥ varṇaiḥ upetaṃ yat	ruru ukta pāṭhena aṣṭācatvāriṃśat saṃkhyaiḥ varṇaiḥ upetam yat 
MBvyomavyaapistavaHK-754	padanavakaṃ tattu uttarapīṭhe pūjyamityarthaḥ | atra anarcitānarcitādīni	pada navakam tat tu uttara pīṭhe pūjyam iti arthaḥ atra anarcita anarcita ādīni 
MBvyomavyaapistavaHK-755	nava padāni krameṇa pūjyānītyarthaḥ ||	nava padāni krameṇa pūjyāni iti arthaḥ 
MBvyomavyaapistavaHK-756	īśānapīṭha padanavakastutimāha kurvannityādibhirdarśabhirāryābhiḥ |	īśānapīṭha pada navaka stutim āha kurvan ityādibhiḥ   āryābhiḥ 
MBvyomavyaapistavaHK-757	tatra prthamapadastavamāha kurvanniti 	tatra prathama pada stavam āha kurvan iti 
MBvyomavyaapistavaHK-758	kurvannupādhiniṣṭhaṃ sarvaṃ yo nopalabhyate paśubhiḥ |	kurvan upādhi niṣṭham sarvam yaḥ na upalabhyate paśubhiḥ 
MBvyomavyaapistavaHK-759	atisūkṣmatvānnityaṃ namo'stu te sūkṣma sūkṣma tasmai ca || 81 ||	ati sūkṣma tvāt nityam namaḥ astu te sūkṣma sūkṣma tasmai ca 
MBvyomavyaapistavaHK-760	upādhiniṣṭhaṃ sarvaṃ kurvan antaryāmitayeti bhāvaḥ | yaḥ paśubhiḥ	upādhi niṣṭham sarvam kurvan antaryāmi tayā iti bhāvaḥ yaḥ paśubhiḥ 
MBvyomavyaapistavaHK-761	no'palabhyate tatra hetuḥ ati sūkṣmatvāt nityaṃ tasmai te he sūkṣma	na upalabhyate tatra hetuḥ ati sūkṣma tvāt nityam tasmai te he sūkṣma 
MBvyomavyaapistavaHK-762	sūkṣma namo'stvityanvayaḥ | niyamāt dviruktyā atisaukṣmya vācaka	sūkṣma namaḥ astu iti anvayaḥ niyamāt dviruktyā atisaukṣmya vācaka 
MBvyomavyaapistavaHK-763	sūkṣma sūkṣmapadavācyāya nama ityarthaḥ ||	sūkṣma sūkṣma pada vācyāya namaḥ iti arthaḥ 
MBvyomavyaapistavaHK-764	p. 62) dvitīyapadastavamāha mantreti 	dvitīya pada stavam āha mantra iti 
MBvyomavyaapistavaHK-765	mantrārthatayā niyataḥ kathito yo'nena śiva padenā'tra |	mantra artha tayā niyataḥ kathitaḥ yonena śiva padena atra 
MBvyomavyaapistavaHK-766	proktaissadaivadharmairyuttasmai namo'stu śiva śiva te || 82 ||	proktaiḥ sa daiva dharmaiḥ yut tasmai namaḥ ustu śiva śiva te 
MBvyomavyaapistavaHK-767	proktaiḥ dharmaiḥ sadā upayuktaḥ yaḥ mantrārtha tayā śivapadena atra	proktaiḥ dharmaiḥ sadā upayuktaḥ yaḥ mantrārtha tayā śivapadena atra 
MBvyomavyaapistavaHK-768	śivaśāsane niyataḥ kathitaḥ tasmai te he śiva śiva namo'stvityanvayaḥ |	śiva śāsane niyataḥ kathitaḥ tasmai te he śiva śiva namaḥ astu iti anvayaḥ 
MBvyomavyaapistavaHK-769	niyamāt dviruktyā śiva śiva padavācyāya nama ityarthaḥ ||	niyamāt dviruktyā śiva śiva pada vācyāya namaḥ iti arthaḥ 
MBvyomavyaapistavaHK-770	tṛtīyapadastavamāha ānantya iti 	tṛtīya pada stavam āha ānantyai iti 
MBvyomavyaapistavaHK-771	ānantyataḥ phalānāṃ vistārānnoktamapi tu saṃkṣepāt |	ānantyataḥ phalānām vistārāt na uktam api tu saṃkṣepāt 
MBvyomavyaapistavaHK-772	sarvandadātyabhīṣṭaṃ parāparaṃ yo namo'stu sarvadate || 83 ||	dadāti abhīṣṭam parāparam yaḥ namaḥ astu sarvadate  /
MBvyomavyaapistavaHK-773	phalānāṃ ānantyataḥ vistārāt noktaṃ api tu saṃkṣepāt uktaṃ	phalānām ānantyataḥ vistārāt na uktam api tu saṃkṣepāt uktam 
MBvyomavyaapistavaHK-774	parāparaṃ sarvaṃ abhīṣṭaṃ yo dadāti tasmai te he sarvadā	parāparam sarvam abhīṣṭam yaḥ dadāti tasmai te he sarvadā 
MBvyomavyaapistavaHK-775	namo'stvityanvayaḥ |	namaḥ astu iti anvayaḥ 
MBvyomavyaapistavaHK-776	p. 63) sarvaṃ dadātīti sarvadapadavācyāya nama ityarthaḥ ||	sarvam dadāti iti sarvada pada vācyāya namaḥ iti arthaḥ 
MBvyomavyaapistavaHK-777	caturthapadastavamāha iṣveti 	caturtha pada stavam āha iṣvā iti 
MBvyomavyaapistavaHK-778	(58) iṣvetthamarthanīyaḥ praṇavasto yaḥ tribhirnamaskāraiḥ |	iṣvā ittham arthanīyaḥ praṇavaḥ tasmāt yaḥ tribhiḥ namaskāraiḥ 
MBvyomavyaapistavaHK-779	bandha trayatastryātmaka kāryadhvaṃ sāyate namastasmai || 84 ||	bandha trayatas tri ātmaka namaḥ tasmai 
MBvyomavyaapistavaHK-780	iṣvā iti yajanaṃ kṛtvā ante bandhatrayataḥ āṇavādi samutpannasya	iṣvā iti yajanam kṛtvā ante bandha trayataḥ āṇava ādi samutpannasya 
MBvyomavyaapistavaHK-781	tryātmaka kāryasya dhvaṃsāya yaḥ praṇavasthaḥ tribhiḥ namaskāraiḥ	tryātmaka kāryasya dhvaṃsāya yaḥ praṇavasthaḥ tribhiḥ namaskāraiḥ 
MBvyomavyaapistavaHK-782	ardhanīyaḥ tasmai nama ityanvayaḥ | bandhatrayamocanāya prayukta oṃ	ardhanīyaḥ tasmai namaḥ iti anvayaḥ bandha traya mocanāya prayuktaḥ om 
MBvyomavyaapistavaHK-783	namo namo namaḥ pada smāryāya nama ityarthaḥ ||	namaḥ namaḥ namaḥ pada smāryāya namaḥ iti arthaḥ 
MBvyomavyaapistavaHK-784	pañcamapadastavamāha mantrārtha iti 	pañcama pada stavam āha mantra arthaḥ iti 
MBvyomavyaapistavaHK-785	mantrārtha yo dvayorapyupasaṃhāraḥ padaiśśivāyeti |	yaḥ dvayoḥ api upasaṃhāraḥ padaiḥ śivāya iti 
MBvyomavyaapistavaHK-786	yadadhiṣṭhāna mantropi śivastasmai śivāya te stu namaḥ ||	yad adhiṣṭhāna mantraḥ upi śivaḥ tasmai śivāya te stu namaḥ 
MBvyomavyaapistavaHK-787	śivāyeti pade mantrārthayordvayorapyupasaṃhāreṇa tvaṃ	śivāya iti pade mantra arthayoḥ dvayoḥ api upasaṃhāreṇa tvam 
MBvyomavyaapistavaHK-788	yadadhiṣṭhānamantropi śivaḥ yadadhiṣṭhānāt sadā śreyānityarthaḥ |	yad adhiṣṭhāna mantraḥ api śivaḥ yad adhiṣṭhānāt sadā śreyān iti arthaḥ 
MBvyomavyaapistavaHK-789	p. 64)  tasmai te śivāya namo'stvityanvayaḥ | mantrārthasphoraka śivāya	tasmai te śivāya namaḥ astu iti anvayaḥ mantra artha sphoraka śivāya 
MBvyomavyaapistavaHK-790	padabodhyāya nama ityarthaḥ |	pada bodhyāya namaḥ iti arthaḥ 
MBvyomavyaapistavaHK-791	ṣaṣṭhapadastavamāha kāryeti 	ṣaṣṭha pada stavam āha kārya iti 
MBvyomavyaapistavaHK-792	kāryatve nivṛttāvapi pade ye nojanvanti kāraṇatvaṃ yat |	kārya tve nivṛttau api pade ye nojanvanti kāraṇa tvam yat 
MBvyomavyaapistavaHK-793	ājñāṃ vinā tadardhaṃ praṇave yo'ntyaṃ punarnamastasmai  || 86 ||	ājñām vinā tad ardham praṇave punar namaḥ tasmai 
MBvyomavyaapistavaHK-794	kāryatve nivṛttāvapi kāraṇatvaṃ ājñāṃvinā nojanyantīti	kārya tve nivṛttau api kāraṇa tvam ājñām vinā na ujanyanti iti 
MBvyomavyaapistavaHK-795	yattadunārthaṃ punaḥ praṇave svarūpe ye na yojyante tasmai	punar praṇave sva rūpe ye na yojyante tasmai 
MBvyomavyaapistavaHK-796	namo'stvityanvayaḥ | yojana viṣaya praṇavākāratayā oṃ pada vācyāya	namaḥ astu iti anvayaḥ yojana viṣaya praṇava ākāra tayā om pada vācyāya 
MBvyomavyaapistavaHK-797	nama ityarthaḥ ||	namaḥ iti arthaḥ 
MBvyomavyaapistavaHK-798	saptamapadastavamāha taditi 	saptama pada stavam āha tat iti 
MBvyomavyaapistavaHK-799	taccāpikāraṇatvaṃ teṣāṃ trividhaṃ tribhirnamaskāraiḥ |	tat ca api kāraṇa tvam teṣām trividham tribhiḥ namaskāraiḥ 
MBvyomavyaapistavaHK-800	bandha trayādhikārāt namā'stu te hanti yo namastasmai || 87 ||	bandha traya adhikārāt namaḥ astu te hanti yaḥ namaḥ tasmai 
MBvyomavyaapistavaHK-801	teṣāṃ patīnāṃ trividhamapi tatkāraṇatvañca bandhatrayādhikārāṃśca	teṣām patīnām trividham api tad kāraṇa tvañca bandha traya adhikārān ca 
MBvyomavyaapistavaHK-802	tṛbhiḥ namaskāraiḥ namaskṛto yo hanti tasmai te namo'stvityanvayaḥ |	tṛbhiḥ namaskāraiḥ namaskṛtaḥ yaḥ hanti tasmai te namaḥ astu iti anvayaḥ 
MBvyomavyaapistavaHK-803	p. 65) adhikāra trayamocaka prayukta namo namo namaḥ padavācyāya	namaḥ namaḥ namaḥ pada vācyāya 
MBvyomavyaapistavaHK-804	namaḥ ityarthaḥ ||	namaḥ iti arthaḥ 
MBvyomavyaapistavaHK-805	aṣṭamapadastavamāha tadanviti 	aṣṭama pada stavam āha tadanu iti 
MBvyomavyaapistavaHK-806	tadanu śivatvavyaktistadvṛddhivardhate dvayaṃ yasmāt |	tadanu śiva tva vyaktiḥ tad vṛddhi vardhate dvayam yasmāt 
MBvyomavyaapistavaHK-807	dvābhyānnamaskṛtibhyāṃ śivastasmai dvirnamo'stu tasmai te || 88 ||	dvābhyām namaskṛtibhyām śivaḥ tasmai dvis namaḥ ustu tasmai te 
MBvyomavyaapistavaHK-808	tadanu bandha trayanivṛtyanantaraṃ śivatvavyaktirbhavati tacchivatvaṃ	tadanu bandha traya nivṛti anantaram śiva tva vyaktiḥ bhavati tat śiva tvam 
MBvyomavyaapistavaHK-809	dvābhyāṃ namaskṛtibhyāṃ yasmāt śivāt nimittāt buddhyā dvayaṃ	dvābhyām namaskṛtibhyām yasmāt śivāt nimittāt buddhyā dvayam 
MBvyomavyaapistavaHK-810	vardhate tadviguṇaṃ śivatvaṃ bhavatīti yāvat śivatvaṃ prāpyapunaḥ	vardhate tad viguṇam śiva tvam bhavati iti yāvat śiva tvam prāpya punar 
MBvyomavyaapistavaHK-811	paśutvaṃ na bhavatītyarthaḥ ||	paśu tvam na bhavati iti arthaḥ 
MBvyomavyaapistavaHK-812	navamapadastavamāha prānta iti 	navama pada stavam āha prānte iti 
MBvyomavyaapistavaHK-813	prānta praṇavaśivo yo'bhidhyātaḥ prārthita phalaṃ tvetat |	prānta praṇava śivaḥ phalam tu etat 
MBvyomavyaapistavaHK-814	avinaśvaraṃ śivatvaṃ dadāti puṃso namo'stu tasmai te || 89  ||	a vinaśvaram śiva tvam dadāti puṃsaḥ namaḥ astu tasmai te   
MBvyomavyaapistavaHK-815	p. 66) yaḥ prāntapraṇavaśivaḥ mantrānta praṇavākāra śiva ityarthaḥ |	yaḥ prānta praṇava śivaḥ mantra anta praṇava ākāra śiva iti arthaḥ 
MBvyomavyaapistavaHK-816	abhidhyātaḥ prārthitassan puṃsaḥ avinaśvaraṃ śivatvaṃ etatphalantu	abhidhyātaḥ prārthitaḥ san puṃsaḥ a vinaśvaram śiva tvam etat phalantu 
MBvyomavyaapistavaHK-817	dadāti tasmai praṇavāya te namo'stvityanvayaḥ | phalasvarūpa oṃ pada	dadāti tasmai praṇavāya te namaḥ ustu iti anvayaḥ phala svarūpa om pada 
MBvyomavyaapistavaHK-818	vācyāya nama ityarthaḥ ||	vācyāya namaḥ iti arthaḥ 
MBvyomavyaapistavaHK-819	atheṣāṃ navapadānāṃ pūjāprakāraṃ varṇasaṃkhyāñca āha īśa iti	atha iṣām nava padānām pūjā prakāram varṇa saṃkhyām ca āha īśaḥ iti 
MBvyomavyaapistavaHK-820	īśānakoṇapīṭhe padanavakaṃ tvetadeva pūjyam |	īśāna koṇa pīṭhe pada navakam tu etat eva pūjyam 
MBvyomavyaapistavaHK-821	tryadhikatriṃśatsaṃkhyairvarṇaivyaktaṃ rurūkta pāṭhena  || 80 ||	tri adhika triṃśat saṃkhyaiḥ varṇaiḥ vyaktam pāṭhena 
MBvyomavyaapistavaHK-822	rurūkta pāṭhena paṭhita tryadhika triṃśadvarṇayutaṃ etatpadanavakaṃ	pāṭhena paṭhita tri adhika triṃśat varṇa yutam etat pada navakam 
MBvyomavyaapistavaHK-823	īśānapīṭha koṇe saṃpūjyaṃ ityanvayaḥ | asminpīṭhe	īśāna pīṭha koṇe saṃpūjyam iti anvayaḥ asmin pīṭhe 
MBvyomavyaapistavaHK-824	sūkṣmasūkṣmapadāni nava padāni pūjyānītyarthaḥ ||	sūkṣma sūkṣma padāni nava padāni pūjyāni iti arthaḥ 
MBvyomavyaapistavaHK-825	evaṃ vyomavyāpimantra rājasya ekāśīti padastavaṃ vidhāyastavakartrā	evam vyomavyāpi mantra rājasya ekāśīti pada stavam vidhāya stava kartrā 
MBvyomavyaapistavaHK-826	svanāmaprakaṭayan stavasyāpi kheṭapāla	sva nāma prakaṭayan stavasya api kheṭapāla 
MBvyomavyaapistavaHK-827	kṛtamantrarājavyākhyānārthānusāritāñca	kṛta mantrarāja vyākhyāna artha anusāri tām ca 
MBvyomavyaapistavaHK-828	aṣṭaṣaṣṭyadhikavarṇaśatatrayākāra mantrasya svaśreyaḥ pradatvaṃ	aṣṭaṣaṣṭi adhika varṇa śata traya ākāra mantrasya sva śreyaḥ prada tvam 
MBvyomavyaapistavaHK-829	prārthayate |	prārthayate 
MBvyomavyaapistavaHK-830	p. 67) itthaṃ varṇaśatatrayaṃ saha punaḥ ṣaṣṭyāṣṭasaṃyuktayā	ittham varṇa śata trayam saha punar ṣaṣṭyā aṣṭa saṃyuktayā 
MBvyomavyaapistavaHK-831	mantro raurava bhāṣya vārtika girā śrīkheṭapālena yat |	mantraḥ raurava bhāṣya vārtika girā śrīkheṭa pālena yat 
MBvyomavyaapistavaHK-832	vyākhyātorthadiśā tayāstutimimāṃ tāṃ rāmakaṇṭhena yat	vyākhyāta ūrtha diśā tayā a stutim imām tām rāma kaṇṭhena yat 
MBvyomavyaapistavaHK-833	kṛtvā nāma śubhānvitaṃ bhavatunaḥ śreyaḥ pradaṃ sarvadā || 91 ||	kṛtvā nāma śubha anvitam bhavatu naḥ śreyaḥ pradam sarvadā 
MBvyomavyaapistavaHK-834	rauravabhāṣyavārtika kṛtā śrīkheṭapāla nāmnā vyākhyātaḥ mantraḥ	                      
MBvyomavyaapistavaHK-835	aṣṭasaṃyuktyā ṣaṣṭyā punassahavarṇaśatatrayaṃ tayā arthadiśā itthaṃ	aṣṭa saṃyuktyā ṣaṣṭyā punar sahavarṇa śata trayam tayā artha diśā ittham 
MBvyomavyaapistavaHK-836	tāmimāṃstutiṃ kṛtvā nātha śubhā kvipiceti śubhidhātoḥ kvippratyaye	tām imān stutim kṛtvā nātha śubhā śubhi dhātoḥ kvip pratyaye 
MBvyomavyaapistavaHK-837	sati nāthavaccobhate iti vyutpatyā nāthavaccobhamānena rāmakaṇṭhena yat	sati nātha vat cobhate iti vyutpatyā nātha vat cobhamānena rāmakaṇṭhena yat 
MBvyomavyaapistavaHK-838	añcitaṃ pūjitaṃ sarvadā śreyaḥ pradaṃ bhavatviti anvayaḥ |	añcitam pūjitam sarvadā śreyaḥ pradam bhavatu iti anvayaḥ 
MBvyomavyaapistavaHK-839	p. 68) itthaṃ uktaprakāreṇa navakamala pīṭheṣu uktastutikrameṇa	ittham ukta prakāreṇa nava kamala pīṭheṣu ukta stuti krameṇa 
MBvyomavyaapistavaHK-840	vyomavyāpi padamantra pūjāvatāṃ sarvaśreyaḥ prāptiḥ karatalasthā	vyoma vyāpi pada mantra pūjāvatām sarva śreyaḥ prāptiḥ kara tala sthā 
MBvyomavyaapistavaHK-841	bhavatītibhāvaḥ | itthametatstotra pradarśitānāṃ ekāśīti	bhavati iti bhāvaḥ ittham etad stotra pradarśitānām 
MBvyomavyaapistavaHK-842	padanirvacanānāṃ sammatavacanāni tu kālottare spaṣṭamuktāni |	pada nirvacanānām sammata vacanāni tu kālottare spaṣṭam uktāni 
MBvyomavyaapistavaHK-843	granthavistārabhītyā nātralikhitam | etatsvarūpa pradarśaka vacanāni	grantha vistāra bhītyā 
MBvyomavyaapistavaHK-844	bṛhaṭṭīkāyāṃ darśitaṃ tatra avadhāryatām |	bṛhat ṭīkāyām darśitam tatra avadhāryatām 
MBvyomavyaapistavaHK-845	śrīmadabhrasabheśasya diśyāgneyyāṃ sadāvasan |	śrīmat abhra sabhā īśasya diśi āgneyyām sadā avasan 
MBvyomavyaapistavaHK-846	devajñāna riṣīdreti (ṛṣīndreti) viśṛtobhuvanatraye ||	deva jñāna ṛṣi indra iti 
MBvyomavyaapistavaHK-847	tannāmadhāriṇā caiva iyaṃ vyākhyā samīritā |	tad nāmadhāriṇā ca eva iyam vyākhyā samīritā 
MBvyomavyaapistavaHK-848	iti vyomavyāpistavaṃ laghuṭīkāsahitaṃ samāptam ||	iti vyomavyāpi stavam laghu ṭīkā sahitam samāptam 
MBvyomavyaapistavaHK-849	śrīgurubhyo namaḥ ||	śrī gurubhyaḥ namaḥ 
MBvyomavyaapistavaHK-850	śubhaṃ bhavatu ||	śubham bhavatu 
MBvyomavyaapistavaHK-851	MUKTABODHA INDOLOGICAL RESEARCH INSTITUTE©2011 Muktabodha Indological Research Institute  All Rights Reserved.E-texts may be viewed only online or downloaded for private study.E-texts may not, under any circumstances, be copied, republished,reproduced, distributed or sold, either in original or altered form, withoutthe express permission of Muktabodha Indological Research Institute in writing.Data-entered by the staff of Muktabodha under the direction of Mark S. G. Dyczkowski.	muktabodha indological research muktabodha indological research institute all rights reserved texts may be viewed only online or downloaded for private studye texts may not under any circumstances be copied republished reproduced distributed or sold either in original or altered form withoutthe express permission of muktabodha indological research institute in writing data entered by the staff of muktabodha under the direction of mark s g dyczkowski 
