segmentnr	original	analyzed
SA_GK18_dhandasu-0	daśarūpakam /	daśa rūpakam 
SA_GK18_dhandasu-1	[pariccheda 1]	pariccheda 
SA_GK18_dhandasu-2	namastasmai gaṇeśāya yatkaṇṭhaḥ puṣkarāyate /	namaḥ tasmai gaṇeśāya yat kaṇṭhaḥ puṣkarāyate 
SA_GK18_dhandasu-3	madābhegaghanadhvāno nīlakaṇṭhasya tāṇd.ave // DhDaś_1.1 //	mada ābhega ghana dhvānaḥ nīlakaṇṭhasya tāṇdave 
SA_GK18_dhandasu-4	daśarūpānukāreṇa mādyanti bhāvakaḥ /	daśa rūpa anukāreṇa mādyanti bhāvakaḥ 
SA_GK18_dhandasu-5	namaḥ sarvavide tasmai viṣṇave bharatāya ca // DhDaś_1.2 //	namaḥ sarva vide tasmai viṣṇave bharatāya ca 
SA_GK18_dhandasu-6	kasyacideva kadācid dayayā viṣayaṃ sarasvatī viduṣaḥ /	kasyacid eva kadācid dayayā viṣayam sarasvatī viduṣaḥ 
SA_GK18_dhandasu-7	ghaṭayati kamapi tamanyo jajati jano yena vaidagdhīm // DhDaś_1.3 //	ghaṭayati kam api tam anyaḥ jajati janaḥ yena vaidagdhīm 
SA_GK18_dhandasu-8	uddhṛtyoddhṛtya sāraṃ yamakhilanigamān nāṭyavedaṃ viriñciś	uddhṛtya uddhṛtya sāram yam akhila nigamāt nāṭya vedam viriñciḥ 
SA_GK18_dhandasu-9	cakre yasya prayogaṃ munirapi bharatastāṇḍavaṃ nīlakaṇṭhaḥ /	cakre yasya prayogam muniḥ api bharataḥ tāṇḍavam nīlakaṇṭhaḥ 
SA_GK18_dhandasu-10	śarvāṇī lāsyamasya pratipadamaparaṃ lakṣma kaḥ kartumīṣṭe	śarvāṇī lāsyam asya pratipadam aparam lakṣma kaḥ kartum īṣṭe 
SA_GK18_dhandasu-11	nāṭyānāṃ kintu kiñcit praguṇaracanayā lakṣaṇaṃ saṅkṣipāmi // DhDaś_1.4 //	nāṭyānām kintu kiñcid praguṇa racanayā lakṣaṇam saṅkṣipāmi 
SA_GK18_dhandasu-12	vyākīrṇe mandabuddhīnāṃ jāyate mativibhramaḥ /	vyākīrṇe manda buddhīnām jāyate mati vibhramaḥ 
SA_GK18_dhandasu-13	tasyārthastatpadaistena saṅkṣipya kriyate 'ñjasā // DhDaś_1.5 //	tasya arthaḥ tad padaiḥ tena saṅkṣipya kriyate ñjasā 
SA_GK18_dhandasu-14	ānandanisyandiṣu rūpakeṣu	ānanda nisyandiṣu rūpakeṣu 
SA_GK18_dhandasu-15	vyutpattimātraṃ phalamalpabuddhiḥ /	vyutpatti mātram phalam alpa buddhiḥ 
SA_GK18_dhandasu-16	yo'pītihāsādivadāha sādhus	yopī itihāsa ādi vat āha sādhuḥ 
SA_GK18_dhandasu-17	tasmai namaḥ svāduparāṅmukhāya // DhDaś_1.6 //	tasmai namaḥ svādu parāṅmukhāya 
SA_GK18_dhandasu-18	avasthānukṛtirnāṭyaṃ rūpaṃ dṛśyatayocyate /	avasthā anukṛtiḥ nāṭyam rūpam dṛśya tayā ucyate 
SA_GK18_dhandasu-19	rūpakaṃ tat samāropād daśadhaiva rasāśrayam // DhDaś_1.7 //	rūpakam tat samāropāt daśadhā eva rasa āśrayam 
SA_GK18_dhandasu-20	nāṭakaṃ saprakaraṇaṃ bhāṇaḥ prahasanaṃ ḍimaḥ /	nāṭakam sa prakaraṇam bhāṇaḥ prahasanam ḍimaḥ 
SA_GK18_dhandasu-21	vyāyogasamavakārau vīthyaṅkehāmṛgā iti // DhDaś_1.8 //	vyāyoga samavakārau vīthi aṅka ihāmṛgāḥ iti 
SA_GK18_dhandasu-22	anyada bhāvāśrayaṃ nṛtyaṃ nṛttaṃ tālalayāśrayam /	bhāva āśrayam nṛtyam nṛttam tāla laya āśrayam 
SA_GK18_dhandasu-23	ādyaṃ padārthābhinayo mārgo deśo tathā param // DhDaś_1.9 //	ādyam padārtha abhinayaḥ mārgaḥ tathā param 
SA_GK18_dhandasu-24	madhuroddhatabhedena tad dvayaṃ dvividhaṃ punaḥ /	madhura uddhata bhedena tat dvayam dvividham punar 
SA_GK18_dhandasu-25	lāsyatāṇḍavarūpeṇa nāṭakādyupakārakam // DhDaś_1.10 //	lāsya tāṇḍava rūpeṇa nāṭaka ādi upakārakam 
SA_GK18_dhandasu-26	vastu netā rasasteṣāṃ bhedako vastu ca dvidhā /	vastu netā rasaḥ teṣām bhedakaḥ vastu ca dvidhā 
SA_GK18_dhandasu-27	tatrādhikārikaṃ mukhyamaṅgaṃ prāsaṅgikaṃ viduḥ // DhDaś_1.11 //	tatra ādhikārikam mukhyam aṅgam prāsaṅgikam viduḥ 
SA_GK18_dhandasu-28	adhikāraḥ phalasvāmyamadhikāro ca tatprabhuḥ /	adhikāraḥ phala svāmyam ca tad prabhuḥ 
SA_GK18_dhandasu-29	tanniravartyamabhivyāpi vṛttaṃ syādādhikārikam // DhDaś_1.12 //	tat niravartyam abhivyāpi vṛttam syāt ādhikārikam 
SA_GK18_dhandasu-30	prāsaṅgikaṃ parārthasya svārtho yasya prasaṅgataḥ /	prāsaṅgikam para arthasya sva arthaḥ yasya prasaṅgataḥ 
SA_GK18_dhandasu-31	sānubandhaṃ patākākhyaṃ prakarī ca pradeśabhāk // DhDaś_1.13 //	sānubandham patākā ākhyam prakarī ca pradeśa bhāj 
SA_GK18_dhandasu-32	prāsaṅgikaṃ parārthasya svārtho yasya prasaṅgataḥ /	prāsaṅgikam para arthasya sva arthaḥ yasya prasaṅgataḥ 
SA_GK18_dhandasu-33	sānubandhaṃ tulyasaṃvidhānaviśeṣaṇam // DhDaś_1.14 //	sa anubandham tulya saṃvidhāna viśeṣaṇam 
SA_GK18_dhandasu-34	prakhyātotpādyamiśratvabhedāt tredhāpi tat tridhā /	prakhyāta utpādya miśra tva bhedāt tredhā api tat tridhā 
SA_GK18_dhandasu-35	prakhyātamitihāsāderutpādyaṃ kavikalpitam /	prakhyātam itihāsa ādeḥ utpādyam kavi kalpitam 
SA_GK18_dhandasu-36	miśraṃ ca saṅkarāt tābhyāṃ divyanartyādibhedataḥ // DhDaś_1.15 //	miśram ca saṅkarāt tābhyām divya narti ādi bhedataḥ 
SA_GK18_dhandasu-37	kāryaṃ trivargastat śuddhamekānekānubandhi ca /	kāryam trivargaḥ tat śuddham eka aneka anubandhi ca 
SA_GK18_dhandasu-38	svalpoddiṣṭastu taddheturbījaṃ vistāryanekadhā /	svalpa uddiṣṭaḥ tu tad hetuḥ bījam vistāri anekadhā 
SA_GK18_dhandasu-39	avāntarārthavicchede binduracchedakāraṇam // DhDaś_1.16 //	avāntara artha vicchede binduḥ accheda kāraṇam 
SA_GK18_dhandasu-40	bījabindupatākākhyaprakarokāryalakṣaṇāḥ /	               
SA_GK18_dhandasu-41	arthaprakṛtayaḥ pañca tā etāḥ parikīrtitāḥ // DhDaś_1.17 //	artha prakṛtayaḥ pañca tāḥ etāḥ parikīrtitāḥ 
SA_GK18_dhandasu-42	avasthāḥ pañca kāryasya prārabdhasya phalārthibhiḥ /	avasthāḥ pañca kāryasya prārabdhasya phala arthibhiḥ 
SA_GK18_dhandasu-43	ārambhayatnaprāptyāśāniyatāptiphalāgamāḥ // DhDaś_1.18 //	ārambha yatna prāpti āśā niyata āpti phala āgamāḥ 
SA_GK18_dhandasu-44	autsukyamātramārambhaḥ phalalābhāya bhūyase /	autsukya mātram ārambhaḥ phala lābhāya bhūyase 
SA_GK18_dhandasu-45	prayatnastu tadaprāptau vyāpāro'titvarānvitaḥ // DhDaś_1.19 //	prayatnaḥ tu tad aprāptau vyāpāra uti tvarā anvitaḥ 
SA_GK18_dhandasu-46	upāyāpāyaśaṅkābhyāṃ prāptyāśā prāptisambhavaḥ /	            
SA_GK18_dhandasu-47	apāyābhāvataḥ prāptirniyatāptiḥ suniścitā /	apāya abhāvataḥ prāptiḥ niyata āptiḥ su niścitā 
SA_GK18_dhandasu-48	samagraphalasampattiḥ phalayogo yathoditaḥ // DhDaś_1.20 //	samagra phala sampattiḥ phala yogaḥ yathā uditaḥ 
SA_GK18_dhandasu-49	arthaprakṛtayaḥ pañca pañcāvasthāsamanvitāḥ /	artha prakṛtayaḥ pañca pañca avasthā samanvitāḥ 
SA_GK18_dhandasu-50	yathāsaṅkhyena jāyante mukhādyāḥ pañca sandhayaḥ // DhDaś_1.21 //	yathāsaṅkhyena jāyante mukha ādyāḥ pañca sandhayaḥ 
SA_GK18_dhandasu-51	antaraikārthasambandhaḥ sandhirekānvaye sati /	antara eka artha sambandhaḥ sandhiḥ eka anvaye sati 
SA_GK18_dhandasu-52	mukhapratimukhe garbhaḥ sāvamarśopasaṃhṛtiḥ // DhDaś_1.22 //	mukha pratimukhe garbhaḥ sa avamarśa upasaṃhṛtiḥ 
SA_GK18_dhandasu-53	mukhaṃ bījasamutpattirnānārtharasasambhavā /	mukham bīja samutpattiḥ nānā artha rasa sambhavā 
SA_GK18_dhandasu-54	aṅgāni dvādaśaitasya bījārambhasamanvayāt // DhDaś_1.23 //	aṅgāni dvādaśa etasya bīja ārambha samanvayāt 
SA_GK18_dhandasu-55	upakṣepaḥ parikaraḥ parinyāso vilobhanam /	upakṣepaḥ parikaraḥ parinyāsaḥ vilobhanam 
SA_GK18_dhandasu-56	yuktiḥ prāptiḥ samādhānaṃ vidhānaṃ paribhāvanā /	yuktiḥ prāptiḥ samādhānam vidhānam paribhāvanā 
SA_GK18_dhandasu-57	udbhedabhedakaraṇānyanvarthānyatha lakṣaṇam // DhDaś_1.24 //	udbheda bheda karaṇāni anvarthāni atha lakṣaṇam 
SA_GK18_dhandasu-58	bījanyāsas upakṣepaḥ tadbāhulyaṃ parikriyā /	         
SA_GK18_dhandasu-59	tannniṣpattiḥ parinyāso guṇākhyānād vilobhanam // DhDaś_1.25 //	tad niṣpattiḥ parinyāsaḥ guṇa ākhyānāt vilobhanam 
SA_GK18_dhandasu-60	sampradhāraṇamarthānāṃ yuktiḥ prāptiḥ sukhāgamaḥ /	sampradhāraṇam arthānām yuktiḥ prāptiḥ sukha āgamaḥ 
SA_GK18_dhandasu-61	bījāgamaḥ samādhānaṃ vidhānaṃ sukhaduḥkhakṛt // DhDaś_1.26 //	                
SA_GK18_dhandasu-62	paribhāvodbhutāveśa udbhedo gūḍhabhedanam /	            
SA_GK18_dhandasu-63	karaṇaṃ prakṛtārambho bhedaḥ protsāhanā matā // DhDaś_1.27 //	karaṇam prakṛta ārambhaḥ bhedaḥ protsāhanā matā 
SA_GK18_dhandasu-64	lakṣyālakṣya ivodbhedastasya pratimukhaṃ bhavet /	lakṣyālakṣyaḥ iva udbhedaḥ tasya pratimukham bhavet 
SA_GK18_dhandasu-65	binduprayatnānugamādaṅgānyasya trayodaśa // DhDaś_1.28 //	bindu prayatna anugamāt aṅgāni asya trayodaśa 
SA_GK18_dhandasu-66	vilāsaḥ parisarpaśca vidhūtaṃ śamanarmaṇo /	vilāsaḥ parisarpaḥ ca vidhūtam śama narmaṇaḥ 
SA_GK18_dhandasu-67	narmadyutiḥ pragayaṇaṃ nirodhaḥ paryupāsanam // DhDaś_1.29 //	narma dyutiḥ pragayaṇam nirodhaḥ paryupāsanam 
SA_GK18_dhandasu-68	vajraṃ puṣpamupanyāpto varṇa saṃhāra ityapi /	vajram puṣpam upanyāptaḥ varṇa saṃhāraḥ iti api 
SA_GK18_dhandasu-69	ratyarthehā vilāsaḥ syād dṛṣṭanaṣṭānusarpaṇam /	rati artha īhā vilāsaḥ syāt dṛṣṭa naṣṭa anusarpaṇam 
SA_GK18_dhandasu-70	parisarpā vidhūtaṃ syādaratistacchamaḥ śamaḥ // DhDaś_1.30 //	parisarpāḥ vidhūtam syāt aratiḥ tad śamaḥ śamaḥ 
SA_GK18_dhandasu-71	parihāsavatto narma dhṛtistajjā dyutirmatā /	parihāsavattaḥ narma dhṛtiḥ tad jā dyutiḥ matā 
SA_GK18_dhandasu-72	uttarā vāk pragayaṇaṃ hitarodho nirodhanam // DhDaś_1.31 //	uttarā vāc pragayaṇam hita rodhaḥ nirodhanam 
SA_GK18_dhandasu-73	paryupāstiranunayaḥ puṣpaṃ vākyaṃ viśeṣavat /	paryupāstiḥ anunayaḥ puṣpam vākyam viśeṣavat 
SA_GK18_dhandasu-74	upanyāsastu sopāyaṃ vajraṃ pratyakṣaniṣṭhuram /	upanyāsaḥ tu sa upāyam vajram pratyakṣa niṣṭhuram 
SA_GK18_dhandasu-75	cāturvarṇopagamanaṃ varṇasaṃhāra iṣyate // DhDaś_1.32 //	cāturvarṇa upagamanam varṇa saṃhāraḥ iṣyate 
SA_GK18_dhandasu-76	garbhastu dṛṣṭanaṣṭasya bījasyānveṣaṇaṃ muhuḥ /	garbhaḥ tu dṛṣṭa naṣṭasya bījasya anveṣaṇam muhur 
SA_GK18_dhandasu-77	dvādaśāṅgaḥ patākā syān na vā syāt prāptisambhavaḥ // DhDaś_1.33 //	dvādaśa aṅgaḥ patākā syāt na vā syāt prāpti sambhavaḥ 
SA_GK18_dhandasu-78	abhūtāharaṇaṃ mārgā rūpodāharaṇe kramaḥ /	a bhūta āharaṇam mārgāḥ rūpa udāharaṇe kramaḥ 
SA_GK18_dhandasu-79	saṅgahaścānumānaṃ ca toṭakādhivale tathā // DhDaś_1.34 //	saṅgahaḥ ca anumānam ca toṭaka adhivale tathā 
SA_GK18_dhandasu-80	udvegasambhramākṣepā lakṣaṇaṃ ca praṇīyate /	udvega sambhrama ākṣepāḥ lakṣaṇam ca praṇīyate 
SA_GK18_dhandasu-81	abhūtāharaṇaṃ chadma mārgastattvārthakīrtanam // DhDaś_1.35 //	abhūta āharaṇam chadma mārgaḥ tattva artha kīrtanam 
SA_GK18_dhandasu-82	rūpaṃ vitarkavad vākyaṃ sotkarṣaṃ syādudāhṛtiḥ /	rūpam vitarkavat vākyam sa utkarṣam syāt udāhṛtiḥ 
SA_GK18_dhandasu-83	kramaḥ sañcintyamānāptir bhāvajñānamathāpare // DhDaś_1.36 //	kramaḥ sañcintyamāna āptiḥ bhāva jñānam atha apare 
SA_GK18_dhandasu-84	saṅgrahaḥ sāmadānoktir abhyūho liṅgato'numā /	saṅgrahaḥ sāma dāna uktiḥ abhyūhaḥ liṅgataḥ numā 
SA_GK18_dhandasu-85	adhivalamabhisandhiḥ saṃrabdhaṃ toṭakaṃ vacaḥ // DhDaś_1.37 //	adhivalam abhisandhiḥ saṃrabdham toṭakam vacaḥ 
SA_GK18_dhandasu-86	udvego'richa(?)	udvegoḥ icha 
SA_GK18_dhandasu-87	tā bhītiḥ śaṅkātrāsau ca sambhramaḥ /	tāḥ bhītiḥ śaṅkā atrā asau ca sambhramaḥ 
SA_GK18_dhandasu-88	garbhabījasamudbhedādākṣepaḥ parikīrtitaḥ // DhDaś_1.38 //	garbha bīja samudbhedāt ākṣepaḥ parikīrtitaḥ 
SA_GK18_dhandasu-89	krodhenāvamṛśed yatra vyasanād yā vilobhanāt /	krodhena avamṛśet yatra vyasanāt yā vilobhanāt 
SA_GK18_dhandasu-90	garbhanirbhinnabījārthaḥ so'vamarśo'ṅgasaṅgahaḥ // DhDaś_1.39 //	garbha nirbhinna bīja arthaḥ sa uvamarśa uṅga saṅgahaḥ 
SA_GK18_dhandasu-91	tatrāpavādasampheṭau vidravadravaśaktayaḥ /	tatra apavāda sampheṭau vidrava drava śaktayaḥ 
SA_GK18_dhandasu-92	dyutiḥ prasaṅgaśchalanaṃ vyavasāyo virodhanam /	dyutiḥ prasaṅgaḥ chalanam vyavasāyaḥ virodhanam 
SA_GK18_dhandasu-93	prayocanā vicalanamādānaṃ ca taryodaśa // DhDaś_1.40 //	prayocanāḥ vicalanam ādānam ca taryaḥ daśa 
SA_GK18_dhandasu-94	doṣaprakhyāpavādaḥ syāt sampheṭo roṣabhāṣaṇam /	doṣa prakhyā apavādaḥ syāt sampheṭaḥ roṣa bhāṣaṇam 
SA_GK18_dhandasu-95	vidravo vadhabandhādir dravo gurutiraskṛtiḥ // DhDaś_1.41 //	vidravaḥ vadha bandha ādiḥ dravaḥ guru tiraskṛtiḥ 
SA_GK18_dhandasu-96	virodhaśamanaṃ śaktistarjanodvejane dyutiḥ /	virodha śamanam śaktiḥ tarjana udvejane dyutiḥ 
SA_GK18_dhandasu-97	gurukīrtanaṃ prasaṅgaśchalanaṃ cāvamānanam // DhDaś_1.42 //	guru kīrtanam prasaṅgaḥ chalanam ca avamānanam 
SA_GK18_dhandasu-98	vyavasāyaḥ khaśaktyuktiḥ saṃrabdhānāṃ virodhanam /	vyavasāyaḥ kha śakti uktiḥ saṃrabdhānām virodhanam 
SA_GK18_dhandasu-99	siddhāmantraṇato bhāvidarśikā syāt prayocanā /	siddhā āmantraṇataḥ bhāvidarśikā syāt prayocanā 
SA_GK18_dhandasu-100	vikatthanā vicalanam ādānaṃ kāryasaṅgrahaḥ // DhDaś_1.43 //	vikatthanā vicalanam ādānam kārya saṅgrahaḥ 
SA_GK18_dhandasu-101	bījavanto mukhādyarthā viprakīrṇā yathāyatham /	bījavantaḥ mukha ādi arthāḥ viprakīrṇāḥ yathāyatham 
SA_GK18_dhandasu-102	aikārthyamupanīyante yatra nirvahaṇaṃ hi tat // DhDaś_1.44 //	aikārthyam upanīyante yatra nirvahaṇam hi tat 
SA_GK18_dhandasu-103	sandhirvibodho grathanaṃ nirṇayaḥ paribhāṣaṇam /	sandhiḥ vibodhaḥ grathanam nirṇayaḥ paribhāṣaṇam 
SA_GK18_dhandasu-104	prasādānandasamayāḥ kṛtibhāṣopagūhanāḥ /	prasāda ānanda samayāḥ kṛti bhāṣā upagūhanāḥ 
SA_GK18_dhandasu-105	pūrvabhāvopasaṃhārau praśastiśca caturdaśa // DhDaś_1.45 //	pūrvabhāva upasaṃhārau praśastiḥ ca caturdaśa 
SA_GK18_dhandasu-106	sandhirbījopagamanaṃ vibodhaḥ kāryamārgaṇam /	sandhiḥ bīja upagamanam vibodhaḥ kārya mārgaṇam 
SA_GK18_dhandasu-107	grathanaṃ tadupakṣepo 'nubhūtākhyā tu nirṇayaḥ // DhDaś_1.46 //	grathanam tad upakṣepaḥ nubhūta ākhyā tu nirṇayaḥ 
SA_GK18_dhandasu-108	paribhāṣā mitho jalpaḥ prasādaḥ paryupāsanam /	paribhāṣā mithas jalpaḥ prasādaḥ paryupāsanam 
SA_GK18_dhandasu-109	ānando vāñchitāvāptiḥ samayo duḥkhanirgamaḥ // DhDaś_1.47 //	            
SA_GK18_dhandasu-110	kṛtirlabdhārthaśamanaṃ mānādyāptiśca bhāṣaṇam /	kṛtiḥ labdha artha śamanam māna ādi āptiḥ ca bhāṣaṇam 
SA_GK18_dhandasu-111	kāryadṛṣṭyadbhutaprāpto pūrvabhāvopagūhane /	kārya dṛṣṭi adbhuta prāpto pūrva bhāva upagūhane 
SA_GK18_dhandasu-112	varāptiḥ kāvyasaṃhāraḥ praśastiḥ śubhaśaṃsanam // DhDaś_1.48 //	vara āptiḥ kāvya saṃhāraḥ praśastiḥ śubha śaṃsanam 
SA_GK18_dhandasu-113	iṣṭasyārthasya racanā gopyaguptiḥ prakāśanam /	iṣṭasya arthasya racanā gopya guptiḥ prakāśanam 
SA_GK18_dhandasu-114	rāgaḥ prayogasyāścaryaṃ vṛttāntasyānupakṣayaḥ // DhDaś_1.49 //	rāgaḥ prayogasya āścaryam vṛttāntasya an upakṣayaḥ 
SA_GK18_dhandasu-115	dvedhā vibhāgaḥ kartavyaḥ sarvasyāpoha vastunaḥ /	dvedhā vibhāgaḥ kartavyaḥ sarvasya apoha vastunaḥ 
SA_GK18_dhandasu-116	sūcyameva bhavet kiñcid dṛśyaśravyamathāparam // DhDaś_1.50 //	sūcyam eva bhavet kiñcid dṛśya śravyam atha aparam 
SA_GK18_dhandasu-117	nīraso'nucitastatra saṃsūcyo vastuvistaraḥ /	nīrasaḥ unucitaḥ tatra saṃsūcyaḥ vastu vistaraḥ 
SA_GK18_dhandasu-118	dṛśyastu madhurodāttarasabhāvanirantaraḥ // DhDaś_1.51 //	dṛśyaḥ tu madhura udātta rasa bhāva nirantaraḥ 
SA_GK18_dhandasu-119	arthopakṣepakaiḥ sūcyaṃ pañcabhiḥ pratipādayet /	artha upakṣepakaiḥ sūcyam pañcabhiḥ pratipādayet 
SA_GK18_dhandasu-120	viṣkambhacūlikāṅgāsyāṅkāvatārapraveśakaiḥ // DhDaś_1.52 //	viṣkambha cūlikā aṅga āsya aṅka avatāra praveśakaiḥ 
SA_GK18_dhandasu-121	vṛttavartiṣyamāṇānāṃ kathāṃśānāṃ nidarśakaḥ /	vṛtta vartiṣyamāṇānām kathā aṃśānām nidarśakaḥ 
SA_GK18_dhandasu-122	saṅkṣepārthastu viṣkambho madhyapātraprayojitaḥ /	saṅkṣepa arthaḥ tu viṣkambhaḥ madhya pātra prayojitaḥ 
SA_GK18_dhandasu-123	ekānekakṛtaḥ śuddhaḥ saṅkīrṇo nīcamadhyamaiḥ // DhDaś_1.53 //	eka aneka kṛtaḥ śuddhaḥ saṅkīrṇaḥ nīca madhyamaiḥ 
SA_GK18_dhandasu-124	tadvadevānudāttoktyā nīcapātraprayojitaḥ /	tadvat eva anudātta uktyā nīca pātra prayojitaḥ 
SA_GK18_dhandasu-125	praveśo'ṅkadvayasyāntaḥ śeṣārthasyopasūcakaḥ // DhDaś_1.54 //	praveśa uṅka dvayasya antaḥ śeṣa arthasya upasūcakaḥ 
SA_GK18_dhandasu-126	antaryavanikāsaṃsthaiścūlikārthasya sūcanā /	antar yavanikā saṃsthaiḥ cūlikā arthasya sūcanā 
SA_GK18_dhandasu-127	aṅkāntapātrairaṅkāsyaṃ chinnāṅkasyārthasūcanāt // DhDaś_1.55 //	aṅka anta pātraiḥ aṅka āsyam chinna aṅkasya artha sūcanāt 
SA_GK18_dhandasu-128	aṅkāvatārastvaṅkānte pāto'ṅkasyāvibhāgataḥ /	aṅka avatāraḥ tu aṅka ante pātā ūṅkasya avibhāgataḥ 
SA_GK18_dhandasu-129	ebhiḥ saṃsūcayet sūcyaṃ dṛśyamaṅkaiḥ pradarśayet // DhDaś_1.56 //	ebhiḥ saṃsūcayet sūcyam dṛśyam aṅkaiḥ pradarśayet 
SA_GK18_dhandasu-130	nāṭyadharmamapekṣyaitat punarvastu tridheṣyate /	nāṭya dharmam apekṣya etat punar vastu tridhā iṣyate 
SA_GK18_dhandasu-131	sarveṣāṃ niyatasyaiva śrāvyamaśrāvyameva ca // DhDaś_1.57 //	sarveṣām niyatasya eva śrāvyam a śrāvyam eva ca 
SA_GK18_dhandasu-132	sarvaśrāvyaṃ prakāśaṃ syādaśrāvyaṃ svagataṃ matam /	sarva śrāvyam prakāśam syāt aśrāvyam svagatam matam 
SA_GK18_dhandasu-133	dvidhānyan nāṭyadharmākhyaṃ janāntamapavāritam // DhDaś_1.58 //	dvidhā anyat nāṭya dharma ākhyam jana antam apavāritam 
SA_GK18_dhandasu-134	tripatākākareṇānyānapavāryāntarā kathām /	tripatākā kareṇa anyān apavārya antarā kathām 
SA_GK18_dhandasu-135	anyonyāmantraṇaṃ yat syāj janānte taj janāntikam /	anyonya āmantraṇam yat syāt jana ante tat janāntikam 
SA_GK18_dhandasu-136	rahasyaṃ kathyate 'nyasya parāvṛttyāpavāritam // DhDaś_1.59 //	rahasyam kathyate nyasya parāvṛttyā apavāritam 
SA_GK18_dhandasu-137	kiṃ bravīṣyevamityādi vinā pātraṃ bravīti yat /	kim bravīṣi evam ityādi vinā pātram bravīti yat 
SA_GK18_dhandasu-138	śrutvevānaktamapyekastat syādākāśamāpitam // DhDaś_1.60 //	śrutvā iva anaktam api ekaḥ tat syāt ākāśam āpitam 
SA_GK18_dhandasu-139	ityādyaśeṣamiha vastuvibhedajātaṃ	ityādi aśeṣam iha vastu vibheda jātam 
SA_GK18_dhandasu-140	rāmāyaṇādi ca vibhāvya bṛhatkathāṃ ca /	rāmāyaṇa ādi ca vibhāvya bṛhat kathām ca 
SA_GK18_dhandasu-141	āsūtrayet tadanu netṛrasānuguṇyāc	āsūtrayet tadanu netṛ rasa ānuguṇyāt 
SA_GK18_dhandasu-142	citrāṃ kathāmucitacāruvacaḥprapañcaiḥ // DhDaś_1.61 // @--------------------------------------------------------------------------------	citrām kathām ucita cāru vacaḥ prapañcaiḥ 
SA_GK18_dhandasu-143	[pariccheda 2]	pariccheda 
SA_GK18_dhandasu-144	netā vinīto madhurastyāgī dakṣaḥ priyagvadaḥ /	netā vinītaḥ madhuraḥ tyāgī dakṣaḥ priya gvadaḥ 
SA_GK18_dhandasu-145	raktalokaḥ śucirvāṅmī rūḍhavaṃśaḥ sthiro yuvā // DhDaś_2.1 //	rakta lokaḥ śuciḥ vāc mī rūḍha vaṃśaḥ sthiraḥ yuvā 
SA_GK18_dhandasu-146	buddhyutsāhasmṛtiprajñākalāmānasamanvitaḥ /	buddhi utsāha smṛti prajñā kalā māna samanvitaḥ 
SA_GK18_dhandasu-147	śūro dṛḍhaśca tejasvī śāstracakṣuśca dhārmikaḥ /	śūraḥ dṛḍhaḥ ca tejasvī śāstra cakṣuḥ ca dhārmikaḥ 
SA_GK18_dhandasu-148	bhedaiścaturdhā lalitaśāntodāttoddhatairayam // DhDaś_2.2 //	bhedaiḥ caturdhā lalita śānta udātta uddhataiḥ ayam 
SA_GK18_dhandasu-149	niścinto dhīralalitaḥ kalāsaktaḥ sukhī mṛduḥ /	niścintaḥ dhīra lalitaḥ kalā āsaktaḥ sukhī mṛduḥ 
SA_GK18_dhandasu-150	sāmānyagu.ayuktastu dhīraśānto dvijādikaḥ // DhDaś_2.3 //	dhīra śāntaḥ dvija ādikaḥ 
SA_GK18_dhandasu-151	mahāsattvo'tigambhīraḥ kṣamāvānavikatthanaḥ /	            
SA_GK18_dhandasu-152	sthiro nigūḍhāhaṅkāro dhīrodātto dṛḍhavrataḥ // DhDaś_2.4 //	sthiraḥ nigūḍha ahaṅkāraḥ dhīra udāttaḥ dṛḍha vrataḥ 
SA_GK18_dhandasu-153	darpamātsaryabhūyiṣṭho māyāchadmaparāyaṇaḥ /	darpa mātsarya bhūyiṣṭhaḥ māyā chadma parāyaṇaḥ 
SA_GK18_dhandasu-154	dhīroddhatastvahaṅkāro calaścaṇḍo vikattthanaḥ // DhDaś_2.5 //	dhīra uddhataḥ tu ahaṅkāro calaḥ caṇḍaḥ vikattthanaḥ 
SA_GK18_dhandasu-155	sa dakṣiṇaḥ śaṭho dhṛṣṭaḥ pūrvāṃ pratyanyayā hṛtaḥ /	sa dakṣiṇaḥ śaṭhaḥ dhṛṣṭaḥ pūrvām pratyanyayā hṛtaḥ 
SA_GK18_dhandasu-156	dakṣiṇo'syāṃ sahṛdayaḥ gūḍhavipriyakṛt śaṭhaḥ /	dakṣiṇā usyām sahṛdayaḥ gūḍha vipriya kṛt śaṭhaḥ 
SA_GK18_dhandasu-157	vyaktāṅgavaikṛto dhṛṣṭo'nukūlastvekanāyikaḥ // DhDaś_2.6 //	vyakta aṅga vaikṛtaḥ dhṛṣṭaḥ anukūlaḥ tu eka nāyikaḥ 
SA_GK18_dhandasu-158	patākānāyakastvanyaḥ pīṭhamardo vicakṣaṇaḥ /	patākānāyakaḥ tu anyaḥ pīṭhamardaḥ vicakṣaṇaḥ 
SA_GK18_dhandasu-159	tasyaivānucaro bhaktaḥ kiñcidūnaśca tadguṇaiḥ // DhDaś_2.7 //	tasya eva anucaraḥ bhaktaḥ kiñcid ūnaḥ ca tad guṇaiḥ 
SA_GK18_dhandasu-160	ekavidyo viṭaścānyo hāsyakṛc ca vidūṣakaḥ /	eka vidyaḥ viṭaḥ ca anyaḥ hāsya kṛt ca vidūṣakaḥ 
SA_GK18_dhandasu-161	lubdho dhīroddhatastabdhaḥ(?)	lubdhaḥ dhīra uddhata stabdhaḥ 
SA_GK18_dhandasu-162	pāpakṛd vyasanī ripuḥ // DhDaś_2.8 //	pāpa kṛt vyasanī ripuḥ 
SA_GK18_dhandasu-163	śobhā vilāso mādhuryaṃ gāmbhīryaṃ dhairyatejasī /	śobhā vilāsaḥ mādhuryam gāmbhīryam dhairya tejasī 
SA_GK18_dhandasu-164	lalitaudāryamityaṣṭau sattvajāḥ pauruṣā guṇāḥ // DhDaś_2.9 //	lalitā audāryam iti aṣṭau sattva jāḥ pauruṣāḥ guṇāḥ 
SA_GK18_dhandasu-165	nīce dhṛṇādhike spardhā śobhāyāṃ śauryadakṣate /	nīce dhṛṇā adhike spardhā śobhāyām 
SA_GK18_dhandasu-166	gatiḥ sadhairyā dṛṣṭiśca vilāse sammitaṃ vacaḥ // DhDaś_2.10 //	gatiḥ sa dhairyā dṛṣṭiḥ ca vilāse sammitam vacaḥ 
SA_GK18_dhandasu-167	ślakṣṇo vikāro mādhuryaṃ saṅkṣobhe sumahatyapi /	ślakṣṇaḥ vikāraḥ mādhuryam saṅkṣobhe su mahati api 
SA_GK18_dhandasu-168	gāmbhīryaṃ yatprabhāvena vikāro nopalakṣyate // DhDaś_2.11 //	gāmbhīryam yad prabhāvena vikāraḥ na upalakṣyate 
SA_GK18_dhandasu-169	vyavasāyādacalanaṃ sthairyaṃ vighnakulādapi /	vyavasāyāt acalanam sthairyam vighna kulāt api 
SA_GK18_dhandasu-170	adhikṣepādyasahanaṃ tejaḥ prāṇātyayeṣvapi // DhDaś_2.12 //	adhikṣepa ādi asahanam tejaḥ prāṇātyayeṣu api 
SA_GK18_dhandasu-171	śṛṅgārākāraceṣṭātvaṃ sahajaṃ lalitaṃ mṛdu /	              
SA_GK18_dhandasu-172	priyoktyājīvitād dānamaudāryaṃ sadupagrahaḥ // DhDaś_2.13 //	priya uktyā ājīvitāt dānam audāryam sat upagrahaḥ 
SA_GK18_dhandasu-173	svānyā sādhāraṇastrīti tadguṇā nāyikā tridhā /	svā anyā sādhāraṇa strī iti tad guṇā nāyikā tridhā 
SA_GK18_dhandasu-174	mugdhā madhyā pragalbheti svīyā śīlārjavādiyuk // DhDaś_2.14 //	mugdhā madhyā pragalbhā iti svīyā śīla ārjava ādi yuj 
SA_GK18_dhandasu-175	mugdhā navavayaḥkāmā ratau vāmā mṛduḥ krudhi /	mugdhā nava vayaḥ kāmā ratau vāmā mṛduḥ krudhi 
SA_GK18_dhandasu-176	madhyodyadyāvanānaṅgā mohāntasuratakṣamā // DhDaś_2.15 //	madhya udyat yāvana anaṅgā moha anta surata kṣamā 
SA_GK18_dhandasu-177	dhīrā sotprāsavakroktyā madhyā sāśru kṛtāgamam /	dhīrā sa utprāsa vakra uktyā madhyā sa aśru kṛta āgamam 
SA_GK18_dhandasu-178	khedayed dayitaṃ kopādadhīrā paruṣākṣaram // DhDaś_2.16 //	khedayet dayitam kopāt adhīrā paruṣa akṣaram 
SA_GK18_dhandasu-179	yauvanāndhā smaronmattā pragalbhā dayitāṅgake /	yauvana andhā smara unmattā pragalbhā dayitā aṅgake 
SA_GK18_dhandasu-180	vilīyamānevānandād ratārambhe'pyacetanā // DhDaś_2.17 //	vilīyamānā iva ānandāt rata ārambhe ipi acetanā 
SA_GK18_dhandasu-181	sāvahitthādarodāste ratau dhīretarā krudhā /	sā avahittha ādara udāste ratau dhīretarā krudhā 
SA_GK18_dhandasu-182	santarjya tāḍayen madhyā madhyādhīreva taṃ vadet /	santarjya tāḍayet madhyā madhya adhīḥ eva tam vadet 
SA_GK18_dhandasu-183	dvedhā jyeṣṭhā kaniṣṭā cetyamugdhā dvādaśoditāḥ // DhDaś_2.18 //	dvedhā jyeṣṭhā kaniṣṭā ca iti amugdhāḥ dvādaśa uditāḥ 
SA_GK18_dhandasu-184	anyastrī kanyakoḍhā ca nānyoḍhāṅgirase kvacit /	anya strī kanyakā ūḍhā ca na anya ūḍhā āṅgirase kvacid 
SA_GK18_dhandasu-185	kanyānurāgamicchātaḥ kuryādaṅgāṅgisaṃśrayam // DhDaś_2.19 //	kanyā anurāgam icchātaḥ kuryāt aṅga aṅgi saṃśrayam 
SA_GK18_dhandasu-186	sādhāraṇastrī gaṇikā kalāprāgalbhyadhaurtyayuk /	             
SA_GK18_dhandasu-187	channakāmasukhārthājñasvatantrāhaṃyupaṇḍakān // DhDaś_2.20 //	channa kāma sukha artha ajña svatantra ahaṃyu paṇḍakān 
SA_GK18_dhandasu-188	rakteva rañjayedāḍhyān niḥsvān mātrā vivāsayet /	raktā iva rañjayet āḍhyān niḥsvān mātrā vivāsayet 
SA_GK18_dhandasu-189	raktaiva tvaprahasane naiṣā divyanṛpāśraye // DhDaś_2.21 //	raktā eva tu a prahasane na eṣā divya nṛpa āśraye 
SA_GK18_dhandasu-190	āsāmaṣṭāvavasthāḥ syuḥ svādhīnapatikādikāḥ /	āsām aṣṭau avasthāḥ syuḥ svādhīna patika ādikāḥ 
SA_GK18_dhandasu-191	āsannāyattaramaṇā hṛṣṭā svādhīnabhartṛkā // DhDaś_2.22 //	āsanna āyatta ramaṇā hṛṣṭā svādhīna bhartṛkā 
SA_GK18_dhandasu-192	mudā vāsakasajjā svaṃ maṇḍayatyeṣyati priye /	mudā vāsaka sajjā svam maṇḍayati eṣyati priye 
SA_GK18_dhandasu-193	cirayatyavyalīke tu virahotkaṇṭhitonmanāḥ // DhDaś_2.23 //	cirayati avyalīke tu viraha utkaṇṭhita unmanāḥ 
SA_GK18_dhandasu-194	jñāte'nyāsaṅgavivṛte khaṇḍterṣyākaṣāyitā /	          
SA_GK18_dhandasu-195	kalahāntaritāmarṣād vidhūte'nuśayārtiyuk // DhDaś_2.24 //	             
SA_GK18_dhandasu-196	vipralabdhoktasamayamaprāpte'tivimānitā /	vipralabdhā ukta samayam aprāpta iti vimānitā 
SA_GK18_dhandasu-197	dūradeśābtarasthe tu kāryataḥ proṣitapriyā /	tu kāryataḥ proṣita priyā 
SA_GK18_dhandasu-198	kāmārtābhisaret kāntaṃ sārayed vābhisārikā // DhDaś_2.25 //	kāma ārtā abhisaret kāntam sārayet vā abhisārikā 
SA_GK18_dhandasu-199	cintāniḥśvāsakhedāśruvaivarṇyaglānyabhūṣaṇaiḥ /	cintā niḥśvāsa kheda aśru vaivarṇya glānya bhūṣaṇaiḥ 
SA_GK18_dhandasu-200	yuktāḥ ṣaḍantyā dve cādye kroḍaujjvalyapraharṣitaiḥ // DhDaś_2.26 //	yuktāḥ ṣaṣ antyāḥ dve ca ādye kroḍa aujjvalya praharṣitaiḥ 
SA_GK18_dhandasu-201	dūtyo dāsī sakhī kārūrdhātreyī prativeśikā /	dūtyaḥ dāsī sakhī kārūḥ dhātreyī prativeśikā 
SA_GK18_dhandasu-202	liṅginī śilpinī svaṃ ca netṛmitraguṇānvitāḥ // DhDaś_2.27 //	liṅginī śilpinī svam ca netṛ mitra guṇa anvitāḥ 
SA_GK18_dhandasu-203	yauvane sattvajāḥ strīṇāmalaṅkārāstu viṃśatiḥ /	yauvane sattva jāḥ strīṇām alaṅkārāḥ tu viṃśatiḥ 
SA_GK18_dhandasu-204	bhāvo hāvaśca helā ca trayastatra śarīrajāḥ // DhDaś_2.28 //	bhāvaḥ hāvaḥ ca helā ca trayaḥ tatra śarīra jāḥ 
SA_GK18_dhandasu-205	śobhā kāntiśca dīptiśca mādhuryaṃ ca pragalbhatā /	śobhā kāntiḥ ca dīptiḥ ca mādhuryam ca pragalbha tā 
SA_GK18_dhandasu-206	audāryaṃ dhairyamityete sapta bhāvā ayatnajāḥ // DhDaś_2.29 //	audāryam dhairyam iti ete sapta bhāvāḥ ayatna jāḥ 
SA_GK18_dhandasu-207	līlā vilāso vicchittirvibhramaḥ kilakiñcitam /	          
SA_GK18_dhandasu-208	moṭṭāyitaṃ kuṭṭamitaṃ bibboko lalitaṃ tathā /	moṭṭāyitam kuṭṭamitam bibbokaḥ lalitam tathā 
SA_GK18_dhandasu-209	vihṛtaṃ ceti vijñeyā daśa bhāvāḥ svabhāvajāḥ // DhDaś_2.30 //	vihṛtam ca iti vijñeyāḥ daśa bhāvāḥ svabhāva jāḥ 
SA_GK18_dhandasu-210	nirvikārātmakāt sattvād bhāvastatrādyavikriyā /	nirvikāra ātmakāt sattvāt bhāvaḥ tatra ādya vikriyā 
SA_GK18_dhandasu-211	hevākasastu śṛṅgāro hāvo'kṣibhrūvikārakṛt // DhDaś_2.31 //	hevākasaḥ tu śṛṅgāraḥ hāva ukṣi bhrū vikāra kṛt 
SA_GK18_dhandasu-212	sa eva helā suvyaktaśṛṅgārarasasūcikā /	saḥ eva helā su vyakta śṛṅgāra rasa sūcikā 
SA_GK18_dhandasu-213	rūpopabhogatāruṇyaiḥ śobhāṅgānāṃ vibhūṣaṇam // DhDaś_2.32 //	rūpa upabhoga tāruṇyaiḥ śobhā aṅgānām vibhūṣaṇam 
SA_GK18_dhandasu-214	manmathāvāpitacchāyā saiva kāntiriti smṛtā /	manmatha āvāpita chāyā sā eva kāntiḥ iti smṛtā 
SA_GK18_dhandasu-215	anulabaṇatvaṃ mādhuryaṃ dīptiḥ kāntestu vistaraḥ // DhDaś_2.33 //	anulabaṇa tvam mādhuryam dīptiḥ kānteḥ tu vistaraḥ 
SA_GK18_dhandasu-216	niḥsādhvasatvaṃ prāgalbhyaṃ audāryaṃ praśrayaḥ sadā /	niḥsādhvasa tvam prāgalbhyam audāryam praśrayaḥ sadā 
SA_GK18_dhandasu-217	cāpalāvihatā dhairyaṃ cidvṛttiravikatthanā // DhDaś_2.34 //	cāpala avihatā dhairyam cit vṛttiḥ avikatthanā 
SA_GK18_dhandasu-218	priyānukaraṇaṃ līlā madhurāṅgaviceṣṭitaiḥ /	priya anukaraṇam līlā madhura aṅga viceṣṭitaiḥ 
SA_GK18_dhandasu-219	tātkāliko viśeṣastu vilāso'ṅgakriyādiṣu // DhDaś_2.35 //	tātkālikaḥ viśeṣaḥ tu vilāsa uṅga kriyā ādiṣu 
SA_GK18_dhandasu-220	ākalparacanālpāpi vicchittiḥ kāntipopa(?)kṛt /	ākalpa racanā alpā api vicchittiḥ kānti popa kṛt 
SA_GK18_dhandasu-221	vibhramastvarayā kāle bhūṣāsthānaviparyayaḥ // DhDaś_2.36 //	vibhramaḥ tvarayā kāle bhūṣā sthāna viparyayaḥ 
SA_GK18_dhandasu-222	krodhāśruharṣabhītyādeḥ saṅkaraḥ kilakiñcitam /	krodha aśru harṣa bhīti ādeḥ saṅkaraḥ kilakiñcitam 
SA_GK18_dhandasu-223	moṭṭāyitaṃ tu tadbhāvabhāvaneṣṭakathādiṣu // DhDaś_2.37 //	moṭṭāyitam tu tad bhāva bhāvanā iṣṭa kathā ādiṣu 
SA_GK18_dhandasu-224	sānandāntaḥ kuṭṭamitaṃ kupyet keśādharagrahe /	sa ānanda antar kuṭṭamitam kupyet keśa adhara grahe 
SA_GK18_dhandasu-225	garvābhimānādiṣṭe'pi bibboko'nādarakriyā // DhDaś_2.38 //	garva abhimāna ādiṣṭe pi bibbokaḥ nādara kriyā 
SA_GK18_dhandasu-226	sukumārāṅgavinyāso masṛṇo lalitaṃ bhavet /	sukumāra aṅga vinyāsaḥ masṛṇaḥ lalitam bhavet 
SA_GK18_dhandasu-227	prāptakālaṃ na yad brūyād vrīḍayā vihṛtaṃ hi tat // DhDaś_2.39 //	prāpta kālam na yat brūyāt vrīḍayā vihṛtam hi tat 
SA_GK18_dhandasu-228	mantrī svaṃ vobhayaṃ vāpi sakhā tasyārthacintane /	mantrī svam vā ubhayam vā api sakhā tasya artha cintane 
SA_GK18_dhandasu-229	mantriṇā lalitaḥ śeṣāḥ mantrisvāyattasiddhayaḥ // DhDaś_2.40 //	mantriṇā lalitaḥ śeṣāḥ mantri sva āyatta siddhayaḥ 
SA_GK18_dhandasu-230	ṛtvikpurohitau dharme tapasvibrahmavādinaḥ /	ṛtvij purohitau dharme tapasvi brahma vādinaḥ 
SA_GK18_dhandasu-231	suhṛtkumārāṭavikā daṇḍe sāmantasainikāḥ // DhDaś_2.41 //	suhṛd kumāra āṭavikāḥ daṇḍe sāmanta sainikāḥ 
SA_GK18_dhandasu-232	antaḥpure varṣavarāḥ kirātā mūkavāmanāḥ /	antaḥpure varṣavarāḥ kirātāḥ mūka vāmanāḥ 
SA_GK18_dhandasu-233	mlecchābhīraśakārādyāḥ svasvakāryopayoginaḥ // DhDaś_2.42 //	mleccha ābhīra śakāra ādyāḥ sva sva kārya upayoginaḥ 
SA_GK18_dhandasu-234	jyeṣṭhamadhyādhamatvena sarveṣāṃ ca trirūpatā /	jyeṣṭha madhya adhama tvena sarveṣām ca tri rūpa tā 
SA_GK18_dhandasu-235	tāratamyād yathoktānāṃ guṇānāṃ cottamāditā /	tāratamyāt yathā uktānām guṇānām ca uttama ādi tā 
SA_GK18_dhandasu-236	evaṃ nāṭye vidhātavyo nāyakaḥ saparicchadaḥ // DhDaś_2.43 //	evam nāṭye vidhātavyaḥ nāyakaḥ sa paricchadaḥ 
SA_GK18_dhandasu-237	tadvyāpārātmikā vṛttiścaturdhā tatra kaiśikī /	tad vyāpāra ātmikā vṛttiḥ caturdhā tatra kaiśikī 
SA_GK18_dhandasu-238	gatinṛtyavilāsādyairmṛduḥ śṛṅgāraceṣṭitaiḥ /	gati nṛtya vilāsa ādyaiḥ mṛduḥ śṛṅgāra ceṣṭitaiḥ 
SA_GK18_dhandasu-239	narmataisphiñjatatsphoṭatadgaibhaiścaturaṅgikā // DhDaś_2.44 //	narma taisphiñja tatsphoṭa tad gaibhaiḥ caturaṅgikā 
SA_GK18_dhandasu-240	vaidagdhyakrīḍitaṃ narma priyopacchandanātmakam /	vaidagdhya krīḍitam narma priya upacchandana ātmakam 
SA_GK18_dhandasu-241	hāsyenaiva saśṛṅgārabhayena vihitaṃ tridhā // DhDaś_2.45 //	hāsyena eva sa śṛṅgāra bhayena vihitam tridhā 
SA_GK18_dhandasu-242	ātmopakṣepasambhogamānaiḥ śṛṅgāryapi tridhā /	ātma upakṣepa sambhoga mānaiḥ śṛṅgārī api tridhā 
SA_GK18_dhandasu-243	śuddhamaṅgaṃ bhayaṃ dvedhā vāgveṣaceṣṭitaiḥ /	śuddham aṅgam bhayam dvedhā vāc veṣa ceṣṭitaiḥ 
SA_GK18_dhandasu-244	sarvaṃ sahāsyamityevaṃ narmāsṭādaśadhoditam // DhDaś_2.46 //	sarvam sahāsyam iti evam narma asṭādaśadhā uditam 
SA_GK18_dhandasu-245	narmasphiñjaḥ sukhārambho bhayānto navasaṅgame /	            
SA_GK18_dhandasu-246	narmasphoṭastu bhāvānāṃ sūcito'lparaso lavaiḥ // DhDaś_2.47 //	narma sphoṭaḥ tu bhāvānām sūcita ulpa rasaḥ lavaiḥ 
SA_GK18_dhandasu-247	channanetrapratīcāro narmagarbho'rthahetave /	channa netra pratīcāraḥ narmagarbha ūrtha hetave 
SA_GK18_dhandasu-248	aṅgaiḥ sahāsyanirhāsyairebhireṣātra kaiśikī // DhDaś_2.48 //	aṅgaiḥ sa hāsya nirhāsyaiḥ ebhiḥ eṣā atra kaiśikī 
SA_GK18_dhandasu-249	viśokā sāttvatī sattvaśauryatyāgadayājavaiḥ /	viśokā sāttvatī sattva śaurya tyāga dayā javaiḥ 
SA_GK18_dhandasu-250	saṃlāpotthāpakāvasyāṃ sāṅghātyaḥ parivartakaḥ // DhDaś_2.49 //	saṃlāpa utthāpakau asyām sāṅghātyaḥ parivartakaḥ 
SA_GK18_dhandasu-251	saṃlāpako gabhīroktirnānābhāvarasā mithaḥ /	saṃlāpakaḥ gabhīra uktiḥ nānā bhāva rasāḥ mithas 
SA_GK18_dhandasu-252	utthāpakastu yatrādau yuddhāyotthāpayet param // DhDaś_2.50 //	utthāpakaḥ tu yatra ādau yuddhāya utthāpayet param 
SA_GK18_dhandasu-253	mantrārthadaivaśaktyādeḥ sāṅghātyaḥ saṅghabhedanam /	mantra artha daiva śakti ādeḥ sāṅghātyaḥ saṅgha bhedanam 
SA_GK18_dhandasu-254	prārabdhotthānakāryānyakaraṇāt parivartakaḥ // DhDaś_2.51 //	prārabdha utthāna kārya anya karaṇāt parivartakaḥ 
SA_GK18_dhandasu-255	ebhiraṅgaiścaturdheyaṃ sāttvatyārabhaṭī punaḥ /	ebhiḥ aṅgaiḥ caturdhā iyam sāttvatī ārabhaṭī punar 
SA_GK18_dhandasu-256	māyendrajālasaṅgrāmakrodhodbhrāntādiceṣṭitaiḥ /	māyā indrajāla saṅgrāma krodha udbhrānta ādi ceṣṭitaiḥ 
SA_GK18_dhandasu-257	saṅkṣiptikā syāt sampheṭo vastūtthānāvapātane // DhDaś_2.52 //	saṅkṣiptikā syāt sampheṭaḥ vastu utthāna avapātane 
SA_GK18_dhandasu-258	saṅkṣiptavasturacanā saṅkṣiptiḥ śilpayogataḥ /	saṅkṣipta vastu racanā saṅkṣiptiḥ śilpa yogataḥ 
SA_GK18_dhandasu-259	pūrvanetṛnivṛttyānye netrantaraparigrahaḥ // DhDaś_2.53 //	pūrva netṛ nivṛttyā anye netṛ antara parigrahaḥ 
SA_GK18_dhandasu-260	sampheṭastu samāghātaḥ kruddhasaṃrabdhayordvayoḥ /	sampheṭaḥ tu samāghātaḥ kruddha saṃrabdhayoḥ dvayoḥ 
SA_GK18_dhandasu-261	māyādyutthāpitaṃ vastu vastūtthāpanamiṣyate /	māyā ādi utthāpitam vastu vastu utthāpanam iṣyate 
SA_GK18_dhandasu-262	avapātastu niṣkrāmapraveśatrāsavidravaiḥ // DhDaś_2.54 //	avapātaḥ tu niṣkrāma praveśa trāsa vidravaiḥ 
SA_GK18_dhandasu-263	ebhiraṅgaiścaturdheyaṃ nārthavṛttirataḥ parā /	ebhiḥ aṅgaiḥ caturdhā iyam na artha vṛttiḥ atas parā 
SA_GK18_dhandasu-264	caturthī bhāratī sāpi vācyā nāṭakalakṣaṇe // DhDaś_2.55 //	caturthī bhāratī sā api vācyā nāṭaka lakṣaṇe 
SA_GK18_dhandasu-265	kaiśikīṃ sāttvatīṃ cārthavṛttimārabhaṭīmiti /	kaiśikīm sāttvatīm ca artha vṛttim ārabhaṭīm iti 
SA_GK18_dhandasu-266	paṭhantaḥ pañcamīṃ vṛttimaudbhaṭāḥ pratijānate // DhDaś_2.56 //	paṭhantaḥ pañcamīm vṛttim audbhaṭāḥ pratijānate 
SA_GK18_dhandasu-267	śṛṅgāre kauśikī vīre sāttvatyārabhaṭī punaḥ /	śṛṅgāre kauśikī vīre sāttvatī ārabhaṭī punar 
SA_GK18_dhandasu-268	rase raudre ca bībhatse vṛttiḥ sarvatra bhāratī // DhDaś_2.57 //	rase raudre ca bībhatse vṛttiḥ sarvatra bhāratī 
SA_GK18_dhandasu-269	deśabhāṣākriyāveṣalakṣaṇāḥ syuḥ pravṛttayaḥ /	deśa bhāṣā kriyā veṣa lakṣaṇāḥ syuḥ pravṛttayaḥ 
SA_GK18_dhandasu-270	lokādevāvagamyaitā yathaucityaṃ prayojayet // DhDaś_2.58 //	lokāt eva avagamya etāḥ yathaucityam prayojayet 
SA_GK18_dhandasu-271	pādyaṃ tu saṃskṛtaṃ nṝṇāmanīcānāṃ kṛtātmanām /	pādyam tu saṃskṛtam nṝṇām anīcānām kṛtātmanām 
SA_GK18_dhandasu-272	liṅginīnāṃ mahādevyā mantrijāveśyayoḥ kvacit // DhDaś_2.59 //	liṅginīnām mahādevyāḥ mantri ja āveśyayoḥ kvacid 
SA_GK18_dhandasu-273	strīṇāṃ tu prākṛtaṃ prāyaḥ śūrasenyadhameṣu ca /	strīṇām tu prākṛtam prāyas śūrasenī adhameṣu ca 
SA_GK18_dhandasu-274	piśācātyantanīcādau paiśācaṃ māgadhaṃ tathā // DhDaś_2.60 //	piśāca atyanta nīca ādau paiśācam māgadham tathā 
SA_GK18_dhandasu-275	yaddeśaṃ nīcapātraṃ yat taddeśaṃ tasya bhāṣitam /	yad deśam nīca pātram yat tad deśam tasya bhāṣitam 
SA_GK18_dhandasu-276	kāryataścottamādīnāṃ kāryo bhāṣāvyatikramaḥ // DhDaś_2.61 //	kāryataḥ ca uttama ādīnām kāryaḥ bhāṣā vyatikramaḥ 
SA_GK18_dhandasu-277	bhagavanto varairvācyā vidvaddevarṣiliṅginaḥ /	bhagavantaḥ varaiḥ vācyāḥ vidvat deva ṛṣi liṅginaḥ 
SA_GK18_dhandasu-278	viprāmātyāgrajāścāryā naṭīsūtramṛtau mithaḥ // DhDaś_2.62 //	vipra amātya agrajāḥ ca āryāḥ naṭī sūtra mṛtau mithas 
SA_GK18_dhandasu-279	rathī sūtena cāyuṣmān pūjyaiḥ śiṣyātmajānujāḥ /	rathī sūtena ca āyuṣmān pūjyaiḥ śiṣya ātmaja anujāḥ 
SA_GK18_dhandasu-280	vatseti tātaḥ pūjyo'pi sugṛhītābhidhastu taiḥ // DhDaś_2.63 //	vatsa iti tātaḥ pūjyaḥ api su gṛhīta abhidhaḥ tu taiḥ 
SA_GK18_dhandasu-281	bhāvo'nugena sūtrī ca mārṣetyetena so'pi ca /	bhāvonugena sūtrī ca mārṣa iti etena saḥ upi ca 
SA_GK18_dhandasu-282	devaḥ svāmīti nṛpatirbhṛtyairbhaṭṭeti cādhamaiḥ // DhDaś_2.64 //	devaḥ svāmī iti nṛpatiḥ bhṛtyaiḥ bhaṭṭa iti ca adhamaiḥ 
SA_GK18_dhandasu-283	āmantraṇīyāḥ pativaj jyeṣṭhamadhyādhamaiḥ striyaḥ /	āmantraṇīyāḥ pati vat jyeṣṭha madhya adhamaiḥ striyaḥ 
SA_GK18_dhandasu-284	samā haleti praṣyā ca hañje veśyājjukā tathā // DhDaś_2.65 //	samā halā iti ca hañje veśyā ajjukā tathā 
SA_GK18_dhandasu-285	kuṭṭinyamvetyanugataiḥ pūjyā vā jaratī janaiḥ /	kuṭṭinī amvā iti anugataiḥ pūjyā vā jaratī janaiḥ 
SA_GK18_dhandasu-286	vidūṣakeṇa bhavatī rājñī ceṭīti śabdyate // DhDaś_2.66 //	vidūṣakeṇa bhavatī rājñī ceṭī iti śabdyate 
SA_GK18_dhandasu-287	ceṣṭāguṇodāhṛtisattvabhāvān	ceṣṭā guṇa udāhṛti sattva bhāvān 
SA_GK18_dhandasu-288	aśeṣato netṛdaśāvibhinnān /	aśeṣatas netṛ daśā vibhinnān 
SA_GK18_dhandasu-289	ko vaktumīśo bharato na yo vā	kaḥ vaktum īśaḥ bharataḥ na yaḥ vā 
SA_GK18_dhandasu-290	yo vā na devaḥ śaśikhaṇḍamauliḥ // DhDaś_2.67 // ==============================	yaḥ vā na devaḥ śaśi khaṇḍa mauliḥ 
SA_GK18_dhandasu-291	[pariccheda 3]	pariccheda 
SA_GK18_dhandasu-292	prakṛtitvādathānyeṣāṃ bhūyorasaparigrahāt /	prakṛti tvāt atha anyeṣām bhūyas rasa parigrahāt 
SA_GK18_dhandasu-293	sampūrṇalakṣaṇatvāc ca pūrvaṃ nāṭakamucyate // DhDaś_3.1 //	sampūrṇa lakṣaṇa tvāt ca pūrvam nāṭakam ucyate 
SA_GK18_dhandasu-294	pūrvaraṅgaṃ vidhāyādau sūtradhāre vinirgate /	pūrvaraṅgam vidhāya ādau sūtradhāre vinirgate 
SA_GK18_dhandasu-295	praviśya tadvadaparaḥ kāvyamāsthāpayen naṭaḥ // DhDaś_3.2 //	praviśya tadvat aparaḥ kāvyam āsthāpayet naṭaḥ 
SA_GK18_dhandasu-296	divyamartye sa tadrūpo miśramanyatarastayoḥ /	divya martye sa tad rūpaḥ miśram anyataraḥ tayoḥ 
SA_GK18_dhandasu-297	sūcayed vastu bījaṃ vā mukhaṃ pātramathāpi vā // DhDaś_3.3 //	sūcayet vastu bījam vā mukham pātram atha api vā 
SA_GK18_dhandasu-298	raṅgaṃ prasādya madhuraiḥ ślokaiḥ kāvyārthasūcakaiḥ /	raṅgam prasādya madhuraiḥ ślokaiḥ kāvya artha sūcakaiḥ 
SA_GK18_dhandasu-299	ṛtuṃ kañcidupādāya bhāratīṃ vṛttimāśrayet // DhDaś_3.4 //	ṛtum kañcid upādāya bhāratīm vṛttim āśrayet 
SA_GK18_dhandasu-300	bhāratī saṃskṛtaprāyo vāgvyāpāro naṭāśrayaḥ /	           
SA_GK18_dhandasu-301	bhedaiḥ prarocanāyuktairvīrthīprahasanāmukhaiḥ // DhDaś_3.5 //	bhedaiḥ prarocanā yuktaiḥ vīrthī prahasanā mukhaiḥ 
SA_GK18_dhandasu-302	unmukhīkaraṇaṃ tatra praśaṃsātaḥ prarocanā /	unmukhīkaraṇam tatra praśaṃsātaḥ prarocanā 
SA_GK18_dhandasu-303	vīthī prahasanaṃ cāpi svaprasaṅge'bhidhāsyate /	vīthī prahasanam ca api sva prasaṅga ibhidhāsyate 
SA_GK18_dhandasu-304	vīthyaṅgāvyāmukhāṅgatvāducyante'traiva tat punaḥ // DhDaś_3.6 //	vīthi aṅga avyāmukha aṅga tvāt ucyante itra eva tat punar 
SA_GK18_dhandasu-305	sūtradhāro naṭīṃ brūte mārṣaṃ vātha vidūṣakam /	sūtradhāraḥ naṭīm brūte mārṣam vā atha vidūṣakam 
SA_GK18_dhandasu-306	svakāryaṃ prastutākṣepi citroktyā yat tadāmukham // DhDaś_3.7 //	sva kāryam prastuta ākṣepi citra uktyā yat tat āmukham 
SA_GK18_dhandasu-307	prastāvanā vā tatra syuḥ kathādghātaḥ pravṛttakam /	prastāvanāḥ vā tatra syuḥ kathādghātaḥ pravṛttakam 
SA_GK18_dhandasu-308	prayogātiśayaścātha vīthyaṅgāni trayodaśa // DhDaś_3.8 //	prayoga atiśayaḥ ca atha vīthi aṅgāni trayodaśa 
SA_GK18_dhandasu-309	svetivṛttasamaṃ vākyamarthaṃ vā yatra sūtriṇaḥ /	sva iti vṛtta samam vākyam artham vā yatra sūtriṇaḥ 
SA_GK18_dhandasu-310	gṛhītvā praviśet pātraṃ kathodghāto dvidhaiva saḥ // DhDaś_3.9 //	gṛhītvā praviśet pātram kathā udghātaḥ dvidhā eva saḥ 
SA_GK18_dhandasu-311	kālasāmyasamākṣiptapraveśaḥ syāt pravṛttakam /	kāla sāmya samākṣipta praveśaḥ syāt pravṛttakam 
SA_GK18_dhandasu-312	eṣo'yamityupakṣepāt sūtradhāraprayogataḥ /	eṣaḥ yam iti upakṣepāt sūtradhāra prayogataḥ 
SA_GK18_dhandasu-313	pātrapraveśo yatraiṣa prayogātiśayo mataḥ // DhDaś_3.10 //	pātra praveśaḥ yatra eṣa prayoga atiśayaḥ mataḥ 
SA_GK18_dhandasu-314	udghātyakāvalagite prapañcatrigate chalam /	udghātya kāvalagite prapañca trigate chalam 
SA_GK18_dhandasu-315	vākkelyadhivale gaṇḍamavasyanditanālike /	gaṇḍam avasyandita nālike 
SA_GK18_dhandasu-316	asatpralāpavyāhāramṛdavāni trayodaśa // DhDaś_3.11 //	asat pralāpa vyāhāra mṛdavāni trayodaśa 
SA_GK18_dhandasu-317	gūḍhārthapadaparyāyamālā praśnottarasya vā /	gūḍha artha pada paryāya mālā praśna uttarasya vā 
SA_GK18_dhandasu-318	yatrānyonyaṃ samālāpo dvedhodghātyaṃ taducyate // DhDaś_3.12 //	yatra anyonyam samālāpaḥ dvedhā udghātyam tat ucyate 
SA_GK18_dhandasu-319	yatraikatra samāveśāt kāryamanyat prasādhyate /	yatra ekatra samāveśāt kāryam anyat prasādhyate 
SA_GK18_dhandasu-320	prastute'nyatra vānyat syāt ta(?)	prastuteni atra vā anyat syāt te 
SA_GK18_dhandasu-321	cāvalagitaṃ dvidhā // DhDaś_3.13 //	ca avalagitam dvidhā 
SA_GK18_dhandasu-322	asadbhūtamithaḥstotraṃ prapañco hāsyakṛn mataḥ /	asat bhūta mithas stotram prapañcaḥ hāsya kṛt mataḥ 
SA_GK18_dhandasu-323	śrutisāmyādanekārthayojanaṃ trigataṃ tviha /	śruti sāmyāt aneka artha yojanam tri gatam tu iha 
SA_GK18_dhandasu-324	naṭāditritayālāpaḥ pūrvaraṅge tadiṣyate // DhDaś_3.14 //	naṭa ādi tritaya ālāpaḥ pūrvaraṅge tat iṣyate 
SA_GK18_dhandasu-325	priyābhairapriyairvākyairvilobhya chalanā chalam /	priya ābhaiḥ apriyaiḥ vākyaiḥ vilobhya chalanā chalam 
SA_GK18_dhandasu-326	vinivṛttyāsya vākkelī dvistriḥ pratyuktito'pi vā // DhDaś_3.15 //	vinivṛttya asya vāc kelī dvis tris pratyuktitaḥ api vā 
SA_GK18_dhandasu-327	anyonyavākyādhikyoktiḥ spardhayādhivalaṃ bhavet /	anyonya vākya ādhikya uktiḥ spardhayā ādhi valam bhavet 
SA_GK18_dhandasu-328	gaṇḍaḥ prastutasambandhibhinnārthaṃ sahasoditam // DhDaś_3.16 //	gaṇḍaḥ prastuta sambandhi bhinna artham sahasā uditam 
SA_GK18_dhandasu-329	rasoktasyānyathā vyākhyā yatrāvasyandita hi tat /	rasa uktasya anyathā vyākhyā hi tat 
SA_GK18_dhandasu-330	sopahāsā nigūḍhārthā nālikaiva prahelikā // DhDaś_3.17 //	sa upahāsā nigūḍha arthā nālikā eva prahelikā 
SA_GK18_dhandasu-331	asambaddhakathāprāyo'satpralāpo yathottaraḥ /	asambaddha kathā prāya usat pralāpaḥ yathottaraḥ 
SA_GK18_dhandasu-332	anyārthameva vyāhāro hāsyalāsyakaraṃ vacaḥ /	anya artham eva vyāhāraḥ hāsya lāsya karam vacaḥ 
SA_GK18_dhandasu-333	doṣā guṇā guṇā doṣā yatra syurmṛdavaṃ hi tat // DhDaś_3.18 //	doṣāḥ guṇāḥ guṇāḥ doṣāḥ yatra syuḥ mṛdavam hi tat 
SA_GK18_dhandasu-334	eṣāmanyatamenārthaṃ pātraṃ cākṣipya sūtrabhṛt /	eṣām anyatamena artham pātram ca ākṣipya sūtrabhṛt 
SA_GK18_dhandasu-335	prastāvanānte nirgacchet tato vastu prapañcayet // DhDaś_3.19 //	prastāvana ante nirgacchet tatas vastu prapañcayet 
SA_GK18_dhandasu-336	abhigamyaguṇairyukto dhīrodāttaḥ pratāpavān /	abhigamya guṇaiḥ yuktaḥ dhīra udāttaḥ pratāpavān 
SA_GK18_dhandasu-337	kīrtikāmo mahotsāhastrayyāstrātā mahīpatiḥ // DhDaś_3.20 //	kīrti kāmaḥ mahā utsāhaḥ trayyāḥ trātā mahīpatiḥ 
SA_GK18_dhandasu-338	prakhyātavaṃśo rājarṣirdivyo vā yatra nāyakaḥ /	prakhyāta vaṃśaḥ rājarṣiḥ divyaḥ vā yatra nāyakaḥ 
SA_GK18_dhandasu-339	tatprakhyātaṃ vidhātavyaṃ vṛttamatrādhikārikam // DhDaś_3.21 //	tat prakhyātam vidhātavyam vṛttam atra ādhikārikam 
SA_GK18_dhandasu-340	yat tatrānucitaṃ kiñcin nāyakasya rasasya vā /	yat tatra anucitam kiñcid nāyakasya rasasya vā 
SA_GK18_dhandasu-341	viruddhaṃ tat parityājyamanyathā vā prakalpayet // DhDaś_3.22 //	viruddham tat parityājyam anyathā vā prakalpayet 
SA_GK18_dhandasu-342	ādyantamevaṃ niścitya pañcadhā tad vibhajya ca /	ādi antam evam niścitya pañcadhā tat vibhajya ca 
SA_GK18_dhandasu-343	khaṇḍaśaḥ sandhisañjñāṃśca vibhāgānapi khaṇḍayet // DhDaś_3.23 //	khaṇḍaśas sandhi sañjñān ca vibhāgān api khaṇḍayet 
SA_GK18_dhandasu-344	catuḥṣaṣṭistu tāni syuraṅgānītyaparaṃ tathā /	catuḥṣaṣṭiḥ tu tāni syuḥ aṅgāni iti aparam tathā 
SA_GK18_dhandasu-345	patākāvṛttamapyūnamekādyairanusandhibhiḥ /	patākāvṛttam api ūnam eka ādyaiḥ anusandhibhiḥ 
SA_GK18_dhandasu-346	aṅgānyatra yathālābhamasandhiṃ prakarīṃ nyaset // DhDaś_3.24 //	aṅgāni atra yathālābham asandhim prakarīm nyaset 
SA_GK18_dhandasu-347	ādau viṣkambhakaṃ kuryādaṅkaṃ vā kāryayuktitaḥ /	ādau viṣkambhakam kuryāt aṅkam vā kārya yuktitaḥ 
SA_GK18_dhandasu-348	apekṣitaṃ parityajya nīrasaṃ vastuvistaram /	apekṣitam parityajya nīrasam vastu vistaram 
SA_GK18_dhandasu-349	yadā sandarśayet śeṣaṃ kuryād viṣkambhakaṃ tadā // DhDaś_3.25 //	yadā sandarśayet śeṣam kuryāt viṣkambhakam tadā 
SA_GK18_dhandasu-350	yadā tu sarasaṃ vastu mūlādeva pravartate /	yadā tu sa rasam vastu mūlāt eva pravartate 
SA_GK18_dhandasu-351	ādāveva tadāṅkaḥ syādāmukhākṣepasaṃśrayaḥ // DhDaś_3.26 //	ādau eva tadā aṅkaḥ syāt āmukha ākṣepa saṃśrayaḥ 
SA_GK18_dhandasu-352	pratyakṣanetṛcarito binduvyāptipuraskṛtaḥ /	             
SA_GK18_dhandasu-353	aṅko nānāprakārārthasaṃvidhānarasāśrayaḥ // DhDaś_3.27 //	aṅkaḥ nānā prakāra artha saṃvidhāna rasa āśrayaḥ 
SA_GK18_dhandasu-354	anubhāvavibhāvābhyāṃ sthāyinā vyabhicāribhiḥ /	anubhāva vibhāvābhyām sthāyinā vyabhicāribhiḥ 
SA_GK18_dhandasu-355	gṛhītamuktaiḥ kartavyamaṅginaḥ paripoṣaṇaṃ // DhDaś_3.28 //	gṛhīta muktaiḥ kartavyam aṅginaḥ paripoṣaṇam 
SA_GK18_dhandasu-356	na cātirasato vastu dūraṃ vicchinnatāṃ nayet /	na ca ati rasataḥ vastu dūram vicchinna tām nayet 
SA_GK18_dhandasu-357	rasaṃ vā na tirodadhyād vastvalaṅkāralakṣaṇaiḥ // DhDaś_3.29 //	rasam vā na tirodadhyāt vastu alaṅkāra lakṣaṇaiḥ 
SA_GK18_dhandasu-358	eko raso'ṅgīkartavyo vīraḥ śṛṅgāra eva vā /	ekaḥ rasa uṅgīkartavyaḥ vīraḥ śṛṅgāraḥ eva vā 
SA_GK18_dhandasu-359	aṅgamanye rasāḥ sarve kuryān nirvahaṇe'dbhutam // DhDaś_3.30 //	aṅgam anye rasāḥ sarve kuryāt nirvahaṇa idbhutam 
SA_GK18_dhandasu-360	dūrādhvānaṃ vadhaṃ yuddhaṃ rājyadeśādiviplavam /	dūra adhvānam vadham yuddham rājya deśa ādi viplavam 
SA_GK18_dhandasu-361	saṃrodhaṃ bhojanaṃ snānaṃ surataṃ cānulepanam // DhDaś_3.31 //	saṃrodham bhojanam snānam suratam ca anulepanam 
SA_GK18_dhandasu-362	ambaragrahaṇādīni pratyakṣāṇi na nirdiśet /	ambara grahaṇa ādīni pratyakṣāṇi na nirdiśet 
SA_GK18_dhandasu-363	nādhikārivadhaṃ kvāpi tyājyamāvaśyakaṃ na ca // DhDaś_3.32 //	na adhikāri vadham kvāpi tyājyam āvaśyakam na ca 
SA_GK18_dhandasu-364	ekāhācaritaikārthamitthamāsannanāyakam /	ekāha ācarita eka artham ittham āsanna nāyakam 
SA_GK18_dhandasu-365	pātraistricaturairaṅkaṃ teṣāmante'sya nirgamaḥ // DhDaś_3.33 //	pātraiḥ tricaturaiḥ aṅkam teṣām ante sya nirgamaḥ 
SA_GK18_dhandasu-366	patākāsthānakānyatra bindurante ca bījavat /	patākā sthānakāni atra binduḥ ante ca bīja vat 
SA_GK18_dhandasu-367	evamaṅkāḥ prakartavyāḥ praveśādipuraskṛtāḥ /	evam aṅkāḥ prakartavyāḥ praveśa ādi puraskṛtāḥ 
SA_GK18_dhandasu-368	pañcāṅkametadavaraṃ daśāṅkaṃ nāṭakaṃ param // DhDaś_3.34 //	pañca aṅkam etat avaram daśa aṅkam nāṭakam param 
SA_GK18_dhandasu-369	atha prakaraṇe vṛttamutpādyaṃ lokasaṃśrayam /	atha prakaraṇe vṛttam utpādyam loka saṃśrayam 
SA_GK18_dhandasu-370	amātyavipravaṇijāmekaṃ kuryāc ca nāyakam // DhDaś_3.35 //	amātya vipra vaṇijām ekam kuryāt ca nāyakam 
SA_GK18_dhandasu-371	dhīrapraśāntaṃ sāpāyaṃ dharmakāmārthatatparam /	dhīra praśāntam sa apāyam dharma kāma artha tatparam 
SA_GK18_dhandasu-372	śepaṃ nāṭakavat sandhipraveśakarasādikam // DhDaś_3.36 //	śepam nāṭaka vat sandhipraveśaka rasa ādikam 
SA_GK18_dhandasu-373	nāyikā tu dvidhā netuḥ kulastrī gaṇikā tathā /	nāyikā tu dvidhā netuḥ kula strī gaṇikā tathā 
SA_GK18_dhandasu-374	kvacidekaiva kulajā kvāpi dvayaṃ kvacit // DhDaś_3.37 //	kvacid ekā eva kula jā kvāpi dvayam kvacid 
SA_GK18_dhandasu-375	kulajābhyantarā bāhyā veśyā nātikramo'nayoḥ /	kula jā abhyantarā bāhyā veśyā na atikramaḥ ūnayoḥ 
SA_GK18_dhandasu-376	ābhiḥ prakaraṇaṃ tredhā saṅkīrṇaṃ dhūrtasaṅkulam // DhDaś_3.38 //	ābhiḥ prakaraṇam tredhā saṅkīrṇam dhūrta saṅkulam 
SA_GK18_dhandasu-377	lakṣyate nāṭikāpyatra saṅkīrṇānyanivṛttaye /	lakṣyate nāṭikā api atra saṅkīrṇa anya nivṛttaye 
SA_GK18_dhandasu-378	tatra vastu prakaraṇān nāṭakān nāyako nṛpaḥ /	tatra vastu prakaraṇāt nāṭakāt nāyakaḥ nṛpaḥ 
SA_GK18_dhandasu-379	prakhyāto dhīralalitaḥ śṛṅgāro'ṅgī salakṣaṇaḥ // DhDaś_3.39 //	              
SA_GK18_dhandasu-380	strīprāyacaturaṅkādibhedakaṃ yadi ceṣyate /	strī prāya catur aṅka ādi bhedakam yadi ca iṣyate 
SA_GK18_dhandasu-381	ekadvitryaṅkapātrādibhedenānantarūpatā // DhDaś_3.40 //	eka dvi tri aṅka pātra ādi bhedena ananta rūpa tā 
SA_GK18_dhandasu-382	devī tatra bhavej jyeṣṭhā pragalbhā nṛpavaṃśajā /	devī tatra bhavet jyeṣṭhā pragalbhā nṛpa vaṃśa jā 
SA_GK18_dhandasu-383	gambhīrā māninī kṛcchāt tadvaśān netṛsaṅgamaḥ // DhDaś_3.41 //	           
SA_GK18_dhandasu-384	nāyikā tādṛśī mugdhā divyā cātimanoharā /	nāyikā tādṛśī mugdhā divyā ca ati manoharā 
SA_GK18_dhandasu-385	antaḥpurādisambandhādāsannā śrutidarśanaiḥ // DhDaś_3.42 //	antaḥpura ādi sambandhāt āsannā śruti darśanaiḥ 
SA_GK18_dhandasu-386	anurāgo navāvastho netustasyāṃ yathottaram /	anurāgaḥ nava avasthaḥ netuḥ tasyām yathottaram 
SA_GK18_dhandasu-387	netā tatra pravarteta devītrāsena śaṅkitaḥ /	netā tatra pravarteta devī trāsena śaṅkitaḥ 
SA_GK18_dhandasu-388	kaiśikyaṅgaiścaturbhiśca yaktāṅkairiva nāṭikā // DhDaś_3.43 //	kaiśikī aṅgaiḥ caturbhiḥ ca yakta aṅkaiḥ iva nāṭikā 
SA_GK18_dhandasu-389	bhāṇastu dhūrtacaritaṃ svānubhūtaṃ pareṇa vā /	bhāṇaḥ tu dhūrta caritam sva anubhūtam pareṇa vā 
SA_GK18_dhandasu-390	yatropavarṇayedeko nipuṇaḥ paṇḍito viṭaḥ // DhDaś_3.44 //	yatra upavarṇayet ekaḥ nipuṇaḥ paṇḍitaḥ viṭaḥ 
SA_GK18_dhandasu-391	sambodhanoktipratyuktī kuryādākāśabhāpitaiḥ /	sambodhana ukti pratyuktī kuryāt ākāśa bhāpitaiḥ 
SA_GK18_dhandasu-392	sūcayed vīraśṛṅgārau śauryasaubhāgyasaṃstavaiḥ // DhDaś_3.45 //	sūcayet vīra śṛṅgārau śaurya saubhāgya saṃstavaiḥ 
SA_GK18_dhandasu-393	bhūyasā bhāratī vṛttirekāṅkaṃ vastu kalpitam /	bhūyasā bhāratī vṛttiḥ eka aṅkam vastu kalpitam 
SA_GK18_dhandasu-394	mukhanirvahaṇe sāṅge lāsyāṅgāni daśāpi ca // DhDaś_3.46 //	mukha nirvahaṇe sa aṅge lāsya aṅgāni daśa api ca 
SA_GK18_dhandasu-395	geyaṃ padaṃ sthitaṃ pādyamāsīnaṃ puṣpagaṇḍikā /	geyam padam sthitam pādyam āsīnam puṣpa gaṇḍikā 
SA_GK18_dhandasu-396	pracchedakastrigūḍhaṃ ca saindhavākhyaṃ dvigūḍhakam // DhDaś_3.47 //	pracchedakaḥ tri gūḍham ca saindhava ākhyam dvi gūḍhakam 
SA_GK18_dhandasu-397	uttamottamakaṃ caiva uktapratyuktameva ca /	uttamottamakam ca eva ukta pratyuktam eva ca 
SA_GK18_dhandasu-398	lāsye daśavidhaṃ hyetadaṅganirdeśakalpanam // DhDaś_3.48 //	lāsye daśavidham hi etat aṅga nirdeśa kalpanam 
SA_GK18_dhandasu-399	tadvat prahasanaṃ tredhā śuddhavaikṛtasaṅkaraiḥ /	tadvat prahasanam tredhā śuddha vaikṛta saṅkaraiḥ 
SA_GK18_dhandasu-400	pākhaṇḍivipraprabhṛticeṭaceṭīviṭākulam /	pākhaṇḍi vipra prabhṛti ceṭa ceṭī viṭa ākulam 
SA_GK18_dhandasu-401	ceṣṭitaṃ vepabhāṣābhiḥ śuddhaṃ hāsyavaconvitam // DhDaś_3.49 //	ceṣṭitam vepa bhāṣābhiḥ śuddham hāsya vacaḥ nvitam 
SA_GK18_dhandasu-402	kāmukādivaciveṣaiḥ ṣaṇḍhakañcukitāpasaiḥ /	kāmuka ādi vaci veṣaiḥ ṣaṇḍha kañcuki tāpasaiḥ 
SA_GK18_dhandasu-403	vikṛtaṃ saṅkarād vīthyā saṅkīrṇaṃ dhūrtasaṅkulam /	vikṛtam saṅkarāt vīthyā saṅkīrṇam dhūrta saṅkulam 
SA_GK18_dhandasu-404	rasastu bhūyasā kāryaḥ ṣaḍvidho hāsya eva tu // DhDaś_3.50 //	rasaḥ tu bhūyasā kāryaḥ ṣaḍvidhaḥ hāsyaḥ eva tu 
SA_GK18_dhandasu-405	ḍime vastu prasiddhaṃ syād vṛttayaḥ kaiśikīṃ vinā /	ḍime vastu prasiddham syāt vṛttayaḥ kaiśikīm vinā 
SA_GK18_dhandasu-406	netāro devagandharvayakṣarakṣomahoragāḥ /	netāraḥ deva gandharva yakṣa rakṣaḥ mahā uragāḥ 
SA_GK18_dhandasu-407	bhūtapretapiśācādyāḥ ṣoḍaśātyantamuddhatāḥ // DhDaś_3.51 //	bhūta preta piśāca ādyāḥ ṣoḍaśā atyantam uddhatāḥ 
SA_GK18_dhandasu-408	rasairahāsyaśṛṅgāraiḥ ṣaḍbhirdīptaiḥ samanvitaḥ /	rasaiḥ ahāsya śṛṅgāraiḥ ṣaḍbhiḥ dīptaiḥ samanvitaḥ 
SA_GK18_dhandasu-409	māyendrajālasaṅgrāmakrodhodbhrāntādiceṣṭitaiḥ // DhDaś_3.52 //	māyā indrajāla saṅgrāma krodha udbhrānta ādi ceṣṭitaiḥ 
SA_GK18_dhandasu-410	candrasūryoparāgaiśca nyāyye raudrarase'ṅgini /	candra sūrya uparāgaiḥ ca nyāyye raudra rasa iṅgini 
SA_GK18_dhandasu-411	caturaṅkaścatuḥsandhirnirvimarśo ḍimaḥ smṛtaḥ // DhDaś_3.53 //	           
SA_GK18_dhandasu-412	khyātetivṛtto vyāyogaḥ khyātoddhatanarāśrayaḥ /	              
SA_GK18_dhandasu-413	hīno garbhavimarśābhyāṃ dīptāḥ syurḍimavad rasāḥ // DhDaś_3.54 //	hīnaḥ garbha vimarśābhyām dīptāḥ syuḥ ḍima vat rasāḥ 
SA_GK18_dhandasu-414	astrīnimittasaṅgrāmo jāmadagnyajaye yathā /	a strī nimitta saṅgrāmaḥ jāmadagnya jaye yathā 
SA_GK18_dhandasu-415	ekāhācaritaikāṅko vyāyogo bahubhirnaraiḥ // DhDaś_3.55 //	eka aha ācarita eka aṅkaḥ vyāyogaḥ bahubhiḥ naraiḥ 
SA_GK18_dhandasu-416	kāryaṃ samavakāre'pi āmukhaṃ nāṭakādivat /	kāryam samavakāre pi āmukham nāṭaka ādi vat 
SA_GK18_dhandasu-417	khyātaṃ devāsuraṃ vastu nirvimarśāstu sandhayaḥ // DhDaś_3.56 //	khyātam devāsuram vastu nirvimarśāḥ tu sandhayaḥ 
SA_GK18_dhandasu-418	vṛttayo mandakaiśikyo netāro devadānavāḥ /	vṛttayaḥ manda kaiśikyaḥ netāraḥ deva dānavāḥ 
SA_GK18_dhandasu-419	dvādaśodāttavikhyātāḥ phalaṃ teṣāṃ pṛthak pṛthak // DhDaś_3.57 //	dvādaśa udātta vikhyātāḥ phalam teṣām pṛthak pṛthak 
SA_GK18_dhandasu-420	bahuvīrarasāḥ sarve yadvadambhodhimanthane /	              
SA_GK18_dhandasu-421	aṅkaiḥstribhistrikapaṭastriśṛṅgārastrividravaḥ // DhDaś_3.58 //	aṅkaiḥ tribhiḥ tri kapaṭaḥ tri śṛṅgāraḥ tri vidravaḥ 
SA_GK18_dhandasu-422	dvisandhiraṅkaḥ prathamaḥ kāryo dvādaśanālikaḥ /	dvi sandhiḥ aṅkaḥ prathamaḥ kāryaḥ dvādaśa nālikaḥ 
SA_GK18_dhandasu-423	caturdvinālikāvantyau nālikā ghaṭikādvayam // DhDaś_3.59 //	catur dvi nālikā avantyau nālikāḥ ghaṭikā dvayam 
SA_GK18_dhandasu-424	vastusvabhāvadaivārikṛtāḥ syuḥ kapaṭāstrayaḥ /	vastu svabhāva daiva ari kṛtāḥ syuḥ kapaṭāḥ trayaḥ 
SA_GK18_dhandasu-425	nagaroparodhayuddhe vātāgnyādikavidravāḥ // DhDaś_3.60 //	nagara uparodha yuddhe vāta agni ādika vidravāḥ 
SA_GK18_dhandasu-426	dharmārthakāmaiḥ śṛṅgāro nātra vindupraveśakau /	dharma artha kāmaiḥ śṛṅgāraḥ na atra vindu praveśakau 
SA_GK18_dhandasu-427	vīthyaṅgāni yathālābhaṃ kuryāt prahasane yathā // DhDaś_3.61 //	vīthi aṅgāni yathālābham kuryāt prahasane yathā 
SA_GK18_dhandasu-428	vīthī tu kaiśikīvṛttau sandhyaṅgāṅkaistu bhāṇavat /	vīthī tu kaiśikī vṛttau sandhi aṅga aṅkaiḥ tu bhāṇa vat 
SA_GK18_dhandasu-429	rasaḥ sūcyastu śṛṅgāraḥ spṛśedapi rasāntaram // DhDaś_3.62 //	rasaḥ sūcyaḥ tu śṛṅgāraḥ spṛśet api rasa antaram 
SA_GK18_dhandasu-430	yuktā prastāvanākhyātairaṅgairudghātyakādibhiḥ /	yuktā prastāvana ākhyātaiḥ aṅgaiḥ udghātyaka ādibhiḥ 
SA_GK18_dhandasu-431	evaṃ vīthī vidhātavyā dvyekapātraprayojitā // DhDaś_3.63 //	evam vīthī vidhātavyā dvi eka pātra prayojitā 
SA_GK18_dhandasu-432	utsṛṣṭikāṅke prakhyātaṃ vṛttaṃ buddhyā prapañcayet /	utsṛṣṭika aṅke prakhyātam vṛttam buddhyā prapañcayet 
SA_GK18_dhandasu-433	rasastu karuṇaḥ sthāyī netāraḥ prākṛtā narāḥ // DhDaś_3.64 //	rasaḥ tu karuṇaḥ sthāyī netāraḥ prākṛtāḥ narāḥ 
SA_GK18_dhandasu-434	bhāṇavat sandhivṛttyaṅgairyuktaḥ strīparidevitaiḥ /	bhāṇa vat sandhi vṛtti aṅgaiḥ yuktaḥ strī paridevitaiḥ 
SA_GK18_dhandasu-435	vācā yuddhaṃ vidhātavyaṃ tathā jayaparājayau // DhDaś_3.65 //	vācā yuddham vidhātavyam tathā jaya parājayau 
SA_GK18_dhandasu-436	miśramohāmṛge vṛttaṃ caturaṅkaṃ trisandhimat /	miśra mohā mṛge vṛttam catur aṅkam tri sandhimat 
SA_GK18_dhandasu-437	naradivyāvaniyamān nāyakapratināyakau // DhDaś_3.66 //	nara divyau aniyamāt nāyaka pratināyakau 
SA_GK18_dhandasu-438	khyātau dhīroddhatāvantyo viparyāsādayuktakṛt /	khyātau dhīra uddhata avantyaḥ viparyāsāt ayukta kṛt 
SA_GK18_dhandasu-439	divyastriyamanicchantīmapahārādinecchataḥ // DhDaś_3.67 //	divya striyam an icchantīm apahāra ādinā icchataḥ 
SA_GK18_dhandasu-440	śṛṅgārābhāsamapyasya kiñcit kiñcit pradarśayet /	śṛṅgāra ābhāsam api asya kiñcid kiñcid pradarśayet 
SA_GK18_dhandasu-441	saṃrambhaṃ paramānīya yuddhaṃ vyājān nivārayet /	saṃrambham param ānīya yuddham vyājāt nivārayet 
SA_GK18_dhandasu-442	vadhaprāptasya kurvīta vadhaṃ naiva mahātmanaḥ // DhDaś_3.68 //	vadha prāptasya kurvīta vadham nā eva mahātmanaḥ 
SA_GK18_dhandasu-443	itthaṃ vicintya daśarūpakalakṣmamārgam	ittham vicintya daśa rūpaka lakṣma mārgam 
SA_GK18_dhandasu-444	ālokya vastu paribhāvya kaviprabandhān /	ālokya vastu paribhāvya kavi prabandhān 
SA_GK18_dhandasu-445	kuryādayatnavadalaṅkṛtibhiḥ prabandhaṃ	kuryāt ayatnavat alaṅkṛtibhiḥ prabandham 
SA_GK18_dhandasu-446	vākyairudāramadhuraiḥ sphuṭamandavṛttaiḥ // DhDaś_3.69 // ================================	vākyaiḥ udāra madhuraiḥ sphuṭa manda vṛttaiḥ 
SA_GK18_dhandasu-447	[pariccheda 4]	pariccheda 
SA_GK18_dhandasu-448	vibhāvairanubhāvaiśca sāttvikairvyabhicāribhiḥ /	vibhāvaiḥ anubhāvaiḥ ca sāttvikaiḥ vyabhicāribhiḥ 
SA_GK18_dhandasu-449	ānīyamānaḥ svādyatvaṃ sthāyī bhāvo rasaḥ smṛtaḥ // DhDaś_4.1 //	ānīyamānaḥ svādya tvam sthāyī bhāvaḥ rasaḥ smṛtaḥ 
SA_GK18_dhandasu-450	jñāyamānatayā tatra vibhāvo bhāvapoṣakṛt /	jñāyamāna tayā tatra vibhāvaḥ bhāva poṣa kṛt 
SA_GK18_dhandasu-451	ālambanoddīpanatvaprabhedena sa ca dvidhā // DhDaś_4.2 //	ālambana uddīpana tva prabhedena sa ca dvidhā 
SA_GK18_dhandasu-452	anubhāvo vikārastu bhāvasaṃsūcanātmakaḥ /	anubhāvaḥ vikāraḥ tu bhāva saṃsūcana ātmakaḥ 
SA_GK18_dhandasu-453	hetukāryātmanoḥ siddhistayoḥ saṃvyavahārataḥ // DhDaś_4.3 //	hetu kārya ātmanoḥ siddhiḥ tayoḥ saṃvyavahārataḥ 
SA_GK18_dhandasu-454	sukhaduḥkhādikairbhāvairbhāvastadbhāvabhāvanam /	sukha duḥkha ādikaiḥ bhāvaiḥ bhāvaḥ tad bhāva bhāvanam 
SA_GK18_dhandasu-455	pṛthag bhāvā bhavantyanye'nubhāvatve'pi sāttvikāḥ /	pṛthak bhāvāḥ sāttvikāḥ 
SA_GK18_dhandasu-456	sattvādeva samutpattestac ca tadbhāvabhāvanam // DhDaś_4.4 //	sattvāt eva samutpatteḥ tat ca tad bhāva bhāvanam 
SA_GK18_dhandasu-457	stambhapralayaromāñcāḥ svedo vaivarṇyavepathū /	stambha pralaya romāñcāḥ svedaḥ vaivarṇya vepathū 
SA_GK18_dhandasu-458	aśruvaisvaryamityaṣṭau stambho'smin niṣkriyāṅgatā /	aśru vaisvaryam iti aṣṭau stambhaḥ asmin niṣkriya aṅgatā 
SA_GK18_dhandasu-459	pralayo naṣṭasañjñatvaṃ śeṣāḥ suvyaktalakṣaṇāḥ // DhDaś_4.5 //	pralayaḥ naṣṭa sañjña tvam śeṣāḥ su vyakta lakṣaṇāḥ 
SA_GK18_dhandasu-460	viśeṣādābhimukhyena caranto vyabhicāriṇaḥ /	viśeṣāt ābhimukhyena carantaḥ vyabhicāriṇaḥ 
SA_GK18_dhandasu-461	sthāyinyunmagnanirmagnāḥ kallolā iva vāridhau // DhDaś_4.6 //	sthāyini unmagna nirmagnāḥ kallolāḥ iva vāridhau 
SA_GK18_dhandasu-462	nirvedaglāniśaṅkāśramadhṛtijaḍatāharṣadainyaugryacintās	nirveda glāni śaṅkā śrama dhṛti jaḍa tā harṣa dainya augrya cintāḥ 
SA_GK18_dhandasu-463	trāserṣyāmarṣagarvāḥ smṛtimaraṇamadāḥ suptanidrāvibodhāḥ /	trāsa īrṣyā āmarṣa garvāḥ smṛti maraṇa madāḥ supta nidrā vibodhāḥ 
SA_GK18_dhandasu-464	vrīḍāpasmāramohāḥ samatiralasatāvegatarkāvahitthā	vrīḍā apasmāra mohāḥ samatiḥ alasa tā vega tarka avahitthā 
SA_GK18_dhandasu-465	vyādhyunmādau vipādotsukacapalayutāstriṃśadete trayaśca // DhDaś_4.7 //	vyādhi unmādau vipāda utsuka capala yutāḥ triṃśat ete trayaḥ ca 
SA_GK18_dhandasu-466	tattvajñānāpadīrṣyādernirvedaḥ svāvamānanam /	tattva jñāna apadīrṣya ādeḥ nirvedaḥ sva avamānanam 
SA_GK18_dhandasu-467	tatra cintāśruniḥśvāsavaiavarṇyocchvāsadīnatāḥ // DhDaś_4.8 //	tatra cintā aśru niḥśvāsa vaiavarṇya ucchvāsa dīna tāḥ 
SA_GK18_dhandasu-468	ratyādyāyāsatṛṭkṣudbhirglānirniṣprāṇateha ca /	rati ādi āyāsa tṛṣ kṣudbhiḥ glāniḥ niṣprāṇa tā iha ca 
SA_GK18_dhandasu-469	vaivarṇyakampānutsāhakṣāmāṅgavacanakriyāḥ // DhDaś_4.9 //	vaivarṇya kampa anutsāha kṣāma aṅga vacana kriyāḥ 
SA_GK18_dhandasu-470	anarthapratibhā śaṅkā parakrauryāt svadurnayāt /	anartha pratibhā śaṅkā para krauryāt sva durnayāt 
SA_GK18_dhandasu-471	kampaśoṣābhivīkṣādiratra varṇasvarānyatā // DhDaś_4.10 //	kampa śoṣa abhivīkṣā ādiḥ atra varṇa svara anya tā 
SA_GK18_dhandasu-472	śramaḥ khedo'dhvaratyādeḥ svedo'smin mardanādayaḥ /	śramaḥ kheda udhvara ti ādeḥ svedaḥ usmin mardana ādayaḥ 
SA_GK18_dhandasu-473	santoṣo jñānaśaktyāderdhṛtiravyagrabhogakṛt // DhDaś_4.11 //	santoṣaḥ jñāna śakti ādeḥ dhṛtiḥ avyagra bhoga kṛt 
SA_GK18_dhandasu-474	apratipattirjaḍatā syādiṣṭāniṣṭadarśanaśrutibhiḥ /	apratipattiḥ jaḍa tā syāt iṣṭa aniṣṭa darśana śrutibhiḥ 
SA_GK18_dhandasu-475	animiṣanayananirīkṣaṇatūṣṇīmbhāvādayastatra // DhDaś_4.12 //	animiṣa nayana nirīkṣaṇa tūṣṇīmbhāva ādayaḥ tatra 
SA_GK18_dhandasu-476	prasattirutsavādibhyo harṣo'śrusvedagadgadāḥ /	prasattiḥ utsava ādibhyaḥ harṣa uśru sveda gadgadāḥ 
SA_GK18_dhandasu-477	daurgatyādyairanaujasyaṃ dainyaṃ kārṣṇyābhṛjādimat // DhDaś_4.13 //	daurgatya ādyaiḥ anaujasyam dainyam kārṣṇya ābhṛja ādimat 
SA_GK18_dhandasu-478	duṣṭe'parādhadaurmukhyakrauryaiścaṇḍatvamugratā /	duṣṭa iparādha daurmukhya krauryaiḥ caṇḍa tvam ugra tā 
SA_GK18_dhandasu-479	tatra svedaśiraḥkampatarjanātāḍanādayaḥ // DhDaś_4.14 //	tatra sveda śiraḥ kampa tarjana ātāḍana ādayaḥ 
SA_GK18_dhandasu-480	dhyānaṃ cintehitānāpteḥ śūnyatāśvāsatāpakṛt /	dhyānam cintā īhita anāpteḥ śūnyatā śvāsa tāpa kṛt 
SA_GK18_dhandasu-481	garjitādermanaḥkṣobhastrāso'trotkampitādayaḥ // DhDaś_4.15 //	garjita ādeḥ manaḥ kṣobhaḥ trāsa utra utkampita ādayaḥ 
SA_GK18_dhandasu-482	parotkarṣākṣamāsūyā garvadaurjanyamanyujā /	para utkarṣa akṣamā asūyā garva daurjanya manyu jā 
SA_GK18_dhandasu-483	doṣoktyavajñe srukuṭimanyukrodheṅgitāni ca // DhDaś_4.16 //	doṣa ukti avajñe sru kuṭi manyu krodha iṅgitāni ca 
SA_GK18_dhandasu-484	adhikṣepāpamānāderamarṣo'bhiniviṣṭatā /	adhikṣepa apamāna ādeḥ amarṣaḥ abhiniviṣṭa tā 
SA_GK18_dhandasu-485	tatra khedaśiraḥkampatarjanātāḍanādayaḥ // DhDaś_4.17 //	tatra kheda śiraḥ kampa tarjana ātāḍana ādayaḥ 
SA_GK18_dhandasu-486	garvo'bhijanalāvaṇyabalaiśvaryādibhirmadaḥ /	garvobhiḥ jana lāvaṇya bala aiśvarya ādibhiḥ madaḥ 
SA_GK18_dhandasu-487	karmāṇyādharpaṇāvajñā savilāsāṅgavīkṣaṇam // DhDaś_4.18 //	karmāṇi ādharpaṇa avajñā savilāsa aṅga vīkṣaṇam 
SA_GK18_dhandasu-488	sadṛśajñānacintādyaiḥ saṃskārāt smṛtiratra ca /	sadṛśa jñāna cintā ādyaiḥ saṃskārāt smṛtiḥ atra ca 
SA_GK18_dhandasu-489	jñātatvenārthabhāsinyāṃ bhrūsamunnayanādayaḥ /	jñāta tvena artha bhāsinyām bhrū samunnayana ādayaḥ 
SA_GK18_dhandasu-490	maraṇaṃ suprasiddhatvādanarthatvāc ca nocyate // DhDaś_4.19 //	maraṇam su prasiddha tvāt anartha tvāt ca nā ucyate 
SA_GK18_dhandasu-491	harṣotkarṣo madaḥ pānāt skhaladaṅgavacogatiḥ /	                  
SA_GK18_dhandasu-492	nidrā hāso'tra ruditaṃ jyeṣṭhamadhyādhamādiṣu /	nidrā hāsaḥ utra ruditam jyeṣṭha madhya adhama ādiṣu 
SA_GK18_dhandasu-493	suptaṃ nidrodbhavaṃ tatra śvāsocchāsakriyā param // DhDaś_4.20 //	suptam nidrā udbhavam tatra śvāsa ucchāsa kriyā param 
SA_GK18_dhandasu-494	manaḥsammīlanaṃ nidrā cintālasyaklamādibhiḥ /	manaḥ sammīlanam nidrā cintā ālasya klama ādibhiḥ 
SA_GK18_dhandasu-495	tatra jṛmbhāṅgabhaṅgākṣimīlanotsvapnatādayaḥ /	tatra jṛmbhā aṅga bhaṅga akṣi mīlana utsvapna tā ādayaḥ 
SA_GK18_dhandasu-496	vivodhaḥ pariṇāmādestatra jṛmbhākṣimardane // DhDaś_4.21 //	vivodhaḥ pariṇāma ādeḥ tatra jṛmbhā akṣi mardane 
SA_GK18_dhandasu-497	durācārādibhirvrīḍā dhārṣṭyābhāvastamunnayet /	durācāra ādibhiḥ vrīḍā dhārṣṭya abhāvaḥ tam unnayet 
SA_GK18_dhandasu-498	sācīkṛtāṅgāvaraṇavaivarṇyādhomukhādibhiḥ // DhDaś_4.22 //	sācīkṛta aṅga āvaraṇa vaivarṇya adhomukha ādibhiḥ 
SA_GK18_dhandasu-499	āveśo grahaduḥkhādyairapasmāro yathāvidhiḥ /	āveśaḥ graha duḥkha ādyaiḥ apasmāraḥ yathā vidhiḥ 
SA_GK18_dhandasu-500	bhūpātakampaprakhedalālāphenodgamādayaḥ // DhDaś_4.23 //	bhūpāta kampa prakheda lālā phena udgama ādayaḥ 
SA_GK18_dhandasu-501	moho vicittatā bhītiduḥkhāveśānucintanaiḥ /	mohaḥ vicitta tā bhīti duḥkha āveśa anucintanaiḥ 
SA_GK18_dhandasu-502	tatrājñānabhramāghātaghūrṇanādarśanādayaḥ // DhDaś_4.24 //	tatra ajñāna bhrama āghāta ghūrṇana adarśana ādayaḥ 
SA_GK18_dhandasu-503	bhrānticchedopadeśābhyāṃ śāstrādestattvadhīrmatiḥ /	bhrānti cheda upadeśābhyām śāstra ādeḥ tattva dhīḥ matiḥ 
SA_GK18_dhandasu-504	ālasyaṃ śramagarbhādejahyajṛmbhāsitādimat // DhDaś_4.25 //	ālasyam 
SA_GK18_dhandasu-505	āvegaḥ samgramo'sminnabhisarajanite śastranāgābhiyogo	āvegaḥ śastra nāga abhiyogaḥ 
SA_GK18_dhandasu-506	vātāt pāṃsūpadigdhastvaritapadagatirvarṣaje piṇḍitāṅgaḥ /	vātāt pāṃsu upadigdhaḥ tvarita pada gatiḥ varṣa je piṇḍita aṅgaḥ 
SA_GK18_dhandasu-507	utpātāt srastatāṅgeṣvahitahitakṛte śokaharṣānubhāvā	utpātāt srasta tā aṅgeṣu ahita hita kṛte śoka harṣa anubhāvā 
SA_GK18_dhandasu-508	vahnerdhūmākulāsyaḥ karijamanubhayastammakampāpasārāḥ // DhDaś_4.26 //	vahneḥ dhūma ākula āsyaḥ kari ja manu bhaya stamma kampa apasārāḥ 
SA_GK18_dhandasu-509	tarko vicāraḥ sandehād bhrūśiroṅgulinartakaḥ /	           
SA_GK18_dhandasu-510	lajjādyairvikriyāguptāvavahitthāṅgavikriyā /	lajjā ādyaiḥ vikriyā guptau avahittha aṅga vikriyā 
SA_GK18_dhandasu-511	vyādhayaḥ sannipātādyāsteṣāmanyatra vistaraḥ // DhDaś_4.27 //	vyādhayaḥ sannipāta ādyāḥ teṣām anyatra vistaraḥ 
SA_GK18_dhandasu-512	aprekṣākāritonmādaḥ sannipātagrahādibhiḥ /	a prekṣā kārita unmādaḥ sannipāta graha ādibhiḥ 
SA_GK18_dhandasu-513	assminnavasthā ruditagītahāsāsitādayaḥ // DhDaś_4.28 //	rudita gīta hāsa asita ādayaḥ 
SA_GK18_dhandasu-514	prārabdhakāryāsiddhyāderviṣādaḥ sattvasaṅkṣayaḥ /	prārabdha kārya asiddhi ādeḥ viṣādaḥ sattva saṅkṣayaḥ 
SA_GK18_dhandasu-515	niḥśvāsocchvāsahṛttāpasahāyānveṣaṇādikṛt // DhDaś_4.29 //	niḥśvāsa ucchvāsa hṛttāpa sahāya anveṣaṇa ādi kṛt 
SA_GK18_dhandasu-516	kālākṣamatvamautmukyaṃ ramyecchāratisamgramaiḥ /	kāla akṣama tvam autmukyam ramya icchā rati samgramaiḥ 
SA_GK18_dhandasu-517	tatrocchvāsatvaniḥśvāsahṛttāpasvedavibhramāḥ // DhDaś_4.30 //	tatra ucchvāsa tva niḥśvāsa hṛd tāpa sveda vibhramāḥ 
SA_GK18_dhandasu-518	mātsaryadveṣarāgādeścāpalaṃ tvanavasthitiḥ /	mātsarya dveṣa rāga ādeḥ cāpalam tu anavasthitiḥ 
SA_GK18_dhandasu-519	tatra bhartsanapāruṣyasvacchandācaraṇādayaḥ // DhDaś_4.31 //	tatra bhartsana pāruṣya svacchanda ācaraṇa ādayaḥ 
SA_GK18_dhandasu-520	viruddhairaviruddhairvā bhāvairvicchidyate /	viruddhaiḥ aviruddhaiḥ vā bhāvaiḥ vicchidyate 
SA_GK18_dhandasu-521	ātmabhāvaṃ nayatyanyān sa sthāyī lavaṇākaraḥ // DhDaś_4.32 //	ātma bhāvam nayati anyān sa sthāyī lavaṇa ākaraḥ 
SA_GK18_dhandasu-522	ratyutsāhajgupsāḥ krodho hāsaḥ smayo bhayaṃ śokaḥ /	rati utsāha jgupsāḥ krodhaḥ hāsaḥ smayaḥ bhayam śokaḥ 
SA_GK18_dhandasu-523	śamamapi kecit prāhuḥ puṣṭirnāṭyeṣu naitasya // DhDaś_4.33 //	śamam api kecid prāhuḥ puṣṭiḥ nāṭyeṣu nā etasya 
SA_GK18_dhandasu-524	nirvedādiratādrūpyādasthāyī svadate katham /	nirveda ādiratāt rūpyāt asthāyī svadate katham 
SA_GK18_dhandasu-525	vairasyāyaiva tatpoṣastenāṣṭau sthāyino matāḥ // DhDaś_4.34 //	vairasyāya eva tad poṣaḥ tena aṣṭau sthāyinaḥ matāḥ 
SA_GK18_dhandasu-526	vācyā prakaraṇādibhyo buddhisthā vā yathā kriyā /	vācyā prakaraṇa ādibhyaḥ buddhi sthā vā yathā kriyā 
SA_GK18_dhandasu-527	vākyārthaḥ kārakairyuktā sthāyī bhāvastathetaraiḥ // DhDaś_4.35 //	vākya arthaḥ kārakaiḥ yuktā sthāyī bhāvaḥ tathā itaraiḥ 
SA_GK18_dhandasu-528	rasaḥ sa eva svādvyatvād rasikasyaiva vartanāt /	rasaḥ saḥ eva svādvya tvāt rasikasya eva vartanāt 
SA_GK18_dhandasu-529	nānukāryasya vṛttatvāt kāvyasyātatparatvataḥ // DhDaś_4.36 //	na anukāryasya vṛtta tvāt kāvyasya a tatpara tvataḥ 
SA_GK18_dhandasu-530	draṣṭuḥ pratītirvrīḍerṣyārāgadveṣaprasaṅgataḥ /	draṣṭuḥ pratītiḥ vrīḍā īrṣyā rāga dveṣa prasaṅgataḥ 
SA_GK18_dhandasu-531	laukikasya svaramaṇīsaṃyuktasyeva darśanāt // DhDaś_4.37 //	laukikasya sva ramaṇī saṃyuktasya iva darśanāt 
SA_GK18_dhandasu-532	dhīrodāttādyavasthānāṃ rāmādiḥ pratipādakaḥ /	dhīra udātta ādi avasthānām rāma ādiḥ pratipādakaḥ 
SA_GK18_dhandasu-533	vibhāvayati ratyādīn svadante rasikasya te // DhDaś_4.38 //	vibhāvayati rati ādīn svadante rasikasya te 
SA_GK18_dhandasu-534	krīḍatāṃ mṛnmayairyadvad bālānāṃ dviradādibhiḥ /	krīḍatām mṛd mayaiḥ yadvat bālānām dvirada ādibhiḥ 
SA_GK18_dhandasu-535	svotsāhaḥ svadate tadvacchrotṛṇāmarjunādibhiḥ // DhDaś_4.39 //	sva utsāhaḥ svadate tadvat śrotṛṇām arjuna ādibhiḥ 
SA_GK18_dhandasu-536	kāvyārthabhāvanāsvādo nartakasya na vāryate /	kāvya artha bhāvanā āsvādaḥ nartakasya na vāryate 
SA_GK18_dhandasu-537	svādaḥ kāvyārthasambhedānātmānandasamudbhavaḥ // DhDaś_4.40 //	             
SA_GK18_dhandasu-538	vikāśavistarakṣobhavikṣepaiḥ sa caturbidhaḥ /	vikāśa vistara kṣobha vikṣepaiḥ sa caturbidhaḥ 
SA_GK18_dhandasu-539	śṛṅgāravīrabībhatsaraudreṣu manasaḥ kramāt // DhDaś_4.41 //	śṛṅgāra vīra bībhatsa raudreṣu manasaḥ kramāt 
SA_GK18_dhandasu-540	hāsyādbhutabhayotkarṣakaruṇānāṃ ta eva hi /	hāsya adbhuta bhaya utkarṣa karuṇānām te eva hi 
SA_GK18_dhandasu-541	atastajjanyatā teṣāmata evāvadhāraṇam // DhDaś_4.42 //	atas tad janya tā teṣām atas eva avadhāraṇam 
SA_GK18_dhandasu-542	śamaprakarṣo nirvācyo muditādestadātmatā /	śama prakarṣaḥ nirvācyaḥ muditā ādeḥ tad ātma tā 
SA_GK18_dhandasu-543	padārthairindunirvedaromāñcādisvarūpakaiḥ /	padārthaiḥ indu nirveda romāñca ādi svarūpakaiḥ 
SA_GK18_dhandasu-544	kāvyād vibhāvasañcāryanubhāvaprakhyatāṃ gataiḥ // DhDaś_4.43 //	kāvyāt vibhāva sañcāri anubhāva prakhya tām gataiḥ 
SA_GK18_dhandasu-545	bhāvitaḥ svadate sthāyī rasaḥ sa parikīrtitaḥ /	bhāvitaḥ svadate sthāyī rasaḥ sa parikīrtitaḥ 
SA_GK18_dhandasu-546	lakṣaṇaikyaṃ vibhāvaikyādabhedād rasabhāvayoḥ // DhDaś_4.44 //	lakṣaṇa aikyam vibhāva aikyāt abhedāt rasa bhāvayoḥ 
SA_GK18_dhandasu-547	ramyadeśakalākālaveṣabhogādisevanaiḥ /	ramya deśa kalā kāla veṣa bhoga ādi sevanaiḥ 
SA_GK18_dhandasu-548	pramodātmā ratiḥ saiva yūnoranyonyaraktayoḥ /	pramoda ātmā ratiḥ sā eva yūnoḥ anyonya raktayoḥ 
SA_GK18_dhandasu-549	prahṛṣyamāṇā śṛṅgāro madhurāṅgaviceṣṭitaiḥ // DhDaś_4.45 //	prahṛṣyamāṇā śṛṅgāraḥ madhura aṅga viceṣṭitaiḥ 
SA_GK18_dhandasu-550	ye sattvajāḥ sthāyin eva cāṣṭau	ye sattva jāḥ sthāyin eva ca aṣṭau 
SA_GK18_dhandasu-551	triṃśat trayo ye vyabhicāriṇaśca /	triṃśat trayaḥ ye vyabhicāriṇaḥ ca 
SA_GK18_dhandasu-552	ekonapañcāśadamī hi bhāvāḥ	ekonapañcāśat amī hi bhāvāḥ 
SA_GK18_dhandasu-553	yuktyā nibaddhāḥ paripoṣayanti /	yuktyā nibaddhāḥ paripoṣayanti 
SA_GK18_dhandasu-554	ālasyamaugryaṃ maraṇaṃ jugupsā	ālasyam augryam maraṇam jugupsā 
SA_GK18_dhandasu-555	tasyāśrayādvaitaviruddhamiṣṭam // DhDaś_4.46 //	tasya āśraya advaita viruddham iṣṭam 
SA_GK18_dhandasu-556	tatrāyogo'nurāge'pi navayorekacittayoḥ /	tatra ayogaḥ unurāge api navayoḥ eka cittayoḥ 
SA_GK18_dhandasu-557	pāratantryeṇa daivād vā viprakarṣādasaṅgamaḥ // DhDaś_4.47 //	pāratantryeṇa daivāt vā viprakarṣāt asaṅgamaḥ 
SA_GK18_dhandasu-558	daśāvasthaḥ sa tatrādāvabhilāṣo'tha cintanam /	daśa avasthaḥ sa tatra ādau abhilāṣaḥ utha cintanam 
SA_GK18_dhandasu-559	smṛtirguṇakathodvegapralāponmādasañjvarāḥ /	smṛtiḥ guṇa kathā udvega pralāpa unmāda sañjvarāḥ 
SA_GK18_dhandasu-560	jaḍatā maraṇaṃ ceti duravasthaṃ yathottaram // DhDaś_4.48 //	jaḍa tā maraṇam ca iti duravastham yathottaram 
SA_GK18_dhandasu-561	abhilāpaḥ spṛhā tatra kānte sarvāṅgasundare /	abhilāpaḥ spṛhā tatra kānte sarva aṅga sundare 
SA_GK18_dhandasu-562	dṛṣṭe śrute vā tatrāpi vismayānandasādhvasāḥ // DhDaś_4.49 //	dṛṣṭe śrute vā tatra api vismaya ānanda sādhvasāḥ 
SA_GK18_dhandasu-563	sākṣāt pratikṛtisvapnacchāyāmāyāsu darśanam /	sākṣāt pratikṛti svapna chāyā māyāsu darśanam 
SA_GK18_dhandasu-564	śrutirvyājāt sakhīgītamāgadhādiguṇastuteḥ // DhDaś_4.50 //	śrutiḥ vyājāt sakhī gīta māgadha ādi guṇa stuteḥ 
SA_GK18_dhandasu-565	sānubhāvavibhāvāstu cintādyāḥ pūrvadarśitāḥ /	sa anubhāva vibhāvāḥ tu cintā ādyāḥ pūrva darśitāḥ 
SA_GK18_dhandasu-566	daśāvasthatvamācāryaiḥ prāyo vṛtyā nidarśitam /	daśa avastha tvam ācāryaiḥ prāyas vṛtyā nidarśitam 
SA_GK18_dhandasu-567	mahākaviprabandheṣu dṛśyate tadanantatā // DhDaś_4.51 //	mahā kavi prabandheṣu dṛśyate tad ananta tā 
SA_GK18_dhandasu-568	dṛṣṭe śrute'bhilāṣāc ca kiṃ nautsukyaṃ prajāyate /	dṛṣṭe śruta ibhilāṣāt ca kim na autsukyam prajāyate 
SA_GK18_dhandasu-569	aprāptau kiṃ na nirvedo glāniḥ kiṃ nāticintanāt // DhDaś_4.52 //	aprāptau kim na nirvedaḥ glāniḥ kim na ati cintanāt 
SA_GK18_dhandasu-570	viprayogastu viśleṣo rūḍhavibhrambhayordvidhā /	viprayogaḥ tu viśleṣaḥ rūḍha vibhrambhayoḥ dvidhā 
SA_GK18_dhandasu-571	mānapravāsabhedena māno'pi praṇayerṣyayoḥ // DhDaś_4.53 //	māna pravāsa bhedena mānaḥ api praṇaya īrṣyayoḥ 
SA_GK18_dhandasu-572	tatra praṇayamānaḥ syāt kopāvasitayordvayoḥ /	tatra praṇayamānaḥ syāt kopa avasitayoḥ dvayoḥ 
SA_GK18_dhandasu-573	strīṇāmīrṣyākṛto mānaḥ kopo'nyāsaṅgini priye /	strīṇām īrṣyā kṛtaḥ mānaḥ kopaḥ nyāsaṅgini priye 
SA_GK18_dhandasu-574	śrute vānumite dṛṣṭe śrutistatra sakhīmukhāt // DhDaś_4.54 //	śrute vā anumite dṛṣṭe śrutiḥ tatra sakhī mukhāt 
SA_GK18_dhandasu-575	utsvapnāyitabhogāṅkagotraskhalanakalpitaḥ /	            
SA_GK18_dhandasu-576	tridhānumāniko dṛṣṭaḥ sākṣādindriyagocaraḥ // DhDaś_4.55 //	tridhā ānumānikaḥ dṛṣṭaḥ sākṣāt indriya gocaraḥ 
SA_GK18_dhandasu-577	yathottaraṃ guruḥ ṣaḍbhirupāyaistamupācaret /	yathottaram guruḥ ṣaḍbhiḥ upāyaiḥ tam upācaret 
SA_GK18_dhandasu-578	sāmnā bhedena dānena natyupekṣārasāntaraiḥ // DhDaś_4.56 //	sāmnā bhedena dānena nati upekṣā rasa antaraiḥ 
SA_GK18_dhandasu-579	tatra oriyavacaḥ sāma bhedastatsakhyupārjanam /	tatra oriyavacaḥ sāma bhedaḥ tad sakhī upārjanam 
SA_GK18_dhandasu-580	dānaṃ vyājena bhūṣādeḥ pādayoḥ patanaṃ natiḥ // DhDaś_4.57 //	dānam vyājena bhūṣā ādeḥ pādayoḥ patanam natiḥ 
SA_GK18_dhandasu-581	sāmādau tu parikṣīṇe syādupekṣāvadhīraṇam /	sāma ādau tu parikṣīṇe syāt upekṣā avadhīraṇam 
SA_GK18_dhandasu-582	rabhasatrāsaharṣādeḥ kopabhraṃśo rasāntaram /	rabhasa trāsa harṣa ādeḥ kopa bhraṃśaḥ rasa antaram 
SA_GK18_dhandasu-583	kopaceṣṭāśca nārīṇāṃ prāgeva pratipāditāḥ // DhDaś_4.58 //	kopa ceṣṭāḥ ca nārīṇām prāk eva pratipāditāḥ 
SA_GK18_dhandasu-584	kāryataḥ sambhramācchāpāt pravāso bhinnadeśatā /	kāryataḥ sambhramāt śāpāt pravāsaḥ bhinna deśa tā 
SA_GK18_dhandasu-585	dvayostatrāśruniḥśvāsakārśyalambālakāditā // DhDaś_4.59 //	dvayoḥ tatra aśru niḥśvāsa kārśya lamba alaka ādi tā 
SA_GK18_dhandasu-586	dvitīyaḥ sahasotpanno divyamānupaviplavāt /	dvitīyaḥ sahasā utpannaḥ divya mānupa viplavāt 
SA_GK18_dhandasu-587	svarūpānyatvakaraṇācchāpajaḥ sannidhāvapi // DhDaś_4.60 //	svarūpa anyatva karaṇāt śāpa jaḥ sannidhau api 
SA_GK18_dhandasu-588	mṛte tvekatra yatrānyaḥ pralapecchoka eva saḥ /	mṛte tu ekatra yatra anyaḥ pralapet śokaḥ eva saḥ 
SA_GK18_dhandasu-589	vyāśrayatvān na śṛṅgāraḥ pratyāpanne tu netaraḥ // DhDaś_4.61 //	vyāśraya tvāt na śṛṅgāraḥ pratyāpanne tu na itaraḥ 
SA_GK18_dhandasu-590	praṇayāyogayorutkā pravāse proṣitapriyā /	praṇaya ayogayoḥ utkā pravāse proṣita priyā 
SA_GK18_dhandasu-591	kalahāntariterṣyāyāṃ vipralavdhā ca khaṇḍitā // DhDaś_4.62 //	kalaha antaritā īrṣyāyām vipralabdhā ca khaṇḍitā 
SA_GK18_dhandasu-592	anukūlau niṣevete yatrānyonyaṃ vilāsinau /	anukūlau niṣevete yatra anyonyam vilāsinau 
SA_GK18_dhandasu-593	darśanasparśanādīni sa sambhogo mudānvitaḥ // DhDaś_4.63 //	darśana sparśana ādīni sa sambhogaḥ mudā anvitaḥ 
SA_GK18_dhandasu-594	ceṣṭāstatra pravartante līlādyā daśa yoṣitām /	ceṣṭāḥ tatra pravartante līlā ādyāḥ daśa yoṣitām 
SA_GK18_dhandasu-595	dākṣiṇyamārdavapremṇāmanurūpāḥ priyaṃ prati // DhDaś_4.64 //	dākṣiṇya mārdava premṇām anurūpāḥ priyam prati 
SA_GK18_dhandasu-596	ramayec cāṭukṛt kāntaḥ kalākrīḍādibhiśca tām /	ramayet cāṭu kṛt kāntaḥ kalā krīḍā ādibhiḥ ca tām 
SA_GK18_dhandasu-597	na grāmyamācaret kiñcin narmabhraṃśakaraṃ na ca // DhDaś_4.65 //	na grāmyam ācaret kiñcid narma bhraṃśa karam na ca 
SA_GK18_dhandasu-598	vīraḥ pratāpavinayādhyavasāyasattva-	vīraḥ pratāpa vinaya adhyavasāya sattva 
SA_GK18_dhandasu-599	mohāviṣādanayavismayavikramādyaiḥ /	moha a viṣāda naya vismaya vikrama ādyaiḥ 
SA_GK18_dhandasu-600	utsāhabhūḥ sa ca dayāraṇadānayogāt	utsāha bhūḥ sa ca dayā raṇa dāna yogāt 
SA_GK18_dhandasu-601	tredhā kilātra matigarvadhṛtipraharṣāḥ // DhDaś_4.66 //	tredhā kila atra mati garva dhṛti praharṣāḥ 
SA_GK18_dhandasu-602	bībhatsaḥ kṛmipūtigandhivamathuprāyairjugupsaikabhūr	bībhatsaḥ kṛmi pūti gandhi vamathu prāyaiḥ jugupsā eka bhūḥ 
SA_GK18_dhandasu-603	udvego rudhirāntrakīkasavasāmāṃsādibhiḥ kṣobhaṇaḥ /	udvegaḥ rudhira antra kīkasa vasā māṃsa ādibhiḥ kṣobhaṇaḥ 
SA_GK18_dhandasu-604	vairāgyāj jaghanastanādiṣu ghṛṇāśuddho'nubhāvairvṛto	vairāgyāt jaghana stana ādiṣu ghṛṇā śuddhaḥ anubhāvaiḥ vṛtaḥ 
SA_GK18_dhandasu-605	nāsāvaktravikūṇanādibhirihāvegārtiśaṅkādayaḥ // DhDaś_4.67 //	nāsā vaktra vikūṇana ādibhiḥ iha āvega ārti śaṅkā ādayaḥ 
SA_GK18_dhandasu-606	krodho matsaravairivaikṛtamayaiḥ poṣo'sya raudro'nujaḥ	krodhaḥ matsara vairi vaikṛta mayaiḥ poṣaḥ sya raudraḥ nujaḥ 
SA_GK18_dhandasu-607	kṣobhaḥ khādharadaṃśakampabhrukuṭisvedāsyarāgairyutaḥ /	kṣobhaḥ kha adhara daṃśa kampa bhrukuṭi sveda āsya rāgaiḥ yutaḥ 
SA_GK18_dhandasu-608	śatrollāsavikatthamāṃsadharaṇīghātapratijñāgrahair	śatra ullāsa vikattha māṃsa dharaṇī ghāta pratijñā grahaiḥ 
SA_GK18_dhandasu-609	atrāmarṣamadau smṛtiścapalatāsūyāgryavegādayaḥ // DhDaś_4.68 //	atra amarṣa madau smṛtiḥ capalatā asūyā agrya vega ādayaḥ 
SA_GK18_dhandasu-610	vikṛtākṛtivāgveṣairātmano'tha parasya vā /	vikṛta ākṛti vāc veṣaiḥ ātmanā utha parasya vā 
SA_GK18_dhandasu-611	hāsaḥ syāt paripoṣo'sya hāsyastriprakṛtiḥ smṛtaḥ // DhDaś_4.69 //	hāsaḥ syāt paripoṣaḥ sya hāsyaḥ tri prakṛtiḥ smṛtaḥ 
SA_GK18_dhandasu-612	smitamiha vikāsinayanaṃ kiñcillakṣyadvijaṃ tu hasitaṃ syāt /	smitam iha vikāsi nayanam kiñcid lakṣya dvijam tu hasitam syāt 
SA_GK18_dhandasu-613	madhurasvaraṃ vihasitaṃ saśiraḥkampamidamupahasitam // DhDaś_4.70 //	madhura svaram vihasitam sa śiraḥ kampam idam upahasitam 
SA_GK18_dhandasu-614	apahasitaṃ sāsrākṣaṃ vikṣiptāṅgaṃ bhavatyatihasitam /	apahasitam sa asra akṣam vikṣipta aṅgam bhavati ati hasitam 
SA_GK18_dhandasu-615	dve dve hasite caiṣāṃ jyeṣṭhe madhye'dhame kramaśaḥ // DhDaś_4.71 //	dve dve hasite ca eṣām jyeṣṭhe madhyedhame kramaśas 
SA_GK18_dhandasu-616	nidrālasyaśramaglānimūrchāśca sahacāriṇaḥ /	nidrā ālasya śrama glāni mūrchāḥ ca sahacāriṇaḥ 
SA_GK18_dhandasu-617	atilokaiḥ padārthaiḥ syād vismayātmā raso'dbhutaḥ // DhDaś_4.72 //	ati lokaiḥ padārthaiḥ syāt vismaya ātmā rasa udbhutaḥ 
SA_GK18_dhandasu-618	karmāsya sādhuvādāśruvepathusvedagadgadāḥ /	karma asya sādhuvāda aśru vepathu sveda gadgadāḥ 
SA_GK18_dhandasu-619	harṣāvegadhṛtiprāyā bhavanti vyabhicāriṇaḥ // DhDaś_4.73 //	harṣa āvega dhṛti prāyāḥ bhavanti vyabhicāriṇaḥ 
SA_GK18_dhandasu-620	vikṛtasvarasattvāderbhayabhāvo bhayānakaḥ /	vikṛta svara sattva ādeḥ bhaya bhāvaḥ bhayānakaḥ 
SA_GK18_dhandasu-621	sarvāṅgavepathusvedaśoṣavaicittyalakṣaṇaḥ /	sarva aṅga vepathu sveda śoṣa vaicittya lakṣaṇaḥ 
SA_GK18_dhandasu-622	dainyasambhramasammohatrāsādistatsahodaraḥ // DhDaś_4.74 //	dainya sambhrama sammoha trāsa ādiḥ tad sahodaraḥ 
SA_GK18_dhandasu-623	iṣṭanāśādaniṣṭāptau śokātmā karuṇo'nu tam /	iṣṭa nāśāt aniṣṭa āptau śoka ātmā karuṇaḥ nu tam 
SA_GK18_dhandasu-624	niḥśvāsocchvāsaruditastambhapralapitādayaḥ // DhDaś_4.75 //	niḥśvāsa ucchvāsa rudita stambha pralapita ādayaḥ 
SA_GK18_dhandasu-625	svāpāpasmāradainyādhimaraṇālasyasambhramāḥ /	svāpa apasmāra dainya ādhi maraṇa ālasya sambhramāḥ 
SA_GK18_dhandasu-626	viṣādajaḍayonmādacintādyā vyabhicāriṇaḥ // DhDaś_4.76 //	viṣāda jaḍayā unmāda cintā ādyāḥ vyabhicāriṇaḥ 
SA_GK18_dhandasu-627	prītibhaktyādayo bhāvā mṛgayākṣādayo rasāḥ /	prīti bhakti ādayaḥ bhāvāḥ mṛgayā akṣa ādayaḥ rasāḥ 
SA_GK18_dhandasu-628	harṣotsāhādiṣu spaṣṭamantarbhāvān na kīrtitāḥ // DhDaś_4.77 //	harṣa utsāha ādiṣu spaṣṭam antarbhāvāt na kīrtitāḥ 
SA_GK18_dhandasu-629	ṣaṭtriṃśadbhūṣaṇādīni sāmādīnyekaviṃśatiḥ /	ṣaṭtriṃśat bhūṣaṇa ādīni sāma ādīni ekaviṃśatiḥ 
SA_GK18_dhandasu-630	lakṣyasandhyantarāṅgāni sālaṅkāreṣu teṣu ca // DhDaś_4.78 //	lakṣya sandhi antara aṅgāni sa alaṅkāreṣu teṣu ca 
SA_GK18_dhandasu-631	ramyaṃ jugupsitamudāramathāpi nīcam	ramyam jugupsitam udāram atha api nīcam 
SA_GK18_dhandasu-632	ugraṃ prasādi gahanaṃ vikṛtaṃ ca vastu /	ugram prasādi gahanam vikṛtam ca vastu 
SA_GK18_dhandasu-633	yadvāpyavastu kavibhāvakabhāvyamānaṃ	yat vā api avastu kavi bhāvaka bhāvyamānam 
SA_GK18_dhandasu-634	tan nāsti yan na rasabhāvamupaiti loke // DhDaś_4.79 //	tat na asti yat na rasa bhāvam upaiti loke 
SA_GK18_dhandasu-635	viṣṇoḥ sutenāpi dhanañjayena	viṣṇoḥ sutena api dhanañjayena 
SA_GK18_dhandasu-636	vidvanmanorāganibandhahetuḥ /	           
SA_GK18_dhandasu-637	āviṣkṛṭaṃ muñjamahīśagoṣṭhī-	āviṣkṛṭam muñja mahī īśa goṣṭhī 
SA_GK18_dhandasu-638	vaidagdhyabhājā daśarūpametat // DhDaś_4.80 //	vaidagdhya bhājā daśa rūpam etat 
