segmentnr	original	analyzed
SA_GR13_saulahpu-0	śivaḥ śaktyā yukto yadi bhavati śaktaḥ prabhavituṃ	śivaḥ śaktyā yuktaḥ yadi bhavati śaktaḥ prabhavitum 
SA_GR13_saulahpu-1	na ced evaṃ devo na khalu kuśalaḥ spanditum api /	na ced evam devaḥ na khalu kuśalaḥ spanditum api 
SA_GR13_saulahpu-2	atas tvām ārādhyāṃ hariharavirañcyādibhir api	atas tvām ārādhyām hari hara virañci ādibhiḥ api 
SA_GR13_saulahpu-3	praṇantuṃ stotuṃ vā katham akṛtapuṇyaḥ prabhavati // Saul_1 //	praṇantum stotum vā katham a kṛta puṇyaḥ prabhavati 
SA_GR13_saulahpu-4	tanīyāṃsaṃ pāṃsuṃ tava caraṇapaṅkeruhabhavaṃ	tanīyāṃsam pāṃsum tava caraṇa paṅkeruha bhavam 
SA_GR13_saulahpu-5	virañciḥ saṃcinvan viracayati lokān avikalam /	virañciḥ saṃcinvan viracayati lokān avikalam 
SA_GR13_saulahpu-6	vahaty enaṃ śauriḥ katham api sahasreṇa śirasāṃ	vahati enam śauriḥ katham api sahasreṇa śirasām 
SA_GR13_saulahpu-7	haraḥ saṃkṣubhyainaṃ bhajati bhasitoddhūlanavidhim // Saul_2 //	haraḥ saṃkṣubhya enam bhajati bhasita uddhūlana vidhim 
SA_GR13_saulahpu-8	avidyānām antastimiramihiradvīpanagarī	avidyānām antar timira mihira dvīpa nagarī 
SA_GR13_saulahpu-9	jaḍānāṃ caitanyastabakamakarandasrutijharī /	            
SA_GR13_saulahpu-10	daridrāṇāṃ cintāmaṇiguṇanikā janmajaladhau	daridrāṇām cintāmaṇi guṇanikā janma jaladhau 
SA_GR13_saulahpu-11	nimagnānāṃ daṃṣṭrā muraripuvarāhasya bhavatī // Saul_3 //	nimagnānām daṃṣṭrā muraripu varāhasya bhavatī 
SA_GR13_saulahpu-12	tvadanyaḥ pāṇibhyām abhayavarado daivatagaṇas	tvad anyaḥ pāṇibhyām abhaya vara daḥ daivata gaṇaḥ 
SA_GR13_saulahpu-13	tvam ekā naivāsi prakaṭitavarābhītyabhinayā /	tvam ekā na eva asi prakaṭita vara abhīti abhinayā 
SA_GR13_saulahpu-14	bhayāt trātuṃ dātuṃ phalam api ca vāñchāsamadhikaṃ	bhayāt trātum dātum phalam api ca vāñchā samadhikam 
SA_GR13_saulahpu-15	śaraṇye lokānāṃ tava hi caraṇāv eva nipuṇau // Saul_4 //	śaraṇye lokānām tava hi caraṇau eva nipuṇau 
SA_GR13_saulahpu-16	haris tvām ārādhya praṇatajanasaubhāgyajananīṃ	hariḥ tvām ārādhya praṇata jana saubhāgya jananīm 
SA_GR13_saulahpu-17	purā nārī bhūtvā puraripum api kṣobham anayat /	purā nārī bhūtvā pura ripum api kṣobham anayat 
SA_GR13_saulahpu-18	smaro 'pi tvāṃ natvā ratinayanalehyena vapuṣā	smaraḥ pi tvām natvā rati nayana lehyena vapuṣā 
SA_GR13_saulahpu-19	munīnām apy antaḥ prabhavati hi mohāya mahatām // Saul_5 //	munīnām api antaḥ prabhavati hi mohāya mahatām 
SA_GR13_saulahpu-20	dhanuḥ pauṣpaṃ maurvī madhukaramayī pañca viśikhā	dhanuḥ pauṣpam maurvī madhukara mayī pañca viśikhā 
SA_GR13_saulahpu-21	vasantaḥ sāmanto malayamarudāyodhanarathaḥ /	vasantaḥ sāmantaḥ malaya marut āyodhana rathaḥ 
SA_GR13_saulahpu-22	tathāpy ekaḥ sarvaṃ himagirisute kām api kṛpāṃ	tathā api ekaḥ sarvam himagiri sute kām api kṛpām 
SA_GR13_saulahpu-23	apāṅgāt te labdhvā jagad idam anaṅgo vijayate // Saul_6 //	apāṅgāt te labdhvā jagat idam anaṅgaḥ vijayate 
SA_GR13_saulahpu-24	kvaṇatkāñcīdāmā karikalabhakumbhastanabharā	kvaṇat kāñcī dāmā kari kalabha kumbha stana bharā 
SA_GR13_saulahpu-25	parikṣīṇā madhye pariṇataśaraccandravadanā /	parikṣīṇā madhye pariṇata śarad candra vadanā 
SA_GR13_saulahpu-26	dhanur bāṇān pāśaṃ sṛṇim api dadhānā karatalaiḥ	dhanuḥ bāṇān pāśam sṛṇim api dadhānā kara talaiḥ 
SA_GR13_saulahpu-27	purastād āstāṃ naḥ puramathitur āhopuruṣikā // Saul_7 //	purastāt āstām naḥ pura mathituḥ āhopuruṣikā 
SA_GR13_saulahpu-28	sudhāsindhor madhye suraviṭapivāṭīparivṛte	sudhā sindhoḥ madhye sura viṭapi vāṭī parivṛte 
SA_GR13_saulahpu-29	maṇidvīpe nīpopavanavati cintāmaṇigṛhe /	maṇidvīpe nīpa upavanavati cintāmaṇi gṛhe 
SA_GR13_saulahpu-30	śivākāre mañce paramaśivaparyaṅkanilayāṃ	śiva ākāre mañce paramaśiva paryaṅka nilayām 
SA_GR13_saulahpu-31	bhajanti tvāṃ dhanyāḥ kati cana cidānandalaharīm // Saul_8 //	bhajanti tvām dhanyāḥ kati cana cit ānanda laharīm 
SA_GR13_saulahpu-32	mahīṃ mūlādhāre kam api maṇipūre hutavahaṃ	mahīm mūlādhāre kam api maṇipūre hutavaham 
SA_GR13_saulahpu-33	sthitaṃ svādhiṣṭhāne hṛdi marutam ākāśam upari /	sthitam svādhiṣṭhāne hṛdi marutam ākāśam upari 
SA_GR13_saulahpu-34	mano 'pi bhrūmadhye sakalam api bhittvā kulapathaṃ	manaḥ pi bhrū madhye sakalam api bhittvā kula patham 
SA_GR13_saulahpu-35	sahasrāre padme saha rahasi patyā viharasi // Saul_9 //	sahasrāre padme saha rahasi patyā viharasi 
SA_GR13_saulahpu-36	sudhādhārāsāraiś caraṇayugalāntarvigalitaiḥ	sudhā dhārā sāraiḥ caraṇa yugala antar vigalitaiḥ 
SA_GR13_saulahpu-37	prapañcaṃ siñcantī punar api rasaāmnāyamahasā /	prapañcam siñcantī punar api rasa āmnāya mahasā 
SA_GR13_saulahpu-38	avāpya svāṃ bhūmiṃ bhujaganibham adhyuṣṭavalayaṃ	avāpya svām bhūmim bhujaga nibham adhyuṣṭa valayam 
SA_GR13_saulahpu-39	svam ātmānaṃ kṛtvā svapiṣi kulakuṇḍe kuhariṇi // Saul_10 //	svam ātmānam kṛtvā svapiṣi kulakuṇḍe kuhariṇi 
SA_GR13_saulahpu-40	caturbhiḥ śrīkaṇṭhaiḥ śivayuvatibhiḥ pañcabhir api	caturbhiḥ śrīkaṇṭhaiḥ śiva yuvatibhiḥ pañcabhiḥ api 
SA_GR13_saulahpu-41	prabhinnābhiḥ śaṃbhor navabhir iti mūlaprakṛtibhiḥ /	prabhinnābhiḥ śaṃbhoḥ navabhiḥ iti mūlaprakṛtibhiḥ 
SA_GR13_saulahpu-42	trayaś catvāriṃśad vasudalakalāśratrivalaya-	trayaḥ catvāriṃśat 
SA_GR13_saulahpu-43	trirekhābhiḥ sārdhaṃ tava caraṇakoṇāḥ pariṇatāḥ // Saul_11 //	tri rekhābhiḥ sārdham tava caraṇa koṇāḥ pariṇatāḥ 
SA_GR13_saulahpu-44	tvadīyaṃ saundaryaṃ tuhinagirikanye tulayituṃ	tvadīyam saundaryam tuhinagiri kanye tulayitum 
SA_GR13_saulahpu-45	kavīndrāḥ kalpante katham api viriñciprabhṛtayaḥ /	kavi indrāḥ kalpante katham api viriñci prabhṛtayaḥ 
SA_GR13_saulahpu-46	yad ālokyautsukyād amaralalanā yānti manasā	yat ālokya autsukyāt amara lalanāḥ yānti manasā 
SA_GR13_saulahpu-47	tapobhir duṣprāpām api giriśasāyujyapadavīm // Saul_12 //	tapobhiḥ duṣprāpām api giriśa sāyujya padavīm 
SA_GR13_saulahpu-48	naraṃ varṣīyāṃsaṃ nayanavirasaṃ narmasu jaḍaṃ	naram varṣīyāṃsam nayana virasam narmasu jaḍam 
SA_GR13_saulahpu-49	tavāpāṅgāloke patitam anudhāvanti śataśaḥ /	tava apāṅga āloke patitam anudhāvanti śataśas 
SA_GR13_saulahpu-50	galadveṇībandhāḥ kucakalaśavisrastasicayā	galat veṇī bandhāḥ kuca kalaśa visrasta sicayā 
SA_GR13_saulahpu-51	haṭhāt truṭyatkāñcyo vigalitadukūlā yuvatayaḥ // Saul_13 //	haṭhāt truṭyat kāñcyaḥ vigalita dukūlāḥ yuvatayaḥ 
SA_GR13_saulahpu-52	kṣitau ṣatpañcāśad dvisamadhikapañcāśad udake	kṣitau ṣatpañcāśat dvi samadhika pañcāśat udake 
SA_GR13_saulahpu-53	hutāśe dvāṣaṣṭiś caturadhikapañcāśad anile /	hutāśe dvāṣaṣṭiḥ catur adhika pañcāśat anile 
SA_GR13_saulahpu-54	divi dviḥṣattriṃśan manasi ca catuḥṣaṣṭir iti ye	divi dviḥṣattriṃśat manasi ca catuḥṣaṣṭiḥ iti ye 
SA_GR13_saulahpu-55	mayūkhās teṣām apy upari tava pādāmbujayugam // Saul_14 //	mayūkhāḥ teṣām api upari tava pāda ambuja yugam 
SA_GR13_saulahpu-56	śarajjyotsnāśubhrāṃ śaśiyutajaṭājūṭamukuṭāṃ	śarad jyotsnā śubhrām śaśi yuta jaṭā jūṭa mukuṭām 
SA_GR13_saulahpu-57	varatrāsatrāṇasphaṭikaguṭikāpustakakarām /	vara trāsa trāṇa sphaṭika guṭikā pustaka karām 
SA_GR13_saulahpu-58	sakṛn na tvā natvā katham iva stāṃ saṃnidadhate	sakṛt na tvā natvā katham iva stām saṃnidadhate 
SA_GR13_saulahpu-59	madhukṣīradrākṣāmadhurimadhurīṇā bhaṇitayaḥ // Saul_15 //	madhu kṣīra drākṣā madhuri madhurīṇāḥ bhaṇitayaḥ 
SA_GR13_saulahpu-60	kavīndrāṇāṃ cetaḥkamalavanabālātaparuciṃ	kavi indrāṇām cetaḥ kamala vana bāla ātapa rucim 
SA_GR13_saulahpu-61	bhajante ye santaḥ kati cid aruṇām eva bhavatīm /	bhajante ye santaḥ kati cit aruṇām eva bhavatīm 
SA_GR13_saulahpu-62	virañcipreyasyās taruṇataraśṛṅgāralaharī-	virañci preyasyāḥ taruṇatara śṛṅgāra laharī 
SA_GR13_saulahpu-63	gabhīrābhir vāgbhir vidadhati satāṃ rañjanam amī // Saul_16 //	gabhīrābhiḥ vāgbhiḥ vidadhati satām rañjanam amī 
SA_GR13_saulahpu-64	savitrībhir vācāṃ śaśimaṇiśilābhaṅgarucibhir	savitrībhiḥ vācām śaśimaṇi śilā bhaṅga rucibhiḥ 
SA_GR13_saulahpu-65	vaśinyādyābhis tvāṃ saha janani saṃcintayati yaḥ /	vaśinī ādyābhiḥ tvām saha janani saṃcintayati yaḥ 
SA_GR13_saulahpu-66	sa kartā kāvyānāṃ bhavati mahatāṃ bhaṅgisubhagair	sa kartā kāvyānām bhavati mahatām bhaṅgi subhagaiḥ 
SA_GR13_saulahpu-67	vacobhir vāgdevīvadanakamalāmodamadhuraiḥ // Saul_17 //	vacobhiḥ vāgdevī vadana kamala āmoda madhuraiḥ 
SA_GR13_saulahpu-68	tanucchāyābhis te taruṇataraṇiśrīsaraṇibhir	tanu chāyābhiḥ te taruṇa taraṇi śrī saraṇibhiḥ 
SA_GR13_saulahpu-69	divaṃ sarvām urvīm aruṇimanigmagnāṃ smarati yaḥ /	divam sarvām urvīm aruṇima nigmagnām smarati yaḥ 
SA_GR13_saulahpu-70	bhavanty asya trasyadvanahariṇaśālīnanayanāḥ	bhavanti asya trasyat vana hariṇa śālīna nayanāḥ 
SA_GR13_saulahpu-71	sahorvaśyā vaśyāḥ katikati na gīrvāṇagaṇikā // Saul_18 //	saha urvaśyā vaśyāḥ kati kati na gīrvāṇa gaṇikā 
SA_GR13_saulahpu-72	mukhaṃ binduṃ kṛtvā kucayugam adhas tasya tadadho	mukham bindum kṛtvā kuca yugam adhas tasya tad adhas 
SA_GR13_saulahpu-73	harārdhaṃ dhyāyed yo haramahiṣi te manmathakalām /	hara ardham dhyāyet yaḥ hara mahiṣi te manmatha kalām 
SA_GR13_saulahpu-74	sa sadyaḥ saṃkṣobhaṃ nayati vanitā ity atilaghu	sa sadyas saṃkṣobham nayati vanitāḥ iti ati laghu 
SA_GR13_saulahpu-75	trilokīm apy āśu bhramayati ravīndustanayugām // Saul_19 //	trilokīm api āśu bhramayati ravi indu stana yugām 
SA_GR13_saulahpu-76	kirantīm aṅgebhyaḥ kiraṇanikurambāmṛtarasaṃ	kirantīm aṅgebhyaḥ kiraṇa nikuramba amṛta rasam 
SA_GR13_saulahpu-77	hṛdi tvām ādhatte himakaraśilāmūrtim iva yaḥ /	hṛdi tvām ādhatte himakara śilā mūrtim iva yaḥ 
SA_GR13_saulahpu-78	sa sarpāṇāṃ darpaṃ śamayati śakuntādhipa iva	sa sarpāṇām darpam śamayati śakunta adhipaḥ iva 
SA_GR13_saulahpu-79	jvarapluṣṭān dṛṣṭyā sukhayati sudhādhārasirayā // Saul_20 //	jvara pluṣṭān dṛṣṭyā sukhayati sudhā dhāra sirayā 
SA_GR13_saulahpu-80	taḍillekhātanvīṃ tapanaśaśivaiśvānaramayīṃ	taḍit lekhā tanvīm tapana śaśi vaiśvānara mayīm 
SA_GR13_saulahpu-81	niṣaṇṇāṃ ṣaṇṇām apy upari kamalānāṃ tava kalām /	niṣaṇṇām ṣaṇṇām api upari kamalānām tava kalām 
SA_GR13_saulahpu-82	mahāpadmāṭavyāṃ mṛditamalamāyena manasā	mahāpadma aṭavyām mṛdita mala māyena manasā 
SA_GR13_saulahpu-83	mahāntaḥ paśyanto dadhati paramāhlādalaharīm // Saul_21 //	mahāntaḥ paśyantaḥ dadhati parama āhlāda laharīm 
SA_GR13_saulahpu-84	bhavāni tvaṃ dāse mayi vitara dṛṣṭiṃ sakaruṇāṃ	bhavāni tvam dāse mayi vitara dṛṣṭim sa karuṇām 
SA_GR13_saulahpu-85	iti stotuṃ vāñchan kathayati bhavāni tvam iti yaḥ /	iti stotum vāñchan kathayati bhavāni tvam iti yaḥ 
SA_GR13_saulahpu-86	tadaiva tvaṃ tasmai diśasi nijasāyujyapadavīṃ	tadā eva tvam tasmai diśasi nija sāyujya padavīm 
SA_GR13_saulahpu-87	mukundabrahmendrasphuṭamukuṭanīrājitapadām // Saul_22 //	mukunda brahma indra sphuṭa mukuṭa nīrājita padām 
SA_GR13_saulahpu-88	tvayā hṛtvā vāmaṃ vapur aparitṛptena manasā	tvayā hṛtvā vāmam vapuḥ a paritṛptena manasā 
SA_GR13_saulahpu-89	śarīrārdhaṃ śaṃbhor aparam api śaṅke hṛtam abhūt /	śarīra ardham śaṃbhoḥ aparam api śaṅke hṛtam abhūt 
SA_GR13_saulahpu-90	tathā hi tvadrūpaṃ sakalam aruṇābhaṃ trinayanaṃ	tathā hi tvad rūpam sakalam aruṇa ābham trinayanam 
SA_GR13_saulahpu-91	kucābhyām ānamraṃ kuṭilaśaśicūḍālamukuṭam // Saul_23 //	kucābhyām ānamram kuṭila śaśi cūḍāla mukuṭam 
SA_GR13_saulahpu-92	jagat sūte dhātā harir avati rudraḥ kṣapayate	jagat sūte dhātā hariḥ avati rudraḥ kṣapayate 
SA_GR13_saulahpu-93	tiras kurvann etat svam api vapur īśas tirayati /	tiras kurvan etat svam api vapuḥ īśaḥ tirayati 
SA_GR13_saulahpu-94	sadāpūrvaḥ sarvaṃ tad idam anugṛhṇāti ca śivas	sadāpūrvaḥ sarvam tat idam anugṛhṇāti ca śivaḥ 
SA_GR13_saulahpu-95	tavājñām ālambya kṣanacalitayor bhrūlatikayoḥ // Saul_24 //	tava ājñām ālambya kṣana calitayoḥ bhrū latikayoḥ 
SA_GR13_saulahpu-96	trayāṇāṃ devānāṃ triguṇajanitānāṃ tava śive	trayāṇām devānām triguṇa janitānām tava śive 
SA_GR13_saulahpu-97	bhavet pūjā pūjā tava caraṇayor yā viracitā /	bhavet pūjā pūjā tava caraṇayoḥ yā viracitā 
SA_GR13_saulahpu-98	tathā hi tvatpādodvahanamaṇipīṭhasya nikaṭe	tathā hi tvad pāda udvahana maṇi pīṭhasya nikaṭe 
SA_GR13_saulahpu-99	sthitā hy ete śaśvan mukulitakarottaṃsamukuṭāḥ // Saul_25 //	sthitāḥ hi ete śaśvat mukulita kara uttaṃsa mukuṭāḥ 
SA_GR13_saulahpu-100	virañciḥ pañcatvaṃ vrajati harir āpnoti viratiṃ	virañciḥ pañcatvam vrajati hariḥ āpnoti viratim 
SA_GR13_saulahpu-101	vināśaṃ kīnāśo bhajati dhanado yāti nidhanam /	vināśam kīnāśaḥ bhajati dhanadaḥ yāti nidhanam 
SA_GR13_saulahpu-102	vitandrī māhendrī vitatir api saṃmīlitadṛśā	vitandrī māhendrī vitatiḥ api saṃmīlita dṛśā 
SA_GR13_saulahpu-103	mahāsaṃhāre +asmin viharati sati tvatpatir asau // Saul_26 //	mahā saṃhāre asmin viharati sati tvad patiḥ asau 
SA_GR13_saulahpu-104	japo jalpaḥ śilpaṃ sakalam api mudrāviracanā	japaḥ jalpaḥ śilpam sakalam api mudrā viracanā 
SA_GR13_saulahpu-105	gatiḥ prādakṣiṇyakramaṇam aśanādy āhutividhiḥ /	gatiḥ prādakṣiṇya kramaṇam aśana ādi āhuti vidhiḥ 
SA_GR13_saulahpu-106	praṇāmaḥ saṃveśaḥ sukham akhilam ātmārpaṇadṛśā	praṇāmaḥ saṃveśaḥ sukham akhilam ātma arpaṇa dṛśā 
SA_GR13_saulahpu-107	saparyāparyāyas tava bhavatu yan me vilasitam // Saul_27 //	saparyā paryāyaḥ tava bhavatu yat me vilasitam 
SA_GR13_saulahpu-108	dadāne dīnebhyaḥ śriyam aniśam āśānusadṛśīṃ	dadāne dīnebhyaḥ śriyam aniśam āśā anu sadṛśīm 
SA_GR13_saulahpu-109	amandaṃ saundaryaprakaramakarandaṃ vikirati /	amandam saundarya prakara makarandam vikirati 
SA_GR13_saulahpu-110	tavāsmin mandārastabakasubhage yātu caraṇe	tava asmin mandāra stabaka subhage yātu caraṇe 
SA_GR13_saulahpu-111	nimajjan majjīvaḥ karaṇacaraṇaiḥ ṣa.ccaraṇatām // Saul_28 //	nimajjan majjīvaḥ karaṇa caraṇaiḥ ṣat caraṇa tām 
SA_GR13_saulahpu-112	sudhām apy āsvādya pratibhayajarāmṛtyuhariṇīṃ	sudhām api āsvādya pratibhaya jarā mṛtyu hariṇīm 
SA_GR13_saulahpu-113	vipadyante viśve vidhiśatamakhādyā diviṣadaḥ /	vipadyante viśve vidhi śata makha ādyāḥ diviṣadaḥ 
SA_GR13_saulahpu-114	karālaṃ yat kṣveḍaṃ kavalitavataḥ kālakalanā	karālam yat kṣveḍam kavalitavataḥ kāla kalanā 
SA_GR13_saulahpu-115	na śaṃbhos tanmūlaṃ tava janani tāṭaṅkamahimā // Saul_29 //	na śaṃbhoḥ tat mūlam tava janani tāṭaṅka mahimā 
SA_GR13_saulahpu-116	kirīṭaṃ vairiñcaṃ parihara puraḥ kaiṭabhabhidaḥ	kirīṭam vairiñcam parihara puras kaiṭabha bhidaḥ 
SA_GR13_saulahpu-117	kaṭhore koṭīre skhalasi jahi jambhārimukuṭam /	kaṭhore koṭīre skhalasi jahi jambhāri mukuṭam 
SA_GR13_saulahpu-118	praṇamreṣv eteṣu prasabham abhiyātasya bhavanaṃ	praṇamreṣu eteṣu prasabham abhiyātasya bhavanam 
SA_GR13_saulahpu-119	bhavasyābhyutthāne tava parijanoktir vijayate // Saul_30 //	bhavasya abhyutthāne tava parijana uktiḥ vijayate 
SA_GR13_saulahpu-120	catuḥṣaṣṭyā tantraiḥ sakalam abhisaṃdhāya bhuvanaṃ	catuḥṣaṣṭyā tantraiḥ sakalam abhisaṃdhāya bhuvanam 
SA_GR13_saulahpu-121	sthitas tattatsiddhiprasavaparatantraiḥ paśupatiḥ /	sthitaḥ tad tad siddhi prasava paratantraiḥ paśupatiḥ 
SA_GR13_saulahpu-122	punas tvannirbandhād akhilapuruṣārthaikaghaṭanā-	punar tvad nirbandhāt akhila puruṣa artha eka ghaṭanā 
SA_GR13_saulahpu-123	svatantraṃ te tantraṃ kṣititalam avātītarad idam // Saul_31 //	svatantram te tantram kṣiti talam avātītarat idam 
SA_GR13_saulahpu-124	śivaḥ śaktiḥ kāmaḥ kṣitir atha raviḥ śītakiraṇaḥ	śivaḥ śaktiḥ kāmaḥ kṣitiḥ atha raviḥ śītakiraṇaḥ 
SA_GR13_saulahpu-125	smaro haṃsaḥ śakras tad anu ca parāmāraharayaḥ /	smaraḥ haṃsaḥ śakraḥ tat anu ca parāmāra harayaḥ 
SA_GR13_saulahpu-126	amī hṛllekhābhis tisṛbhir avasāneṣu ghaṭitā	amī hṛllekhābhiḥ tisṛbhiḥ avasāneṣu ghaṭitā 
SA_GR13_saulahpu-127	bhajante varṇās te tava janani nāmāvayavatām // Saul_32 //	bhajante varṇāḥ te tava janani nāma avayava tām 
SA_GR13_saulahpu-128	smaraṃ yoniṃ lakṣmīṃ tritayam idam ādau tava manor	smaram yonim lakṣmīm tritayam idam ādau tava manoḥ 
SA_GR13_saulahpu-129	nidhāyaike nitye niravadhimahābhogarasikāḥ /	nidhāya eke nitye niravadhi mahā bhoga rasikāḥ 
SA_GR13_saulahpu-130	japanti tvāṃ cintāmaṇigunanibaddhākṣavalayāḥ	japanti tvām 
SA_GR13_saulahpu-131	śivāgnau juhvantaḥ surabhighṛtadhārāhutiśataiḥ // Saul_33 //	śiva agnau juhvantaḥ surabhi ghṛta dhārā āhuti śataiḥ 
SA_GR13_saulahpu-132	śarīraṃ tvaṃ śaṃbhoḥ śaśimihiravakṣoruhayugaṃ	śarīram tvam śaṃbhoḥ śaśimihira vakṣoruha yugam 
SA_GR13_saulahpu-133	tavātmānaṃ manye bhagavati bhavātmānam anagham /	tava ātmānam manye bhagavati bhava ātmānam anagham 
SA_GR13_saulahpu-134	ataḥ śeṣaḥ śeṣīty ayam ubhayasādhāraṇatayā	atas śeṣaḥ śeṣī iti ayam ubhaya sādhāraṇa tayā 
SA_GR13_saulahpu-135	sthitaḥ saṃbandho vāṃ samarasaparānandaparayoḥ // Saul_34 //	sthitaḥ saṃbandhaḥ vām samarasa para ānanda parayoḥ 
SA_GR13_saulahpu-136	manas tvaṃ vyoma tvaṃ marud asi marutsārathir asi	manaḥ tvam vyoma tvam marut asi marut sārathiḥ asi 
SA_GR13_saulahpu-137	tvam āpas tvaṃ bhūmis tvayi pariṇatāyāṃ na hi param /	tvam āpaḥ tvam bhūmiḥ tvayi pariṇatāyām na hi param 
SA_GR13_saulahpu-138	tvam eva svātmānaṃ pariṇamayituṃ viśvavapuṣā	tvam eva sva ātmānam pariṇamayitum viśva vapuṣā 
SA_GR13_saulahpu-139	cidānandākāraṃ śivayuvati bhāvena bibhṛṣe // Saul_35 //	cidānanda ākāram śivayuvati bhāvena bibhṛṣe 
SA_GR13_saulahpu-140	tavājñācakrasthaṃ tapanaśaśikoṭidyutidharam	tava ājñā cakra stham tapana śaśi koṭi dyuti dharam 
SA_GR13_saulahpu-141	paraṃ śaṃbhuṃ vande parimilitapārśvaṃ paracitā /	param śaṃbhum vande parimilita pārśvam para citā 
SA_GR13_saulahpu-142	yam ārādhyan bhaktyā raviśaśiśucīnām aviṣaye	yam ārādhyan bhaktyā ravi śaśi śucīnām aviṣaye 
SA_GR13_saulahpu-143	nirāloke loko nivasati hi bhālokabhavane // Saul_36 //	nirāloke lokaḥ nivasati hi bhāloka bhavane 
SA_GR13_saulahpu-144	viśuddhau te śuddhasphaṭikaviśadaṃ vyomajanakaṃ	viśuddhau te śuddha sphaṭika viśadam vyoma janakam 
SA_GR13_saulahpu-145	śivaṃ seve devīm api śivasamānavyasaninīm /	śivam seve devīm api śiva samāna vyasaninīm 
SA_GR13_saulahpu-146	yayoḥ kāntyā yāntyā śaśikiraṇasārūpyasaraṇiṃ	yayoḥ kāntyā yāntyā śaśi kiraṇa sārūpya saraṇim 
SA_GR13_saulahpu-147	vidhūtāntardhvāntā vilasati cakorīva jagatī // Saul_37 //	vidhūta antar dhvāntā vilasati cakorī iva jagatī 
SA_GR13_saulahpu-148	samunmīlatsaṃvitkamalamakarandaikarasikaṃ	               
SA_GR13_saulahpu-149	bhaje haṃsadvaṃdvaṃ kim api mahatāṃ mānasacaram /	bhaje haṃsa dvaṃdvam kim api mahatām mānasa caram 
SA_GR13_saulahpu-150	yadālāpād aṣṭādaśaguṇitavidyāpariṇatir	           
SA_GR13_saulahpu-151	yad ādatte doṣād guṇam akhilam adbhyaḥ paya iva // Saul_38 //	yat ādatte doṣāt guṇam akhilam adbhyaḥ payaḥ iva 
SA_GR13_saulahpu-152	tava svādhiṣṭhāne hutavaham adhiṣṭhāya nirataṃ	tava svādhiṣṭhāne hutavaham adhiṣṭhāya niratam 
SA_GR13_saulahpu-153	tam īḍe saṃvartaṃ janani mahatīṃ tāṃ ca samayām /	tam īḍe saṃvartam janani mahatīm tām ca samayām 
SA_GR13_saulahpu-154	yadāloke lokān dahati mahati krodhakalile	yadā āloke lokān dahati mahati krodha kalile 
SA_GR13_saulahpu-155	dayārdrā dṛṣṭis te śiśiram upacāraṃ racayati // Saul_39 //	dayā ārdrā dṛṣṭiḥ te śiśiram upacāram racayati 
SA_GR13_saulahpu-156	taḍitvantaṃ śaktyā timiraparipanthisphuraṇayā	taḍitvantam śaktyā timira paripanthi sphuraṇayā 
SA_GR13_saulahpu-157	sphurannānāratnābharaṇapariṇaddhendradhanuṣam /	sphurat nānā ratna ābharaṇa pariṇaddha indradhanuṣam 
SA_GR13_saulahpu-158	tava śyāmaṃ meghaṃ kam api maṇipūraikaśaraṇaṃ	tava śyāmam megham kam api maṇipūra eka śaraṇam 
SA_GR13_saulahpu-159	niṣeve varṣantaṃ haramihirataptaṃ tribhuvanam // Saul_40 //	niṣeve varṣantam haramihira taptam tribhuvanam 
SA_GR13_saulahpu-160	tavādhāre mūle saha samayayā lāsyaparayā	tava ādhāre mūle saha samayayā lāsya parayā 
SA_GR13_saulahpu-161	navātmānaṃ vande navarasamahātāṇḍavanaṭam /	          
SA_GR13_saulahpu-162	ubhābhyām etābhyām ubhayavidhim uddiśya dayayā	ubhābhyām etābhyām ubhaya vidhim uddiśya dayayā 
SA_GR13_saulahpu-163	sanāthābhyāṃ jajñe janakajananīmad jagad idam // Saul_41 //	sanāthābhyām jajñe janaka jananīmat jagat idam 
SA_GR13_saulahpu-164	gatair māṇikyatvaṃ gaganamaṇibhiḥ sāndraghaṭitaṃ	gataiḥ māṇikya tvam gagana maṇibhiḥ sāndra ghaṭitam 
SA_GR13_saulahpu-165	kirīṭaṃ te haimaṃ himagirisute kīrtayati yaḥ /	kirīṭam te haimam himagiri sute kīrtayati yaḥ 
SA_GR13_saulahpu-166	sa nīḍeyacchāyācchuraṇaśabalaṃ candraśakalaṃ	sa nīḍeya chāyā ācchuraṇa śabalam candra śakalam 
SA_GR13_saulahpu-167	dhanuḥ śaunāsīraṃ kim iti na nibadhnāti dhiṣaṇām // Saul_42 //	dhanuḥ śaunāsīram kim iti na nibadhnāti dhiṣaṇām 
SA_GR13_saulahpu-168	dhunotu dhvāntaṃ nas tulitadalitendīvaravanaṃ	dhunotu dhvāntam naḥ tulita dalita indīvara vanam 
SA_GR13_saulahpu-169	ghanasnigdhaṃ ślakṣṇaṃ cikuranikurambaṃ tava śive /	ghana snigdham ślakṣṇam cikura nikurambam tava śive 
SA_GR13_saulahpu-170	yadīyaṃ saurabhyaṃ sahajam upalabdhuṃ sumanaso	yadī iyam saurabhyam sahajam upalabdhum sumanasaḥ 
SA_GR13_saulahpu-171	vasanty asmin manye balamathanavāṭīviṭapinām // Saul_43 //	vasanti asmin manye bala mathana vāṭī viṭapinām 
SA_GR13_saulahpu-172	vahantī sundūraṃ prabalakabarībhāratimira-	vahantī sundūram prabala kabarī bhāra timira 
SA_GR13_saulahpu-173	tviṣāṃ bṛndair bandīkṛtam iva navīnārkakiraṇam /	tviṣām bṛndaiḥ bandīkṛtam iva navīna arka kiraṇam 
SA_GR13_saulahpu-174	tanotu kṣemaṃ nas tava vadanasaundaryalaharī-	tanotu kṣemam naḥ tava vadana saundarya laharī 
SA_GR13_saulahpu-175	parīvāhasrotaḥsaraṇir iva sīmantasaraṇiḥ // Saul_44 //	parīvāha srotaḥ saraṇiḥ iva sīmanta saraṇiḥ 
SA_GR13_saulahpu-176	arālaiḥ svābhāvyād alikalabhasaśrībhir alakaiḥ	arālaiḥ svābhāvyāt ali kalabha sa śrībhiḥ alakaiḥ 
SA_GR13_saulahpu-177	parītaṃ te vaktraṃ parihasati paṅkeruharucim /	parītam te vaktram parihasati paṅkeruha rucim 
SA_GR13_saulahpu-178	darasmere yasmin daśanarucikiñjalkarucire	dara smere yasmin daśana ruci kiñjalka rucire 
SA_GR13_saulahpu-179	sugandhau mādyanti smaramathanacakṣurmadhulihaḥ // Saul_45 //	sugandhau mādyanti smara mathana cakṣuḥ madhulihaḥ 
SA_GR13_saulahpu-180	lalāṭaṃ lāvaṇyadyutivimalam ābhāti tava yad	lalāṭam lāvaṇya dyuti vimalam ābhāti tava yat 
SA_GR13_saulahpu-181	dvitīyaṃ tan manye mukuṭaśaśikhaṇḍasya śakalam /	dvitīyam tat manye mukuṭa śaśi khaṇḍasya śakalam 
SA_GR13_saulahpu-182	viparyāsanyāsād ubhayam api saṃbhūya ca mithaḥ	viparyāsa nyāsāt ubhayam api saṃbhūya ca mithas 
SA_GR13_saulahpu-183	sudhālepasyūtiḥ pariṇamati rākāhimakaraḥ // Saul_46 //	sudhā lepa syūtiḥ pariṇamati rākā himakaraḥ 
SA_GR13_saulahpu-184	bhruvau bhugne kiṃcid bhuvanabhayabhaṅgavyasanini	bhruvau bhugne kiṃcid bhuvana bhaya bhaṅga vyasanini 
SA_GR13_saulahpu-185	tvadīye netrābhyāṃ madhukararucibhyāṃ dhṛtaguṇe /	tvadīye netrābhyām madhukara rucibhyām dhṛta guṇe 
SA_GR13_saulahpu-186	dhanur manye savyetarakaragṛhītaṃ ratipateḥ	dhanuḥ manye savyetara kara gṛhītam ratipateḥ 
SA_GR13_saulahpu-187	prakoṣṭhe muṣṭau ca sthagayati nigūḍhāntaram ume // Saul_47 //	prakoṣṭhe muṣṭau ca sthagayati nigūḍha antaram ume 
SA_GR13_saulahpu-188	ahaḥ sūte savyaṃ tava nayanam arkātmakatayā	ahar sūte savyam tava nayanam arka ātmaka tayā 
SA_GR13_saulahpu-189	triyāmāṃ vāmaṃ te sṛjati rajanīnāyakamayam /	triyāmām vāmam te sṛjati rajanīnāyaka mayam 
SA_GR13_saulahpu-190	tṛtīyā te dṛṣtir daradalitahemāmbujaruciḥ	tṛtīyā te dṛṣtiḥ dara dalita hema ambuja ruciḥ 
SA_GR13_saulahpu-191	samādhatte saṃdhyāṃ divasaniśayor antaracarīm // Saul_48 //	samādhatte saṃdhyām divasa niśayoḥ antara carīm 
SA_GR13_saulahpu-192	viśālā kalyāṇī sphuṭarucir ayodhyā kuvalayaiḥ	viśālā kalyāṇī sphuṭa ruciḥ ayodhyā kuvalayaiḥ 
SA_GR13_saulahpu-193	kṛpādhārādhārā kim api madhurā bhogavatikā /	kṛpā dhārā dhārā kim api madhurā bhogavatikā 
SA_GR13_saulahpu-194	avantī dṛṣṭis te bahunagaravistāravijayā	avantī dṛṣṭiḥ te bahu nagara vistāra vijayā 
SA_GR13_saulahpu-195	dhruvaṃ tattannāmavyavaharaṇayogyā vijayate // Saul_49 //	dhruvam tad tad nāma vyavaharaṇa yogyā vijayate 
SA_GR13_saulahpu-196	kavīnāṃ saṃdarbhastabakamakarandaikarasikaṃ	             
SA_GR13_saulahpu-197	kaṭākṣavyākṣepabhramarakalabhau karṇayugalam /	kaṭākṣa vyākṣepa bhramara kalabhau karṇa yugalam 
SA_GR13_saulahpu-198	amuñcantau dṛṣṭvā tava nvarasāsvādataralāv	a muñcantau dṛṣṭvā tava nu arasa āsvāda taralau 
SA_GR13_saulahpu-199	asūyāsaṃsargād alikanayanaṃ kiṃcid aruṇam // Saul_50 //	asūyā saṃsargāt alika nayanam kiṃcid aruṇam 
SA_GR13_saulahpu-200	śive śṛṅgārārdrā taditaramukhe kutsanaparā	śive śṛṅgāra ārdrā tad itara mukhe kutsana parā 
SA_GR13_saulahpu-201	saroṣā gaṅgāyāṃ giriśacarite vismayavatī /	sa roṣā gaṅgāyām giriśa carite vismayavatī 
SA_GR13_saulahpu-202	harāhibhyo bhītā sarasiruhasaubhāgyajayinī	hara ahibhyaḥ bhītā sarasiruha saubhāgya jayinī 
SA_GR13_saulahpu-203	sakhīṣu smerā te mayi janani dṛṣṭiḥ sakaruṇā // Saul_51 //	sakhīṣu smerā te mayi janani dṛṣṭiḥ sa karuṇā 
SA_GR13_saulahpu-204	gate karṇābhyarṇaṃ garuta iva pakṣmāṇi dadhatī	gate karṇa abhyarṇam garutaḥ iva pakṣmāṇi dadhatī 
SA_GR13_saulahpu-205	purāṃ bhettuś cittapraśamarasavidrāvaṇaphale /	purām bhettuḥ citta praśama rasa vidrāvaṇa phale 
SA_GR13_saulahpu-206	ime netre gotrādharapatikulottaṃsakalike	ime netre gotra adhara pati kula uttaṃsa kalike 
SA_GR13_saulahpu-207	tavākarṇākṛṣṭasmaraśaravilāsaṃ kalayataḥ // Saul_52 //	tava a karṇa ākṛṣṭa smara śara vilāsam kalayataḥ 
SA_GR13_saulahpu-208	vibhaktatraivarṇyaṃ vyatikaritanīlāñjanatayā	vibhakta traivarṇyam vyatikarita nīlāñjana tayā 
SA_GR13_saulahpu-209	vibhāti tvannetratritayam idam īśānadayite /	vibhāti tvad netra tritayam idam īśāna dayite 
SA_GR13_saulahpu-210	punaḥ sraṣṭuṃ devān druhiṇaharirudrān uparatān	punar sraṣṭum devān druhiṇa hari rudrān uparatān 
SA_GR13_saulahpu-211	rajaḥ sattvaṃ bibhrat tama iti guṇānāṃ trayam iva // Saul_53 //	rajaḥ sattvam bibhrat tamaḥ iti guṇānām trayam iva 
SA_GR13_saulahpu-212	pavitrīkartuṃ naḥ paśupatiparādhīnahṛdaye	pavitrīkartum naḥ paśupati para adhīna hṛdaye 
SA_GR13_saulahpu-213	dayāmitrair netrair aruṇadhavalaśyāmarucibhiḥ /	dayā mitraiḥ netraiḥ aruṇa dhavala śyāma rucibhiḥ 
SA_GR13_saulahpu-214	nadaḥ śoṇo gaṅgā tapanatanayeti dhruvam amuṃ	nadaḥ śoṇaḥ gaṅgā tapanatanayā iti dhruvam amum 
SA_GR13_saulahpu-215	trayāṇāṃ tīrthānām upanayasi saṃbhedam anaghe // Saul_54 //	trayāṇām tīrthānām upanayasi saṃbhedam anaghe 
SA_GR13_saulahpu-216	tavāparṇe karṇejapanayanapaiśunyacakitā	tava aparṇe karṇejapa nayana paiśunya cakitā 
SA_GR13_saulahpu-217	nilīyante toye niyatam animeṣāḥ śapharikāḥ /	nilīyante toye niyatam animeṣāḥ śapharikāḥ 
SA_GR13_saulahpu-218	iyaṃ ca śrīr baddhacchadapuṭakapāṭaṃ kuvalayam	iyam ca śrīḥ baddha chada puṭa kapāṭam kuvalayam 
SA_GR13_saulahpu-219	jahāti pratyūṣe niśi ca vighaṭayya praviśati // Saul_55 //	jahāti pratyūṣe niśi ca vighaṭayya praviśati 
SA_GR13_saulahpu-220	nimeṣonmeṣābhyāṃ pralayam udayaṃ yāti jagatī	nimeṣa unmeṣābhyām pralayam udayam yāti jagatī 
SA_GR13_saulahpu-221	tavety āhuḥ santo dharaṇidhararājanyatanaye /	tava iti āhuḥ santaḥ dharaṇidhara rājanya tanaye 
SA_GR13_saulahpu-222	tvadunmeṣāj jātaṃ jagad idam aśeṣaṃ pralayataḥ	tvad unmeṣāt jātam jagat idam aśeṣam pralayataḥ 
SA_GR13_saulahpu-223	paritrātuṃ śaṅke parihṛtanimeṣās tava dṛśaḥ // Saul_56 //	paritrātum śaṅke parihṛta nimeṣāḥ tava dṛśaḥ 
SA_GR13_saulahpu-224	dṛśā drāghīyasyā daradalitanīlotpalarucā	dṛśā drāghīyasyā dara dalita nīlotpala rucā 
SA_GR13_saulahpu-225	davīyāṃsaṃ dīnaṃ snapaya kṛpayā mām api śive /	davīyāṃsam dīnam snapaya kṛpayā mām api śive 
SA_GR13_saulahpu-226	anenāyaṃ dhanyo bhavati na ca te hānir iyatā	anena ayam dhanyaḥ bhavati na ca te hāniḥ iyatā 
SA_GR13_saulahpu-227	vane vā harmye vā samakaranipāto himakaraḥ // Saul_57 //	vane vā harmye vā sa makara nipātaḥ himakaraḥ 
SA_GR13_saulahpu-228	arālaṃ te pālīyugalam agarājanyatanaye	arālam te pālī yugalam agarājanya tanaye 
SA_GR13_saulahpu-229	na keṣām ādhatte kusumaśarakodaṇḍakutukam /	na keṣām ādhatte kusuma śara kodaṇḍa kutukam 
SA_GR13_saulahpu-230	tiraścīno yatra śravaṇapatham ullaṅghya vilasan	tiraścīnaḥ yatra śravaṇapatham ullaṅghya vilasan 
SA_GR13_saulahpu-231	apāṅgavyāsaṅgo diśati śarasaṃdhānadhiṣaṇām // Saul_58 //	apāṅga vyāsaṅgaḥ diśati śara saṃdhāna dhiṣaṇām 
SA_GR13_saulahpu-232	sphuradgaṇḍābhogapratiphalitatāṭaṅkayugalaṃ	sphurat gaṇḍa ābhoga pratiphalita tāṭaṅka yugalam 
SA_GR13_saulahpu-233	catuścakraṃ manye tava mukham idaṃ manmatharatham /	catur cakram manye tava mukham idam manmatha ratham 
SA_GR13_saulahpu-234	yam āruhya druhyaty avaniratham arkenducaraṇaṃ	yam āruhya druhyati avani ratham arka indu caraṇam 
SA_GR13_saulahpu-235	mahāvīro māraḥ pramathapataye svaṃ jitavate // Saul_59 //	mahāvīraḥ māraḥ pramatha pataye svam jitavate 
SA_GR13_saulahpu-236	sarasvatyāḥ sūktīr amṛtalaharīkauśalaharīḥ	sarasvatyāḥ sūktīḥ amṛta laharī kauśa laharīḥ 
SA_GR13_saulahpu-237	pibantyāḥ śarvāṇi śravaṇaculukābhyām aviratam /	pibantyāḥ śarvāṇi śravaṇa culukābhyām aviratam 
SA_GR13_saulahpu-238	camatkāraślāghācalitaśirasaḥ kuṇḍalagaṇo	camatkāra ślāghā calita śirasaḥ kuṇḍala gaṇaḥ 
SA_GR13_saulahpu-239	jhaṇatkārais tāraiḥ prativacanam ācaṣṭae iva te // Saul_60 //	jhaṇatkāraiḥ tāraiḥ prativacanam ācaṣṭe iva te 
SA_GR13_saulahpu-240	asau nāsāvaṃśas tuhinagirivaṃśadhvajapaṭi	asau nāsā vaṃśaḥ tuhinagiri vaṃśa dhvaja paṭi 
SA_GR13_saulahpu-241	tvadīyo nedīyaḥ phalatu phalam asmākam ucitam /	tvadīyaḥ nedīyaḥ phalatu phalam asmākam ucitam 
SA_GR13_saulahpu-242	vahann antar muktāḥ śiśirataraniśvāsaghaṭitāḥ	vahan antar muktāḥ śiśiratara niśvāsa ghaṭitāḥ 
SA_GR13_saulahpu-243	samṛddhyā yas tāsāṃ bahir api ca muktāmaṇidharaḥ // Saul_61 //	samṛddhyā yaḥ tāsām bahis api ca muktā maṇi dharaḥ 
SA_GR13_saulahpu-244	prakṛtyā raktāyās tava sudati dantacchadaruceḥ	prakṛtyāḥ raktāyāḥ tava sudati dantacchada ruceḥ 
SA_GR13_saulahpu-245	pravakṣye sādṛśyaṃ janayatu phalaṃ vidrumalatā /	pravakṣye sādṛśyam janayatu phalam vidruma latā 
SA_GR13_saulahpu-246	na bimbaṃ tadbimbapratiphalanalābhād aruṇitaṃ	na bimbam tad bimba pratiphalana lābhāt aruṇitam 
SA_GR13_saulahpu-247	tulām adhyāroḍhuṃ katham iva vilajjeta kalayā // Saul_62 //	tulām adhyāroḍhum katham iva vilajjeta kalayā 
SA_GR13_saulahpu-248	smitajyotsnājālaṃ tava vadanacandrasya pibatāṃ	smita jyotsnā jālam tava vadana candrasya pibatām 
SA_GR13_saulahpu-249	cakorāṇām āsīd atirasatayā cañcujaḍimā /	cakorāṇām āsīt ati rasa tayā cañcu jaḍimā 
SA_GR13_saulahpu-250	atas te śītāṃśor amṛtalaharīm amlarucayaḥ	atas te śītāṃśoḥ amṛta laharīm amla rucayaḥ 
SA_GR13_saulahpu-251	pibanti svacchandaṃ niśiniśi bhṛśaṃ kāñcikadhiyā // Saul_63 //	pibanti svacchandam niśi niśi bhṛśam kāñcika dhiyā 
SA_GR13_saulahpu-252	aviśrāntaṃ patyur guṇagaṇakathāmreḍanajapā	a viśrāntam patyuḥ guṇa gaṇa kathā āmreḍana japā 
SA_GR13_saulahpu-253	japāpuṣpacchāyā tava janani jihvā jayati sā /	japā puṣpa chāyā tava janani jihvā jayati sā 
SA_GR13_saulahpu-254	yadagrāsīnāyāḥ sphaṭikadṛṣadacchacchavimayī	yat agra āsīnāyāḥ sphaṭika dṛṣad accha chavi mayī 
SA_GR13_saulahpu-255	sarasvatyā mūrtiḥ pariṇamati māṇikyavapuṣā // Saul_64 //	sarasvatyāḥ mūrtiḥ pariṇamati māṇikya vapuṣā 
SA_GR13_saulahpu-256	raṇe jitvā daityān apahṛtaśirastraiḥ kavacibhir	raṇe jitvā daityān apahṛta śirastraiḥ kavacibhiḥ 
SA_GR13_saulahpu-257	nivṛttaiś caṇḍāṃśutripuraharanirmālyavimukhaiḥ /	nivṛttaiḥ caṇḍāṃśu tripura hara nirmālya vimukhaiḥ 
SA_GR13_saulahpu-258	viśākhendropendraiḥ śaśiviśadakarpūraśakalā	viśākha indra upendraiḥ śaśi viśada karpūra śakalā 
SA_GR13_saulahpu-259	vilīyante mātas tava vadanatāmbūlakabalāḥ // Saul_65 //	vilīyante mātar tava vadana tāmbūlaka balāḥ 
SA_GR13_saulahpu-260	vipañcyā gāyantī vividham avadānaṃ paśupates	vipañcyā gāyantī vividham avadānam paśupateḥ 
SA_GR13_saulahpu-261	tvayārabdhe vaktuṃ calitaśirasā sādhuvacane /	tvayā ārabdhe vaktum calita śirasā sādhu vacane 
SA_GR13_saulahpu-262	tvadīyair mādhuryair apalapitatantrīkalaravāṃ	tvadīyaiḥ mādhuryaiḥ apalapita tantrī kalaravām 
SA_GR13_saulahpu-263	nijāṃ vīṇāṃ vāṇī niculayati colena nibhṛtam // Saul_66 //	nijām vīṇām vāṇī niculayati colena nibhṛtam 
SA_GR13_saulahpu-264	karāgreṇa spaṣṭaṃ tuhinagiriṇā vatsalatayā	kara agreṇa spaṣṭam tuhinagiriṇā vatsala tayā 
SA_GR13_saulahpu-265	girīśenodastaṃ muhur adharapānākulatayā /	girīśena udastam muhur adhara pāna ākula tayā 
SA_GR13_saulahpu-266	karagrāhyaṃ śaṃbhor mukhamukuravṛntaṃ girisute	kara grāhyam śaṃbhoḥ mukha mukura vṛntam girisute 
SA_GR13_saulahpu-267	kathaṃkāraṃ brūmas tava cibukam aupamyarahitam // Saul_67 //	kathaṃkāram brūmaḥ tava cibukam aupamya rahitam 
SA_GR13_saulahpu-268	bhujāśleṣān nityaṃ puradamayituḥ kaṇṭakavatī	bhuja āśleṣāt nityam pura damayituḥ kaṇṭakavatī 
SA_GR13_saulahpu-269	tava grīvā dhatte mukhakamalanālaśriyam iyam /	tava grīvā dhatte mukha kamala nāla śriyam iyam 
SA_GR13_saulahpu-270	svataḥ śvetā kālāgarubahalajambālamalinā	svatas śvetā kālāgaru bahala jambāla malinā 
SA_GR13_saulahpu-271	mṛṇālīlālityam vahati yadadho hāralatikā // Saul_68 //	mṛṇālī lālityam vahati yat adhas hāra latikā 
SA_GR13_saulahpu-272	gale rekhās tisro gatigamakagītaikanipuṇe	gale rekhāḥ tisraḥ gati gamaka gīta eka nipuṇe 
SA_GR13_saulahpu-273	vivāhavyānaddhatriguṇaguṇasaṃkhyāpratibhuvaḥ /	vivāha vyānaddha triguṇa guṇa saṃkhyā pratibhuvaḥ 
SA_GR13_saulahpu-274	virājante nānāvidhamadhurarāgākarabhuvāṃ	virājante nānāvidha madhura rāga ākara bhuvām 
SA_GR13_saulahpu-275	trayāṇāṃ grāmāṇāṃ sthitiniyamasīmāna iva te // Saul_69 //	trayāṇām grāmāṇām sthiti niyama sīmānaḥ iva te 
SA_GR13_saulahpu-276	mṛṇālīmṛdvīnāṃ tava bhujalatānāṃ catasṛṇāṃ	mṛṇālī mṛdvīnām tava bhuja latānām catasṛṇām 
SA_GR13_saulahpu-277	caturbhiḥ saundaryaṃ sarasijabhavaḥ stauti vadanaiḥ /	caturbhiḥ saundaryam sarasija bhavaḥ stauti vadanaiḥ 
SA_GR13_saulahpu-278	nakhebhyaḥ saṃtrasyan prathamamathanād andhakaripoś	nakhebhyaḥ saṃtrasyan prathama mathanāt andhaka ripoḥ 
SA_GR13_saulahpu-279	caturṇāṃ śīrṣāṇāṃ samam abhayahastārpaṇadhiyā // Saul_70 //	caturṇām śīrṣāṇām samam abhaya hasta arpaṇa dhiyā 
SA_GR13_saulahpu-280	nakhānām uddyotair navanalinarāgaṃ vihasatāṃ	nakhānām uddyotaiḥ nava nalina rāgam vihasatām 
SA_GR13_saulahpu-281	karāṇāṃ te kāntiṃ kathaya kathayāmaḥ katham ume /	karāṇām te kāntim kathaya kathayāmaḥ katham ume 
SA_GR13_saulahpu-282	kayā cid vā sāmyaṃ bhajatu kalayā hanta kamalaṃ	kayā cit vā sāmyam bhajatu kalayā hanta kamalam 
SA_GR13_saulahpu-283	yadi krīḍallakṣmīcaraṇatalalākṣāruṇadalam // Saul_71 //	yadi krīḍat lakṣmīcaraṇa tala lākṣā aruṇa dalam 
SA_GR13_saulahpu-284	samaṃ devi skandadvipavadanapītaṃ stanayugaṃ	samam devi skanda dvipa vadana pītam stana yugam 
SA_GR13_saulahpu-285	tavedaṃ naḥ khedaṃ haratu satataṃ prasnutamukham /	tava idam naḥ khedam haratu satatam prasnuta mukham 
SA_GR13_saulahpu-286	yad ālokyāśaṅkākulitahṛdayo hāsajanakaḥ	yat ālokya āśaṅkā ākulita hṛdayaḥ hāsa janakaḥ 
SA_GR13_saulahpu-287	svakumbhau herambaḥ parimṛśati hastena jhaṭiti // Saul_72 //	sva kumbhau herambaḥ parimṛśati hastena jhaṭiti 
SA_GR13_saulahpu-288	amū te vakṣojāv amṛtarasamāṇikyakutupau	amū te vakṣojau amṛta rasa māṇikya kutupau 
SA_GR13_saulahpu-289	na saṃdehaspando nagapatipatāke manasi naḥ /	na saṃdeha spandaḥ nagapati patāke manasi naḥ 
SA_GR13_saulahpu-290	pibantau tau yasmād aviditavadhūsaṃgamarasau	pibantau tau yasmāt avidita vadhū saṃgama rasau 
SA_GR13_saulahpu-291	kumārāv adyāpi dviradavadanakrauñcadalanau // Saul_73 //	kumārau adya api dvirada vadana krauñca dalanau 
SA_GR13_saulahpu-292	vahaty amba stamberamadanujakumbhaprakṛtibhiḥ	vahati amba stambera mad anuja kumbha prakṛtibhiḥ 
SA_GR13_saulahpu-293	samārabdhāṃ muktāmaṇibhir amalāṃ hāralatikām /	samārabdhām muktāmaṇibhiḥ amalām hāra latikām 
SA_GR13_saulahpu-294	kucābhogo bimbādhararucibhir antaḥ śabalitāṃ	kuca ābhogaḥ bimba adhara rucibhiḥ antar śabali tām 
SA_GR13_saulahpu-295	pratāpavyāmiśrāṃ puravijayinaḥ kīrtim iva te // Saul_74 //	pratāpa vyāmiśrām pura vijayinaḥ kīrtim iva te 
SA_GR13_saulahpu-296	tava stanyaṃ manye dharaṇidharakanye hṛdayataḥ	tava stanyam manye dharaṇidhara kanye hṛdayataḥ 
SA_GR13_saulahpu-297	payaḥpārāvāraḥ parivahati sārasvata iva /	payaḥ pārāvāraḥ parivahati sārasvataḥ iva 
SA_GR13_saulahpu-298	dayāvatyā dattaṃ draviḍaśiśur āsvādya tava yat	dayāvatyā dattam draviḍa śiśuḥ āsvādya tava yat 
SA_GR13_saulahpu-299	kavīnāṃ prauḍhānām ajani kamaniyaḥ kavayitā // Saul_75 //	kavīnām prauḍhānām ajani kamaniyaḥ kavayitā 
SA_GR13_saulahpu-300	harakrodhajvālāvalibhir avalīḍhena vapuṣā	hara krodha jvālā āvalibhiḥ avalīḍhena vapuṣā 
SA_GR13_saulahpu-301	gabhīre te nābhīsarasi kṛtasaṅgo manasijaḥ /	gabhīre te nābhī sarasi kṛta saṅgaḥ manasijaḥ 
SA_GR13_saulahpu-302	samuttasthau tasmād acalatanaye dhūmalatikā	samuttasthau tasmāt acala tanaye dhūmalatikā 
SA_GR13_saulahpu-303	janas tāṃ jānīte janani tava romāvalir iti // Saul_76 //	janaḥ tām jānīte janani tava roma āvaliḥ iti 
SA_GR13_saulahpu-304	yad etat kālindītanutarataraṅgākṛti śive	yat etat kālindī tanutara taraṅga ākṛti śive 
SA_GR13_saulahpu-305	kṛśe madhye kiṃ cij janani tava tad bhāti sudhiyām /	kṛśe madhye kim cit janani tava tat bhāti su dhiyām 
SA_GR13_saulahpu-306	vimardād anyoanyaṃ kucakalaśayor antaragataṃ	vimardāt anyoanyam kuca kalaśayoḥ antara gatam 
SA_GR13_saulahpu-307	tanūbhūtaṃ vyoma praviśad iva nābhīkuhariṇīm // Saul_77 //	tanūbhūtam vyoma praviśat iva nābhī kuhariṇīm 
SA_GR13_saulahpu-308	sthiro gaṅgāvartaḥ stanamukularomāvalilatā-	sthiraḥ gaṅgā āvartaḥ stana mukula roma āvali latā 
SA_GR13_saulahpu-309	kalāvālaṃ kuṇḍaṃ kusumaśaratejohutabhujaḥ /	kalā vālam kuṇḍam kusuma śara tejaḥ hutabhujaḥ 
SA_GR13_saulahpu-310	rater līlāgāraṃ kim api tava nābhīti girije	rateḥ līlā āgāram kim api tava nābhi iti girije 
SA_GR13_saulahpu-311	biladvāraṃ siddher giriśanayanānāṃ vijayate // Saul_78 //	bila dvāram siddheḥ giriśa nayanānām vijayate 
SA_GR13_saulahpu-312	nisargakṣīṇasya stanataṭabhareṇa klamajuṣo	nisarga kṣīṇasya stana taṭa bhareṇa klama juṣaḥ 
SA_GR13_saulahpu-313	namanmūrter nābhau baliṣu śanakais truṭyatae iva /	naman mūrteḥ nābhau baliṣu śanakais truṭyate iva 
SA_GR13_saulahpu-314	ciraṃ te madhyasya truṭitataṭinītīrataruṇā	ciram te madhyasya truṭita taṭinī tīra taruṇā 
SA_GR13_saulahpu-315	samāvasthāsthemno bhavatu kuśalaṃ śailatanaye // Saul_79 //	sama avasthā sthemnaḥ bhavatu kuśalam śailatanaye 
SA_GR13_saulahpu-316	kucau sadyaḥ svidyattaṭaghaṭitakūrpāsabhidurau	kucau sadyas svidyat taṭa ghaṭita kūrpāsa bhidurau 
SA_GR13_saulahpu-317	kaṣantau dormūle kanakakalaśābhau kalayatā /	kaṣantau dormūle kanaka kalaśa ābhau kalayatā 
SA_GR13_saulahpu-318	tava trātuṃ bhaṅgād alam iti vilagnaṃ tanubhuvā	tava trātum bhaṅgāt alam iti vilagnam tanubhuvā 
SA_GR13_saulahpu-319	tridhā naddhaṃ devi trivali lavalīvallibhir iva // Saul_80 //	tridhā naddham devi trivali lavalī vallibhiḥ iva 
SA_GR13_saulahpu-320	gurutvaṃ vistāraṃ kṣitidharapatiḥ pārvati nijān	guru tvam vistāram kṣitidhara patiḥ pārvati nijān 
SA_GR13_saulahpu-321	nitambād ācchidya tvayi haraṇarūpeṇa nidadhe /	nitambāt ācchidya tvayi haraṇa rūpeṇa nidadhe 
SA_GR13_saulahpu-322	atas te vistīrṇo gurur ayam aśeṣāṃ vasumatīṃ	atas te vistīrṇaḥ guruḥ ayam aśeṣām vasumatīm 
SA_GR13_saulahpu-323	nitambaprāgbhāraḥ sthagayati laghutvaṃ nayati ca // Saul_81 //	nitamba prāgbhāraḥ sthagayati laghu tvam nayati ca 
SA_GR13_saulahpu-324	karīndrāṇāṃ śuṇḍāḥ kanakakadalīkāṇḍapaṭalīm	karīndrāṇām śuṇḍāḥ kanaka kadalī kāṇḍa paṭalīm 
SA_GR13_saulahpu-325	ubhābhyām ūrubhyām ubhayam api nirjitya bhavatī /	ubhābhyām ūrubhyām ubhayam api nirjitya bhavatī 
SA_GR13_saulahpu-326	suvṛttābhyāṃ patyuḥ praṇatikaṭhinābhyāṃ girisute	su vṛttābhyām patyuḥ praṇati kaṭhinābhyām girisute 
SA_GR13_saulahpu-327	vijigye jānubhyāṃ vibudhakarikumbhadvayam api // Saul_82 //	vijigye jānubhyām vibudha kari kumbha dvayam api 
SA_GR13_saulahpu-328	parājetuṃ rudraṃ dviguṇaśaragarbhau girisute	parājetum rudram dviguṇa śara garbhau girisute 
SA_GR13_saulahpu-329	niṣaṅgau jaṅghe te viṣamaviśikho bāḍham akṛta /	niṣaṅgau jaṅghe te viṣama viśikhaḥ bāḍham akṛta 
SA_GR13_saulahpu-330	yadagre dṛśyante daśaśaraphalāḥ pādayugalī-	yad agre dṛśyante daśa śara phalāḥ pāda yugalī 
SA_GR13_saulahpu-331	nakhāgracchadmānaḥ suramukuṭaśāṇaikaniśitāḥ // Saul_83 //	nakha agra chadmānaḥ sura mukuṭa śāṇa eka niśitāḥ 
SA_GR13_saulahpu-332	śrutīnāṃ mūrdhāno dadhati tava yau śekharatayā	śrutīnām mūrdhānaḥ dadhati tava yau śekhara tayā 
SA_GR13_saulahpu-333	mamāpy etau mātaḥ śirasi dayayā dhehi caraṇau /	mama api etau mātar śirasi dayayā dhehi caraṇau 
SA_GR13_saulahpu-334	yayoḥ pādyaṃ pāthaḥ paśupatijaṭājūṭataṭinī	yayoḥ pādyam pāthaḥ paśupati jaṭā jūṭa taṭinī 
SA_GR13_saulahpu-335	yayor lākṣālakṣmīr aruṇaharicūḍāmaṇiruciḥ // Saul_84 //	yayoḥ lākṣā lakṣmīḥ aruṇa hari cūḍāmaṇi ruciḥ 
SA_GR13_saulahpu-336	namovākaṃ brūmo nayanaramaṇīyāya padayos	namovākam brūmaḥ nayana ramaṇīyāya padayoḥ 
SA_GR13_saulahpu-337	tavāsmai dvandvāya sphuṭarucirasālaktakavate /	tava asmai dvandvāya sphuṭa ruci rasa alaktakavate 
SA_GR13_saulahpu-338	asūyaty atyantaṃ yad abhihananāya spṛhayate	asūyati atyantam yat abhihananāya spṛhayate 
SA_GR13_saulahpu-339	paśūnām īśānaḥ pramadavanakaṅkelitarave // Saul_85 //	paśūnām īśānaḥ pramada vana kaṅkeli tarave 
SA_GR13_saulahpu-340	mṛṣā kṛtvā gotraskhalanam atha vailakṣyanamitaṃ	mṛṣā kṛtvā gotra skhalanam atha vailakṣya namitam 
SA_GR13_saulahpu-341	lalāṭe bhartāraṃ caraṇakamale tāḍayati te /	lalāṭe bhartāram caraṇa kamale tāḍayati te 
SA_GR13_saulahpu-342	cirād antaḥśalyaṃ dahanakṛtam unmūlitavatā	cirāt antar śalyam dahana kṛtam unmūlitavatā 
SA_GR13_saulahpu-343	tulākoṭikvāṇaiḥ kilikilitam īśānaripuṇā // Saul_86 //	tulā koṭi kvāṇaiḥ kilikilitam īśāna ripuṇā 
SA_GR13_saulahpu-344	himānīhantavyaṃ himagiritaṭākrānticaturau	himānī hantavyam himagiri taṭa ākrānti caturau 
SA_GR13_saulahpu-345	niśāyāṃ nidrāṇāṃ niśi ca parabhāge ca viśadau /	niśāyām nidrāṇām niśi ca parabhāge ca viśadau 
SA_GR13_saulahpu-346	paraṃ lakṣmīpātraṃ śriyam atisṛjantau samayināṃ	param lakṣmī pātram śriyam atisṛjantau samayinām 
SA_GR13_saulahpu-347	sarojaṃ tvatpādau janani jayataś citram iha kim // Saul_87 //	sarojam tvad pādau janani jayataḥ citram iha kim 
SA_GR13_saulahpu-348	padaṃ te kāntīnāṃ prapadam apadaṃ devi vipadāṃ	padam te kāntīnām prapadam a padam devi vipadām 
SA_GR13_saulahpu-349	kathaṃ nītaṃ sadbhiḥ kaṭhinakamaṭhīkarparatulām /	katham nītam sadbhiḥ kaṭhina kamaṭhī karpara tulām 
SA_GR13_saulahpu-350	kathaṃ vā bāhubhyām upayamanakāle purabhidā	katham vā bāhubhyām upayamana kāle purabhidā 
SA_GR13_saulahpu-351	yad ādāya nyastaṃ dṛṣadi dayamānena manasā // Saul_88 //	yat ādāya nyastam dṛṣadi dayamānena manasā 
SA_GR13_saulahpu-352	nakhair nākastrīṇāṃ karakamalasaṃkocaśaśibhis	nakhaiḥ nāka strīṇām kara kamala saṃkoca śaśibhiḥ 
SA_GR13_saulahpu-353	tarūṇāṃ divyānāṃ hasata iva te caṇḍi caraṇau /	tarūṇām divyānām hasataḥ iva te caṇḍi caraṇau 
SA_GR13_saulahpu-354	phalāni svasthebhyaḥ kisalayakarāgreṇa dadatāṃ	phalāni svasthebhyaḥ kisalaya kara agreṇa dadatām 
SA_GR13_saulahpu-355	daridrebhyo bhadrāṃ śriyam aniśam ahnāya dadatau // Saul_89 //	daridrebhyaḥ bhadrām śriyam aniśam ahne dadatau 
SA_GR13_saulahpu-356	kadā kāle mātaḥ kathaya kalitālaktakarasaṃ	kadā kāle mātar kathaya kalita alaktaka rasam 
SA_GR13_saulahpu-357	pibeyaṃ vidyārthī tava caraṇanirṇejanajalam /	pibeyam vidyā arthī tava caraṇa nirṇejana jalam 
SA_GR13_saulahpu-358	prakṛtyā mūkānām api ca kavitākāraṇatayā	prakṛtyā mūkānām api ca kavi tā kāraṇa tayā 
SA_GR13_saulahpu-359	yad ādhatte vāṇīmukhakamalatāmbūlarasatām // Saul_90 //	yat ādhatte vāṇī mukha kamala tāmbūla rasa tām 
SA_GR13_saulahpu-360	padanyāsakrīḍāparicayam ivārabdhumanasaś	padanyāsa krīḍā paricayam iva ārabdhu manasaḥ 
SA_GR13_saulahpu-361	carantas te khelaṃ bhavanakalahaṃsā na jahati /	carantaḥ te khelam bhavana kalahaṃsāḥ na jahati 
SA_GR13_saulahpu-362	suvikṣepe śikṣāṃ subhagamaṇimañjīraraṇita-	su vikṣepe śikṣām subhaga maṇi mañjīra raṇita 
SA_GR13_saulahpu-363	cchalād ācakṣāṇaṃ caraṇakamalaṃ cārucarite // Saul_91 //	cchalāt ācakṣāṇam caraṇa kamalam cāru carite 
SA_GR13_saulahpu-364	arālā keśeṣu prakṛtisaralā mandahasite	arālā keśeṣu prakṛti saralā manda hasite 
SA_GR13_saulahpu-365	śirīṣābhā citte dṛṣad iva kaṭhorā kucataṭe /	śirīṣa ābhā citte dṛṣad iva kaṭhorā kuca taṭe 
SA_GR13_saulahpu-366	bhṛśaṃ tanvī madhye pṛthur urasijārohaviṣaye	bhṛśam tanvī madhye pṛthuḥ urasija āroha viṣaye 
SA_GR13_saulahpu-367	jagat trātuṃ śaṃbhor jayati karuṇā kā cid aruṇā // Saul_92 //	jagat trātum śaṃbhoḥ jayati karuṇā kā cit aruṇā 
SA_GR13_saulahpu-368	purārāter antaḥpuram asi tatas tvaccaraṇayoḥ	purārāteḥ antaḥpuram asi tatas tvad caraṇayoḥ 
SA_GR13_saulahpu-369	saparyāmaryādā taralakaraṇānām asulabhā /	saparyā maryādā tarala karaṇānām a sulabhā 
SA_GR13_saulahpu-370	tathā hy ete nītāḥ śatamakhamukhāḥ siddhim atulāṃ	tathā hi ete nītāḥ śata makha mukhāḥ siddhim atulām 
SA_GR13_saulahpu-371	tava dvāropāntasthitibhir aṇimādyābhir amarāḥ // Saul_93 //	tava dvāra upānta sthitibhiḥ aṇima ādyābhiḥ amarāḥ 
SA_GR13_saulahpu-372	gatās te mañcatvaṃ druhiṇaharirudreśvarabhṛtaḥ	gatāḥ te mañca tvam druhiṇa hari rudra īśvara bhṛtaḥ 
SA_GR13_saulahpu-373	śivaḥ svacchacchāyāghaṭitakapaṭapracchadapaṭaḥ /	               
SA_GR13_saulahpu-374	tvadīyānāṃ bhāsāṃ pratiphalanalābhāruṇatayā	tvadīyānām bhāsām pratiphalana lābha aruṇa tayā 
SA_GR13_saulahpu-375	śarīrī śṛṅgāro rasa iva dṛśāṃ dogdhi kutukam // Saul_94 //	śarīrī śṛṅgāraḥ rasaḥ iva dṛśām dogdhi kutukam 
SA_GR13_saulahpu-376	kalaṅkaḥ kastūrī rajanikarabimbaṃ jalamayaṃ	           
SA_GR13_saulahpu-377	kalābhiḥ karpūrair marakatakaraṇḍaṃ nibiḍitam /	kalābhiḥ karpūraiḥ marakata karaṇḍam nibiḍitam 
SA_GR13_saulahpu-378	atas tvadbhogena pratidinam idaṃ riktakuharaṃ	atas tvad bhogena pratidinam idam rikta kuharam 
SA_GR13_saulahpu-379	vidhir bhūyobhūyo nibiḍayati nūnaṃ tava kṛte // Saul_95 //	vidhiḥ bhūyas bhūyas nibiḍayati nūnam tava kṛte 
SA_GR13_saulahpu-380	svadehodbhūtābhir ghṛṇibhir aṇimādyābhir abhito	sva deha udbhūtābhiḥ ghṛṇibhiḥ aṇima ādyābhiḥ abhitas 
SA_GR13_saulahpu-381	niṣevye nitye tvām aham iti sadā bhāvayati yaḥ /	niṣevye nitye tvām aham iti sadā bhāvayati yaḥ 
SA_GR13_saulahpu-382	kim āścaryaṃ tasya trinayansamṛddhiṃ tṛṇayato	kim āścaryam tasya trinayan samṛddhim tṛṇayataḥ 
SA_GR13_saulahpu-383	mahāsaṃvartāgnir viracayati nīrājanavidhim // Saul_96 //	mahā saṃvarta agniḥ viracayati nīrājana vidhim 
SA_GR13_saulahpu-384	kalatraṃ vaidhātraṃ katikati bhajante na kavayaḥ	kalatram vaidhātram kati kati bhajante na kavayaḥ 
SA_GR13_saulahpu-385	śriyo devyāḥ ko vā na bhavati patiḥ kair api dhanaiḥ /	śriyaḥ devyāḥ kaḥ vā na bhavati patiḥ kaiḥ api dhanaiḥ 
SA_GR13_saulahpu-386	mahādevaṃ hitvā tava sati satīnām acarame	mahādevam hitvā tava sati satīnām acarame 
SA_GR13_saulahpu-387	kucābhyām āsaṅgaḥ kuravakataror apy asulabhaḥ // Saul_97 //	kucābhyām āsaṅgaḥ kuravaka taroḥ api a sulabhaḥ 
SA_GR13_saulahpu-388	girām āhur devīṃ druhiṇagṛhiṇīm āgamavido	girām āhuḥ devīm druhiṇa gṛhiṇīm āgama vidaḥ 
SA_GR13_saulahpu-389	hareḥ patnīṃ padmāṃ harasahacārīm adritanayām /	hareḥ patnīm padmām hara sahacārīm adri tanayām 
SA_GR13_saulahpu-390	turīyā kāpi tvaṃ duradhigamaniḥsīmamahimā	turīyā kā api tvam duradhigama niḥsīma mahimā 
SA_GR13_saulahpu-391	mahāmāye viśvaṃ bhramayasi parabrahmamahiṣi // Saul_98 //	mahāmāye viśvam bhramayasi para brahma mahiṣi 
SA_GR13_saulahpu-392	sarasvatyā lakṣmyā vidhiharisapatno viharate	sarasvatyā lakṣmyā vidhi hari sapatnaḥ viharate 
SA_GR13_saulahpu-393	rateḥ pātivratyaṃ śithilayati ramyeṇa vapuṣā /	rateḥ pātivratyam śithilayati ramyeṇa vapuṣā 
SA_GR13_saulahpu-394	ciraṃ jīvann eṣa kṣapitapaśupāśavyatikaraḥ	ciram jīvan eṣa kṣapita paśu pāśa vyatikaraḥ 
SA_GR13_saulahpu-395	parabrahmābhikhyaṃ rasayati rasaṃ tvadbhajanavān // Saul_99 //	para brahma abhikhyam rasayati rasam tvad bhajanavān 
SA_GR13_saulahpu-396	pradīpajvālābhir divasakaranīrājanavidhiḥ	            
SA_GR13_saulahpu-397	sudhāsūteś candropalajalalavair arghyaghaṭanā /	sudhā sūteḥ candropala jala lavaiḥ arghya ghaṭanā 
SA_GR13_saulahpu-398	svakīyair ambhobhiḥ salilanidhisauhityakaraṇaṃ	svakīyaiḥ ambhobhiḥ salilanidhi sauhitya karaṇam 
SA_GR13_saulahpu-399	tvadīyābhir vāgbhis tava janani vācāṃ stutir iyam // Saul_100 //	tvadīyābhiḥ vāgbhiḥ tava janani vācām stutiḥ iyam 
SA_GR13_saulahpu-400	samānītaḥ padbhyāṃ maṇimukuratām ambaramaṇir	samānītaḥ padbhyām maṇi mukura tām ambaramaṇiḥ 
SA_GR13_saulahpu-401	bhayād antarbaddhastimitakiraṇaśreṇimasṛṇaḥ /	bhayāt antar baddha stimita kiraṇa śreṇi masṛṇaḥ 
SA_GR13_saulahpu-402	dadhāti tvadvaktraṃ pratiphalitam aśrāntivikacaṃ	dadhāti tvad vaktram pratiphalitam a śrānti vikacam 
SA_GR13_saulahpu-403	nirātaṅkaṃ candrān nijahṛdayapaṅkeruham iva // Saul_101 //	nirātaṅkam candrāt nija hṛdaya paṅkeruham iva 
SA_GR13_saulahpu-404	samudbhūtasthūlastanabharam uraś cāru hasitaṃ	samudbhūta sthūla stana bharam uraḥ cāru hasitam 
SA_GR13_saulahpu-405	kaṭākṣe kandarpaḥ kusumitakadambadyutivapuḥ /	kaṭākṣe kandarpaḥ kusumita kadamba dyuti vapuḥ 
SA_GR13_saulahpu-406	harasya tvadbhrāntiṃ manasi janayām āsa madano	harasya tvad bhrāntim manasi janayām āsa madano 
SA_GR13_saulahpu-407	bhavatyā ye bhaktāḥ pariṇatir amīṣām iyam ume // Saul_102 //	bhavatyāḥ ye bhaktāḥ pariṇatiḥ amīṣām iyam ume 
SA_GR13_saulahpu-408	nidhe nityasmere niravadhiguṇe nītinipuṇe	             
SA_GR13_saulahpu-409	nirāghātajñāne niyamaparacittaikanilaye /	             
SA_GR13_saulahpu-410	niyatyā nirmukte nikhilanigamāntastutipade	                   
SA_GR13_saulahpu-411	nirātaṅke nitye nigamaya mamāpi stutim imām // Saul_103 //	nirātaṅke nitye nigamaya mama api stutim imām 
