segmentnr	original	analyzed
SA_GSP31_vijsamsu-0	sāṅkhyasāraḥ /	sāṅkhya sāraḥ 
SA_GSP31_vijsamsu-1	pūrvabhāgaḥ /	pūrva bhāgaḥ 
SA_GSP31_vijsamsu-2	prathamaḥ paricchedaḥ /	prathamaḥ paricchedaḥ 
SA_GSP31_vijsamsu-3	mahadākhyaḥ svayambhūryo jagadaṅkura īśvaraḥ /	mahat ākhyaḥ svayambhūḥ yaḥ jagat aṅkuraḥ īśvaraḥ 
SA_GSP31_vijsamsu-4	sarvātmane namastasmai viṣṇave sarvajiṣṇave // ViSs_1,1.1 //	sarvātmane namaḥ tasmai viṣṇave sarva jiṣṇave 
SA_GSP31_vijsamsu-5	sāṅkhyakārikayā leśādātmatattvaṃ vivecitam /	sāṅkhya kārikayā leśāt ātma tattvam vivecitam 
SA_GSP31_vijsamsu-6	sāṅkhyasāraviveko 'to vijñānena prapañcyate // ViSs_1,1.2 //	sāṅkhya sāra vivekaḥ taḥ vijñānena prapañcyate 
SA_GSP31_vijsamsu-7	prāyaḥ saṅkalitā sāṅkhyaprakriyā kārikāgaṇe /	prāyas saṅkalitā sāṅkhya prakriyā kārikā gaṇe 
SA_GSP31_vijsamsu-8	sā 'to 'tra varṇyate leśāt tadanuktāṃśamātrataḥ // ViSs_1,1.3 //	sā to tra varṇyate leśāt tad anukta aṃśa mātrataḥ 
SA_GSP31_vijsamsu-9	sāṅkhyabhāṣye prakṛtyādeḥ svarūpaṃ vistarān mayā /	sāṅkhya bhāṣye prakṛti ādeḥ svarūpam vistarāt mayā 
SA_GSP31_vijsamsu-10	proktaṃ tasmāt tadapyatra saṅkṣepādeva vakṣyate // ViSs_1,1.4 //	proktam tasmāt tat api atra saṅkṣepāt eva vakṣyate 
SA_GSP31_vijsamsu-11	ātmānātmavivekasākṣātkārāt kartṛtvādyakhilābhimānanivṛttyā tatkāryarāgadveṣadharmādharmādyanutpādāt	ātma anātma viveka sākṣātkārāt kartṛ tva ādi akhila abhimāna nivṛttyā tad kārya rāga dveṣa dharma adharma ādi anutpādāt 
SA_GSP31_vijsamsu-12	pūrvotpannakarmaṇāṃ cāvidyārāgādisahakāryucchedarūpadānena vipākānārambhakatvāt prārabdhasamāptyanantaraṃ	pūrva utpanna karmaṇām ca avidyā rāga ādi sahakāri uccheda rūpa dānena vipāka anārambhaka tvāt prārabdha samāpti anantaram 
SA_GSP31_vijsamsu-13	punarjanmābhāvena trividhaduḥkhātyantanivṛttirūpo mokṣo bhavatīti śrutismṛtiḍiṇḍimaḥ /	punarjanma abhāvena trividha duḥkha atyanta nivṛtti rūpaḥ mokṣaḥ bhavati iti śruti smṛti ḍiṇḍimaḥ 
SA_GSP31_vijsamsu-14	tatra śrutayaḥ /	tatra śrutayaḥ 
SA_GSP31_vijsamsu-15	athākāmayamāno yo 'kāmo niṣkāmo na tasya prāṇā utkrāmantīhaiva samavalīyante /	atha a kāmayamānaḥ yaḥ kāmaḥ niṣkāmaḥ na tasya prāṇāḥ utkrāmanti iha eva samavalīyante 
SA_GSP31_vijsamsu-16	ātmānaṃ cedvijānīyādayamastīti pūruṣaḥ /	ātmānam ced vijānīyāt ayam asti iti pūruṣaḥ 
SA_GSP31_vijsamsu-17	kimicchan kasya kāmāya śarīramanusañcaret //	kim icchan kasya kāmāya śarīram anusañcaret 
SA_GSP31_vijsamsu-18	yadā sarve pramucyante kāmā ye 'sya hṛdi śritāḥ /	yadā sarve pramucyante kāmāḥ ye sya hṛdi śritāḥ 
SA_GSP31_vijsamsu-19	atha martyo 'mṛto bhavatyatra brahma samaśnute //	atha martyaḥ mṛtaḥ bhavati atra brahma samaśnute 
SA_GSP31_vijsamsu-20	kāmān yaḥ kāmayate manyamānaḥ	kāmān yaḥ kāmayate manyamānaḥ 
SA_GSP31_vijsamsu-21	sa karmabhirjāyate tatra tatra /	sa karmabhiḥ jāyate tatra tatra 
SA_GSP31_vijsamsu-22	paryāptakāmasya kṛtātmanastu	paryāpta kāmasya kṛtātmanaḥ tu 
SA_GSP31_vijsamsu-23	ihaiva sarve pravilīyanti kāmāḥ //	iha eva sarve pravilīyanti kāmāḥ 
SA_GSP31_vijsamsu-24	ityādyāḥ / smṛtayaśca kaurmādyāḥ /	ityādyāḥ smṛtayaḥ ca kaurma ādyāḥ 
SA_GSP31_vijsamsu-25	yathā kaurme /	yathā kaurme 
SA_GSP31_vijsamsu-26	rāgadveṣādayo doṣāḥ sarve bhrāntinibandhanāḥ /	rāga dveṣa ādayaḥ doṣāḥ sarve bhrānti nibandhanāḥ 
SA_GSP31_vijsamsu-27	kāryo hyasya bhaveddoṣaḥ puṇyāpuṇyamiti śrutiḥ //	kāryaḥ hi asya bhavet doṣaḥ puṇya apuṇyam iti śrutiḥ 
SA_GSP31_vijsamsu-28	tadvaśādeva sarveṣāṃ sarvadehasamudbhavaḥ /	tad vaśāt eva sarveṣām sarva deha samudbhavaḥ 
SA_GSP31_vijsamsu-29	iti / mokṣadharme ca /	iti mokṣa dharme ca 
SA_GSP31_vijsamsu-30	indriyāṇīndriyārthāśca nopasarpantyatarṣulam /	indriyāṇi indriya arthāḥ ca na upasarpanti atarṣulam 
SA_GSP31_vijsamsu-31	hīnaśca karaṇairdehī na dehaṃ punararhati //	hīnaḥ ca karaṇaiḥ dehī na deham punar arhati 
SA_GSP31_vijsamsu-32	tasmāt tarṣātmakād rāgād bījājjāyanti jantavaḥ /	tasmāt tarṣa ātmakāt rāgāt bījāt jāyanti jantavaḥ 
SA_GSP31_vijsamsu-33	iti / nanu rāgābhāve 'pi kevalakarmavaśānnarakādiprāpteḥ kathaṃ rāgasya karmasahakāritvaṃ vipākārambha upapannam /	iti nanu rāga abhāve pi kevala karma vaśāt naraka ādi prāpteḥ katham rāgasya karma sahakāri tvam vipāka ārambhe upapannam 
SA_GSP31_vijsamsu-34	narakādau viśeṣato rāgābhāve 'pi sāmānyato rāgasattvāt /	naraka ādau viśeṣataḥ rāga abhāve pi sāmānyatas rāga sattvāt 
SA_GSP31_vijsamsu-35	niṣiddhastryādigāmināṃ stryādirāgādeva taptalohamayanārīsamāliṅganādirūpanarakotpatteḥ /	niṣiddha strī ādi gāminām strī ādi rāgāt eva tapta loha maya nārī samāliṅgana ādi rūpa naraka utpatteḥ 
SA_GSP31_vijsamsu-36	yadyapyavidyāsmitārāgadveṣabhayākhyaṃ kleśapañcakameva janmādivipākārambhe karmaṇāṃ sahakāri bhavati /	yadi api avidyā asmitā rāga dveṣa bhaya ākhyam kleśa pañcakam eva janma ādi vipāka ārambhe karmaṇām sahakāri bhavati 
SA_GSP31_vijsamsu-37	tadeva saktaḥ saha karmaṇaiti	tat eva saktaḥ saha karmaṇā eti 
SA_GSP31_vijsamsu-38	liṅgaṃ mano yatra niṣiktamasya /	liṅgam manaḥ yatra niṣiktam asya 
SA_GSP31_vijsamsu-39	iti śrutāvabhimānarāgadveṣādijanyasya viṣayavāsanākhyasaṅgasāmānyasyaiva janmādivipākārambhe karmasahakāritvasiddheḥ /	iti śrutau abhimāna rāga dveṣa ādi janyasya viṣaya vāsanā ākhya saṅga sāmānyasya eva janma ādi vipāka ārambhe karma sahakāri tva siddheḥ 
SA_GSP31_vijsamsu-40	yatra yatra mano dehī dhārayet sakalaṃ dhiyā /	yatra yatra manaḥ dehī dhārayet sakalam dhiyā 
SA_GSP31_vijsamsu-41	snehāddveṣādbhayādvā 'pi yāti tattatsarūpatām //	snehāt dveṣāt bhayāt vā pi yāti tad tad sarūpa tām 
SA_GSP31_vijsamsu-42	ityādismṛteśca /	ityādi smṛteḥ ca 
SA_GSP31_vijsamsu-43	tathā ca kleśamūlaḥ karmāśayaḥ /	tathā ca kleśa mūlaḥ karma āśayaḥ 
SA_GSP31_vijsamsu-44	sati mūle tadvipāko jātyāyurbhogā iti yogasūtrābhyāmapyadṛṣṭe tadvipākārambhe ca kleśānāṃ hetutvavacanācca /	sati mūle tad vipākaḥ jāti āyuḥ bhogāḥ iti yoga sūtrābhyām api adṛṣṭe tad vipāka ārambhe ca kleśānām hetu tva vacanāt ca 
SA_GSP31_vijsamsu-45	tathā 'pyavidyāsmitāsattve rāgasyāvaśyakatvāddveṣabhayayośca rāgamūlakatvādrāga eva mukhyato janmādihetutayā yathoktavākyairnirdiśyata iti  #	tathā pi avidyā asmitā sattve rāgasya āvaśyaka tvāt dveṣa bhayayoḥ ca rāga mūlaka tvāt rāgaḥ eva mukhyatas janma ādi hetutayā yathā ukta vākyaiḥ nirdiśyate iti 
SA_GSP31_vijsamsu-46	/ nanu /	nanu 
SA_GSP31_vijsamsu-47	kṣīyante cāsya karmāṇi tasmin dṛṣṭe parāvare /	kṣīyante ca asya karmāṇi tasmin dṛṣṭe parāvare 
SA_GSP31_vijsamsu-48	ityādiśruterjñānasya prācīnakarmanāśakatvamevocitaṃ dāhakatvaṃ kathamiṣyata iti cenna /	ityādi śruteḥ jñānasya prācīna karma nāśaka tvam eva ucitam dāhaka tvam katham iṣyate iti ced na 
SA_GSP31_vijsamsu-49	jñānāgnidagdhakarmāṇaṃ tamāhuḥ paṇḍitaṃ budhāḥ /	jñāna agni dagdha karmāṇam tam āhuḥ paṇḍitam budhāḥ 
SA_GSP31_vijsamsu-50	ityādivākyairdāhasyāpi śravaṇena lāghavāddāhaparatvasyaiva nāśādivākyeṣvapi kalpanaucityāt /	ityādi vākyaiḥ dāhasya api śravaṇena lāghavāt dāha paratvasya eva nāśa ādi vākyeṣu api kalpanā aucityāt 
SA_GSP31_vijsamsu-51	karmaṇāṃ dāhaśca kleśākhyasahakāryucchedena naiṣphalyam /	karmaṇām dāhaḥ ca kleśa ākhya sahakāri ucchedena naiṣphalyam 
SA_GSP31_vijsamsu-52	karmaṇāṃ nāśastu prārabdhabhogānte cittanāśādeva bhaviṣyati /	karmaṇām nāśaḥ tu prārabdha bhoga ante citta nāśāt eva bhaviṣyati 
SA_GSP31_vijsamsu-53	ato lokasiddhenāvidyānāśenaiva dvāreṇa karmaphalānutpattisambhavānna jñānasya karmanāśakatvaṃ gauravādityādikaṃ yogavārttike praprañcitamasmābhiriti  #	atas loka siddhena avidyā nāśena eva dvāreṇa karma phala anutpatti sambhavāt na jñānasya karma nāśaka tvam gauravāt iti ādikam yogavārttike praprañcitam asmābhiḥ iti 
SA_GSP31_vijsamsu-54	dik /	diś 
SA_GSP31_vijsamsu-55	tasmādvivekasākṣātkārādavidyāsmitārāgādikleśanivṛttau trividhaduḥkhātyantanivṛttirūpaparamapuruṣārthaḥ siddhyatītyupapannam /	tasmāt viveka sākṣātkārāt avidyā asmitā rāga ādi kleśa nivṛttau trividha duḥkha atyanta nivṛtti rūpa parama puruṣa arthaḥ siddhi ati iti upapannam 
SA_GSP31_vijsamsu-56	tathā ca yogasūtradvayam /	tathā ca yogasūtra dvayam 
SA_GSP31_vijsamsu-57	heyaṃ duḥkhamanāgatam /	heyam duḥkham anāgatam 
SA_GSP31_vijsamsu-58	vivekkhyātiraviplavā hānopāya iti /	viveka khyātiḥ aviplavā hāna upāyaḥ iti 
SA_GSP31_vijsamsu-59	iti śrīvijñānabhikṣuviracite sāṅkhyasāre 'bhyarhitattvādādau vivekakhyātiphalasya paramapuruṣārthasya paricchedaḥ // * // @---------------------------------------------------------------------	iti śrī vijñānabhikṣu viracite sāṅkhyasāre bhyarhita tvāt ādau viveka khyāti phalasya parama puruṣa arthasya paricchedaḥ 
SA_GSP31_vijsamsu-60	atha dvitīyaḥ paricchedaḥ	atha dvitīyaḥ paricchedaḥ 
SA_GSP31_vijsamsu-61	athātmānātmavivekajñānasya kiṃ svarūpaṃ taducyate /	atha ātma anātma viveka jñānasya kim svarūpam tat ucyate 
SA_GSP31_vijsamsu-62	ātmā tāvat sukhaduḥkhādyanubhaviteti sāmānyato lokaprasiddhiḥ anātmā ca prakṛtyādirjaḍavargaḥ	ātmā tāvat sukha duḥkha ādi anubhavitā iti sāmānyatas loka prasiddhiḥ anātmā ca prakṛti ādiḥ jaḍa vargaḥ 
SA_GSP31_vijsamsu-63	tayoranyonyavaidharmyeṇa pariṇāmitvāpariṇāmitvādirūpeṇa doṣaguṇātmakena heyopādeyatayā	tayoḥ anyonya vaidharmyeṇa pariṇāmi tva apariṇāmi tva ādi rūpeṇa doṣa guṇa ātmakena heya upādeya tayā 
SA_GSP31_vijsamsu-64	pṛthaktvena jñānaṃ vivekajñānam /	        
SA_GSP31_vijsamsu-65	tathā ca śrutiḥ /	tathā ca śrutiḥ 
SA_GSP31_vijsamsu-66	sa eṣa neti netyātmā 'gṛhyo na hi gṛhyate 'śīryo na hi śīryate 'saṅgo na hi sajyate 'sito na vyathate na riṣyatītyādi / smṛtiśca /	saḥ eṣa na iti na iti ātmā gṛhyaḥ na hi gṛhyate śīryaḥ na hi śīryate saṅgaḥ na hi sajyate sitaḥ na vyathate na riṣyati ityādi smṛtiḥ ca 
SA_GSP31_vijsamsu-67	so 'tha pratinivṛttākṣo gurudarpaṇabodhitaḥ /	saḥ tha pratinivṛtta akṣaḥ guru darpaṇa bodhitaḥ 
SA_GSP31_vijsamsu-68	svato 'nyāṃ vikriyāṃ mauḍhyādāsthitāmañjasaikṣata //	svatas nyām vikriyām mauḍhyāt āsthitām añjasā aikṣata 
SA_GSP31_vijsamsu-69	athāsau prakṛtirnāhamiyaṃ hi kaluṣātmikā /	atha asau prakṛtiḥ na aham iyam hi kaluṣa ātmikā 
SA_GSP31_vijsamsu-70	śuddhabuddhasvabhāvo 'hamiti tyajati tāṃ vidan //	śuddha buddha svabhāvaḥ ham iti tyajati tām vidan 
SA_GSP31_vijsamsu-71	evaṃ dehendriyādibhyaḥ śuddhatvenātmani smṛte /	evam deha indriya ādibhyaḥ śuddha tvena ātmani smṛte 
SA_GSP31_vijsamsu-72	nikhilā savikāreyaṃ tyaktaprāyā 'hicarmavat //	nikhilā sa vikārā iyam tyakta prāyā hi carma vat 
SA_GSP31_vijsamsu-73	iti / sūtraṃ ca /	iti sūtram ca 
SA_GSP31_vijsamsu-74	evaṃ tattvābhyāsānneti netīti tyāgādvivekasiddhiriti /	evam tattva abhyāsāt na iti na iti iti tyāgāt viveka siddhiḥ iti 
SA_GSP31_vijsamsu-75	tattvajñānasya lakṣaṇaṃ ca mātsye kṛtam /	tattva jñānasya lakṣaṇam ca mātsye kṛtam 
SA_GSP31_vijsamsu-76	avyaktādye viśeṣānte vikāre 'smiṃśca varṇite /	avyakta ādye viśeṣa ante vikāre smin ca varṇite 
SA_GSP31_vijsamsu-77	cetanācetanānyatvajñānena jñānamucyate //	cetana acetana anya tva jñānena jñānam ucyate 
SA_GSP31_vijsamsu-78	iti / yadyapyanyonyabhedajñānameva vivekajñānaṃ tathāpyātmaviśeṣyakameva tanmokṣakāraṇaṃ bhavati /	iti yadi api anyonya bheda jñānam eva viveka jñānam tathā api ātma viśeṣyakam eva tat mokṣa kāraṇam bhavati 
SA_GSP31_vijsamsu-79	ātmā vā 're draṣṭavya ityādi śrutismṛtibhyaḥ /	ātmā vā re draṣṭavyaḥ ityādi śruti smṛtibhyaḥ 
SA_GSP31_vijsamsu-80	nanvanātmanyātmabuddhirūpā yā 'vidyā pātañjalādiṣūktā tasyāḥ kathamātmaviśeṣyakavivekajñānanāśyatvaṃ prakārādibhedāditi cenna /	nanu anātmani ātma buddhi rūpā yā vidyā pātañjala ādiṣu uktā tasyāḥ katham ātma viśeṣyaka viveka jñāna nāśya tvam prakāra ādi bhedāt iti ced na 
SA_GSP31_vijsamsu-81	tādṛśāvidyāyā anātmaviśeṣyakavivekajñānadvāreṇātmaviśeṣyakavivekajñānanāśyatvāditi /	tādṛśa avidyāyāḥ anātma viśeṣyaka viveka jñāna dvāreṇa ātma viśeṣyaka viveka jñāna nāśya tvāt iti 
SA_GSP31_vijsamsu-82	yacca yogena nirvikalpakamātmajñānaṃ jāyate tadvivekajñānadvāraiva mokṣakāraṇaṃ bhavati na tu sākṣādavidyānivartakatvābhāvāt /	yat ca yogena nirvikalpakam ātma jñānam jāyate tad viveka jñāna dvārā eva mokṣa kāraṇam bhavati na tu sākṣāt avidyā nivartaka tva abhāvāt 
SA_GSP31_vijsamsu-83	ahaṃ gauraḥ kartā sukhī duḥkhītyādi jñānameva hyavidyā saṃsārānarthahetutayā śrutismṛtinyāyasiddhā tasyāśca nivartikā nāhaṃ gaura ityādirūpā  #	aham gauraḥ kartā sukhī duḥkhī ityādi jñānam eva hi avidyā saṃsāra anartha hetutayā śruti smṛti nyāya siddhā tasyāḥ ca nivartikā na aham gauraḥ ityādi rūpā 
SA_GSP31_vijsamsu-84	vivekakhyātireva bhavati /	viveka khyātiḥ eva bhavati 
SA_GSP31_vijsamsu-85	samāne viṣaye grāhyābhāvatvaprakārakagrāhyābhāvajñānatvenaiva virodhāt /	samāne viṣaye grāhya abhāva tva prakāraka grāhya abhāva jñāna tvena eva virodhāt 
SA_GSP31_vijsamsu-86	anyathā śuktanirvikalpakasyāpi idaṃ rajatamiti jñānavirodhitvāpatteḥ /	anyathā śukta nirvikalpakasya api idam rajatam iti jñāna virodhi tva āpatteḥ 
SA_GSP31_vijsamsu-87	kiñca yatoktābhāvajñāne grāhyajñānavirodhitvasyāvaśyakatayā nirvikalpakajñānasya bhramanivartakatvaṃ na pṛthak kalpyate gauravāt /	kiñca yatas ukta abhāva jñāne grāhya jñāna virodhi tvasya āvaśyaka tayā nirvikalpaka jñānasya bhrama nivartaka tvam na pṛthak kalpyate gauravāt 
SA_GSP31_vijsamsu-88	api cāthā 'ta ādeśo neti neti na hyetasmāditi netyanyat paramastītyādiśrutyā vivekopadeśāpekṣayottamopadeśo nāstītyucyate /	api ca atha te ādeśaḥ na iti na iti na hi etasmāt iti na iti anyat param asti ityādi śrutyā viveka upadeśa apekṣayā uttama upadeśaḥ na asti iti ucyate 
SA_GSP31_vijsamsu-89	kṣetrakṣetrajñayorevamantaraṃ jñānacakṣuṣā /	kṣetra kṣetrajñayoḥ evam antaram jñānacakṣuṣā 
SA_GSP31_vijsamsu-90	bhūtaprakṛtimokṣaṃ ca ye viduryānti te param //	bhūta prakṛti mokṣam ca ye viduḥ yānti te param 
SA_GSP31_vijsamsu-91	iti gītādivākyaiśca vivekajñānasyaiva mokṣahetutvamucyate /	iti gītā ādi vākyaiḥ ca viveka jñānasya eva mokṣa hetu tvam ucyate 
SA_GSP31_vijsamsu-92	ato vivekajñānameva sākṣādavidyānivṛttyā mokṣahetuḥ /	atas viveka jñānam eva sākṣāt avidyā nivṛttyā mokṣa hetuḥ 
SA_GSP31_vijsamsu-93	yogena kevalātmasākṣātkārastu yogyānupalabdhividhayopādhyādigatadharmābhāvamupādhyādibhedaṃ ca grāhayati tato 'vidyānivṛttiriti /	yogena kevala ātma sākṣātkāraḥ tu yogya anupalabdhi vidhayā upādhi ādi gata dharma abhāvam upādhi ādi bhedam ca grāhayati tatas vidyā nivṛttiḥ iti 
SA_GSP31_vijsamsu-94	etena sarvabhūteṣu samatājñānamātmanaḥ sarvātmakatvādijñānaṃ ca śrutismṛtyorgīyamānaṃ vivekajñānasyaiva śeṣabhūtaṃ sarvadarśaneṣu mantavyam	etena sarva bhūteṣu sama tā jñānam ātmanaḥ sarva ātmaka tva ādi jñānam ca śruti smṛtyoḥ gīyamānam viveka jñānasya eva śeṣa bhūtam sarva darśaneṣu mantavyam 
SA_GSP31_vijsamsu-95	jñānāntarāṇāṃ sākṣādabhimānānivartakatvāt /	jñāna antarāṇām sākṣāt abhimāna a nivartaka tvāt 
SA_GSP31_vijsamsu-96	brahmamīmāṃsāyāṃ tvayaṃ viśeṣo yat paramātmavivekaśeṣatvam /	brahma mīmāṃsāyām tu ayam viśeṣaḥ yat paramātma viveka śeṣa tvam 
SA_GSP31_vijsamsu-97	sāṅkhyaśāstre tu sāmānyātmavivekaśeṣatvamiti dik /	sāṅkhya śāstre tu sāmānya ātma viveka śeṣa tvam iti diś 
SA_GSP31_vijsamsu-98	nanu yathoktavivekakhyātito 'pyatyantamavidyocchedo na ghaṭate /	nanu yathā ukta viveka khyātitaḥ pi atyantam avidyā ucchedaḥ na ghaṭate 
SA_GSP31_vijsamsu-99	vivekakhyāteravidyāpratibandhakatvamātratvena vivekakhyātināśottaraṃ punarabhimānasambhavāt /	viveka khyāteḥ avidyā pratibandhaka tva mātra tvena viveka khyāti nāśa uttaram punar abhimāna sambhavāt 
SA_GSP31_vijsamsu-100	śuktirajatavivekadarśino 'pi kālāntare śuktau rajatabhramavaditi /	śukti rajata viveka darśinaḥ pi kāla antare śuktau rajata bhrama vat iti 
SA_GSP31_vijsamsu-101	maivam /	mā evam 
SA_GSP31_vijsamsu-102	dṛṣṭāntavaiṣamyāt /	dṛṣṭānta vaiṣamyāt 
SA_GSP31_vijsamsu-103	śuktyādiṣu jāte 'pi sākṣātkāre dūratvādirūpaviṣayadoṣāṇāṃ paṭalādirūpakaraṇadoṣāṇāṃ cotpattisambhavena punarbhramo yuktaḥ /	śukti ādiṣu jāte sākṣātkāre dūra tva ādi rūpa viṣaya doṣāṇām paṭala ādi rūpa karaṇa doṣāṇām ca utpatti sambhavena punar bhramaḥ yuktaḥ 
SA_GSP31_vijsamsu-104	anātmanyātmābhimāne tvanādivāsanaiva doṣaḥ sarvāstikasammataḥ jātamātrasyābhimāne doṣāntarānupalabdheḥ /	anātmani ātma abhimāne tu anādi vāsanā eva doṣaḥ sarva āstika sammataḥ jāta mātrasya abhimāne doṣa antara anupalabdheḥ 
SA_GSP31_vijsamsu-105	sā mithyājñānavāsanā yadā vivekakhyātiparamparājanyadṛḍhavāsanonmūlitā tadaiva vivekasākṣātkāraniṣṭhocyate /	sā mithyājñāna vāsanā yadā viveka khyāti paramparā janya dṛḍha vāsanā unmūlitā tadā eva viveka sākṣātkāra niṣṭhā ucyate 
SA_GSP31_vijsamsu-106	tatpūrvamavaśyaṃ vāsanāleśato mithyāṃśasya kasyāpyātmani bhāvāt tasyāṃ ca vivekakhyātiniṣṭhāyāṃ jātāyāṃ na punarabhimānaḥ sambhavati vāsanākhyadoṣābhāvāditi  #	tat pūrvam avaśyam vāsanā leśataḥ mithyā aṃśasya kasya api ātmani bhāvāt tasyām ca viveka khyāti niṣṭhāyām jātāyām na punar abhimānaḥ sambhavati vāsanā ākhya doṣa abhāvāt iti 
SA_GSP31_vijsamsu-107	tu mahadvaiṣamyam /	tu mahat vaiṣamyam 
SA_GSP31_vijsamsu-108	yadi tu buddhipuruṣayoranyonyapratibimbanādikamavivekakāraṇaṃ doṣa iṣyate tadā tu	yadi tu buddhi puruṣayoḥ anyonya pratibimbana ādikam aviveka kāraṇam doṣaḥ iṣyate tadā tu 
SA_GSP31_vijsamsu-109	taddoṣaṃ bādhitvaiva vivekasākṣātkāra udita iti na tasya punarbhramahetutvaṃ phalabalena	tad doṣam bādhitvā eva viveka sākṣātkāraḥ uditaḥ iti na tasya punar bhrama hetu tvam phala balena 
SA_GSP31_vijsamsu-110	yogajadharmāsahakṛtasyaiva tasya doṣatvakalpanāsambhavāditi /	yoga ja dharma a sahakṛtasya eva tasya doṣa tva kalpanā asambhavāt iti 
SA_GSP31_vijsamsu-111	vivekakhyātiniṣṭhā ca gītādiṣu lakṣitā /	viveka khyāti niṣṭhā ca gīta ādiṣu lakṣitā 
SA_GSP31_vijsamsu-112	prakāśaṃ ca pravṛttiṃ ca mohameva ca pāṇḍava /	prakāśam ca pravṛttim ca moham eva ca pāṇḍava 
SA_GSP31_vijsamsu-113	na dveṣṭi sampravṛttāni na nivṛttāni kāṅkṣati //	na dveṣṭi sampravṛttāni na nivṛttāni kāṅkṣati 
SA_GSP31_vijsamsu-114	udāsīnavadāsīno guṇairyo na vicālyate /	udāsīna vat āsīnaḥ guṇaiḥ yaḥ na vicālyate 
SA_GSP31_vijsamsu-115	sarvārambhaparityāgī guṇātītaḥ sa ucyate //	sarva ārambha parityāgī guṇa atītaḥ saḥ ucyate 
SA_GSP31_vijsamsu-116	iti / guṇātīto nivṛttaguṇābhimānaḥ /	iti guṇa atītaḥ nivṛtta guṇa abhimānaḥ 
SA_GSP31_vijsamsu-117	adhikaṃ tu jñānilakṣaṇamagre vakṣyāmaḥ /	adhikam tu jñāni lakṣaṇam agre vakṣyāmaḥ 
SA_GSP31_vijsamsu-118	nanvevamapi vivekapratiyogipadārthānāmānantyena prātisvikarūpaiḥ sarvapadārthebhyo vivekagrahāsambhavāt kathaṃ vivekakhyātermokṣahetutvamiti  #	nanu evam api viveka pratiyogi padārthānām ānantyena prātisvika rūpaiḥ sarva padārthebhyaḥ viveka graha asambhavāt katham viveka khyāteḥ mokṣa hetu tvam iti 
SA_GSP31_vijsamsu-119	cenna /	ced na 
SA_GSP31_vijsamsu-120	dṛśyatvapariṇāmitvādisāmānyarūpairvivekagrahasambhavāt /	dṛśya tva pariṇāmi tva ādi sāmānya rūpaiḥ viveka graha sambhavāt 
SA_GSP31_vijsamsu-121	tathā hi /	tathā hi 
SA_GSP31_vijsamsu-122	draṣṭā svasākṣātprakāśebhyo bhinnaḥ prakāśakatvādyo yasya prakāśakaḥ sa tasmādbhinnaḥ	draṣṭā sva sākṣāt prakāśebhyaḥ bhinnaḥ prakāśaka tvāt yaḥ yasya prakāśakaḥ sa tasmāt bhinnaḥ 
SA_GSP31_vijsamsu-123	yathā ghaṭādāloko vṛttiprakāśyācca vṛttirityanumānenādāvantardṛśyebhyo buddhivṛttitadārūḍhārthebhyo	yathā ghaṭāt ālokaḥ vṛtti prakāśyāt ca vṛttiḥ iti anumānena ādau antar dṛśyebhyaḥ buddhi vṛtti tad ārūḍha arthebhyaḥ 
SA_GSP31_vijsamsu-124	vivekato buddhīsākṣī sidhyati /	        
SA_GSP31_vijsamsu-125	karmakartṛvirodhaścānukūlastarkaḥ /	karma kartṛ virodhaḥ ca anukūlaḥ tarkaḥ 
SA_GSP31_vijsamsu-126	atra ātmani vyabhicāravāraṇāya sākṣātpadam /	atra ātmani vyabhicāra vāraṇāya sākṣāt padam 
SA_GSP31_vijsamsu-127	vṛttidvāraivātmanaḥ svaviṣayatvāt /	vṛtti dvārā eva ātmanaḥ sva viṣaya tvāt 
SA_GSP31_vijsamsu-128	nanvatrānumāne buddhivṛttimātrādvivekaḥ sidhyatu /	nanu atra anumāne buddhi vṛtti mātrāt vivekaḥ sidhyatu 
SA_GSP31_vijsamsu-129	tasyā eva sākṣadātmadṛśyatvāt na prakṛtyādibhya iti cenna /	tasyāḥ eva sākṣat ātma dṛśya tvāt na prakṛti ādibhyaḥ iti ced na 
SA_GSP31_vijsamsu-130	vṛttīnāmajñātasattvābhāvena hyatrānumāne lāghavādvakṣyamāṇatarkagaṇāccākhilavṛttīnāṃ draṣṭā vibhukūṭasthanityaikajñānasvarūpatayaiva sidhyati	vṛttīnām ajñāta sattva abhāvena hi atra anumāne lāghavāt vakṣyamāṇa tarka gaṇāt ca akhila vṛttīnām draṣṭā vibhu kūṭastha nitya eka jñāna svarūpa tayā eva sidhyati 
SA_GSP31_vijsamsu-131	yathā naiyāyikānāṃ kṣitiḥ sakartṛkā kāryatvādityanumāne lāghavāt karturekatvanityatvādikaṃ tadvat /	yathā naiyāyikānām kṣitiḥ sa kartṛkā kārya tvāt iti anumāne lāghavāt kartuḥ ekatva nitya tva ādikam tadvat 
SA_GSP31_vijsamsu-132	tatra vibhutvaṃ paricchinnabhinnatvaṃ kūṭasthatvādikatvaṃ ca pariṇāmibhinnatvādikamato	tatra vibhu tvam paricchinna bhinna tvam kūṭastha tva ādika tvam ca pariṇāmi bhinna tva ādikam atas 
SA_GSP31_vijsamsu-133	buddhyātmanordṛgdṛśyarūpato vivekagrahe sati taduttarānumānena pariṇāmitvāpariṇāmitvādirūpaiḥ	buddhi ātmanoḥ dṛś dṛśya rūpataḥ viveka grahe sati tad uttara anumānena pariṇāmi tva apariṇāmi tva ādi rūpaiḥ 
SA_GSP31_vijsamsu-134	sāmānyato 'pyātmānātmavivekagraho ghaṭata iti /	sāmānyatas pi ātma anātma viveka grahaḥ ghaṭate iti 
SA_GSP31_vijsamsu-135	ataeva pātañjale sattvapuruṣānyatākhyātireva mokṣahetutayā sthale sthale vyāsabhāṣye proktā /	ataeva pātañjale sattva puruṣa anya tā khyātiḥ eva mokṣa hetu tayā sthale sthale vyāsa bhāṣye proktā 
SA_GSP31_vijsamsu-136	sattvapuruṣānyatākhyātirūpadṛgdṛśyavivekagrahottaraṃ yathoktarītyā prakṛtyādivivekagrahāt /	sattva puruṣa anya tā khyāti rūpa dṛś dṛśya viveka graha uttaram yathā ukta rītyā prakṛti ādi viveka grahāt 
SA_GSP31_vijsamsu-137	tatra ca sattvaśabde buddhisthatvena buddhisattvamuktamiti /	tatra ca sattva śabde buddhi stha tvena buddhi sattvam uktam iti 
SA_GSP31_vijsamsu-138	evaṃ ca prakṛtyādipadārthānāṃ viśiṣyajñānābhāve 'pi tadvivekajñānaṃ ghaṭate /	evam ca prakṛti ādi padārthānām viśiṣya jñāna abhāve tad viveka jñānam ghaṭate 
SA_GSP31_vijsamsu-139	etena dṛgdṛśyavivekādavidyānivṛttiriti prācāṃ pravādo 'pyupapāditaḥ /	etena dṛś dṛśya vivekāt avidyā nivṛttiḥ iti prācām pravādaḥ pi upapāditaḥ 
SA_GSP31_vijsamsu-140	kiñcātmā prakṛtitatkāryebhyo bhinno 'pariṇāmitvādityādyanumānairapi sāmānyato dṛśyaviveko draṣṭari sambhavatīti /	kiñca ātmā prakṛti tad kāryebhyaḥ bhinnaḥ pariṇāmi tvāt ityādi anumānaiḥ api sāmānyatas dṛśya vivekaḥ draṣṭari sambhavati iti 
SA_GSP31_vijsamsu-141	yattvādhunikā vedāntibruvā dṛśyatvenaiva prakṛtyādīnāṃ draṣṭṛtvena ca prakṛtyādyakhilajaḍebhya ātmavivekaṃ manyante /	yat tu ādhunikāḥ vedānti bruvāḥ dṛśya tvena eva prakṛti ādīnām draṣṭṛ tvena ca prakṛti ādi akhila jaḍebhyaḥ ātma vivekam manyante 
SA_GSP31_vijsamsu-142	ghaṭadraṣṭā ghaṭādbhinnaḥ sarvathā na ghaṭo yathā /	ghaṭa draṣṭā ghaṭāt bhinnaḥ sarvathā na ghaṭaḥ yathā 
SA_GSP31_vijsamsu-143	dehadraṣṭā tathā deho nāhamityādirūpataḥ //	deha draṣṭā tathā dehaḥ na aham ityādi rūpataḥ 
SA_GSP31_vijsamsu-144	tanna / ātmā vā 're draṣṭavya ityādiśrutibhirātmano 'pi dṛśyatvāt sākṣāddṛśyatvavivakṣayā ca prakṛtyāderasaṅgrahāt karaṇadvāraiva taddarśanāt	tat na ātmā vā re draṣṭavyaḥ ityādi śrutibhiḥ ātmanaḥ api dṛśya tvāt sākṣāt dṛśya tva vivakṣayā ca prakṛti ādeḥ asaṅgrahāt karaṇa dvārā eva tad darśanāt 
SA_GSP31_vijsamsu-145	athaivaṃ kalpanīyaṃ ātmano vṛttivyāpyatvameva dṛśyatvaṃ śrutyādibhirvidhīyate na tu prakāśyatvarūpaphalavyāpyatvam /	atha evam kalpanīyam ātmanaḥ vṛtti vyāpya tvam eva dṛśya tvam śruti ādibhiḥ vidhīyate na tu prakāśya tva rūpa phala vyāpya tvam 
SA_GSP31_vijsamsu-146	svayamprakāśasvarūpasya prakāśāpekṣāvirahāt /	svayam prakāśa svarūpasya prakāśa apekṣā virahāt 
SA_GSP31_vijsamsu-147	ato 'tra dṛśyatvaṃ prakāśyatvaṃ taccātmani nāstīti tadapi tuccham /	dṛśya tvam prakāśya tvam tat ca ātmani na asti iti tat api tuccham 
SA_GSP31_vijsamsu-148	yathā hyahamityanubhūyamāno 'pyātmā caitanyākhyaphalavyāpyo na bhavatīti bhavadbhirucyate	yathā hi aham iti anubhūyamānaḥ pi ātmā caitanya ākhya phala vyāpyaḥ na bhavati iti bhavadbhiḥ ucyate 
SA_GSP31_vijsamsu-149	tathaiva bauddhairapīṣyate sukhaduḥkhādimattvenāpi buddhiḥ svaprakāśatayā caitanyavyāpyā na bhavatīti /	tathā eva bauddhaiḥ api iṣyate sukha duḥkha ādimattvena api buddhiḥ sva prakāśa tayā caitanya vyāpyā na bhavati iti 
SA_GSP31_vijsamsu-150	tathā cātmanīva buddhāvapi dṛśyatvāsiddhyā dṛśyatvena rūpeṇa buddhiviveko 'tyantāpekṣito 'pi na sidhyatīti bhāṣyādiṣu cānyānyatra dūṣaṇānyuktānīti  #	tathā ca ātmani iva buddhau api dṛśya tva asiddhyā dṛśya tvena rūpeṇa buddhi vivekaḥ tyanta apekṣitaḥ na sidhyati iti bhāṣya ādiṣu ca anyāni atra dūṣaṇāni uktāni iti 
SA_GSP31_vijsamsu-151	dik /	diś 
SA_GSP31_vijsamsu-152	nanu sambhavatyevaṃ sāmānyarūpeṇa vivekagrahaḥ /	nanu sambhavati evam sāmānya rūpeṇa viveka grahaḥ 
SA_GSP31_vijsamsu-153	tathāpi sāmānyānyeva bahūni santi pariṇāmitvasaṃhatyakāritvasukhaduḥkhamohātmakatvacaturviṃśatitattvatvādīnyatastaistai rūpairvivekagrahāṇāṃ  #	tathā api sāmānyāni eva bahūni santi pariṇāmi tva saṃhatyakāri tva sukha duḥkha moha ātmaka tva caturviṃśati tattva tva ādīni atas taiḥ taiḥ rūpaiḥ viveka grahāṇām 
SA_GSP31_vijsamsu-154	mokṣahetutve 'nanugamadoṣa iti cenna /	mokṣa hetu tve nanugama doṣaḥ iti ced na 
SA_GSP31_vijsamsu-155	abhimānapratibandhakajñānatvenaivānugamāditi /	abhimāna pratibandhaka jñāna tvena eva anugamāt iti 
SA_GSP31_vijsamsu-156	athaivaṃ sāmānyarūpeṇa vivekasyaiva sarvābhimānanivartakatayā nāhaṃ deho nendriyāṇityādipratyekarūpairvivekagrahāṇāṃ mokṣahetutvaṃ śrutismṛtyorucyamānaṃ  #	atha evam sāmānya rūpeṇa vivekasya eva sarva abhimāna nivartaka tayā na aham dehaḥ na indriyāṇi ityādi pratyeka rūpaiḥ viveka grahāṇām mokṣa hetu tvam śruti smṛtyoḥ ucyamānam 
SA_GSP31_vijsamsu-157	kathaṃ ghaṭeteti cenna /	katham ghaṭeta iti ced na 
SA_GSP31_vijsamsu-158	avāntaravivekānāṃ sāmānyavivekaprapañcamātratvāditi //	avāntara vivekānām sāmānya viveka prapañca mātra tvāt iti 
SA_GSP31_vijsamsu-159	iti śrīvijñānabhikṣuviracite sāṅkhyasāre mokṣahetuvivekajñānasya svarūpasya paricchedaḥ // * // @-----------------------------------------------------------------------	iti śrī vijñānabhikṣu viracite sāṅkhyasāre mokṣa hetu viveka jñānasya svarūpasya paricchedaḥ 
SA_GSP31_vijsamsu-160	atha tṛtīyaḥ paricchedaḥ /	atha tṛtīyaḥ paricchedaḥ 
SA_GSP31_vijsamsu-161	atha ke te prakṛtyādayo yebhyaḥ puruṣo vivecanīya ityucyate /	atha ke te prakṛti ādayaḥ yebhyaḥ puruṣaḥ vivecanīyaḥ iti ucyate 
SA_GSP31_vijsamsu-162	prakṛtirbuddhyahaṅkārau tanmātraikādaśendriyam /	prakṛtiḥ buddhi ahaṅkārau tanmātra ekādaśa indriyam 
SA_GSP31_vijsamsu-163	bhūtāni ceti sāmānyāccaturviṃśatireva te //	bhūtāni ca iti sāmānyāt caturviṃśatiḥ eva te 
SA_GSP31_vijsamsu-164	eteṣveva dharmadharmyabhedena guṇakarmasāmānyānāmantarbhāvaḥ /	eteṣu eva dharma dharmya bhedena guṇa karma sāmānyānām antarbhāvaḥ 
SA_GSP31_vijsamsu-165	tatra prakṛtitvaṃ sākṣāt paramparayā 'khilavikāropādānatvaṃ prakṛṣṭākṛtiḥ pariṇāmarūpā 'syā iti vyutpatteḥ /	tatra prakṛti tvam sākṣāt paramparayā khila vikāra upādāna tvam prakṛṣṭa ākṛtiḥ pariṇāma rūpā syāḥ iti vyutpatteḥ 
SA_GSP31_vijsamsu-166	prakṛtiḥ śaktirajā pradhānamavyaktaṃ tamo māyā 'vidyetyādayaḥ prakṛteḥ paryāyāḥ /	prakṛtiḥ śaktiḥ ajā pradhānam avyaktam tamaḥ māyā vidyā ityādayaḥ prakṛteḥ paryāyāḥ 
SA_GSP31_vijsamsu-167	brāhmīti vidyā 'vidyeti māyeti ca tathā pare /	brāhmī iti vidyā vidyā iti māyā iti ca tathā pare 
SA_GSP31_vijsamsu-168	prakṛtiśca parā ceti vadanti paramarṣayaḥ //	prakṛtiḥ ca parā ca iti vadanti parama ṛṣayaḥ 
SA_GSP31_vijsamsu-169	iti smṛteḥ / sā ca sāmyāvasthayopalakṣitaṃ sattvādidravyatrayam /	iti smṛteḥ sā ca sāmya avasthayā upalakṣitam sattva ādi dravya trayam 
SA_GSP31_vijsamsu-170	kāryasattvādivāraṇāyopalakṣitāntam /	kārya sattva ādi vāraṇāya upalakṣita antam 
SA_GSP31_vijsamsu-171	sāmyāvasthā ca nyūnādhikabhāvenāsaṃhananāvasthā akāryāvastheti yāvat /	sāmya avasthā ca nyūna adhika bhāvena asaṃhanana avasthā akārya avasthā iti yāvat 
SA_GSP31_vijsamsu-172	mahadādikaṃ tu kāryasattvādikaṃ na kadā 'pyakāryāvasthaṃ bhavatīti tadvyāvṛttiḥ /	mahat ādikam tu kārya sattva ādikam na kadā pi akārya avastham bhavati iti tad vyāvṛttiḥ 
SA_GSP31_vijsamsu-173	vaiṣamyāvasthāyāmapi prakṛtitvasiddhaya upalakṣitamityuktam /	vaiṣamya avasthāyām api prakṛti tva siddhaye upalakṣitam iti uktam 
SA_GSP31_vijsamsu-174	akāryamiti tūpalakṣitāntasya niṣkṛṣṭārthaḥ /	akāryam iti tu upalakṣita antasya niṣkṛṣṭa arthaḥ 
SA_GSP31_vijsamsu-175	sattvādiguṇavatī sattvādyatiriktā prakṛtiriti na śaṅkanīyam /	sattva ādi guṇavatī sattva ādi atiriktā prakṛtiḥ iti na śaṅkanīyam 
SA_GSP31_vijsamsu-176	sattvādīnāmataddharmatvaṃ tadrūpatvāditi sāṅkhyasūtreṇa sattvādīnāṃ prakṛtisvarūpahetunā prakṛtidharmatvapratiṣedhāt /	sattva ādīnām a tad dharma tvam tad rūpa tvāt iti sāṅkhya sūtreṇa sattva ādīnām prakṛti svarūpa hetunā prakṛti dharma tva pratiṣedhāt 
SA_GSP31_vijsamsu-177	yogasūtratadbhāṣyābhyāmapi guṇānāmeva prakṛtitvavacanācca /	yogasūtra tad bhāṣyābhyām api guṇānām eva prakṛti tva vacanāt ca 
SA_GSP31_vijsamsu-178	guṇebhya eva kāryotpattau tadanyaprakṛtikalpanāvaiyarthyācca /	guṇebhyaḥ eva kārya utpattau tad anya prakṛti kalpanā vaiyarthyāt ca 
SA_GSP31_vijsamsu-179	prakṛterguṇā ityādivākyaṃ tu vanasya vṛkṣā itivad bodhyam /	prakṛteḥ guṇāḥ ityādi vākyam tu vanasya vṛkṣāḥ iti vat bodhyam 
SA_GSP31_vijsamsu-180	sattvaṃ rajastama iti prakṛterabhavan guṇāḥ /	sattvam rajaḥ tamaḥ iti prakṛteḥ abhavan guṇāḥ 
SA_GSP31_vijsamsu-181	iti sattvādīnāṃ prakṛtikāryatvavacanaṃ tu guṇanityatāvākyavirodhena mahattattvakāraṇībhūtakāryasattvādiparameva /	iti sattva ādīnām prakṛti kārya tva vacanam tu guṇa nitya tā vākya virodhena mahat tattva kāraṇī bhūta kārya sattva ādi param eva 
SA_GSP31_vijsamsu-182	mahadādisṛṣṭirhi guṇavaiṣamyāt śrūyate /	mahat ādi sṛṣṭiḥ hi guṇa vaiṣamyāt śrūyate 
SA_GSP31_vijsamsu-183	tacca vaiṣamyaṃ sajātīyasavalanena guṇāntaravyāvṛttaprakāśādiphalopahitaḥ sattvādivyavahārayogyaḥ pariṇāma iti /	tat ca vaiṣamyam sajātīya savalanena guṇa antara vyāvṛtta prakāśa ādi phala upahitaḥ sattva ādi vyavahāra yogyaḥ pariṇāmaḥ iti 
SA_GSP31_vijsamsu-184	etenāṣṭāviṃśatitattvapakṣo 'pyupapādito mantavyaḥ /	etena aṣṭāviṃśati tattva pakṣaḥ pi upapāditaḥ mantavyaḥ 
SA_GSP31_vijsamsu-185	vaiṣamya eva sattvādivyavahāraśca śrutau dṛśyate /	vaiṣamye eva sattva ādi vyavahāraḥ ca śrutau dṛśyate 
SA_GSP31_vijsamsu-186	yathā tama evedamagra āsa tatpareṇeritaṃ viṣamatvaṃ prayātyetad vai rajaso rūpaṃ khalvīritaṃ viṣamatvaṃ prayātyetad vai sattvasya rūpamiti	yathā tamaḥ eva idam agre āsa tat pareṇa īritam viṣama tvam prayāti etat vai rajasaḥ rūpam khalu īritam viṣama tvam prayāti etat vai sattvasya rūpam iti 
SA_GSP31_vijsamsu-187	sattvāditrayaṃ ca sukhaprakāśalāghavaprasādādiguṇavattayā /	sattva ādi trayam ca sukha prakāśa lāghava prasāda ādi guṇavat tayā 
SA_GSP31_vijsamsu-188	saṃyogavibhāgādimattayā 'nāśritatvopādānatvādinā ca draṣṭavye 'pi puruṣopakaraṇatvāt puruṣabandhakatvācca guṇaśabdenocyate /	saṃyoga vibhāga ādimattayā na āśrita tva upādāna tva ādinā ca draṣṭavye pi puruṣa upakaraṇa tvāt puruṣa bandhaka tvāt ca guṇa śabdena ucyate 
SA_GSP31_vijsamsu-189	indriyādivat /	indriya ādi vat 
SA_GSP31_vijsamsu-190	guṇānāṃ sukhaduḥkhamohātmakatvapravādastu dharmadharmyabhedāt /	guṇānām sukha duḥkha moha ātmaka tva pravādaḥ tu dharma dharmya bhedāt 
SA_GSP31_vijsamsu-191	manasaḥ saṅkalpātmakatvavat /	manasaḥ saṅkalpa ātmaka tva vat 
SA_GSP31_vijsamsu-192	tatra sattvaṃ sukhaprasādaprakāśādyanekadharmakaṃ prādhānyatastu sukhātmakamucyate /	tatra sattvam sukha prasāda prakāśa ādi aneka dharmakam prādhānyataḥ tu sukha ātmakam ucyate 
SA_GSP31_vijsamsu-193	evaṃ rajo 'pi duḥkhakāluṣyapravṛttyādyanekadharmakaṃ prādhānyatastu duḥkhātmakamucyate /	evam rajaḥ pi duḥkha kāluṣya pravṛtti ādi aneka dharmakam prādhānyataḥ tu duḥkha ātmakam ucyate 
SA_GSP31_vijsamsu-194	tathā tamo 'pi mohāvaraṇastambhanādyanekadharmakaṃ prādhānyatastu mohātmakamucyate /	tathā tamaḥ pi moha āvaraṇa stambhana ādi aneka dharmakam prādhānyataḥ tu moha ātmakam ucyate 
SA_GSP31_vijsamsu-195	ta eva dharmāsteṣāṃ lakṣaṇāni bhavanti /	te eva dharmāḥ teṣām lakṣaṇāni bhavanti 
SA_GSP31_vijsamsu-196	sattvādisañjñā cānvarthā /	sattva ādi sañjñā ca anvarthā 
SA_GSP31_vijsamsu-197	sato bhāvaḥ sattvamuttamatvamiti vyutpattyā hi dharmaprādhānyenottamaṃ puruṣopakaraṇaṃ sattvaśabdārthaḥ /	sataḥ bhāvaḥ sattvam uttama tvam iti vyutpattyā hi dharma prādhānyena uttamam puruṣa upakaraṇam sattva śabda arthaḥ 
SA_GSP31_vijsamsu-198	madhyamaṃ ca rajaḥśabdārtho rāgayogāt /	madhyamam ca rajaḥ śabda arthaḥ rāga yogāt 
SA_GSP31_vijsamsu-199	adhamaṃ ca tamaḥśabdārthaḥ /	adhamam ca tamaḥ śabda arthaḥ 
SA_GSP31_vijsamsu-200	adharmāvaraṇayogāt /	adharma āvaraṇa yogāt 
SA_GSP31_vijsamsu-201	tāni ca sattvādīni pratyekamasaṅkhyavyaktayaḥ /	tāni ca sattva ādīni pratyekam asaṅkhya vyaktayaḥ 
SA_GSP31_vijsamsu-202	laghutvādidharmairanyonyasādharmyaṃ vaidharmyaṃ ca guṇānāmiti sāṅkhyasūtrāt /	laghu tva ādi dharmaiḥ anyonya sādharmyam vaidharmyam ca guṇānām iti sāṅkhyasūtrāt 
SA_GSP31_vijsamsu-203	atra hi sūtre laghutvādinā bahūnāṃ sattvānāṃ sādharmyaṃ tenaiva rajastamobhyāṃ vaidharmyam /	atra hi sūtre laghu tva ādinā bahūnām sattvānām sādharmyam tena eva rajaḥ tamobhyām vaidharmyam 
SA_GSP31_vijsamsu-204	evaṃ calatvādinā gurutvādinā ca bahūnāṃ rajasāṃ bahūnāṃ ca tamasāṃ tadubhayamuktamiti /	evam calatva ādinā gurutva ādinā ca bahūnām rajasām bahūnām ca tamasām tat ubhayam uktam iti 
SA_GSP31_vijsamsu-205	kiñca yadi sattvāditrayamekaikavyaktireva syāt tat trayaṃ vibhveva vaktavyam /	kiñca yadi sattva ādi trayam ekaika vyaktiḥ eva syāt tat trayam vibhu eva vaktavyam 
SA_GSP31_vijsamsu-206	ekadā 'nekabrahmāṇḍādisṛṣṭiśravaṇāt /	ekadā aneka brahmāṇḍa ādi sṛṣṭi śravaṇāt 
SA_GSP31_vijsamsu-207	tathā ca kāryāṇāmanantavaicitryaṃ na ghaṭate /	tathā ca kāryāṇām ananta vaicitryam na ghaṭate 
SA_GSP31_vijsamsu-208	na ca saṃyogavaicitryādvaicitryaṃ syāditi vācyam /	na ca saṃyoga vaicitryāt vaicitryam syāt iti vācyam 
SA_GSP31_vijsamsu-209	vibhūnāṃ trayāṇāṃ guṇānāṃ svataḥ saṃyogavaicitryāsambhavāt /	vibhūnām trayāṇām guṇānām svatas saṃyoga vaicitrya asambhavāt 
SA_GSP31_vijsamsu-210	dravyāntarasya cāvacchedakībhūtasyābhāvāditi /	dravya antarasya ca avacchedakībhūtasya abhāvāt iti 
SA_GSP31_vijsamsu-211	tasmāt sattvādīnyasaṅkhyavyaktikānyeva dravyāṇi /	tasmāt sattva ādīni asaṅkhya vyaktikāni eva dravyāṇi 
SA_GSP31_vijsamsu-212	teṣu tritvavacanaṃ tu sattvatvādivibhājakopādhitrayeṇa vaiśeṣikāṇāṃ navadravyavacanavaditi siddham /	teṣu tri tva vacanam tu sattva tva ādi vibhājaka upādhi trayeṇa vaiśeṣikāṇām nava dravya vacana vat iti siddham 
SA_GSP31_vijsamsu-213	tāni ca sattvādīni yathāyogyamaṇuvibhuparimāṇakāni /	tāni ca sattva ādīni yathāyogyam aṇu vibhu parimāṇakāni 
SA_GSP31_vijsamsu-214	anyathā rajasaścalasvabhāvatvavacanavirodhāt /	anyathā rajasaḥ cala svabhāva tva vacana virodhāt 
SA_GSP31_vijsamsu-215	ākāśakāraṇatvasya ca vibhutvaucityāt /	ākāśa kāraṇa tvasya ca vibhu tva aucityāt 
SA_GSP31_vijsamsu-216	sarveṣāṃ kāraṇadravyāṇāṃ vibhutve kāryāṇāṃ paricchinnatvānupapatteśca /	sarveṣām kāraṇa dravyāṇām vibhu tve kāryāṇām paricchinna tva anupapatteḥ ca 
SA_GSP31_vijsamsu-217	nanvevaṃ vaiśeṣikoktānyeva pārthivāṇvādīni prakṛtirityāyāyamiti cenna /	nanu evam vaiśeṣika uktāni eva pārthiva aṇu ādīni prakṛtiḥ iti āya ayam iti ced na 
SA_GSP31_vijsamsu-218	gandhādiguṇaśūnyatvena kāraṇadravyeṣu pṛthivītvādyabhāvato 'smākaṃ viśeṣāt /	gandha ādi guṇa śūnya tvena kāraṇa dravyeṣu smākam viśeṣāt 
SA_GSP31_vijsamsu-219	taduktaṃ viṣṇupurāṇādiṣu //	tat uktam viṣṇu purāṇa ādiṣu 
SA_GSP31_vijsamsu-220	avyaktaṃ kāraṇaṃ yat tat pradhānamṛṣisattamaiḥ /	avyaktam kāraṇam yat tat pradhānam ṛṣi sattamaiḥ 
SA_GSP31_vijsamsu-221	procyate prakṛtiḥ sūkṣmā nityaṃ sadasadātmakam //	procyate prakṛtiḥ sūkṣmā nityam sat asat ātmakam 
SA_GSP31_vijsamsu-222	śabdasparśavihīnaṃ tadrūpādibhirasaṃyutam /	śabda sparśa vihīnam tad rūpa ādibhiḥ asaṃyutam 
SA_GSP31_vijsamsu-223	triguṇaṃ tajjagadyoniranādiprabhavāpyayam //	triguṇam tat jagat yoniḥ anādi prabhava apyayam 
SA_GSP31_vijsamsu-224	ityādinā /	ityādinā 
SA_GSP31_vijsamsu-225	vaiśeṣikāṇāṃ kāraṇadravyeṣu gandhādyanumānaṃ tu bhāṣye 'smābhirnirākṛtam /	vaiśeṣikāṇām kāraṇa dravyeṣu gandha ādi anumānam tu bhāṣye smābhiḥ nirākṛtam 
SA_GSP31_vijsamsu-226	athaivamapi prakṛteraṇuvibhusādhāraṇasattvādyanekavyaktirupatve 'paricchinnatvaikatvākriyatvasiddhāntakṣatiriti maivam /	atha evam api prakṛteḥ aṇu vibhu sādhāraṇa sattva ādi aneka vyakti rupatve paricchinna tva ekatva akriyatva siddhānta kṣatiḥ iti mā evam 
SA_GSP31_vijsamsu-227	kāraṇadravyatvarūpaprakṛtitvenaivāparicchinnatvavacanāt /	kāraṇa dravya tva rūpa prakṛti tvena eva aparicchinna tva vacanāt 
SA_GSP31_vijsamsu-228	gandhatvena gandhānāṃ pṛthivīvyāpakatāvat /	gandha tvena gandhānām pṛthivī vyāpaka tā vat 
SA_GSP31_vijsamsu-229	ākāśādiprakṛtīnāṃ vibhutvenaiva prakṛtivibhutvasiddhāntopapatteśca /	ākāśa ādi prakṛtīnām vibhu tvena eva prakṛti vibhu tva siddhānta upapatteḥ ca 
SA_GSP31_vijsamsu-230	tathā puruṣabhedena sargabhedena ca bhedābhāvasyaivaikaśabdārthatvāt /	tathā puruṣa bhedena sarga bhedena ca bheda abhāvasya eva eka śabda artha tvāt 
SA_GSP31_vijsamsu-231	ajāmekāmiti śrutitastathā 'vagamāt /	ajām ekām iti śrutitaḥ tathā vagamāt 
SA_GSP31_vijsamsu-232	athādhyavasāyābhimānādikriyārāhityasyaivākriyaśabdārthatvāt /	atha adhyavasāya abhimāna ādi kriyā rāhityasya eva akriya śabda artha tvāt 
SA_GSP31_vijsamsu-233	anyathā śrutismṛtiṣūktasya prakṛtikṣobhasyānupapatteriti /	anyathā śruti smṛtiṣu uktasya prakṛti kṣobhasya anupapatteḥ iti 
SA_GSP31_vijsamsu-234	prakṛtigatāścāpare viśeṣā bhāṣye draṣṭavyāḥ /	prakṛti gatāḥ ca apare viśeṣāḥ bhāṣye draṣṭavyāḥ 
SA_GSP31_vijsamsu-235	prakṛtyanumānaṃ cedam /	prakṛti anumānam ca idam 
SA_GSP31_vijsamsu-236	sukhaduḥkhamohātmakaṃ mahadādikāryaṃ sukhaduḥkhamohātmakadravyakāryaṃ sukhaduḥkhamohātmakatvāt vastrādikāryaśayyādivaditi /	sukha duḥkha moha ātmakam mahat ādi kāryam sukha duḥkha moha ātmaka dravya kāryam sukha duḥkha moha ātmaka tvāt vastra ādi kārya śayyā ādi vat iti 
SA_GSP31_vijsamsu-237	śrutismṛtī cātrānugrāhakastarkaḥ /	śruti smṛtī ca atra anugrāhakaḥ tarkaḥ 
SA_GSP31_vijsamsu-238	evaṃ sāmānyato 'numitāyāḥ prakṛterviśeṣāḥ śāstrādyogāccāvagantavyāḥ /	evam sāmānyataḥ numitāyāḥ prakṛteḥ viśeṣāḥ śāstrāt yogāt ca avagantavyāḥ 
SA_GSP31_vijsamsu-239	anumānasya sāmānyamātraviṣayakatvāt /	anumānasya sāmānya mātra viṣayaka tvāt 
SA_GSP31_vijsamsu-240	nanvantareva sukhādikamupalabhyate bāhyavastuṣu sukhādau kiṃ pramāṇaṃ yena dṛṣṭāntatā syāditi /	nanu antar eva sukha ādikam upalabhyate bāhya vastuṣu sukha ādau kim pramāṇam yena dṛṣṭānta tā syāt iti 
SA_GSP31_vijsamsu-241	ucyate /	ucyate 
SA_GSP31_vijsamsu-242	antaḥkaraṇasya sukhādihetutayā viṣayeṣu sukhādikaṃ sidhyati /	antaḥkaraṇasya sukha ādi hetutayā viṣayeṣu sukha ādikam sidhyati 
SA_GSP31_vijsamsu-243	na ca rūpādigatottamatvādikameva sukhādyutpādane niyāmakam /	na ca rūpa ādi gata uttama tva ādikam eva sukha ādi utpādane niyāmakam 
SA_GSP31_vijsamsu-244	uttamatvāderjātirūpatve nīlatvapītatvādinā jātisāṅkaryāpatteḥ /	uttama tva ādeḥ jāti rūpatve nīla tva pīta tva ādinā jāti sāṅkarya āpatteḥ 
SA_GSP31_vijsamsu-245	kālādibhedairekasyā eva rūpavyakteḥ sukhaduḥkhotpādakatvācca /	kāla ādi bhedaiḥ ekasyāḥ eva rūpa vyakteḥ sukha duḥkha utpādaka tvāt ca 
SA_GSP31_vijsamsu-246	ataḥ sukhādimattvamevottamatvādikam /	atas sukha ādimattvam eva uttama tva ādikam 
SA_GSP31_vijsamsu-247	kiñca ghaṭarūpamiti pratyayavat strīsukhaṃ candanasukhamityādipratyayādapi viṣaye sukhādyucitam /	kiñca ghaṭa rūpam iti pratyaya vat strī sukham candana sukham ityādi pratyayāt api viṣaye sukha ādi ucitam 
SA_GSP31_vijsamsu-248	adhikaṃ tu bhāṣye draṣṭavyam /	adhikam tu bhāṣye draṣṭavyam 
SA_GSP31_vijsamsu-249	tadevaṃ prakṛtirnirūpitā /	tat evam prakṛtiḥ nirūpitā 
SA_GSP31_vijsamsu-250	mahattattvaṃ nirūpyate /	mahat tattvam nirūpyate 
SA_GSP31_vijsamsu-251	prakṛteḥ sakāśādbuddhyākhyaṃ mahattattvaṃ jāyate /	prakṛteḥ sakāśāt buddhi ākhyam mahat tattvam jāyate 
SA_GSP31_vijsamsu-252	tasya dharmādirūpaprakṛṣṭaguṇayogān mahatsañjñā tadeva ca lakṣaṇam /	tasya dharma ādi rūpa prakṛṣṭa guṇa yogāt mahat sañjñā tat eva ca lakṣaṇam 
SA_GSP31_vijsamsu-253	mahān buddhiḥ prajñetyādayaśca tasya paryāyāḥ /	mahān buddhiḥ prajñā ityādayaḥ ca tasya paryāyāḥ 
SA_GSP31_vijsamsu-254	tathā coktamanugītāyām /	tathā ca uktam anugītāyām 
SA_GSP31_vijsamsu-255	mahānātmā matirviṣṇurjiṣṇuḥ śambhuśca vīryavān /	mahān ātmā matiḥ viṣṇuḥ jiṣṇuḥ śambhuḥ ca vīryavān 
SA_GSP31_vijsamsu-256	buddhiḥ prajñopalabdhiśca tathā brahmā dhṛtiḥ smṛtiḥ //	buddhiḥ prajñā upalabdhiḥ ca tathā brahmā dhṛtiḥ smṛtiḥ 
SA_GSP31_vijsamsu-257	paryāyavācakairetairmahānātmā nigadyate /	paryāya vācakaiḥ etaiḥ mahān ātmā nigadyate 
SA_GSP31_vijsamsu-258	sarvataḥ pāṇipādaśca sarvato 'kṣiśiromukhaḥ //	sarvatas pāṇi pādaḥ ca sarvatas kṣi śiraḥ mukhaḥ 
SA_GSP31_vijsamsu-259	sarvataḥ śrutimāṃlloke sarvaṃ vyāpya sa tiṣṭhati /	sarvatas śrutimān loke sarvam vyāpya sa tiṣṭhati 
SA_GSP31_vijsamsu-260	aṇimā laghimā prāptirīśāno jyotiravyayaḥ //	aṇimā laghimā prāptiḥ īśānaḥ jyotiḥ avyayaḥ 
SA_GSP31_vijsamsu-261	jñānavantaśca ye kecidalubdhā jitamanyavaḥ /	jñānavantaḥ ca ye kecid alubdhāḥ jita manyavaḥ 
SA_GSP31_vijsamsu-262	vimuktāḥ sarva evaite mahattvamupayāntyuta /	vimuktāḥ sarve eva ete mahā tvam upayānti uta 
SA_GSP31_vijsamsu-263	viṣṇurevādisargeṣu svayambhūrbhavati prabhuḥ //	viṣṇuḥ eva ādi sargeṣu svayambhūḥ bhavati prabhuḥ 
SA_GSP31_vijsamsu-264	iti / atra sattvādyaṃśatrayeṇa mahato devatātrayopādhitvāt tadavivekena brahmaviṣṇuśivatvavacanam /	iti atra sattva ādi aṃśa trayeṇa mahataḥ devatā traya upādhi tvāt tad avivekena brahma viṣṇu śiva tva vacanam 
SA_GSP31_vijsamsu-265	taduktaṃ viṣṇau /	tat uktam viṣṇau 
SA_GSP31_vijsamsu-266	sāttviko rājasaścaiva tāmasaśca tridhā mahān /	sāttvikaḥ rājasaḥ ca eva tāmasaḥ ca tridhā mahān 
SA_GSP31_vijsamsu-267	iti / mātsye ca /	iti mātsye ca 
SA_GSP31_vijsamsu-268	savikārāt pradhānāt tu mahattattvamajāyata /	sa vikārāt pradhānāt tu mahat tattvam ajāyata 
SA_GSP31_vijsamsu-269	mahāniti yataḥ khyātirlokānāṃ jāyate sadā //	mahān iti yatas khyātiḥ lokānām jāyate sadā 
SA_GSP31_vijsamsu-270	guṇebhyaḥ kṣobhyamāṇebhyastrayo devā vijajñire /	guṇebhyaḥ kṣobhyamāṇebhyaḥ trayaḥ devāḥ vijajñire 
SA_GSP31_vijsamsu-271	ekā mūrtistrayo devā brahmaviṣṇumaheśvarāḥ //	ekā mūrtiḥ trayaḥ devāḥ brahma viṣṇu maheśvarāḥ 
SA_GSP31_vijsamsu-272	iti / aṇimetyādibhāvanirdeśo dharmadharmyabhedāt /	iti aṇimā ityādi bhāva nirdeśaḥ dharma dharmya bhedāt 
SA_GSP31_vijsamsu-273	brahmaśaṅkarāpekṣayā 'pyādau viṣṇurūpeṇaiva mahānāvirbhavatīti viṣṇurevetyardhenoktam /	brahma śaṅkara apekṣayā pi ādau viṣṇu rūpeṇa eva mahān āvirbhavati iti viṣṇuḥ eva iti ardhena uktam 
SA_GSP31_vijsamsu-274	ekameva mahattattvamaṃśato rajastamaḥsambhedena pariṇataṃ sad vyaṣṭijīvānāmupādhiradharmādiyuktaṃ kṣudramapi bhavati /	ekam eva mahat tattvam aṃśataḥ rajaḥ tamaḥ sambhedena pariṇatam sat vyaṣṭi jīvānām upādhiḥ adharma ādi yuktam kṣudram api bhavati 
SA_GSP31_vijsamsu-275	mahaduparāgādviparītamiti sāṅkhyasūtrāt /	mahat uparāgāt viparītam iti sāṅkhyasūtrāt 
SA_GSP31_vijsamsu-276	mahattattvasya prādhānyenāsādhāraṇyena cādhyavasāyo vṛttiḥ /	mahat tattvasya prādhānyena asādhāraṇyena ca adhyavasāyaḥ vṛttiḥ 
SA_GSP31_vijsamsu-277	mahadahaṅkāramanastritayātmakasyāntaḥkaraṇasya mahattattvaṃ bījāvastheti /	mahat ahaṅkāra manaḥ tritaya ātmakasya antaḥkaraṇasya mahat tattvam bīja avasthā iti 
SA_GSP31_vijsamsu-278	atra prakṛtermahān mahato 'haṅkāra ityādisṛṣṭikrame śāstrameva pramāṇam /	atra prakṛteḥ mahān mahataḥ haṅkāraḥ ityādi sṛṣṭi krame śāstram eva pramāṇam 
SA_GSP31_vijsamsu-279	anumānena sāmānyataḥ kāryāṇāṃ sakāraṇakatvamātrasiddheḥ na tu sṛṣṭau bhūtādikramo vā 'ntaḥkaraṇādikramo vetyekataravadhārakamanumānaṃ sambhavati	anumānena sāmānyatas kāryāṇām sa kāraṇaka tva mātra siddheḥ na tu sṛṣṭau bhūta ādi kramaḥ vā ntaḥkaraṇa ādi kramaḥ vā iti ekatara avadhārakam anumānam sambhavati 
SA_GSP31_vijsamsu-280	spaṣṭaliṅgābhāvāt /	spaṣṭa liṅga abhāvāt 
SA_GSP31_vijsamsu-281	śrutismṛtyanugṛhītaṃ yathākathañcilliṅgaṃ tu mahadādikrame 'stīti bhāṣye 'smābhiḥ pradarśitam /	śruti smṛti anugṛhītam yathā kathañcid liṅgam tu mahat ādi krame sti iti bhāṣye smābhiḥ pradarśitam 
SA_GSP31_vijsamsu-282	mahattattvaṃ nirūpitam /	mahat tattvam nirūpitam 
SA_GSP31_vijsamsu-283	ahaṅkāro nirūpyate /	ahaṅkāraḥ nirūpyate 
SA_GSP31_vijsamsu-284	mahattattvādahaṅkāra utpadyate /	mahat tattvāt ahaṅkāraḥ utpadyate 
SA_GSP31_vijsamsu-285	aṅkurāt śākhāvat /	aṅkurāt śākhāvat 
SA_GSP31_vijsamsu-286	tasya cābhimānavṛttikatvādahaṅkārasañjñā /	tasya ca abhimāna vṛttika tvāt ahaṅkāra sañjñā 
SA_GSP31_vijsamsu-287	kumbhakārasañjñāvat /	kumbhakāra sañjñā vat 
SA_GSP31_vijsamsu-288	tadeva lakṣaṇam /	tat eva lakṣaṇam 
SA_GSP31_vijsamsu-289	tasya ca paryāyāḥ kaurme proktāḥ /	tasya ca paryāyāḥ kaurme proktāḥ 
SA_GSP31_vijsamsu-290	ahaṅkāro 'bhimānañca kartā mantā ca saṃsmṛtaḥ /	ahaṅkāraḥ bhimānaṃ ca kartā mantā ca saṃsmṛtaḥ 
SA_GSP31_vijsamsu-291	ātmā ca prakulo jīvo yataḥ sarvāḥ pravṛttayaḥ //	ātmā ca prakulaḥ jīvaḥ yatas sarvāḥ pravṛttayaḥ 
SA_GSP31_vijsamsu-292	iti / sa cāhaṅkārastrividhatayā trividhakāryahetuḥ /	iti sa ca ahaṅkāraḥ trividha tayā trividha kārya hetuḥ 
SA_GSP31_vijsamsu-293	taduktaṃ kaurme /	tat uktam kaurme 
SA_GSP31_vijsamsu-294	vaikārikastaijasaśca bhūtādiścaiva tāmasaḥ /	vaikārikaḥ taijasaḥ ca bhūtādiḥ ca eva tāmasaḥ 
SA_GSP31_vijsamsu-295	trividho 'yamahaṅkāro mahataḥ sambabhūva ha //	trividhaḥ yam ahaṅkāraḥ mahataḥ sambabhūva ha 
SA_GSP31_vijsamsu-296	taijasādindriyāṇi syurdevā vaikārikāddaśa /	taijasāt indriyāṇi syuḥ devāḥ vaikārikāt daśa 
SA_GSP31_vijsamsu-297	ekādaśaṃ manaścātra svaguṇenobhayātmakam //	ekādaśam manaḥ ca atra sva guṇena ubhaya ātmakam 
SA_GSP31_vijsamsu-298	bhūtatanmātrasargastu bhūtāderabhavan prajāḥ /	bhūta tanmātra sargaḥ tu bhūtādeḥ abhavan prajāḥ 
SA_GSP31_vijsamsu-299	iti / vaikārikaḥ sāttvikaḥ /	iti vaikārikaḥ sāttvikaḥ 
SA_GSP31_vijsamsu-300	taijaso rājasaḥ /	taijasaḥ rājasaḥ 
SA_GSP31_vijsamsu-301	svaguṇenindriyavṛttiṣu sāhāyyarūpeṇotkarṣeṇa /	sva guṇena indriya vṛttiṣu sāhāyya rūpeṇa utkarṣeṇa 
SA_GSP31_vijsamsu-302	ubhayātmakaṃ jñānakarmobhayendriyātmakam /	ubhaya ātmakam jñāna karma ubhaya indriya ātmakam 
SA_GSP31_vijsamsu-303	anyatramanā abhūvaṃ nā 'śrauṣamityādiśrutyā manaso jñānakarmobhayendriyasahakāritvasiddheriti /	anyatramanāḥ abhūvam nā śrauṣam ityādi śrutyā manasaḥ jñāna karma ubhaya indriya sahakāri tva siddheḥ iti 
SA_GSP31_vijsamsu-304	ekādaśendriyadevāśca /	ekādaśa indriya devāḥ ca 
SA_GSP31_vijsamsu-305	digvātārkapracetośvivahnīndropendramitrakāḥ /	diś vāta arka praceta uśvi vahni indra upendra mitrakāḥ 
SA_GSP31_vijsamsu-306	candraśca	candraḥ ca 
SA_GSP31_vijsamsu-307	iti / ahaṅkāro nirūpitaḥ /	iti ahaṅkāraḥ nirūpitaḥ 
SA_GSP31_vijsamsu-308	indriyādīni nirūpyante /	indriya ādīni nirūpyante 
SA_GSP31_vijsamsu-309	ahaṅkārādādau mana utpadyate /	ahaṅkārāt ādau manaḥ utpadyate 
SA_GSP31_vijsamsu-310	śabdarāgācchrotramasya jāyate bhāvitātmanaḥ /	śabda rāgāt śrotram asya jāyate bhāvitātmanaḥ 
SA_GSP31_vijsamsu-311	rūparāgāt tathā cakṣurghrāṇaṃ gandhajighṛkṣayā //	rūpa rāgāt tathā cakṣuḥ ghrāṇam gandha jighṛkṣayā 
SA_GSP31_vijsamsu-312	ityādinā mokṣadharmādāvindriyādīnāṃ manovṛttirāgādikāryatvaśravaṇāt /	ityādinā mokṣa dharma ādau indriya ādīnām manaḥ vṛtti rāga ādi kārya tva śravaṇāt 
SA_GSP31_vijsamsu-313	tataścāhaṅkārāt saṅkalpapūrvakaṃ daśendriyāṇi pañcatanmātrāni cotpadyante /	tatas ca ahaṅkārāt saṅkalpa pūrvakam daśa indriyāṇi pañca tanmātrāni ca utpadyante 
SA_GSP31_vijsamsu-314	indriyatanmātrayośca kāryakāraṇabhāvasyābhāvāt kramaniyamo nāsti /	indriya tanmātrayoḥ ca kārya kāraṇa bhāvasya abhāvāt krama niyamaḥ na asti 
SA_GSP31_vijsamsu-315	tatrendriyeṣu nāstyavāntarakāryakāraṇabhāvaḥ pramāṇābhāvāt /	tatra indriyeṣu na asti avāntara kārya kāraṇa bhāvaḥ pramāṇa abhāvāt 
SA_GSP31_vijsamsu-316	tanmātreṣu tvasti /	tanmātreṣu tu asti 
SA_GSP31_vijsamsu-317	sa yathā /	sa yathā 
SA_GSP31_vijsamsu-318	śabdatanmātrādvakṣyamāṇakrameṇa sparśatanmātraṃ śabdasparśobhayaguṇakamevaṃ krameṇaikaikaguṇavṛddhyā	śabda tanmātrāt vakṣyamāṇa krameṇa sparśa tanmātram śabda sparśa ubhaya guṇakam evam krameṇa ekaika guṇa vṛddhyā 
SA_GSP31_vijsamsu-319	paratanmātratrayaṃ pūrvapūrvatanmātrebhya utpadyate pātañjalabhāṣye tanmātreṣu krameṇaikaikaguṇavṛddhivacanāt /	para tanmātra trayam pūrva pūrva tanmātrebhyaḥ utpadyate pātañjala bhāṣye tanmātreṣu krameṇa ekaika guṇa vṛddhi vacanāt 
SA_GSP31_vijsamsu-320	tataśca pañcatanmātrebhyaḥ pañcabhūtāni jāyante /	tatas ca pañcatanmātrebhyaḥ pañcabhūtāni jāyante 
SA_GSP31_vijsamsu-321	tatrāhaṅkārāt pañcatanmātrāṇāṃ taddvārā bhūtānāṃ cotpattau kramaḥ kūrmaviṣṇvādipurāṇeṣūktaḥ /	tatra ahaṅkārāt pañca tanmātrāṇām tad dvārā bhūtānām ca utpattau kramaḥ kūrma viṣṇu ādi purāṇeṣu uktaḥ 
SA_GSP31_vijsamsu-322	yathā kūrme /	yathā kūrme 
SA_GSP31_vijsamsu-323	bhūtādistu vikurvāṇaḥ śabdamātraṃ sasarja ha /	bhūtādiḥ tu vikurvāṇaḥ śabda mātram sasarja ha 
SA_GSP31_vijsamsu-324	ākāśaṃ suṣiraṃ tasmādutpannaṃ śabdalakṣaṇam //	ākāśam suṣiram tasmāt utpannam śabda lakṣaṇam 
SA_GSP31_vijsamsu-325	ākāśastu vikurvāṇaḥ sparśamātraṃ sasarja ha /	ākāśaḥ tu vikurvāṇaḥ sparśa mātram sasarja ha 
SA_GSP31_vijsamsu-326	vāyurutpadyate tasmāt tasya sparśo guṇo mataḥ //	vāyuḥ utpadyate tasmāt tasya sparśaḥ guṇaḥ mataḥ 
SA_GSP31_vijsamsu-327	ityādikrameṇeti /	ityādi krameṇa iti 
SA_GSP31_vijsamsu-328	nanvevamākāśādibhūtacatuṣṭayasyāpi tattvāntarārambhakatvena prakṛtitvāpattyā kevalavikṛtitvasiddhāntakṣatiriti cenna /	nanu evam ākāśa ādi bhūta catuṣṭayasya api tattva antara ārambhaka tvena prakṛti tva āpattyā kevala vikṛti tva siddhānta kṣatiḥ iti ced na 
SA_GSP31_vijsamsu-329	ākāśādīnāṃ sparśāditanmātreṣvahaṅkāropaṣṭambhamātreṇa kāraṇatvasya purāṇeṣūktatvāditi /	ākāśa ādīnām sparśa ādi tanmātreṣu ahaṅkāra upaṣṭambha mātreṇa kāraṇa tvasya purāṇeṣu ukta tvāt iti 
SA_GSP31_vijsamsu-330	tadevaṃ trayoviṃśatitattvānāmutpattiruktā /	tat evam trayoviṃśati tattvānām utpattiḥ uktā 
SA_GSP31_vijsamsu-331	tatra pañcabhūtāni varjayitvā 'haṅkāraṃ ca buddhau praveśya saptadaśakaṃ liṅgaśarīrasañjñaṃ bhavati vahnerindhanavadātmano 'bhivyaktisthānatvāt	tatra pañcabhūtāni varjayitvā haṅkāram ca buddhau praveśya saptadaśakam liṅga śarīra sañjñam bhavati vahneḥ indhana vat ātmanaḥ bhivyakti sthāna tvāt 
SA_GSP31_vijsamsu-332	tacca sarvapuruṣāṇāṃ sargādāvutpadya prākṛtapralayaparyantaṃ tiṣṭhati /	tat ca sarva puruṣāṇām sarga ādau utpadya prākṛta pralaya paryantam tiṣṭhati 
SA_GSP31_vijsamsu-333	tenaiva cehalokaparalokayoḥ saṃsaraṇaṃ jīvānāṃ bhavati /	tena eva ca ihaloka paralokayoḥ saṃsaraṇam jīvānām bhavati 
SA_GSP31_vijsamsu-334	prāṇaśca buddhereva vṛttibheda ityato na liṅgaśarīrāt pṛthaṅ nirdiśyate /	prāṇaḥ ca buddheḥ eva vṛtti bhedaḥ iti atas na liṅga śarīrāt pṛthak nirdiśyate 
SA_GSP31_vijsamsu-335	tasya liṅgaśarīrasya sūkṣmāṇi pañcabhūtānyāśrayaścitrādivadāśrayaṃ vinā paramasūkṣmasya lokāntaragamanāsambhavāt /	tasya liṅgaśarīrasya sūkṣmāṇi pañcabhūtāni āśrayaḥ citra ādi vat āśrayam vinā parama sūkṣmasya loka antara gamana asambhavāt 
SA_GSP31_vijsamsu-336	idaṃ ca liṅgaśarīramādau svayambhuva upādhibhūtamekameva jāyate /	idam ca liṅga śarīram ādau svayambhuvaḥ upādhi bhūtam ekam eva jāyate 
SA_GSP31_vijsamsu-337	tasyaiva virāḍākhyavakṣyamāṇasthūlaśarīravat /	tasya eva virāṭ ākhya vakṣyamāṇa sthūlaśarīra vat 
SA_GSP31_vijsamsu-338	tataśca vyaṣṭijīvānāmupādhibhūtāni vyaṣṭiliṅgaśarīrāṇi tadaṃśabhūtāni tato vibhajyante /	tatas ca vyaṣṭi jīvānām upādhi bhūtāni vyaṣṭi liṅga śarīrāṇi tad aṃśa bhūtāni tatas vibhajyante 
SA_GSP31_vijsamsu-339	piturliṅgaśarīrāt putraliṅgaśarīravat /	pituḥ liṅga śarīrāt putra liṅga śarīra vat 
SA_GSP31_vijsamsu-340	taduktaṃ sūtrakāreṇa /	tat uktam sūtrakāreṇa 
SA_GSP31_vijsamsu-341	vyaktibhedaḥ karmaviśeṣāditi /	vyakti bhedaḥ karma viśeṣāt iti 
SA_GSP31_vijsamsu-342	manunā 'pyuktam /	manunā pi uktam 
SA_GSP31_vijsamsu-343	teṣāṃ tvavayavān sūkṣmān ṣaṇṇāmapyamitaujasām /	teṣām tu avayavān sūkṣmān ṣaṇṇām api amita ojasām 
SA_GSP31_vijsamsu-344	sanniveśyātmamātrāsu sarvabhūtāni nirmame //	sanniveśya ātma mātrāsu sarva bhūtāni nirmame 
SA_GSP31_vijsamsu-345	iti / ṣaṇṇāmiti ṣaḍindriyaṃ samastaliṅgaśarīropalakṣakam /	iti ṣaṇṇām iti ṣaṣ indriyam samasta liṅga śarīra upalakṣakam 
SA_GSP31_vijsamsu-346	tathā ca svayambhūḥ svaliṅgaśarīrāvayavān sūkṣmān alpān ātmamātrāsu svāṃśacetaneṣu saṃyojya sarvaprāṇinaḥ sasarjetyarthaḥ /	tathā ca svayambhūḥ sva liṅga śarīra avayavān sūkṣmān alpān ātma mātrāsu sva aṃśa cetaneṣu saṃyojya sarva prāṇinaḥ sasarja iti arthaḥ 
SA_GSP31_vijsamsu-347	liṅgaśarīraṃ nirūpitam /	liṅga śarīram nirūpitam 
SA_GSP31_vijsamsu-348	sthūlaśarīrotpattirucyate /	sthūlaśarīra utpattiḥ ucyate 
SA_GSP31_vijsamsu-349	daśaguṇitamahattattvamadhye 'haṅkāro 'haṅkārasyāpi daśaguṇitasya madhye vyoma vyomno	daśa guṇita mahat tattva madhye haṅkāraḥ haṅkārasya api daśa guṇitasya madhye vyoma vyomnaḥ 
SA_GSP31_vijsamsu-350	'pi daśaguṇitasya madhye vāyurvāyorapi daśaguṇitasya madhye tejaḥ tejaso 'pi daśaguṇitasya	daśa guṇitasya madhye vāyuḥ vāyoḥ api daśa guṇitasya madhye tejaḥ daśa guṇitasya 
SA_GSP31_vijsamsu-351	madhye jalaṃ jalasyāpi daśaguṇitasya madhye pṛthivī samutpadyate /	madhye jalam jalasya api daśa guṇitasya madhye pṛthivī samutpadyate 
SA_GSP31_vijsamsu-352	saiva sthūlaśarīrasya bījam /	sā eva sthūlaśarīrasya bījam 
SA_GSP31_vijsamsu-353	tadeva ca pṛthivīrūpaṃ bījamaṇḍarūpeṇa pariṇamate /	tat eva ca pṛthivī rūpam bīja maṇḍa rūpeṇa pariṇamate 
SA_GSP31_vijsamsu-354	tasyāpi daśaguṇitasyāṇḍarūpasya pṛthivyāvaraṇasya madhye caturdaśabhuvanātmakaṃ svayambhuvaṃ sthūlaśarīraṃ tatsaṅkalpādevotpadyate /	tasya api daśa guṇitasya aṇḍa rūpasya pṛthivī āvaraṇasya madhye caturdaśa bhuvana ātmakam svayambhuvam sthūlaśarīram tad saṅkalpāt eva utpadyate 
SA_GSP31_vijsamsu-355	tenaiva śarīreṇa svayambhūrnārāyaṇa ityucyate /	tena eva śarīreṇa svayambhūḥ nārāyaṇaḥ iti ucyate 
SA_GSP31_vijsamsu-356	taduktaṃ manunā svayambhuvaṃ prakṛtya /	tat uktam manunā svayambhuvam prakṛtya 
SA_GSP31_vijsamsu-357	so 'bhidhyāya śarīrāt svāt sisṛkṣurvividhāḥ prajāḥ /	saḥ abhidhyāya śarīrāt svāt sisṛkṣuḥ vividhāḥ prajāḥ 
SA_GSP31_vijsamsu-358	apa eva sasarjādau tāsu bījamavāsṛjat //	apaḥ eva sasarja ādau tāsu bījam avāsṛjat 
SA_GSP31_vijsamsu-359	tadaṇḍamabhavaddhaimaṃ sahasrāṃśusamaprabham /	tat aṇḍam abhavat haimam sahasrāṃśu sama prabham 
SA_GSP31_vijsamsu-360	tasmin jajñe svayaṃ brahmā sarvalokapitāmahaḥ //	tasmin jajñe svayam brahmā sarva loka pitāmahaḥ 
SA_GSP31_vijsamsu-361	sa vai śarīrī prathamaḥ sa vai puruṣa ucyate /	sa vai śarīrī prathamaḥ sa vai puruṣaḥ ucyate 
SA_GSP31_vijsamsu-362	ādikartā sa bhūtānāṃ brahmāgre samavartata //	ādikartā sa bhūtānām brahma agre samavartata 
SA_GSP31_vijsamsu-363	āpe nārā iti proktā āpo vai narasūnavaḥ /	nārāḥ iti proktāḥ āpaḥ vai nara sūnavaḥ 
SA_GSP31_vijsamsu-364	tā yadasyāyanaṃ pūrvaṃ tena nārāyaṇaḥ smṛtaḥ //	tāḥ yat asya ayanam pūrvam tena nārāyaṇaḥ smṛtaḥ 
SA_GSP31_vijsamsu-365	ityādineti /	ityādinā iti 
SA_GSP31_vijsamsu-366	tata eva cādipuruṣāt vyaṣṭipuruṣāṇāṃ vibhāgādante ca tatraiva layāt sa eva caika ātmeti śrutismṛtyorvyavahriyate /	tatas eva ca ādi puruṣāt vyaṣṭi puruṣāṇām vibhāgāt ante ca tatra eva layāt saḥ eva ca ekaḥ ātmā iti śruti smṛtyoḥ vyavahriyate 
SA_GSP31_vijsamsu-367	ato na vyavahāraparatayā nārāyaṇa eva sarvabhūtānāmātmeti śrutismṛtivirodha iti /	atas na vyavahāra para tayā nārāyaṇaḥ eva sarva bhūtānām ātmā iti śruti smṛti virodhaḥ iti 
SA_GSP31_vijsamsu-368	tataśca sa nārāyaṇo virāṭ śarīrī svanābhikamalakarṇikāsthānīyasya sumerorupari caturmukhākhyasvayambhuvaṃ sṛṣṭvā taddvārā 'nyānapi vyaṣṭiśarīriṇaḥ  #	tatas ca sa nārāyaṇaḥ virāj śarīrī sva nābhi kamala karṇikā sthānīyasya sumeroḥ upari caturmukha ākhya svayambhuvam sṛṣṭvā tad dvārā nyān api vyaṣṭi śarīriṇaḥ  /
SA_GSP31_vijsamsu-369	sthāvarāntān sasarja /	sthāvara antān sasarja 
SA_GSP31_vijsamsu-370	tathā ca smaryate /	tathā ca smaryate 
SA_GSP31_vijsamsu-371	taccharīrasamutpannaiḥ kāryaistaiḥ karaṇaiḥ saha /	tad śarīra samutpannaiḥ kāryaiḥ taiḥ karaṇaiḥ saha 
SA_GSP31_vijsamsu-372	kṣetrajñāḥ samajāyanta gātrebhyastasya dhīmataḥ //	kṣetrajñāḥ samajāyanta gātrebhyaḥ tasya dhīmataḥ 
SA_GSP31_vijsamsu-373	iti / yattu śeṣaśāyino nārāyaṇasya nābhikamalaśrotracakṣurādibhyaścaturmukhasyāvirbhāvaḥ śrūyate taddainandinasargeṣveva kalpabhedena mantavyam	iti yat tu śeṣa śāyinaḥ nārāyaṇasya nābhi kamala śrotra cakṣuḥ ādibhyaḥ caturmukhasya āvirbhāvaḥ śrūyate tat dainandina sargeṣu eva kalpa bhedena mantavyam 
SA_GSP31_vijsamsu-374	dainandinapralayeṣveva hi nārāyaṇaśarīre praviśyaikībhūya suptānāṃ devānāṃ caturmukhādikrameṇāvirbhāvaḥ śeṣaśāyinaḥ sakāśādghaṭate na tvādisargeṣu	dainandina pralayeṣu eva hi nārāyaṇa śarīre praviśya ekībhūya suptānām devānām caturmukha ādi krameṇa āvirbhāvaḥ śeṣa śāyinaḥ sakāśāt ghaṭate na tu ādi sargeṣu 
SA_GSP31_vijsamsu-375	dainandinapralaya eva līlāvigraheṇa śayanāditi /	eva līlā vigraheṇa śayanāt iti 
SA_GSP31_vijsamsu-376	tadevaṃ saṅkṣepataścaturviṃśatitattvāni teṣāṃ sṛṣṭirūpaṃ prayojanaṃ coktam /	tat evam saṅkṣepataḥ caturviṃśati tattvāni teṣām sṛṣṭi rūpam prayojanam ca uktam 
SA_GSP31_vijsamsu-377	tatra yadyasmājjāyate tasya tadāpūraṇenaiva sthitiḥ tatastasya saṃhāro 'pi tatraiva bhavati /	tatra yat yasmāt jāyate tasya tad āpūraṇena eva sthitiḥ tatas tasya saṃhāraḥ tatra eva bhavati 
SA_GSP31_vijsamsu-378	yadyasmājjāyate tattvaṃ tattatra pravilīyate /	yat yasmāt jāyate tattvam tat tatra pravilīyate 
SA_GSP31_vijsamsu-379	līyante pratilomāni jāyante cottarottaram //	līyante pratilomāni jāyante ca uttarottaram 
SA_GSP31_vijsamsu-380	iti bhāratādibhya iti /	iti bhārata ādibhyaḥ iti 
SA_GSP31_vijsamsu-381	ete ca sṛṣṭisthitisaṃhārarūpāḥ sthūlā eva pariṇāmāścaturviṃśatitattvānāṃ kūṭasthapuruṣavivekāya pradarśitāḥ /	ete ca sṛṣṭi sthiti saṃhāra rūpāḥ sthūlāḥ eva pariṇāmāḥ caturviṃśati tattvānām kūṭastha puruṣa vivekāya pradarśitāḥ 
SA_GSP31_vijsamsu-382	sūkṣmā apyanye pratikṣaṇapariṇāmā eteṣāṃ smaryante / tathā /	sūkṣmāḥ api anye prati kṣaṇa pariṇāmāḥ eteṣām smaryante tathā 
SA_GSP31_vijsamsu-383	nityadā hyaṅgabhūtāni bhavanti na bhavanti ca /	nityadā hi aṅga bhūtāni bhavanti na bhavanti ca 
SA_GSP31_vijsamsu-384	kālenālakṣyavegena sūkṣmatvāttanna dṛśyate //	kālena alakṣya vegena sūkṣma tvāt tat na dṛśyate 
SA_GSP31_vijsamsu-385	iti / ataśca sarvaṃ jaḍavastu paramārthataḥ sarvadaivāsaducyate /	iti atas ca sarvam jaḍa vastu paramārthataḥ sarvadā eva asat ucyate 
SA_GSP31_vijsamsu-386	tataśca tasmādvirajyātmaiva paramārthasatyo duḥkhabhīrubhirdraṣṭavyaḥ /	tatas ca tasmāt virajya ātmā eva paramārtha satyaḥ duḥkha bhīrubhiḥ draṣṭavyaḥ 
SA_GSP31_vijsamsu-387	taduktamanugītāyām /	tat uktam anugītāyām 
SA_GSP31_vijsamsu-388	avyaktabījaprabhavo budhiskandhamayo mahān /	avyakta bīja prabhavaḥ budhi skandha mayaḥ mahān 
SA_GSP31_vijsamsu-389	mahāhaṅkāraviṭapa indriyāṅkurakoṭaraḥ //	mahā ahaṅkāra viṭapaḥ indriya aṅkura koṭaraḥ 
SA_GSP31_vijsamsu-390	mahābhūtapraśākhaśca viśeṣapratiśākhavān /	mahābhūta praśākhaḥ ca viśeṣa pratiśākhavān 
SA_GSP31_vijsamsu-391	sadāparṇaḥ sadāpuṣpaḥ śubhāśubhaphalodayaḥ //	             
SA_GSP31_vijsamsu-392	ājīvaḥ sarvabhūtānāṃ brahmavṛttaḥ sanātanaḥ /	ājīvaḥ sarva bhūtānām brahma vṛttaḥ sanātanaḥ 
SA_GSP31_vijsamsu-393	etajjñātvā ca tattvena jñānena paramāsinā //	etat jñātvā ca tattvena jñānena parama asinā 
SA_GSP31_vijsamsu-394	chittvā cākṣaratāṃ prāpya jahāti mṛtyujanmanī /	chittvā ca akṣara tām prāpya jahāti mṛtyu janmanī 
SA_GSP31_vijsamsu-395	iti śrīvijñānabhikṣuviracite sāṅkhyasāre vivekapratiyogināṃ prakṛtyādīnāṃ svarūpaparicchedaḥ // * //	iti śrī vijñānabhikṣu viracite sāṅkhyasāre viveka pratiyoginām prakṛti ādīnām svarūpa paricchedaḥ 
SA_GSP31_vijsamsu-396	iti sāṅkhyasārasya pūrvabhāgaḥ // @-----------------------------------------------------------------------	iti sāṅkhya sārasya pūrva bhāgaḥ 
SA_GSP31_vijsamsu-397	athottarabhāgaḥ //	atha uttarabhāgaḥ 
SA_GSP31_vijsamsu-398	prathamaḥ paricchedaḥ //	prathamaḥ paricchedaḥ 
SA_GSP31_vijsamsu-399	atha śiṣyaiḥ sukhenaiva grahītuṃ padyamālayā /	atha śiṣyaiḥ sukhena eva grahītum padya mālayā 
SA_GSP31_vijsamsu-400	vivekasyānuyogyātmā puruṣākhyo nirūpyate // ViSs_2,1.1 //	vivekasya anuyogī ātmā puruṣa ākhyaḥ nirūpyate 
SA_GSP31_vijsamsu-401	tatra sāmānyataḥ siddho jāne 'hamiti dhībalāt /	tatra sāmānyatas siddhaḥ jāne ham iti dhī balāt 
SA_GSP31_vijsamsu-402	draṣṭā 'to nityavibhvādidharmaireva sa sādhyate // ViSs_2,1.2 //	nitya vibhu ādi dharmaiḥ eva sa sādhyate 
SA_GSP31_vijsamsu-403	bhoktā nityastadarthatvāt tatkarmotpāditatvataḥ /	bhoktā nityaḥ tad artha tvāt tad karma utpādita tvataḥ 
SA_GSP31_vijsamsu-404	mahadādivikārāṇāṃ sarveṣāmaviśeṣataḥ // ViSs_2,1.3 //	mahat ādi vikārāṇām sarveṣām aviśeṣatas 
SA_GSP31_vijsamsu-405	api cādṛṣṭasaṃskārādhāratvādbījarūpataḥ /	api ca adṛṣṭa saṃskāra ādhāra tvāt bīja rūpataḥ 
SA_GSP31_vijsamsu-406	dhīranādirato 'syāśca siddhā bhokturanāditā // ViSs_2,1.4 //	dhīḥ anādiḥ atas syāḥ ca siddhā bhoktuḥ anādi tā 
SA_GSP31_vijsamsu-407	svasvāmibhāvānāditvamṛte bhoktṛvyavasthiteḥ /	sva svāmi bhāva anādi tvam ṛte bhoktṛ vyavasthiteḥ 
SA_GSP31_vijsamsu-408	svabhaktavṛttisaṃskāravattvaṃ svatvaṃ tu buddhiṣu // ViSs_2,1.5 //	sva bhakta vṛtti saṃskāravat tvam sva tvam tu buddhiṣu 
SA_GSP31_vijsamsu-409	svāmyaṃ svaniṣṭhasaṃskārahetuvṛtteśca bhoktari /	svāmyam sva niṣṭha saṃskāra hetu vṛtteḥ ca bhoktari 
SA_GSP31_vijsamsu-410	ataśca ghaṭate svatvanāśe kaivalyamātmanaḥ // ViSs_2,1.6 //	atas ca ghaṭate sva tva nāśe kaivalyam ātmanaḥ 
SA_GSP31_vijsamsu-411	bhoktuścānādibhāvasya vināśe hetvasambhavāt /	bhoktuḥ ca anādi bhāvasya vināśe hetu asambhavāt 
SA_GSP31_vijsamsu-412	na nāśo bhokturastīti bhoktā nityo hi sidhyati // ViSs_2,1.7 //	na nāśaḥ bhoktuḥ asti iti bhoktā nityaḥ hi sidhyati 
SA_GSP31_vijsamsu-413	janyo jñānaprakāśo 'sya nityatve tu na yujyate /	janyaḥ jñāna prakāśaḥ sya nitya tve tu na yujyate 
SA_GSP31_vijsamsu-414	na hyaprakāśe kutrāpi prakāśotpattirīkṣyate // ViSs_2,1.8 //	na hi aprakāśe kutra api prakāśa utpattiḥ īkṣyate 
SA_GSP31_vijsamsu-415	kārye prakāśākhyaguṇe 'vayavānāṃ hi tadguṇaḥ /	kārye prakāśa ākhya guṇe vayavānām hi tad guṇaḥ 
SA_GSP31_vijsamsu-416	kāraṇaṃ tena nānityaḥ prakāśo nityavastuni // ViSs_2,1.9 //	kāraṇam tena na anityaḥ prakāśaḥ nitya vastuni 
SA_GSP31_vijsamsu-417	prakāśāśrayasaṃyogāt prakāśabhūma indhane /	prakāśa āśraya saṃyogāt prakāśa bhūmaḥ indhane 
SA_GSP31_vijsamsu-418	ādarśe cāvṛterbhaṅgāt prakāśotpattivibhramaḥ // ViSs_2,1.10 //	ādarśe ca āvṛteḥ bhaṅgāt prakāśa utpatti vibhramaḥ 
SA_GSP31_vijsamsu-419	tasmānnityātmano jñānaṃ nityaṃ vācyaṃ tathā sati /	tasmāt nitya ātmanaḥ jñānam nityam vācyam tathā sati 
SA_GSP31_vijsamsu-420	lāghavājjñānamevātmā nirādhāraḥ prakalpyate // ViSs_2,1.11 //	lāghavāt jñānam eva ātmā nirādhāraḥ prakalpyate 
SA_GSP31_vijsamsu-421	anāśritatayā dravyaṃ saṃyogādeśca tanmatam /	anāśrita tayā dravyam saṃyoga ādeḥ ca tat matam 
SA_GSP31_vijsamsu-422	ato jñāne 'hamityādibuddhirapyupapadyate // ViSs_2,1.12 //	atas jñāne ham ityādi buddhiḥ api upapadyate 
SA_GSP31_vijsamsu-423	piṇḍe 'handhīrhi mūḍhānāṃ dhruvaivānādidoṣataḥ /	piṇḍe handhīḥ hi mūḍhānām dhruvā evā anādi doṣataḥ 
SA_GSP31_vijsamsu-424	saṃyogāttatra piṇḍe tu jñānavattvamatiḥ pramā // ViSs_2,1.13 //	saṃyogāt tatra piṇḍe tu jñānavat tva matiḥ pramā 
SA_GSP31_vijsamsu-425	santu vā '; 'dheyatā 'lpatvajanmanāśādibuddhayaḥ /	santu vā dheya tā alpa tva janma nāśa ādi buddhayaḥ 
SA_GSP31_vijsamsu-426	śrotrasya nabhasīvārthajñānasya jñānamātrake // ViSs_2,1.14 //	śrotrasya nabhasi iva artha jñānasya jñāna mātrake 
SA_GSP31_vijsamsu-427	tasmāllāghavatarkeṇa bādhakābhāvatastathā /	tasmāt lāghava tarkeṇa bādhaka abhāvataḥ tathā 
SA_GSP31_vijsamsu-428	śrutyādibhiśca nityātmā cidrūpeṇaiva sidhyati // ViSs_2,1.15 //	śruti ādibhiḥ ca nitya ātmā cit rūpeṇa eva sidhyati 
SA_GSP31_vijsamsu-429	tajjñānaṃ vibhu nityatvāddehavyāpitayā 'pi ca /	tat jñānam vibhu nitya tvāt deha vyāpi tayā ca 
SA_GSP31_vijsamsu-430	madhyatve nāśitā hi syādaṇutve vā 'lpadeśatā // ViSs_2,1.16 //	madhya tve nāśitā hi syāt aṇu tve vā alpa deśa tā 
SA_GSP31_vijsamsu-431	vibhutve 'pi svadhīvṛttereva sākṣānnirīkṣaṇāt /	vibhu tve sva dhī vṛtteḥ eva sākṣāt nirīkṣaṇāt 
SA_GSP31_vijsamsu-432	na sarvatra sadā sarvabhānaṃ jñāne prasajyate // ViSs_2,1.17 //	na sarvatra sadā sarva bhānam jñāne prasajyate 
SA_GSP31_vijsamsu-433	arthabhānaṃ citāvarthapratibimbo mato budhaiḥ /	artha bhānam citau artha pratibimbaḥ mataḥ budhaiḥ 
SA_GSP31_vijsamsu-434	vṛttereva cittau sākṣātpratibimbanayogyatā // ViSs_2,1.18 //	vṛtteḥ eva cittau sākṣāt pratibimbana yogya tā 
SA_GSP31_vijsamsu-435	ato 'saṅge 'pi kūṭasthacaitanye vibhuni dhruve /	atas saṅge kūṭastha caitanye vibhuni dhruve 
SA_GSP31_vijsamsu-436	vṛttidvārakamevānyabhānaṃ phalabalān matam // ViSs_2,1.19 //	vṛtti dvārakam evā anya bhānam phala balāt matam 
SA_GSP31_vijsamsu-437	anvayavyatirekābhyāṃ vṛttijanyatayā 'khilaḥ /	anvaya vyatirekābhyām vṛtti janya tayā khilaḥ 
SA_GSP31_vijsamsu-438	vṛtyaikādhikaraṇyena kāmādirdhīṣu nātmasu // ViSs_2,1.20 //	vṛtyā eka adhikaraṇyena kāma ādiḥ dhīṣu na ātmasu 
SA_GSP31_vijsamsu-439	ato 'ntaḥsvavikārāṇāṃ svasvabuddhiṣvavasthiteḥ /	atas ntar sva vikārāṇām sva sva buddhiṣu avasthiteḥ 
SA_GSP31_vijsamsu-440	kūṭāstha eva sarvo 'pi cidākāśagaṇaḥ samaḥ // ViSs_2,1.21 //	kūṭāsthaḥ eva sarvaḥ cit ākāśa gaṇaḥ samaḥ 
SA_GSP31_vijsamsu-441	nityaśuddho nityabuddho nityamukto nirañjanaḥ /	          
SA_GSP31_vijsamsu-442	svaprakāśo nirādhāraḥ pradīpaḥ sarvavastuṣu // ViSs_2,1.22 //	sva prakāśaḥ nirādhāraḥ pradīpaḥ sarva vastuṣu 
SA_GSP31_vijsamsu-443	nanvevamekataivāstu lāghavādātmanāṃ svavat /	nanu evam ekatā evā astu lāghavāt ātmanām sva vat 
SA_GSP31_vijsamsu-444	dhīṣveva sukhaduḥkhādivaidharmyāditi cenna tat // ViSs_2,1.23 //	dhīṣu eva sukha duḥkha ādi vaidharmyāt iti ced na tat 
SA_GSP31_vijsamsu-445	bhogābhogādivaidharmyeṇaikarūpe 'pi cidgaṇe /	bhoga abhoga ādi vaidharmyeṇa eka rūpe cit gaṇe 
SA_GSP31_vijsamsu-446	śrutismṛtibhyāmuktena bhedasiddheḥ parasparam // ViSs_2,1.24 //	śruti smṛtibhyām uktena bheda siddheḥ parasparam 
SA_GSP31_vijsamsu-447	sukhādipratibimbhātmā bhogo 'pyasya na vastutaḥ /	sukha ādi pratibimbha ātmā bhogaḥ pi asya na vastutas 
SA_GSP31_vijsamsu-448	tathā 'pyasya citau bhāvābhāvau syātāṃ hi bhedakau // ViSs_2,1.25 //	tathā pi asya citau bhāva abhāvau syātām hi bhedakau 
SA_GSP31_vijsamsu-449	aupādhikau yathā śyāmarāgau sphaṭikabhedakau /	aupādhikau yathā śyāma rāgau sphaṭika bhedakau 
SA_GSP31_vijsamsu-450	svadṛṣṭāntaśca viṣamo vaidharmyāsiddhito 'mbare // ViSs_2,1.26 //	sva dṛṣṭāntaḥ ca viṣamaḥ vaidharmya asiddhitaḥ mbare 
SA_GSP31_vijsamsu-451	iti śrīvijñānabhikṣuviracite sāṅkhyasāre puruṣasvarūpaparicchedaḥ // * // @----------------------------------------------------------------------	iti śrī vijñānabhikṣu viracite sāṅkhyasāre puruṣa svarūpa paricchedaḥ 
SA_GSP31_vijsamsu-452	atha dvitīyaḥ paricchedaḥ //	atha dvitīyaḥ paricchedaḥ 
SA_GSP31_vijsamsu-453	athātmānātmavaidharmye guṇadoṣātmake tayoḥ /	atha ātma anātma vaidharmye guṇa doṣa ātmake tayoḥ 
SA_GSP31_vijsamsu-454	vakṣye vistārato yena viveko 'tisphuṭo bhavet // ViSs_2,2.1 //	vakṣye vistārataḥ yena ti sphuṭaḥ bhavet 
SA_GSP31_vijsamsu-455	sāmānyātmaghanākāśe sānnidhyeritaśaktibhiḥ /	sāmānya ātma ghana ākāśe sānnidhya īrita śaktibhiḥ 
SA_GSP31_vijsamsu-456	jāyate līyate bhūtvā bhūyo 'yaṃ jagadambudaḥ // ViSs_2,2.2 //	jāyate līyate bhūtvā bhūyas yam jagat ambudaḥ 
SA_GSP31_vijsamsu-457	triguṇātmakaśaktīnāṃ pariṇāmairataścitiḥ /	triguṇa ātmaka śaktīnām pariṇāmaiḥ atas citiḥ 
SA_GSP31_vijsamsu-458	ādhāravidhayā viśvopādānamavikārataḥ // ViSs_2,2.3 //	ādhāra vidhayā viśva upādānam avikārataḥ 
SA_GSP31_vijsamsu-459	yathā '; 'dharatayā toyaṃ dharopādānamiṣyate /	yathā dhara tayā toyam dharā upādānam iṣyate 
SA_GSP31_vijsamsu-460	svasthapārthivatanmātradvāreṇaivaṃ citirmatā // ViSs_2,2.4 //	svastha pārthiva tanmātra dvāreṇa evam citiḥ matā 
SA_GSP31_vijsamsu-461	ato jagadupādānamapi brahmāvikārataḥ /	atas jagat upādānam api brahma avikārataḥ 
SA_GSP31_vijsamsu-462	kūṭasthanityaparyāyaparamārthasaducyate // ViSs_2,2.5 //	kūṭastha nitya paryāya paramārtha sat ucyate 
SA_GSP31_vijsamsu-463	svārthatvāt svānubhūtyā ca siddhatvāt paramārthasat /	sva artha tvāt sva anubhūtyā ca siddha tvāt paramārtha sat 
SA_GSP31_vijsamsu-464	svataḥ sthityā svataḥ siddhyā lokaiḥ sanniti hīryate // ViSs_2,2.6 //	svatas sthityā svatas siddhyā lokaiḥ san iti hi īryate 
SA_GSP31_vijsamsu-465	pratikṣaṇavikāreṇa taistai rūpairapāyataḥ /	prati kṣaṇa vikāreṇa taiḥ taiḥ rūpaiḥ apāyataḥ 
SA_GSP31_vijsamsu-466	prakṛtyādirasat sarvo jaḍārtho 'bdhau taraṅgavat // ViSs_2,2.7 //	prakṛti ādiḥ asat sarvaḥ jaḍa arthaḥ bdhau taraṅga vat 
SA_GSP31_vijsamsu-467	yattu kālāntareṇāpi nānyasañjñāmupaiti vai /	yat tu kāla antareṇa api na anya sañjñām upaiti vai 
SA_GSP31_vijsamsu-468	pariṇāmādisambhūtāṃ tadvastvityādikasmṛteḥ // ViSs_2,2.8 //	pariṇāma ādi sambhūtām tat vastu iti ādika smṛteḥ 
SA_GSP31_vijsamsu-469	parārthādhīnasattvācca paradṛṣṭyā ca siddhitaḥ /	parārtha adhīna sattvāt ca para dṛṣṭyā ca siddhitaḥ 
SA_GSP31_vijsamsu-470	parataḥ sannasanneva tatparāpekṣayā mataḥ // ViSs_2,2.9 //	paratas sanna san eva tad para apekṣayā mataḥ 
SA_GSP31_vijsamsu-471	sato 'stitvaṃ tu nāsattā nāstitve satyatā kutaḥ /	sataḥ stitvam tu na asattā nāstitve satyatā kutas 
SA_GSP31_vijsamsu-472	iti gāruḍataścaivaṃ sadasattvavyavasthiteḥ // ViSs_2,2.10 //	iti gāruḍataḥ ca evam sat asat tva vyavasthiteḥ 
SA_GSP31_vijsamsu-473	ato na sannāsadidaṃ jagat sadasadātmakam /	atas na sat na asat idam jagat sat asat ātmakam 
SA_GSP31_vijsamsu-474	asadviṣayakatvācca tasya dhīstāttviko bhramaḥ // ViSs_2,2.11 //	asat viṣayaka tvāt ca tasya dhīḥ tāttvikaḥ bhramaḥ 
SA_GSP31_vijsamsu-475	jagadvṛkṣasya caitanyaṃ sāro 'sārastathetarat /	jagat vṛkṣasya caitanyam sāraḥ sāraḥ tathā itarat 
SA_GSP31_vijsamsu-476	prapañcasya sthirāṃśo hi citirevāvikārataḥ // ViSs_2,2.12 //	prapañcasya sthira aṃśaḥ hi citiḥ eva avikārataḥ 
SA_GSP31_vijsamsu-477	tadanyadakhilaṃ tucchamasāratvādudīryate /	tat anyat akhilam tuccham asāra tvāt udīryate 
SA_GSP31_vijsamsu-478	tathā 'nṛtamasaccāpi tadapekṣāsthiratvataḥ // ViSs_2,2.13 //	tathā tad apekṣā sthira tvataḥ 
SA_GSP31_vijsamsu-479	evaṃvidhaivātmasattā anyāsattā ca darśitā /	evaṃvidhā eva ātma sattā anya asattā ca darśitā 
SA_GSP31_vijsamsu-480	vāsiṣṭhādau vistarato yathā leśāttaducyate // ViSs_2,2.14 //	vāsiṣṭha ādau vistarataḥ yathā leśāt tat ucyate 
SA_GSP31_vijsamsu-481	svapno jāgratyasadrūpaḥ svapne jāgradasadvapuḥ /	svapnaḥ jāgrati asat rūpaḥ svapne jāgrat asat vapuḥ 
SA_GSP31_vijsamsu-482	mṛtirjanmanyasadrūpā mṛtau janmāpyasanmayam // ViSs_2,2.15 //	mṛtiḥ janmani asat rūpā mṛtau janma api asat mayam 
SA_GSP31_vijsamsu-483	jaganmayī bhrāntiriti na kadāpi na vidyate /	jagat mayī bhrāntiḥ iti na kadāpi na vidyate 
SA_GSP31_vijsamsu-484	vidyate na kadācicca jalabudbudavat sthitam // ViSs_2,2.16 //	vidyate na kadācid ca jala budbuda vat sthitam 
SA_GSP31_vijsamsu-485	ātmaivāsti paraṃ satyaṃ nānyāḥ saṃsāradṛṣṭayaḥ /	ātmā eva asti param satyam na anyāḥ saṃsāra dṛṣṭayaḥ 
SA_GSP31_vijsamsu-486	śuktikārajataṃ yadvadyathā marumarīcikā // ViSs_2,2.17 //	śuktikārajatam yadvat yathā marumarīcikā 
SA_GSP31_vijsamsu-487	asti sarvagataṃ śāntaṃ paramātmaghanaṃ śuci /	asti sarva gatam śāntam paramātma ghanam śuci 
SA_GSP31_vijsamsu-488	acintyacinmātravapuḥ paramākāśamātatam // ViSs_2,2.18 //	acintya cit mātra vapuḥ parama ākāśam ātatam 
SA_GSP31_vijsamsu-489	tatsarvagaṃ sarvaśakti sarvaṃ sarvātmakaṃ svayam /	tat sarvagam sarva śakti sarvam sarva ātmakam svayam 
SA_GSP31_vijsamsu-490	yatra yatra yathodeti yathā ';	yatra yatra yathā udeti yathā 
SA_GSP31_vijsamsu-491	'ste tatra tatra vai // ViSs_2,2.19 //	ste tatra tatra vai 
SA_GSP31_vijsamsu-492	āvirbhāvatirobhāvamayāstribhuvanormayaḥ /	āvirbhāva tirobhāva mayāḥ tribhuvana ūrmayaḥ 
SA_GSP31_vijsamsu-493	sphurantyatitate yasmin marāviva marīcayaḥ // ViSs_2,2.20 //	sphuranti atitate yasmin marau iva marīcayaḥ 
SA_GSP31_vijsamsu-494	asateva satī toyanadyeva laharī calā /	asatā iva satī toya nadyā iva laharī calā 
SA_GSP31_vijsamsu-495	manasevendrajālaśrīrjāgatī pravitanyate // ViSs_2,2.21 //	manasā iva indrajāla śrīḥ jāgatī pravitanyate 
SA_GSP31_vijsamsu-496	brahmaṇā tanyate viśvaṃ manasaiva svayambhuvā /	brahmaṇā tanyate viśvam manasā eva svayambhuvā 
SA_GSP31_vijsamsu-497	manomayamato viśvaṃ yannāma paridṛśyate // ViSs_2,2.22 //	manaḥ mayam atas viśvam yat nāma paridṛśyate 
SA_GSP31_vijsamsu-498	yo hyaśuddhamatirmūḍho rūḍho na vitate pade /	yaḥ hi aśuddha matiḥ mūḍhaḥ rūḍhaḥ na vitate pade 
SA_GSP31_vijsamsu-499	vajrasāramidaṃ tasya jagadastyasadeva sat // ViSs_2,2.23 //	vajra sāram idam tasya jagat asti asat eva sat 
SA_GSP31_vijsamsu-500	avyutpannasya kanake kānake kaṭake yathā /	avyutpannasya kanake kānake kaṭake yathā 
SA_GSP31_vijsamsu-501	kaṭakajñaptirevāsti na manāgapi hemadhīḥ // ViSs_2,2.24 //	kaṭaka jñaptiḥ evā asti na manāk api hema dhīḥ 
SA_GSP31_vijsamsu-502	tathā 'jñasya purāgāranaganāgendrabhāsurā /	tathā jñasya pura āgāra naga nāga indra bhāsurā 
SA_GSP31_vijsamsu-503	iyaṃ dṛśyadṛgevāsti na tvanyā paramārthadṛk // ViSs_2,2.25 //	iyam dṛśya dṛś evā asti na tu anyā paramārtha dṛś 
SA_GSP31_vijsamsu-504	ityādivākyairvāsiṣṭhe nātyantāsatyatoditā /	ityādi vākyaiḥ vāsiṣṭhe na atyanta asatya tā uditā 
SA_GSP31_vijsamsu-505	jagato 'paravākyairhi satkāryaṃ prākṛtaṃ matam // ViSs_2,2.26 //	para vākyaiḥ hi satkāryam prākṛtam matam 
SA_GSP31_vijsamsu-506	nāmarūpavinirmuktaṃ yasmin santiṣṭhate jagat /	nāma rūpa vinirmuktam yasmin santiṣṭhate jagat 
SA_GSP31_vijsamsu-507	tamāhuṃ prakṛtiṃ kecin māyāmeke 'pare tvaṇūn // ViSs_2,2.27 //	tam āhum prakṛtim kecid māyām eke pare tu aṇūn 
SA_GSP31_vijsamsu-508	suṣuptāvasthayā cakrapadmarekhāśilodare /	suṣupta avasthayā cakra padma rekhā śilā udare 
SA_GSP31_vijsamsu-509	yathā sthitā citerantastatheyaṃ jagadāvalī // ViSs_2,2.28 //	yathā sthitā citeḥ antar tathā iyam jagat āvalī 
SA_GSP31_vijsamsu-510	prakṛtivratatirvyomni jātā brahmāṇḍasatphalā /	prakṛti vratatiḥ vyomni jātā brahmāṇḍa sat phalā 
SA_GSP31_vijsamsu-511	ityādivākyaiḥ sāṅkhyīyasatkāryādyupavarṇanāt // ViSs_2,2.29 //	ityādi vākyaiḥ sāṅkhyīya satkārya ādi upavarṇanāt 
SA_GSP31_vijsamsu-512	iti śrīvijñānabhikṣuviracite sāṅkhyasāre ātmānātmanoḥ satyatvāsatyatvavaidharmyaparicchedaḥ // * // @----------------------------------------------------------------------	iti śrī vijñānabhikṣu viracite sāṅkhyasāre ātma anātmanoḥ satya tva asatya tva vaidharmya paricchedaḥ 
SA_GSP31_vijsamsu-513	atha tṛtīyaḥ paricchedaḥ //	atha tṛtīyaḥ paricchedaḥ 
SA_GSP31_vijsamsu-514	tadevātmanaḥ sattā darśitā 'nyavilakṣaṇā /	tat eva ātmanaḥ sattā darśitā 
SA_GSP31_vijsamsu-515	atha cidrūpatāṃ vakṣye buddhivṛttivilakṣaṇām // ViSs_2,3.1 //	atha cit rūpa tām vakṣye buddhi vṛtti vilakṣaṇām 
SA_GSP31_vijsamsu-516	anubhūtiścitirbodho vedanaṃ cocyate pumān /	anubhūtiḥ citiḥ bodhaḥ vedanam ca ucyate pumān 
SA_GSP31_vijsamsu-517	vedyaṃ jaḍaṃ tamo 'jñānaṃ pradhānādikamucyate // ViSs_2,3.2 //	vedyam jaḍam tamaḥ jñānam pradhāna ādikam ucyate 
SA_GSP31_vijsamsu-518	vedanaṃ vedyasambandhādeva vettrabhidhīyate /	vedanam vedya sambandhāt eva vettā abhidhīyate 
SA_GSP31_vijsamsu-519	yathā prakāśyasambandhāt prakāśo 'pi prakāśakaḥ // ViSs_2,3.3 //	yathā prakāśya sambandhāt prakāśaḥ pi prakāśakaḥ 
SA_GSP31_vijsamsu-520	yathā vā 'rthoparāgeṇa bhānamarthasya bhāsakam /	yathā vā rtha uparāgeṇa bhānam arthasya bhāsakam 
SA_GSP31_vijsamsu-521	evaṃ vedyoparaktasyāsvāṃśasyādhāratāṃ 'śini // ViSs_2,3.4 //	evam vedya uparaktasya a sva aṃśasya ādhāra tām śini 
SA_GSP31_vijsamsu-522	asaṅgāyāṃ citau vedyoparāgo 'yaṃ na dhīṣviva /	asaṅgāyām citau vedya uparāgaḥ yam na dhīṣu iva 
SA_GSP31_vijsamsu-523	kintu sākṣāddvārato vā citi tatpratibimbanam // ViSs_2,3.5 //	kintu sākṣāt dvārataḥ vā citi tat pratibimbanam 
SA_GSP31_vijsamsu-524	bāhyaṃ vṛttyākhyakaraṇābhāvādanuparāgataḥ /	bāhyam vṛtti ākhya karaṇa abhāvāt anuparāgataḥ 
SA_GSP31_vijsamsu-525	citirnaivekṣate cetyaṃ vibhutve 'pi ca sarvataḥ // ViSs_2,3.6 //	citiḥ na eva īkṣate cetyam vibhu tve ca sarvatas 
SA_GSP31_vijsamsu-526	tathā cidapi vṛttyākhyakaraṇābhāvato 'rthavat /	tathā cit api vṛtti ākhya karaṇa abhāvataḥ rtha vat 
SA_GSP31_vijsamsu-527	svagocarāṃ vṛttimṛte tiṣṭhatyajñātasattayā // ViSs_2,3.7 //	sva gocarām vṛttim ṛte tiṣṭhati ajñāta sattayā 
SA_GSP31_vijsamsu-528	tadevaṃ cinnirākārā prakāśākāśarūpiṇī /	tat evam cit nirākārā prakāśa ākāśa rūpiṇī 
SA_GSP31_vijsamsu-529	tiṣṭhatyavyaktarūpā ca mokṣādau vṛttyabhāvataḥ // ViSs_2,3.8 //	tiṣṭhati avyakta rūpā ca mokṣa ādau vṛtti abhāvataḥ 
SA_GSP31_vijsamsu-530	buddhivṛttistu sākārā paricchinnā ca dīpavat /	buddhi vṛttiḥ tu sa ākārā paricchinnā ca dīpa vat 
SA_GSP31_vijsamsu-531	vyaktā ca sarvadā tadvadasaṅkhyā kṣaṇabhaṅgurā // ViSs_2,3.9 //	vyaktā ca sarvadā tadvat asaṅkhyā kṣaṇa bhaṅgurā 
SA_GSP31_vijsamsu-532	jaḍā ca paradṛśyatvādghaṭadīpādivan matā /	jaḍā ca para dṛśya tvāt ghaṭa dīpa ādi vat matā 
SA_GSP31_vijsamsu-533	vṛtteḥ prakāśatā tvarthākāratvādakṣataiva hi // ViSs_2,3.10 //	vṛtteḥ prakāśa tā tu artha ākāra tvāt akṣa tā eva hi 
SA_GSP31_vijsamsu-534	yathā 'syākāratārhatvādādarśastatprakāśakaḥ /	yathā sya ākāra tā arha tvāt ādarśaḥ tad prakāśakaḥ 
SA_GSP31_vijsamsu-535	sarvākāratvayogyatvāt saivaṃ sarvaprakāśikā // ViSs_2,3.11 //	sarva ākāra tva yogya tvāt sā evam sarva prakāśikā 
SA_GSP31_vijsamsu-536	na punarvṛttidraṣṭṛtvaṃ citastadbhinnadraṣṭṛtā /	na punar vṛtti draṣṭṛ tvam citaḥ tad bhinna draṣṭṛ tā 
SA_GSP31_vijsamsu-537	vṛtteryato gauravaṃ syāddvayorjñātṛtvakalpane // ViSs_2,3.12 //	vṛtteḥ yatas gauravam syāt dvayoḥ jñātṛ tva kalpane 
SA_GSP31_vijsamsu-538	buddhyārūḍhaṃ tvanyavastu taddvārā pratibimbitam /	buddhi ārūḍham tu anya vastu tad dvārā pratibimbitam 
SA_GSP31_vijsamsu-539	paśyatyanubhavo nānyo draṣṭā buddhyādiko 'khilaḥ // ViSs_2,3.13 //	paśyati anubhavaḥ na anyaḥ draṣṭā buddhi ādikaḥ khilaḥ 
SA_GSP31_vijsamsu-540	ityevaṃ buddhivṛttibhyo vailakṣaṇyaṃ citīritam /	iti evam buddhi vṛttibhyaḥ vailakṣaṇyam citi īritam 
SA_GSP31_vijsamsu-541	cidacittvākhyavaidharmyaṃ dehādibhyaḥ sphuṭantvidam // ViSs_2,3.14 //	cit acit tva ākhya vaidharmyam deha ādibhyaḥ sphuṭantu idam 
SA_GSP31_vijsamsu-542	anyonyapratibimbena sārūpyādvṛtibodhayoḥ /	anyonya pratibimbena sārūpyāt vṛti bodhayoḥ 
SA_GSP31_vijsamsu-543	bodhavyavahṛtirvṛttau lohe 'gnivyavahāravat // ViSs_2,3.15 //	bodha vyavahṛtiḥ vṛttau lohe gni vyavahāra vat 
SA_GSP31_vijsamsu-544	naivālpabuddhyāśakyo 'yaṃ viveko vṛttibodhayoḥ /	na eva alpa buddhyā aśakyaḥ yam vivekaḥ vṛtti bodhayoḥ 
SA_GSP31_vijsamsu-545	tārkikā yatra sammūḍhāḥ sāṅkhyānāṃ śreṣṭhatā yataḥ // ViSs_2,3.16 //	tārkikāḥ yatra sammūḍhāḥ sāṅkhyānām śreṣṭha tā yatas 
SA_GSP31_vijsamsu-546	vijñānavādino bauddhā vṛttibodhāvivekataḥ /	vijñāna vādinaḥ bauddhāḥ vṛtti bodha avivekataḥ 
SA_GSP31_vijsamsu-547	jñātātmatvaśrutau mūḍhā menire kṣaṇikāṃ citim // ViSs_2,3.17 //	jñāta ātma tva śrutau mūḍhāḥ menire kṣaṇikām citim 
SA_GSP31_vijsamsu-548	sattvapuṃso viveko 'yaṃ vṛttitadbodharūpayoḥ /	sattva puṃsaḥ vivekaḥ yam vṛtti tad bodha rūpayoḥ 
SA_GSP31_vijsamsu-549	nāśakyaḥ sudhiyāṃ yadvaddhaṃsānāṃ kṣīranīrayoḥ // ViSs_2,3.18 //	na aśakyaḥ sudhiyām yadvat haṃsānām kṣīra nīrayoḥ 
SA_GSP31_vijsamsu-550	etadantaśca saṃsāro mokṣāstatraiva saṃsthitaḥ /	etad antaḥ ca saṃsāraḥ mokṣāḥ tatra eva saṃsthitaḥ 
SA_GSP31_vijsamsu-551	yadvṛttibhyo vivekena tadbodhasyāvadhāraṇam // ViSs_2,3.19 //	           
SA_GSP31_vijsamsu-552	sarvo 'pyanubhavaṃ veda na kaścidapi vedatām /	sarvaḥ pi anubhavam veda na kaścid api vedatām 
SA_GSP31_vijsamsu-553	vivekamātramasmin hi bhāsamāne 'pyapekṣate // ViSs_2,3.20 //	viveka mātram asmin hi bhāsamāne pi apekṣate 
SA_GSP31_vijsamsu-554	ātmā vivektuṃ bāhyārthe na śakyo vṛtimiśraṇāt /	ātmā vivektum bāhya arthe na śakyaḥ vṛti miśraṇāt 
SA_GSP31_vijsamsu-555	ato vṛttau vivektavyo vṛttibodhatayaiva saḥ // ViSs_2,3.21 //	atas vṛttau vivektavyaḥ vṛtti bodha tayā eva saḥ 
SA_GSP31_vijsamsu-556	yathā buddhyā vivekārho nāgniraṅgāramiśraṇāt /	yathā buddhyā viveka arhaḥ na agniḥ aṅgāra miśraṇāt 
SA_GSP31_vijsamsu-557	so 'ṅgāre tu vivekārho kāṣṭhadagdhṛtayā sphuṭam // ViSs_2,3.22 //	ṅgāre tu sphuṭam 
SA_GSP31_vijsamsu-558	ataeva śrutau svapne dṛśyavṛttivivekataḥ /	ataeva śrutau svapne dṛśya vṛtti vivekataḥ 
SA_GSP31_vijsamsu-559	svayaṃjyotiḥsvarūpeṇa tasyā draṣṭā pradarśitaḥ // ViSs_2,3.23 //	svayam jyotiḥ sva rūpeṇa tasyāḥ draṣṭā pradarśitaḥ 
SA_GSP31_vijsamsu-560	sākṣāt prakāśo yo yasya sa tadbhinno mato budhaiḥ /	sākṣāt prakāśaḥ yaḥ yasya sa tad bhinnaḥ mataḥ budhaiḥ 
SA_GSP31_vijsamsu-561	ghaṭādibhyo yathā ';	ghaṭa ādibhyaḥ yathā 
SA_GSP31_vijsamsu-562	'loka ālokāccāpi vṛttayaḥ // ViSs_2,3.24 //	lokaḥ ālokāt ca api vṛttayaḥ 
SA_GSP31_vijsamsu-563	vṛtteḥ sākṣāt prakāśatvādato 'nubhavarūpakaḥ /	vṛtteḥ sākṣāt prakāśa tvāt atas nubhava rūpakaḥ 
SA_GSP31_vijsamsu-564	vṛttibhyo bhinna ātmeti śīghro mārgaḥ svadarśane // ViSs_2,3.25 //	vṛttibhyaḥ bhinnaḥ ātmā iti śīghraḥ mārgaḥ sva darśane 
SA_GSP31_vijsamsu-565	evamādiprakāreṇa buddhisattvaprakāśataḥ /	evamādi prakāreṇa buddhi sattva prakāśataḥ 
SA_GSP31_vijsamsu-566	vilakṣaṇatayā siddhaścitprakāśo 'sya bhāsakaḥ // ViSs_2,3.26 //	vilakṣaṇa tayā siddhaḥ cit prakāśaḥ sya bhāsakaḥ 
SA_GSP31_vijsamsu-567	svapnadehādidṛṣṭāntaistasmācchrutyādidarśitaiḥ /	svapna deha ādi dṛṣṭāntaiḥ tasmāt śruti ādi darśitaiḥ 
SA_GSP31_vijsamsu-568	jāgraddehendriyārthebhyaścitirbhinnatayā matā // ViSs_2,3.27 //	jāgrat deha indriya arthebhyaḥ citiḥ bhinna tayā matā 
SA_GSP31_vijsamsu-569	svapne dehādikaṃ sarvaṃ cidbhinnaṃ citi bhāsate /	svapne deha ādikam sarvam cit bhinnam citi bhāsate 
SA_GSP31_vijsamsu-570	jāgratyevaṃ viśeṣastu yadbāhyamapi bhāsate // ViSs_2,3.28 //	jāgrati evam viśeṣaḥ tu yat bāhyam api bhāsate 
SA_GSP31_vijsamsu-571	svapne manomayatvācca sākṣāccidviṣayo 'khilam /	svapne manaḥ maya tvāt ca sākṣāt cit viṣayaḥ khilam 
SA_GSP31_vijsamsu-572	karaṇadvārato bāhyaṃ cito jāgrati gocaraḥ // ViSs_2,3.29 //	karaṇa dvārataḥ bāhyam citaḥ jāgrati gocaraḥ 
SA_GSP31_vijsamsu-573	sarvaṃ dehādikaṃ svapnajāgratorekarūpataḥ /	sarvam deha ādikam svapna jāgratoḥ eka rūpataḥ 
SA_GSP31_vijsamsu-574	bhāti cidvyomni nātrārthabāhyāntarbhedato bhidā // ViSs_2,3.30 //	bhāti cit vyomni nā atra artha bāhya antar bhedataḥ bhidā 
SA_GSP31_vijsamsu-575	cidvyomni vāsanāto dhīḥ pramāṇādvā 'rtharūpiṇī /	cit vyomni vāsanātaḥ dhīḥ pramāṇāt vā rtha rūpiṇī 
SA_GSP31_vijsamsu-576	tataścito 'rthabhānaṃ yat tat samaṃ svapnajāgratoḥ // ViSs_2,3.31 //	tatas citaḥ ṛtha bhānam yat tat samam svapna jāgratoḥ 
SA_GSP31_vijsamsu-577	tadidaṃ svānubhūtyaiva procyate na parokṣataḥ /	tat idam sva anubhūtyā eva procyate na parokṣataḥ 
SA_GSP31_vijsamsu-578	svapnadṛṣṭāntasadṛśo nopāyo 'styātmadarśane // ViSs_2,3.32 //	svapna dṛṣṭānta sadṛśaḥ na upāyaḥ sti ātma darśane 
SA_GSP31_vijsamsu-579	suṣuptau hi yathā svapne svātmanyevekṣate 'khilam /	suṣuptau hi yathā svapne sva ātmani eva īkṣate khilam 
SA_GSP31_vijsamsu-580	ātmānaṃ caikadeśasthaṃ manyate jāgare tathā // ViSs_2,3.33 //	ātmānam ca eka deśa stham manyate jāgare tathā 
SA_GSP31_vijsamsu-581	suṣuptirātmanastattvaṃ svarūpāvasthitestadā /	suṣuptiḥ ātmanaḥ tattvam sva rūpa avasthiteḥ tadā 
SA_GSP31_vijsamsu-582	jāgratsvapnau māyikau tu mṛṣāsārūpyato dhiyā // ViSs_2,3.34 //	jāgrat svapnau māyikau tu mṛṣā sārūpyataḥ dhiyā 
SA_GSP31_vijsamsu-583	buddheḥ suṣuptistamasā ';	buddheḥ suṣuptiḥ tamasā 
SA_GSP31_vijsamsu-584	'varaṇaṃ tadvilakṣaṇā /	varaṇam tad vilakṣaṇā 
SA_GSP31_vijsamsu-585	citeḥ suṣuptirvṛttyākhyadṛśyāvaraṇaśūnyatā // ViSs_2,3.35 //	citeḥ suṣuptiḥ vṛtti ākhya dṛśya āvaraṇa śūnyatā 
SA_GSP31_vijsamsu-586	pūrṇaḥ kūṭasthanityaśca svasvadhīmātravṛttidṛk /	pūrṇaḥ kūṭastha nityaḥ ca sva sva dhī mātra vṛtti dṛś 
SA_GSP31_vijsamsu-587	vṛttyākhyadṛśyavirahāt sarvadā nekṣate pumān // ViSs_2,3.36 //	vṛtti ākhya dṛśya virahāt sarvadā na īkṣate pumān 
SA_GSP31_vijsamsu-588	vṛttideśe yathā bodhastathā sarvatra sarvadā /	vṛtti deśe yathā bodhaḥ tathā sarvatra sarvadā 
SA_GSP31_vijsamsu-589	vṛthaiva tapyate mūḍhairvyayanāśādinā '; 'tmanaḥ // ViSs_2,3.37 //	vṛthā eva tapyate mūḍhaiḥ vyaya nāśa ādinā tmanaḥ 
SA_GSP31_vijsamsu-590	duḥkhabhogamahāroganidānaṃ dehagehinī /	duḥkha bhoga mahā roga nidānam dehagehinī 
SA_GSP31_vijsamsu-591	buddhirna tyajyate mūḍhairmahānidrāsukhaṃ yataḥ // ViSs_2,3.38 //	buddhiḥ na tyajyate mūḍhaiḥ mahā nidrā sukham yatas 
SA_GSP31_vijsamsu-592	anādibuddhigārhasthyaṃ vivekastyajyate na cet /	anādi buddhi gārhasthyam vivekaḥ tyajyate na ced 
SA_GSP31_vijsamsu-593	na mokṣo bāhyasannyāsādihāmutrāsukhaṃ param // ViSs_2,3.39 //	na mokṣaḥ bāhya sannyāsāt iha amutra asukham param 
SA_GSP31_vijsamsu-594	samacinmātrarūpeṣu svaparātmasu sarvadā /	sama cit mātra rūpeṣu sva para ātmasu sarvadā 
SA_GSP31_vijsamsu-595	buddhimātravivekena svaparādibhidā mṛṣā // ViSs_2,3.40 //	buddhi mātra vivekena sva para ādi bhidā mṛṣā 
SA_GSP31_vijsamsu-596	cinmātre nirguṇe svāminyāropyaivātmakartṛtām /	cit mātre nirguṇe svāmini āropya eva ātma kartṛtām 
SA_GSP31_vijsamsu-597	svāmyavajñāparādhena vadhyate dhīḥ svakarmabhiḥ // ViSs_2,3.41 //	svāmi avajñāparādhena vadhyate dhīḥ sva karmabhiḥ 
SA_GSP31_vijsamsu-598	sādhvī tu dhīḥ patiṃ dṛṣṭvā yāthātathyena tatparā /	sādhvī tu dhīḥ patim dṛṣṭvā yāthātathyena tatparā 
SA_GSP31_vijsamsu-599	ihānandamayī cānte patidehe layaṃ vrajet // ViSs_2,3.42 //	iha ānanda mayī ca ante pati dehe layam vrajet 
SA_GSP31_vijsamsu-600	nāhaṃ kartā sukhī duḥkhī cinmātrākāśarūpakaḥ /	na aham kartā sukhī duḥkhī cit mātra ākāśa rūpakaḥ 
SA_GSP31_vijsamsu-601	evaṃ nāthaṃ cintayantī na patyurduḥkhabhogadā // ViSs_2,3.43 //	evam nātham cintayantī na patyuḥ duḥkha bhoga dā 
SA_GSP31_vijsamsu-602	iti śrīvijñānabhikṣuviracite sāṅkhyasāre ātmānātmanościdacittvavaidharmyaparicchedaḥ // * // @----------------------------------------------------------------------	iti śrī vijñānabhikṣu viracite sāṅkhyasāre ātma anātmanoḥ cit acit tva vaidharmya paricchedaḥ 
SA_GSP31_vijsamsu-603	atha caturthaḥ paricchedaḥ //	atha caturthaḥ paricchedaḥ 
SA_GSP31_vijsamsu-604	ityevamātmanaḥ prokto buddhyādibhyo vilakṣaṇaḥ /	iti evam ātmanaḥ proktaḥ buddhi ādibhyaḥ vilakṣaṇaḥ 
SA_GSP31_vijsamsu-605	citprakāśo 'dhunā ';	       
SA_GSP31_vijsamsu-606	'nandarūpatā vakṣyate tathā // ViSs_2,4.1 //	nanda rūpa tā vakṣyate tathā 
SA_GSP31_vijsamsu-607	duḥkhaṃ kāmasukhāpekṣā sukhaṃ duḥkhasukhātyayaḥ /	duḥkham kāma sukha apekṣā sukham duḥkha sukha atyayaḥ 
SA_GSP31_vijsamsu-608	iti smṛteḥ sukhātmatvaṃ nityanirduḥkhatā '; 'tmanaḥ // ViSs_2,4.2 //	iti smṛteḥ sukha ātmatvam nitya nirduḥkha tā tmanaḥ 
SA_GSP31_vijsamsu-609	paribhāṣābalādrūḍhibādhaḥ sarvatra sammataḥ /	paribhāṣā balāt rūḍhi bādhaḥ sarvatra sammataḥ 
SA_GSP31_vijsamsu-610	anyathā paribhāṣeyaṃ mokṣaśāstre bhavedvṛthā // ViSs_2,4.3 //	anyathā paribhāṣā iyam mokṣa śāstre bhavet vṛthā 
SA_GSP31_vijsamsu-611	yadvā parokṣavādena paramapriyatāptaye /	yat vā parokṣa vādena parama priya tā āptaye 
SA_GSP31_vijsamsu-612	rūpikā sukhagīḥ puṃsi vibhutvāptyai svaśabdavat // ViSs_2,4.4 //	rūpikā sukha gīḥ puṃsi vibhu tva āptyai sva śabda vat 
SA_GSP31_vijsamsu-613	nānandaṃ na nirānandamityādiśrutibhiḥ sphuṭam /	na ānandam na nirānandam ityādi śrutibhiḥ sphuṭam 
SA_GSP31_vijsamsu-614	ātmanyānandarūpatvaniṣedhādyuktisaṃyutāt // ViSs_2,4.5 //	ātmani ānanda rūpa tva niṣedha ādi ukti saṃyutāt 
SA_GSP31_vijsamsu-615	upāsādyarthaśūnyatvānneti neti śrutestathā /	upāsā ādi artha śūnya tvāt na iti na iti śruteḥ tathā 
SA_GSP31_vijsamsu-616	niṣedhavākyaṃ balavadvidhivākyāditi sthitiḥ // ViSs_2,4.6 //	niṣedha vākyam balavat vidhi vākyāt iti sthitiḥ 
SA_GSP31_vijsamsu-617	nirnirānandamiti ca svopādhyānandabhoktṛtām /	niḥ nirānandam iti ca sva upādhi ānanda bhoktṛ tām 
SA_GSP31_vijsamsu-618	svāmitvarūpiṇīṃ vakti na nirdhana itīva hi // ViSs_2,4.7 //	svāmi tva rūpiṇīm vakti na nirdhanaḥ iti iva hi 
SA_GSP31_vijsamsu-619	preyo 'nyasmācca sarvasmāditi śrutyā sukhādapi /	preyaḥ nyasmāt ca sarvasmāt iti śrutyā sukhāt api 
SA_GSP31_vijsamsu-620	ukta ātmā priyastasya sukhatvoktiśca nocitā // ViSs_2,4.8 //	uktaḥ ātmā priyaḥ tasya sukha tva uktiḥ ca nā ucitā 
SA_GSP31_vijsamsu-621	ānandādyāḥ pradhānasya iti vedāntasūtrataḥ /	ānanda ādyāḥ pradhānasya iti vedānta sūtrataḥ 
SA_GSP31_vijsamsu-622	vedānte 'pi na siddhānta ātmanaḥ sukharūpatā // ViSs_2,4.9 //	vedānte pi na siddhānte ātmanaḥ sukha rūpa tā 
SA_GSP31_vijsamsu-623	vistārādbrahmamīmāṃsābhāṣye 'smābhiḥ parīkṣitam /	vistārāt brahmamīmāṃsā bhāṣye smābhiḥ parīkṣitam 
SA_GSP31_vijsamsu-624	citerasukharūpatvaṃ premā vyākhyāyate 'dhunā // ViSs_2,4.10 //	citeḥ asukha rūpa tvam premā vyākhyāyate dhunā 
SA_GSP31_vijsamsu-625	mā na bhūvamahaṃ śaśvadbhūyāsamiti rūpakaḥ /	mā na bhūvam aham śaśvat bhūyāsam iti rūpakaḥ 
SA_GSP31_vijsamsu-626	nirnimitto 'nurāgo yaḥ sa premā paramaściti // ViSs_2,4.11 //	nirnimittaḥ nurāgaḥ yaḥ sa premā paramaḥ citi 
SA_GSP31_vijsamsu-627	anyāśeṣatayā buddheḥ sneho 'yaṃ na sukheṣvapi /	anya aśeṣa tayā buddheḥ snehaḥ yam na sukheṣu api 
SA_GSP31_vijsamsu-628	ataḥ priyatamaḥ svātmā nānyo 'to hyadhikaḥ priyaḥ // ViSs_2,4.12 //	atas priyatamaḥ svātmā hi adhikaḥ priyaḥ 
SA_GSP31_vijsamsu-629	ātmatvenātmani premā na sukhatvādyapekṣate /	ātma tvena ātmani premā na sukha tva ādi apekṣate 
SA_GSP31_vijsamsu-630	ahaṃ syāmiti cedyasmāt sukhaṃ syāmiti neṣyate // ViSs_2,4.13 //	aham syām iti ced yasmāt sukham syām iti na iṣyate 
SA_GSP31_vijsamsu-631	tathā ca sukhatāduḥkhābhāvate vā '; 'tmatā 'pi ca /	tathā ca vā ca 
SA_GSP31_vijsamsu-632	premṇi prayojikā siddhā svataḥpremātmataiva tu // ViSs_2,4.14 //	premṇi prayojikā siddhā svatas prema ātma tā eva tu 
SA_GSP31_vijsamsu-633	tasmādvastuta ātmaiva priyo naipādhikatvataḥ /	tasmāt vastutas ātmā eva priyaḥ na aipādhika tvataḥ 
SA_GSP31_vijsamsu-634	aupādhikītaraprītirasthiratvānna tāttvikī // ViSs_2,4.15 //	aupādhikī itara prītiḥ asthira tvāt na tāttvikī 
SA_GSP31_vijsamsu-635	prītiranyatra cānityāvivekādyaiḥ sukhādiṣu /	prītiḥ anyatra ca anitya aviveka ādyaiḥ sukha ādiṣu 
SA_GSP31_vijsamsu-636	ātmaprītistu nityā 'to nityānandaḥ pumān mataḥ // ViSs_2,4.16 //	ātma prītiḥ tu nityā nitya ānandaḥ pumān mataḥ 
SA_GSP31_vijsamsu-637	ātmanaḥ priyatāṃ buddhiryadi paśyet samāhitā /	ātmanaḥ priya tām buddhiḥ yadi paśyet samāhitā 
SA_GSP31_vijsamsu-638	sarvātiśāyinīṃ tarhi sukhābdhau kiṃ na majjati // ViSs_2,4.17 //	sarva atiśāyinīm tarhi sukha abdhau kim na majjati 
SA_GSP31_vijsamsu-639	priyadarśanato buddheḥ sukhaṃ lokeṣu dṛśyate /	priya darśanataḥ buddheḥ sukham lokeṣu dṛśyate 
SA_GSP31_vijsamsu-640	ato 'numeyaṃ paramapriyadṛṣṭyā paraṃ sukham // ViSs_2,4.18 //	atas numā iyam parama priya dṛṣṭyā param sukham 
SA_GSP31_vijsamsu-641	ātmārthatvena sarvatra prītirātmā svataḥ priyaḥ /	ātma artha tvena sarvatra prītiḥ ātmā svatas priyaḥ 
SA_GSP31_vijsamsu-642	iti śaśvacchrutiḥ prāha ātmadṛṣṭividhitsayā // ViSs_2,4.19 //	iti śaśvat śrutiḥ prāha ātma dṛṣṭi vidhitsayā 
SA_GSP31_vijsamsu-643	tato 'pyanupamaṃ jñeyaṃ priyātmekṣaṇataḥ sukham /	tatas u pi anupamam jñeyam priya ātma īkṣaṇataḥ sukham 
SA_GSP31_vijsamsu-644	bhuñjate tat sukhaṃ dhīrā jīvanmuktā mahādhiyaḥ // ViSs_2,4.20 //	bhuñjate tat sukham dhīrāḥ jīvanmuktāḥ mahā dhiyaḥ 
SA_GSP31_vijsamsu-645	antarātmasukhaṃ satyamavisaṃvādi yoginam /	antarātma sukham satyam avisaṃvādi yoginam 
SA_GSP31_vijsamsu-646	apaśyan kṛpaṇo bāhyasukhārthī vañcito janaḥ // ViSs_2,4.21 //	a paśyan kṛpaṇaḥ bāhya sukha arthī vañcitaḥ janaḥ 
SA_GSP31_vijsamsu-647	sukhāśayā bahiḥ paśyan dehī hīndriyarandhrakaiḥ /	sukha āśayāḥ bahis paśyan dehī hi indriya randhrakaiḥ 
SA_GSP31_vijsamsu-648	vātāyanairgṛhītvā 'ntaḥ sukhaṃ vetti na bāhyadṛk // ViSs_2,4.22 //	vātāyanaiḥ gṛhītvā ntar sukham vetti na bāhya dṛś 
SA_GSP31_vijsamsu-649	dukhalabhyān duḥkhamayān pariṇāme 'tiduḥkhadān /	dukha labhyān duḥkha mayān pariṇāme ti duḥkha dān 
SA_GSP31_vijsamsu-650	viṣayotthān sukhābhāsān dhik svātmasukharodhakān // ViSs_2,4.23 //	viṣaya utthān sukha ābhāsān dhik sva ātma sukha rodhakān 
SA_GSP31_vijsamsu-651	iti śrīvijñānabhikṣuviracite sāṅkhyasāre ātmānātmanoḥ priyāpriyatvavaidharmyaparicchedaḥ // * // @----------------------------------------------------------------------	iti śrī vijñānabhikṣu viracite sāṅkhyasāre ātma anātmanoḥ priya apriya tva vaidharmya paricchedaḥ 
SA_GSP31_vijsamsu-652	atha pañcamaḥ paricchedaḥ /	atha pañcamaḥ paricchedaḥ 
SA_GSP31_vijsamsu-653	paricchedatrayeṇoktaṃ saccidānandarūpakam /	            
SA_GSP31_vijsamsu-654	gīyamānaṃ śrutismṛtyorātmano lakṣaṇatrayam // ViSs_2,5.1 //	gīyamānam śruti smṛtyoḥ ātmanaḥ lakṣaṇa trayam 
SA_GSP31_vijsamsu-655	tadvaiparītyamanyeṣāṃ lakṣaṇaṃ ceritaṃ sphuṭam /	tad vaiparītyam anyeṣām lakṣaṇam ca īritam sphuṭam 
SA_GSP31_vijsamsu-656	ābhyāṃ tu guṇadoṣābhyāṃ viveko doṣahṛt paraḥ // ViSs_2,5.2 //	ābhyām tu guṇa doṣābhyām vivekaḥ doṣa hṛt paraḥ 
SA_GSP31_vijsamsu-657	nairguṇyasaguṇatvādivaidharmyāṇyaparāṇyapi /	nairguṇya saguṇa tva ādi vaidharmyāṇi aparāṇi api 
SA_GSP31_vijsamsu-658	bahūni vakṣye saṅkṣepāt pumprakṛtyorataḥ param // ViSs_2,5.3 //	bahūni vakṣye saṅkṣepāt pum prakṛtyoḥ atas param 
SA_GSP31_vijsamsu-659	dhiyo 'rthākārayā vṛttyā janitatvāt sukhādayaḥ /	dhiyaḥ rtha ākārayā vṛttyā janita tvāt sukha ādayaḥ 
SA_GSP31_vijsamsu-660	sāmānādhikaraṇyena kalpyante lāghavād dhiyām // ViSs_2,5.4 //	sāmānādhikaraṇyena kalpyante lāghavāt dhiyām 
SA_GSP31_vijsamsu-661	mahadāderjaḍatvena taddhetuśca jaḍo mataḥ /	mahat ādeḥ jaḍa tvena tad hetuḥ ca jaḍaḥ mataḥ 
SA_GSP31_vijsamsu-662	kāryakāraṇasājātyaṃ dṛṣṭaṃ loke hi sarvataḥ // ViSs_2,5.5 //	kārya kāraṇa sājātyam dṛṣṭam loke hi sarvatas 
SA_GSP31_vijsamsu-663	ata ātmā bodhamātratayā sidhyati lāghavāt /	atas ātmā bodha mātra tayā sidhyati lāghavāt 
SA_GSP31_vijsamsu-664	guṇāḥ sarve prakṛtyādervikārāścetare 'khilāḥ // ViSs_2,5.6 //	guṇāḥ sarve prakṛti ādeḥ vikārāḥ ca itare khilāḥ 
SA_GSP31_vijsamsu-665	ātmā tu nirguṇastadvat kūṭasthaśca mato budhaiḥ /	ātmā tu nirguṇaḥ tadvat kūṭasthaḥ ca mataḥ budhaiḥ 
SA_GSP31_vijsamsu-666	citeḥ kūṭasthasañjñā tu sthiratvād girikūṭavat // ViSs_2,5.7 //	citeḥ kūṭastha sañjñā tu sthira tvāt giri kūṭa vat 
SA_GSP31_vijsamsu-667	lepaścetarasambandhe tadrūpairuparaktatā /	lepaḥ ca itara sambandhe tad rūpaiḥ uparakta tā 
SA_GSP31_vijsamsu-668	yathā viṣayasambandhādbuddhau bhavati vāsanā // ViSs_2,5.8 //	yathā viṣaya sambandhāt buddhau bhavati vāsanā 
SA_GSP31_vijsamsu-669	bhāṇḍādau dravyayogācca tattaddravyasya vāsanā /	bhāṇḍa ādau dravya yogāt ca tad tad dravyasya vāsanā 
SA_GSP31_vijsamsu-670	lepahetuśca sambandhaḥ saṅgaḥ sambandhi cāñjanam // ViSs_2,5.9 //	lepa hetuḥ ca sambandhaḥ saṅgaḥ sambandhi ca añjanam 
SA_GSP31_vijsamsu-671	ato nirañjano 'saṅgo nirlepaścocyate pumān /	atas nirañjanaḥ saṅgaḥ nirlepaḥ ca ucyate pumān 
SA_GSP31_vijsamsu-672	nabhaḥpuṣkarapatrādidṛṣṭāntaiḥ paramarṣibhiḥ // ViSs_2,5.10 //	nabhaḥ puṣkara patra ādi dṛṣṭāntaiḥ parama ṛṣibhiḥ 
SA_GSP31_vijsamsu-673	cinmātrānantaśaktyabdhau pumarthapavaneritāḥ /	                                          
SA_GSP31_vijsamsu-674	sattvādiśaktayo yānti viśvabudbudarūpatām // ViSs_2,5.11 //	sattva ādi śaktayaḥ yānti viśva budbuda rūpa tām 
SA_GSP31_vijsamsu-675	ata īśaścidātmaiva jagataḥ sannidhānataḥ /	atas īśaḥ cit ātmā eva jagataḥ sannidhānataḥ 
SA_GSP31_vijsamsu-676	maṇivat prerakatvena jaḍānāmayasāmiva // ViSs_2,5.12 //	maṇi vat preraka tvena jaḍānām ayasām iva 
SA_GSP31_vijsamsu-677	pumāneva jagatkartā jagadbhartā 'khileśvaraḥ /	pumān eva jagatkartā jagat bhartā khila īśvaraḥ 
SA_GSP31_vijsamsu-678	svāmyarthe mṛtyavadyasmājjaḍavargaḥ pravartate // ViSs_2,5.13 //	svāmi arthe mṛtyu vat yasmāt jaḍa vargaḥ pravartate 
SA_GSP31_vijsamsu-679	karaṇāni ca deheṣu rājārthamadhikārivat /	karaṇāni ca deheṣu rāja artham adhikāri vat 
SA_GSP31_vijsamsu-680	bhogyajātaṃ manomantriṇyarpayanti svabhāvataḥ // ViSs_2,5.14 //	bhogya jātam manaḥ mantriṇi arpayanti svabhāvataḥ 
SA_GSP31_vijsamsu-681	tairbhogyairyuktamātmānamāvedayati dhīściti /	taiḥ bhogyaiḥ yuktam ātmānam āvedayati dhīḥ citi 
SA_GSP31_vijsamsu-682	īkṣāmātreṇa tadbhuṅkte rājevātmā 'khileśvaraḥ // ViSs_2,5.15 //	īkṣā mātreṇa tat bhuṅkte rājā iva ātmā khila īśvaraḥ 
SA_GSP31_vijsamsu-683	dhanāderīśvaro deho dehasyendriyamīśvaram /	dhana ādeḥ īśvaraḥ dehaḥ dehasya indriyam īśvaram 
SA_GSP31_vijsamsu-684	indriyasyeśvarī buddhirbuddherātmeśvaraḥ paraḥ // ViSs_2,5.16 //	indriyasya īśvarī buddhiḥ buddheḥ ātmā īśvaraḥ paraḥ 
SA_GSP31_vijsamsu-685	kūṭasthasyeśvarasyānyo nāsti preraka ityataḥ /	kūṭasthasya īśvarasya anyaḥ na asti prerakaḥ iti atas 
SA_GSP31_vijsamsu-686	īśvarasyāvadhitvena draṣṭā vai parameśvaraḥ // ViSs_2,5.17 //	īśvarasya avadhi tvena draṣṭā vai parameśvaraḥ 
SA_GSP31_vijsamsu-687	anyasyāgantukaiśvaryaṃ bahuvyāpārasaṅkulam /	anyasya āgantuka aiśvaryam bahu vyāpāra saṅkulam 
SA_GSP31_vijsamsu-688	nirvyāpārasya nirdoṣamanādyaiśvaryamātmanaḥ // ViSs_2,5.18 //	nirvyāpārasya nirdoṣam anādya aiśvaryam ātmanaḥ 
SA_GSP31_vijsamsu-689	sarvaśaktimayo hyātmā śaktimaṇḍalatāṇḍavaḥ /	sarva śakti mayaḥ hi ātmā śakti maṇḍala tāṇḍavaḥ 
SA_GSP31_vijsamsu-690	saṃsāraṃ tannivṛttiṃ ca māyayā ';	saṃsāram tad nivṛttim ca māyayā 
SA_GSP31_vijsamsu-691	'pnoti helayā // ViSs_2,5.19 //	pnoti helayā 
SA_GSP31_vijsamsu-692	sarvātiśāyi nirdoṣamaiśvaryamidamātmanaḥ /	sarva atiśāyi nirdoṣam aiśvaryam idam ātmanaḥ 
SA_GSP31_vijsamsu-693	paśyato yogino brāhmamapyaiśvaryaṃ tṛṇāyate // ViSs_2,5.20 //	paśyataḥ yoginaḥ brāhmam api aiśvaryam tṛṇāyate 
SA_GSP31_vijsamsu-694	bāhyasyātmocyate deho dehasyātmendriyāṇi ca /	bāhyasya ātmā ucyate dehaḥ dehasya ātma indriyāṇi ca 
SA_GSP31_vijsamsu-695	buddhirātmendriyāntasya buddherātmā tu cinnabhaḥ // ViSs_2,5.21 //	buddhiḥ ātmā indriya antasya buddheḥ ātmā tu cit nabhaḥ 
SA_GSP31_vijsamsu-696	ata ātmāvadhitvena paramātmocyate citiḥ /	atas ātma avadhi tvena paramātmā ucyate citiḥ 
SA_GSP31_vijsamsu-697	tathā 'ntaḥkaraṇairyogājjīva ityucyate citiḥ // ViSs_2,5.22 //	tathā ntaḥkaraṇaiḥ yogāt jīvaḥ iti ucyate citiḥ 
SA_GSP31_vijsamsu-698	avidyākāryarahitaḥ paramātmani ca smṛtiḥ /	avidyā kārya rahitaḥ paramātmani ca smṛtiḥ 
SA_GSP31_vijsamsu-699	yasya yadvyāpakaṃ tasya tadbrahmā 'to dharādikam // ViSs_2,5.23 //	yasya yat vyāpakam tasya tat brahmā dharā ādikam 
SA_GSP31_vijsamsu-700	prakṛtyantaṃ bhavedbrahma svasvakāryādyapekṣayā /	prakṛti antam bhavet brahma sva sva kārya ādi apekṣayā 
SA_GSP31_vijsamsu-701	seśvare sāṅkhyavāde 'pi citerevānumanyate // ViSs_2,5.24 //	sa īśvare sāṅkhya vāde pi citeḥ eva anumanyate 
SA_GSP31_vijsamsu-702	pare vā paramātmatvādikaṃ tu na jaḍe kvacit /	pare vā parama ātma tva ādikam tu na jaḍe kvacid 
SA_GSP31_vijsamsu-703	adhyakṣavyāpakatvābhyāṃ paraṃ brahma tu cetanaḥ // ViSs_2,5.25 //	adhyakṣa vyāpaka tvābhyām param brahma tu cetanaḥ 
SA_GSP31_vijsamsu-704	tasyādhyakṣaṃ vyāpakaṃ ca na hetuvidhayā 'sti hi /	tasya adhyakṣam vyāpakam ca na hetu vidhayā sti hi 
SA_GSP31_vijsamsu-705	asaṅkhyātmā nabhorāśiravibhaktaikarūpakaḥ // ViSs_2,5.26 //	asaṅkhyā ātmā nabhorāśiḥ avibhakta eka rūpakaḥ 
SA_GSP31_vijsamsu-706	so 'taścidghanavijñānaghanātmaghanasaṃjñakaḥ /	saḥ taḥ cit ghana vijñāna ghana ātma ghana saṃjñakaḥ 
SA_GSP31_vijsamsu-707	prakāśasyānapekṣatvāt svasya draṣṭṛtayā 'pi ca // ViSs_2,5.27 //	prakāśasya anapekṣa tvāt svasya draṣṭṛ tayā ca 
SA_GSP31_vijsamsu-708	svaprakāśaḥ pumānukta itare tadvilakṣaṇāḥ /	sva prakāśaḥ pumān uktaḥ itare tad vilakṣaṇāḥ 
SA_GSP31_vijsamsu-709	bhogo 'bhyavahṛtiḥ sā ca kūṭasthe nāsti dhīṣviva // ViSs_2,5.28 //	bhogaḥ bhyavahṛtiḥ sā ca kūṭasthe nā asti dhīṣu iva 
SA_GSP31_vijsamsu-710	dhīvṛttipratibimbākhyagauṇabhogā tu bhoktṛtā /	dhī vṛtti pratibimba ākhya gauṇa bhogā tu bhoktṛ tā 
SA_GSP31_vijsamsu-711	sākṣāddhīvṛtidraṣṭṛtvād buddhisākṣyucyate pumān // ViSs_2,5.29 //	sākṣāt dhī vṛti draṣṭṛ tvāt buddhi sākṣī ucyate pumān 
SA_GSP31_vijsamsu-712	vinā vikāraṃ draṣṭṛtvāt sākṣī tūkto 'khilasya saḥ /	vinā vikāram draṣṭṛ tvāt sākṣī tu uktaḥ khilasya saḥ 
SA_GSP31_vijsamsu-713	caityoparāgarūpatvāt sākṣitā 'pyadhruvā citaḥ // ViSs_2,5.30 //	caitya uparāga rūpa tvāt sākṣi tā pi adhruvā citaḥ 
SA_GSP31_vijsamsu-714	upalakṣaṇamevedamapi vyāvṛttaye jaḍāt /	upalakṣaṇam evā idam api vyāvṛttaye jaḍāt 
SA_GSP31_vijsamsu-715	ataḥ pumānanirdeśyo 'ṇuśca sūkṣmaśca kathyate // ViSs_2,5.31 //	atas pumān anirdeśyaḥ ṇuḥ ca sūkṣmaḥ ca kathyate 
SA_GSP31_vijsamsu-716	vinā dṛśyamadṛśyatvādavyaktaścocyate sataḥ /	vinā dṛśyam adṛśya tvāt avyaktaḥ ca ucyate satas 
SA_GSP31_vijsamsu-717	adṛśyo dṛśyate rāhurgṛhītena yathendunā // ViSs_2,5.32 //	adṛśyaḥ dṛśyate rāhuḥ gṛhītena yathā indunā 
SA_GSP31_vijsamsu-718	adṛśyaṃ cāsyamādarśe cit tathā svasvabuddhiṣu /	adṛśyam ca āsyam ādarśe cit tathā sva sva buddhiṣu 
SA_GSP31_vijsamsu-719	citi viśvasya saṅgaśced viśvaṃ bhāseta sarvadā // ViSs_2,5.33 //	citi viśvasya saṅgaḥ ced viśvam bhāseta sarvadā 
SA_GSP31_vijsamsu-720	viśvādhāro 'pyataḥ śūnyamiti cidgīyate khavat /	viśva ādhāraḥ pyatas śūnyam iti cit gīyate kha vat 
SA_GSP31_vijsamsu-721	dṛśyadoṣān mṛṣābuddhirdṛṣṭyāropya nirmale // ViSs_2,5.34 //	dṛśya doṣān mṛṣā buddhiḥ dṛṣṭyā āropya nirmale 
SA_GSP31_vijsamsu-722	ādarśe malavadvyomni doṣadṛṣṭyā tu tapyate /	ādarśe malavat vyomni doṣa dṛṣṭyā tu tapyate 
SA_GSP31_vijsamsu-723	vastutaściti nāstyeva malo dṛśyāśritaḥ sadā // ViSs_2,5.35 //	vastutas citi nā asti eva malaḥ dṛśya āśritaḥ sadā 
SA_GSP31_vijsamsu-724	ataśca nirmalaḥ svastho nirdoṣaścocyate pumān /	atas ca nirmalaḥ svasthaḥ nirdoṣaḥ ca ucyate pumān 
SA_GSP31_vijsamsu-725	sajātīyeṣu vaidharmyalakṣaṇā nāsti yadbhidā // ViSs_2,5.36 //	sajātīyeṣu vaidharmya lakṣaṇā na asti yat bhidā 
SA_GSP31_vijsamsu-726	ata ātmā samaḥ prokta aikarūpyācca sarvadā /	atas ātmā samaḥ proktaḥ aikarūpyāt ca sarvadā 
SA_GSP31_vijsamsu-727	dehādhyakṣatayā dehī puryabhivyaktitaḥ pumān // ViSs_2,5.37 //	deha adhyakṣa tayā dehī puri abhivyaktitaḥ pumān 
SA_GSP31_vijsamsu-728	ekākievādadvitīyaḥ kevalaścocyate tu saḥ /	kevalaḥ ca ucyate tu saḥ 
SA_GSP31_vijsamsu-729	cicchaktyapratibandhena procyate 'nāvṛtaḥ pumān // ViSs_2,5.38 //	cicchakti apratibandhena procyate na āvṛtaḥ pumān 
SA_GSP31_vijsamsu-730	sarvasvāmitayā cātmā kṣetrajñaḥ kṣetravedanāt /	sarva svāmi tayā ca ātmā kṣetrajñaḥ kṣetra vedanāt 
SA_GSP31_vijsamsu-731	hṛtsarovaradhīpadmadalavṛttiṣu līlayā // ViSs_2,5.39 //	hṛd sarovara dhī padma dala vṛttiṣu līlayā 
SA_GSP31_vijsamsu-732	carannivānandamīnān bhuñjāno haṃsa ucyate /	caran iva ānanda mīnān bhuñjānaḥ haṃsaḥ ucyate 
SA_GSP31_vijsamsu-733	hakāreṇa bahiryāti sakāreṇa viśan punaḥ // ViSs_2,5.40 //	hakāreṇa bahis yāti sakāreṇa viśan punar 
SA_GSP31_vijsamsu-734	prānavṛttyā 'naya cāpi prāṇyātmā haṃsa ucyate /	naya ca api prāṇi ātmā haṃsaḥ ucyate 
SA_GSP31_vijsamsu-735	śarīrāgarihṛddyāmaguhāyāṃ buddhibhāryayā // ViSs_2,5.41 //	buddhi bhāryayā 
SA_GSP31_vijsamsu-736	vyajyamānastayā sārdhaṃ svapanniva guhāśayaḥ /	vyajyamānaḥ tayā sārdham svapan iva guhā āśayaḥ 
SA_GSP31_vijsamsu-737	triguṇātmakamāyāṃ svāṃ sānnidhyāt pariṇāmayan // ViSs_2,5.42 //	triguṇa ātmaka māyām svām sānnidhyāt pariṇāmayan 
SA_GSP31_vijsamsu-738	māyīti kathyate cātmā tatkṛtānṛtaveṣadhṛk /	māyī iti kathyate ca ātmā tad kṛta anṛta veṣa dhṛk 
SA_GSP31_vijsamsu-739	svānyekādaśa bhūtāni pañcaitāni tu ṣoḍaśa // ViSs_2,5.43 //	svāni ekādaśa bhūtāni pañca etāni tu ṣoḍaśa 
SA_GSP31_vijsamsu-740	puṃsaḥ kalāstattvatastu niraṃśatvāt sa niṣkalaḥ /	puṃsaḥ kalāḥ tattvataḥ tu niraṃśa tvāt sa niṣkalaḥ 
SA_GSP31_vijsamsu-741	ahaṃśabdaḥ svāmivācī svāmī sākṣī tu cetasaḥ // ViSs_2,5.44 //	ahaṃśabdaḥ svāmi vācī svāmī sākṣī tu cetasaḥ 
SA_GSP31_vijsamsu-742	ato 'hamiti śabdena cinmātraṃ procyate budhaiḥ /	atas ham iti śabdena cit mātram procyate budhaiḥ 
SA_GSP31_vijsamsu-743	sarveśvaraḥ sarvavettā sarvakartā 'dvayaḥ pumān // ViSs_2,5.45 //	          
SA_GSP31_vijsamsu-744	sāmānyāducyate yadvad rājā sarvanarādhipaḥ /	sāmānyāt ucyate yadvat rājā sarva narādhipaḥ 
SA_GSP31_vijsamsu-745	ātmādvaitasya sūtreṇa jātimātreṇa varṇanāt // ViSs_2,5.46 //	ātma advaitasya sūtreṇa jāti mātreṇa varṇanāt 
SA_GSP31_vijsamsu-746	pralaye hi vijātīyadvaitaśūnyatvamātmanām /	pralaye hi vijātīya dvaita śūnya tvam ātmanām 
SA_GSP31_vijsamsu-747	asaṅgatvānnityaśuddho nityabuddhaśca cittvataḥ // ViSs_2,5.47 //	asaṅga tvāt nitya śuddhaḥ nitya buddhaḥ ca cit tvataḥ 
SA_GSP31_vijsamsu-748	nityamuktastathā nityanirduḥkhatvāt pumān mataḥ /	nitya muktaḥ tathā nitya nirduḥkha tvāt pumān mataḥ 
SA_GSP31_vijsamsu-749	ityāduguruśāstroktadiśā svānubhavena ca // ViSs_2,5.48 //	iti ādu guru śāstra ukta diśā sva anubhavena ca 
SA_GSP31_vijsamsu-750	vaidharmyādātmano 'nātmavivekaḥ kriyatāṃ budhaiḥ /	vaidharmyāt ātmanaḥ na ātma vivekaḥ kriyatām budhaiḥ 
SA_GSP31_vijsamsu-751	paricchedacatuṣkeṇa pumprakṛtyoḥ suvistarāt /	pariccheda catuṣkeṇa pum prakṛtyoḥ su vistarāt 
SA_GSP31_vijsamsu-752	vaidharmyagaṇa ukto 'yaṃ dhyāyināmāśu muktidaḥ // ViSs_2,5.49 //	vaidharmya gaṇaḥ uktaḥ yam dhyāyinām āśu mukti daḥ 
SA_GSP31_vijsamsu-753	iti śrīvijñānabhikṣuviracite sāṅkhyasāre ātmavaidharmyagaṇaparicchedaḥ // * // @----------------------------------------------------------------------	iti śrī vijñānabhikṣu viracite sāṅkhyasāre ātma vaidharmya gaṇa paricchedaḥ 
SA_GSP31_vijsamsu-754	atha ṣaṣṭhaḥ paricchedaḥ /	atha ṣaṣṭhaḥ paricchedaḥ 
SA_GSP31_vijsamsu-755	vivekameva sadyuktyā matvā tadanubhūyate /	vivekam eva sat yuktyā matvā tat anubhūyate 
SA_GSP31_vijsamsu-756	rājayogaṃ yathā kuryāt samāsena taducyate // ViSs_2,6.1 //	rājayogam yathā kuryāt samāsena tat ucyate 
SA_GSP31_vijsamsu-757	aśakto rājayogasya haṭhayoge 'dhikāravān /	aśaktaḥ rājayogasya haṭhayoge dhikāravān 
SA_GSP31_vijsamsu-758	vāsiṣṭhe ca vasiṣṭhāya bhusuṇḍenaivamīritam // ViSs_2,6.2 //	vāsiṣṭhe ca vasiṣṭhāya bhusuṇḍena evam īritam 
SA_GSP31_vijsamsu-759	jñānāvṛttī rājayoge prāṇāyamāsane haṭhe /	jñāna āvṛttiḥ rājayoge prāṇāyamāsane haṭhe 
SA_GSP31_vijsamsu-760	mukhye te 'ṅgatayā 'nyonyaṃ sevye śaktyanusārataḥ // ViSs_2,6.3 //	mukhye te ṅga tayā nyonyam sevye śakti anusārataḥ 
SA_GSP31_vijsamsu-761	viṣaye 'nantadoṣā ye śrutismṛtisamīritāḥ /	viṣaye nanta doṣāḥ ye śruti smṛti samīritāḥ 
SA_GSP31_vijsamsu-762	ta ādau paridraṣṭavyāścittasthairyāya yogibhiḥ // ViSs_2,6.4 //	te ādau paridraṣṭavyāḥ citta sthairyāya yogibhiḥ 
SA_GSP31_vijsamsu-763	kāmabījānyanantāni samprarohanti yaddhṛdi /	kāma bījāni anantāni samprarohanti yat hṛdi 
SA_GSP31_vijsamsu-764	tatrāṭavīnibhe jñānapuṇyasasyaṃ na vardhate // ViSs_2,6.5 //	tatra aṭavī nibhe jñāna puṇya sasyam na vardhate 
SA_GSP31_vijsamsu-765	doṣadṛṣṭyagnisandagdhe kāmabīje tu cetasi /	doṣa dṛṣṭi agni sandagdhe kāma bīje tu cetasi 
SA_GSP31_vijsamsu-766	guruśāstrahalaiḥ kṛṣṭe sukṣetre tadvivardhate // ViSs_2,6.6 //	guru śāstra halaiḥ kṛṣṭe su kṣetre tat vivardhate 
SA_GSP31_vijsamsu-767	satyeṣvasattāṃ pracurāṃ tathā ramyeṣvaramyatām /	satyeṣu asattām pracurām tathā ramyeṣu aramyatām 
SA_GSP31_vijsamsu-768	sukheṣu pracuraṃ duḥkhaṃ paśyan dhīro virajyate // ViSs_2,6.7 //	sukheṣu pracuram duḥkham paśyan dhīraḥ virajyate 
SA_GSP31_vijsamsu-769	brahmaloko 'pi narako vināśāmedhyapūritaḥ /	brahma lokaḥ pi narakaḥ 
SA_GSP31_vijsamsu-770	yuktaśca svādhikairanyaistraiguṇyādapi duḥkhayuk // ViSs_2,6.8 //	yuktaḥ ca sva adhikaiḥ anyaiḥ traiguṇyāt api duḥkha yuj 
SA_GSP31_vijsamsu-771	tatratyairapi muktyarthaṃ yatyate janmabhīrubhiḥ /	tatratyaiḥ api mukti artham yatyate janma bhīrubhiḥ 
SA_GSP31_vijsamsu-772	ato jñeyaḥ samāsena lokaḥ sarvo 'pi duḥkhayukt // ViSs_2,6.9 //	atas jñeyaḥ samāsena lokaḥ duḥkha yukt 
SA_GSP31_vijsamsu-773	idaṃ me syādidaṃ mā syāditīcchāvyathitaṃ manaḥ /	idam me syāt idam mā syāt iti icchā vyathitam manaḥ 
SA_GSP31_vijsamsu-774	svabhāvāt tena vijñeyaṃ duḥkhaṃ cittena saṅgatiḥ // ViSs_2,6.10 //	svabhāvāt tena vijñeyam duḥkham cittena saṅgatiḥ 
SA_GSP31_vijsamsu-775	sukhaṃ suṣuptiḥ paramā duḥkhaṃ viṣayavedanam /	sukham suṣuptiḥ paramā duḥkham viṣaya vedanam 
SA_GSP31_vijsamsu-776	sukhaduḥkhasamāso 'yaṃ kimanyairbahubhāṣitaiḥ // ViSs_2,6.11 //	sukha duḥkha samāsaḥ yam kim anyaiḥ bahu bhāṣitaiḥ 
SA_GSP31_vijsamsu-777	tasmādanarthānarthābhān parīkṣya viṣayān sudhīḥ /	tasmāt anartha anartha ābhān parīkṣya viṣayān sudhīḥ 
SA_GSP31_vijsamsu-778	utsṛjet paramārthārthī bālaramyānahīniva // ViSs_2,6.12 //	utsṛjet parama artha arthī bāla ramyān ahīn iva 
SA_GSP31_vijsamsu-779	ityādikānantadoṣadṛṣṭyā rāgasya tānave /	iti ādika ananta doṣa dṛṣṭyā rāgasya tānave 
SA_GSP31_vijsamsu-780	māyāvivekataḥ śuddhamātmānaṃ cintayet sadā // ViSs_2,6.13 //	māyā vivekataḥ śuddham ātmānam cintayet sadā 
SA_GSP31_vijsamsu-781	idaṃ taditi nirdeṣṭuṃ guruṇā 'pi na śakyate /	idam tat iti nirdeṣṭum guruṇā na śakyate 
SA_GSP31_vijsamsu-782	udāsīnasyātmatattvaṃ svayameva prakāśate // ViSs_2,6.14 //	udāsīnasya ātma tattvam svayam eva prakāśate 
SA_GSP31_vijsamsu-783	buddhibodhātmako buddhisākṣī buddheḥ paro vibhuḥ /	buddhi bodha ātmakaḥ buddhi sākṣī buddheḥ paraḥ vibhuḥ 
SA_GSP31_vijsamsu-784	kūṭastho 'haṃ cidāditya ityekāgro 'nucintayet // ViSs_2,6.15 //	kūṭasthaḥ ham cit ādityaḥ iti ekāgraḥ nu cintayet 
SA_GSP31_vijsamsu-785	vṛttibodho ghaṭacchidramiva nāśyalpa īkṣyate /	vṛtti bodhaḥ ghaṭa chidram iva nāśī alpaḥ īkṣyate 
SA_GSP31_vijsamsu-786	vastuto vṛttibodho 'haṃ pūrṇo vyomavadakṣayaḥ // ViSs_2,6.16 //	vastutas vṛtti bodhaḥ ham pūrṇaḥ vyoma vat akṣayaḥ 
SA_GSP31_vijsamsu-787	antaryad dṛśyate sarvaṃ tadbuddhervṛttirucyate /	antar yat dṛśyate sarvam tat buddheḥ vṛttiḥ ucyate 
SA_GSP31_vijsamsu-788	tebhyo duḥkhātmakebhyo 'haṃ sākṣāt tadvīkṣitā pṛthak // ViSs_2,6.17 //	tebhyaḥ duḥkha ātmakebhyaḥ ham sākṣāt tad vīkṣitā pṛthak 
SA_GSP31_vijsamsu-789	karmakartṛvirodho hi vṛttyā vṛttiprakāśane /	karma kartṛ virodhaḥ hi vṛttyā vṛtti prakāśane 
SA_GSP31_vijsamsu-790	vṛttidhārākalpane ca gauravāditi niścitam // ViSs_2,6.18 //	vṛtti dhārā kalpane ca gauravāt iti niścitam 
SA_GSP31_vijsamsu-791	harṣaśokabhayakrodhalobhamohamadaistathā /	harṣa śoka bhaya krodha lobha moha madaiḥ tathā 
SA_GSP31_vijsamsu-792	dveṣābhimānakārpaṇyanidrālasyasmarādibhiḥ // ViSs_2,6.19 //	dveṣa abhimāna kārpaṇya nidrā ālasya smara ādibhiḥ 
SA_GSP31_vijsamsu-793	dharmādharmaiśca sampūrṇā buddhirduḥkhamayī tu me /	dharma adharmaiḥ ca sampūrṇā buddhiḥ duḥkha mayī tu me 
SA_GSP31_vijsamsu-794	ātmānaṃ darśayatyeva bhāskarāyeva rogiṇaḥ // ViSs_2,6.20 //	ātmānam darśayati eva bhāskarāya iva rogiṇaḥ 
SA_GSP31_vijsamsu-795	ahaṃ sarvagataṃ śāntaṃ paramātmaghanaṃ śuci /	aham sarva gatam śāntam paramātma ghanam śuci 
SA_GSP31_vijsamsu-796	acintyacinmātranabho viśvadarpaṇamakṣayam // ViSs_2,6.21 //	acintya cit mātra nabhaḥ viśva darpaṇam akṣayam 
SA_GSP31_vijsamsu-797	nirañjanaṃ nirādhāraṃ nirguṇaṃ nirupadravam /	nirañjanam nirādhāram nirguṇam nirupadravam 
SA_GSP31_vijsamsu-798	nirviśeṣaṃ sajātīyāt samastārthāvabhāsakam // ViSs_2,6.22 //	nirviśeṣam sajātīyāt samasta artha avabhāsakam 
SA_GSP31_vijsamsu-799	brahmaviṣṇumaheśādyāḥ sthāvarāntāśca cetanāḥ /	brahma viṣṇu maheśa ādyāḥ sthāvara antāḥ ca cetanāḥ 
SA_GSP31_vijsamsu-800	avaidharmyātmakābhedādahamityanucintayet // ViSs_2,6.23 //	avaidharmya ātmaka abhedāt aham iti anucintayet 
SA_GSP31_vijsamsu-801	ahamanye ca puruṣāḥ samacidvyomarūpiṇaḥ /	aham anye ca puruṣāḥ sama cit vyoma rūpiṇaḥ 
SA_GSP31_vijsamsu-802	ata ātmaika evā 'hamiti śrutiṣu gīyate // ViSs_2,6.24 //	atas ātmā ekaḥ eva ā ham iti śrutiṣu gīyate 
SA_GSP31_vijsamsu-803	iti paśyan svabhogaiśca yogī viśvaṃ prapūjayet /	iti paśyan sva bhogaiḥ ca yogī viśvam prapūjayet 
SA_GSP31_vijsamsu-804	ātmayogo 'pyayaṃ proktaḥ śrutyuktaḥ sāṅkhyayoginām // ViSs_2,6.25 //	ātma yogaḥ pi ayam proktaḥ śruti uktaḥ sāṅkhya yoginām 
SA_GSP31_vijsamsu-805	sarvabhūtasthamātmānaṃ sarvabhūtāni cātmani /	sarva bhūta stham ātmānam sarva bhūtāni ca ātmani 
SA_GSP31_vijsamsu-806	samaṃ paśyannātmayājī svārājyamadhigacchati // ViSs_2,6.26 //	samam paśyan ātma yājī svārājyam adhigacchati 
SA_GSP31_vijsamsu-807	ityevaṃ manunā 'pyātmayāgo jñānāṅgamīritaḥ /	iti evam manunā pi ātma yāgaḥ jñāna aṅgam īritaḥ 
SA_GSP31_vijsamsu-808	tasmādabhayadānena svabhogādyarcanena ca // ViSs_2,6.27 //	tasmāt abhaya dānena sva bhoga ādi arcanena ca 
SA_GSP31_vijsamsu-809	sammānayan bhūtajātamātmānamanucintayet /	sammānayan bhūtajātam ātmānam anucintayet 
SA_GSP31_vijsamsu-810	brahmaviṣṇuśivādīnāṃ bhoge rāgaśca hīyate // ViSs_2,6.28 //	brahma viṣṇu śiva ādīnām bhoge rāgaḥ ca hīyate 
SA_GSP31_vijsamsu-811	teṣāṃ svasāmyadṛṣṭyā 'taḥ sāmyaṃ yogī vicintayet /	teṣām sva sāmya dṛṣṭyā sāmyam yogī vicintayet 
SA_GSP31_vijsamsu-812	utpattau pralaye caiva sarvāvasthāsu sarvadā // ViSs_2,6.29 //	utpattau pralaye ca eva sarva avasthāsu sarvadā 
SA_GSP31_vijsamsu-813	sarveṣāmekarūpatvaṃ draṣṭū rāgādikaṃ kutaḥ /	sarveṣām eka rūpa tvam draṣṭuḥ rāga ādikam kutas 
SA_GSP31_vijsamsu-814	viṣṇvādayo mahaiśvaryaṃ bhuñja nā api nādhikā // ViSs_2,6.30 //	viṣṇu ādayaḥ mahā aiśvaryam bhuñja nā api nā adhikā 
SA_GSP31_vijsamsu-815	matto 'to 'laṃ tadaiśvaryairavivekijanapriyaiḥ /	mattaḥ taḥ laṃ tat aiśvaryaiḥ aviveki jana priyaiḥ 
SA_GSP31_vijsamsu-816	guṇakarmādibhiḥ kiñcinnirīkṣyādhikamātmanaḥ // ViSs_2,6.31 //	guṇa karma ādibhiḥ kiñcid nirīkṣya adhikam ātmanaḥ 
SA_GSP31_vijsamsu-817	tadarthaṃ yatate loko nāhaṃ paśyāmi me 'dhikam /	tad artham yatate lokaḥ na aham paśyāmi me dhikam 
SA_GSP31_vijsamsu-818	tathā nyūnaṃ na paśyāmi yadatikramaśaṅkayā // ViSs_2,6.32 //	tathā nyūnam na paśyāmi yat atikrama śaṅkayā 
SA_GSP31_vijsamsu-819	devā daityajayāyeva yatiṣye tajjayāśayā /	devāḥ daitya jayāya iva yatiṣye tad jaya āśayā 
SA_GSP31_vijsamsu-820	ahaṃ yathā tathaivānye ābrahmā nārakā janāḥ // ViSs_2,6.33 //	aham yathā tathā eva anye ābrahmāḥ nārakāḥ janāḥ 
SA_GSP31_vijsamsu-821	dṛśyante svātmavat premṇā pitṛbhrātṛsutādivat /	dṛśyante sva ātma vat premṇā pitṛ bhrātṛ suta ādi vat 
SA_GSP31_vijsamsu-822	ka īśa īśitavyo vā kaḥ śreṣṭhaḥ ko 'dhamo 'pi vā // ViSs_2,6.34 //	kaḥ īśaḥ īśitavyaḥ vā kaḥ śreṣṭhaḥ kaḥ vā 
SA_GSP31_vijsamsu-823	abhinne bhedadṛṣṭyā syānmṛtyorbhayamiti śrutiḥ /	abhinne bheda dṛṣṭyā syāt mṛtyoḥ bhayam iti śrutiḥ 
SA_GSP31_vijsamsu-824	cidvyomasvekarūpeṣu īśānīśādirūpakaḥ // ViSs_2,6.35 //	cit vyomasu eka rūpeṣu īśāna īśa ādi rūpakaḥ 
SA_GSP31_vijsamsu-825	rūpabhedo hyasan sarvaḥ sphaṭike rūpabhedavat /	rūpa bhedaḥ hi asan sarvaḥ sphaṭike rūpa bheda vat 
SA_GSP31_vijsamsu-826	dhiyāṃ rūpaiḥ pumāneko bahurūpa iveyate // ViSs_2,6.36 //	dhiyām rūpaiḥ pumān ekaḥ bahu rūpaḥ iva iyate 
SA_GSP31_vijsamsu-827	vṛkacarmādirūpādyairmāyīva bahurūpadhṛk /	vṛka carma ādi rūpa ādyaiḥ māyī iva bahu rūpadhṛk 
SA_GSP31_vijsamsu-828	māmāliṅgya nirākāraṃ vividhākāradhāriṇī // ViSs_2,6.37 //	mām āliṅgya nirākāram vividha ākāra dhāriṇī 
SA_GSP31_vijsamsu-829	māyaivaikā hi nṛtyantī mohayatyakhilā dhiyaḥ /	māyā eva ekā hi nṛtyantī mohayati akhilāḥ dhiyaḥ 
SA_GSP31_vijsamsu-830	puṃsāṃ bhedo buddhibhedādambubhedādyathā raveḥ // ViSs_2,6.38 //	puṃsām bhedaḥ buddhi bhedāt ambu bhedāt yathā raveḥ 
SA_GSP31_vijsamsu-831	vyomnaśca chidrarūpeṇa bhedaḥ kumbhādibhedataḥ /	vyomnaḥ ca chidra rūpeṇa bhedaḥ kumbha ādi bhedataḥ 
SA_GSP31_vijsamsu-832	ataḥ śuddho buddhamuktaḥ sarvadā sarvago 'vyayaḥ // ViSs_2,6.39 //	atas śuddhaḥ buddha muktaḥ sarvadā sarvagaḥ vyayaḥ 
SA_GSP31_vijsamsu-833	ahamanye ca tatrā 'ho śatrumitrādidhīrmṛṣā /	aham anye ca tatra ho śatru mitra ādidhīḥ mṛṣā 
SA_GSP31_vijsamsu-834	brahmaṇīśe harāvindre sarvabhūtagaṇe tathā // ViSs_2,6.40 //	brahmaṇi īśe harau indre sarva bhūta gaṇe tathā 
SA_GSP31_vijsamsu-835	uttamādhamamadhyatvavibhāgo māyayā mṛṣā /	uttama adhama madhya tva vibhāgaḥ māyayā mṛṣā 
SA_GSP31_vijsamsu-836	triguṇātmakamāyāyāstraividhyādātmano 'pi hi // ViSs_2,6.41 //	triguṇa ātmaka māyāyāḥ traividhyāt ātmanaḥ pi hi 
SA_GSP31_vijsamsu-837	uttamādhamamadhyatvatraividhyaṃ naiva hi svataḥ /	uttama adhama madhya tva traividhyam nā eva hi svatas 
SA_GSP31_vijsamsu-838	yathā dehe tathā 'nyatra citprakāśo 'yamavyayaḥ // ViSs_2,6.42 //	yathā dehe tathā nyatra cit prakāśaḥ yam avyayaḥ 
SA_GSP31_vijsamsu-839	vyaktatāvyaktatāmātrabhedo hyantarabāhyayoḥ /	vyakta tā avyakta tā mātra bhedaḥ hi antara bāhyayoḥ 
SA_GSP31_vijsamsu-840	evamanye 'pi puruṣā baddhamuktāviśeṣataḥ // ViSs_2,6.43 //	evam anye pi puruṣāḥ baddha muktā viśeṣataḥ 
SA_GSP31_vijsamsu-841	īśānīśāviśeṣācca puruṣārtho na me 'styataḥ /	īśāna īśā viśeṣāt ca puruṣa arthaḥ na me sti atas 
SA_GSP31_vijsamsu-842	mahānidraiva me sādhvī duḥkhabhogaharā priyā // ViSs_2,6.44 //	mahā nidrā eva me sādhvī duḥkha bhoga harā priyā 
SA_GSP31_vijsamsu-843	apriyā mūḍhacittānāmasādhvī dhīhatātmanām /	apriyā mūḍha cittānām asādhvī dhī hata ātmanām 
SA_GSP31_vijsamsu-844	cidādarśe mayi dhiyo yadyapi pratibimbanam // ViSs_2,6.45 //	cit ādarśe mayi dhiyaḥ yadi api pratibimbanam 
SA_GSP31_vijsamsu-845	tattvato naiva doṣāya tathā 'pi tyājyameva tat /	tattvataḥ nā eva doṣāya tathā tyājyam eva tat 
SA_GSP31_vijsamsu-846	svabhāvādasya heyatvaṃ svānubhūtyā hi sidhyati // ViSs_2,6.46 //	svabhāvāt asya heya tvam sva anubhūtyā hi sidhyati 
SA_GSP31_vijsamsu-847	yathā ko 'pi parasyāpi vairūpyaṃ na didṛkṣati /	yathā kaḥ pi parasya api vairūpyam na didṛkṣati 
SA_GSP31_vijsamsu-848	svāminyāropyātmadoṣān sādhvīyamanutapyate // ViSs_2,6.47 //	svāmini āropya ātma doṣān sādhvī iyam anutapyate 
SA_GSP31_vijsamsu-849	nirdoṣaṃ svāminaṃ dṛṣṭvā nirdoṣā syāt pativratā /	nirdoṣam svāminam dṛṣṭvā nirdoṣā syāt pativratā 
SA_GSP31_vijsamsu-850	evamasyā rūpabhede 'pyekarūpo 'smi sarvadā // ViSs_2,6.48 //	evam asyāḥ rūpa bhede smi sarvadā 
SA_GSP31_vijsamsu-851	bhuñjāno vā 'pyabhuñjānastāṃ madarthāmananyagām /	bhuñjānaḥ vā pi a bhuñjānaḥ tām mad arthām ananyagām 
SA_GSP31_vijsamsu-852	yathaikarūpatopādhiyogāyogadaśāsvaho // ViSs_2,6.49 //	yathā eka rūpa tā upādhi yoga ayoga daśāsu aho 
SA_GSP31_vijsamsu-853	ādarśasyāmalasyaiva cinnabhodarpaṇasya me /	ādarśasya amalasya eva cit nabhaḥ darpaṇasya me 
SA_GSP31_vijsamsu-854	dṛśyabuddhigatā doṣāḥ sākṣāttaddraṣṭari prabhau // ViSs_2,6.50 //	dṛśya buddhi gatāḥ doṣāḥ sākṣāt tad draṣṭari prabhau 
SA_GSP31_vijsamsu-855	na santi mayi mohādyā bhāskare bhāsyadoṣavat /	na santi mayi moha ādyāḥ bhāskare bhāsya doṣa vat 
SA_GSP31_vijsamsu-856	duḥkhairbaddhā svamātmānaṃ tyaktvā madbhāvamāgatā // ViSs_2,6.51 //	duḥkhaiḥ baddhā svam ātmānam tyaktvā mad bhāvam āgatā 
SA_GSP31_vijsamsu-857	mucyate duḥkhabandhāddhīrna me mokṣo na bandhanam /	mucyate duḥkha bandhāt dhīḥ na me mokṣaḥ na bandhanam 
SA_GSP31_vijsamsu-858	kūṭasthāsaṅgacidvyomni dhīduḥkhapratibimbanam // ViSs_2,6.52 //	             
SA_GSP31_vijsamsu-859	yo 'nyo bandho bhogarūpaḥ so 'pi ciddarpaṇe mṛṣā /	yaḥ nyaḥ bandhaḥ bhoga rūpaḥ saḥ cit darpaṇe mṛṣā 
SA_GSP31_vijsamsu-860	jāgradāditrayāvasthāsākṣī tābhirvivarjitaḥ // ViSs_2,6.53 //	jāgrat ādi traya avasthā sākṣī tābhiḥ vivarjitaḥ 
SA_GSP31_vijsamsu-861	ahaṃ pūrṇaścidāditya udayāstavivarjitaḥ /	aham pūrṇaḥ cit ādityaḥ udaya asta vivarjitaḥ 
SA_GSP31_vijsamsu-862	darpaṇe mukhavadviśvaṃ mayi bodhe na tāttvikam // ViSs_2,6.54 //	darpaṇe mukha vat viśvam mayi bodhe na tāttvikam 
SA_GSP31_vijsamsu-863	vibhutve ca bāhyāntaḥ suṣuptyādāvadarśanāt /	vibhu tve ca bāhya antar suṣupti ādau adarśanāt 
SA_GSP31_vijsamsu-864	mayi vā 'nyatra vā puṃsi kevalānubhave vibhau // ViSs_2,6.55 //	mayi vā nyatra vā puṃsi kevala anubhave vibhau 
SA_GSP31_vijsamsu-865	bhāti yattadvivartto dhīpratibimbātmakatvataḥ /	bhāti yat tat vivarttaḥ dhī pratibimba ātmaka tvataḥ 
SA_GSP31_vijsamsu-866	śuktau rajatavad viśvamato mayi na doṣakṛt // ViSs_2,6.56 //	śuktau rajata vat viśvam atas mayi na doṣa kṛt 
SA_GSP31_vijsamsu-867	marīcau toyavat tadvadvyomādau nagarādivat /	marīcau toya vat tadvat vyoma ādau nagara ādi vat 
SA_GSP31_vijsamsu-868	kālatraye 'pi nāstyeva mayi viśvaṃ sanātane // ViSs_2,6.57 //	kāla traye na asti eva mayi viśvam sanātane 
SA_GSP31_vijsamsu-869	anyatrāstvathavā mā 'stu buddhyādau mama tena kim /	anyatra astu athavā mā stu buddhi ādau mama tena kim 
SA_GSP31_vijsamsu-870	mayi sarvaṃ yathā vyomni sarvatrāhaṃ yathā nabhaḥ // ViSs_2,6.58 //	mayi sarvam yathā vyomni sarvatra aham yathā nabhaḥ 
SA_GSP31_vijsamsu-871	na sarvaṃ mayi sarvatra nāhaṃ cālepataḥ khavat /	na sarvam mayi sarvatra na aham ca ālepataḥ kha vat 
SA_GSP31_vijsamsu-872	ata evāvibhāgākhyābhedena kṣīranīravat // ViSs_2,6.59 //	atas eva a vibhāga ākhyā abhedena kṣīra nīra vat 
SA_GSP31_vijsamsu-873	jñānātmakamidaṃ viśvaṃ gāyanti paramarṣayaḥ /	jñāna ātmakam idam viśvam gāyanti parama ṛṣayaḥ 
SA_GSP31_vijsamsu-874	jaganmama madarthatvānmaccharīrasukhādivat // ViSs_2,6.60 //	jagat mama mad artha tvāt mad śarīra sukha ādi vat 
SA_GSP31_vijsamsu-875	yatha mama tathā 'nyeṣāṃ mamaiveti dhiyo bhramaḥ /	mama tathā nyeṣām mama evā iti dhiyaḥ bhramaḥ 
SA_GSP31_vijsamsu-876	vastutastu na kasyāpi kimapi vyabhicārataḥ // ViSs_2,6.61 //	vastutas tu na kasya api kim api vyabhicārataḥ 
SA_GSP31_vijsamsu-877	svāmitvasyādhruvatvena pānthasyāvāsagehavat /	svāmi tvasya adhruva tvena pānthasya āvāsa geha vat 
SA_GSP31_vijsamsu-878	ekaṃ cinmātramastīha śuddhaṃ śūnyaṃ nirañjanam // ViSs_2,6.62 //	ekam cit mātram asti iha śuddham śūnyam nirañjanam 
SA_GSP31_vijsamsu-879	sūkṣmāt sūkṣmataraṃ tatra na jaganna jagatkriyā /	sūkṣmāt sūkṣmataram tatra na jagat na jagatkriyā 
SA_GSP31_vijsamsu-880	dṛśyate sarvadṛśyāḍhyā svasvabuddhiparamparā // ViSs_2,6.63 //	dṛśyate sarva dṛśya āḍhyā sva sva buddhi paramparā 
SA_GSP31_vijsamsu-881	cinmaṇḍalamahādarśe pratibimbamupāgatā /	cit maṇḍala mahā darśe pratibimbam upāgatā 
SA_GSP31_vijsamsu-882	kvacidvyaktaṃ kvacit sūkṣmaṃ nabhaḥ sarvatra tiṣṭhati // ViSs_2,6.64 //	kvacid vyaktam kvacid sūkṣmam nabhaḥ sarvatra tiṣṭhati 
SA_GSP31_vijsamsu-883	yathā tathā cidākāśaṃ dhīdeśe 'nyatra ca sthitam /	yathā tathā cit ākāśam dhī deśe nyatra ca sthitam 
SA_GSP31_vijsamsu-884	cidākāśamayaṃ viśvaṃ yato 'to dhīritastataḥ // ViSs_2,6.65 //	cit ākāśa mayam viśvam dhīḥ itas tatas 
SA_GSP31_vijsamsu-885	bhramantī tatra tatraiva bhāsate 'rke ghaṭādivat /	bhramantī tatra tatra eva bhāsate rke ghaṭa ādi vat 
SA_GSP31_vijsamsu-886	dharmādharmau janmamṛtyū sukhaduḥkhādi cākhilam // ViSs_2,6.66 //	dharma adharmau janma mṛtyū sukha duḥkha ādi ca akhilam 
SA_GSP31_vijsamsu-887	jāgratyapi mṛṣā svapna iva janmādikaṃ mama /	jāgrati api mṛṣā svapne iva janma ādikam mama 
SA_GSP31_vijsamsu-888	dṛśyayogaviyogābhyāṃ cito janmavināśadhīḥ // ViSs_2,6.67 //	dṛśya yoga viyogābhyām citaḥ janma vināśa dhīḥ 
SA_GSP31_vijsamsu-889	abhivyaktyanabhivyaktidoṣābhyāṃ śaśino yathā /	abhivyakti anabhivyakti doṣābhyām śaśinaḥ yathā 
SA_GSP31_vijsamsu-890	mahāsuṣuptau bhavajanmamṛtyu-	mahāsuṣuptau bhava janma mṛtyu 
SA_GSP31_vijsamsu-891	duḥsvapnadhārāḥ kṣaṇabhaṅgurā dhiyaḥ /	duḥsvapna dhārāḥ kṣaṇa bhaṅgurāḥ dhiyaḥ 
SA_GSP31_vijsamsu-892	paśyāmyahaṃ tābhiraliptarūpo	paśyāmi aham tābhiḥ alipta rūpaḥ 
SA_GSP31_vijsamsu-893	ghanairūrtairvigatai raveḥ kim // ViSs_2,6.68 //	ghanaiḥ ūrtaiḥ vigataiḥ raveḥ kim 
SA_GSP31_vijsamsu-894	ityevaṃ satataṃ dhyāyannekāgramanasā sudhīḥ /	iti evam satatam dhyāyan ekāgra manasā sudhīḥ 
SA_GSP31_vijsamsu-895	sākṣātkarotyātmatattvaṃ vāgagocararūpataḥ // ViSs_2,6.69 //	sākṣātkaroti ātma tattvam vāc agocara rūpataḥ 
SA_GSP31_vijsamsu-896	svarūpaṃ nirmalaṃ śāntaṃ manastyajati cet kṣaṇam /	sva rūpam nirmalam śāntam manaḥ tyajati ced kṣaṇam 
SA_GSP31_vijsamsu-897	tadaiva dṛśyasaṃskāraśeṣāt saṅkṣubhyatīndriyam // ViSs_2,6.70 //	tadā eva dṛśya saṃskāra śeṣāt saṅkṣubhyati indriyam 
SA_GSP31_vijsamsu-898	utthitanutthitāṃstatra indriyārīn punaḥ punaḥ /	utthita nutthitān tatra indriya arīn punar punar 
SA_GSP31_vijsamsu-899	vivekenaiva vajreṇa hanyādindro girīniva // ViSs_2,6.71 //	vivekena eva vajreṇa hanyāt indraḥ girīn iva 
SA_GSP31_vijsamsu-900	iti śrīvijñānabhikṣuviracite sāṅkhyasāre rājayogaprakāraparicchedaḥ // * // @----------------------------------------------------------------------	iti śrī vijñānabhikṣu viracite sāṅkhyasāre rājayoga prakāra paricchedaḥ 
SA_GSP31_vijsamsu-901	atha saptamaḥ paricchedaḥ /	atha saptamaḥ paricchedaḥ 
SA_GSP31_vijsamsu-902	evamātmānubhavino jīvanmuktasya lakṣaṇam /	evam ātma anubhavinaḥ jīvanmuktasya lakṣaṇam 
SA_GSP31_vijsamsu-903	spaṣṭaṃ vakṣye bhavedyena jñānājñānaparīkṣaṇam // ViSs_2,7.1 //	spaṣṭam vakṣye bhavet yena jñāna ajñāna parīkṣaṇam 
SA_GSP31_vijsamsu-904	śravaṇān mananādvā 'pi anyathā ';	śravaṇāt mananāt vā pi anyathā 
SA_GSP31_vijsamsu-905	'tmajñatābhramāt /	tma jña tā bhramāt 
SA_GSP31_vijsamsu-906	kuryādgurumavidvāṃsaṃ syāccājño jñābhimānyapi // ViSs_2,7.2 //	kuryāt gurum avidvāṃsam syāt ca ajñaḥ jña abhimānī api 
SA_GSP31_vijsamsu-907	naiśvaryānāgatajñatvādikaṃ jñānasya lakṣaṇam /	na aiśvarya anāgata jña tva ādikam jñānasya lakṣaṇam 
SA_GSP31_vijsamsu-908	tadṛte 'pi hi kaivalyaṃ yogabhāṣyakṛteritam // ViSs_2,7.3 //	tat ṛte hi kaivalyam yoga bhāṣya kṛtā īritam 
SA_GSP31_vijsamsu-909	śrautasmārtāni vākyāni jñānino mokṣabhāginaḥ /	śrauta smārtāni vākyāni jñāninaḥ mokṣa bhāginaḥ 
SA_GSP31_vijsamsu-910	lakṣakāṇyeva likhyante viśvāsātiśayāya vai // ViSs_2,7.4 //	lakṣakāṇi eva likhyante viśvāsa atiśayāya vai 
SA_GSP31_vijsamsu-911	yatra sarvāṇi bhūtāni ātmaivābhūd vijānataḥ /	yatra sarvāṇi bhūtāni ātmā eva abhūt vijānataḥ 
SA_GSP31_vijsamsu-912	tatra ko mohaḥ kaḥ śoka ekatvamanupaśyataḥ // ViSs_2,7.5 //	tatra kaḥ mohaḥ kaḥ śokaḥ eka tvam anupaśyataḥ 
SA_GSP31_vijsamsu-913	yaḥ sarvatrānabhisnehastat tat prāpya śubhāśubham /	yaḥ sarvatra anabhisnehaḥ tat tat prāpya śubha aśubham 
SA_GSP31_vijsamsu-914	nābhinandanti na dveṣṭi tasya prajñā pratiṣṭhitā // ViSs_2,7.6 //	na abhinandanti na dveṣṭi tasya prajñā pratiṣṭhitā 
SA_GSP31_vijsamsu-915	na vismarati sarvatra yathā satatago gatim /	na vismarati sarvatra yathā satatagaḥ gatim 
SA_GSP31_vijsamsu-916	na vismarati niścetyaṃ cinmātraṃ prājñadhīstathā // ViSs_2,7.7 //	na vismarati niścetyam cit mātram prājña dhīḥ tathā 
SA_GSP31_vijsamsu-917	nodeti nāstamāyāti sukhe duḥkhe mukhaprabhā /	na udeti na astam āyāti sukhe duḥkhe mukha prabhā 
SA_GSP31_vijsamsu-918	yathāpūrvasthitiryasya sa jīvanmukta ucyate // ViSs_2,7.8 //	yathāpūrva sthitiḥ yasya sa jīvanmuktaḥ ucyate 
SA_GSP31_vijsamsu-919	yo jāgartti suṣuptastho yasya jāgranna vidyate /	yaḥ jāgartti suṣupta sthaḥ yasya jāgrat na vidyate 
SA_GSP31_vijsamsu-920	yasya nirvāsano bodhaḥ sa jīvanmukta ucyate // ViSs_2,7.9 //	yasya nirvāsanaḥ bodhaḥ sa jīvanmuktaḥ ucyate 
SA_GSP31_vijsamsu-921	rāgadveṣabhayādīnāmanurūpaṃ carannapi /	rāga dveṣa bhaya ādīnām anurūpam caran api 
SA_GSP31_vijsamsu-922	yo 'ntarvyomavadatyacchaḥ sa jīvanmukta ucyate // ViSs_2,7.10 //	yaḥ ntar vyoma vadati acchaḥ sa jīvanmuktaḥ ucyate 
SA_GSP31_vijsamsu-923	yasya nāhaṅkṛto bhāvo buddhiryasya na lipyate /	yasya na ahaṅkṛtaḥ bhāvaḥ buddhiḥ yasya na lipyate 
SA_GSP31_vijsamsu-924	kurvato 'kurvato vā 'pi sa jīvanmukta ucyate // ViSs_2,7.11 //	kurvataḥ kurvataḥ vā sa jīvanmuktaḥ ucyate 
SA_GSP31_vijsamsu-925	api śītarucāvarke atyuṣṇe 'pīndumaṇḍale /	api śīta rucau arke ati uṣṇe pi indu maṇḍale 
SA_GSP31_vijsamsu-926	apyadhaḥprasavatyagnau jīvanmuto na cānyadhīḥ // ViSs_2,7.12 //	api adhas prasavati agnau jīvanmutaḥ na ca anya dhīḥ 
SA_GSP31_vijsamsu-927	cidātmana imā nityamprasphurantīha śaktayaḥ /	cit ātmanaḥ imāḥ nityam prasphuranti iha śaktayaḥ 
SA_GSP31_vijsamsu-928	ityasyāścaryajāleṣu nābhyudeti kutūhalam // ViSs_2,7.13 //	iti asya āścarya jāleṣu na abhyudeti kutūhalam 
SA_GSP31_vijsamsu-929	paravyasaninī nārī vyagrā 'pi gṛhakarmaṇi /	para vyasaninī nārī vyagrā pi gṛhakarmaṇi 
SA_GSP31_vijsamsu-930	tadevāsvādayatyantarnarasaṅgarasāyanam // ViSs_2,7.14 //	tat eva āsvādayati antar nara saṅga rasāyanam 
SA_GSP31_vijsamsu-931	evaṃ tattve pare śuddhe dhīro viśrāntimāgataḥ /	evam tattve pare śuddhe dhīraḥ viśrāntim āgataḥ 
SA_GSP31_vijsamsu-932	tadevāsvādayatyantarbahirvyavaharannapi // ViSs_2,7.15 //	tat eva āsvādayati antar bahis vyavaharan api 
SA_GSP31_vijsamsu-933	yo nityamadhyātmamayo nityamantarmukhaḥ sukhī /	yaḥ nityam adhyātma mayaḥ nityam antarmukhaḥ sukhī 
SA_GSP31_vijsamsu-934	gambhīraśca prasannaśca girāviva mahāhṛdaḥ // ViSs_2,7.16 //	gambhīraḥ ca prasannaḥ ca girau iva mahā hṛdaḥ 
SA_GSP31_vijsamsu-935	parānandarasākṣubdho ramate svātmanā '; 'tmani /	           
SA_GSP31_vijsamsu-936	sarvakarmaparityāgī nityahṛṣṭo nirāmayaḥ // ViSs_2,7.17 //	sarva karma parityāgī nitya hṛṣṭaḥ nirāmayaḥ 
SA_GSP31_vijsamsu-937	na puṇyena na pāpena netareṇāpi lipyate /	na puṇyena na pāpena na itareṇa api lipyate 
SA_GSP31_vijsamsu-938	yena kena cidācchanno yena kena cidāśitaḥ // ViSs_2,7.18 //	yena kena cit ācchannaḥ yena kena cit āśitaḥ 
SA_GSP31_vijsamsu-939	yatra kvacana śāyī ca sa samrāḍiva rājate /	yatra kvacana śāyī ca sa samrāj iva rājate 
SA_GSP31_vijsamsu-940	varṇadharmāśramācāraśāstramantranayepsitaḥ // ViSs_2,7.19 //	varṇa dharma āśrama ācāra śāstra mantra naya īpsitaḥ 
SA_GSP31_vijsamsu-941	nirgacchati jagajjālāt pañjarādiva kesarī /	nirgacchati jagat jālāt pañjarāt iva kesarī 
SA_GSP31_vijsamsu-942	vācāmatītaviṣamo viṣayāśādṛśekṣitaḥ // ViSs_2,7.20 //	vācām atīta viṣamaḥ viṣaya āśā dṛśā īkṣitaḥ 
SA_GSP31_vijsamsu-943	kāmapyupagataḥ śobhāṃ śaradīva nabhastalam /	kām api upagataḥ śobhām śaradi iva nabhastalam 
SA_GSP31_vijsamsu-944	niḥstotro nirnamaskāraḥ pūjyapūjāvivarjitaḥ // ViSs_2,7.21 //	niḥstotraḥ nirnamaskāraḥ pūjya pūjā vivarjitaḥ 
SA_GSP31_vijsamsu-945	saṃyukto vā viyukto vā sadācāranayakramaiḥ /	saṃyuktaḥ vā viyuktaḥ vā sat ācāra naya kramaiḥ 
SA_GSP31_vijsamsu-946	etāvadeva khalu liṅgamaliṅgamūrtteḥ	etāvat eva khalu liṅgam aliṅga mūrtteḥ 
SA_GSP31_vijsamsu-947	saṃśāntasaṃsṛticirabhramanirvṛttasya /	saṃśānta saṃsṛti cira bhrama nirvṛttasya 
SA_GSP31_vijsamsu-948	tadyasya yanmadanakopaviṣādalobha-	tat yasya yat madana kopa viṣāda lobha 
SA_GSP31_vijsamsu-949	mohāpadāmanudinaṃ nipuṇaṃ tanutvam // ViSs_2,7.22 //	moha āpadām anudinam nipuṇam tanu tvam 
SA_GSP31_vijsamsu-950	turyaviśrāntiyuktasya pratitīpasya bhavārṇavāt /	turya viśrānti yuktasya pratitīpasya bhava arṇavāt 
SA_GSP31_vijsamsu-951	na kṛtenākṛtenārtho na śrutismṛtivibhramaiḥ // ViSs_2,7.23 //	na kṛtena akṛtena arthaḥ na śruti smṛti vibhramaiḥ 
SA_GSP31_vijsamsu-952	tanuṃ tayajatu vā tīrthe śvapacasya gṛhe 'thavā /	tanum vā tīrthe śvapacasya gṛhe 
SA_GSP31_vijsamsu-953	jñānasamprāptisamaye mukta evāmalāśayaḥ // ViSs_2,7.24 //	jñāna samprāpti samaye muktaḥ eva amala āśayaḥ 
SA_GSP31_vijsamsu-954	na mokṣo nabhasaḥ pṛṣṭhe na pātāle na bhūtale /	na mokṣaḥ nabhasaḥ pṛṣṭhe na pātāle na bhū tale 
SA_GSP31_vijsamsu-955	sarvāśāsaṅkṣaye cetaḥkṣayo mokṣa iti śruteḥ // ViSs_2,7.25 //	sarva āśā saṅkṣaye cetaḥ kṣayaḥ mokṣaḥ iti śruteḥ 
SA_GSP31_vijsamsu-956	jīvanmuktapadaṃ tyaktā svadehe kālasātkṛte /	jīvanmukta padam tyaktā sva dehe kālasāt kṛte 
SA_GSP31_vijsamsu-957	viśatyadehamuktatvaṃ pavano 'spandatāmiva // ViSs_2,7.26 //	viśati a deha mukta tvam spandatām iva 
SA_GSP31_vijsamsu-958	anāptākhilaśailādipratibimbe hi yādṛśī /	an āpta akhila śaila ādi pratibimbe hi yādṛśī 
SA_GSP31_vijsamsu-959	syāddarpaṇe darpaṇatā kevalātmasvarūpiṇī // ViSs_2,7.27 //	syāt darpaṇe darpaṇa tā kevala ātma svarūpiṇī 
SA_GSP31_vijsamsu-960	ahaṃ tvaṃ jagadityādau praśānte dṛśyasambhrame /	aham tvam jagat ityādau praśānte dṛśya sambhrame 
SA_GSP31_vijsamsu-961	syāt tādṛśī kevalatā sthite draṣṭaryavīkṣaṇe // ViSs_2,7.28 //	syāt tādṛśī kevala tā sthite draṣṭari avīkṣaṇe 
SA_GSP31_vijsamsu-962	cinmātraṃ cetyarahitamanantamajaraṃ śivam /	cit mātram cetya rahitam anantam ajaram śivam 
SA_GSP31_vijsamsu-963	anādimadhyanilayaṃ yadanādhi nirāmayam // ViSs_2,7.29 //	anādi madhya nilayam yat anādhi nirāmayam 
SA_GSP31_vijsamsu-964	na śūnyaṃ nāpi cākāraṃ na dṛśyaṃ na ca darśanam /	na śūnyam na api ca ākāram na dṛśyam na ca darśanam 
SA_GSP31_vijsamsu-965	anākhyamanabhivyaktaṃ tat kiñcidavaśiṣyate // ViSs_2,7.30 //	anākhyam anabhivyaktam tat kiñcid avaśiṣyate 
SA_GSP31_vijsamsu-966	iti śrīvijñānabhikṣuviracite sāṅkhyasāre jīvanmuktiparamamuktyoḥ paricchedaḥ // * //	iti śrī vijñānabhikṣu viracite sāṅkhyasāre jīvanmukti parama muktyoḥ paricchedaḥ 
SA_GSP31_vijsamsu-967	iti sāṅkhyasārasyottarabhāgaḥ /	iti sāṅkhya sārasya uttara bhāgaḥ 
SA_GSP31_vijsamsu-968	sāṅkhyasārākhyaṃ prakaraṇaṃ samāptam /	sāṅkhya sāra ākhyam prakaraṇam samāptam 
