segmentnr	original	analyzed
SA_GS40_vanighpu-0	Vāhaṭa: Aṣṭāṅganighaṇṭu	vāhaṭa aṣṭāṅganighaṇṭu 
SA_GS40_vanighpu-1	sarvajñāya namaskṛtya dravyāṇāṃ gūḍhavācinām /	sarvajñāya namaskṛtya dravyāṇām gūḍha vācinām 
SA_GS40_vanighpu-2	aṣṭāṅgasaṃgrahoktānāṃ nighaṇṭur abhidhīyate // VAnigh_1 //	aṣṭāṅgasaṃgraha uktānām nighaṇṭuḥ abhidhīyate 
SA_GS40_vanighpu-3	vidārīpañcāṅgulavṛścikālī- vṛścīvadevāhvayaśūrpaparṇyaḥ /	vidārī pañcāṅgula vṛścikālī vṛścīva devāhvaya śūrpaparṇyaḥ 
SA_GS40_vanighpu-4	kaṇḍūkarī jīvanāhvasvasaṃjñe dve pañcake gopasutā tripādī // VAnigh_2 //	               
SA_GS40_vanighpu-5	vidāryādir ayaṃ hṛdyo bṛṃhaṇo vātapittahā /	vidārī ādiḥ ayam hṛdyaḥ bṛṃhaṇaḥ vāta pitta hā 
SA_GS40_vanighpu-6	śoṣagulmāṅgamardordhva- śvāsakāsaharo gaṇaḥ // VAnigh_3 //	śoṣa gulma aṅgamarda ūrdhva śvāsa kāsa haraḥ gaṇaḥ 
SA_GS40_vanighpu-7	vidārī gajavājīṣṭā vṛṣagandhekṣugandhikā /	            
SA_GS40_vanighpu-8	śṛgālikā puṣpavallī śuklakandā palāśikā // VAnigh_4 //	        
SA_GS40_vanighpu-9	kṣīrekṣuvallīgandhānyā kṣīraśuklā payasvinī /	           
SA_GS40_vanighpu-10	vallīpalāśikā kṣīra- vidārī śreṣṭhakandakaḥ // VAnigh_5 //	        
SA_GS40_vanighpu-11	pañcāṅgulo vardhamānaś citro gandharvahastakaḥ /	pañcāṅgulaḥ vardhamānaḥ citraḥ gandharvahastakaḥ 
SA_GS40_vanighpu-12	uruvūkas tathairaṇḍa āmaṇḍo vātanāśanaḥ // VAnigh_6 //	           
SA_GS40_vanighpu-13	raktairaṇḍo dvitīyas tu vyāghro vyāghratalopamaḥ /	raktairaṇḍaḥ dvitīyaḥ tu vyāghraḥ vyāghra tala upamaḥ 
SA_GS40_vanighpu-14	nakrāhidaṃṣṭrikā kolī vṛścikāly uṣṭradhūmakaḥ // VAnigh_7 //	          
SA_GS40_vanighpu-15	kāleyī dhūmrapattroṣṭrā viśalyā sarpadaṃṣṭrikā /	           
SA_GS40_vanighpu-16	punarnavā varṣaketuḥ vṛścīvaḥ śvetamūlakaḥ // VAnigh_8 //	           
SA_GS40_vanighpu-17	varṣābhūḥ dīrghapattrā ca vikasas tu kaṭhillakaḥ /	           
SA_GS40_vanighpu-18	sunāḍiko raktapuṣpo viśākho maṇḍalacchadaḥ // VAnigh_9 //	         
SA_GS40_vanighpu-19	sahadevā mahāgandhā devagandhā balāhvayā /	              
SA_GS40_vanighpu-20	gāṅgerukī nāgabalā kharabandhā niśāhvayā // VAnigh_10 //	            
SA_GS40_vanighpu-21	viśvadevā jhaṣā kālā tathā cāśvagavedhukā /	viśvadevā jhaṣā kālā tathā ca aśvagavedhukā 
SA_GS40_vanighpu-22	mudgaparṇī sahā sūpya- parṇī mārjāragandhikā // VAnigh_11 //	mudgaparṇī sahā sūpya parṇī mārjāragandhikā 
SA_GS40_vanighpu-23	kākamudgā kṣudrarasā cāsrapittaharā sarā /	          
SA_GS40_vanighpu-24	piśācī siṃhavinnā ca māṣaparṇī mahāsahā // VAnigh_12 //	           
SA_GS40_vanighpu-25	markaṭī cātmaguptā ca kaṇḍūkṛt kapikacchurā /	            
SA_GS40_vanighpu-26	vṛṣyabījā galekaṇḍū- karī śārdulavigrahā // VAnigh_13 //	          
SA_GS40_vanighpu-27	phaṇijihvāparṇy abhīruḥ pīvarīndīvarī varī /	          
SA_GS40_vanighpu-28	sūkṣmapattrā dvīpiśatruḥ śatamūlī śatāvarī // VAnigh_14 //	         
SA_GS40_vanighpu-29	kākolī kavarī vīrā dhvāṅkṣolī kṣīraśuklikā /	            
SA_GS40_vanighpu-30	jīvantī jīvanī jīvā śākaśreṣṭhā sumaṅgalā // VAnigh_15 //	           
SA_GS40_vanighpu-31	payasyā payasī poṭa- galā jñeyārkapuṣpikā /	             
SA_GS40_vanighpu-32	jīvakaḥ kūrcanibhas tu vṛṣāṇī vṛṣabho vṛṣaḥ // VAnigh_16 //	    tu       
SA_GS40_vanighpu-33	pṛśniparṇī pṛthakparṇī dhāvanī kalaśī guhā /	         
SA_GS40_vanighpu-34	śṛgālavinnā lāṅgūlī sthirā kroṣṭukapucchikā // VAnigh_17 //	        
SA_GS40_vanighpu-35	vidārigandhāṃśumatī śālaparṇī sthirā dhruvā /	          
SA_GS40_vanighpu-36	triparṇy atiguhā saumyā mahākṣī tanvikā matā // VAnigh_18 //	           
SA_GS40_vanighpu-37	vyāghrī nidigdhikā kṣudrā drāvaṇī kaṇṭakārikā /	          
SA_GS40_vanighpu-38	siṃhā ca kṣudravārttākī bṛhatī bahuputrikā // VAnigh_19 //	siṃhā ca kṣudravārttākī bṛhatī bahuputrikā 
SA_GS40_vanighpu-39	vārttākī hiṅgulī siṃhī bhāṇṭākī duṣpradharṣiṇī /	           
SA_GS40_vanighpu-40	gokaṇṭako gokṣurakaḥ śvadaṃṣṭrā ca trikaṇṭakaḥ // VAnigh_20 //	            
SA_GS40_vanighpu-41	kanyā gopī kṛṣṇavallī sārivā phāṇijihvikā /	            
SA_GS40_vanighpu-42	sugandhimūlā bhadrā ca sugandhā gopavally api // VAnigh_21 //	sugandhimūlā bhadrā ca sugandhā gopavallī api 
SA_GS40_vanighpu-43	haṃsapādī raktapādī tripādī kīṭamārikā /	          
SA_GS40_vanighpu-44	dhṛtarāṣṭrapadī caiva mṛtamandātiparṇikā // VAnigh_22 //	         
SA_GS40_vanighpu-45	sārivośīrakāśmarya- madhūkaśiśiradvayam /	            
SA_GS40_vanighpu-46	yaṣṭī paruṣakaṃ hanti dāhapittāsratṛḍjvarān // VAnigh_23 //	    hanti         
SA_GS40_vanighpu-47	sārivādigaṇaṃ vakṣye purā proktā tu sārivā /	sārivādi gaṇam vakṣye purā proktā tu sārivā 
SA_GS40_vanighpu-48	vīraṇyābhayalāmajja- kośīram amṛṇālakam // VAnigh_24 //	vīraṇī abhaya lāmajja ka uśīram amṛṇālakam 
SA_GS40_vanighpu-49	vīraṃ vīraṇamūlaṃ ca bahumūlaṃ raṇapriyā /	    ca      
SA_GS40_vanighpu-50	kāśmaryabhīruḥ śrīparṇī kāśmaryaṃ kaṭphalaṃ tathā // VAnigh_25 //	            
SA_GS40_vanighpu-51	ḍolāphalas tīkṣṇasāro madhūko guḍapuṣpakaḥ /	         
SA_GS40_vanighpu-52	madhupuṣpo lodhrapuṣpo vānaprastho madhudrumaḥ // VAnigh_26 //	         
SA_GS40_vanighpu-53	jñeyo madhūlasaṃjño 'pi madhūko vārisaṃsthitaḥ /	jñeyaḥ madhūla saṃjñaḥ madhūkaḥ vāri saṃsthitaḥ 
SA_GS40_vanighpu-54	chade hrasvas tailapuṣpas tulyas tu rasavīryataḥ // VAnigh_27 //	          
SA_GS40_vanighpu-55	bhadraśriyaṃ malayajaṃ gośīrṣaṃ śvetacandanam /	bhadraśriyam malayajam gośīrṣam śvetacandanam 
SA_GS40_vanighpu-56	kucandanaṃ tāmravarṇaṃ lohitaṃ raktacandanam // VAnigh_28 //	kucandanam tāmra varṇam lohitam raktacandanam 
SA_GS40_vanighpu-57	yaṣṭī madhukayaṣṭyāhvā madhukaṃ klītakāhvayam /	              
SA_GS40_vanighpu-58	paruṣako mṛduphalo roṣajo dhanvanacchadaḥ // VAnigh_29 //	         
SA_GS40_vanighpu-59	kṛṣṇāgranthikakākamācicavikāviśvauṣadhājājibhiḥ pāṭhārāmaṭhareṇukāgajakaṇāsiddhārthacitroṣaṇaiḥ /	                                    
SA_GS40_vanighpu-60	spṛkkā jātyajamodahiṅgutruṭibhiḥ bhārṅgīvilaṅgānvitaiḥ ebhir viṃśatibhiḥ kaphāmayaharaḥ kṛṣṇādiko 'yaṃ gaṇaḥ // VAnigh_30 //	spṛkkā jātī ajamoda hiṅgu truṭibhiḥ bhārṅgī vilaṅgā anvitaiḥ ebhiḥ viṃśatibhiḥ kapha āmaya haraḥ kṛṣṇā ādikaḥ yam gaṇaḥ 
SA_GS40_vanighpu-61	pippalī māgadhī kṛṣṇā vaidehī capalā kaṇā /	          
SA_GS40_vanighpu-62	upakulyā kaulanāmā śauṇḍī syāt tīkṣṇataṇḍulā // VAnigh_31 //	           
SA_GS40_vanighpu-63	kākamācī gucchaphalā svaryā maricikā phalā /	          
SA_GS40_vanighpu-64	kākolī cavikā cavyaṃ granthilā kolavallikā // VAnigh_32 //	          
SA_GS40_vanighpu-65	śuṇṭhī mahauṣadhaṃ viśvaṃ nāgaraṃ viśvabheṣajam /	śuṇṭhī mahauṣadham viśvam nāgaram viśvabheṣajam 
SA_GS40_vanighpu-66	ajājī jīrakaṃ mātā medhyaṃ syād auttarāpatham // VAnigh_33 //	ajājī jīrakam mātā medhyam syāt auttarāpatham 
SA_GS40_vanighpu-67	kṛṣṇajīreti kākolī kālikodgāraśodhanī /	  iti         
SA_GS40_vanighpu-68	jīraṇā kārabhī yoni- śūlaghnī copakuñcikā // VAnigh_34 //	jīraṇā kārabhī yoni śūlaghnī ca upakuñcikā 
SA_GS40_vanighpu-69	mālavī triśirā pāṭhā prācīnā vṛttaparṇikā /	          
SA_GS40_vanighpu-70	ambaṣṭhā sthāpanī vīrā bodhakī ca kucelikā // VAnigh_35 //	           
SA_GS40_vanighpu-71	jantughnaṃ jaraṇaṃ hiṅgu bhūtaghnaṃ vastihiṃsakaḥ /	          
SA_GS40_vanighpu-72	kapilā reṇukā kauntī rājaputrī hareṇukā // VAnigh_36 //	        
SA_GS40_vanighpu-73	śreyasī syād gajakaṇā- kṛtrimācavikāphalā /	            
SA_GS40_vanighpu-74	āsurī sarṣapo rājī nāsāsaṃvedanaḥ kaṭuḥ // VAnigh_37 //	          
SA_GS40_vanighpu-75	siddhārthako bhūtanāśo rakṣoghnaḥ śvetasarṣapaḥ /	         
SA_GS40_vanighpu-76	tilā kaṭvī matsyapittā kaṭukā śakulādanī // VAnigh_38 //	          
SA_GS40_vanighpu-77	vallījaṃ yavaneṣṭaṃ syān maricaṃ tīkṣṇam ūṣaṇam /	         
SA_GS40_vanighpu-78	spṛkkā spṛk brāhmaṇī devī piśunā ca latā satī // VAnigh_39 //	spṛkkā spṛś brāhmaṇī devī piśunā ca latā satī 
SA_GS40_vanighpu-79	jātīphalaṃ majjasāraṃ jātī madanaśauṇḍikau /	           
SA_GS40_vanighpu-80	ajamodā kharāhvā ca bastamodā ca markaṭī // VAnigh_40 //	ajamodā kharāhvā ca bastamodā ca markaṭī 
SA_GS40_vanighpu-81	elā tu drāviḍī tutthā sūkṣmailā bahulā truṭiḥ /	          
SA_GS40_vanighpu-82	bhārṅgī gardabhaśākaṃ ca padmā brāhmaṇayaṣṭikā // VAnigh_41 //	bhārṅgī gardabhaśākam ca padmā brāhmaṇayaṣṭikā 
SA_GS40_vanighpu-83	padmakapuṇḍrau vṛddhitugarddhayaḥ śṛṅgy amṛtā daśa jīvanasaṃjñāḥ /*	padmaka puṇḍrau vṛddhi tuga ṛddhayaḥ śṛṅgī amṛtā daśa jīvana saṃjñāḥ 
SA_GS40_vanighpu-84	stanyakarā ghnantīraṇapittaṃ prīṇanajīvanabṛṃhaṇavṛṣyāḥ // VAnigh_42 //*	stanya karāḥ ghnanti īraṇa pittam prīṇana jīvana bṛṃhaṇa vṛṣyāḥ 
SA_GS40_vanighpu-85	padmakādigaṇaṃ vakṣye hemapadmaṃ tu padmakam /	           
SA_GS40_vanighpu-86	prapauṇḍarīkaṃ śrīpuṣpaṃ puṇḍrāhvaṃ mūlasādhanam // VAnigh_43 //	            
SA_GS40_vanighpu-87	vṛddhis tu śrāvaṇī puṣṭiḥ mahāvṛddhiḥ parocyate /	vṛddhiḥ tu śrāvaṇī puṣṭiḥ mahāvṛddhiḥ parā ucyate 
SA_GS40_vanighpu-88	tavakṣīrī tuṣā śubhrā vaṃśākhyā vaṃśarocanā // VAnigh_44 //	tavakṣīrī tuṣā śubhrā vaṃśākhyā vaṃśarocanā 
SA_GS40_vanighpu-89	śṛṅgī smṛtā mahāghoṣā jñeyā karkaṭaśṛṅgikā /	          
SA_GS40_vanighpu-90	guḍūcī kuṇḍalī chinna- ruhā kāṇḍodbhavāmṛtā // VAnigh_45 //	          
SA_GS40_vanighpu-91	madhuparṇī vayaḥsthā ca maṇḍalī tantrikā smṛtā /	           
SA_GS40_vanighpu-92	śalyaparṇī maṇicchidrā medā medaḥsamudbhavā // VAnigh_46 //	          
SA_GS40_vanighpu-93	mahāmedā vṛkṣaruhā mahāpuruṣadantikā /	        
SA_GS40_vanighpu-94	daśānāṃ jīvanīyānāṃ saṃjñā tu parikīrtitā // VAnigh_47 //	daśānām jīvanīyānām saṃjñā tu parikīrtitā 
SA_GS40_vanighpu-95	paruṣakaṃ varā drākṣā kaṭphalaṃ katakāt phalāt /	            
SA_GS40_vanighpu-96	rājāhvaṃ dāḍimaṃ śākaṃ tṛṇmūtrāmayavātajit // VAnigh_48 //	                     
SA_GS40_vanighpu-97	paruṣādigaṇaṃ vakṣye purā proktaṃ paruṣakam /	          
SA_GS40_vanighpu-98	varottamā ca triphalā śreṣṭhā cāpi phalatrayam // VAnigh_49 //	varā uttamā ca triphalā śreṣṭhā ca api phalatrayam 
SA_GS40_vanighpu-99	prāṇadā pūtanāmoghā harītaky abhayā jayā /	prāṇadā pūtanā amoghā harītakī abhayā jayā 
SA_GS40_vanighpu-100	pathyāmṛtā haimavatī kāyasthā rohiṇī smṛtā // VAnigh_50 //	pathyā amṛtā haimavatī kāyasthā rohiṇī smṛtā 
SA_GS40_vanighpu-101	akṣaḥ kaliḥ karṣaphalo vindhyajāto vibhītakaḥ /	         
SA_GS40_vanighpu-102	koraṅgako mṛduphalo dhātrī cāmalakī śivā // VAnigh_51 //	           
SA_GS40_vanighpu-103	rohiṇī khaṭvalā proktā drākṣā mṛduphalā tathā /	           
SA_GS40_vanighpu-104	mṛdvīkā tūttamaphalā gostanī cauttarāpathā // VAnigh_52 //	             
SA_GS40_vanighpu-105	hemavalko mahāvalko bhadravṛkṣaś ca kīrtitaḥ /	          
SA_GS40_vanighpu-106	katakasya phalaṃ kātyaṃ jñeyaṃ vāriprasādanam // VAnigh_53 //	           
SA_GS40_vanighpu-107	rājādanaṃ kṣīraśuklaṃ rājāhvaṃ vānarapriyam /	           
SA_GS40_vanighpu-108	śukeṣṭaṃ dāḍimaṃ caiva raktabījaphalāhvayam // VAnigh_54 //	             
SA_GS40_vanighpu-109	svādvamlaṃ rocanaṃ caiva dvitīyam amladāḍimam /	            
SA_GS40_vanighpu-110	bṛhacchadas tathā śāko varadāruḥ kharacchadaḥ // VAnigh_55 //	         
SA_GS40_vanighpu-111	añjanaṃ phalinī māṃsī padmotpalarasāñjanam /	añjanam phalinī māṃsī padma utpala rasāñjanam 
SA_GS40_vanighpu-112	sailāmadhukanāgāhvaṃ viṣāntardāhapittanut // VAnigh_56 //	                  
SA_GS40_vanighpu-113	smṛtaṃ srotoñjanaṃ vīram añjanaṃ yāmunaṃ tathā /	smṛtam srotoñjanam vīram añjanam yāmunam tathā 
SA_GS40_vanighpu-114	srotodbhavam atho nādyaṃ sauvīraṃ netrabhūṣaṇam // VAnigh_57 //	srotodbhavam atho nādyam sauvīram netrabhūṣaṇam 
SA_GS40_vanighpu-115	phalinī kolagirikā śyāmā kāntā priyaṅgukā /	          
SA_GS40_vanighpu-116	piśācī naladaṃ māṃsī jaṭilā bhūtakeśinī // VAnigh_58 //	           
SA_GS40_vanighpu-117	nalinaṃ puṣkaraṃ padmam aravindaṃ kuśeśayam /	nalinam puṣkaram padmam aravindam kuśeśayam 
SA_GS40_vanighpu-118	paṅkeruhaṃ tāmarasaṃ sārasaṃ sarasīruham // VAnigh_59 //	paṅkeruham tāmarasam sārasam sarasīruham 
SA_GS40_vanighpu-119	bisaprasūnarājīva- jalajāmbhoruhāṇi ca /	bisaprasūna rājī iva jalaja ambhoruhāṇi ca 
SA_GS40_vanighpu-120	indīvaraṃ kuvalayaṃ nīlaṃ nīlotpalaṃ tathā // VAnigh_60 //	indīvaram kuvalayam nīlam nīlotpalam tathā 
SA_GS40_vanighpu-121	saugandhikaṃ tu kalhāraṃ raktotpalasugandhike /	saugandhikam tu kalhāram raktotpala sugandhike 
SA_GS40_vanighpu-122	dravāhvam amṛtāsaṅga- kṛtaṃ tārkṣyo rasāñjanam // VAnigh_61 //	           
SA_GS40_vanighpu-123	elā tu drāviḍī proktā bahulā truṭisaṃjñakā /	elā tu drāviḍī proktā bahulā truṭi saṃjñakā 
SA_GS40_vanighpu-124	hemapuṣpaṃ tu nāgāhvaṃ kesaraṃ nāgakesaram // VAnigh_62 //	         
SA_GS40_vanighpu-125	paṭolakaṭurohiṇīcandanaṃ madhusravaguḍūcīpāṭhānvitam /	                         
SA_GS40_vanighpu-126	nihanti kaphapittakuṣṭhajvarān viṣaṃ vamim arocakaṃ kāmalām // VAnigh_63 //	nihanti kapha pitta kuṣṭha jvarān viṣam vamim arocakam kāmalām 
SA_GS40_vanighpu-127	paṭolādis tu rājīmat kulakaṃ ca paṭolakam /	paṭola ādiḥ tu rājīmat kulakam ca paṭolakam 
SA_GS40_vanighpu-128	kharacchadaḥ pāṇḍuphalo rājamānyo 'mṛtāphalaḥ // VAnigh_64 //	         
SA_GS40_vanighpu-129	pīluparṇī madhurasā mūrvā cātirasā smṛtā /	           
SA_GS40_vanighpu-130	madhusravā pīlupattrā moraṭī kṣīramoraṭam // VAnigh_65 //	         
SA_GS40_vanighpu-131	guḍūcīpadmakāriṣṭa- dhānakāraktacandanam /	guḍūcī padmaka ariṣṭa dhānakā raktacandanam 
SA_GS40_vanighpu-132	pittaśleṣmajvaracchardi- dāhatṛṣṇāghnam agnikṛt // VAnigh_66 //	                      
SA_GS40_vanighpu-133	nimbo 'riṣṭo guḍūcyādau picumāndaḥ śukapriyaḥ /	             
SA_GS40_vanighpu-134	dhānyā kustumburuḥ dhānyaṃ dhanikā dhānyakaṃ tathā // VAnigh_67 //	            
SA_GS40_vanighpu-135	āragvadhendrayavapāṭalikākatiktā- nimbāmṛtāmadhurasāsruvavṛkṣapāṭhāḥ /	āragvadha indrayava pāṭali kākatiktāḥ nimba amṛtā madhurasā sruvavṛkṣa pāṭhāḥ 
SA_GS40_vanighpu-136	bhūnimbasairyakapaṭolakarañjayugma- saptacchadāgnisuṣavīphalabāṇaghoṇṭāḥ // VAnigh_68 //	                     
SA_GS40_vanighpu-137	āragvadhādir jayati chardikuṣṭhaviṣajvarān /	āragvadha ādiḥ jayati chardi kuṣṭha viṣa jvarān 
SA_GS40_vanighpu-138	kaphaṃ kaṇḍūṃ pramehaṃ ca duṣṭavraṇaviśodhanaḥ // VAnigh_69 //	kapham kaṇḍūm prameham ca duṣṭavraṇa viśodhanaḥ 
SA_GS40_vanighpu-139	āragvadho rājavṛkṣaḥ śamyākaś caturaṅgulaḥ /	āragvadhaḥ rājavṛkṣaḥ śamyākaḥ caturaṅgulaḥ 
SA_GS40_vanighpu-140	ārevato vyādhighātaḥ pragrahaḥ kṛtamālakaḥ // VAnigh_70 //	ārevataḥ vyādhighātaḥ pragrahaḥ kṛtamālakaḥ 
SA_GS40_vanighpu-141	kaliṅgakas tv indrayavo vatsakaḥ kauṭajaṃ phalam /	  tu         
SA_GS40_vanighpu-142	pāṭalī dīrghavṛttā ca sthalyāmoghāmbuvāsinī // VAnigh_71 //	pāṭalī dīrgha vṛttā ca sthalyā amogha ambu vāsinī 
SA_GS40_vanighpu-143	vṛttatuṇḍā kākatiktā śārṅgeṣṭāṅgāravallikā /	          
SA_GS40_vanighpu-144	vyāghrapādaḥ sruvataruḥ svādukaṇṭo vikaṅkataḥ // VAnigh_72 //	        
SA_GS40_vanighpu-145	kirātatikto bhūnimbaḥ kattṛṇaḥ kāṇḍatiktakaḥ /	          
SA_GS40_vanighpu-146	sairyakas tu sahacaraḥ saryako mṛdupuṣpakaḥ // VAnigh_73 //	  tu         
SA_GS40_vanighpu-147	bāṇaḥ smṛto nīlapuṣpaḥ dhīraśauryakaghośvarāḥ /	bāṇaḥ smṛtaḥ nīlapuṣpaḥ dhīra śauryaka ghośvarāḥ 
SA_GS40_vanighpu-148	pūtikarañjaḥ kaiḍaryaḥ prakīryaś cirabilvakaḥ // VAnigh_74 //	          
SA_GS40_vanighpu-149	udakīryo naktamālaḥ karañjo lājapuṣpakaḥ /	          
SA_GS40_vanighpu-150	saptacchado 'yugmapattraḥ saptāhvo gucchapuṣpakaḥ // VAnigh_75 //	         
SA_GS40_vanighpu-151	citrako dvīpisaṃjñas tu vahniparyāyavācakaḥ /	            
SA_GS40_vanighpu-152	raktacitras tathānyas tu mahāṅgaḥ kālamūlakaḥ // VAnigh_76 //	raktacitraḥ tathā anyaḥ tu mahāṅgaḥ kālamūlakaḥ 
SA_GS40_vanighpu-153	pānīyavallī suṣavī bṛhadvally utpalacchadā /	          
SA_GS40_vanighpu-154	gālo rāṭho 'tha madanaḥ piṇḍītaḥ karahāṭakaḥ // VAnigh_77 //	madanaḥ piṇḍītaḥ karahāṭakaḥ 
SA_GS40_vanighpu-155	śalyakaiḍaryavṛkṣaḥ syāc chardanas tagaraḥ phalam /	         
SA_GS40_vanighpu-156	ghoṇṭo muṇṭhagopaghoṇṭau padmakī markaṭāhvayā // VAnigh_78 //	             
SA_GS40_vanighpu-157	asanatiniśabhūrjaśvetavāhaprakīryā khadirakadarabhaṇḍīśiṃśapāmeṣaśṛṅgyaḥ /	asana tiniśa bhūrja śvetavāha prakīryā khadira kadara bhaṇḍī śiṃśapā meṣaśṛṅgyaḥ 
SA_GS40_vanighpu-158	trihimatalapalāśāḥ joṅgakaḥ śākaśālau kramukadhavakaliṅgacchāgakarṇāśvakarṇāḥ // VAnigh_79 //	trihima tala palāśāḥ joṅgakaḥ śāka śālau kramuka dhava kaliṅga chāgakarṇa aśvakarṇāḥ 
SA_GS40_vanighpu-159	asanādir vijayate śvitrakuṣṭhakaphakrimīn /	asana ādiḥ vijayate śvitra kuṣṭha kapha krimīn 
SA_GS40_vanighpu-160	pāṇḍurogaṃ pramehaṃ ca medodoṣanibarhaṇaḥ // VAnigh_80 //	pāṇḍu rogam prameham ca medaḥ doṣa nibarhaṇaḥ 
SA_GS40_vanighpu-161	asanādau pītasāraḥ priyako bījako 'sanaḥ /	asana ādau pītasāraḥ priyakaḥ bījakaḥ sanaḥ 
SA_GS40_vanighpu-162	syandanaḥ stimito nemiḥ rathadruḥ sarvasādhakaḥ // VAnigh_81 //	           
SA_GS40_vanighpu-163	bhūrjo bhurjo bahupuṭo mṛdutvak cāsthiracchadaḥ /	bhūrjaḥ bhurjaḥ bahupuṭaḥ mṛdutvac ca asthiracchadaḥ 
SA_GS40_vanighpu-164	pārtho 'rjunaḥ śvetavāhaḥ kakubhaḥ phālgunāhvayaḥ // VAnigh_82 //	              
SA_GS40_vanighpu-165	gāyatrī khadiro gītā kuṣṭhaghno bālapattrakaḥ /	           
SA_GS40_vanighpu-166	kadaraḥ khadiraḥ sāraḥ koṭarī śyāmasārakaḥ // VAnigh_83 //	           
SA_GS40_vanighpu-167	bhaṇḍī śukadruḥ plavaṃgaḥ śirīṣo mṛdupuṣpakaḥ /	          
SA_GS40_vanighpu-168	kapilā śiṃśapā kṛṣṇa- sāro maṇḍalapattrakaḥ // VAnigh_84 //	         
SA_GS40_vanighpu-169	bastāntrī meṣaśṛṅgī ca cakṣuṣyā bahulāṅgikā /	          
SA_GS40_vanighpu-170	kāleyakaṃ pītasāraṃ tṛtīyaṃ varṇakṛddhimam // VAnigh_85 //	            
SA_GS40_vanighpu-171	tāḍas tālo dīrghatarus tṛṇarājas tribījakaḥ /	          
SA_GS40_vanighpu-172	palāśaḥ kiṃśuko vāta- rodho brahmataruḥ paṭuḥ // VAnigh_86 //	palāśaḥ kiṃśukaḥ vāta rodhaḥ brahmataruḥ paṭuḥ 
SA_GS40_vanighpu-173	joṅgakaḥ śītaśamano lohanāmāgaruḥ smṛtaḥ /	         
SA_GS40_vanighpu-174	sajahviḥ śrīkaraḥ śālo raso niryāsarālakau // VAnigh_87 //	           
SA_GS40_vanighpu-175	dhavo dṛḍhatarur gauraḥ śakaṭākṣo marūdbhavaḥ /	           
SA_GS40_vanighpu-176	kramukaṃ kaivukaṃ pūgaṃ kaṣāyaṃ madhur āhvayam // VAnigh_88 //	           
SA_GS40_vanighpu-177	śvetaghnaḥ śītaśamanaḥ bastakarṇo 'jakarṇakaḥ /	          
SA_GS40_vanighpu-178	śasyasaṃvaraṇaḥ śūraḥ kuśikaś cāśvakarṇakaḥ // VAnigh_89 //	śasyasaṃvaraṇaḥ śūraḥ kuśikaḥ ca aśvakarṇakaḥ 
SA_GS40_vanighpu-179	varuṇasairyakayugmaśatāvarī- dahanamoraṭabilvaviṣāṇikāḥ /	                     
SA_GS40_vanighpu-180	dvibṛhatīdvikarañjajayādvayaṃ bahalapallavadarbharujākarāḥ // VAnigh_90 //	dvi bṛhatī dvi karañja jayā dvayam bahalapallava darbha rujākarāḥ 
SA_GS40_vanighpu-181	varuṇādiḥ kaphaṃ medo mandāgnitvaṃ niyacchati /	varuṇādiḥ kapham medaḥ mandāgni tvam niyacchati 
SA_GS40_vanighpu-182	āḍhyavātaṃ śiraḥśūlaṃ gulmaṃ cāntaḥ savidradhim // VAnigh_91 //	āḍhyavātam śiraḥśūlam gulmam ca antar sa vidradhim 
SA_GS40_vanighpu-183	varuṇādau śvetapuṣpo varuṇo varaṇaḥ smṛtaḥ /	             
SA_GS40_vanighpu-184	śaṭālavṛkṣo bilvo 'strī pūtivāto mahāphalaḥ // VAnigh_92 //	         
SA_GS40_vanighpu-185	mālūraḥ śrīphalaḥ śaivaḥ śāṇḍilyaḥ śrīnivāsakaḥ /	            
SA_GS40_vanighpu-186	mahākālyajaśṛṅgī ca kūrcaparṇī viṣāṇikā // VAnigh_93 //	          
SA_GS40_vanighpu-187	jayāgnimantho 'raṇikā takkārī vaijayantikā /	        
SA_GS40_vanighpu-188	śigruḥ śobhāñjanas tīkṣṇa- gandho bahalapallavaḥ // VAnigh_94 //	         
SA_GS40_vanighpu-189	muraṅgī śigruko rakta- puṣpo madhuraśigrukaḥ /	        
SA_GS40_vanighpu-190	tṛtīyo madhuraḥ siṃśa- kesaro madhuśigrukaḥ // VAnigh_95 //	tṛtīyaḥ madhuraḥ siṃśa kesaraḥ madhuśigrukaḥ 
SA_GS40_vanighpu-191	sitaṃ tīkṣṇaṃ śigrubījaṃ śvetāṅgaṃ maricāhvayam /	              
SA_GS40_vanighpu-192	darbhaḥ kuśo lavaḥ sthūlaḥ sūkṣmo vedapavitrakaḥ // VAnigh_96 //	              
SA_GS40_vanighpu-193	rujākaras tv ārtagalo huṃkāro bhīṣaṇāhvayaḥ /	            
SA_GS40_vanighpu-194	jālavṛkṣo duṣpradharṣaḥ svādutiktaphalaḥ smṛtaḥ // VAnigh_97 //	         
SA_GS40_vanighpu-195	ūṣakas tutthakaṃ hiṅgu kāsīsadvayasaindhavam /	           
SA_GS40_vanighpu-196	saśilājatu kṛcchrāśma- gulmamedaḥkaphāpaham // VAnigh_98 //	               
SA_GS40_vanighpu-197	ūṣakādau tu vṛṣako vūṣako rucakāhvayaḥ /	ūṣaka ādau tu vṛṣakaḥ vūṣakaḥ rucaka āhvayaḥ 
SA_GS40_vanighpu-198	ūṣo niḥsārakaḥ siṃho mūtravṛddhikaraḥ smṛtaḥ // VAnigh_99 //	            
SA_GS40_vanighpu-199	kaṭhinaṃ tutthakaṃ dvedhā karparaṃ barhikaṇṭakam /	           
SA_GS40_vanighpu-200	jantughnaṃ jaraṇaṃ hiṅgu rāmaṭhaṃ bhūtanāśanam // VAnigh_100 //	            
SA_GS40_vanighpu-201	kāsīsaṃ pāṃśudhāvākhyaṃ dvitīyaṃ puṣpasaṃjñakam /	               
SA_GS40_vanighpu-202	saindhavaṃ māṇimanthaṃ ca nādeyaṃ lavaṇottamam // VAnigh_101 //	saindhavam māṇimantham ca nādeyam lavaṇottamam 
SA_GS40_vanighpu-203	śilājaṃ dhātujaṃ jñeyaṃ mandarotthaṃ śilājatu /	          
SA_GS40_vanighpu-204	pārvataṃ śailaniryāsaḥ girijaṃ ca śilāhvayam // VAnigh_102 //	            
SA_GS40_vanighpu-205	vellantarāraṇikabūkavṛṣāśmabheda- gokaṇṭakotkaṭasahācarabāṇakāśāḥ /	vellantara araṇika būka vṛṣa aśmabheda gokaṇṭaka utkaṭa sahācara bāṇa kāśāḥ 
SA_GS40_vanighpu-206	vṛkṣādanīnalakuśādvayaguṇṭhagundrā- bhallūkamoraṭakuraṇṭakarambhapārthāḥ // VAnigh_103 //	vṛkṣādanī nala kuśā dvaya guṇṭha gundrāḥ bhallūka moraṭa kuraṇṭa karambha pārthāḥ 
SA_GS40_vanighpu-207	vargo vīratarādyo 'yaṃ hanti vātakṛtān gadān /	vargaḥ vīratarādyaḥ yam hanti vāta kṛtān gadān 
SA_GS40_vanighpu-208	aśmarīśarkarāmūtra- kṛcchrāghātarujāharaḥ // VAnigh_104 //	              
SA_GS40_vanighpu-209	vellantaro vīratarur gaṇe vīratarādike /	           
SA_GS40_vanighpu-210	vasukaḥ sthūlapuṣpaś ca bukaś ceśvaramallikā // VAnigh_105 //	            
SA_GS40_vanighpu-211	siṃhāsyaḥ karkaṭaś caiva vṛṣakaś cāṭarūṣakaḥ /	siṃhāsyaḥ karkaṭaḥ ca eva vṛṣakaḥ ca āṭarūṣakaḥ 
SA_GS40_vanighpu-212	veṇupatrī vṛṣā pārvī parvaṇī vaṃśapatrikā // VAnigh_106 //	          
SA_GS40_vanighpu-213	aśmabhedī śilābhedī jñeyā pāṣāṇabhedikā /	          
SA_GS40_vanighpu-214	utkaṭā sūkṣmapatrā ca dīrghalohitayaṣṭikā // VAnigh_107 //	utkaṭā sūkṣma patrā ca dīrgha lohita yaṣṭikā 
SA_GS40_vanighpu-215	śarekṣukusumau bāṇaḥ sa kāṇḍekṣunibhāṅghrikaḥ /	śara ikṣu kusumau bāṇaḥ sa kāṇḍa ikṣu nibha aṅghrikaḥ 
SA_GS40_vanighpu-216	śvetacāmarakaḥ kāśo gundrā syād gucchapuṣpikā // VAnigh_108 //	           
SA_GS40_vanighpu-217	vṛkṣādanī tu śikharo vandākaḥ kāmavṛkṣakaḥ /	          
SA_GS40_vanighpu-218	mṛdupuṣpo 'tha suṣiro nadīstho nalako nalaḥ // VAnigh_109 //	suṣiraḥ nadīsthaḥ nalakaḥ nalaḥ 
SA_GS40_vanighpu-219	guṇṭho vṛttatṛṇaḥ śuṇṭhaḥ śṛṅgaverābhamūlakaḥ /	            
SA_GS40_vanighpu-220	bhallūko bhūtavṛkṣaś ca śyonākaś caiva ṭuṇṭukaḥ // VAnigh_110 //	bhallūkaḥ bhūtavṛkṣaḥ ca śyonākaḥ ca eva ṭuṇṭukaḥ 
SA_GS40_vanighpu-221	śrīhastinī kuraṭakā picukaḥ śitivārakaḥ /	         
SA_GS40_vanighpu-222	kṛṣṇasūkṣmaphalā yukta- puṣpā mastakamañjarī // VAnigh_111 //	       
SA_GS40_vanighpu-223	karambhaḥ karkaśo yugma- phalā cottamakanyakā /	karambhaḥ karkaśaḥ phalā ca uttamakanyakā 
SA_GS40_vanighpu-224	kapotavaṅkā varadā ravibhaktā suvarcalā // VAnigh_112 //	        
SA_GS40_vanighpu-225	rodhraśābarakarodhrapalāśāḥ jiṅgiṇīsaralakaṭphalayuktāḥ /	                            
SA_GS40_vanighpu-226	kutsitāmbakadalīgataśokāḥ sailavāluparipelavamocāḥ // VAnigh_113 //	kutsitāmba kadalī gataśokāḥ sailavālu paripelava mocāḥ 
SA_GS40_vanighpu-227	eṣa rodhrādiko nāma medaḥkaphaharo gaṇaḥ /	eṣa rodhra ādikaḥ nāma medaḥ kapha haraḥ gaṇaḥ 
SA_GS40_vanighpu-228	yonidoṣaharaḥ stambhī varṇyo viṣavināśanaḥ // VAnigh_114 //	             
SA_GS40_vanighpu-229	lodhrādau tilvako lodhras tirīṭaḥ paṭṭikāhvayaḥ /	               
SA_GS40_vanighpu-230	dvitīyaḥ śābaraḥ śveto ghanatvak cākṣibheṣajaḥ // VAnigh_115 //	dvitīyaḥ śābaraḥ śvetaḥ ghanatvac ca akṣibheṣajaḥ 
SA_GS40_vanighpu-231	jiṅgiṇī jhiṅgiṇī jñeyā mocakī guḍamañjarī /	           
SA_GS40_vanighpu-232	pūtikāṣṭhaṃ devavṛkṣaḥ saralo devadārukaḥ // VAnigh_116 //	         
SA_GS40_vanighpu-233	surakāṣṭhaṃ bhadradāruḥ devaparyāyavācakaḥ /	            
SA_GS40_vanighpu-234	sugandhā suvahā rāsnā yuktāhvā gandhanākulī // VAnigh_117 //	          
SA_GS40_vanighpu-235	surabhiś ca kadambaś ca kuñcitāṅgo haripriyaḥ /	surabhiḥ ca kadambaḥ ca kuñcitāṅgaḥ haripriyaḥ 
SA_GS40_vanighpu-236	rambhā tu kadalī mocā vṛttapuṣpāṃśumatphalā // VAnigh_118 //	              
SA_GS40_vanighpu-237	aśoko vigataśokaḥ subhagas tāmrapallavaḥ /	        
SA_GS40_vanighpu-238	elavālukam aileyaṃ bāleyaṃ harivālukam // VAnigh_119 //	elavālukam aileyam bāleyam harivālukam 
SA_GS40_vanighpu-239	kuṭannaṭaṃ plavaṃgaṃ ca vitunnaṃ paripelavam /	kuṭannaṭam plavaṃgam ca vitunnam paripelavam 
SA_GS40_vanighpu-240	surabhiḥ sallakī mocā mahārambhā gajapriyā // VAnigh_120 //	          
SA_GS40_vanighpu-241	arkālakau nāgadantī viśalyā bhārṅgī rāsnā vṛścikālī prakīryā /	             
SA_GS40_vanighpu-242	pratyakpuṣpī pītatailodakīryā śvetāyugmaṃ tāpasānāṃ ca vṛkṣaḥ // VAnigh_121 //	pratyakpuṣpī pītatailā udakīryā śvetā yugmam tāpasānām ca vṛkṣaḥ 
SA_GS40_vanighpu-243	ayam arkādiko vargaḥ kaphamedoviṣāpahaḥ /	ayam arka ādikaḥ vargaḥ kapha medaḥ viṣa apahaḥ 
SA_GS40_vanighpu-244	kṛmikuṣṭhapraśamano viśeṣād vraṇaśodhanaḥ // VAnigh_122 //	             
SA_GS40_vanighpu-245	arkādau tu sadāpuṣpā sūryāhvārkas tu rūpikā /	             
SA_GS40_vanighpu-246	mandāraḥ śvetakusumo 'larko vikaraṇaḥ smṛtaḥ // VAnigh_123 //	           
SA_GS40_vanighpu-247	nāgadantī śvetaghaṇṭā nāginī pūrvapuṣpikā /	           
SA_GS40_vanighpu-248	viśalyā halinī vahmi- jihvā lāṅgalikā smṛtā // VAnigh_124 //	           
SA_GS40_vanighpu-249	bhārṅgī phañjī ca pālindī dvijayaṣṭiḥ sugandhikā /	    ca       
SA_GS40_vanighpu-250	apāmārgaḥ śaikharikaḥ pratyakpuṣpī mayūrakaḥ // VAnigh_125 //	         
SA_GS40_vanighpu-251	kākādanī pītatailā vegā kākāṇḍakī tathā /	          
SA_GS40_vanighpu-252	jyotiṣmatī pītatailā vegā kaṅguṇikā smṛtā // VAnigh_126 //	          
SA_GS40_vanighpu-253	śvetā sunābhiḥ kaṭabhī kiṇihī madhureṇukā /	śvetā sunābhiḥ kaṭabhī kiṇihī madhureṇukā 
SA_GS40_vanighpu-254	kaṭaṃbharā mahāśvetā kālindī kaṭabhī sitā // VAnigh_127 //	          
SA_GS40_vanighpu-255	kumāryākhyā mahāśvetā vandhyā karkoṭakī tathā /	           
SA_GS40_vanighpu-256	iṅgudas tiktamañjā ca pīlukas tāpasadrumaḥ // VAnigh_128 //	iṅgudaḥ tiktamañjā ca pīlukaḥ tāpasadrumaḥ 
SA_GS40_vanighpu-257	surasayugaphaṇijjaṃ kālamālā viḍaṅgaṃ kharabusavṛṣakarṇī kaṭphalaṃ kāsamardaḥ /	                    
SA_GS40_vanighpu-258	kṣavakasarasibhārṅgīkārmukāḥ kākamācī kulahalaviṣamuṣṭī bhūstṛṇo bhūtaveśī // VAnigh_129 //	kākamācī kulahala viṣamuṣṭī bhūstṛṇaḥ bhūtaveśī 
SA_GS40_vanighpu-259	surasādir gaṇaḥ śleṣma- medaḥkṛminiṣūdanaḥ /	              
SA_GS40_vanighpu-260	pratiśyāyāruciśvāsa- kāsaghno vraṇaśodhanaḥ // VAnigh_130 //	            
SA_GS40_vanighpu-261	surasādau gaṇe dvedhā surā kṛṣṇagarur ataḥ /	             
SA_GS40_vanighpu-262	svādugandhicchadā caiva kāyasthā tulasī tathā // VAnigh_131 //	svādu gandhi chadā ca eva kāyasthā tulasī tathā 
SA_GS40_vanighpu-263	phaṇijjako mañjarīkas tīkṣṇagandhaḥ sugandhikaḥ /	        
SA_GS40_vanighpu-264	kṛṣṇasarjakaḥ kālamālaḥ vaṭhiñjarakuṭherakau // VAnigh_132 //	            
SA_GS40_vanighpu-265	viḍaṅgaṃ kṛmijid balyaṃ kirīṭaṃ śvetataṇḍulam /	            
SA_GS40_vanighpu-266	śūkātmakaḥ kharabusau maruvaḥ kharapattrakaḥ // VAnigh_133 //	         
SA_GS40_vanighpu-267	vṛṣakarṇyākhukarṇī ca tathā bhūmipariśrayā /	vṛṣakarṇī ākhukarṇī ca tathā bhūmipariśrayā 
SA_GS40_vanighpu-268	rājakṣavaḥ pītapuṣpaḥ kāsaghnaṃ kāsamardakaḥ // VAnigh_134 //	         
SA_GS40_vanighpu-269	udvegajananas tīkṣṇaḥ kṣavakaḥ kṣudvibodhakaḥ /	            
SA_GS40_vanighpu-270	kapitthapattrī jharasī nirjharā jharapattrikā // VAnigh_135 //	         
SA_GS40_vanighpu-271	prācīnā bodhakī kāntā kāmukā raktamañjarī /	        
SA_GS40_vanighpu-272	mādhavī syād amuktaś ca suvasanto 'timuktakaḥ // VAnigh_136 //	mādhavī syāt amuktaḥ ca timuktakaḥ 
SA_GS40_vanighpu-273	kākamācī gūḍhaphalā kākāhvā mācikāpi ca /	               
SA_GS40_vanighpu-274	volo vṛddhaḥ kulahalo jambūlo bhūkadambakaḥ // VAnigh_137 //	          
SA_GS40_vanighpu-275	viṣamuṣṭiś ca karkoṭī kṣayāhvā keśamuṣṭikā /	          
SA_GS40_vanighpu-276	putrāñjaliḥ bhūtakeśī bhūstṛṇo guhyabījakaḥ // VAnigh_138 //	         
SA_GS40_vanighpu-277	bhūtāveśī bhūtakeśī nirguṇḍī tinduvārakaḥ /	        
SA_GS40_vanighpu-278	śephālikā śvetapuṣpā śvetanirguṇḍikā smṛtā // VAnigh_139 //	          
SA_GS40_vanighpu-279	muṣkakasnugvarādvīpi- palāśadhavaśiṃśapāḥ /	muṣkaka snuh varā dvīpi palāśa dhava śiṃśapāḥ 
SA_GS40_vanighpu-280	gulmamehāśmarīpāṇḍu- medo 'rśaḥkaphaśukrajit // VAnigh_140 //	                       
SA_GS40_vanighpu-281	muṣkakādau tu śikharī muṣkako mokṣakas tathā /	           
SA_GS40_vanighpu-282	kālamuṣkaḥ kṣāravṛkṣaḥ kṣīṇavāriphalaḥ smṛtaḥ // VAnigh_141 //	         
SA_GS40_vanighpu-283	sudhā vajrī mahāvṛkṣo granthilā snug guḍā snuhī /	sudhā vajrī mahāvṛkṣaḥ granthilā snuh guḍā snuhī 
SA_GS40_vanighpu-284	samantadugdhā śvajihva- patraś ca yugmakaṇṭakaḥ // VAnigh_142 //	samantadugdhā śvajihva patraḥ ca yugmakaṇṭakaḥ 
SA_GS40_vanighpu-285	vatsakamūrvābhārṅgīkaṭukā marīcaṃ ghuṇapriyā ca gaṇḍīram /*	vatsaka mūrvā bhārṅgī kaṭukāḥ marīcam ghuṇapriyā ca gaṇḍīram 
SA_GS40_vanighpu-286	elā pāṭhā jājī kaṭvaṅgaphalājamodasiddhārthavacāḥ // VAnigh_143 //*	             
SA_GS40_vanighpu-287	jīrakahiṅguviḍaṅgaṃ paśugandhā pañcakolakaṃ hanti /*	jīraka hiṅgu viḍaṅgam paśugandhā pañcakolakam hanti 
SA_GS40_vanighpu-288	calakaphamedaḥpīnasagulmajvaraśūladurnāmnaḥ // VAnigh_144 //*	cala kapha medaḥ pīnasa gulma jvara śūla durnāmnaḥ 
SA_GS40_vanighpu-289	vanatikto vatsakādau kuṭajo girimallikā /	          
SA_GS40_vanighpu-290	vṛkṣakaḥ śakravṛkṣaś ca vatsakaḥ kuṭajas tathā // VAnigh_145 //	           
SA_GS40_vanighpu-291	bhaṅgurātiviṣā mādrī śuklakandā ghuṇapriyā /	          
SA_GS40_vanighpu-292	dvitīyā tu prativiṣā śvetaraktaviṣā matā // VAnigh_146 //	dvitīyā tu prativiṣā śvetaraktaviṣā matā 
SA_GS40_vanighpu-293	dīrghavṛnto mahānimbaḥ kaṭvaṅgo 'ralutiktakaḥ /	          
SA_GS40_vanighpu-294	dīpyakaṃ tv ajamodas tu yavānī jaraṇāhvayā // VAnigh_147 //	             
SA_GS40_vanighpu-295	vacogragandhā jaṭilā ṣaḍgranthā haimavatyapi /	vacā ugragandhā jaṭilā ṣaḍgranthā haimavatī api 
SA_GS40_vanighpu-296	śuklā yā sā svādukandā suvāsā himasaṃbhavā // VAnigh_148 //	śuklā yā sā svādukandā suvāsāḥ himasaṃbhavā 
SA_GS40_vanighpu-297	vacājaladadevāhva- nāgarātiviṣāmayāḥ /	            
SA_GS40_vanighpu-298	haridrādvayayaṣṭyāhva- kalaśīkuṭajodbhavāḥ // VAnigh_149 //	                                                       
SA_GS40_vanighpu-299	vacāharidrādigaṇāv āmātīsāranāśanau /	            
SA_GS40_vanighpu-300	medaḥkaphāḍhyapavana- stanyadoṣanibarhaṇau // VAnigh_150 //	            
SA_GS40_vanighpu-301	vacādau prāg vacā proktā mustā tu jaladāhvayā /	                                                   
SA_GS40_vanighpu-302	gāṅgeyī kuruvindā ca devāhvā bhadramustakam // VAnigh_151 //	          
SA_GS40_vanighpu-303	haridrādigaṇaṃ vakṣye gaurī śyāmā ca nirviṣā /	             
SA_GS40_vanighpu-304	niśā kṣapā ca rātriś ca varā lomaśamūlikā // VAnigh_152 //	niśā kṣapā ca rātriḥ ca varā lomaśamūlikā 
SA_GS40_vanighpu-305	svarṇavarṇā haridrā tu niśāhvā rajanī tathā /	          
SA_GS40_vanighpu-306	dārvī kaṭaṃkaṭerī ca parjanyā ca pacampacā // VAnigh_153 //	dārvī kaṭaṃkaṭerī ca parjanyā ca pacampacā 
SA_GS40_vanighpu-307	priyaṅgupuṣpāñjanayugmapadmāḥ padmādrajo yojanavallyanantā /	priyaṅgu puṣpāñjana yugma padmāḥ padmāt rajaḥ yojanavallī anantā 
SA_GS40_vanighpu-308	mānadrumo mocarasaḥ samaṅgā punnāgaśītaṃ madanīyahetuḥ // VAnigh_154 //	             
SA_GS40_vanighpu-309	ambaṣṭhā madhukaṃ namaskarī nandīvṛkṣapalāśakacchurā /	            
SA_GS40_vanighpu-310	rodhraṃ dhātakibilvapeśike kaṭvaṅgaṃ kamalodbhavaṃ rajaḥ // VAnigh_155 //	               
SA_GS40_vanighpu-311	gaṇau priyaṅgvambaṣṭhādī pakvātīsāranāśanau /	              
SA_GS40_vanighpu-312	sandhānīyau hitau pitte vraṇānām api ropaṇau // VAnigh_156 //	sandhānīyau hitau pitte vraṇānām api ropaṇau 
SA_GS40_vanighpu-313	priyaṅgvādigaṇe pūrvaṃ priyaṅguḥ samudāhṛtā /	            
SA_GS40_vanighpu-314	padmāsitāravindā ca cāraṭī padmacāriṇī // VAnigh_157 //	ca cāraṭī padmacāriṇī 
SA_GS40_vanighpu-315	rajaḥ parāgaṃ kiñjalkaṃ kesaraṃ padmasaṃbhavam /	rajaḥ parāgam kiñjalkam kesaram padma saṃbhavam 
SA_GS40_vanighpu-316	mañjiṣṭhā vijayā raktā samaṅgā vikasāruṇā // VAnigh_158 //	           
SA_GS40_vanighpu-317	mañjukā raktayaṣṭī ca tāmrā yojanavally api /	mañjukā raktayaṣṭī ca tāmrā yojanavallī api 
SA_GS40_vanighpu-318	anantā dīrghamūlā ca samudrānto yavāsakaḥ // VAnigh_159 //	anantā dīrghamūlā ca samudrāntaḥ yavāsakaḥ 
SA_GS40_vanighpu-319	sāradruḥ śālmalī mocā purāṇī raktapuṣpikā /	           
SA_GS40_vanighpu-320	niryāso yas tu śālmalyāḥ sa mocarasasaṃjñakaḥ // VAnigh_160 //	niryāsaḥ yaḥ tu śālmalyāḥ sa mocarasa saṃjñakaḥ 
SA_GS40_vanighpu-321	samaṅgā śatapattrā ca tathaivāñjalikārikā /	samaṅgā śatapattrā ca tathā evā añjalikārikā 
SA_GS40_vanighpu-322	namaskārī raktamūlā tathā puṣpāvarodhikā // VAnigh_161 //	          
SA_GS40_vanighpu-323	puṃnāgaḥ puruṣāhvaś ca tuṅgākhyo raktakesaraḥ /	             
SA_GS40_vanighpu-324	namerur devapuṃnāgaḥ skandhapuṣpaḥ surāhvayaḥ // VAnigh_162 //	           
SA_GS40_vanighpu-325	madahetuḥ sindhupuṣpī dhātakī madayantikā /	          
SA_GS40_vanighpu-326	kuñjarā harisārā ca madavīryā madapriyā // VAnigh_163 //	           
SA_GS40_vanighpu-327	ambaṣṭhādau smṛtāmbaṣṭhā sahasrī bahumūlakaḥ /	          
SA_GS40_vanighpu-328	madhuparṇī kekiśikhā mayūrāhvā śikhī tathā // VAnigh_164 //	           
SA_GS40_vanighpu-329	nandīvṛkṣaḥ prarohī ca jayavṛkṣendravṛkṣakau /	    ca      
SA_GS40_vanighpu-330	kacchurā paṇihārī ca tīkṣṇapattrā marudbhavā // VAnigh_165 //	          
SA_GS40_vanighpu-331	mustāvacāgnidviniśādvitiktā- bhallātapāṭhātriphalīviṣākhyāḥ /	                                                                                               
SA_GS40_vanighpu-332	kuṣṭhaṃ kuṭī haimavatī ca yoni- stanyāmayaghnā malapācanāś ca // VAnigh_166 //	kuṣṭham kuṭī haimavatī ca yoni stanya āmaya ghnāḥ mala pācanāḥ ca 
SA_GS40_vanighpu-333	mustādike gaṇe mustā pūrvam eva prakīrtitā /	            
SA_GS40_vanighpu-334	tiktā ca kaṭukā jñeyā rohiṇī kaṭurohiṇī // VAnigh_167 //	tiktā ca kaṭukā jñeyā rohiṇī kaṭurohiṇī 
SA_GS40_vanighpu-335	sphoṭaśophakṣatakaraṃ bhallātakam aruṣkaram /	            
SA_GS40_vanighpu-336	pākalaṃ vāri bhāvyaṃ ca vāpyaṃ kuṣṭhaṃ gadāhvayam // VAnigh_168 //	            
SA_GS40_vanighpu-337	nyāgrodhapappalasadāphalarodhrayugmaṃ jambudvayārjunakapītanasomavalkāḥ /	                             
SA_GS40_vanighpu-338	plakṣāmravañjulapiyālapalāśanandī- kolīkadambaviralāmadhukaṃ madhūkam // VAnigh_169 //	                  
SA_GS40_vanighpu-339	nyagrodhādir gaṇo vraṇyaḥ saṃgrāhī bhagnasādhanaḥ /	             
SA_GS40_vanighpu-340	medaḥpittāsratṛḍdāha- yoniroganibarhaṇaḥ // VAnigh_170 //	               
SA_GS40_vanighpu-341	nyagrodhādau yakṣavāso nyagrodho bahupād vaṭaḥ /	          
SA_GS40_vanighpu-342	aśvatthaḥ pippalo bodhiś caityadruś calapattrakaḥ // VAnigh_171 //	           
SA_GS40_vanighpu-343	udumbaraḥ kṛmiphalaḥ supratiṣṭhaḥ sadāphalaḥ /	         
SA_GS40_vanighpu-344	bṛhatphalā rājajambūḥ kākajambvalpasasyakā // VAnigh_172 //	            
SA_GS40_vanighpu-345	phalaśreṇī varaḥ proktaḥ kapicūtaḥ kapītanaḥ /	          
SA_GS40_vanighpu-346	plakṣaḥ kupippalaḥ plāvo gardabhāṇḍaḥ kapītanaḥ // VAnigh_173 //	           
SA_GS40_vanighpu-347	āmraś cūtaś cāvatalaḥ kāntaḥ piṇḍaphalas tathā /	āmraḥ cūtaḥ kāntaḥ piṇḍaphalaḥ tathā 
SA_GS40_vanighpu-348	vasantadūtī mākandā bhṛṅgeṣṭā kokilapriyā // VAnigh_174 //	          
SA_GS40_vanighpu-349	rasāladruḥ sahakāraḥ saurabhaḥ kokilapriyaḥ /	          
SA_GS40_vanighpu-350	nādeyo vañjulaḥ prokto vidulo vetaso 'paraḥ // VAnigh_175 //	           
SA_GS40_vanighpu-351	priyālas tu kharaskandhaś cāro drākṣārasapriyaḥ /	             
SA_GS40_vanighpu-352	karkandhūḥ kāṣṭhakṛt kolī badarī yugmakaṇṭakaḥ // VAnigh_176 //	          
SA_GS40_vanighpu-353	visphūrjanī vikaraṇī tindukī viralā smṛtā /	           
SA_GS40_vanighpu-354	kālaskandho nīlasāro dvitīyaḥ kākatindukaḥ // VAnigh_177 //	          
SA_GS40_vanighpu-355	vakraśalyā kṛṣṇaphalā viralā gṛdhranakhy api /	          
SA_GS40_vanighpu-356	gandhayuktā sāravastrā durdharṣā kuṇḍalī smṛtā // VAnigh_178 //	           
SA_GS40_vanighpu-357	elāyugmaturuṣkakuṣṭhaphalinīmāṃsījaladhyāmakaṃ spṛkkācorakacocapattratagarasthauṇeyajātīrasāḥ /	                                                                                        
SA_GS40_vanighpu-358	śuktivyāghrinakho 'marāhvamaguruḥ śrīvāsakaḥ kuṅkumaṃ caṇḍāgugguladevadhūpakhapurāḥ puṃnāganāgāhvayam // VAnigh_179 //	                                                      
SA_GS40_vanighpu-359	elādiko vātakaphau viṣaṃ viniyacchati /	             
SA_GS40_vanighpu-360	varṇaprasādanaḥ kaṇḍū- piṭikākoṭhanāśanaḥ // VAnigh_180 //	            
SA_GS40_vanighpu-361	elādike pūrvam uktā sūkṣmailānyā tu kathyate /	             
SA_GS40_vanighpu-362	bhadrailā bṛhadelā tu sthūlailā tripuṭodbhavā // VAnigh_181 //	              
SA_GS40_vanighpu-363	suhelā ca suṣeṇī ca reṇukā kāntanāmikā /	suhelā ca suṣeṇī ca reṇukā kāntanāmikā 
SA_GS40_vanighpu-364	piṇḍī turuṣkajaṃ tailaṃ pirāyākaṃ kṛtrimaṃ kapiḥ // VAnigh_182 //	             
SA_GS40_vanighpu-365	hrīveraṃ vāri keśāhvam udīcyaṃ bālakaṃ jalam /	              
SA_GS40_vanighpu-366	dhyāmakaṃ śabalaṃ gandhaṃ spṛkkā devī latā satī // VAnigh_183 //	             
SA_GS40_vanighpu-367	corako granthiparṇī syāt śaṭī somasamudbhavā /	            
SA_GS40_vanighpu-368	varāṅgaṃ carmanāmā ca cocaṃ tvak ca varāṅgakam // VAnigh_184 //	     ca     
SA_GS40_vanighpu-369	romaśaṃ chadanaṃ pattraṃ tamālaṃ romaśīphalam /	          
SA_GS40_vanighpu-370	bahiṣṭhaṃ tagaraṃ vakraṃ nataṃ kālānusāri ca // VAnigh_185 //	            
SA_GS40_vanighpu-371	cāraṭī śukabarhākhyaṃ sthauṇeyaṃ tailapītakam /	              
SA_GS40_vanighpu-372	jātīraso raso bolaṃ śuktiḥ kararuho nakhaḥ // VAnigh_186 //	            
SA_GS40_vanighpu-373	badarīpattrakaṃ caiva jñeyo nāgahanus tathā /	        
SA_GS40_vanighpu-374	samudrajo vyāghranakho vijñeyo vyāghranāmakaḥ // VAnigh_187 //	          
SA_GS40_vanighpu-375	śrīveṣṭako vāyasako dadhināmā ca kīrtitaḥ /	          
SA_GS40_vanighpu-376	kāśmīraṃ kuṅkumaṃ raktaṃ vāhlīkaṃ ghusṛṇaṃ varam // VAnigh_188 //	           
SA_GS40_vanighpu-377	krodhanā piśunā caṇḍā caurī śaṅkhinikā matā /	            
SA_GS40_vanighpu-378	mahiṣākṣo niśācārī kauśiko gugguluḥ puraḥ // VAnigh_189 //	         
SA_GS40_vanighpu-379	rālas tu devadhūpaḥ syāt śālaḥ sarjarasāhvayaḥ /	  tu   syāt       
SA_GS40_vanighpu-380	kundurur medakaḥ kundro vijñeyaḥ khapuras tathā // VAnigh_190 //	           
SA_GS40_vanighpu-381	śyāmādantīdravantīkramukakuṭaraṇāśaṃkhinī carmasāhvā svarṇakṣīrīgavākṣīśikharirajanakacchinnarohākarañjāḥ /	                            
SA_GS40_vanighpu-382	bastāntrī vyādhighāto bahalabahurasas tīkṣṇavṛkṣāt phalāni śyāmādyo hanti gulmaṃ viṣamarucikaphau hṛdrujaṃ mūtrakṛcchram // VAnigh_191 //	          hanti              
SA_GS40_vanighpu-383	masūravidalā śyāmā śyāmādo kālameṣikā /	        
SA_GS40_vanighpu-384	suṣeṇikā śaśāhvā ca kālindī kālikā smṛtā // VAnigh_192 //	            
SA_GS40_vanighpu-385	citrā mukūlako dantī nikumbhaḥ śambaras tathā /	            
SA_GS40_vanighpu-386	udumbaracchadā hasti- dantī syād upacitrakā // VAnigh_193 //	          
SA_GS40_vanighpu-387	nyagrodhāhvā sutatreṇī dravanty undurukarṇikā /	          
SA_GS40_vanighpu-388	kumbhastrī bhaṭṭinī sūtrā śyāmā kuṭaraṇā trivṛt // VAnigh_194 //	           
SA_GS40_vanighpu-389	śaṅkhinī tiktalā vakrī yavatiktā kiśorikā /	           
SA_GS40_vanighpu-390	śaṅkhāvartā śaṅkhapuṣpī viśikhā nāhikā smṛtā // VAnigh_195 //	          
SA_GS40_vanighpu-391	sātalā saptalā carma- kaṣāhvāvartakī smṛtā /	            
SA_GS40_vanighpu-392	anyeṣāṃ tu tathā brāhmī brahmanāmā tu kīrtitā // VAnigh_196 //	anyeṣām tu tathā brāhmī brahmanāmā tu kīrtitā 
SA_GS40_vanighpu-393	svarṇakṣīrī haimavatī kaṅkuṣṭhas tīkṣṇadugdhikā /	           
SA_GS40_vanighpu-394	indravāruṇikā caindrī gavākṣī gajacirbhiṭī // VAnigh_197 //	indravāruṇikā ca aindrī gavākṣī gajacirbhiṭī 
SA_GS40_vanighpu-395	viśālā ca viśalyā ca saiva proktā gavādanī /	viśālā ca viśalyā ca sā eva proktā gavādanī 
SA_GS40_vanighpu-396	girikarṇy aśvakṣurakaḥ sthāṇukarṇī gavādanī // VAnigh_198 //	          
SA_GS40_vanighpu-397	nīlasyandā nīlapuṣpī nīlākhyā girikarṇikā /	          
SA_GS40_vanighpu-398	tilvakaḥ śikharī śveta- tvak tirīṭo bṛhacchadaḥ // VAnigh_199 //	          
SA_GS40_vanighpu-399	kampillako rañjanako recano raktacūrṇakaḥ /	        
SA_GS40_vanighpu-400	bastāntrī vṛṣagandhākhyā meṣāntrī vṛṣapattrikā // VAnigh_200 //	             
SA_GS40_vanighpu-401	ghanabhūrirasas tv ikṣuḥ guḍamūlo 'sipattrakaḥ /	        
SA_GS40_vanighpu-402	tīkṣṇavṛkṣaḥ śaṇaḥ pīluḥ prokto 'nyaḥ sthāṇukas tathā // VAnigh_201 //	                
SA_GS40_vanighpu-403	gaṇeṣu yāni dravyāṇi saṃgrahe vālpasaṃgrahe /	gaṇeṣu yāni dravyāṇi saṃgrahe vā alpa saṃgrahe 
SA_GS40_vanighpu-404	tāny uktāny abhidhīyante viprakīrṇāny ataḥ param // VAnigh_202 //	tāni uktāni abhidhīyante viprakīrṇāni atas param 
SA_GS40_vanighpu-405	pavitrapattrā maṅgalyā śamī lakṣmī ca keśanut /	            
SA_GS40_vanighpu-406	sohalā rudatī tanvī sūkṣmamūlāparājitā // VAnigh_203 //	            
SA_GS40_vanighpu-407	pānīyo bījavṛkṣas tu jīvavṛkṣas tu pāśikaḥ /	          
SA_GS40_vanighpu-408	śuklapuṣpā bhūmilagnā hrasvāṅgā śaṅkhapuṣpikā // VAnigh_204 //	        
SA_GS40_vanighpu-409	sūkṣmapattrā sarpagandhā sarpākṣī raktapuṣpikā /	         
SA_GS40_vanighpu-410	anyā tu sumahākandā nākulī nakulapriyā // VAnigh_205 //	anyā tu sumahākandā nākulī nakulapriyā 
SA_GS40_vanighpu-411	viṣṇukrāntā nīlapuṣpī satīnā chardikā tathā /	         
SA_GS40_vanighpu-412	vāṭyālakaḥ pītapuṣpo vāṭyā bhadraudanī balā // VAnigh_206 //	          
SA_GS40_vanighpu-413	mahābalā varṣapuṣpī śītapākī subījakaḥ /	        
SA_GS40_vanighpu-414	vāṭyāyanī tv atibalā bhāradvājī suparṇikā // VAnigh_207 //	vāṭyāyanī tu atibalā bhāradvājī suparṇikā 
SA_GS40_vanighpu-415	rāmānyācchādanaphalā vāṭyā kārpāsasaṃjñakā /	            
SA_GS40_vanighpu-416	ajaṭā bahupattrā ca bhūdhātrī tāmalaky api // VAnigh_208 //	            
SA_GS40_vanighpu-417	śītavīryaḥ parpaṭakaḥ tṛṣṇāghnaḥ sūkṣmapattrakaḥ /	           
SA_GS40_vanighpu-418	trāyantī trāyamāṇā ca pālinī bhayanāśinī // VAnigh_209 //	trāyantī trāyamāṇā ca pālinī bhaya nāśinī 
SA_GS40_vanighpu-419	durālabhā dhanvayāso yāso duḥsparśakas tathā /	          
SA_GS40_vanighpu-420	kalyāṇalocano jñeyo nādeyo jalajambukaḥ // VAnigh_210 //	         
SA_GS40_vanighpu-421	mahākadambo niculo 'napāyī jalanūpuraḥ /	         
SA_GS40_vanighpu-422	kiṅkirātaḥ karṇikāro gauraḥ kanakapuṣpakaḥ // VAnigh_211 //	          
SA_GS40_vanighpu-423	mandāraḥ pāribhadrāhvo jñeyaḥ kaṇṭakīkiṃśukaḥ /	            
SA_GS40_vanighpu-424	pārijātaś ca rohītaḥ plīhaghno raktapuṣpakaḥ // VAnigh_212 //	  ca        
SA_GS40_vanighpu-425	śukanāsā tu nalikā śukaghrāṇo 'lpanālikā /	          
SA_GS40_vanighpu-426	śākarājo bhūtavāso gojihvā karkaśacchadā // VAnigh_213 //	           
SA_GS40_vanighpu-427	ajākṣī vraṇanāśinī kuṣṭhaghnī phalguvāṭikā /	         
SA_GS40_vanighpu-428	siṃhāsyaḥ karkaṭaś caiva vṛṣo vāsāṭarūṣakaḥ // VAnigh_214 //	           
SA_GS40_vanighpu-429	aśmantako 'mlayoniś ca jñeyo yamalapattrakaḥ /	         
SA_GS40_vanighpu-430	vaṃśo veṇur yavaphalaḥ suparvā ca tṛṇadhvajaḥ // VAnigh_215 //	vaṃśaḥ veṇuḥ yavaphalaḥ suparvā ca tṛṇadhvajaḥ 
SA_GS40_vanighpu-431	karīraḥ kīcako mṛtyu- phalāṅkura iti smṛtaḥ /	           
SA_GS40_vanighpu-432	vāraṇas taralī kumbhi- karañjas tīravṛkṣakaḥ // VAnigh_216 //	          
SA_GS40_vanighpu-433	sindhuraḥ sindhuvāraś ca śvetapuṣpāvarohitaḥ /	sindhuraḥ sindhuvāraḥ ca śvetapuṣpā avarohitaḥ 
SA_GS40_vanighpu-434	kākodumbarikā phalguḥ bhadrodumbaravāyasī // VAnigh_217 //	           
SA_GS40_vanighpu-435	kālāntradārī kanthārī phaṇī khadiravally api /	           
SA_GS40_vanighpu-436	sitā kumārikā mallī mohinī vaṭapattrikā // VAnigh_218 //	          
SA_GS40_vanighpu-437	phenilo hastikarkoṭaḥ kāṇḍo bāṇaḥ śaṇaḥ smṛtaḥ /	            
SA_GS40_vanighpu-438	śleṣmāntako bahuphalaḥ śailūṣaḥ kāntavṛkṣakaḥ // VAnigh_219 //	          
SA_GS40_vanighpu-439	kuddālakaḥ kovidāras tāmrapuṣpo yugacchadaḥ /	         
SA_GS40_vanighpu-440	kālakarṇī bhūtavallī balyā gandhāśvagandhikā // VAnigh_220 //	           
SA_GS40_vanighpu-441	tintiḍīkas tu vṛkṣāmlo badarī kolasaṃjñakaḥ /	            
SA_GS40_vanighpu-442	karkandhūḥ hrasvabadarī vasuvṛkṣas tu dhanvanaḥ // VAnigh_221 //	          
SA_GS40_vanighpu-443	sahasravīryas tīkṣṇāmlo varāmlas tv amlavetasaḥ /	           
SA_GS40_vanighpu-444	godhāpadī godhavallī paṭvamlādityanāmikā // VAnigh_222 //	            
SA_GS40_vanighpu-445	pattrabhaṅgo mahāśyāmā kharāśvā vṛddhadārukaḥ /	         
SA_GS40_vanighpu-446	dāvāgnidamanī mātā kṣudrakaṇṭarikā tathā // VAnigh_223 //	          
SA_GS40_vanighpu-447	barhiśikhāhvayā guñjā raktikā kākaṇantikā /	         
SA_GS40_vanighpu-448	śvetakāmbhojikā dhvāṅkṣī śvetapākī śikhaṇḍikā // VAnigh_224 //	         
SA_GS40_vanighpu-449	tṛtīyā kṛṣṇakāmbhojī kuṇapokaḥ susādanī /	          
SA_GS40_vanighpu-450	jyotiṣmatī kaṅguṇikā pārāvatapadī ca sā // VAnigh_225 //	         
SA_GS40_vanighpu-451	īśvarī nāgadamanī kīṭāriḥ sarpagandhikā /	          
SA_GS40_vanighpu-452	adhomukhā tv avākpuṣpī vārāhī vanamālikā // VAnigh_226 //	         
SA_GS40_vanighpu-453	ārāmaśītalo devo gandhāḍhyaḥ kurumardakaḥ /	          
SA_GS40_vanighpu-454	nāgajihvā śvetaphalā kṣīriṇī cārkapuṣpikā // VAnigh_227 //	             
SA_GS40_vanighpu-455	nimbacchadendravallī ca karabhī rucirā smṛtā /	           
SA_GS40_vanighpu-456	likhikā bhaktikā bhūrī navanītā prakīrtitā // VAnigh_228 //	            
SA_GS40_vanighpu-457	jñeyā badarikāparṇī parṇakaḥ pūtikarṇakaḥ /	        
SA_GS40_vanighpu-458	malayūḥ vākucī caiva candrarekhā tv avalgujaḥ // VAnigh_229 //	           
SA_GS40_vanighpu-459	cakṣuṣyā cāraṭī jñeyā tathāraṇyakulatthikā /	           
SA_GS40_vanighpu-460	ahimāro 'rimedas tu pītadārur haridrumaḥ // VAnigh_230 //	          
SA_GS40_vanighpu-461	śvetatvak tīkṣṇasāraś ca vibudhas tīkṣṇasārakaḥ /	          
SA_GS40_vanighpu-462	vāpyāhvaṃ pauṣkaraṃ śūla- haraṃ bījāhvayaṃ matam // VAnigh_231 //	           
SA_GS40_vanighpu-463	śarī tu suvratā jñeyā gandhāhvā somasambhavā /	           
SA_GS40_vanighpu-464	sahasravīryā golomī sitā dūrvā ca śādvalaḥ // VAnigh_232 //	            
SA_GS40_vanighpu-465	kṣudravārī dugdhayutā ghaṭikā chatrapattrakā /	         
SA_GS40_vanighpu-466	āghoṭako brahmaphalo raktabindus tilacchadaḥ // VAnigh_233 //	        
SA_GS40_vanighpu-467	ajākṣī lomaparṇī ca jñeyo meṣavilocanaḥ /	          
SA_GS40_vanighpu-468	mahāvṛkṣo mahānīlo bhṛṅgāhvo mārkavaḥ smṛtaḥ // VAnigh_234 //	            
SA_GS40_vanighpu-469	keśarañjanako jñeyo bhṛṅgarāḍ bhṛṅgareṇukaḥ /	         
SA_GS40_vanighpu-470	rāmāhvārkalatārāmā taruṇī puṣpavaty api // VAnigh_235 //	                         
SA_GS40_vanighpu-471	sūryabhaktā sukhodbhāvā sūryāvartā ravipriyā /	          
SA_GS40_vanighpu-472	hiraṇyapuṣpī kharjūrī tāḍapattrī musaly api // VAnigh_236 //	            
SA_GS40_vanighpu-473	ikṣvālikā tu kākekṣuḥ kāṇḍekṣur vāyasekṣukaḥ /	  tu        
SA_GS40_vanighpu-474	śvetacāmarakaḥ kāśas tathekṣukusumaś ca saḥ // VAnigh_237 //	           
SA_GS40_vanighpu-475	adhyaṇḍekṣurakaḥ sthūla- kaṇṭakaḥ kokilākṣakaḥ /	         
SA_GS40_vanighpu-476	uccaṭā caṭakā jñeyā śikhaṇḍy āsphotakaḥ smṛtaḥ // VAnigh_238 //	           
SA_GS40_vanighpu-477	unmattako mātulako dhuttūro hemanāmakaḥ /	          
SA_GS40_vanighpu-478	tripuṣpaḥ kṛṣṇadhuttūraḥ kṛṣṇapuṣpī ca mohinī // VAnigh_239 //	            
SA_GS40_vanighpu-479	devadālī ca karkoṭī veṇī jīmūtakaḥ smṛtaḥ /	           
SA_GS40_vanighpu-480	dhāmārgavaḥ kośaphalo rājakośātakī smṛtā // VAnigh_240 //	          
SA_GS40_vanighpu-481	kaṭukośātakī kṣveḍā jālinī kṛtavedhanaḥ /	         
SA_GS40_vanighpu-482	kaṭukālāmbunī tumbā- lāmbur ikṣvākusaṃjñikā // VAnigh_241 //	            
SA_GS40_vanighpu-483	nīlinī cāraṭī jñeyā nīlinī nīlapuṣpikā /	           
SA_GS40_vanighpu-484	sūkṣmapādas tāmracūḍo jñeyaḥ kukkuṭapādikaḥ // VAnigh_242 //	         
SA_GS40_vanighpu-485	godhūlikā ca gojihvā gojī kroṣṭukamūlakaḥ /	  ca        
SA_GS40_vanighpu-486	aṅkolo girikolaś ca pītasāro nikocakaḥ // VAnigh_243 //	          
SA_GS40_vanighpu-487	jālārir mehaśatruś ca bakulī talapoṭakaḥ /	         
SA_GS40_vanighpu-488	svarṇavarṇākaraḥ pīta- puṣpako dohakāhvayaḥ // VAnigh_244 //	          
SA_GS40_vanighpu-489	śaṇapuṣpī bṛhatpuṣpī śaṇaḥ ghaṇṭaśaṇaḥ smṛtaḥ /	           
SA_GS40_vanighpu-490	ubhātasī rudrapattrī gopikā bāṇakaḥ smṛtaḥ // VAnigh_245 //	          
SA_GS40_vanighpu-491	saumyā suvarcalā brāhmī somā brahmasuvarcalā /	           
SA_GS40_vanighpu-492	maṇḍūkaparṇī vikrāntā cānyā brāhmī vanauṣadhiḥ // VAnigh_246 //	           
SA_GS40_vanighpu-493	sutajīvaḥ putrajīvaḥ pavitraḥ putrasiddhikṛt /	            
SA_GS40_vanighpu-494	āvartakī carmaraṅgā mahājālī vibhāṇḍikā // VAnigh_247 //	         
SA_GS40_vanighpu-495	prasāraṇī suprasarā sāraṇī supratānikā /	          
SA_GS40_vanighpu-496	hiṅgupattrī tu pṛthvīkā bāṣpikā kavarī smṛtā // VAnigh_248 //	           
SA_GS40_vanighpu-497	tumburus tīkṣṇavalkaś ca tīkṣṇapattraḥ kutumburuḥ /	tumburuḥ tīkṣṇavalkaḥ ca tīkṣṇapattraḥ kutumburuḥ 
SA_GS40_vanighpu-498	akṣoḍaḥ parvatīyaś ca phalasneho guḍāśrayaḥ // VAnigh_249 //	         
SA_GS40_vanighpu-499	kīreṣṭaḥ karparālaś ca svādumañjā pṛthucchadaḥ /	          
SA_GS40_vanighpu-500	agastiko munināmā kumbhayoniś ca sa smṛtaḥ // VAnigh_250 //	agastikaḥ muni nāmā kumbhayoniḥ ca sa smṛtaḥ 
SA_GS40_vanighpu-501	adhicchattrā kumbhayoniḥ droṇapuṣpī kutumbikā /	          
SA_GS40_vanighpu-502	kauṇḍinyaś ca mahādroṇaḥ smṛto devakutumbakaḥ // VAnigh_251 //	kauṇḍinyaḥ ca mahādroṇaḥ smṛtaḥ devakutumbakaḥ 
SA_GS40_vanighpu-503	adhicchattrā gautamasthā bālagranthiḥ prakīrtitā /	        
SA_GS40_vanighpu-504	vatsādanī sudaśākhyā cakrāṅgī jalaśoṣakaḥ // VAnigh_252 //	          
SA_GS40_vanighpu-505	prapunnāṭas tv eḍagajo dadrughnaś cakramardakaḥ /	prapunnāṭaḥ tu eḍagajaḥ dadrughnaḥ cakramardakaḥ 
SA_GS40_vanighpu-506	lakṣmaṇā putrajananī raktabinducchadā tathā // VAnigh_253 //	          
SA_GS40_vanighpu-507	nāginī śūlinī nāga- vallī matsyārjakaḥ smṛtaḥ /	            
SA_GS40_vanighpu-508	śṛgālaghaṇṭā vajrākṣī vajravallī tu śṛṅkhalā // VAnigh_254 //	           
SA_GS40_vanighpu-509	palaṃkaṣā mūlakaṃ ca hiṃgunā puṣkaracchadaḥ /	palaṃkaṣā mūlakam ca hiṃgunā puṣkaracchadaḥ 
SA_GS40_vanighpu-510	dadhipuṣpī tu khaṭvāṅgī khaṭvā paryaṅkapādikā // VAnigh_255 //	           
SA_GS40_vanighpu-511	bimbī go hā tuṇḍikerī tilākhyā phalanābhikā /	              
SA_GS40_vanighpu-512	urvāruḥ karkaṭī proktā lomaśā ca prakīrtitā // VAnigh_256 //	            
SA_GS40_vanighpu-513	khūrjarikas tu kāliṅgaḥ mūtralaṃ trapusaṃ smṛtam /	         
SA_GS40_vanighpu-514	kūṣmāṇḍakī puṣpalatā kakubhāṇḍā phalottamā // VAnigh_257 //	        
SA_GS40_vanighpu-515	gorakṣatumbī gorakṣī kumbhālāmbur ghaṭābhidhā /	          
SA_GS40_vanighpu-516	cirbhiṭikā citraphalā cīnāraṃ cirbhaṭaṃ smṛtam // VAnigh_258 //	          
SA_GS40_vanighpu-517	lambā piṇḍaphalekṣvākuḥ kaṭukā kṣatriyātmajā /	            
SA_GS40_vanighpu-518	mahāphalekṣurā caiva tumbikā tiktabījakā // VAnigh_259 //	          
SA_GS40_vanighpu-519	cukrikā cāmlikā ciñcā jīvantī tintiḍī smṛtā /	            
SA_GS40_vanighpu-520	cukrikā tv amlacāṅgerī suniṣaṇṇadalā tathā // VAnigh_260 //	         
SA_GS40_vanighpu-521	upodakam upodī ca kṣudrakā podakī tathā /	upodakam upodī ca kṣudrakā podakī tathā 
SA_GS40_vanighpu-522	jīvantiko raktaśākaḥ kalambī vallyupodakaḥ // VAnigh_261 //	         
SA_GS40_vanighpu-523	taṇḍulīyo meghanādaḥ cillī tu lomaśā smṛtā /	            
SA_GS40_vanighpu-524	śitivāraḥ sūcipattraḥ svastikaḥ suniṣaṇṇakaḥ // VAnigh_262 //	          
SA_GS40_vanighpu-525	matsyākṣikas tu matsīraḥ pattūraḥ priyasaty api /	  tu          
SA_GS40_vanighpu-526	śīghraśākhā śākhinī ca mahāśākaś ca vāstukī // VAnigh_263 //	śīghraśākhā śākhinī ca mahāśākaḥ ca vāstukī 
SA_GS40_vanighpu-527	śrāvaṇī syāt muṇḍitikā bhikṣuḥ śravaṇaśīrṣakā /	         
SA_GS40_vanighpu-528	saumyagandhā barbarikā tilaparṇī ca sā smṛtā // VAnigh_264 //	            
SA_GS40_vanighpu-529	sarpaś citras tu nīlābho bhūśāko bhūmikandakaḥ /	           
SA_GS40_vanighpu-530	rasono laśuno jñeyaḥ palāṇḍur mukhadūṣaṇaḥ // VAnigh_265 //	           
SA_GS40_vanighpu-531	śatapuṣpā śatacchattrā miśiḥ ghoṣā śatāhvayā /	              
SA_GS40_vanighpu-532	miśreyā śālinī śīta- śivāraṇyā miśiḥ smṛtā // VAnigh_266 //	            
SA_GS40_vanighpu-533	pṛthvīkā vāripattrā tu bāṣpikā ca sthalodbhavā /	           
SA_GS40_vanighpu-534	kapittho 'tha dadhitthaś ca durmadaḥ surabhicchadaḥ // VAnigh_267 //	kapitthaḥ tha dadhitthaḥ ca durmadaḥ surabhicchadaḥ 
SA_GS40_vanighpu-535	toyakṣobhakaraḥ kumbhī vāruṇo vṛkṣadhūmakaḥ /	         
SA_GS40_vanighpu-536	mūṣikāriś citraphalaḥ karaṇḍaphalakaś ca saḥ // VAnigh_268 //	         
SA_GS40_vanighpu-537	cocaṃ ciṣu nārikelaḥ tuṅgadruḥ kūrcaśekharaḥ /	cocam ciṣu nārikelaḥ tuṅgadruḥ kūrcaśekharaḥ 
SA_GS40_vanighpu-538	nīrapūrṇaphalaḥ śṛṅgī mocaṃ tu kadalīphalam // VAnigh_269 //	           
SA_GS40_vanighpu-539	rambhā tu kadalī mocā vṛttapuṣpāṃśumatphalā /	              
SA_GS40_vanighpu-540	karamardī kṣīraphalā śvetapuṣpaphaleti ca // VAnigh_270 //	              
SA_GS40_vanighpu-541	kṛṣṇapākaphalāvigna- karāmlāḥ karamardakaḥ /	        
SA_GS40_vanighpu-542	mātuluṅgo bījapūro luṅgaś ca phalapūrakaḥ // VAnigh_271 //	            
SA_GS40_vanighpu-543	jambīro jambhalo jambhaḥ jambo dantaśaṭhaḥ smṛtaḥ /	              
SA_GS40_vanighpu-544	nāraṅgas tvaksugandhākhya airāvatamukhapriyau // VAnigh_272 //	nāraṅgaḥ tvaksugandha ākhyaḥ airāvata mukhapriyau 
SA_GS40_vanighpu-545	bhavyaṃ bhaviṣyaṃ cāmlaṃ ca bhavaṃ romaphalaṃ matam /	            
SA_GS40_vanighpu-546	pārāvataṃ raivatakaṃ likuco lakuco ḍahuḥ // VAnigh_273 //	pārāvatam raivatakam likucaḥ lakucaḥ ḍahuḥ 
SA_GS40_vanighpu-547	panasaḥ kaṇṭakiphalaḥ coco dīrghaphalaḥ smṛtaḥ /	           
SA_GS40_vanighpu-548	nalikā suṣirā śūnyā kapotacaraṇā naṭī // VAnigh_274 //	        
SA_GS40_vanighpu-549	snigdhavṛkṣastu sakṣīraḥ plakṣaḥ syād guḍabījakaḥ /	           
SA_GS40_vanighpu-550	kālavṛntā kuberākṣī kuliṅgākṣī ca yakṣadṛk // VAnigh_275 //	          
SA_GS40_vanighpu-551	ugrakāṇḍaḥ kāravallī toyavallī sukāṇḍakā /	         
SA_GS40_vanighpu-552	pañcāṅgulī liṅgabījā rājikā piṇḍavatphalā // VAnigh_276 //	          
SA_GS40_vanighpu-553	turyatuṇḍī śilācchedī pūtikā nityapuṣpikā /	         
SA_GS40_vanighpu-554	parvamañjarikā kīṭa- hantrī vṛścikahāriṇī // VAnigh_277 //	        
SA_GS40_vanighpu-555	kumārī vyāghracaraṇā kanyā sthūladalā ca sā /	           
SA_GS40_vanighpu-556	bandhūko bandhujīvaś ca pārvako vṛkadhūmakaḥ // VAnigh_278 //	    ca      
SA_GS40_vanighpu-557	kṛṣṇanīlaḥ kālaśākhaḥ kaiḍaryaḥ surabhicchadaḥ /	          
SA_GS40_vanighpu-558	viśvarūpā rūpyagaṇḍā rūpyo haritatumbilī // VAnigh_279 //	        
SA_GS40_vanighpu-559	arśoghnaś cākhukandaś ca vanyakandaś ca śūraṇaḥ /	arśoghnaḥ ca ākhukandaḥ ca vanyakandaḥ ca śūraṇaḥ 
SA_GS40_vanighpu-560	raktapādī śamīpattrā lajjā lohitayaṣṭikā // VAnigh_280 //	         
SA_GS40_vanighpu-561	durārohā kharaskandhā kharjūrī svādumastakā /	          
SA_GS40_vanighpu-562	hintālī tu mahātālī kutālī tilapuṣpikā // VAnigh_281 //	         
SA_GS40_vanighpu-563	bahuskandhā mṛtyuphalā gūḍhapākī śilāphalā /	        
SA_GS40_vanighpu-564	jatuvṛkṣo ghanaskandhaḥ krimivṛkṣaḥ kuśāmrakaḥ // VAnigh_282 //	         
SA_GS40_vanighpu-565	nīlapattrī kālanīlī nīlinī nīlapuṣpikā /	         
SA_GS40_vanighpu-566	kākajaṅghā dhvāṅkṣajaṅghā dāsī kāntā pracībalā // VAnigh_283 //	          
SA_GS40_vanighpu-567	śarapuṅkhā bāṇapuṅkhā maṇikā cekṣupuṅkhikā /	śarapuṅkhā bāṇapuṅkhā maṇikā ca ikṣupuṅkhikā 
SA_GS40_vanighpu-568	putradātrī vṛttapattrā vātāriḥ śvetapuṣpikā // VAnigh_284 //	          
SA_GS40_vanighpu-569	tālīśapattraṃ tālīśaṃ tālamāmalakīdalam /	          
SA_GS40_vanighpu-570	śvāsadrumaḥ kākataruḥ rugyogyo vyāghraparṇyapi // VAnigh_285 //	              
SA_GS40_vanighpu-571	kubjapuṣpā kṛṣṇavallī mahānīlā pratānikā /	         
SA_GS40_vanighpu-572	mṛdukāntiḥ mahāśvetā śvetā tu khaṭikā smṛtā // VAnigh_286 //	            
SA_GS40_vanighpu-573	raktapāṣāṇako dhātuḥ girimṛd gairikaḥ smṛtaḥ /	          
SA_GS40_vanighpu-574	stanyākhyo dugdhapāṣāṇaḥ saudhaḥ pāṣāṇako lavaḥ // VAnigh_287 //	           
SA_GS40_vanighpu-575	saugandhiko gandhakastu vaigandho gandhako baliḥ /	saugandhikaḥ gandhakaḥ tu vaigandhaḥ gandhakaḥ baliḥ 
SA_GS40_vanighpu-576	manaḥśilā manoguptā manohvā kunaṭī śilā // VAnigh_288 //	         
SA_GS40_vanighpu-577	haritālamālaṃ tālaṃ godantaṃ naṭabhūṣaṇam /	            
SA_GS40_vanighpu-578	pārado rasadhātuś ca rudraretā mahārasaḥ // VAnigh_289 //	          
SA_GS40_vanighpu-579	rasendraś capalaḥ sūto harayonī rasottamaḥ /	          
SA_GS40_vanighpu-580	abhrakaṃ pārvatībījaṃ śailodbhūtaṃ tathāmbaram // VAnigh_290 //	             
SA_GS40_vanighpu-581	mayūragrīvikaṃ tu syāt śikhikaṇṭhaṃ ca tutthakam /	          
SA_GS40_vanighpu-582	anyat karparikā tutthaṃ vāmanaṃ tutthameva tu // VAnigh_291 //	anyat karparikā tuttham vāmanam tuttham eva tu 
SA_GS40_vanighpu-583	hiṅgulaṃ daradaṃ mlecchaṃ rasabhūḥ carmarañjanam /	          
SA_GS40_vanighpu-584	sindūraṃ raktareṇu śrī- bhūṣaṇaṃ nāgasambhavam // VAnigh_292 //	           
SA_GS40_vanighpu-585	sauvarcalaṃ tu rucakam akṣāhvaṃ kṛṣṇasaṃjñakam /	              
SA_GS40_vanighpu-586	viḍaṃ tu kṛtrimaṃ proktaṃ pṛthvīsambhavam audbhidam // VAnigh_293 //	            
SA_GS40_vanighpu-587	samudrajaṃ ca sāmudraṃ lavaṇaṃ paṭunāmakam /	  ca         
SA_GS40_vanighpu-588	yāvaśūko yavakṣāraḥ srotoghnastu suvarcikaḥ // VAnigh_294 //	yāvaśūkaḥ yavakṣāraḥ srotoghnaḥ tu suvarcikaḥ 
SA_GS40_vanighpu-589	saubhāgyaṃ ṭaṅkaṇaṃ kṣāraḥ mālatīrasasambhavaḥ /	             
SA_GS40_vanighpu-590	tāpīsamudbhavaṃ tāpyaṃ mākṣikaṃ haimamākṣikam // VAnigh_295 //	           
SA_GS40_vanighpu-591	jatvaśmajaṃ dhātujaṃ ca śilākarpūrasaṃjñakam /	jatu aśmajam dhātujam ca śilākarpūra saṃjñakam 
SA_GS40_vanighpu-592	gorocanā badarikā saurāṣṭrī rocanā śivā // VAnigh_296 //	          
SA_GS40_vanighpu-593	lākṣā dīptir drumavyādhiḥ krimijā lohitā jatu /	         
SA_GS40_vanighpu-594	[padmottaras] tālakumbho yāvako 'laktakaḥ smṛtaḥ // VAnigh_297 //	           
SA_GS40_vanighpu-595	mṛganābhir mṛgamadaḥ kastūrī darpasaṃjñakaḥ /	             
SA_GS40_vanighpu-596	latākastūrikā rālī gandhaveṇī mukhapriyā // VAnigh_298 //	         
SA_GS40_vanighpu-597	ghanasāro himarājaḥ karpūraṃ himanāmakam /	             
SA_GS40_vanighpu-598	mṛgasvedo mṛgajalaṃ pūtiḥ pūtyaṇḍajaḥ smṛtaḥ // VAnigh_299 //	            
SA_GS40_vanighpu-599	jātīphalaṃ majjasāraṃ jātikā jātipattrakaḥ /	         
SA_GS40_vanighpu-600	kakkolakaṃ kośaphalaṃ kolakaṃ bahubījakam // VAnigh_300 //	         
SA_GS40_vanighpu-601	phalaṃ dvīpamarīcaṃ ca kaṭukaṃ kaṭukīphalam /	phalam dvīpamarīcam ca kaṭukam kaṭukīphalam 
SA_GS40_vanighpu-602	lavaṃgaṃ devakusumaṃ kusumaṃ śekharaṃ lavam // VAnigh_301 //	        
SA_GS40_vanighpu-603	niṣpattraṃ ca mahāpuṣpaṃ svargapuṣpaṃ varālakam /	niṣpattram ca mahāpuṣpam svargapuṣpam varālakam 
SA_GS40_vanighpu-604	śilāpuṣpaṃ tu śaileyaṃ śilājaṃ sthaviraṃ tathā // VAnigh_302 //	           
SA_GS40_vanighpu-605	puṣpāñjanaṃ rītipuṣpaṃ puṣpaketuś ca rītijam /	          
SA_GS40_vanighpu-606	samudraphenaṃ śuṣkaṃ ca phenaṃ vāridhijaṃ malam // VAnigh_303 //	samudraphenam śuṣkam ca phenam vāridhi jam malam 
SA_GS40_vanighpu-607	śaṅkho vāribhavaḥ kambuḥ jalajo dīrghaniḥsvanaḥ /	            
SA_GS40_vanighpu-608	pravālaṃ vallijaṃ raktaṃ vidrumaṃ ca prakīrtitam // VAnigh_304 //	            
SA_GS40_vanighpu-609	rūpyakaṃ rajataṃ tāraṃ suvarṇaṃ kanakaṃ smṛtam /	rūpyakam rajatam tāram suvarṇam kanakam smṛtam 
SA_GS40_vanighpu-610	jātarūpaṃ tathā hema śātakumbhaṃ ca hāṭakam // VAnigh_305 //	jātarūpam tathā hema śātakumbham ca hāṭakam 
SA_GS40_vanighpu-611	jāmbūnadaṃ hiraṇyaṃ ca tapanīyaṃ ca kāñcanam /	jāmbūnadam hiraṇyam ca tapanīyam ca kāñcanam 
SA_GS40_vanighpu-612	tāmramaudumbaraṃ śulbaṃ mihiraṃ harināmakam // VAnigh_306 //	tāmram audumbaram śulbam mihiram harināmakam 
SA_GS40_vanighpu-613	rītikā pittalaṃ pūti pītalohaṃ ca saiṃhalam /	rītikā pittalam pūti pītaloham ca saiṃhalam 
SA_GS40_vanighpu-614	trapusaṃ trapusaṃjñaṃ ca tagaraṃ rūpyaśatrukaḥ // VAnigh_307 //	trapusam trapu saṃjñam ca tagaram rūpyaśatrukaḥ 
SA_GS40_vanighpu-615	sīsakaṃ nāgamuragaṃ kāṃsyaṃ kāśaṃ ca ghoṣakam /	sīsakam nāgam uragam kāṃsyam kāśam ca ghoṣakam 
SA_GS40_vanighpu-616	vārttālohaṃ vartalohaṃ trilohaṃ pañcalohakam // VAnigh_308 //	vārttāloham vartaloham triloham pañcalohakam 
SA_GS40_vanighpu-617	kṛṣṇalohamayaḥ sāra- māyasaṃ ca śilodbhavam /	kṛṣṇaloham ayaḥ sāra māyasam ca śilodbhavam 
SA_GS40_vanighpu-618	ayorajo loharajas tat kiṭṭaṃ syād ayomalam // VAnigh_309 //	              
SA_GS40_vanighpu-619	cipiṭaṃ cippaṭaṃ ciṭṭaṃ vālukā sikatā smṛtā /	           
SA_GS40_vanighpu-620	lohakāntamayaskāntaṃ kāntaṃ bhrāmaracumbakam // VAnigh_310 //	           
SA_GS40_vanighpu-621	mṛdulohaṃ tīkṣṇalohaṃ tīkṣṇākhyaṃ sūkṣmalohakam /	             
SA_GS40_vanighpu-622	kālakūṭo mahāmusto vatsanābho halāhalaḥ // VAnigh_311 //	         
SA_GS40_vanighpu-623	vatsadantī mahāśṛṅgī lelihas tālapattrakaḥ /	         
SA_GS40_vanighpu-624	viṣaṃ ca mūlakaṃ śṛṅgī garaṃ kṛtrimasaṃjñakam // VAnigh_312 //	           
SA_GS40_vanighpu-625	toyacchadā vāriparṇī kumbhikā jalakumbhikā /	         
SA_GS40_vanighpu-626	dīrghamūlaṃ jalāvāsaṃ śaivālaṃ jalasambhavam // VAnigh_313 //	dīrghamūlam jalāvāsam śaivālam jalasambhavam 
SA_GS40_vanighpu-627	paṅkajaṃ puṇḍarīkaṃ ca śatapattraṃ kuśeśayam /	paṅkajam puṇḍarīkam ca śatapattram kuśeśayam 
SA_GS40_vanighpu-628	bisaprasūnarājīva- jalajāmbhoruhāṇi ca // VAnigh_314 //	bisaprasūna rājī iva jalaja ambhoruhāṇi ca 
SA_GS40_vanighpu-629	śaśipriyaṃ ca gandhāḍhyaṃ kumudaṃ kokanandanam /	śaśipriyam ca gandhāḍhyam kumudam kokanandanam 
SA_GS40_vanighpu-630	kākotpalaṃ tu kākotthaṃ kākākhyaṃ hrasvamutpalam // VAnigh_315 //	  tu          
SA_GS40_vanighpu-631	teṣāṃ phalaṃ tu kumbhīkaṃ mūlaṃ śālūkakandakam /	teṣām phalam tu kumbhīkam mūlam śālūka kandakam 
SA_GS40_vanighpu-632	kaśerukaḥ sugandhiś ca sukando mustakandakaḥ // VAnigh_316 //	          
SA_GS40_vanighpu-633	śṛṅgāṭako jalaphalaṃ jalakandas trikoṇakaḥ /	         
SA_GS40_vanighpu-634	karavīro 'śvamārastu bakulaṃ madyakesaram // VAnigh_317 //	        
SA_GS40_vanighpu-635	alaktā mālyaśephālī rūpikā tāmrapuṣpikā /	        
SA_GS40_vanighpu-636	raktapuṣpī jayā rudrā- -mlāyanī vanamālikā (?) // VAnigh_318 //	          
SA_GS40_vanighpu-637	āmlāyano rājasairyaḥ koraṇḍo nakharañjanaḥ /	          
SA_GS40_vanighpu-638	tilakaḥ pūrṇakaḥ śrīmān sudyutiḥ śuklapuṣpakaḥ // VAnigh_319 //	          
SA_GS40_vanighpu-639	mālatī sumanā jātī yūthikā gandhanāmikā /	          
SA_GS40_vanighpu-640	mallikoktā vicakilā dvipuṣpī puṣpaṭī tathā // VAnigh_320 //	           
SA_GS40_vanighpu-641	kuñjaraḥ śatapattraś ca kaṇṭakāḍhyaś ca kubjakaḥ /	    ca     
SA_GS40_vanighpu-642	aṭṭahāsaḥ śaṅkhaśuklā nāmnā sā śaṅkhayūthikā // VAnigh_321 //	aṭṭahāsaḥ śaṅkhaśuklā nāmnā sā śaṅkhayūthikā 
SA_GS40_vanighpu-643	ṛṣir damanako dānto vinītaḥ kulapattrakaḥ /	          
SA_GS40_vanighpu-644	damanaḥ pāṇḍurāgaḥ syāt tathā gandhotkaṭo muniḥ // VAnigh_322 //	            
SA_GS40_vanighpu-645	pānīyam ambu salilaṃ toyaṃ codakavāriṇī /	pānīyam ambu salilam toyam ca udaka vāriṇī 
SA_GS40_vanighpu-646	payaḥ kīlālamamṛtaṃ jīvanaṃ bhuvanaṃ vanam // VAnigh_323 //	payaḥ kīlālam amṛtam jīvanam bhuvanam vanam 
SA_GS40_vanighpu-647	kṣīraṃ svādu payo dugdhaṃ stanyaṃ vāri stanodbhavam /	kṣīram svādu payaḥ dugdham stanyam vāri stanodbhavam 
SA_GS40_vanighpu-648	dadhi māṅgalyakaṃ caiva saṃtānaṃ stanikā smṛtā // VAnigh_324 //	dadhi māṅgalyakam ca eva saṃtānam stanikā smṛtā 
SA_GS40_vanighpu-649	ghoṣaṃ daṇḍāhataṃ takraṃ kālaśeyamudāhṛtam /	ghoṣam daṇḍāhatam takram kālaśeyam udāhṛtam 
SA_GS40_vanighpu-650	ghṛtamājyaṃ haviḥ sarpiḥ navanītaṃ ghṛtālayaḥ // VAnigh_325 //	ghṛtam ājyam haviḥ sarpiḥ navanītam ghṛta ālayaḥ 
SA_GS40_vanighpu-651	guḍastvikṣuvikāraḥ syāt khaṇḍaṃ phullamiti smṛtam /	guḍaḥ tu ikṣuvikāraḥ syāt khaṇḍam phullam iti smṛtam 
SA_GS40_vanighpu-652	sitopalā śarkarā ca sitā matsyaṇḍikā smṛtā // VAnigh_326 //	          
SA_GS40_vanighpu-653	mākṣikaṃ sāraghaṃ kṣaudraṃ madhu puṣparasodbhavam /	               
SA_GS40_vanighpu-654	madhūcchiṣṭaṃ ca madanaṃ sikthakaṃ makṣikāmalam // VAnigh_327 //	madhūcchiṣṭam ca madanam sikthakam makṣikāmalam 
SA_GS40_vanighpu-655	tailam abhyañjanavaraṃ tilajaṃ tilasambhavam /	          
SA_GS40_vanighpu-656	prasannā vāruṇī jñeyā parisvinnā ca sā smṛtā // VAnigh_328 //	prasannā vāruṇī jñeyā parisvinnā ca sā smṛtā 
SA_GS40_vanighpu-657	kādambarī ghanā surā maireyo hy āsavo madaḥ /	            
SA_GS40_vanighpu-658	mārdvīkaṃ madhu vijñeyaṃ mādhvīkaṃ madhunā kṛtam // VAnigh_329 //	mārdvīkam madhu vijñeyam mādhvīkam madhunā kṛtam 
SA_GS40_vanighpu-659	guḍena gauḍaṃ sitayā śārkaraṃ saindham aikṣavam /	guḍena gauḍam sitayā śārkaram aikṣavam 
SA_GS40_vanighpu-660	khaṇḍena khaṇḍavāsaḥ syāt paiṣṭakaṃ piṣṭasambhavam // VAnigh_330 //	khaṇḍena khaṇḍa vāsaḥ syāt paiṣṭakam piṣṭa sambhavam 
SA_GS40_vanighpu-661	avantisomo dhānyāmlam āranālaṃ ca kāñjikam /	avantisomaḥ dhānyāmlam āranālam ca kāñjikam 
SA_GS40_vanighpu-662	śuktaṃ sauvīrakaṃ ceti tuṣodaṃ tu tuṣodakam // VAnigh_331 //	śuktam sauvīrakam ca iti tuṣodam tu tuṣodakam 
SA_GS40_vanighpu-663	yavotthaṃ taṇḍulodaṃ ca rasāmlaṃ śuktakāñjikam /	              
SA_GS40_vanighpu-664	brahmāmbu gombu gomūtraṃ gomalaṃ gomayaṃ smṛtam // VAnigh_332 //	              
SA_GS40_vanighpu-665	śālir vrīhir varaś caiva dhānyakaṃ raktaśūkaraḥ /	śāliḥ vrīhiḥ varaḥ ca eva dhānyakam raktaśūkaraḥ 
SA_GS40_vanighpu-666	yavaś ca sthūlamadhyaś ca varuṇo munibhikṣitaḥ // VAnigh_333 //	yavaḥ ca sthūlamadhyaḥ ca varuṇaḥ muni bhikṣitaḥ 
SA_GS40_vanighpu-667	akṛṣṭapacyo nīvāraḥ śakuntamunibhojanam /	         
SA_GS40_vanighpu-668	caṇakastu kalāyaḥ syād godhūmo mlecchabhojanaḥ // VAnigh_334 //	caṇakaḥ tu kalāyaḥ syāt godhūmaḥ mlecchabhojanaḥ 
SA_GS40_vanighpu-669	camasī cātibījā syāt koradūṣastu kodravaḥ /	camasī ca atibījā syāt koradūṣaḥ tu kodravaḥ 
SA_GS40_vanighpu-670	kaṅguḥ saṃdhyanthisaṃbandhī priyaṅguḥ pītataṇḍulaḥ // VAnigh_335 //	           
SA_GS40_vanighpu-671	gavedhukā ca gojihvā karśanīyā sitā tathā /	gavedhukā ca gojihvā karśanīyā sitā tathā 
SA_GS40_vanighpu-672	uddālakastu jūrṇāhvo yāvanālaḥ śukapriyaḥ // VAnigh_336 //	uddālakaḥ tu jūrṇāhvaḥ yāvanālaḥ śukapriyaḥ 
SA_GS40_vanighpu-673	vāsantaḥ kṛṣṇamudgastu mādhavaś ca surāṣṭrajaḥ /	vāsantaḥ kṛṣṇamudgaḥ tu mādhavaḥ ca surāṣṭrajaḥ 
SA_GS40_vanighpu-674	makuṣṭho vanamudgaś ca masūraḥ pittabheṣajam // VAnigh_337 //	          
SA_GS40_vanighpu-675	harimanthāḥ sugandhāś ca caṇakāḥ kṛṣṇakañcukāḥ /	harimanthāḥ sugandhāḥ ca caṇakāḥ kṛṣṇakañcukāḥ 
SA_GS40_vanighpu-676	kulatthaḥ kālavṛttaś ca tāmravarṇo 'nilāpahā // VAnigh_338 //	          
SA_GS40_vanighpu-677	māṣastu picchilarasaḥ kuruvindo vṛṣākaraḥ /	māṣaḥ tu picchilarasaḥ kuruvindaḥ vṛṣākaraḥ 
SA_GS40_vanighpu-678	rājamāṣo 'lasāndraḥ syāt khañjakākhyaḥ kalāyakaḥ // VAnigh_339 //	            
SA_GS40_vanighpu-679	āḍhakī tuvarī proktā niṣpāvā śimbikā smṛtā /	          
SA_GS40_vanighpu-680	tilaḥ snehaphalaḥ sneha- pūrṇaś ca kṛṣṇatailakaḥ // VAnigh_340 //	tilaḥ snehaphalaḥ sneha pūrṇaḥ ca kṛṣṇatailakaḥ 
SA_GS40_vanighpu-681	phalatrayaṃ tu triphalā varā śreṣṭhā tathottamā /	phalatrayam tu triphalā varā śreṣṭhā tathā uttamā 
SA_GS40_vanighpu-682	dvipaṃ ca mūlaṃ daśakaṃ daśamūlaṃ daśāṅghrikam // VAnigh_341 //	dvipam ca mūlam daśakam daśa mūlam daśa aṅghrikam 
SA_GS40_vanighpu-683	trikaṭu tryūṣaṇaṃ vyoṣaṃ kaṭutrayam ihocyate /	trikaṭu tryūṣaṇam vyoṣam kaṭutrayam iha ucyate 
SA_GS40_vanighpu-684	pañcakolaṃ pañcakaṭu trisugandhi trijātakam // VAnigh_342 //	          
SA_GS40_vanighpu-685	auṣadhaṃ bheṣajaṃ pathyam agadaṃ ca bhiṣagjitam /	auṣadham bheṣajam pathyam agadam ca bhiṣagjitam 
SA_GS40_vanighpu-686	kalabho vāraṇo dantī mātaṃgo dvirado dvipaḥ // VAnigh_343 //	kalabhaḥ vāraṇaḥ dantī mātaṃgaḥ dviradaḥ dvipaḥ 
SA_GS40_vanighpu-687	gajo hastī karībhaś ca kareṇur hastinī smṛtā /	gajaḥ hastī karībhaḥ ca kareṇuḥ hastinī smṛtā 
SA_GS40_vanighpu-688	hayo 'śvas turago vājī saptir vāhas tu bāḍavaḥ // VAnigh_344 //	hayaḥ śvas turagaḥ vājī saptiḥ vāhaḥ tu bāḍavaḥ 
SA_GS40_vanighpu-689	bāleyo rāsabho jñeyo dhūsaro gardabhaḥ kharaḥ /	          
SA_GS40_vanighpu-690	karabho dīrghagaś coṣṭraḥ kṣamī vesarako balī // VAnigh_345 //	karabhaḥ dīrghagaḥ ca uṣṭraḥ kṣamī vesarakaḥ balī 
SA_GS40_vanighpu-691	śārdūlaś citrakāyastu vyāghraḥ syāt puṇḍarīkaḥ (?) /	śārdūlaḥ citra kāyaḥ tu vyāghraḥ syāt puṇḍarīkaḥ 
SA_GS40_vanighpu-692	pañcāsyo mṛgarāṭ siṃho haryakṣaḥ kesarī hariḥ // VAnigh_346 //	            
SA_GS40_vanighpu-693	kaṇṭhīravaś ca vijñeyaḥ piṅgadṛṣṭir mṛgādanaḥ /	kaṇṭhīravaḥ ca vijñeyaḥ piṅgadṛṣṭiḥ mṛgādanaḥ 
SA_GS40_vanighpu-694	mṛge kuraṅgavātāyu- hariṇājinayonayaḥ // VAnigh_347 //	mṛge kuraṅga vātāyu hariṇa ajinayonayaḥ 
SA_GS40_vanighpu-695	tāmrābho hariṇaḥ kṛṣṇas tv eṇas tvakkomalaḥ smṛtaḥ /	tāmra ābhaḥ hariṇaḥ kṛṣṇaḥ tu eṇaḥ tvakkomalaḥ smṛtaḥ 
SA_GS40_vanighpu-696	kṛṣṇasāraś citramṛgaḥ romaśā camarī smṛtā // VAnigh_348 //	           
SA_GS40_vanighpu-697	varāhaḥ śūkaraḥ kīṭī daṃṣṭrī ghoṇī ca romaśaḥ /	varāhaḥ śūkaraḥ kīṭī daṃṣṭrī ghoṇī ca romaśaḥ 
SA_GS40_vanighpu-698	stabdharomā pṛthuskandhaḥ kroḍaḥ kolastathā kiriḥ // VAnigh_349 //	stabdharomā pṛthuskandhaḥ kroḍaḥ kolaḥ tathā kiriḥ 
SA_GS40_vanighpu-699	kapiḥ plavaṃgaplavaga- śākhāmṛgavalīmukhāḥ /	kapiḥ plavaṃga plavaga śākhāmṛga valīmukhāḥ 
SA_GS40_vanighpu-700	markaṭo vānaraḥ kīśaḥ vanaukāḥ phalabhakṣakaḥ // VAnigh_350 //	            
SA_GS40_vanighpu-701	śṛgālo jambukaḥ kroṣṭā gomāyur mṛgadhūrtakaḥ /	śṛgālaḥ jambukaḥ kroṣṭā gomāyuḥ mṛgadhūrtakaḥ 
SA_GS40_vanighpu-702	pārāvataḥ kalaravo gehapakṣī kapotakaḥ // VAnigh_351 //	        
SA_GS40_vanighpu-703	kṛkavākus tāmracūḍaḥ kukkuṭaś caraṇāyudhaḥ /	kṛkavākuḥ tāmracūḍaḥ kukkuṭaḥ caraṇāyudhaḥ 
SA_GS40_vanighpu-704	mayūro barhiṇo barhī nīlakaṇṭho bhujaṃgabhuk // VAnigh_352 //	            
SA_GS40_vanighpu-705	śikhāvalaḥ śikhī kekī kalāpī meghanādinī /	          
SA_GS40_vanighpu-706	ulūko vāyasāristu kauśiko rajanīcaraḥ // VAnigh_353 //	ulūkaḥ vāyasāriḥ tu kauśikaḥ rajanīcaraḥ 
SA_GS40_vanighpu-707	kākastu karaṭo 'riṣṭaḥ balipuṣṭaḥ sakṛtprajaḥ /	kākaḥ tu karaṭaḥ riṣṭaḥ balipuṣṭaḥ sakṛtprajaḥ 
SA_GS40_vanighpu-708	parabhūr balibhug dhvāṅkṣaś cirajīvī ca vāyasaḥ // VAnigh_354 //	parabhūḥ balibhuj dhvāṅkṣaḥ cirajīvī ca vāyasaḥ 
SA_GS40_vanighpu-709	ekadṛṣṭiś cātmaghoṣaḥ droṇakākastu kṛṣṭalaḥ /	ekadṛṣṭiḥ ca ātmaghoṣaḥ droṇakākaḥ tu kṛṣṭalaḥ 
SA_GS40_vanighpu-710	caṭakaḥ kalaviṅkaś ca kuliṅgaś caṭakāpi ca // VAnigh_355 //	caṭakaḥ kalaviṅkaḥ ca kuliṅgaḥ caṭakā api ca 
SA_GS40_vanighpu-711	vijñeyaś carmapathikaḥ jātuṣaś carmasāhvayaḥ /	vijñeyaḥ carmapathikaḥ jātuṣaḥ carmasāhvayaḥ 
SA_GS40_vanighpu-712	bharadvājo dvijo brāhmo vyāghrāṭaḥ khañjarīṭakaḥ // VAnigh_356 //	bharadvājaḥ dvijaḥ brāhmaḥ vyāghrāṭaḥ khañjarīṭakaḥ 
SA_GS40_vanighpu-713	sāraṅgaḥ khañjanaś caiva meghavṛttistu cātakaḥ /	sāraṅgaḥ khañjanaḥ ca eva meghavṛttiḥ tu cātakaḥ 
SA_GS40_vanighpu-714	vanapriyaḥ parabhṛtaḥ kokilaḥ susvaraḥ pikaḥ // VAnigh_357 //	          
SA_GS40_vanighpu-715	gūḍhapāt kacchapaḥ kūrmaḥ kulīraḥ karkaṭaḥ smṛtaḥ /	           
SA_GS40_vanighpu-716	śambūko vṛttaśaṅkhaś ca śaṅkhako mātṛgehakaḥ // VAnigh_358 //	           
SA_GS40_vanighpu-717	mīno matsyo 'ṇḍajaś caiva jalaukā jalaśāyanaḥ /	mīnaḥ matsyaḥ ṇḍajaḥ ca eva jalaukāḥ jalaśāyanaḥ 
SA_GS40_vanighpu-718	maṇḍūko darduro bhekaḥ kākāhis toyasarpakaḥ // VAnigh_359 //	          
SA_GS40_vanighpu-719	sarpaḥ pṛdākurbhujago bhujaṃgo 'hir bhujaṃgamaḥ /	sarpaḥ pṛdākuḥ bhujagaḥ bhujaṃgaḥ hiḥ bhujaṃgamaḥ 
SA_GS40_vanighpu-720	āśīviṣo viṣadharaś cakrī vyālaḥ sarīsṛpaḥ // VAnigh_360 //	āśīviṣaḥ viṣadharaḥ cakrī vyālaḥ sarīsṛpaḥ 
SA_GS40_vanighpu-721	kuṇḍalī gūḍapāc cakṣuḥ śravāḥ kākodaraḥ phaṇī /	kuṇḍalī cakṣuḥ śravāḥ kākodaraḥ phaṇī 
SA_GS40_vanighpu-722	darvīkaro dīrghapṛṣṭho jihmagaḥ pavanāśanaḥ // VAnigh_361 //	          
SA_GS40_vanighpu-723	lelihāno dandaśūko dvijihvaś ca bileśayaḥ /	lelihānaḥ dandaśūkaḥ dvijihvaḥ ca bileśayaḥ 
SA_GS40_vanighpu-724	kṛkalāso mayūrādī kāleyo bahupannagaḥ // VAnigh_362 //	           
SA_GS40_vanighpu-725	śatapāt saraṭā cakrī nakulaḥ sarpabhakṣakaḥ /	          
SA_GS40_vanighpu-726	nālinī nālahūlīkā talāṭā sthūladantikā // VAnigh_363 //	         
SA_GS40_vanighpu-727	ākhūndurur mūṣakaś ca vṛkaś ca dūṣakaḥ smṛtaḥ /	ākhu unduruḥ mūṣakaḥ ca vṛkaḥ ca dūṣakaḥ smṛtaḥ 
SA_GS40_vanighpu-728	chuchundarī rājaputrī vijñeyā gandhamūṣikā // VAnigh_364 //	         
SA_GS40_vanighpu-729	purohitā kuḍyamatsyā gaurī ca gṛhagodhikā /	           
SA_GS40_vanighpu-730	gaudherakākṛtir godhā prāgbāhur yugmajihvakaḥ // VAnigh_365 //	           
SA_GS40_vanighpu-731	otur biḍālo mārjāro vṛṣadaṃśaka ākhubhuk /	otuḥ biḍālaḥ mārjāraḥ vṛṣadaṃśakaḥ ākhubhuj 
SA_GS40_vanighpu-732	udaṅghā kapijaṅghā tu lohitāṅgaḥ pipīlakaḥ // VAnigh_366 //	         
SA_GS40_vanighpu-733	gaṇḍūpadā bhūmilatā bhūnāgo varṣajālakaḥ /	          
SA_GS40_vanighpu-734	madhuyuto madhukaro madhuliṭ madhupastathā // VAnigh_367 //	madhu yutaḥ madhukaraḥ madhulih madhupaḥ tathā 
SA_GS40_vanighpu-735	dvirephaḥ puṣpaliḍ bhṛṅgaḥ ṣaṭpadabhramarāvaliḥ /	             
SA_GS40_vanighpu-736	indindiraś cañcarīkaḥ saraghā madhumakṣikā // VAnigh_368 //	indindiraḥ cañcarīkaḥ saraghā madhumakṣikā 
SA_GS40_vanighpu-737	lambaromā makṣikā ca parā dīpanivāraṇī /	           
SA_GS40_vanighpu-738	pataṃgikā puttikā syāt daṃśastu vanamakṣikā // VAnigh_369 //	pataṃgikā puttikā syāt daṃśaḥ tu vanamakṣikā 
SA_GS40_vanighpu-739	bhṛṅgārī cīrukā cīrī jhillikā ghargharasvanā /	          
SA_GS40_vanighpu-740	pataṃgaḥ śalabho jñeyaḥ svadyoto jyotiriṅgaṇaḥ // VAnigh_370 //	           
SA_GS40_vanighpu-741	lulāyo mahiṣo vāha- dveṣī kāsarasairibhau /	lulāyaḥ mahiṣaḥ vāha dveṣī kāsara sairibhau 
SA_GS40_vanighpu-742	vanyastu gavayo jñeyaḥ kakudmān gopatir vṛṣaḥ // VAnigh_371 //	vanyaḥ tu gavayaḥ jñeyaḥ kakudmān gopatiḥ vṛṣaḥ 
SA_GS40_vanighpu-743	ukṣān aḍvān balīvardaḥ surabhir gopakaḥ smṛtaḥ /	         
SA_GS40_vanighpu-744	sakṛtprasūtā gṛṣṭiḥ syāt baṣkayaṇy ekahāyanī // VAnigh_372 //	sakṛt prasūtā gṛṣṭiḥ syāt baṣkayaṇī ekahāyanī 
SA_GS40_vanighpu-745	annasāro raso rakta- yoniḥ syād dṛḍhadhātukaḥ /	annasāraḥ rasaḥ rakta yoniḥ syāt dṛḍhadhātukaḥ 
SA_GS40_vanighpu-746	raktaṃ śoṇaṃ māṃsakaraṃ śoṇitaṃ kṣatajam asṛk // VAnigh_373 //	raktam śoṇam māṃsakaram śoṇitam kṣatajam asṛk 
SA_GS40_vanighpu-747	palaṃ māṃsaṃ śoṇitotthaṃ piśitaṃ kravyam āmiṣam /	palam māṃsam śoṇitottham piśitam kravyam āmiṣam 
SA_GS40_vanighpu-748	picchā māṃsodbhavaṃ medo vasā medaḥsamudbhavā // VAnigh_374 //	picchā māṃsodbhavam medaḥ vasā medaḥsamudbhavā 
SA_GS40_vanighpu-749	medaḥsambhavam asthi syād dehasaṃdhānadhāraṇam /	medaḥsambhavam asthi syāt deha saṃdhāna dhāraṇam 
SA_GS40_vanighpu-750	asthisārastathā majjā snehasāro 'sthisambhavaḥ // VAnigh_375 //	asthisāraḥ tathā majjā snehasāraḥ sthisambhavaḥ 
SA_GS40_vanighpu-751	śuklaṃ tejo bījapuṃstve reto vīryāntyadhātuke /	śuklam tejaḥ bīja puṃstve retaḥ vīrya āntyadhātuke 
SA_GS40_vanighpu-752	ojastu dhātusāraḥ syāt saumyo hṛdayadīpanaḥ // VAnigh_376 //	ojaḥ tu dhātusāraḥ syāt saumyaḥ hṛdayadīpanaḥ 
SA_GS40_vanighpu-753	anilo māruto vāyuḥ marutprāṇaḥ prabhañjanaḥ /	anilaḥ mārutaḥ vāyuḥ marut prāṇaḥ prabhañjanaḥ 
SA_GS40_vanighpu-754	samīraṇo mātariśvā pavanaś ca sadāgatiḥ // VAnigh_377 //	samīraṇaḥ mātariśvā pavanaḥ ca sadāgatiḥ 
SA_GS40_vanighpu-755	māyuḥ pittaṃ vahnikāntaṃ kaphaḥ śleṣmā ca picchilaḥ /	māyuḥ pittam vahnikāntam kaphaḥ śleṣmā ca picchilaḥ 
SA_GS40_vanighpu-756	kardamaḥ paṅkajambālau mṛtsā mṛtsnā ca mṛttikā // VAnigh_378 //	kardamaḥ paṅka jambālau mṛtsā mṛtsnā ca mṛttikā 
SA_GS40_vanighpu-757	hasantikāṅgāradhānī tailapātraṃ kutūḥ smṛtā /	hasantikā aṅgāradhānī taila pātram kutūḥ smṛtā 
SA_GS40_vanighpu-758	pāṣāṇaprastaragrāvo- -palāśmānaḥ śilā dṛṣat // VAnigh_379 //	pāṣāṇa prastara grāvaḥ pala aśmānaḥ śilā dṛṣad 
SA_GS40_vanighpu-759	pṛthvī vasuṃdharākhyā ca gaur bhūmir medinī mahī /	pṛthvī vasuṃdharā ākhyā ca gauḥ bhūmiḥ medinī mahī 
SA_GS40_vanighpu-760	dharā dharitrī dharaṇī kṣoṇī jyā kāśyapī kṣitiḥ // VAnigh_380 //	dharā dharitrī dharaṇī kṣoṇī jyā kāśyapī kṣitiḥ 
SA_GS40_vanighpu-761	sarvaṃsahā vasumatī vasudhorvyacalā smṛtā /	sarvaṃsahā vasumatī vasudhā ūrvī acalā smṛtā 
SA_GS40_vanighpu-762	viśvambharā rasānantā gotrā kuḥ pṛthivī kṣamā // VAnigh_381 //	viśvambharāḥ rasā anantāḥ gotrā kuḥ pṛthivī kṣamā 
SA_GS40_vanighpu-763	avanī bhūtadhātrī ca vipulā sāgarāmbarā /	avanī bhūtadhātrī ca vipulā sāgarāmbarā 
SA_GS40_vanighpu-764	sūro haṃso ravir bhānuḥ pataṃgo 'rko divākaraḥ // VAnigh_382 //	sūraḥ haṃsaḥ raviḥ bhānuḥ pataṃgaḥ rkaḥ divākaraḥ 
SA_GS40_vanighpu-765	pradyotano dinamaṇiḥ khadyoto dyumaṇistathā // VAnigh_383 //	pradyotanaḥ dinamaṇiḥ khadyotaḥ dyumaṇiḥ tathā 
SA_GS40_vanighpu-766	bradhnaḥ prabhākaro bhāsvān dvādaśātmā divākaraḥ /	bradhnaḥ prabhākaraḥ bhāsvān dvādaśa ātmā divākaraḥ 
SA_GS40_vanighpu-767	savitā ca sahasrāṃśur mārtaṇḍaś ca vikartanaḥ // VAnigh_384 //	savitā ca sahasrāṃśuḥ mārtaṇḍaḥ ca vikartanaḥ 
SA_GS40_vanighpu-768	karmasākṣī jagaccakṣur aṃśumālī trayītanuḥ /	          
SA_GS40_vanighpu-769	vibhāvasur grahapatis tviṣāṃpatir aharpatiḥ // VAnigh_385 //	vibhāvasuḥ graha patiḥ tviṣāṃpatiḥ aharpatiḥ 
SA_GS40_vanighpu-770	śītāṃśur induś candramāḥ śaśī candro niśākaraḥ /	śītāṃśuḥ induḥ candramāḥ śaśī candraḥ niśākaraḥ 
SA_GS40_vanighpu-771	vidhuḥ sudhāṃśuḥ śubhrāṃśur oṣadhīśo niśāpatiḥ // VAnigh_386 //	vidhuḥ sudhāṃśuḥ śubhrāṃśuḥ oṣadhīśaḥ niśāpatiḥ 
SA_GS40_vanighpu-772	abjo jaivātṛkaḥ somo glaur mṛgāṅkaḥ kalānidhiḥ /	           
SA_GS40_vanighpu-773	dvijarājaḥ śaśadharo nakṣatreśaḥ kṣapākaraḥ // VAnigh_387 //	           
SA_GS40_vanighpu-774	aṅgārakaḥ kujo bhaumo rauhiṇeyo budho dvijaḥ /	aṅgārakaḥ kujaḥ bhaumaḥ rauhiṇeyaḥ budhaḥ dvijaḥ 
SA_GS40_vanighpu-775	gurur bṛhaspatir mantrī cośanā bhārgavaḥ kaviḥ // VAnigh_388 //	guruḥ bṛhaspatiḥ mantrī ca uśanāḥ bhārgavaḥ kaviḥ 
SA_GS40_vanighpu-776	śaniḥ paṅguḥ sūryaputraḥ saiṃhikeyo vidhuṃtudaḥ /	śaniḥ paṅguḥ sūryaputraḥ saiṃhikeyaḥ vidhuṃtudaḥ 
SA_GS40_vanighpu-777	tamastu rāhuḥ svarbhānuḥ ketustu dhvajanāmakaḥ // VAnigh_389 //	tamaḥ tu rāhuḥ svarbhānuḥ ketuḥ tu dhvaja nāmakaḥ 
SA_GS40_vanighpu-778	uḍu nakṣatramṛkṣaṃ bhaṃ doṣā naktaṃ niśā kṣapā /	uḍu nakṣatram ṛkṣam bham doṣā naktam niśā kṣapā 
SA_GS40_vanighpu-779	kṣaṇadā yāminī rātris triyāmā coravallabhā // VAnigh_390 //	kṣaṇadā yāminī rātriḥ triyāmā coravallabhā 
SA_GS40_vanighpu-780	dināhanī vāsaraś ca ghasro bhāskaravallabhaḥ /	dina ahanī vāsaraḥ ca ghasraḥ bhāskaravallabhaḥ 
SA_GS40_vanighpu-781	śambhur īśaḥ paśupatiḥ śivaḥ śūlī maheśvaraḥ // VAnigh_391 //	śambhuḥ īśaḥ paśupatiḥ śivaḥ śūlī maheśvaraḥ 
SA_GS40_vanighpu-782	īśvaraḥ śarvaḥ īśānaḥ śaṃkaraś candraśekharaḥ /	īśvaraḥ śarvaḥ īśānaḥ śaṃkaraḥ candraśekharaḥ 
SA_GS40_vanighpu-783	bhūteśaḥ khaṇḍaparaśur girīśo giriśo mṛḍaḥ // VAnigh_392 //	         
SA_GS40_vanighpu-784	mṛtyuṃjayaḥ kṛttivāsāḥ pinākī pramathādhipaḥ /	            
SA_GS40_vanighpu-785	ugraḥ kapardī śrīkaṇṭhaḥ śitikaṇṭhaḥ kapālabhṛt // VAnigh_393 //	ugraḥ kapardī śrīkaṇṭhaḥ śitikaṇṭhaḥ kapālabhṛt 
SA_GS40_vanighpu-786	vāmadevo mahādevo virūpākṣastrilocanaḥ /	vāmadevaḥ mahādevaḥ virūpākṣaḥ trilocanaḥ 
SA_GS40_vanighpu-787	kṛśānuretāḥ sarvajño dhūrjaṭir nīlalohitaḥ // VAnigh_394 //	          
SA_GS40_vanighpu-788	haraḥ smaraharo bhargas tryambakastripurāntakaḥ /	                   
SA_GS40_vanighpu-789	gaṅgādharo 'ndhakaripuḥ kratudhvaṃsī vṛṣadhvajaḥ // VAnigh_395 //	         
SA_GS40_vanighpu-790	vyomakeśo bhavo bhīmaḥ sthāṇū rudra umāpatiḥ /	             
SA_GS40_vanighpu-791	umā kātyāyanī gaurī kālī haimavatīśvarī // VAnigh_396 //	           
SA_GS40_vanighpu-792	śivāparṇā bhavānī ca pārvatī caṇḍikāmbikā /	śivā aparṇā bhavānī ca pārvatī caṇḍikā ambikā 
SA_GS40_vanighpu-793	ajo harir vāsudevo daityāriḥ puruṣottamaḥ // VAnigh_397 //	            
SA_GS40_vanighpu-794	viṣṇur nārāyaṇaḥ kṛṣṇo vaikuṇṭho viṣṭaraśravāḥ /	viṣṇuḥ nārāyaṇaḥ kṛṣṇaḥ vaikuṇṭhaḥ viṣṭaraśravāḥ 
SA_GS40_vanighpu-795	dāmodaro hṛṣīkeśaḥ keśavo mādhavaḥ svabhūḥ // VAnigh_398 //	dāmodaraḥ hṛṣīkeśaḥ keśavaḥ mādhavaḥ svabhūḥ 
SA_GS40_vanighpu-796	pītāmbaro 'cyutaḥ śārṅgī viṣvakseno janārdanaḥ /	cyutaḥ śārṅgī viṣvaksenaḥ janārdanaḥ 
SA_GS40_vanighpu-797	upendra indrāvarajaś cakrapāṇiś caturbhujaḥ // VAnigh_399 //	            
SA_GS40_vanighpu-798	lakṣmī padmālayā padmā kamalā śrīr haripriyā /	             
SA_GS40_vanighpu-799	indirā lokamātā mā kṣīrābdhitanayā ramā // VAnigh_400 //	indirā lokamātā mā kṣīrābdhitanayā ramā 
SA_GS40_vanighpu-800	netraṃ pādaḥ śiphā cāṅghriḥ mūlaṃ śālūkakandakau /	netram pādaḥ śiphā ca aṅghriḥ mūlam śālūka kandakau 
SA_GS40_vanighpu-801	tvak carma valkalaṃ proktaṃ viṭapaḥ śikharaṃ śiraḥ // VAnigh_401 //	tvac carma valkalam proktam viṭapaḥ śikharam śiraḥ 
SA_GS40_vanighpu-802	pattraṃ dalaṃ chadaḥ parṇaṃ palāśaś chadanaṃ tathā /	pattram dalam chadaḥ parṇam palāśaḥ chadanam tathā 
SA_GS40_vanighpu-803	pallavastu pravālaḥ syāt mukulaṃ korakaṃ smṛtam // VAnigh_402 //	pallavaḥ tu pravālaḥ syāt mukulam korakam smṛtam 
SA_GS40_vanighpu-804	kalikā jālakaś caiva korakakṣārakuḍmalāḥ /	kalikā jālakaḥ ca eva koraka kṣāra kuḍmalāḥ 
SA_GS40_vanighpu-805	prasūnaṃ sumanaḥ sūnaṃ puṣpaṃ ca kusumaṃ smṛtam // VAnigh_403 //	prasūnam sumanaḥ sūnam puṣpam ca kusumam smṛtam 
SA_GS40_vanighpu-806	āmaṃ śalāṭusaṃjñaṃ tu pakvaṃ phalamudāhṛtam /	āmam śalāṭu saṃjñam tu pakvam phalam udāhṛtam 
SA_GS40_vanighpu-807	makarandaḥ puṣparasaḥ dalottho dalajo rasaḥ // VAnigh_404 //	             
SA_GS40_vanighpu-808	auṣadhaṃ bheṣajaṃ pathyam agadaṃ ca bhiṣagjitam /	auṣadham bheṣajam pathyam agadam ca bhiṣagjitam 
SA_GS40_vanighpu-809	kriyā cikitsitaṃ śastraṃ prāyaś cittaṃ samāhitam // VAnigh_405 //	kriyā cikitsitam śastram prāyaḥ cittam samāhitam 
SA_GS40_vanighpu-810	rogahāro 'gadaṃkāro bhiṣag vaidyaś cikitsakaḥ /	rogahāraḥ gadaṃkāraḥ bhiṣaj vaidyaḥ cikitsakaḥ 
SA_GS40_vanighpu-811	rogajño jīvano vidvān āyur vedī gadāntakaḥ // VAnigh_406 //	           
SA_GS40_vanighpu-812	śītāṃśvamṛtalakṣmībhir juṣṭo 'sau dhanasaṃyutaḥ /	śītāṃśu amṛta lakṣmībhiḥ juṣṭaḥ sau dhana saṃyutaḥ 
SA_GS40_vanighpu-813	kṣīrodhijaś cābjayoniḥ pāyād dhanvantaristathā // VAnigh_407 //	kṣīrodhijaḥ ca abjayoniḥ pāyāt dhanvantariḥ tathā 
SA_GS40_vanighpu-814	nāsatyāv aśvinau dasrāv āśvineyau ca tāv ubhau /	nāsatyau aśvinau dasrau āśvineyau ca tau ubhau 
SA_GS40_vanighpu-815	rakṣatāṃ devabhiṣajau vaidyaputrān svarociṣā // VAnigh_408 //	rakṣatām deva bhiṣajau vaidya putrān sva rociṣā 
