segmentnr	original	analyzed
SA_GK20_hpriydpu-0	śrīHarṣadevaviracitā /	śrī harṣadeva viracitā 
SA_GK20_hpriydpu-1	// Priyadarśikā //	    
SA_GK20_hpriydpu-2	[p. 1]	p 
SA_GK20_hpriydpu-3	dhūmavyākuladṛṣṭir indukiraṇair āhlāditākṣī punaḥ	dhūma vyākula dṛṣṭiḥ indu kiraṇaiḥ āhlādita akṣī punar 
SA_GK20_hpriydpu-4	paśyantī varam utsukānatamukhī bhūyo hriyā brahmaṇaḥ /	paśyantī varam utsuka ānata mukhī bhūyas hriyā brahmaṇaḥ 
SA_GK20_hpriydpu-5	serṣyā pādanakhendudarpaṇagate Gaṅgāṃ dadhāne hare	sa īrṣyā pāda nakha indu darpaṇa gate gaṅgām dadhāne hare 
SA_GK20_hpriydpu-6	sparśādutpulakā karagrahavidhau Gaurī śivāyāstu vaḥ // HPri_1.1 //	sparśāt utpulakā karagraha vidhau gaurī śivāya astu vaḥ 
SA_GK20_hpriydpu-7	api ca /	api ca 
SA_GK20_hpriydpu-8	Kailāsādrāv udaste paricalati gaṇeṣūllasatkautukeṣu	kailāsa adrau udaste paricalati gaṇeṣu ullasat kautukeṣu 
SA_GK20_hpriydpu-9	kroḍaṃ mātuḥ Kumāre viśati viṣamuci prekṣamāṇe saroṣam /	kroḍam mātuḥ kumāre viśati viṣamuci prekṣamāṇe sa roṣam 
SA_GK20_hpriydpu-10	[p. 2]	p 
SA_GK20_hpriydpu-11	pādāvaṣṭambhasīdadvapuṣi Daśamukhe yāti pātālamūlaṃ	pāda avaṣṭambha sīdat vapuṣi daśa mukhe yāti pātāla mūlam 
SA_GK20_hpriydpu-12	kruddho 'py āśliṣṭamūrtir bhayaghanam Umayā pātu tuṣṭaḥ Śivo naḥ // HPri_1.2 //	kruddhaḥ u pi āśliṣṭa mūrtiḥ bhaya ghanam umayā pātu tuṣṭaḥ śivaḥ naḥ 
SA_GK20_hpriydpu-13	(nāndyante sūtradhāraḥ parikramya) /	nāndī ante sūtradhāraḥ parikramya 
SA_GK20_hpriydpu-14	adyāhaṃ vasantotsave sabahumānam āhūya	adya aham vasanta utsave sa bahu mānam āhūya 
SA_GK20_hpriydpu-15	nānādigdeśād āgatena rājñaḥ śrīHarṣadevasya pādapadmopajīvinā rājasamūhenoktaḥ yathāsmatsvāminā	nānā diś deśāt āgatena rājñaḥ śrī harṣa devasya pāda padma upajīvinā rāja samūhena uktaḥ yathā asmad svāminā 
SA_GK20_hpriydpu-16	śrīHarṣadevenāpūrvavasturacanālaṃkṛtā Priyadarśikā nāma [p. 3] nāṭikā kṛtety asmābhiḥ	śrī harṣadevena apūrva vastu racanā alaṃkṛtā priyadarśikā nāma nāṭikā kṛtā iti asmābhiḥ 
SA_GK20_hpriydpu-17	śrotraparaṃparayā śrutam /	śrotra paraṃparayā śrutam 
SA_GK20_hpriydpu-18	na tu prayogato dṛṣṭā /	na tu prayogataḥ dṛṣṭā 
SA_GK20_hpriydpu-19	tat tasyaiva rājñaḥ sarvajanahṛdayāhlādino bahumānād asmāsu cānugrahabuddhyā	tat tasya eva rājñaḥ sarva jana hṛdaya āhlādinaḥ bahu mānāt asmāsu ca anugraha buddhyā 
SA_GK20_hpriydpu-20	yathāvat prayogena tvayā nāṭayitavyeti /	yathāvat prayogena tvayā nāṭayitavyā iti 
SA_GK20_hpriydpu-21	tad yāvan nepathyaracanāṃ kṛtvā yathābhilaṣitaṃ saṃpādayāmi /	tat yāvat nepathya racanām kṛtvā yathā abhilaṣitam saṃpādayāmi 
SA_GK20_hpriydpu-22	parito 'valokya /	paritas valokya 
SA_GK20_hpriydpu-23	āvarjitāni sāmājikamanāṃsīti me niścayaḥ / kutaḥ /	āvarjitāni sāmājika manāṃsi iti me niścayaḥ kutas 
SA_GK20_hpriydpu-24	śrīHarṣo nipuṇaḥ kaviḥ pariṣad apy eṣā guṇagrāhiṇī	śrī harṣaḥ nipuṇaḥ kaviḥ pariṣad api eṣā guṇa grāhiṇī 
SA_GK20_hpriydpu-25	loke hāri ca Vatsarājacaritaṃ nāṭye ca dakṣā vayam /	loke hāri ca vatsa rāja caritam nāṭye ca dakṣāḥ vayam 
SA_GK20_hpriydpu-26	vastv ekaikam apīha vāñchitaphalaprāpteḥ padaṃ kiṃ punar	vastu ekaikam api iha vāñchita phala prāpteḥ padam kim punar 
SA_GK20_hpriydpu-27	madbhāgyopacayād ayaṃ samuditaḥ sarvo guṇānāṃ gaṇaḥ // HPri_1.3 //	mad bhāgya upacayāt ayam samuditaḥ sarvaḥ guṇānām gaṇaḥ 
SA_GK20_hpriydpu-28	(nepathyābhimukham avalokya) /	nepathya abhimukham avalokya 
SA_GK20_hpriydpu-29	aye /	aye 
SA_GK20_hpriydpu-30	kathaṃ prastāvanābhyudyate mayi viditāsmadabhiprāyo 'ṅgādhipater Dṛḍhavarmaṇaḥ kañcukino bhūmikāṃ kṛtvāsmadbhrāteta evābhivartate /	katham prastāvanā abhyudyate mayi vidita asmad abhiprāyaḥ ṅga adhipateḥ dṛḍhavarmaṇaḥ kañcukinaḥ bhūmikām kṛtvā asmad bhrātā itas eva abhivartate 
SA_GK20_hpriydpu-31	tad yāvad aham apy anantarabhūmikāṃ saṃpādayāmi /	tat yāvat aham api anantara bhūmikām saṃpādayāmi 
SA_GK20_hpriydpu-32	(iti niṣkrāntaḥ) /	iti niṣkrāntaḥ 
SA_GK20_hpriydpu-33	(iti prastāvanā) /	iti prastāvanā 
SA_GK20_hpriydpu-34	[p. 4]	p 
SA_GK20_hpriydpu-35	prathamo 'ṅkaḥ /	prathamaḥ ṅkaḥ 
SA_GK20_hpriydpu-36	(tataḥ praviśati kañcukī /)	tatas praviśati kañcukī 
SA_GK20_hpriydpu-37	kañcukī - (saśokaśramaṃ nāṭayan /	kañcukī sa śoka śramam nāṭayan 
SA_GK20_hpriydpu-38	niḥśvasya) /	niḥśvasya 
SA_GK20_hpriydpu-39	kaṣṭaṃ bhoḥ kaṣṭam /	kaṣṭam bhoḥ kaṣṭam 
SA_GK20_hpriydpu-40	rājño vipadbandhuviyogaduḥkhaṃ deśacyutir durgamamārgakhedaḥ /	rājñaḥ vipad bandhu viyoga duḥkham deśa cyutiḥ durgama mārga khedaḥ 
SA_GK20_hpriydpu-41	āsvādyate 'syāḥ kaṭuniṣphalāyāḥ phalaṃ mayaitac cirajīvitāyāḥ // HPri_1.4 //	āsvādyate syāḥ kaṭu niṣphalāyāḥ phalam mayā etat cira jīvitāyāḥ 
SA_GK20_hpriydpu-42	(saśokaṃ savismayaṃ ca) /	sa śokam sa vismayam ca 
SA_GK20_hpriydpu-43	tādṛśasyāpi nāmāpratihataśaktitrayasya RaghuDilīpaNalatulyasya devasya Dṛḍhavarmaṇo	tādṛśasya api nāma apratihata śakti trayasya raghu dilīpa nala tulyasya devasya dṛḍhavarmaṇaḥ 
SA_GK20_hpriydpu-44	matprārthyamānāpy anena svaduhitā Vatsarājāya datteti baddhānuśayena Vatsarājo bandhanān	mad prārthyamānā api anena sva duhitā vatsa rājāya dattā iti baddha anuśayena vatsa rājaḥ bandhanān 
SA_GK20_hpriydpu-45	na nivartata iti ca labdharandhreṇa sahasāgatya Kaliṅgahatakena vipattir īdṛśī kriyata	na nivartate iti ca labdha randhreṇa sahasā āgatya kaliṅga hatakena vipattiḥ īdṛśī kriyata 
SA_GK20_hpriydpu-46	iti yat satyam upapannam api na śraddadhe /	iti yat satyam upapannam api na śraddadhe 
SA_GK20_hpriydpu-47	katham ekāntaniṣṭhuram īdṛśaṃ ca daivam asmāsu /	katham ekānta niṣṭhuram īdṛśam ca daivam asmāsu 
SA_GK20_hpriydpu-48	yena sāpi rājaputrī yathākathaṃcid enāṃ Vatsarājāyopanīya svāminam anṛṇaṃ kariṣyāmīti	yena sā api rāja putrī yathā kathaṃcid enām vatsa rājāya upanīya svāminam anṛṇam kariṣyāmi iti 
SA_GK20_hpriydpu-49	matvā mayā tādṛśād api pralayakāladāruṇād avaskandasaṃbhramād apavāhya devasya Dṛḍhavarmaṇo	matvā mayā tādṛśāt api pralaya kāla dāruṇāt avaskanda saṃbhramāt apavāhya devasya dṛḍhavarmaṇaḥ 
SA_GK20_hpriydpu-50	mitrabhāvānvitasyaivāṭavikasya nṛpater Vindhyaketor gṛhe sthāpitā satī snānāya nātidūram	mitra bhāva anvitasya eva āṭavikasya nṛpateḥ vindhyaketoḥ gṛhe sthāpitā satī snānāya na ati dūram 
SA_GK20_hpriydpu-51	ity Agastyatīrthaṃ gate mayi kṣaṇāt kair api nipatya hate Vindhyaketau rakṣobhir	iti agastyatīrtham gate mayi kṣaṇāt kaiḥ api nipatya hate vindhyaketau rakṣobhiḥ 
SA_GK20_hpriydpu-52	iva nirmānuṣīkṛte dagdhe sthāne na jñāyate kasyām avasthāyāṃ vartata iti /	iva nirmānuṣīkṛte dagdhe sthāne na jñāyate kasyām avasthāyām vartate iti 
SA_GK20_hpriydpu-53	nipuṇaṃ ca vicitam etan mayā sarvaṃ sthānam /	nipuṇam ca vicitam etat mayā sarvam sthānam 
SA_GK20_hpriydpu-54	na ca jñātaṃ kiṃ tair eva dasyubhir nītāthavā dagdheti /	na ca jñātam kim taiḥ eva dasyubhiḥ nītā athavā dagdhā iti 
SA_GK20_hpriydpu-55	tat kiṃ karomi mandabhāgyaḥ /	tat kim karomi mandabhāgyaḥ 
SA_GK20_hpriydpu-56	(vicintya) /	vicintya 
SA_GK20_hpriydpu-57	aye /	aye 
SA_GK20_hpriydpu-58	śrutaṃ mayā bandhanāt paribhraṣṭaḥ Pradyotatanayām apahṛtya Vatsarājaḥ Kauśāmbīm āgata iti /	śrutam mayā bandhanāt paribhraṣṭaḥ pradyota tanayām apahṛtya vatsa rājaḥ kauśāmbīm āgataḥ iti 
SA_GK20_hpriydpu-59	[p. 5] kiṃ tatraiva gacchāmi /	kim tatra eva gacchāmi 
SA_GK20_hpriydpu-60	(niḥśvasyātmano 'vasthāṃ paśyan) /	niḥśvasya ātmanaḥ vasthām paśyan 
SA_GK20_hpriydpu-61	kim iva hi rājaputryā vinā tatra gatvā kathayiṣyāmi /	kim iva hi rāja putryā vinā tatra gatvā kathayiṣyāmi 
SA_GK20_hpriydpu-62	aye /	aye 
SA_GK20_hpriydpu-63	kathitaṃ cādya mama Vindhyaketunā -- mā bhaiṣīḥ /	kathitam ca adya mama vindhyaketunā mā bhaiṣīḥ 
SA_GK20_hpriydpu-64	jīvati tatrabhavān mahārājo Dṛḍhavarmā gāḍhaprahārajarjarīkṛto baddhas tiṣṭhati /	jīvati tatrabhavān mahā rājaḥ dṛḍhavarmā gāḍha prahāra jarjarīkṛtaḥ baddhaḥ tiṣṭhati 
SA_GK20_hpriydpu-65	iti /	iti 
SA_GK20_hpriydpu-66	tad adhunā svāminam eva gatvā pādaparicaryayā jīvitaśeṣam ātmanaḥ saphalayiṣyāmi (parikramyordhvam avalokya) /	tat adhunā svāminam eva gatvā pāda paricaryayā jīvita śeṣam ātmanaḥ saphalayiṣyāmi parikramya ūrdhvam avalokya 
SA_GK20_hpriydpu-67	aho atidāruṇatā śaradātapasya /	aho ati dāruṇa tā śarad ātapasya 
SA_GK20_hpriydpu-68	yad evam anekaduḥkhasaṃtāpitenāpi mayā tīkṣṇo 'vagamyate /	yat evam aneka duḥkha saṃtāpitena api mayā tīkṣṇaḥ vagamyate 
SA_GK20_hpriydpu-69	ghanabandhanamukto 'yaṃ kanyāgrahaṇāt paraṃ tulāṃ prāpya /	ghana bandhana muktaḥ yam kanyā grahaṇāt param tulām prāpya 
SA_GK20_hpriydpu-70	ravir adhigatasvadhāmā pratapati khalu Vatsarāja iva // HPri_1.5 //	raviḥ adhigata sva dhāmā pratapati khalu vatsa rājaḥ iva 
SA_GK20_hpriydpu-71	(iti niṣkrāntaḥ) /	iti niṣkrāntaḥ 
SA_GK20_hpriydpu-72	(iti viṣkambhakaḥ) /	iti viṣkambhakaḥ 
SA_GK20_hpriydpu-73	(tataḥ praviśati rājā vidūṣakaś ca) /	tatas praviśati rājā vidūṣakaḥ ca 
SA_GK20_hpriydpu-74	rājā -	rājā 
SA_GK20_hpriydpu-75	bhṛtyānām avikāritā parigatā dṛṣṭā matir mantriṇāṃ	bhṛtyānām avikāri tā parigatā dṛṣṭā matiḥ mantriṇām 
SA_GK20_hpriydpu-76	mitrāṇy apy upalakṣitāni viditaḥ paurānurāgo 'dhikam /	mitrāṇi api upalakṣitāni viditaḥ paura anurāgaḥ dhikam 
SA_GK20_hpriydpu-77	nirvyūḍhā raṇasāhasavyasanitā strīratnam āsāditaṃ	nirvyūḍhā raṇa sāhasa vyasani tā strī ratnam āsāditam 
SA_GK20_hpriydpu-78	nirvyājād iva dharmataḥ kim iva na prāptaṃ mayā bandhanāt // HPri_1.6 //	nirvyājāt iva dharmataḥ kim iva na prāptam mayā bandhanāt 
SA_GK20_hpriydpu-79	[p. 6]	p 
SA_GK20_hpriydpu-80	vidūṣakaḥ - (saroṣam) /	vidūṣakaḥ sa roṣam 
SA_GK20_hpriydpu-81	bho vassa /	bho vassa 
SA_GK20_hpriydpu-82	kahaṃ taṃ evva dāsīe uttaṃ bandhaṇahadaaṃ pasaṃsesi /	kaham tam evva dāsīe uttam bandhaṇa hadaam pasaṃsesi 
SA_GK20_hpriydpu-83	taṃ dāṇiṃ visumaridaṃ /	tam dāṇim 
SA_GK20_hpriydpu-84	jaṃ taha ṇavaggaho via gaavaī khalakhalāamāṇalohasiṅkhalābandhapaḍikkhalantacalaṇo	jam taha ṇavaggahaḥ via gaavaī 
SA_GK20_hpriydpu-85	suṇṇadukkharapisuṇidahiaasaṃdāvo rosavasuttambhidadiṭṭhī guruakaraphoḍiadharaṇimaggo	suṇṇa dukkhara pisuṇida hiaa asaṃdāvaḥ rosava su tambhida diṭṭhī gurua kara phoḍia dharaṇi maggo 
SA_GK20_hpriydpu-86	raaṇīsu vi aṇiddāsuhaṃ aṇuhūdo si /	vi aṇiddā suham aṇuhūdaḥ si 
SA_GK20_hpriydpu-87	[bho vayasya /	bho vayasya 
SA_GK20_hpriydpu-88	kathaṃ tam eva dāsyāḥ putraṃ bandhanahatakaṃ praśaṃsasi /	katham tam eva dāsyāḥ putram bandhana hatakam praśaṃsasi 
SA_GK20_hpriydpu-89	tad idānīṃ vismṛtam /	tat idānīm vismṛtam 
SA_GK20_hpriydpu-90	yat tathā navagraha iva gajapatiḥ khalakhalāyamānalohaśṛṅkhalābandhapratiskhalaccaraṇaḥ	yat tathā nava grahaḥ iva gajapatiḥ khalakhalāyamāna loha śṛṅkhalā bandha pratiskhalat caraṇaḥ 
SA_GK20_hpriydpu-91	śūnyamukhapuṣkarapiśunitaddhṛdayasaṃtāpo roṣavaśottambhitadṛṣṭir gurukakarasphoṭitadharaṇimārgo	śūnya mukha puṣkara piśuni tad hṛdaya saṃtāpaḥ roṣa vaśa uttambhita dṛṣṭiḥ guruka kara sphoṭita dharaṇi mārgaḥ 
SA_GK20_hpriydpu-92	rajanīṣv apy anidrāsukham anubhūto 'si] /	rajanīṣu api anidrā sukham si 
SA_GK20_hpriydpu-93	rājā - Vasantaka durjanaḥ khalv asi / paśya /	rājā vasantaka durjanaḥ khalu asi paśya 
SA_GK20_hpriydpu-94	dṛṣṭaṃ cārakam andhakāragahanaṃ no tanmukhendudyutiḥ	dṛṣṭam cārakam andhakāra gahanam no tad mukha indu dyutiḥ 
SA_GK20_hpriydpu-95	pīḍā te nigalasvanena madhurās tasyā giro na śrutāḥ /	pīḍā te nigala svanena madhurāḥ tasyāḥ giraḥ na śrutāḥ 
SA_GK20_hpriydpu-96	krūrā bandhanarakṣiṇo 'dya manasi snigdhāḥ kaṭākṣā na te	krūrāḥ bandhana rakṣiṇaḥ manasi snigdhāḥ kaṭākṣāḥ na te 
SA_GK20_hpriydpu-97	doṣān paśyasi bandhanasya na punaḥ Pradyotaputryā guṇān // HPri_1.7 //	doṣān paśyasi bandhanasya na punar pradyota putryāḥ guṇān 
SA_GK20_hpriydpu-98	vidūṣakaḥ - (sagarvam) /	vidūṣakaḥ sa garvam 
SA_GK20_hpriydpu-99	bho /	bho 
SA_GK20_hpriydpu-100	jai dāva bandhaṇaṃ suhaṇibandhaṇaṃ hoi tā kīsa tumaṃ Diḍhavammā baddho tti Kaliṅgaraṇṇo uvari rosaṃ bandhesi /	jai dāva bandhaṇam suha nibandhaṇam hoi tā kīsa tumam diḍha vammā baddhaḥ tti kaliṅga raṇṇaḥ uvari rosam bandhesi 
SA_GK20_hpriydpu-101	[bhoḥ /	bhoḥ 
SA_GK20_hpriydpu-102	yadi tāvad bandhanaṃ sukhanibandhanaṃ bhavati [p. 7] tat kasmāt tvaṃ Dṛḍhavarmā baddha iti Kaliṅgarājasyopari roṣaṃ badhnāsi] /	yadi tāvat bandhanam sukha nibandhanam bhavati tat kasmāt tvam dṛḍhavarmā baddhaḥ iti kaliṅga rājasya upari roṣam badhnāsi 
SA_GK20_hpriydpu-103	rājā - (vihasya) /	rājā vihasya 
SA_GK20_hpriydpu-104	dhiṅ mūrkha /	dhik mūrkha 
SA_GK20_hpriydpu-105	na khalu sarvo Vatsarājo ya evaṃ Vāsavadattām avāpya bandhanān niryāsyati /	na khalu sarvaḥ vatsa rājaḥ yaḥ evam vāsavadattām avāpya bandhanāt niryāsyati 
SA_GK20_hpriydpu-106	tad āstāṃ tāvad iyaṃ kathā /	tat āstām tāvat iyam kathā 
SA_GK20_hpriydpu-107	Vindhyaketor upari bahūny ahāni Vijayasenasya preṣitasya na cādyāpi tatsakāśāt kaścid āgataḥ /	vindhyaketoḥ upari bahūni ahāni vijayasenasya preṣitasya na ca adya api tad sakāśāt kaścid āgataḥ 
SA_GK20_hpriydpu-108	tad āhūyatāṃ tāvad amātyo Rumaṇvān /	tat āhūyatām tāvat amātyaḥ rumaṇvān 
SA_GK20_hpriydpu-109	tena saha kiṃcid ālapitum icchāmi /	tena saha kiṃcid ālapitum icchāmi 
SA_GK20_hpriydpu-110	(praviśya) /	praviśya 
SA_GK20_hpriydpu-111	pratīhārī - jedu jedu devvo /	pratīhārī jedu jedu devvo 
SA_GK20_hpriydpu-112	eso kkhu Vijaaseṇo amacco Rumaṇṇo vi paḍihārabhūmiṃ uvaṭṭhio /	esaḥ kkhu vijaaseṇaḥ amaccaḥ rumaṇṇaḥ vi paḍihāra bhūmim uvaṭṭhiaḥ 
SA_GK20_hpriydpu-113	[jayatu jayatu devaḥ /	jayatu jayatu devaḥ 
SA_GK20_hpriydpu-114	eṣa khalu Vijayaseno 'mātyo Rumaṇvān api pratīhārabhūmim upasthitau] /	eṣa khalu vijayasenaḥ mātyaḥ rumaṇvān api pratīhāra bhūmim upasthitau 
SA_GK20_hpriydpu-115	rājā - tvaritaṃ praveśaya tau /	rājā tvaritam praveśaya tau 
SA_GK20_hpriydpu-116	pratīhārī - jaṃ devo āṇavedi /	pratīhārī jam devaḥ āṇavedi 
SA_GK20_hpriydpu-117	[yad deva ājñāpayati] /	yat devaḥ ājñāpayati 
SA_GK20_hpriydpu-118	(iti niṣkrāntā) /	iti niṣkrāntā 
SA_GK20_hpriydpu-119	(tataḥ praviśati Rumaṇvān Vijayasenaś ca)	tatas praviśati rumaṇvān vijayasenaḥ ca 
SA_GK20_hpriydpu-120	Rumaṇvān - (vicintya) /	rumaṇvān vicintya 
SA_GK20_hpriydpu-121	tat kṣanam api niṣkrāntāḥ kṛtadoṣā iva vināpi doṣeṇa /	tat kṣanam api niṣkrāntāḥ kṛta doṣāḥ iva vinā api doṣeṇa 
SA_GK20_hpriydpu-122	praviśanti śaṅkamānā rājakulaṃ prāyaśo bhṛtyāḥ // HPri_1.8 //	praviśanti śaṅkamānāḥ rājakulam prāyaśas bhṛtyāḥ 
SA_GK20_hpriydpu-123	(upasṛtya) / jayatu devaḥ /	upasṛtya jayatu devaḥ 
SA_GK20_hpriydpu-124	rājā - (āsanaṃ nirdiśya) /	rājā āsanam nirdiśya 
SA_GK20_hpriydpu-125	Rumaṇvan /	rumaṇvan 
SA_GK20_hpriydpu-126	ita āsyatām /	itas āsyatām 
SA_GK20_hpriydpu-127	Rumaṇvān - (sasmitam upaviśya /	rumaṇvān sa smitam upaviśya 
SA_GK20_hpriydpu-128	eṣa khalu jitaVindhyaketur Vijayasenaḥ	eṣa khalu jita vindhya ketuḥ vijayasenaḥ 
SA_GK20_hpriydpu-129	praṇamati /	praṇamati 
SA_GK20_hpriydpu-130	(Vijayasenas tathā karoti) /	vijayasenaḥ tathā karoti 
SA_GK20_hpriydpu-131	rājā - (sādaraṃ pariṣvajya) /	rājā sa ādaram pariṣvajya 
SA_GK20_hpriydpu-132	api kuśalī bhavān /	api kuśalī bhavān 
SA_GK20_hpriydpu-133	Vijayasenaḥ - adya svāminaḥ prasādāt /	vijayasenaḥ adya svāminaḥ prasādāt 
SA_GK20_hpriydpu-134	rājā - Vijayasena upaviśyatām /	rājā vijayasenaḥ upaviśyatām 
SA_GK20_hpriydpu-135	[p. 8]	p 
SA_GK20_hpriydpu-136	(Vijayasena upaviśati) /	vijayasenaḥ upaviśati 
SA_GK20_hpriydpu-137	rājā - Vijayasena kathaya Vindhyaketor vṛttāntam /	rājā vijayasena kathaya vindhyaketoḥ vṛttāntam 
SA_GK20_hpriydpu-138	Vijayasenaḥ - deva kim aparaṃ kathayāmi /	vijayasenaḥ deva kim aparam kathayāmi 
SA_GK20_hpriydpu-139	yādṛśaḥ svāmini kupite /	yādṛśaḥ svāmini kupite 
SA_GK20_hpriydpu-140	rājā - tathāpi vistarataḥ śrotum icchāmi /	rājā tathā api vistarataḥ śrotum icchāmi 
SA_GK20_hpriydpu-141	Vijayasenaḥ - deva śrūyatām /	vijayasenaḥ deva śrūyatām 
SA_GK20_hpriydpu-142	ito vayaṃ devapādādeśād yathādiṣṭena karituragapadātidainyena mahāntam apy adhvānaṃ divasatrayeṇollaṅghya prabhātavelāyām atarkitā eva Vindhyaketor  #	itas vayam deva pāda ādeśāt yathā ādiṣṭena kari turaga padāti dainyena mahāntam api adhvānam divasa trayeṇa ullaṅghya prabhāta velāyām atarkitāḥ eva vindhyaketoḥ 
SA_GK20_hpriydpu-143	upari nipatitāḥ smaḥ /	upari nipatitāḥ smaḥ 
SA_GK20_hpriydpu-144	rājā - tatas tataḥ /	rājā tatas tatas 
SA_GK20_hpriydpu-145	Vijayasenaḥ - tataḥ so 'py asmadbalatumulakalakalākarṇanena pratibuddhaḥ kesarīva	vijayasenaḥ tatas saḥ pi asmad bala tumula kalakala ākarṇanena pratibuddhaḥ kesarī iva 
SA_GK20_hpriydpu-146	Vindhyakandarān nirgatya Vindhyaketur anapekṣitabalavāhano yathāsaṃnihita katipayasahāyaḥ	vindhyakandarāt nirgatya vindhyaketuḥ an apekṣita bala vāhanaḥ yathā saṃnihita katipaya sahāyaḥ 
SA_GK20_hpriydpu-147	sahasā svanāmodghoṣayann asmān abhiyoddhuṃ pravṛttaḥ /	sahasā sva nāma udghoṣayan asmān abhiyoddhum pravṛttaḥ 
SA_GK20_hpriydpu-148	rājā - (Rumaṇvantam avalokya sasmitam) /	rājā rumaṇvantam avalokya sa smitam 
SA_GK20_hpriydpu-149	śobhitaṃ Vindhyaketunā /	śobhitam vindhyaketunā 
SA_GK20_hpriydpu-150	tatas tataḥ /	tatas tatas 
SA_GK20_hpriydpu-151	Vijayasenaḥ - tato 'smābhir ayam asāv iti dviguṇatarabaddhamatsarotsāhair mahatā vimardena niḥśeṣitasahāya eka eva vimarditādhikabalakrodhavego  #	vijayasenaḥ tatas smābhiḥ ayam asau iti dviguṇatara baddha matsara utsāhaiḥ mahatā vimardena niḥśeṣita sahāyaḥ ekaḥ eva vimardita adhika bala krodha vegaḥ 
SA_GK20_hpriydpu-152	dāruṇataraṃ saṃprahāram akarot /	dāruṇataram saṃprahāram akarot 
SA_GK20_hpriydpu-153	rājā - sādhu Vindhyaketo /	rājā sādhu vindhyaketo 
SA_GK20_hpriydpu-154	sādhu sādhu /	sādhu sādhu 
SA_GK20_hpriydpu-155	Vijayasenaḥ - kiṃ vā varṇyate deva /	vijayasenaḥ kim vā varṇyate deva 
SA_GK20_hpriydpu-156	saṃkṣepato vijñāpayāmi /	saṃkṣepataḥ vijñāpayāmi 
SA_GK20_hpriydpu-157	pādātaṃ pātter eva prathamataram uraḥpeṣamātreṇa piṣṭvā	pādātam pātteḥ eva prathamataram uraḥpeṣa mātreṇa piṣṭvā 
SA_GK20_hpriydpu-158	dūrān nītvā śaraughair hariṇakulam iva trastam aśvīyam āśāḥ /	dūrāt nītvā śara oghaiḥ hariṇa kulam iva trastam aśvīyam āśāḥ 
SA_GK20_hpriydpu-159	[p. 9]	p 
SA_GK20_hpriydpu-160	sarvatrotsṛṣṭasarvapraharaṇanivahas tūrṇam utkhāya khaḍgaṃ	sarvatra utsṛṣṭa sarva praharaṇa nivahaḥ tūrṇam utkhāya khaḍgam 
SA_GK20_hpriydpu-161	paścāt kartuṃ pravṛttaḥ karikarakadalīkānanacchedalīlām // HPri_1.9 //	paścāt kartum pravṛttaḥ kari kara kadalī kānana cheda līlām 
SA_GK20_hpriydpu-162	evaṃ balatritayam ākulam eka eva	evam bala tritayam ākulam ekaḥ eva 
SA_GK20_hpriydpu-163	kurvan kṛpāṇakiraṇacchuritāṃsakūṭaḥ /	kurvan kṛpāṇa kiraṇa churita aṃsakūṭaḥ 
SA_GK20_hpriydpu-164	śastraprahāraśatajarjaritoruvakṣāḥ	śastra prahāra śata jarjarita ūru vakṣāḥ 
SA_GK20_hpriydpu-165	śrāntaś cirād vinihato yudhi Vindhyaketuḥ // HPri_1.10 //	śrāntaḥ cirāt vinihataḥ yudhi vindhyaketuḥ 
SA_GK20_hpriydpu-166	rājā - Rumaṇvan /	rājā rumaṇvan 
SA_GK20_hpriydpu-167	satpuruṣocitaṃ mārgam anugacchato yat satyaṃ vrīḍitā eva vayaṃ Vindhyaketor maraṇena /	sat puruṣa ucitam mārgam anugacchataḥ yat satyam vrīḍitāḥ eva vayam vindhyaketoḥ maraṇena 
SA_GK20_hpriydpu-168	Rumaṇvān - deva tvadvidhānām evaṃ guṇaikapakṣapātināṃ ripor api guṇāḥ prītiṃ janayanti /	rumaṇvān deva tvadvidhānām evam guṇa eka pakṣapātinām ripoḥ api guṇāḥ prītim janayanti 
SA_GK20_hpriydpu-169	rājā - Vijayasena apy asti Vindhyaketor apatyaṃ yatrāsya paritoṣasya phalaṃ darśayāmi /	rājā vijayasenaḥ api asti vindhyaketoḥ apatyam yatra asya paritoṣasya phalam darśayāmi 
SA_GK20_hpriydpu-170	Vijayasenaḥ - deva idam api vijñāpayāmi /	vijayasenaḥ deva idam api vijñāpayāmi 
SA_GK20_hpriydpu-171	evaṃ sabandhuparivāre hate Vindhyaketau tam anusṛtāsu sahadharmacāriṇīṣu Vindhyaśikharāśriteṣu	evam sa bandhu parivāre hate vindhyaketau tam anusṛtāsu saha dharmacāriṇīṣu vindhya śikhara āśriteṣu 
SA_GK20_hpriydpu-172	janapadeṣu śūnyībhūte tatsthāne hā tāta hā mātaḥ iti kṛtakṛpaṇapralāpā Vindhyaketor	janapadeṣu śūnyībhūte tad sthāne hā tāta hā mātar iti kṛta kṛpaṇa pralāpāḥ vindhyaketoḥ 
SA_GK20_hpriydpu-173	veśmany ābhijātyānurūpā kanyakā tadduhitety asmābhir ānītā dvāri tiṣṭhati /	veśmani ābhijātya anurūpā kanyakā tad duhitā iti asmābhiḥ ānītā dvāri tiṣṭhati 
SA_GK20_hpriydpu-174	tāṃ prati devaḥ pramāṇam /	tām prati devaḥ pramāṇam 
SA_GK20_hpriydpu-175	[p. 10]	p 
SA_GK20_hpriydpu-176	rājā - Yaśodhare gaccha /	rājā yaśodhare gaccha 
SA_GK20_hpriydpu-177	tvam eva Vāsavadattāyāḥ samarpaya /	tvam eva vāsavadattāyāḥ samarpaya 
SA_GK20_hpriydpu-178	vaktavyā ca devī /	vaktavyā ca devī 
SA_GK20_hpriydpu-179	bhaginībuddhyā tvayaiva sarvadā draṣṭavyā /	bhaginī buddhyā tvayā eva sarvadā draṣṭavyā 
SA_GK20_hpriydpu-180	gītanṛttavādyādiṣu viśiṣṭakanyakocitaṃ sarvaṃ śikṣayitavyā /	gīta nṛtta vādya ādiṣu viśiṣṭa kanyakā ucitam sarvam śikṣayitavyā 
SA_GK20_hpriydpu-181	yadā varayogyā bhaviṣyati tadā māṃ smārayeti /	yadā vara yogyā bhaviṣyati tadā mām smāraya iti 
SA_GK20_hpriydpu-182	pratīhārī - jaṃ devo āṇavedi /	pratīhārī jam devaḥ āṇavedi 
SA_GK20_hpriydpu-183	[yad deva ājñāpayati] /	yat devaḥ ājñāpayati 
SA_GK20_hpriydpu-184	(iti niṣkrāntā) /	iti niṣkrāntā 
SA_GK20_hpriydpu-185	(nepathye vaitālikaḥ) /	nepathye vaitālikaḥ 
SA_GK20_hpriydpu-186	līlāmajjanamaṅgalopakaraṇasnānīyasampādinaḥ	              
SA_GK20_hpriydpu-187	sarvāntaḥpuravāravibhramavatīlokasya te saṃprati /	sarva antaḥpura vāra vibhramavatī lokasya te saṃprati 
SA_GK20_hpriydpu-188	āyāsaskhaladaṃśukāvyavahitacchāyāvadātaiḥ stanair	āyāsa skhalat aṃśuka avyavahita chāyā avadātaiḥ stanaiḥ 
SA_GK20_hpriydpu-189	utkṣiptāparaśātakumbhakalaśevālaṃkṛtā snānabhūḥ // HPri_1.11 //	utkṣipta apara śātakumbha kalaśā iva alaṃkṛtā snāna bhūḥ 
SA_GK20_hpriydpu-190	rājā - (ūrdhvam avalokya) /	rājā ūrdhvam avalokya 
SA_GK20_hpriydpu-191	aye kathaṃ nabhomadhyam adhyāste bhagavān sahasradīdhitiḥ /	aye katham nabhaḥ madhyam adhyāste bhagavān sahasradīdhitiḥ 
SA_GK20_hpriydpu-192	saṃprati hi /	saṃprati hi 
SA_GK20_hpriydpu-193	ābhāty arkāṃśutāpakvathad iva śapharodvartanair dīrghikāmbhaś	ābhāti arka aṃśu tāpa kvathat iva śaphara udvartanaiḥ dīrghikā ambhaḥ 
SA_GK20_hpriydpu-194	chatrābhaṃ nṛttalīlāśithilam api śikhī barhabhāraṃ tanoti /	chatra ābham nṛtta līlā śithilam api śikhī barha bhāram tanoti 
SA_GK20_hpriydpu-195	[p. 11]	p 
SA_GK20_hpriydpu-196	chāyācakraṃ tarūṇāṃ hariṇaśiśur upaityālavālāmbulubdhaḥ	chāyā cakram tarūṇām hariṇa śiśuḥ upaiti ālavāla ambu lubdhaḥ 
SA_GK20_hpriydpu-197	sadyas tyaktvā kapolaṃ viśati madhukaraḥ karṇapālīṃ gajasya // HPri_1.12 //	sadyas tyaktvā kapolam viśati madhukaraḥ karṇa pālīm gajasya 
SA_GK20_hpriydpu-198	Rumaṇvan / uttiṣṭhottiṣṭha /	rumaṇvan uttiṣṭha uttiṣṭha 
SA_GK20_hpriydpu-199	praviśyābhyantaram eva kṛtayathocitakriyāḥ satkṛtya Vijayasenaṃ Kaliṅgocchittaye preṣayāmaḥ /	praviśya abhyantaram eva kṛta yathocita kriyāḥ satkṛtya vijayasenam kaliṅga ucchittaye preṣayāmaḥ 
SA_GK20_hpriydpu-200	(iti niṣkrāntāḥ sarve) /	iti niṣkrāntāḥ sarve 
SA_GK20_hpriydpu-201	(iti prathamo 'ṅkaḥ) // *	iti prathamaḥ ṅkaḥ 
SA_GK20_hpriydpu-202	vidūṣakaḥ - ṇaṃ bhaṇido mhi Indīvariāe jaha ajja uvavāsaṇiamaṭṭhiā devī Vāsavadattā sotthivāaṇaṇimittaṃ saddāvedi tti /	vidūṣakaḥ nam bhaṇidaḥ mhi indīvariāe jaha ajja uvavāsaṇiam aṭṭhiā devī vāsavadattā tti 
SA_GK20_hpriydpu-203	tā jāva dhārāgharujjāṇadigghiāe ṇhāia devīpāsaṃ gadua kukkuṭavādaṃ karissaṃ /	tā jāva devī pāsam kukkuṭa vādam karissam 
SA_GK20_hpriydpu-204	aṇṇahā kahaṃ amhāṇaṃ sarisā brahmaṇā (sic)	aṇṇahā kaham amhāṇam sarisā brahmaṇā sic 
SA_GK20_hpriydpu-205	rāakule paḍiggahaṃ karenti /	rāa kule paḍiggaham karenti 
SA_GK20_hpriydpu-206	(nepathyābhimukham avalokya)	nepathya abhimukham avalokya 
SA_GK20_hpriydpu-207	kahaṃ eso piavaasso ajja devīe virahukkaṇṭhaviṇodaṇāṇimittaṃ dhārāgharujjāṇe evva patthido /	kaham esaḥ pia vaassaḥ ajja devīe virahu kaṇṭha viṇoda ṇā nimittam dhārā ghara ujjāṇe evva patthidaḥ 
SA_GK20_hpriydpu-208	tā jāva vaasseṇa saha evva gadua jahodidaṃ aṇuciṭṭhissaṃ /	tā jāva vaasseṇa saha evva aṇuciṭṭhissam 
SA_GK20_hpriydpu-209	[nanu bhaṇito 'smīndivarikayā yathā upavāsaniyamasthitā devī Vāsavadattā svastivācananimittaṃ śabdāyateti /	nanu bhaṇitaḥ smi indivarikayā yathā upavāsa niyama sthitā devī vāsavadattā svastivācana nimittam śabdāyata iti 
SA_GK20_hpriydpu-210	tad yāvad dhārāgṛhodyānadīrghikāyāṃ snātvā devīpārśvaṃ gatvā kukkuṭavādaṃ kariṣyāmi /	tat yāvat dhārāgṛha udyāna dīrghikāyām snātvā devī pārśvam gatvā kukkuṭa vādam kariṣyāmi 
SA_GK20_hpriydpu-211	anyathā katham asmābhiḥ sadṛśā brāhmaṇā rājakule pratigrahaṃ kurvanti (nepathyābhimukham avalokya)	anyathā katham asmābhiḥ sadṛśāḥ brāhmaṇāḥ rājakule pratigraham kurvanti nepathya abhimukham avalokya 
SA_GK20_hpriydpu-212	katham eṣa priyavayasyo 'dya devyā virahotkaṇṭhāvinodanānimittaṃ dhārāgṛhodyānam eva prasthitaḥ /	katham eṣa priya vayasyaḥ devyāḥ viraha utkaṇṭhā vinodana a nimittam dhārāgṛha udyānam eva prasthitaḥ 
SA_GK20_hpriydpu-213	tad yāvad vayasyena sahaiva gatvā yathoditam anuṣṭhāsyāmi /]	tat yāvat vayasyena saha eva gatvā yathā uditam anuṣṭhāsyāmi 
SA_GK20_hpriydpu-214	[p. 12]	p 
SA_GK20_hpriydpu-215	(tataḥ praviśati sotkanṇṭho rājā)	tatas praviśati sa utkanṇṭhaḥ rājā 
SA_GK20_hpriydpu-216	rājā -	rājā 
SA_GK20_hpriydpu-217	kṣāmāṃ maṅgalamātramaṇḍanabhṛtaṃ mandodyamālāpinīm	kṣāmām maṅgala mātra maṇḍana bhṛtam manda udyama ālāpinīm 
SA_GK20_hpriydpu-218	āpāṇducchavinā mukhena vijitaprātastanendudyutim /	āpāṇd ucchavinā mukhena vijita prāta stana indu dyutim 
SA_GK20_hpriydpu-219	sotkaṇthāṃ niyamopavāsavidhinā ceto mamotkaṇṭhate	sa utkaṇthām niyama upavāsa vidhinā cetaḥ mama utkaṇṭhate 
SA_GK20_hpriydpu-220	tāṃ draṣṭuṃ prathamānurāgajanitāvasthām ivādya priyām // HPri_2.1 //	tām draṣṭum prathama anurāga janita avasthām iva adya priyām 
SA_GK20_hpriydpu-221	vidūṣakaḥ- (upasṛtya)	vidūṣakaḥ upasṛtya 
SA_GK20_hpriydpu-222	sotthi hode /	sotthi hode 
SA_GK20_hpriydpu-223	vaḍḍhadu bhavaṃ /	vaḍḍhadu bhavam 
SA_GK20_hpriydpu-224	[svasti bhavate /	svasti bhavate 
SA_GK20_hpriydpu-225	vardhatāṃ bhagavān /]	vardhatām bhagavān 
SA_GK20_hpriydpu-226	rājā -(vilokya) Vasantaka /	rājā vilokya vasantaka 
SA_GK20_hpriydpu-227	kasmāt prahṛṣṭa iva lakṣyase /	kasmāt prahṛṣṭaḥ iva lakṣyase 
SA_GK20_hpriydpu-228	vidūṣakaḥ - accadi kkhu devī bamhaṇaṃ /	vidūṣakaḥ kkhu devī 
SA_GK20_hpriydpu-229	[arcati khalu devī brāhmaṇam /]	arcati khalu devī brāhmaṇam 
SA_GK20_hpriydpu-230	rājā - yady evaṃ tataḥ kim /	rājā yadi evam tatas kim 
SA_GK20_hpriydpu-231	vidūṣakaḥ - (sagarvam) bho /	vidūṣakaḥ sa garvam bho 
SA_GK20_hpriydpu-232	īriso kkhu bamhaṇo jo cauvvedapañcavedachaṭṭhavedabamhaṇasahassapajjāule rāaule paḍhamaṃ (Kale : pu)	īriso kkhu bamhaṇaḥ jaḥ paḍhamam kale 
SA_GK20_hpriydpu-233	ahaṃ evva devīsaāsado sotthiāvāāṇaṃ lahemi /	aham evva devī saāsadaḥ sotthiā vāāṇam lahemi 
SA_GK20_hpriydpu-234	[bhoḥ /	bhoḥ 
SA_GK20_hpriydpu-235	īdṛśaḥ khalu brāhmaṇaḥ /	īdṛśaḥ khalu brāhmaṇaḥ 
SA_GK20_hpriydpu-236	yaś caturvedapañcavedaṣaḍvedabrāhmaṇasahasraparyākule rjakule prathamam aham eva devīsakāśāt svastivācanaṃ labhe /]	yaḥ catur veda pañca veda ṣaṣ veda brāhmaṇa sahasra paryākule rjakule prathamam aham eva devī sakāśāt svastivācanam labhe 
SA_GK20_hpriydpu-237	rājā - (vihasya)	rājā vihasya 
SA_GK20_hpriydpu-238	vedasaṃkhyayaivāveditaṃ brāhmaṇyam /	veda saṃkhyayā eva āveditam brāhmaṇyam 
SA_GK20_hpriydpu-239	tad āgaccha mahābrāhmaṇa /	tat āgaccha mahābrāhmaṇa 
SA_GK20_hpriydpu-240	dhārāgṛhodyānam eva gacchāvaḥ /	dhārāgṛha udyānam eva gacchāvaḥ 
SA_GK20_hpriydpu-241	vidūṣakaḥ - jaṃ devo āṇavedi /	vidūṣakaḥ jam devaḥ āṇavedi 
SA_GK20_hpriydpu-242	[yad deva ājñāpayati /]	yat devaḥ ājñāpayati 
SA_GK20_hpriydpu-243	rājā - gacchāgrataḥ /	rājā gaccha agratas 
SA_GK20_hpriydpu-244	[p. 13]	p 
SA_GK20_hpriydpu-245	vidūṣakaḥ - bho ehi gacchamha /	vidūṣakaḥ bho ehi gacchamha 
SA_GK20_hpriydpu-246	(parikramyāvalokya ca)	parikramya avalokya ca 
SA_GK20_hpriydpu-247	bho vaassa pekkha pekkha /	bho vaassa pekkha pekkha 
SA_GK20_hpriydpu-248	aviradapaḍantavivihakusumasuumālasilāalucchangassa parimalaṇilīṇamahuarabharabhaggabaulamāladīladājālaassa kamalagandhagahaṇuddāmamārudapajjava  #	a virada paḍanta viviha kusuma suu māla silā alu changassa kamala gandha gahaṇa uddāma māruda pajjava 
SA_GK20_hpriydpu-249	(Kale : parjava)	kale parjava 
SA_GK20_hpriydpu-250	buddhabandhūabandhaṇassa aviralatamālatarupihidātapapaāsassa assa dhārāgharujjāṇassa sassarīaaṃ /	buddha bandhūa bandhaṇassa avirala tamāla taru pihida ātapa paāsassa assa dhārā gharujjāṇassa sa sarīaam 
SA_GK20_hpriydpu-251	[bho ehi gacchāvaḥ /	bho ehi gacchāvaḥ 
SA_GK20_hpriydpu-252	(parikramyāvalokya ca)	parikramya avalokya ca 
SA_GK20_hpriydpu-253	bho vayasya paśya paśya /	bho vayasya paśya paśya 
SA_GK20_hpriydpu-254	aviratapatadvividhakusuma-	avirata pata dvividha kusuma 
SA_GK20_hpriydpu-255	sukumāraśilātalotsaṅgasya parimalanilīnamadhukarabharabhagnabakulamālatīlatājālakasya	su kumāra śilā tala utsaṅgasya parimala nilīna madhukara bhara bhagna bakula mālatī latā jālakasya 
SA_GK20_hpriydpu-256	kamalagandhagrahaṇoddāmamārutaparyavabuddhabandhūkabandhanasyāviralatamālatarupihitātapaprakāśasyāsya	kamala gandha grahaṇa uddāma māruta paryavabuddha bandhūka bandhanasya avirala tamāla taru pihita ātapa prakāśasya asya 
SA_GK20_hpriydpu-257	dhārāgṛhodyānasya saśrīkatām /]	dhārāgṛha udyānasya sa śrīka tām 
SA_GK20_hpriydpu-258	rājā - vayasya sādhv abhihitam / atra hi /	rājā vayasya sādhu abhihitam atra hi 
SA_GK20_hpriydpu-259	vṛntaiḥ kṣudrapravālasthagitam iva talaṃ bhāti śephālikānāṃ	vṛntaiḥ kṣudra pravāla sthagitam iva talam bhāti śephālikānām 
SA_GK20_hpriydpu-260	gandhaḥ saptacchadānāṃ sapadi gajamadāmodamohaṃ karoti /	gandhaḥ saptacchadānām sapadi gaja mada āmoda moham karoti 
SA_GK20_hpriydpu-261	ete connidrapadmacyutabahalarajaḥpuñjapiṅgāṅgarāgā	ete ca unnidra padma cyuta bahala rajaḥ puñja piṅga aṅgarāgā 
SA_GK20_hpriydpu-262	gāyanty avyaktavācaḥ kim api madhuliho vāruṇīpānamattāḥ // HPri_2.2 //	gāyanti avyakta vācaḥ kim api madhulihaḥ vāruṇī pāna mattāḥ 
SA_GK20_hpriydpu-263	vidūṣakaḥ - bho vaassa /	vidūṣakaḥ bho vaassa 
SA_GK20_hpriydpu-264	edaṃ pi dāva pekkha pekkha /	ā idam pi dāva pekkha pekkha 
SA_GK20_hpriydpu-265	jo eso aviralapaḍantakusumaṇiaro ajja vi pattantaragaḷantavarisāvasāṇasalilabindū via lakkhīadi [p. 14] sattavaṇṇapāāvo /	jaḥ esaḥ avirala paḍanta kusuma niaraḥ ajja vi satta vaṇṇa pāāvaḥ 
SA_GK20_hpriydpu-266	[bho vayasya etad api tāvat paśya paśya /	bho vayasya etat api tāvat paśya paśya 
SA_GK20_hpriydpu-267	ya eṣo 'viralapatadkusumanikaro 'dyāpi patrāntaragaladvarṣāvasānasalilabindur iva lakṣyate saptaparṇapādapaḥ /]	yaḥ eṣaḥ virala patat kusuma nikaraḥ dyā api patra antara galat varṣa avasāna salila binduḥ iva lakṣyate sapta parṇa pādapaḥ 
SA_GK20_hpriydpu-268	rājā - vayasya samyag utprekṣitam /	rājā vayasya samyak utprekṣitam 
SA_GK20_hpriydpu-269	bahv eva sadṛśaṃ jaladasamayasya / tathā hi /	bahu eva sadṛśam jalada samayasya tathā hi 
SA_GK20_hpriydpu-270	bibhrāṇā mṛdutāṃ śirīṣakusumaśrīhāribhiḥ śādvalaiḥ	bibhrāṇāḥ mṛdu tām śirīṣa kusuma śrī hāribhiḥ śādvalaiḥ 
SA_GK20_hpriydpu-271	sadyaḥ kalpitakuṭṭimā marakatakṣodair iva kṣālitaiḥ /	sadyas kalpita kuṭṭimā marakata kṣodaiḥ iva kṣālitaiḥ 
SA_GK20_hpriydpu-272	eṣā saṃprati bandhanād vigalitair bandhūkapuṣpotkaraiḥ	eṣā saṃprati bandhanāt vigalitaiḥ bandhūka puṣpa utkaraiḥ 
SA_GK20_hpriydpu-273	adyāpi kṣitir indragopakaśataiś cchanneva saṃlakṣyate // HPri_2.3 //	adyā api kṣitiḥ indragopaka śataiḥ channā iva saṃlakṣyate 
SA_GK20_hpriydpu-274	(tataḥ praviśati ceṭī)	tatas praviśati ceṭī 
SA_GK20_hpriydpu-275	ceṭī - āṇatta mhi devīe Vāsavadattāe /	ceṭī āṇatta mhi devīe vāsavadattāe 
SA_GK20_hpriydpu-276	hanje Indīvarie ajja mae Agatthimahesiṇo aggho dādavvo /	hanje indīvarie ajja mae agatthi mahesiṇaḥ agghaḥ dādavvaḥ 
SA_GK20_hpriydpu-277	tā gaccha tumaṃ /	tāḥ gaccha tumam 
SA_GK20_hpriydpu-278	sehāliākusumamālaṃ lahu geṇhia āacchetti /	sehāliā kusuma mālam lahu geṇhia āacchetti 
SA_GK20_hpriydpu-279	esā vi Āraṇṇiā dhārāgharujjāṇadīhiāe jāva evva viāsiāiṃ kamalāiṃ ṇa atthāhilāsiṇā [p. 15] sujjeṇa maulāvijjanti tāva evva lahuaṃ avaciṇua āacchadu  #	esā vi āraṇṇiā dhārā gharujjāṇa dīhiāe jāva evva viāsiāim kamalāim na 
SA_GK20_hpriydpu-280	tti /	t ti 
SA_GK20_hpriydpu-281	esā tavassiṇī taṃ dīhiaṃ ṇa jāṇādi /	esā tavassiṇī tam dīhiam ṇa jāṇādi 
SA_GK20_hpriydpu-282	tā geṇhia taṃ gamissaṃ /	tā geṇhia tam gamissam 
SA_GK20_hpriydpu-283	(nepathyābhimukham avalokya)	nepathya abhimukham avalokya 
SA_GK20_hpriydpu-284	ido ido Āraṇṇie ehi /	idam idam āraṇṇie ehi 
SA_GK20_hpriydpu-285	[ājñāptāsmi devyā Vāsavadattayā /	ājñāptā asmi devyā vāsavadattayā 
SA_GK20_hpriydpu-286	hañje Indīvarike adya mayāgastyamaharṣaye 'rgho dātavyaḥ /	hañje indīvarike adya mayā agastya mahā ṛṣaye rghaḥ dātavyaḥ 
SA_GK20_hpriydpu-287	tad gaccha tvam /	tat gaccha tvam 
SA_GK20_hpriydpu-288	śephalikākusumamālāṃ laghu gṛhītvāgaccheti /	śephalikā kusuma mālām laghu gṛhītvā āgaccha iti 
SA_GK20_hpriydpu-289	eṣāpy Āraṇyikā dhārāgṛhodyānadīrghikāyā yāvad eva vikasitāni kamalāni nāstābhilāṣiṇā sūryeṇa mukulāyyante tāvad eva laghv avacintyāgacchatv  #	eṣā api āraṇyikā dhārāgṛha udyāna dīrghikāyāḥ yāvat eva vikasitāni kamalāni na āsta abhilāṣiṇā sūryeṇa mukulāyyante tāvat eva laghu avacintya āgacchatu 
SA_GK20_hpriydpu-290	iti /	iti 
SA_GK20_hpriydpu-291	eṣā tapasvinī tāṃ dīrghikāṃ na jānāti /	eṣā tapasvinī tām dīrghikām na jānāti 
SA_GK20_hpriydpu-292	tad gṛhītvā tāṃ gamiṣyāmi (nepathyābhimukham avalokya)]	tat gṛhītvā tām gamiṣyāmi nepathya abhimukham avalokya 
SA_GK20_hpriydpu-293	(tataḥ praviśaty Āraṇyikā)	tatas praviśati āraṇyikā 
SA_GK20_hpriydpu-294	Āraṇyikā - (sabāṣpodvegam ātmagatam)	āraṇyikā sa bāṣpa udvegam ātma gatam 
SA_GK20_hpriydpu-295	taha ṇāma tārise vaṃse uppaṇṇāe aṇṇajaṇaṃ āṇṇāvia ṭṭhiyāe saṃpadaṃ parassa mae āṇattī kādavvetti ṇatthi kkhu dukkharaṃ devvassa /	taha ṇāma tārise vaṃse uppaṇṇāe aṇṇa jaṇam āṇṇāvia ṭṭhiyāe saṃpadam parassa mae āṇattī kādavvā itti ṇatthi kkhu dukkharam devvassa 
SA_GK20_hpriydpu-296	ahavā maha evva eso doso jeṇa jāṇantīe vi ṇa vāvādio appā /	ahavā mahaḥ evva esaḥ dosaḥ jeṇa jāṇantīe vi ṇa vāvādiaḥ appā 
SA_GK20_hpriydpu-297	tā kiṃ saṃpadaṃ karissaṃ /	tā kim saṃpadam karissam 
SA_GK20_hpriydpu-298	ahavā dukkharaṃ dāṇiṃ mae cintidaṃ /	ahavā dukkharam dāṇim mae cintidam 
SA_GK20_hpriydpu-299	varaṃ evva edaṃ vi ṇa uṇa appaṇo mahagghaṃ vaṃsaṃ paāsaantīe lahūkido appā /	varam evva edam vi na uṇa appaṇaḥ mahaggham vaṃsam paāsaantīe lahūkidaḥ appā 
SA_GK20_hpriydpu-300	tā kā gaī /	tā kā gaī 
SA_GK20_hpriydpu-301	jahabhaṇidaṃ aṇuciṭṭhissaṃ /	aṇuciṭṭhissam 
SA_GK20_hpriydpu-302	[(sabāṣpodvegam ātmagatam)	sa bāṣpa udvegam ātma gatam 
SA_GK20_hpriydpu-303	tathā nāma tādṛśe vaṃśa utpannayānyajanam ājñāpya sthitayā sāṃprataṃ parasya mayājñaptiḥ kartavyeti nāsti khalu duṣkaraṃ daivasya /	tathā nāma tādṛśe vaṃśe utpannayā anya janam ājñāpya sthitayā sāṃpratam parasya mayā ājñaptiḥ kartavyā iti na asti khalu duṣkaram daivasya 
SA_GK20_hpriydpu-304	athavā mamaivaiṣa doṣo yena jānatyāpi na vyāpādita ātmā /	athavā mama eva eṣa doṣaḥ yena jānatyā api na vyāpāditaḥ ātmā 
SA_GK20_hpriydpu-305	tat kiṃ sāṃprataṃ kariṣyāmi /	tat kim sāṃpratam kariṣyāmi 
SA_GK20_hpriydpu-306	athavā duṣkaram idānīṃ mayā cintitam /	athavā duṣkaram idānīm mayā cintitam 
SA_GK20_hpriydpu-307	varam evaitad api /	varam eva etat api 
SA_GK20_hpriydpu-308	na punar ātmano mahārghaṃ vaṃśaṃ prakāśayantyā mayā laghūkṛta ātmā /	na punar ātmanaḥ mahārgham vaṃśam prakāśayantyā mayā laghūkṛtaḥ ātmā 
SA_GK20_hpriydpu-309	tat kā gatiḥ /	tat kā gatiḥ 
SA_GK20_hpriydpu-310	yathābhaṇitam anuṣṭhāsyāmi /]	yathā bhaṇitam anuṣṭhāsyāmi 
SA_GK20_hpriydpu-311	ceṭī - ido ehi Āraṇṇie /	ceṭī ido ehi āraṇṇie 
SA_GK20_hpriydpu-312	ita ehi Āraṇyike /	itas ehi āraṇyike 
SA_GK20_hpriydpu-313	Āraṇyikā - iaṃ āacchāmi /	āraṇyikā iam āacchāmi 
SA_GK20_hpriydpu-314	(śramaṃ nāṭayantī)	śramam nāṭayantī 
SA_GK20_hpriydpu-315	hanje dūre kiṃ ajja vi digghiā /	hanje dūre kim ajja vi 
SA_GK20_hpriydpu-316	[iyam āgacchāmi /	iyam āgacchāmi 
SA_GK20_hpriydpu-317	(śramaṃ nāṭayantī)	śramam nāṭayantī 
SA_GK20_hpriydpu-318	hañje dūre kim adyāpi dīrghikā /]	hañje dūre kim adyā api dīrghikā 
SA_GK20_hpriydpu-319	ceṭī - esā sehāliāgummantariā /	ceṭī esā 
SA_GK20_hpriydpu-320	tā ehi odaramha /	tā ehi 
SA_GK20_hpriydpu-321	(avataraṇaṃ nāṭayataḥ)	avataraṇam nāṭayataḥ 
SA_GK20_hpriydpu-322	[eṣā śephalikāgulmāntaritā /	eṣā śephalikā gulma antaritā 
SA_GK20_hpriydpu-323	tad ehi avatarāvaḥ /	tat ehi avatarāvaḥ 
SA_GK20_hpriydpu-324	(avataraṇaṃ nāṭayataḥ)]	avataraṇam nāṭayataḥ 
SA_GK20_hpriydpu-325	rājā - vayasya kim anyad iva cintayasi /	rājā vayasya kim anyat iva cintayasi 
SA_GK20_hpriydpu-326	nanu bravīmi bahv eva sadṛśaṃ jaladasamayasyeti /	nanu bravīmi bahu eva sadṛśam jalada samayasya iti 
SA_GK20_hpriydpu-327	(bibhrāṇā mṛdutām ityādi punaḥ paṭhati)	bibhrāṇā mṛdu tām ityādi punar paṭhati 
SA_GK20_hpriydpu-328	vidūṣakaḥ - (sakrodham)	vidūṣakaḥ sa krodham 
SA_GK20_hpriydpu-329	bho tumaṃ dāva edaṃ aṇṇaṃ a pekkhanto ukkaṇṭhaṇibbharaṃ viṇodesi appāṇaṃ /	bho tumam dāva edam aṇṇam a pekkhantaḥ ukkaṇṭha nibbharam viṇodesi appāṇam 
SA_GK20_hpriydpu-330	mama uṇa bamhaṇassa sotthivāaṇavelā adikkamadi /	mama uṇa bamhaṇassa sotthi vāaṇa velā 
SA_GK20_hpriydpu-331	tā jāva ahaṃ tuvariaṃ dīhiāe ṇhāia devīe saāsaṃ gamissaṃ /	tā jāva aham tuvariam dīhiāe devīe saāsam gamissam 
SA_GK20_hpriydpu-332	[(sakrodham) bhoḥ tvaṃ tāvad etad anyac ca paśyann utkaṇṭhānirbharaṃ vinodayasyātmānam /	sa krodham bhoḥ tvam tāvat etat anyat ca paśyan utkaṇṭhā nirbharam vinodayasi ātmānam 
SA_GK20_hpriydpu-333	mama punar brāhmaṇasya svastivācanavelātikramati /	mama punar brāhmaṇasya svastivācana velā atikramati 
SA_GK20_hpriydpu-334	tad yāvad ahaṃ tvaritaṃ dīrghikāyāṃ snātvā devyāḥ sakāśaṃ gamiṣyāmi /]	tat yāvat aham tvaritam dīrghikāyām snātvā devyāḥ sakāśam gamiṣyāmi 
SA_GK20_hpriydpu-335	[p. 16]	p 
SA_GK20_hpriydpu-336	rājā -nanu mūrkha pāraṃgatā eva vayaṃ dīrghikāyāḥ /	rājā nanu mūrkha pāraṃgatāḥ eva vayam dīrghikāyāḥ 
SA_GK20_hpriydpu-337	evam anekendriyasukhātiśayam anubhavann api nopalakṣayasi / paśya /	evam aneka indriya sukha atiśayam anubhavan api nā upalakṣayasi paśya 
SA_GK20_hpriydpu-338	śrotraṃ haṃsasvano 'yaṃ sukhayati dayitānūpurahrādakārī	śrotram haṃsa svanaḥ yam sukhayati dayitā nūpura hrāda kārī 
SA_GK20_hpriydpu-339	dṛṣṭiprītiṃ vidhatte taṭataruvivarālakṣitā saudhapālī /	dṛṣṭi prītim vidhatte taṭa taru vivara ālakṣitā saudha pālī 
SA_GK20_hpriydpu-340	gandhenāmbhoruhāṇāṃ parimalapaṭunā jāyate ghrāṇasaukhyaṃ	gandhena ambhoruhāṇām parimala paṭunā jāyate ghrāṇa saukhyam 
SA_GK20_hpriydpu-341	gātrāṇāṃ hlādam ete vidadhati maruto vārisaṃparkaśītāḥ // HPri_2.4 //	gātrāṇām hlādam ete vidadhati marutaḥ vāri saṃparka śītāḥ 
SA_GK20_hpriydpu-342	tadehi dīrghikātaṭam upasarpāvaḥ /	tat ehi dīrghikā taṭam upasarpāvaḥ 
SA_GK20_hpriydpu-343	(parikramyāvalokya ca)	parikramya avalokya ca 
SA_GK20_hpriydpu-344	vayasya paśya paśya /	vayasya paśya paśya 
SA_GK20_hpriydpu-345	udyānadevatāyāḥ sphuṭapaṅkajakāntihāriṇī svacchā /	udyāna devatāyāḥ sphuṭa paṅkaja kānti hāriṇī svacchā 
SA_GK20_hpriydpu-346	dṛṣṭir iva dīrghikeyaṃ ramayati māṃ darśanenaiva // HPri_2.5 //	dṛṣṭiḥ iva dīrghikā iyam ramayati mām darśanena eva 
SA_GK20_hpriydpu-347	vidūṣakaḥ - (sakautukam)	vidūṣakaḥ sa kautukam 
SA_GK20_hpriydpu-348	bho vaassa pekkha pekkha /	bho vaassa pekkha pekkha 
SA_GK20_hpriydpu-349	kā esā kusumaparimalasuandhaveṇīmahuarāvalī viddumalaāruṇahatthapallavā ujjalantataṇukomalabāhuladā saccaṃ paccakkhacarī via ujjāṇadevadā itthiā  #	kā esā kusuma parimala suandha veṇī mahuara āvalī viddu malaa aruṇa hattha pallavā ujjalanta taṇu komala bāhuladā saccam paccakkha carī via ujjāṇa devadā itthiā 
SA_GK20_hpriydpu-350	dīsai /	dīsai 
SA_GK20_hpriydpu-351	[(sakautukam)	sa kautukam 
SA_GK20_hpriydpu-352	bho vayasya paśya paśya /	bho vayasya paśya paśya 
SA_GK20_hpriydpu-353	kaiṣā kusumaparimalasugandhaveṇimadhukarāvalir vidrumalatāruṇahastapallavā ujjvalattanukomalabāhulatā satyaṃ pratyakṣacarīvodyānadevatā strī  #	kā eṣā kusuma parimala sugandha veṇi madhukara āvaliḥ vidruma latā aruṇa hasta pallavā ujjvalat tanu komala bāhu latā satyam pratyakṣa carī iva udyāna devatā strī 
SA_GK20_hpriydpu-354	dṛśyate /]	dṛśyate 
SA_GK20_hpriydpu-355	rājā - (sakautukaṃ vilokya)	rājā sa kautukam vilokya 
SA_GK20_hpriydpu-356	vayasya niratiśayasvarūpaśobhājanitabahuvikalpeyam /	vayasya niratiśaya sva rūpa śobhā janita bahu vikalpā iyam 
SA_GK20_hpriydpu-357	yat satyam aham api nāvagacchāmi / paśya /	yat satyam aham api na avagacchāmi paśya 
SA_GK20_hpriydpu-358	[p. 17]	p 
SA_GK20_hpriydpu-359	pātālād bhuvanālokanaparā kiṃ nāgakanyotthitā	pātālāt bhuvana ālokana parā kim nāga kanyā utthitā 
SA_GK20_hpriydpu-360	mithyā tat khalu dṛṣṭam eva hi mayā tasmin kuto 'stīdṛśī /	mithyā tat khalu dṛṣṭam eva hi mayā tasmin kutas stīdṛśī 
SA_GK20_hpriydpu-361	mūrtā syād iha kaumudī na ghaṭate tasyā divā darśanaṃ	mūrtā syāt iha kaumudī na ghaṭate tasyāḥ divā darśanam 
SA_GK20_hpriydpu-362	keyaṃ hastatalasthitena kamalenālokyate śrīr iva // HPri_2.6 //	kā iyam hasta tala sthitena kamalena ālokyate śrīḥ iva 
SA_GK20_hpriydpu-363	vidūṣakaḥ - (nirūpya)	vidūṣakaḥ nirūpya 
SA_GK20_hpriydpu-364	esā kkhu devīe pariāriā Indīvariā /	esā kkhu devīe pariāriā indīvariā 
SA_GK20_hpriydpu-365	tā gummantariā bhavia pekkha mha /	tā gummantariā bhavia pekkha mha 
SA_GK20_hpriydpu-366	[(nirūpya) eṣā khalu devyāḥ paricārikendīvarikā /	nirūpya eṣā khalu devyāḥ paricārikā indīvarikā 
SA_GK20_hpriydpu-367	tad gulmāntaritau bhūtvā paśyāvaḥ /]	tat gulma antaritau bhūtvā paśyāvaḥ 
SA_GK20_hpriydpu-368	(ubhau tathā kurutaḥ)	ubhau tathā kurutaḥ 
SA_GK20_hpriydpu-369	ceṭī - (kamalinīpatragrahaṇaṃ nāṭayantī)	ceṭī kamalinī patra grahaṇam nāṭayantī 
SA_GK20_hpriydpu-370	Āraṇṇie avaiṇu (Kale : avaiṇuṃ)	āraṇṇie kale 
SA_GK20_hpriydpu-371	tumaṃ padumāiṃ /	tumam 
SA_GK20_hpriydpu-372	ahaṃ vi edassiṃ ṇaliṇīpattammi sehāliākusumāīṃ avaiṇua devīsaāsaṃ gamissaṃ /	aham vi edassim naliṇī pattammi devī saāsam gamissam 
SA_GK20_hpriydpu-373	[(kamalinīpatragrahaṇaṃ nāṭayantī)	kamalinī patra grahaṇam nāṭayantī 
SA_GK20_hpriydpu-374	Āraṇyike avacinu tvaṃ padmāni /	āraṇyike avacinu tvam padmāni 
SA_GK20_hpriydpu-375	aham apy etasmin nalinīpatre śephālikākusumāny avacitya devīsakāśaṃ gamiṣyāmi /]	aham api etasmin nalinī patre śephālikā kusumāni avacitya devī sakāśam gamiṣyāmi 
SA_GK20_hpriydpu-376	rājā - vayasya saṃlāpa iva vartate /	rājā vayasya saṃlāpe iva vartate 
SA_GK20_hpriydpu-377	tad avahitāḥ śṛṇumaḥ /	tat avahitāḥ śṛṇumaḥ 
SA_GK20_hpriydpu-378	kadācid ita eva vyaktībhaviṣyati /	kadācid itas eva vyaktībhaviṣyati 
SA_GK20_hpriydpu-379	(ceṭī gamanaṃ nāṭayati)	ceṭī gamanam nāṭayati 
SA_GK20_hpriydpu-380	Āraṇyikā - halā Indīvarie ṇa sakkuṇomi tue viṇā muhuttaṃ vi ettha āsiduṃ /	āraṇyikā halā indīvarie ṇa sakkuṇomi tue viṇā muhuttam vi ettha āsidum 
SA_GK20_hpriydpu-381	[halā Indīvarike /	halā indīvarike 
SA_GK20_hpriydpu-382	na śaknomi tvayā vinā muhūrtam apy atrāsitum /]	na śaknomi tvayā vinā muhūrtam api atrāsitum 
SA_GK20_hpriydpu-383	ceṭī - (vihasya)	ceṭī vihasya 
SA_GK20_hpriydpu-384	jādisaṃ ajja mae devīe mantidaṃ sudaṃ tāriseṇa ciraṃ evva mae viṇā tue āsidavvaṃ /	jādisam ajja mae devīe mantidam sudam tāriseṇa ciram evva mae viṇā tue āsidavvam 
SA_GK20_hpriydpu-385	[(vihasya) yādṛśam adya mayā devyā mantritaṃ śrutaṃ tādṛśena ciram eva mayā vinā tvayāsitavyam /]	vihasya yādṛśam adya mayā devyā mantritam śrutam tādṛśena ciram eva mayā vinā tvayā āsitavyam 
SA_GK20_hpriydpu-386	[p. 18]	p 
SA_GK20_hpriydpu-387	Āraṇyikā - (saviṣādam)	āraṇyikā sa viṣādam 
SA_GK20_hpriydpu-388	kiṃ devīe mantidaṃ /	kim devīe manti dam 
SA_GK20_hpriydpu-389	[kiṃ devyā mantritam /]	kim devyā mantritam 
SA_GK20_hpriydpu-390	ceṭī - evaṃ / tadā esā ahaṃ mahārāeṇa bhaṇidā jaha jadā esā Viñjhakeduduhidā varajoggā bhavissadi tadā ahaṃ sumarāidavvetti /	ceṭī evam tadā esā aham mahārāeṇa bhaṇidā jaha jadā esā viñjhakedu duhidā vara joggā bhavissadi tadā aham 
SA_GK20_hpriydpu-391	tā saṃpadaṃ sumarāvemi jeṇa se varacintāpajjāulo bhavissadi /	tā saṃpadam jeṇa se vara cintā pajja āulaḥ bhavissadi 
SA_GK20_hpriydpu-392	[etat /	etat 
SA_GK20_hpriydpu-393	tadaiṣāhaṃ mahārājena bhaṇitā yathā yadaiṣā Vindhyaketuduhitā varayogyā bhaviṣyati tadāhaṃ smārayitavya iti /	tadā eṣā aham mahā rājena bhaṇitā yathā yadā eṣā vindhyaketu duhitā vara yogyā bhaviṣyati tadā aham smārayitavyaḥ iti 
SA_GK20_hpriydpu-394	tat sāṃprataṃ mahārājaṃ smārayāmi yenāsyā varacintāparyākulo bhaviṣyati /]	tat sāṃpratam mahā rājam smārayāmi yena asyāḥ vara cintā paryākulaḥ bhaviṣyati 
SA_GK20_hpriydpu-395	rājā - (saharṣam)	rājā sa harṣam 
SA_GK20_hpriydpu-396	iyaṃ sā Vindhyaketor duhitā /	iyam sā vindhyaketoḥ duhitā 
SA_GK20_hpriydpu-397	(sānutāpam) ciraṃ muṣitāḥ smo vayam /	sa anutāpam ciram muṣitāḥ smaḥ vayam 
SA_GK20_hpriydpu-398	vayasya nirdoṣadarśanā kanyakā khalv iyam /	vayasya nirdoṣa darśanā kanyakā khalu iyam 
SA_GK20_hpriydpu-399	viśrabdham idānīṃ paśyāmaḥ /	viśrabdham idānīm paśyāmaḥ 
SA_GK20_hpriydpu-400	Āraṇyikā - (saroṣaṃ karṇau pidhāya)	āraṇyikā sa roṣam karṇau pidhāya 
SA_GK20_hpriydpu-401	tā gaccha tumaṃ /	tāḥ gaccha tumam 
SA_GK20_hpriydpu-402	ṇa maha tue asaṃbaddhappalāviṇīe paoaṇaṃ /	ṇa maha tue a saṃbaddha ppalāviṇīe paoaṇam 
SA_GK20_hpriydpu-403	[tad gaccha tvam /	tat gaccha tvam 
SA_GK20_hpriydpu-404	na mama tvayāsaṃbaddhapralāpinyā prayojanam /]	na mama tvayā asaṃbaddha pralāpinyā prayojanam 
SA_GK20_hpriydpu-405	(ceṭy apasṛtya puṣpāvacayaṃ nāṭayati)	ceṭī apasṛtya puṣpa avacayam nāṭayati 
SA_GK20_hpriydpu-406	rājā - aho sutarāṃ prakaṭīkṛtam ābhijātyaṃ dhīratayā /	rājā aho sutarām prakaṭīkṛtam ābhijātyam dhīra tayā 
SA_GK20_hpriydpu-407	vayasya dhanyaḥ khalv asau ya etad aṅgasparśasukhabhājanaṃ bhaviṣyati /	vayasya dhanyaḥ khalu asau yaḥ etat aṅga sparśa sukha bhājanam bhaviṣyati 
SA_GK20_hpriydpu-408	(Āraṇyikā kamalāvacayaṃ nāṭayati)	āraṇyikā kamala avacayam nāṭayati 
SA_GK20_hpriydpu-409	vidūṣakaḥ - bho vaassa pekkha pekkha /	vidūṣakaḥ bho vaassa pekkha pekkha 
SA_GK20_hpriydpu-410	accariaṃ accariaṃ /	accariam 
SA_GK20_hpriydpu-411	esā salilacalantakarapallavappahāvitthideṇa ohasiasohaṃ karedi kamalavaṇaṃ avaciṇantī /	esā salila calanta kara pallava ppahā vitthideṇa oha sia soham karedi kamala vaṇam avaciṇantī 
SA_GK20_hpriydpu-412	[bho vayasya paśya paśya /	bho vayasya paśya paśya 
SA_GK20_hpriydpu-413	āścaryam āścaryam /	āścaryam āścaryam 
SA_GK20_hpriydpu-414	eṣā salilacalatkarapallavaprabhāvistṛtenāpahasitaśobhaṃ karoti kamalavanam avacinvatī /]	eṣā salila calat karapallava prabhā vistṛtena apahasita śobham karoti kamala vanam avacinvatī 
SA_GK20_hpriydpu-415	rājā - vayasya satyam evaitat / paśya /	rājā vayasya satyam eva etat paśya 
SA_GK20_hpriydpu-416	[p. 19]	p 
SA_GK20_hpriydpu-417	acchinnāmṛtabinduvṛṣṭisadṛśīṃ prītiṃ dadatyā dṛśāṃ	acchinna amṛta bindu vṛṣṭi sadṛśīm prītim dadatyāḥ dṛśām 
SA_GK20_hpriydpu-418	yātāyā vigalatpayodharapaṭādraṣṭavyatāṃ kām api /	yātāyāḥ vigalat payodhara paṭa adraṣṭavya tām kām api 
SA_GK20_hpriydpu-419	asyāś candramasas tanor iva karasparśāspadatvaṃ gatā	asyāḥ candramasaḥ tanoḥ iva kara sparśa āspada tvam gatā 
SA_GK20_hpriydpu-420	naite yan mukulībhavanti sahasā padmās tad evādbhutam // HPri_2.7 //	na ete yat mukulībhavanti sahasā padmāḥ tat eva adbhutam 
SA_GK20_hpriydpu-421	Āraṇyikā - (bhramarabādhaṃ nāṭayantī)	āraṇyikā bhramara bādham nāṭayantī 
SA_GK20_hpriydpu-422	ha ddhi ha ddhi /	ha ddhi ha ddhi 
SA_GK20_hpriydpu-423	ede kkhu avare pariccaia kamaliṇiṃ ṇīluppalavaṇāiṃ samāpaḍantā ṇiuṇaaraṃ bādhantā āāsaanti maṃ duṭṭhamahuarā /	ede kkhu avare kamaliṇim ṇīluppala vaṇāim samāpaḍantā ṇiuṇaaram bādhantā mama duṭṭha mahuarā 
SA_GK20_hpriydpu-424	(uttarīyeṇa mukhaṃ pidhāya sabhayam)	uttarīyeṇa mukham pidhāya sa bhayam 
SA_GK20_hpriydpu-425	halā Indīvarie parittāehi maṃ parittāehi maṃ /	halā indīvarie parittāehi mam parittāehi mam 
SA_GK20_hpriydpu-426	ede kkhu duṭṭhamahuarā paribhavissanti /	ede kkhu duṭṭha mahuarā paribhavissanti 
SA_GK20_hpriydpu-427	[(bhramarabādhaṃ nāṭayantī)	bhramara bādham nāṭayantī 
SA_GK20_hpriydpu-428	hā dhik hā dhik /	hā dhik hā dhik 
SA_GK20_hpriydpu-429	ete khalv apare parityajya kamalinīṃ nīlotpalavanāni samāpatanto nipuṇataraṃ bādhamānā āyāsayanti māṃ (uttarīyeṇa mukhaṃ pidhāya sabhayam)	ete khalu apare parityajya kamalinīm nīlotpala vanāni samāpatantaḥ nipuṇataram bādhamānāḥ āyāsayanti mām uttarīyeṇa mukham pidhāya sa bhayam 
SA_GK20_hpriydpu-430	halā Indīvarike paritrāyasva māṃ paritrāyasva mām /	halā indīvarike paritrāyasva mām paritrāyasva mām 
SA_GK20_hpriydpu-431	ete khalu duṣṭamadhukarāḥ paribhaviṣyanti /]	ete khalu duṣṭa madhukarāḥ paribhaviṣyanti 
SA_GK20_hpriydpu-432	vidūṣakaḥ - bho vaassa puṇṇā de maṇorahā /	vidūṣakaḥ bho vaassa puṇṇā de maṇorahā 
SA_GK20_hpriydpu-433	jāva evva gabbhadāsīe sudā ṇa āacchadi dāva evva tumaṃ vi tuṇhīko bhavia uvasappa /	jāvaḥ evva gabbha dāsīe sudā ṇaḥ āacchadi dāvaḥ evva tumam vi tuṇhīkaḥ bhavia uvasappa 
SA_GK20_hpriydpu-434	esā vi salilasaddasūideṇa paasaṃcāreṇa Indīvariā āacchadi tti jāṇia tumaṃ evva olambissadi /	esā vi salilasadda sūideṇa paa saṃcāreṇa indīvariā āacchadi tti jāṇia tumam evva olambissadi 
SA_GK20_hpriydpu-435	[bho vayasya pūrṇās te manorathāḥ /	bho vayasya pūrṇāḥ te manorathāḥ 
SA_GK20_hpriydpu-436	yāvad eva garbhadāsyāḥ sutā nāgacchati tāvad eva tvam api tūṣṇīko bhūtvopasarpa /	yāvat eva garbha dāsyāḥ sutā na āgacchati tāvat eva tvam api tūṣṇīkaḥ bhūtvā upasarpa 
SA_GK20_hpriydpu-437	eṣāpi salilaśabdasūcitena padasaṃcāreṇendīvarikāgacchatīti jñātvā tvām evāvalambiṣyate /]	eṣā api salila śabda sūcitena pada saṃcāreṇa indīvarikā āgacchati iti jñātvā tvām eva avalambiṣyate 
SA_GK20_hpriydpu-438	rājā - sādhu vayasya sādhu /	rājā sādhu vayasya sādhu 
SA_GK20_hpriydpu-439	kālānurūpam upadiṣṭam /	kāla anurūpam upadiṣṭam 
SA_GK20_hpriydpu-440	(ity Āraṇyikāsamīpam upasarpati)	iti āraṇyikā samīpam upasarpati 
SA_GK20_hpriydpu-441	[p. 20]	p 
SA_GK20_hpriydpu-442	Āraṇyikā - (padaśabdākarṇanaṃ nāṭayantī) Indīvarie /	āraṇyikā pada śabda ākarṇanam nāṭayantī 
SA_GK20_hpriydpu-443	lahu uvasappa lahu uvasappa /	lahu uvasappa lahu uvasappa 
SA_GK20_hpriydpu-444	āulīkida mhi duṭṭhamahuarehiṃ (rājānam avalambate) /	āulīkida mhi duṭṭha mahuarehim rājānam avalambate 
SA_GK20_hpriydpu-445	[Indīvarike laghūpasarpa laghūpasarpa /	indīvarike laghu upasarpa laghu upasarpa 
SA_GK20_hpriydpu-446	akulīkṛtāsmi duṣṭamadhukaraiḥ /]	akulīkṛtā asmi duṣṭa madhukaraiḥ 
SA_GK20_hpriydpu-447	(rājā kaṇṭhe gṛhṇāti /	rājā kaṇṭhe gṛhṇāti 
SA_GK20_hpriydpu-448	Āraṇyikottarīyaṃ mukhād apanīya rājānam apaśyantī bhramarāvalokanaṃ nāṭayati)	āraṇyika uttarīyam mukhāt apanīya rājānam a paśyantī bhramara avalokanam nāṭayati 
SA_GK20_hpriydpu-449	rājā - (svottarīyeṇa bhramarān nivārayan)	rājā sva uttarīyeṇa bhramarān nivārayan 
SA_GK20_hpriydpu-450	ayi visṛja viṣādaṃ bhīru bhṛṅgās tavaite	ayi visṛja viṣādam bhīru bhṛṅgāḥ tava ete 
SA_GK20_hpriydpu-451	parimalarasalubdhā vaktrapadme patanti /	parimala rasa lubdhāḥ vaktra padme patanti 
SA_GK20_hpriydpu-452	vikirasi yadi bhūyas trāsalolāyatākṣī	vikirasi yadi bhūyas trāsa lola āyata akṣī 
SA_GK20_hpriydpu-453	kuvalayavanalakṣmīṃ tat kutas tvāṃ tyajanti // HPri_2.8 //	kuvalaya vana lakṣmīm tat kutas tvām tyajanti 
SA_GK20_hpriydpu-454	Āraṇyikā - (rājānaṃ dṛṣṭvā sādhvasaṃ nāṭayantī)	āraṇyikā rājānam dṛṣṭvā sādhvasam nāṭayantī 
SA_GK20_hpriydpu-455	kahaṃ ṇa esā Indīvariā /	kaham ṇaḥ esā indīvariā 
SA_GK20_hpriydpu-456	(sabhayaṃ rājānaṃ tyaktvāpasarantī)	sa bhayam rājānam tyaktvā apasarantī 
SA_GK20_hpriydpu-457	Indīvarie lahu āaccha lahu āaccha /	indīvarie lahu āaccha lahu āaccha 
SA_GK20_hpriydpu-458	parittāehi māṃ /	parittāehi mām 
SA_GK20_hpriydpu-459	[kathaṃ naiṣendīvarikā /	katham naiṣendīvarikā 
SA_GK20_hpriydpu-460	(sabhayaṃ rājānaṃ tyaktvāpasarantī) Indīvarike /	sa bhayam rājānam tyaktvā apasarantī indīvarike 
SA_GK20_hpriydpu-461	laghv āgaccha laghv āgaccha /	laghu āgaccha laghu āgaccha 
SA_GK20_hpriydpu-462	paritrāyasva mām /]	paritrāyasva mām 
SA_GK20_hpriydpu-463	vidūṣakaḥ - hodi saalapuḍhavīparittāṇasamattheṇa Vaccharāeṇa parittāantī ceḍiṃ Indīvariaṃ akkandasi /	vidūṣakaḥ hodi saala puḍhavī parittāṇa samattheṇa vaccha rāeṇa ceḍim indīvariam akkandasi 
SA_GK20_hpriydpu-464	[bhavati sakalapṛthvīparitrāṇasamarthena Vatsarājena paritrāyamāṇā ceṭīm Indīvarikām ākrandasi /]	bhavati sakala pṛthvī paritrāṇa samarthena vatsa rājena paritrāyamāṇā ceṭīm indīvarikām ākrandasi 
SA_GK20_hpriydpu-465	(rājā ayi visṛja ityādi punaḥ paṭhati)	rājā ayi visṛja ityādi punar paṭhati 
SA_GK20_hpriydpu-466	Āraṇyikā - (rājānam avalokya saspṛhaṃ salajjaṃ cātmagatam)	āraṇyikā rājānam avalokya sa spṛham sa lajjam ca ātma gatam 
SA_GK20_hpriydpu-467	aaṃ kkhu so mahārāo jassa ahaṃ tādeṇa diṇṇā /	aam kkhu saḥ mahā rāo jassa aham tādeṇa diṇṇā 
SA_GK20_hpriydpu-468	ṭhāṇe kkhu tādassa pakkhavādo (ākulatāṃ nāṭayati) /	ṭhāṇe kkhu tādassa pakkhavādaḥ ākula tām nāṭayati 
SA_GK20_hpriydpu-469	[ayaṃ khalu sa mahārājo yasyāhaṃ tātena dattā /	ayam khalu sa mahā rājaḥ yasya aham tātena dattā 
SA_GK20_hpriydpu-470	sthāne khalu tātasya pakṣapātaḥ /]	sthāne khalu tātasya pakṣapātaḥ 
SA_GK20_hpriydpu-471	[p. 21]	p 
SA_GK20_hpriydpu-472	ceṭī - āāsiā kkhu Āraṇṇiā duṭṭhamahuarehiṃ /	ceṭī āāsiā kkhu āraṇṇiā duṭṭha mahuarehiṃ 
SA_GK20_hpriydpu-473	tā jāva uvasappia samassāsemi /	tā jāva uvasappia samassāsemi 
SA_GK20_hpriydpu-474	Āraṇṇie mā bhaāhi /	āraṇṇie mā bhaāhi 
SA_GK20_hpriydpu-475	esā uvaada mhi /	esā uvaada mhi 
SA_GK20_hpriydpu-476	[āyāsitā khalu Āraṇyikā duṣṭamadhukaraiḥ /	āyāsitā khalu āraṇyikā duṣṭa madhukaraiḥ 
SA_GK20_hpriydpu-477	tad yāvad upasarpya samāśvāsayāmi /	tat yāvat upasarpya samāśvāsayāmi 
SA_GK20_hpriydpu-478	Āraṇyike mā bibhihi /	āraṇyike mā bibhihi 
SA_GK20_hpriydpu-479	eṣopagatāsmi /]	eṣā upagatā asmi 
SA_GK20_hpriydpu-480	vidūṣakaḥ - bho osara osara /	vidūṣakaḥ bho osara osara 
SA_GK20_hpriydpu-481	esā kkhu Indīvarīā āadā /	esā kkhu indīvarīā āadā 
SA_GK20_hpriydpu-482	edaṃ uttantaṃ pekkhia devīe ṇivedaissadi /	edam uttantam pekkhia devīe 
SA_GK20_hpriydpu-483	(aṅgulyā nirdiśya)	aṅgulyā nirdiśya 
SA_GK20_hpriydpu-484	tā imaṃ evva kadalīgharaṃ pavisia muhuttaṃ ciṭṭamha /	tāḥ imam evva kadalī gharam pavisia muhuttam ciṭṭamha 
SA_GK20_hpriydpu-485	[bhoḥ apasarāpasara /	bhoḥ apasara apasara 
SA_GK20_hpriydpu-486	eṣā khalv Indīvarikāgatā /	eṣā khalu indīvarikā āgatā 
SA_GK20_hpriydpu-487	etaṃ vṛttāntaṃ prekṣya devyai nivedayiṣyati /	etam vṛttāntam prekṣya devyai nivedayiṣyati 
SA_GK20_hpriydpu-488	(aṅgulyā nirdiśya)	aṅgulyā nirdiśya 
SA_GK20_hpriydpu-489	tad idam eva kadalīgṛhaṃ praviśya muhūrtaṃ tiṣṭhāvaḥ /]	tat idam eva kadalīgṛham praviśya muhūrtam tiṣṭhāvaḥ 
SA_GK20_hpriydpu-490	(ubhau tathā kurutaḥ)	ubhau tathā kurutaḥ 
SA_GK20_hpriydpu-491	ceṭī -(upasṛtya kapolau spṛśantī)	ceṭī upasṛtya kapolau spṛśantī 
SA_GK20_hpriydpu-492	hanje Āraṇṇie kamalasarisassa tuha vaaṇassa aaṃ doso jaṃ mahuarā evvaṃ avarajjhanti /	hanje āraṇṇie kamala sarisassa tuha vaaṇassa aam dosaḥ jam mahuarāḥ evvam avarajjhanti 
SA_GK20_hpriydpu-493	(haste gṛhītvā)	haste gṛhītvā 
SA_GK20_hpriydpu-494	tā ehi gacchamha /	tāḥ ehi gacchamha 
SA_GK20_hpriydpu-495	pariṇado diaho /	pariṇadaḥ di ahaḥ 
SA_GK20_hpriydpu-496	[hañje Āraṇyike /	hañje āraṇyike 
SA_GK20_hpriydpu-497	kamalasadṛśasya tava vadanasyāhaṃ doṣo yan madhukarā evam aparādhyanti (haste gṛhītvā)	kamala sadṛśasya tava vadanasya aham doṣaḥ yat madhukarāḥ evam aparādhyanti haste gṛhītvā 
SA_GK20_hpriydpu-498	tad ehi gacchāvaḥ /	tat ehi gacchāvaḥ 
SA_GK20_hpriydpu-499	pariṇato divasaḥ /]	pariṇataḥ divasaḥ 
SA_GK20_hpriydpu-500	(gamanaṃ nāṭayataḥ)	gamanam nāṭayataḥ 
SA_GK20_hpriydpu-501	Āraṇyikā - (kadalīgrhābhimukham avalokya)	āraṇyikā kadalī grha abhimukham avalokya 
SA_GK20_hpriydpu-502	hanje Indīvarie adisisiradāe salilassa ūrūtthambho via samuppaṇṇo /	hanje indīvarie adisi sira dāe salilassa ūru utthambhaḥ via samuppaṇṇaḥ 
SA_GK20_hpriydpu-503	tā saṇiaṃ saṇiaṃ gacchamha /	tā saṇiam saṇiam gacchamha 
SA_GK20_hpriydpu-504	[hañje Indīvarike atiśiśiratayā salilasyorustambha iva samutpannaḥ /	hañje indīvarike ati śiśira tayā salilasya ūru stambhaḥ iva samutpannaḥ 
SA_GK20_hpriydpu-505	tac chanaiḥ śanair gacchāvaḥ /]	tat śanais śanais gacchāvaḥ 
SA_GK20_hpriydpu-506	ceṭī - taha / taha /	ceṭī 
SA_GK20_hpriydpu-507	(iti niṣkrānte)	iti niṣkrānte 
SA_GK20_hpriydpu-508	vidūṣakaḥ - bho ehi ṇikkamamha /	vidūṣakaḥ bho ehi ṇikkamamha 
SA_GK20_hpriydpu-509	taṃ geṇhia esā dāsīe sudā Indīvariā gadā /	tam geṇhia esā dāsīe sudā indīvariā gadā 
SA_GK20_hpriydpu-510	[bhoḥ ehi niṣkrāmāvaḥ /	bhoḥ ehi niṣkrāmāvaḥ 
SA_GK20_hpriydpu-511	tāṃ gṛhītvaiṣā dāsyāḥ sutendīvarikā gatā /]	tām gṛhītvā eṣā dāsyāḥ sutā indīvarikā gatā 
SA_GK20_hpriydpu-512	rājā -(niḥśvasya)	rājā niḥśvasya 
SA_GK20_hpriydpu-513	kathaṃ gatā /	katham gatā 
SA_GK20_hpriydpu-514	sakhe Vasantaka/	sakhe vasantaka 
SA_GK20_hpriydpu-515	na khalv avighnam abhilaṣitam adhanyaiḥ prāpyate /	na khalu avighnam abhilaṣitam adhanyaiḥ prāpyate 
SA_GK20_hpriydpu-516	(vilokya) sakhe paśya paśya /	vilokya sakhe paśya paśya 
SA_GK20_hpriydpu-517	[p. 22]	p 
SA_GK20_hpriydpu-518	ābaddhamukham apīdam kaṇṭakitaṃ kamalakānanaṃ tasyāḥ /	ābaddha mukham api idam kaṇṭakitam kamala kānanam tasyāḥ 
SA_GK20_hpriydpu-519	sukumārapāṇipallavasaṃsparśasukhaṃ kathayatīva // HPri_2.9 //	sukumāra pāṇipallava saṃsparśa sukham kathayati iva 
SA_GK20_hpriydpu-520	(niḥśvasya) sakhe /	niḥśvasya sakhe 
SA_GK20_hpriydpu-521	ka idānīm upāyaḥ punas tāṃ draṣṭum /	kaḥ idānīm upāyaḥ punar tām draṣṭum 
SA_GK20_hpriydpu-522	vidūṣakaḥ - bho tume evva puttaliaṃ bhañjia dāṇiṃ rodisi /	vidūṣakaḥ bho tume evva puttaliam bhañjia dāṇim rodisi 
SA_GK20_hpriydpu-523	ṇa maha kkhu bamhaṇassa vaaṇaṃ karesi /	ṇa maha kkhu bamhaṇassa vaaṇam karesi 
SA_GK20_hpriydpu-524	[bhoḥ tvam eva puttalikāṃ bhaṅktvedānīṃ rodiṣi /	bhoḥ tvam eva puttalikām bhaṅktvā idānīm rodiṣi 
SA_GK20_hpriydpu-525	na mama khalu brāhmaṇasya vacanaṃ karoṣi /]	na mama khalu brāhmaṇasya vacanam karoṣi 
SA_GK20_hpriydpu-526	rājā - kiṃ mayā na kṛtam /	rājā kim mayā na kṛtam 
SA_GK20_hpriydpu-527	vidūṣakaḥ - taṃ dāṇiṃ visumaridaṃ /	vidūṣakaḥ tam dāṇim visumaridam 
SA_GK20_hpriydpu-528	jaha tuṇhīko bhavia uvasappetti mae bhaṇidaṃ /	jaha tuṇhīkaḥ bhavia uvasappa itti mae bhaṇidam 
SA_GK20_hpriydpu-529	adisaṃkaḍe jaṃ bhavaṃ pavisia aliapaṃḍiccaduvvidaddhadāe ai visija visādetti edehiṃ aṇṇehiṃ a kaḍuavaaṇehiṃ ṇibbhacchia (Kale : -ccia)	adi saṃkaḍe jam bhavam pavisia alia paṃḍicca duvvidaddha dāe edehim aṇṇehim a kaḍua vaaṇehim nibbhacchia kale 
SA_GK20_hpriydpu-530	saṃpadaṃ kiṃ rodisi /	saṃpadam kim rodisi 
SA_GK20_hpriydpu-531	puṇo vi uvāaṃ pucchasi /	puṇar vi pucchasi 
SA_GK20_hpriydpu-532	[tad idāniṃ vismṛtam /	tat idānim vismṛtam 
SA_GK20_hpriydpu-533	yathā tuṣṇīko bhūtvopasarpeti mayā bhaṇitam /	yathā tuṣṇīkaḥ bhūtvā upasarpa iti mayā bhaṇitam 
SA_GK20_hpriydpu-534	atisaṃkaṭe yad bhavān praviśyālīkapāṇḍityadurvidagdhatayā ayi visṛja viṣādaṃ ity etair anyaiś ca kaṭuvacanair nirbhartsya sāṃprataṃ kiṃ rodiṣi	ati saṃkaṭe yat bhavān praviśya alīka pāṇḍitya durvidagdha tayā ayi visṛja viṣādam iti etaiḥ anyaiḥ ca kaṭu vacanaiḥ nirbhartsya sāṃpratam kim rodiṣi 
SA_GK20_hpriydpu-535	punar apy upāyaṃ pṛcchasi /]	punar api upāyam pṛcchasi 
SA_GK20_hpriydpu-536	rājā - kathaṃ samāśvāsanam api nirbhartsitam iti bhaṇitaṃ mūrkheṇa /	rājā katham samāśvāsanam api nirbhartsitam iti bhaṇitam mūrkheṇa 
SA_GK20_hpriydpu-537	vidūṣakaḥ - jāṇidaṃ evva ko ettha mukkho tti /	vidūṣakaḥ jāṇidam evva kaḥ ettha mukkhaḥ tti 
SA_GK20_hpriydpu-538	tā kiṃ edeṇa /	tā kim 
SA_GK20_hpriydpu-539	atthamaāhilāsī bhaavaṃ sahassarassī /	bhaavam 
SA_GK20_hpriydpu-540	tā ehi abbhantaraṃ evva pavisamha /	tāḥ ehi abbhantaram evva 
SA_GK20_hpriydpu-541	[jñātam eva ko 'tra mūrkha iti /	jñātam eva kaḥ tra mūrkhaḥ iti 
SA_GK20_hpriydpu-542	tat kim anena astamayābhilāṣī bhagavān sahasraraśmiḥ /	tat kim anena astamaya abhilāṣī bhagavān sahasraraśmiḥ 
SA_GK20_hpriydpu-543	tad ehy abhyantaram eva praviśāvaḥ /]	tat ehi abhyantaram eva praviśāvaḥ 
SA_GK20_hpriydpu-544	rājā - (vilokya)	rājā vilokya 
SA_GK20_hpriydpu-545	aye pariṇataprāyo divasaḥ /	aye pariṇata prāyaḥ divasaḥ 
SA_GK20_hpriydpu-546	ahaha /	ahaha 
SA_GK20_hpriydpu-547	saṃprati hi	saṃprati hi 
SA_GK20_hpriydpu-548	hṛtvā padmavana dyutiṃ priyatameveyaṃ dinaśrīr gatā	hṛtvā padma vana dyutim priyatamā iva iyam dina śrīḥ gatā 
SA_GK20_hpriydpu-549	rāgo 'smin mama cetasīva savitur bimbe 'dhikaṃ lakṣyate /	rāgaḥ u smin mama cetasi iva savituḥ bimbe dhikam lakṣyate 
SA_GK20_hpriydpu-550	[p. 23]	p 
SA_GK20_hpriydpu-551	cakrāhvo 'ham iva stithaḥ sahacarīṃ dhyāyan nalinyāṣ taṭe	cakrāhvaḥ ham iva stithaḥ sahacarīm dhyāyan nalinyāḥ taṭe 
SA_GK20_hpriydpu-552	saṃjātā sahasā mameva bhuvanasyāpy andhakārā diśaḥ // HPri_2.10 //	saṃjātā sahasā mama iva bhuvanasya api andhakārāḥ diśaḥ 
SA_GK20_hpriydpu-553	(iti niṣkrāntāḥ sarve /)	iti niṣkrāntāḥ sarve 
SA_GK20_hpriydpu-554	(iti dvitīyo 'ṅkaḥ) // *	iti dvitīyaḥ ṅkaḥ 
SA_GK20_hpriydpu-555	tṛtīyo 'ṅkaḥ /	tṛtīyaḥ ṅkaḥ 
SA_GK20_hpriydpu-556	(tataḥ praviśati Manoramā /)	tatas praviśati manoramā 
SA_GK20_hpriydpu-557	Manoramā - āṇatta mhi devīe Vāsavadattāe hanje Maṇorame jaṃ taṃ Saṃkiccāyaṇīe ajjauttassa	manoramā āṇatta mhi devīe vāsavadattāe hanje maṇorame jam tam saṃkiccāyaṇīe ajjauttassa 
SA_GK20_hpriydpu-558	mama a uttantaṃ ṇāḍaovaṇibaddhaṃ tassa ṇaccidavvasesaṃ [p. 24] ajja tumhehiṃ komudīmahūsave ṇaccidavvaṃ ti /	mama a uttantam tassa ti 
SA_GK20_hpriydpu-559	hio kkhu Āraṇṇiāe piasahīe suṇṇahiaāe aṇṇahā evva ṇaccidaṃ /	hio kkhu āraṇṇiāe piasahīe suṇṇa hiaāe aṇṇahā evva 
SA_GK20_hpriydpu-560	ajja uṇa Vāsavadattābhūmiāe tāe jai taha karīadi tado avassaṃ devī kuppadi /	ajja uṇa vāsavadattā bhūmiāe tāe jai taha karīadi tado avassam devī 
SA_GK20_hpriydpu-561	tā kahiṃ dāva tāṃ pekkhia uvālambhissaṃ /	tā kahim dāva tām pekkhia uvālambhissam 
SA_GK20_hpriydpu-562	(vilokya /	vilokya 
SA_GK20_hpriydpu-563	)esā Āraṇṇiā appaṇā evva kiṃ vi kiṃ vi mantaantī digghiātīle kadalīgharaaṃ pavisadi /	esā āraṇṇiā appaṇā evva kim vi kim vi mantaantī kadalī gharaam pavisadi 
SA_GK20_hpriydpu-564	tā gummantariā bhavia suṇissaṃ dāva se vīsaddhajappidāṇiṃ /	tā gummantariā bhavia suṇissam dāva se vīsaddha jappi dāṇim 
SA_GK20_hpriydpu-565	[ājñaptāsmi devyā Vāsavadattayā hañje Manorame yaḥ sa Sāṅkṛtyāyany āryaputrasya mama	ājñaptā asmi devyā vāsavadattayā hañje manorame yaḥ sa sāṅkṛtyāyani ārya putrasya mama 
SA_GK20_hpriydpu-566	ca vṛttānto nāṭakopanibaddhas tasya nartitavyaśeṣam adya yuṣmābhiḥ kaumudīmahotsave nartitavyam iti /	ca vṛttāntaḥ nāṭaka upanibaddhaḥ tasya nartitavya śeṣam adya yuṣmābhiḥ kaumudīmahotsave nartitavyam iti 
SA_GK20_hpriydpu-567	hyaḥ khalv Āraṇyikayā priyasakhyā śūnyahṛdayayānyathaiva nartitam /	hyas khalu āraṇyikayā priya sakhyā śūnya hṛdayayā anyathā eva nartitam 
SA_GK20_hpriydpu-568	adya punar Vāsavadattābhūmikayā tayā yadi tathā kriyate tato 'vaśyaṃ devī kupyati /	adya punar vāsavadattā bhūmikayā tayā yadi tathā kriyate tatas vaśyam devī kupyati 
SA_GK20_hpriydpu-569	tat kutra tāvat tāṃ prekṣyopālapsye /	tat kutra tāvat tām prekṣya upālapsye 
SA_GK20_hpriydpu-570	(vilokya /	vilokya 
SA_GK20_hpriydpu-571	) eṣāraṇyikātmanaiva kim api kim api mantrayamāṇā dīrghikātīre kadalīgṛhaṃ praviśati /	eṣā āraṇyikā ātmanā eva kim api kim api mantrayamāṇā dīrghikā tīre kadalīgṛham praviśati 
SA_GK20_hpriydpu-572	tad gulmāntaritā bhūtvā śroṣyāmi tāvad asyā viśrabdhajalpitāni /]	tat gulma antaritā bhūtvā śroṣyāmi tāvat asyāḥ viśrabdha jalpitāni 
SA_GK20_hpriydpu-573	(tataḥ praviśaty āsanasthā kāmāvasthāṃ nāṭayanty Āraṇyikā /)	tatas praviśati āsana sthā kāma avasthām nāṭayantī āraṇyikā 
SA_GK20_hpriydpu-574	Āraṇyikā - (niḥśvasya /	āraṇyikā niḥśvasya 
SA_GK20_hpriydpu-575	) hiaa dullahajaṇaṃ patthaanto tumaṃ kīsa maṃ dukkhidaṃ karesi /	hiaa dullaha jaṇam patthaantaḥ tumam kīsa mama dukkhidam karesi 
SA_GK20_hpriydpu-576	[hṛdaya durlabhajanaṃ prārthayamānaṃ tvaṃ kasmān māṃ duḥkhitāṃ karoṣi /]	hṛdaya durlabha janam prārthayamānam tvam kasmāt mām duḥkhitām karoṣi 
SA_GK20_hpriydpu-577	Manoramā - taṃ edaṃ edassa suṇṇahiaattaṇassa kāraṇaṃ /	manoramā tat edam edassa suṇṇa hiaa ttaṇassa kāraṇam 
SA_GK20_hpriydpu-578	kiṃ uṇa esā patthedi /	kim uṇa esā patthedi 
SA_GK20_hpriydpu-579	avahidā dāva suṇissaṃ /	avahidā dāva suṇissam 
SA_GK20_hpriydpu-580	[tad etad asyāḥ śūnyahṛdayatvasya kāraṇam /	tat etat asyāḥ śūnya hṛdaya tvasya kāraṇam 
SA_GK20_hpriydpu-581	kiṃ punar eṣā prārthayate /	kim punar eṣā prārthayate 
SA_GK20_hpriydpu-582	avahitā tāvac chroṣyāmi /]	avahitā tāvat śroṣyāmi 
SA_GK20_hpriydpu-583	Āraṇyikā - (sāsram /	āraṇyikā sa asram 
SA_GK20_hpriydpu-584	) kahaṃ taha ṇāma sommadaṃsaṇo bhavia mahārāo evvaṃ saṃdāvedi maṃ /	kaham taha ṇāma sommadaṃsaṇaḥ bhavia mahārāo evvam saṃdāvedi mama 
SA_GK20_hpriydpu-585	acchariaṃ acchariam /	acchariam acchariam 
SA_GK20_hpriydpu-586	ahavā maha evva esā abhāaheadā /	ahavā mahaḥ evva esā abhāa headā 
SA_GK20_hpriydpu-587	ṇa uṇa mahārāassa doso /	ṇa uṇa mahā rāassa dosaḥ 
SA_GK20_hpriydpu-588	[kathaṃ tathā nāma saumyadarśano bhūtvā mahārāja evaṃ saṃtāpayati mām /	katham tathā nāma saumya darśanaḥ bhūtvā mahā rājaḥ evam saṃtāpayati mām 
SA_GK20_hpriydpu-589	āścaryam āścaryam /	āścaryam āścaryam 
SA_GK20_hpriydpu-590	(niḥśvasya /	niḥśvasya 
SA_GK20_hpriydpu-591	) athavā mamaivaiṣā 'bhāgadheyatā /	athavā mama eva eṣā bhāgadheya tā 
SA_GK20_hpriydpu-592	na punar mahārājasya doṣaḥ /]	na punar mahā rājasya doṣaḥ 
SA_GK20_hpriydpu-593	Manoramā - (sabāṣpam /	manoramā sa bāṣpam 
SA_GK20_hpriydpu-594	) kaham mahārāo evva se patthaṇijjo /	kaham mahā rāo evva se patthaṇijjaḥ 
SA_GK20_hpriydpu-595	sāhu piasahī sāhu /	sāhu piasahī sāhu 
SA_GK20_hpriydpu-596	abhijāasariso de ahilāso /	de ahilāsaḥ 
SA_GK20_hpriydpu-597	[kathaṃ mahārāja evāsyāḥ prārthanīyaḥ /	katham mahā rājaḥ eva asyāḥ prārthanīyaḥ 
SA_GK20_hpriydpu-598	sādhu priyasakhi sādhu /	sādhu priya sakhi sādhu 
SA_GK20_hpriydpu-599	ābhijātyasadṛśas te 'bhilāṣaḥ /]	ābhijātya sadṛśaḥ te bhilāṣaḥ 
SA_GK20_hpriydpu-600	Āraṇyikā - kassa dāva edaṃ uttantaṃ ṇivedia sajjhaveaṇaṃ via dukkhaṃ kāraissaṃ /	āraṇyikā kassa dāva edam uttantam nivedia sajjhaveaṇam via dukkham kāraissam 
SA_GK20_hpriydpu-601	(vicintya /	vicintya 
SA_GK20_hpriydpu-602	) ahavā atthi me hiaaṇivvisesa piasahī Manoramā /	ahavā atthi me piasahī manoramā 
SA_GK20_hpriydpu-603	tāe vi edaṃ lajjāe ṇa pāremi kahiduṃ /	tāe vi ā idam lajjāe na pāremi kahidum 
SA_GK20_hpriydpu-604	savvahā maraṇaṃ vajjia kudo me hiaassa aṇṇa ṇivvudī /	savvahā maraṇam vajjia kudaḥ me hiaassa 
SA_GK20_hpriydpu-605	[kasmai tāvad etaṃ vṛttāntaṃ nivedya sahyavedanam iva duḥkhaṃ kariṣyāmi /	kasmai tāvat etam vṛttāntam nivedya sahya vedanam iva duḥkham kariṣyāmi 
SA_GK20_hpriydpu-606	(vicintya /	vicintya 
SA_GK20_hpriydpu-607	) athavā asti me hṛdayanirviśeṣā priyasakhī Manoramā /	athavā asti me hṛdaya nirviśeṣā priya sakhī manoramā 
SA_GK20_hpriydpu-608	tasyā apy etal lajjayā na pārayāmi kathayitum /	tasyāḥ api etat lajjayā na pārayāmi kathayitum 
SA_GK20_hpriydpu-609	sarvathā maraṇaṃ varjayitvā kuto me hṛdayasyānyā nirvṛtiḥ /]	sarvathā maraṇam varjayitvā kutas me hṛdayasya anyā nirvṛtiḥ 
SA_GK20_hpriydpu-610	[p. 25]	p 
SA_GK20_hpriydpu-611	Manoramā - (sāsram /	manoramā sa asram 
SA_GK20_hpriydpu-612	) haddhi haddhi /	haddhi haddhi 
SA_GK20_hpriydpu-613	adibhūmiṃ gado se tavassiṇīe aṇurāo /	adi bhūmim gadaḥ se tavassiṇīe aṇurāaḥ 
SA_GK20_hpriydpu-614	tā kiṃ dāṇiṃ ettha karissaṃ [hā dhik hā dhik /	tā kim dāṇim ettha karissam hā dhik hā dhik 
SA_GK20_hpriydpu-615	atibhūmiṃ gato 'syās tapasvinyā anurāgaḥ /	atibhūmim gataḥ syāḥ tapasvinyāḥ anurāgaḥ 
SA_GK20_hpriydpu-616	tat kim idānīm atra kariṣyāmi /]	tat kim idānīm atra kariṣyāmi 
SA_GK20_hpriydpu-617	Āraṇyikā - (sābhilāṣam /	āraṇyikā sa abhilāṣam 
SA_GK20_hpriydpu-618	) aaṃ so uddeso jassiṃ mahuarehiṃ āāsijjantī olambia mahārāeṇa samassāsida mhi bhīru mā bhaāhi tti /	aam saḥ uddesaḥ mahuarehiṃ olambia mahārāeṇa mhi bhīru mā bhaāhi tti 
SA_GK20_hpriydpu-619	[ayaṃ sa uddeśo yasmin madhukarair āyāsyamānāvalambya mahārājena samāśvāsitāsmi bhiru mā bibhīhīti /]	ayam saḥ uddeśaḥ yasmin madhukaraiḥ āyāsyamānā avalambya mahā rājena samāśvāsitā asmi bhiru mā bibhīhi iti 
SA_GK20_hpriydpu-620	Manoramā - (saharṣam /	manoramā sa harṣam 
SA_GK20_hpriydpu-621	) kahaṃ esā vi diṭṭhā mahārāeṇa /	kaham esā vi diṭṭhā mahārāeṇa 
SA_GK20_hpriydpu-622	savvahā atthi se jīvidassa uvāo /	savvahā atthi se jīvidassa uvāo 
SA_GK20_hpriydpu-623	jāva uvasappia samassāsemi ṇaṃ /	jāva uvasappia samassāsemi ṇam 
SA_GK20_hpriydpu-624	(sahasopasṛtya /	sahasā upasṛtya 
SA_GK20_hpriydpu-625	) juttaṃ ṇāma hiaassa vi lajjiduṃ /	juttam ṇāma hiaassa vi lajjidum 
SA_GK20_hpriydpu-626	[katham eṣāpi dṛṣṭā mahārājena /	katham eṣā api dṛṣṭā mahā rājena 
SA_GK20_hpriydpu-627	sarvathāsty asyā jīvitasyopāyaḥ /	sarvathā asti asyāḥ jīvitasya upāyaḥ 
SA_GK20_hpriydpu-628	yāvad upasṛtya samāśvāsayāmy enām /	yāvat upasṛtya samāśvāsayāmi enām 
SA_GK20_hpriydpu-629	(sahasopasṛtya /	sahasā upasṛtya 
SA_GK20_hpriydpu-630	) yuktaṃ nāma hṛdayasyāpi lajjitum /]	yuktam nāma hṛdayasya api lajjitum 
SA_GK20_hpriydpu-631	Āraṇyikā - (salajjam ātmagatam /	āraṇyikā sa lajjam ātma gatam 
SA_GK20_hpriydpu-632	) haddhi haddhi /	haddhi haddhi 
SA_GK20_hpriydpu-633	savvaṃ sudaṃ edāe /	savvam sudam ā idāe 
SA_GK20_hpriydpu-634	tā ettha juttaṃ evva paāsaiduṃ /	tāḥ ettha juttam evva 
SA_GK20_hpriydpu-635	(prakāśaṃ haste gṛhītvā /	prakāśam haste gṛhītvā 
SA_GK20_hpriydpu-636	) piasahi mā kuppa mā kuppa /	piasahi mā kuppa mā kuppa 
SA_GK20_hpriydpu-637	lajjā evva ettha avarajjhadi /	lajjā evva ettha 
SA_GK20_hpriydpu-638	[hā dhik hā dhik /	hā dhik hā dhik 
SA_GK20_hpriydpu-639	sarvaṃ śrutam etayā /	sarvam śrutam etayā 
SA_GK20_hpriydpu-640	tad atra yuktam eva prakāśayitum /	tat atra yuktam eva prakāśayitum 
SA_GK20_hpriydpu-641	(prakāśaṃ haste gṛhītvā /	prakāśam haste gṛhītvā 
SA_GK20_hpriydpu-642	) priyasakhi mā kupya mā kupya /	priya sakhi mā kupya mā kupya 
SA_GK20_hpriydpu-643	lajjaivātrāparādhyati /]	lajjā eva atra aparādhyati 
SA_GK20_hpriydpu-644	Manoramā - (saharṣam /	manoramā sa harṣam 
SA_GK20_hpriydpu-645	) sahi alaṃ saṃkāe /	sahi alam saṃkāe 
SA_GK20_hpriydpu-646	edaṃ me āakkha /	edam me āakkha 
SA_GK20_hpriydpu-647	saccaṃ evva tumaṃ mahārāeṇa diṭṭhā ṇa vetti /	saccam evva tumam mahārāeṇa diṭṭhā ṇa vetti 
SA_GK20_hpriydpu-648	[sakhi alaṃ śaṅkayā /	sakhi alam śaṅkayā 
SA_GK20_hpriydpu-649	etan ma ācakṣva /	etat me ācakṣva 
SA_GK20_hpriydpu-650	satyam eva tvaṃ mahārājena dṛṣṭā na veti /]	satyam eva tvam mahā rājena dṛṣṭā na vā iti 
SA_GK20_hpriydpu-651	Āraṇyikā - (salajjam adhomukhī /	āraṇyikā sa lajjam adhomukhī 
SA_GK20_hpriydpu-652	) sudaṃ evva piasahīe savvaṃ /	sudam evva piasahīe savvam 
SA_GK20_hpriydpu-653	[śrutam eva priyasakhyā sarvam /]	śrutam eva priya sakhyā sarvam 
SA_GK20_hpriydpu-654	Manoramā - jai diṭṭhā mahārāeṇa tumaṃ tā alaṃ saṃtappideṇa /	manoramā jai diṭṭhā mahārāeṇa tumam tā alam saṃtappideṇa 
SA_GK20_hpriydpu-655	so evva dāṇiṃ daṃsaṇovāapajjāulo bhavissadi /	saḥ evva dāṇim daṃsaṇa uvāa pajjāulaḥ bhavissadi 
SA_GK20_hpriydpu-656	[yadi dṛṣṭā mahārājena tvaṃ tad alaṃ saṃtāpitena /	yadi dṛṣṭā mahā rājena tvam tat alam saṃtāpitena 
SA_GK20_hpriydpu-657	sa evedānīṃ darśanopāyaparyākulo bhaviṣyati /]	saḥ eva idānīm darśana upāya paryākulaḥ bhaviṣyati 
SA_GK20_hpriydpu-658	[p. 26]	p 
SA_GK20_hpriydpu-659	Āraṇyikā - ahaṃ sahīaṇo pakkhavādeṇa mantedi /	āraṇyikā aham sa hīaṇaḥ pakkha vādeṇa mantedi 
SA_GK20_hpriydpu-660	ai sahipakkhavādiṇi /	ai sahi pakkha vādiṇi 
SA_GK20_hpriydpu-661	devīguṇaṇialaṇibaddhe kkhu tassiṃ jaṇe kudo edaṃ /	devī guṇa niala nibaddhe kkhu tassim jaṇe kudo edam 
SA_GK20_hpriydpu-662	[ayaṃ sakhījanaḥ pakṣapātena mantrayate /	ayam sakhī janaḥ pakṣapātena mantrayate 
SA_GK20_hpriydpu-663	ayi sakhipakṣapātini /	ayi sakhi pakṣapātini 
SA_GK20_hpriydpu-664	devīguṇanigaḍanibaddhe khalu tasmiñ jane kuta etat /]	devī guṇa nigaḍa nibaddhe khalu tasmin jane kutas etat 
SA_GK20_hpriydpu-665	Manoramā - (vihasya /	manoramā vihasya 
SA_GK20_hpriydpu-666	) halā apaṇḍide kamaliṇībaddhāṇurāo vi mahuaro māladīṃ pekkhia ahiṇavarasāssādalampaḍo kudo taṃ aṇāsādia ṭṭhidiṃ karedi /	halā a paṇḍide kamaliṇī baddha anurāaḥ vi mahuaraḥ māladīm pekkhia ahiṇava rasa āssāda lampaḍaḥ kudo tam an āsādia ṭṭhidim karedi 
SA_GK20_hpriydpu-667	[halā apaṇḍite kamalinībaddhānurāgo 'pi madhukaro mālatīṃ prekṣyābhinavarasāsvādalampaṭaḥ kutas tām anāsādya sthitiṃ karoti /]	halā apaṇḍite kamalinī baddha anurāgaḥ pi madhukaraḥ mālatīm prekṣya abhinava rasa āsvāda lampaṭaḥ kutas tām an āsādya sthitim karoti 
SA_GK20_hpriydpu-668	Āraṇyikā - kiṃ ediṇa asaṃbhāvideṇa /	āraṇyikā 
SA_GK20_hpriydpu-669	tā ehi /	tāḥ ehi 
SA_GK20_hpriydpu-670	ahiaṃ kkhu saradādaveṇa saṃtappāiṃ ajja vi ṇa me aṅgāiṃ saṃdāvaṃ muñcandi /	ahiam kkhu saradādaveṇa saṃtappāim ajja vi na me aṅgāim saṃdāvam 
SA_GK20_hpriydpu-671	[kim etenāsaṃbhāvitena /	kim etena a saṃbhāvitena 
SA_GK20_hpriydpu-672	tad ehi /	tat ehi 
SA_GK20_hpriydpu-673	adhikaṃ khalu śaradātapena saṃtaptāny adyāpi na me 'ṅgāni saṃtāpaṃ muñcanti /]	adhikam khalu śaradā ātapena saṃtaptāni adya api na me ṅgāni saṃtāpam muñcanti 
SA_GK20_hpriydpu-674	Manoramā - ai lajjālue ṇa juttam edāvatthaṃ gadāe vi de appā pacchādiduṃ /	manoramā lajjālue ṇa juttam edāvattham gadāe vi de 
SA_GK20_hpriydpu-675	[ayi lajjāluke na yuktam etad avasthāṃ gatayāpi ta ātmā pracchādayitum /]	ayi lajjāluke na yuktam etat avasthām gatayā api te ātmā pracchādayitum 
SA_GK20_hpriydpu-676	(Āraṇyikā mukham avanamayati /)	āraṇyikā mukham avanamayati 
SA_GK20_hpriydpu-677	Manoramā - ai avisambhasīle kiṃ dāṇiṃ pacchādesi /	manoramā ai avisambha sīle kim dāṇim pacchādesi 
SA_GK20_hpriydpu-678	ṇīsāsaṇihaviṇiggao diahaṃ ratiṃ vi tujjha aṇurāo aviradapaḍantakusumasarasaraṇivahapauttahuṃkārasaddo via ṇa bhaṇai /	ratim vi tujjha aṇurāaḥ a virada paḍanta kusuma sara saraṇi vaha pautta huṃkāra saddaḥ via ṇa bhaṇai 
SA_GK20_hpriydpu-679	(ātmagatam /	ātma gatam 
SA_GK20_hpriydpu-680	)ahavā ṇa hu aaṃ kālo uvālambhassa /	ahavā ṇa hu aam kālaḥ uvālambhassa 
SA_GK20_hpriydpu-681	tā jāva ṇaliṇīpattāiṃ se hiae dāissaṃ /	tā jāva ṇaliṇī pattāim se hiae dāissam 
SA_GK20_hpriydpu-682	(utthāya [p. 27] dīrghikāya nalinīpattrāṇi gṛhītvāraṇyikāyā hṛdaye dadatī /	utthāya p dīrghikāya nalinī pattrāṇi gṛhītvā araṇyikāyāḥ hṛdaye dadatī 
SA_GK20_hpriydpu-683	)samassasadu sahī samassasadu sahī /	samassasadu sahī samassasadu sahī 
SA_GK20_hpriydpu-684	[ayi aviśrambhaśīle kim idānīṃ pracchādayasi /	ayi a viśrambha śīle kim idānīm pracchādayasi 
SA_GK20_hpriydpu-685	niśvāsānibhavinirgato divasaṃ rātrim api tavānurāgo 'viratapatatkusumaśaraśaranivahapravṛttahuṅkāraśabda iva na bhaṇati /	niśvāsa anibha vinirgataḥ divasam rātrim api tava anurāgaḥ virata patat kusuma śara śara nivaha pravṛtta huṅkāra śabdaḥ iva na bhaṇati 
SA_GK20_hpriydpu-686	(ātmagatam /	ātma gatam 
SA_GK20_hpriydpu-687	) athavā na khalv ayaṃ kāla upālambhasya /	athavā na khalu ayam kālaḥ upālambhasya 
SA_GK20_hpriydpu-688	tad yāvan nalinīpatrāṇy asyā hṛdaye dāsyāmi /	tat yāvat nalinī patrāṇi asyāḥ hṛdaye dāsyāmi 
SA_GK20_hpriydpu-689	(utthāya dīrghikāya nalinīpattrāṇi gṛhītvāraṇyikāyā hṛdaye dadatī /	utthāya dīrghikāya nalinī pattrāṇi gṛhītvā araṇyikāyāḥ hṛdaye dadatī 
SA_GK20_hpriydpu-690	) samāśvasitu sakhī samāśvasitu sakhī /]	samāśvasitu sakhī samāśvasitu sakhī 
SA_GK20_hpriydpu-691	(tataḥ praviśati vidūṣakaḥ)	tatas praviśati vidūṣakaḥ 
SA_GK20_hpriydpu-692	vidūṣakaḥ - adimahaṇto kkhu piavaassassa Āraṇṇiāe uvari aṇurāo /	vidūṣakaḥ kkhu pia vaassassa āraṇṇiāe uvari anurāaḥ 
SA_GK20_hpriydpu-693	jeṇa pariccattarāakajjo tāe evva daṃsaṇovāaṃ cintaanto appāṇaṃ viṇodei /	jeṇa pariccatta rāa kajjaḥ tāe evva daṃsaṇa uvāam cintaantaḥ appāṇam viṇodei 
SA_GK20_hpriydpu-694	(vicintya) kahiṃ dāṇiṃ taṃ pekkhe /	vicintya kahim dāṇim tam pekkhe 
SA_GK20_hpriydpu-695	ahavā tahiṃ evva dāva digghiāe aṇṇesāmi /	ahavā tahim evva dāva digghiāe 
SA_GK20_hpriydpu-696	[atimahān khalu priyavayasyasyāraṇiyakāyā upary anurāgaḥ /	ati mahān khalu priya vayasyasya araṇiyakāyāḥ upari anurāgaḥ 
SA_GK20_hpriydpu-697	yena parityaktarājakāryas tasyā eva darśanopāyaṃ cintayann ātmānaṃ vinodayati /	yena parityakta rāja kāryaḥ tasyāḥ eva darśana upāyam cintayan ātmānam vinodayati 
SA_GK20_hpriydpu-698	(vicintya /	vicintya 
SA_GK20_hpriydpu-699	) kutredānīṃ tāṃ prekṣe /	kutra idānīm tām prekṣe 
SA_GK20_hpriydpu-700	athavā tatraiva tāvad dīrghikāyām anviṣyāmi /	athavā tatra eva tāvat dīrghikāyām anviṣyāmi 
SA_GK20_hpriydpu-701	(parikrāmati /)]	parikrāmati 
SA_GK20_hpriydpu-702	Manoramā - (ākarṇya /	manoramā ākarṇya 
SA_GK20_hpriydpu-703	) padasaddo via suṇīadi /	pada saddaḥ via 
SA_GK20_hpriydpu-704	tā kadalīgummantaridā bhavia pekkhamha dāva ko eso tti /	tā kadalīgummantaridā bhavia pekkhamha dāva kaḥ esaḥ tti 
SA_GK20_hpriydpu-705	[padaśabda iva śrūyate /	pada śabdaḥ iva śrūyate 
SA_GK20_hpriydpu-706	tat kadalīgulmāntarite bhūtvā prekṣāvahe tāvat ka eṣa iti /]	tat kadalī gulma antarite bhūtvā prekṣāvahe tāvat kaḥ eṣaḥ iti 
SA_GK20_hpriydpu-707	(ubhe tathā kṛtvā paśyataḥ /)	ubhe tathā kṛtvā paśyataḥ 
SA_GK20_hpriydpu-708	Āraṇyikā - kahaṃ so evva mahārāassa pasaparivaṭṭa (sic) bamhaṇo /	āraṇyikā kaham saḥ evva mahārāassa 
SA_GK20_hpriydpu-709	[kathaṃ sa eva mahārājasya pārśvaparivartī brāhmaṇaḥ /]	katham saḥ eva mahā rājasya pārśvaparivartī brāhmaṇaḥ 
SA_GK20_hpriydpu-710	Manoramā - kahaṃ Vasantao evva /	manoramā kaham vasantao evva 
SA_GK20_hpriydpu-711	avi ṇāma taha have /	avi ṇāma have 
SA_GK20_hpriydpu-712	[kathaṃ Vasantaka eva /	katham vasantakaḥ eva 
SA_GK20_hpriydpu-713	(saharṣam ātmagatam /	sa harṣam ātma gatam 
SA_GK20_hpriydpu-714	) api nāma tathā bhavet /]	api nāma tathā bhavet 
SA_GK20_hpriydpu-715	vidūṣakaḥ - (diśo 'valokya /	vidūṣakaḥ diśaḥ valokya 
SA_GK20_hpriydpu-716	) kiṃ dāṇiṃ Āraṇṇiā saccaṃ evva saṃvuttā /	kim dāṇim āraṇṇiā saccam evva saṃvuttā 
SA_GK20_hpriydpu-717	[kim idānīm Āraṇyikā satyam eva saṃvṛttā /]	kim idānīm āraṇyikā satyam eva saṃvṛttā 
SA_GK20_hpriydpu-718	Manoramā - (sasmitam /	manoramā sa smitam 
SA_GK20_hpriydpu-719	) sahi rāavaasso kkhu bamhaṇo tumaṃ uddissia mantedi /	sahi rāa vaassaḥ kkhu bamhaṇaḥ tumam uddissia mantedi 
SA_GK20_hpriydpu-720	tā dāva avahidā suṇamha /	tā dāva avahidā suṇamha 
SA_GK20_hpriydpu-721	[sakhi rājavayasyaḥ khalu brāhmaṇas tvām uddiśya mantrayate /	sakhi rāja vayasyaḥ khalu brāhmaṇaḥ tvām uddiśya mantrayate 
SA_GK20_hpriydpu-722	tat tāvad avahite śṛṇuvaḥ /]	tat tāvat avahite śṛṇuvaḥ 
SA_GK20_hpriydpu-723	(Āraṇyikā saspṛhaṃ salajjaṃ ca śṛṇoti /)	āraṇyikā sa spṛham sa lajjam ca śṛṇoti 
SA_GK20_hpriydpu-724	vidūṣakaḥ - (sodvegam /	vidūṣakaḥ sa udvegam 
SA_GK20_hpriydpu-725	) [p. 28] jadā dāva mae garumaaṇasaṃdāvaṇīsahasarīrassa piavaassassa vaaṇeṇa devīṇaṃ	jadā dāva mae garu maaṇa saṃdāvaṇī saha sarīrassa pia vaassassa vaaṇeṇa devīṇam 
SA_GK20_hpriydpu-726	VāsavadattāPadumāvadīṇaṃ aṇṇaṇam a devīṇaṃ bhavaṇāiṃ aṇṇesanteṇa ṇa sā diṭṭhā tadā	a devīṇam bhavaṇāīm an na sā diṭṭhā tadā 
SA_GK20_hpriydpu-727	jahiṃ digghiāe diṭṭhā idaṃ vi dāva pekkhissaṃ ti āado mhi /	digghiāe diṭṭhā idam vi dāva pekkhissam ti mhi 
SA_GK20_hpriydpu-728	tā jāva iha vi ṇatthi /	tā jāva iha vi ṇatthi 
SA_GK20_hpriydpu-729	kiṃ dāṇiṃ karissaṃ /	kim dāṇim karissam 
SA_GK20_hpriydpu-730	[yadā tāvan mayā gurumadanasaṃtāpaniḥsahaśarīrasya priyavayasyasya vacanena devyor	yadā tāvat mayā guru madana saṃtāpa niḥsaha śarīrasya priya vayasyasya vacanena devyoḥ 
SA_GK20_hpriydpu-731	VāsavadattāPadmāvatyor anyāsāṃ ca devīnāṃ bhavanāny anviṣyatā na sā dṛṣṭā tadā yatra	vāsavadattā padmāvatyoḥ anyāsām ca devīnām bhavanāni anviṣyatā na sā dṛṣṭā tadā yatra 
SA_GK20_hpriydpu-732	dīrghikāyāṃ dṛṣṭedam api tāvat prekṣiṣya ity āgato 'smi /	dīrghikāyām dṛṣṭā idam api tāvat prekṣiṣye iti āgataḥ smi 
SA_GK20_hpriydpu-733	tad yāvad ihāpi nāsti /	tat yāvat iha api na asti 
SA_GK20_hpriydpu-734	kim idānīṃ kariṣye /]	kim idānīm kariṣye 
SA_GK20_hpriydpu-735	Manoramā -sudaṃ piasahīe /	manoramā su dam piasahīe 
SA_GK20_hpriydpu-736	[śrutaṃ priyasakhyā /]	śrutam priya sakhyā 
SA_GK20_hpriydpu-737	vidūṣakaḥ - (vicintya /	vidūṣakaḥ vicintya 
SA_GK20_hpriydpu-738	) ahavā bhaṇido evva ahaṃ vaasseṇa /	ahavā bhaṇidaḥ evva aham vaasseṇa 
SA_GK20_hpriydpu-739	jai taṃ aṇṇesanto ṇa pekkhasi tā tado vi dāva digghiādo tāe karaalapparisadiuṇiasuhassīalāiṃ ṇaliṇīpattāiṃ geṇhia āaccha tti /	jai tam anṇa īsantaḥ na pekkhasi tā tadaḥ vi dāva tāe naliṇī pattāim geṇhia āaccha tti 
SA_GK20_hpriydpu-740	tā kahaṃ edāiṃ jāṇidavvāiṃ /	tā kaham edāim jāṇidavvāim 
SA_GK20_hpriydpu-741	[athavā bhaṇita evāhaṃ vayasyena /	athavā bhaṇitaḥ eva aham vayasyena 
SA_GK20_hpriydpu-742	yadi tām anviṣyan na prekṣase tat tato 'pi tāvad dīrghikātas tasyāḥ karatalasparśadviguṇitasukhaśītalāni nalinīpatrāṇi gṛhītvāgaccheti /	yadi tām anviṣyan na prekṣase tat tatas tāvat dīrghikātaḥ tasyāḥ kara tala sparśa dvi guṇita sukha śītalāni nalinī patrāṇi gṛhītvā āgaccha iti 
SA_GK20_hpriydpu-743	tat katham etāni jñātavyāni /]	tat katham etāni jñātavyāni 
SA_GK20_hpriydpu-744	Manoramā - aaṃ me avasaro /	manoramā 
SA_GK20_hpriydpu-745	Vasantaa ehi /	vasantaa ehi 
SA_GK20_hpriydpu-746	ahaṃ de jāṇāvemi /	aham de jāṇāvemi 
SA_GK20_hpriydpu-747	[ayaṃ mamāvasaraḥ /	ayam mama avasaraḥ 
SA_GK20_hpriydpu-748	(upasṛtya vidūṣakaṃ haste gṛhītvā /	upasṛtya vidūṣakam haste gṛhītvā 
SA_GK20_hpriydpu-749	) Vasantaka ehi /	vasantaka ehi 
SA_GK20_hpriydpu-750	ahaṃ te jñāpayāmi /]	aham te jñāpayāmi 
SA_GK20_hpriydpu-751	vidūṣakaḥ - (sabhayam /	vidūṣakaḥ sa bhayam 
SA_GK20_hpriydpu-752	) kassa tumaṃ jāṇāvesi /	kassa tumam jāṇāvesi 
SA_GK20_hpriydpu-753	kiṃ devīe /	kim devīe 
SA_GK20_hpriydpu-754	ṇa hu mae kiṃ vi mantidaṃ /	ṇa hu mae kim vi 
SA_GK20_hpriydpu-755	[kasya tvaṃ jñāpayāsi /	kasya tvam jñāpayāsi 
SA_GK20_hpriydpu-756	kiṃ devyāḥ /	kim devyāḥ 
SA_GK20_hpriydpu-757	na khalu mayā kim api mantritam /]	na khalu mayā kim api mantritam 
SA_GK20_hpriydpu-758	Manoramā - Vasantaa alaṃ saṃkāe /	manoramā 
SA_GK20_hpriydpu-759	jādisī Āraṇṇiāe kide attaṇo piavaassassa avatthā tue vaṇṇidā tado diuṇadarā bhaṭṭiṇo vi kide mama piasahīe avatthā /	jādisī āraṇṇiāe kide attaṇaḥ pia vaassassa avatthā tue vaṇṇidā tado diuṇadarā bhaṭṭiṇaḥ vi kide mama pia sahīe avatthā 
SA_GK20_hpriydpu-760	tā pekkha pekkha /	tā pekkha pekkha 
SA_GK20_hpriydpu-761	(upasṛtya Āraṇyikāṃ darśayati /	upasṛtya āraṇyikām darśayati 
SA_GK20_hpriydpu-762	) [Vasantaka alaṃ śaṅkayā /	vasantaka alam śaṅkayā 
SA_GK20_hpriydpu-763	yādṛśy Āranyikāyāḥ kṛta ātmanaḥ priyavayasyasyāvasthā tvayā varṇitā tato dviguṇatarā bhartur api kṛte mama priyasakhyā avasthā /	yādṛśī āranyikāyāḥ kṛte ātmanaḥ priya vayasyasya avasthā tvayā varṇitā tatas dviguṇatarā bhartuḥ api kṛte mama priya sakhyāḥ avasthā 
SA_GK20_hpriydpu-764	tat paśya paśya /	tat paśya paśya 
SA_GK20_hpriydpu-765	(upasṛtya Āraṇyikāṃ darśayati /)]	upasṛtya āraṇyikām darśayati 
SA_GK20_hpriydpu-766	[p. 29]	p 
SA_GK20_hpriydpu-767	vidūṣakaḥ - (dṛṣṭvā saharṣam /	vidūṣakaḥ dṛṣṭvā sa harṣam 
SA_GK20_hpriydpu-768	) saphalo me parissamo /	saphalaḥ me parissamaḥ 
SA_GK20_hpriydpu-769	sotthi hodīe /	sotthi hodīe 
SA_GK20_hpriydpu-770	[saphalo me pariśramaḥ /	saphalaḥ me pariśramaḥ 
SA_GK20_hpriydpu-771	svasti bhavatyai /]	svasti bhavatyai 
SA_GK20_hpriydpu-772	(Āraṇyikā salajjaṃ kamalinīpattrāṇy apanīyottiṣṭhati /)	āraṇyikā sa lajjam kamalinī pattrāṇi apanīya uttiṣṭhati 
SA_GK20_hpriydpu-773	Manoramā - ajja Vasantaa tuha daṃsaṇena evva avagado piasahīe saṃdāvo jeṇa saaṃ evva ṇaliṇīpattāiṃ avaṇei /	manoramā ajja vasantaa tuha daṃsaṇena evva avagadaḥ piasahīe saṃdāvaḥ jeṇa saam evva ṇaliṇī pattāim avaṇei 
SA_GK20_hpriydpu-774	tā aṇugaṇhādu ajjo imāiṃ /	tāḥ aṇugaṇhādu ajjaḥ imāim 
SA_GK20_hpriydpu-775	[ārya Vasantaka /	ārya vasantaka 
SA_GK20_hpriydpu-776	tava darśanenaivāpagataḥ priyasakhyāḥ saṃtāpo yena svayam eva nalinīpatrāṇy apanayati /	tava darśanena evā apagataḥ priya sakhyāḥ saṃtāpaḥ yena svayam eva nalinī patrāṇi apanayati 
SA_GK20_hpriydpu-777	tad anugṛhṇātv ārya imāni /]	tat anugṛhṇātu āryaḥ imāni 
SA_GK20_hpriydpu-778	Āraṇyikā - (sāvegam /	āraṇyikā sa āvegam 
SA_GK20_hpriydpu-779	) ai parihāsasīle /	ai parihāsa sīle 
SA_GK20_hpriydpu-780	kīsa maṃ lajjāvesi /	kīsa mama 
SA_GK20_hpriydpu-781	(kiṃcit parāṅmukhītiṣṭhati /	kiṃcid 
SA_GK20_hpriydpu-782	) [ayi parihāsaśīle /	ayi parihāsa śīle 
SA_GK20_hpriydpu-783	kasmān māṃ lajjayasi /	kasmāt mām lajjayasi 
SA_GK20_hpriydpu-784	(kiṃcit parāṅmukhī tiṣṭhati /)]	kiṃcid parāṅmukhī tiṣṭhati 
SA_GK20_hpriydpu-785	vidūṣakaḥ - (saviṣādam /	vidūṣakaḥ sa viṣādam 
SA_GK20_hpriydpu-786	) ciṭṭhaṃdu dāva ṇaliṇīpattāiṃ /	ciṭṭhaṃdu dāva naliṇī pattāim 
SA_GK20_hpriydpu-787	adilajjāluā de piasahī /	de piasahī 
SA_GK20_hpriydpu-788	tā kahaṃ edāṇaṃ samāamo bhavissadi /	tā kaham edāṇam samāamaḥ bhavissadi 
SA_GK20_hpriydpu-789	[tiṣṭhantu tāvan nalinīpattrāṇi /	tiṣṭhantu tāvat nalinī pattrāṇi 
SA_GK20_hpriydpu-790	ati(lajjālukā te priyasakhī /	ati lajjālukā te priya sakhī 
SA_GK20_hpriydpu-791	tat katham etayoḥ samāgamo bhaviṣyati /]	tat katham etayoḥ samāgamaḥ bhaviṣyati 
SA_GK20_hpriydpu-792	Manoramā - (kṣaṇaṃ vicintya saharṣam /	manoramā kṣaṇam vicintya sa harṣam 
SA_GK20_hpriydpu-793	) Vasantaa evvaṃ via /	vasantaa evvam via 
SA_GK20_hpriydpu-794	(karṇe kathayati /	karṇe kathayati 
SA_GK20_hpriydpu-795	) [Vasantaka evam iva /]	vasantakaḥ evam iva 
SA_GK20_hpriydpu-796	vidūṣakaḥ - sāhu piasahi sāhu /	vidūṣakaḥ sāhu piasahi sāhu 
SA_GK20_hpriydpu-797	(apavārya /	apavārya 
SA_GK20_hpriydpu-798	) jāva evva tumhe ṇevacchaggahaṇaṃ karettha dāva evva ahaṃ vi vaassaṃ geṇhia āacchāmi /	jāva evva tumhe ṇevaccha gahaṇam karettha dāva evva aham vi vaassam geṇhia āacchāmi 
SA_GK20_hpriydpu-799	[sādhu priyasakhi sādhu /	sādhu priya sakhi sādhu 
SA_GK20_hpriydpu-800	(apavārya /	apavārya 
SA_GK20_hpriydpu-801	) yāvad eva yuvāṃ nepathyagrahaṇaṃ kuruthas tāvad evāham api vayasyaṃ gṛhītvāgacchāmi /]	yāvat eva yuvām nepathya grahaṇam kuruthaḥ tāvat eva aham api vayasyam gṛhītvā āgacchāmi 
SA_GK20_hpriydpu-802	(iti niṣkrāntaḥ /)	iti niṣkrāntaḥ 
SA_GK20_hpriydpu-803	Manoramā - adikovaṇe /	manoramā adi kovaṇe 
SA_GK20_hpriydpu-804	uṭṭhehi uṭṭhehi /	uṭṭhehi uṭṭhehi 
SA_GK20_hpriydpu-805	ṇaccidavvaṃ amhehiṃ tassa evva ṇāḍaassa ṇaccidasesaṃ /	amhehim tassa evva ṇāḍaassa 
SA_GK20_hpriydpu-806	tā ehi /	tāḥ ehi 
SA_GK20_hpriydpu-807	pekkhāgharaṃ evva gacchamha /	pekkhāgharam evva gacchamha 
SA_GK20_hpriydpu-808	(parikramyāvalokya /	parikramya avalokya 
SA_GK20_hpriydpu-809	) idaṃ pekkhāgāraṃ /	idam pekkhāgāram 
SA_GK20_hpriydpu-810	jāva ehi pavisamha /	jāva ehi pavisamha 
SA_GK20_hpriydpu-811	sāhu sāhu /	sāhu sāhu 
SA_GK20_hpriydpu-812	savvaṃ sajjīkidaṃ /	savvam sajjīkidam 
SA_GK20_hpriydpu-813	devīe āantavvaṃ /	devīe 
SA_GK20_hpriydpu-814	[atikopane uttiṣṭhottiṣṭha /	atikopane uttiṣṭha uttiṣṭha 
SA_GK20_hpriydpu-815	nartitavyam asmābhis tasyaiva naṭakasya nartitaśeṣam /	nartitavyam asmābhiḥ tasya eva naṭakasya nartita śeṣam 
SA_GK20_hpriydpu-816	tad ehi /	tat ehi 
SA_GK20_hpriydpu-817	prekṣāgṛham eva gacchāvaḥ /	prekṣāgṛham eva gacchāvaḥ 
SA_GK20_hpriydpu-818	(parikramyāvalokya /	parikramya avalokya 
SA_GK20_hpriydpu-819	) idaṃ prekṣāgāram /	idam prekṣāgāram 
SA_GK20_hpriydpu-820	yāvad ehi praviśāvaḥ /	yāvat ehi praviśāvaḥ 
SA_GK20_hpriydpu-821	(praviṣṭakenāvalokya /	praviṣṭakena avalokya 
SA_GK20_hpriydpu-822	) sādhu sādhu sarvaṃ sajjīkṛtam /	sādhu sādhu sarvam sajjīkṛtam 
SA_GK20_hpriydpu-823	devyāgantavyam /	devyā āgantavyam 
SA_GK20_hpriydpu-824	(tataḥ praviśati devī Sāṅkṛtyāyanī vibhavataś ca parivāraḥ /)	tatas praviśati devī sāṅkṛtyāyanī vibhavataḥ ca parivāraḥ 
SA_GK20_hpriydpu-825	[p. 30]	p 
SA_GK20_hpriydpu-826	Vāsavadattā - bhavaadi aho de kavittaṇaṃ /	vāsavadattā bhavaadi aho de kavi ttaṇam 
SA_GK20_hpriydpu-827	jeṇa edaṃ gūḍhauttantaṃ ṇāḍaovaṇibaddhaṃ sāṇubhavaṃ vi amhāṇaṃ ajjauttacaridaṃ adiṭṭhapuvvaṃ via disantaṃ ahiaaraṃ kodūhalaṃ vaḍḍhaadi /	jeṇa edam gūḍha ottantam nāḍa uvaṇibaddham sa anubhavam vi amhāṇam ajjautta caridam a diṭṭha puvvam via disantam ahiaaram kodūhalam 
SA_GK20_hpriydpu-828	[bhagavati aho te kavitvam /	bhagavati aho te kavi tvam 
SA_GK20_hpriydpu-829	yenaitad gūḍhavṛttāntaṃ nāṭakopanibaddhaṃ sānubhavam apy asmākam āryaputracaritam adṛṣṭapūrvam iva dṛśyamānam adhikataraṃ kautūhalaṃ vardhayati	yena etat gūḍha vṛttāntam nāṭaka upanibaddham sa anubhavam api asmākam āryaputra caritam a dṛṣṭa pūrvam iva dṛśyamānam adhikataram kautūhalam vardhayati 
SA_GK20_hpriydpu-830	Sāṅkṛtyāyanī - āyuṣmati āśrayaguṇa evāyam īdṛśo yad asāram api kāvyam avaśyam eva śṛṇvatāṃ śravaṇasukham utpādayati / paśya /	sāṅkṛtyāyanī āyuṣmati āśraya guṇaḥ eva ayam īdṛśaḥ yat asāram api kāvyam avaśyam eva śṛṇvatām śravaṇa sukham utpādayati paśya 
SA_GK20_hpriydpu-831	prāyo yat kiṃ cid api prāpnoty utkarṣam āśrayān mahataḥ /	prāyas yat kim cit api prāpnoti utkarṣam āśrayāt mahataḥ 
SA_GK20_hpriydpu-832	mattebhakumbhataṭagatam eti hi śṛṅgāratām bhasma // HPri_3.1 //	matta ibha kumbha taṭa gatam eti hi śṛṅgāra tām bhasma 
SA_GK20_hpriydpu-833	Vāsavadattā -(sasmitam)	vāsavadattā sa smitam 
SA_GK20_hpriydpu-834	bhaavadi savvassa vallaho jāmādo hodi tti jāṇiadi evva edaṃ /	bhaavadi savvassa vallahaḥ jāmādaḥ hodi tti jāṇiadi evva edam 
SA_GK20_hpriydpu-835	tā kiṃ ediṇā kahāṇubandheṇa /	tā kim ediṇā kahā aṇubandheṇa 
SA_GK20_hpriydpu-836	varaṃ taṃ evva ṇaccidavvaṃ daṭṭhuṃ /	varam tam evva daṭṭhum 
SA_GK20_hpriydpu-837	[bhagavati sarvasya vallabho jāmātā bhaktīti jñāyata evaitat /	bhagavati sarvasya vallabhaḥ jāmātā bhaktī iti jñāyate eva etat 
SA_GK20_hpriydpu-838	tat kim etena kathānubandhena /	tat kim etena kathā anubandhena 
SA_GK20_hpriydpu-839	varaṃ tad eva nartitavyaṃ draṣṭum /]	varam tat eva nartitavyam draṣṭum 
SA_GK20_hpriydpu-840	Sāṅkṛtyāyanī - evam /	sāṅkṛtyāyanī evam 
SA_GK20_hpriydpu-841	Indīvarike prekṣāgṛham ādeśaya /	indīvarike prekṣāgṛham ādeśaya 
SA_GK20_hpriydpu-842	ceṭī - edu edu bhaṭṭiṇī /	ceṭī edu edu bhaṭṭiṇī 
SA_GK20_hpriydpu-843	[etu etu bhaṭṭinī /]	etu etu bhaṭṭinī 
SA_GK20_hpriydpu-844	(sarvāḥ parikrāmanti /)	sarvāḥ parikrāmanti 
SA_GK20_hpriydpu-845	Sāṅkṛtyāyanī - (vilokya /	sāṅkṛtyāyanī vilokya 
SA_GK20_hpriydpu-846	) aho prekṣaṇīyatā prekṣāgṛhasya /	aho prekṣaṇīya tā prekṣāgṛhasya 
SA_GK20_hpriydpu-847	ābhāti ratnaśataśobhitaśātakumbha-	ābhāti ratna śata śobhita śātakumbha 
SA_GK20_hpriydpu-848	stambhāvasaktapṛthumauktikadāmaramyam /	stambha avasakta pṛthu mauktika dāma ramyam 
SA_GK20_hpriydpu-849	adhyāsitaṃ yuvatibhir vijitāpsarobhiḥ	adhyāsitam yuvatibhiḥ vijita apsarobhiḥ 
SA_GK20_hpriydpu-850	prekṣāgṛhaṃ suravimānasamānam etat // HPri_3.2 //	prekṣāgṛham sura vimāna samānam etat 
SA_GK20_hpriydpu-851	[p. 31]	p 
SA_GK20_hpriydpu-852	Manoramāraṇyake -(upasṛtya /	manoramāraṇyake upasṛtya 
SA_GK20_hpriydpu-853	) jedu jedu bhaṭṭiṇī /	jedu jedu bhaṭṭiṇī 
SA_GK20_hpriydpu-854	[jayatu jayatu bhaṭṭinī /]	jayatu jayatu bhaṭṭinī 
SA_GK20_hpriydpu-855	Vāsavadattā -Maṇorame adikkandā khu saṃjjhā /	vāsavadattā maṇorame adikkandā khu saṃjjhā 
SA_GK20_hpriydpu-856	tā gacchaha /	tāḥ gacchaha 
SA_GK20_hpriydpu-857	lahu gaṇhaha ṇevacchaṃ /	lahu gaṇhaha ṇevaccham 
SA_GK20_hpriydpu-858	[Manorame atikrāntā khalu saṃdhyā /	manorame atikrāntā khalu saṃdhyā 
SA_GK20_hpriydpu-859	tad gacchatam /	tat gacchatam 
SA_GK20_hpriydpu-860	laghu gṛhṇītaṃ nepathyam /]	laghu gṛhṇītam nepathyam 
SA_GK20_hpriydpu-861	ubhe - jaṃ devī āṇavedi /	ubhe jam devī 
SA_GK20_hpriydpu-862	[yad devy ājñāpayati /]	yat devī ājñāpayati 
SA_GK20_hpriydpu-863	(iti prasthite /)	iti prasthite 
SA_GK20_hpriydpu-864	Vāsavadattā - Āraṇṇie edehiṃ evva madangapiṇaddhehiṃ ābharaṇehiṃ ṇevacchabhūmiṃ gadua appāṇaaṃ pasāhehi /	vāsavadattā āraṇṇie edehim evva madanga piṇaddhehiṃ ābharaṇehiṃ nevaccha bhūmim appāṇaam pasāhehi 
SA_GK20_hpriydpu-865	(ābharaṇāny aṅgād avatārya Āraṇyikāyāḥ samarpayati)	ābharaṇāni aṅgāt avatārya āraṇyikāyāḥ samarpayati 
SA_GK20_hpriydpu-866	Maṇorame tumaṃ vi Ṇalagiriggahaṇaparituṭṭheṇa tādeṇa ajjauttassa diṇṇāiṃ ābharaṇāiṃ Indīvariāsaāsādo geṇhia ṇevacchabhūmiaṃ gadua appāṇaṃ maṇḍehi  #	maṇorame tumam vi ṇala giri ggahaṇa parituṭṭheṇa tādeṇa ajjauttassa diṇṇāim ābharaṇāim geṇhia ṇevaccha bhūmiam appāṇam maṇḍehi 
SA_GK20_hpriydpu-867	jeṇa susadisī dīsasi mahārāassa /	jeṇa su sadisī dīsasi mahārāassa 
SA_GK20_hpriydpu-868	[Āraṇyike etair eva madaṅgapinaddhair ābharaṇair nepathyabhūmiṃ gatvātmānaṃ prasādhya /	āraṇyike etaiḥ eva mad aṅga pinaddhaiḥ ābharaṇaiḥ nepathya bhūmim gatvā ātmānam prasādhya 
SA_GK20_hpriydpu-869	(ābharaṇāny aṅgād avatārya Āraṇyikāyāḥ samarpayati)	ābharaṇāni aṅgāt avatārya āraṇyikāyāḥ samarpayati 
SA_GK20_hpriydpu-870	Manorame tvam api Nalagirigrahaṇaparituṣṭena tātenāryaputrasya dattāny ābharaṇānīndīvarikāsakāśād gṛhītvā nepathyabhūmiṃ gatvātmānaṃ maṇḍaya  #	manorame tvam api nalagiri grahaṇa parituṣṭena tātena aryaputrasya dattāni ābharaṇāni indīvarikā sakāśāt gṛhītvā nepathya bhūmim gatvā ātmānam maṇḍaya 
SA_GK20_hpriydpu-871	yena susadṛśī dṛśyase mahārājasya /]	yena su sadṛśī dṛśyase mahā rājasya 
SA_GK20_hpriydpu-872	(Manoramā Indīvarikāsakāśād ābharaṇāni gṛhītvā sahāraṇyakayā niṣkrāntā /)	manoramā indīvarikā sakāśāt ābharaṇāni gṛhītvā saha āraṇyakayā niṣkrāntā 
SA_GK20_hpriydpu-873	Indīvarikā - edaṃ āsaṇaṃ /	indīvarikā ā idam āsaṇam 
SA_GK20_hpriydpu-874	uvavisadu bhaṭṭiṇī /	uvavisadu bhaṭṭiṇī 
SA_GK20_hpriydpu-875	[idam āsanam /	idam āsanam 
SA_GK20_hpriydpu-876	upaviśatu bhaṭṭiṇī /]	upaviśatu bhaṭṭiṇī 
SA_GK20_hpriydpu-877	Vāsavadattā -(āsanaṃ nirdiśya /	vāsavadattā āsanam nirdiśya 
SA_GK20_hpriydpu-878	) uvavisadu bhaavadī /	uvavisadu bhaavadī 
SA_GK20_hpriydpu-879	[upaviśatu bhagavatī /]	upaviśatu bhagavatī 
SA_GK20_hpriydpu-880	(ubhe upaviśataḥ /)	ubhe upaviśataḥ 
SA_GK20_hpriydpu-881	(tataḥ praviśati gṛhītanepathyaḥ kañcukī /)	tatas praviśati gṛhīta nepathyaḥ kañcukī 
SA_GK20_hpriydpu-882	kañcukī -	kañcukī 
SA_GK20_hpriydpu-883	antaḥpurāṇāṃ vihitavyavasthaḥ	antaḥpurāṇām vihita vyavasthaḥ 
SA_GK20_hpriydpu-884	pade pade 'haṃ skhalitāni rakṣan /	pade pade haṃ skhalitāni rakṣan 
SA_GK20_hpriydpu-885	[p. 32]	p 
SA_GK20_hpriydpu-886	jarāturaḥ samprati daṇḍanītyā	jarā āturaḥ samprati daṇḍanītyā 
SA_GK20_hpriydpu-887	sarvaṃ nṛpasyānukaromi vṛttam // HPri_3.3 //	sarvam nṛpasya anukaromi vṛttam 
SA_GK20_hpriydpu-888	bhoḥ ājñāpito 'smi vimānitāśeṣaśatrusainyena yathārthanāmnā Mahāsenena samādiśyatām antaḥpureṣu yathā - śvo vayam Udayanotsavam anubhavāmaḥ	bhoḥ ājñāpitaḥ smi vimānita aśeṣa śatru sainyena yathārtha nāmnā mahāsenena samādiśyatām antaḥpureṣu yathā śvas vayam udayana utsavam anubhavāmaḥ 
SA_GK20_hpriydpu-889	ato yuṣmābhir utsavānurūpaveṣojjvalena parijanena saha Manmathodyānaṃ gantavyam iti /	atas yuṣmābhiḥ utsava anurūpa veṣa ujjvalena parijanena saha manmatha udyānam gantavyam iti 
SA_GK20_hpriydpu-890	Sāṅkṛtyāyanī - (kañcukinaṃ nirdiśya /	sāṅkṛtyāyanī kañcukinam nirdiśya 
SA_GK20_hpriydpu-891	) rājaputri pravṛttā prekṣā / dṛśyatām /	rāja putri pravṛttā prekṣā dṛśyatām 
SA_GK20_hpriydpu-892	kañcukī - tad etad ādeṣṭavyam parijanena saha gantavyam iti /	kañcukī tat etat ādeṣṭavyam parijanena saha gantavyam iti 
SA_GK20_hpriydpu-893	na gṛhītanepathyeneti / kutaḥ /	na gṛhīta nepathyena iti kutas 
SA_GK20_hpriydpu-894	pādair nūpuribhir nitambaphalakaiḥ śiñjānakāñcīguṇair	pādaiḥ nūpuribhiḥ nitamba phalakaiḥ śiñjāna kāñcī guṇaiḥ 
SA_GK20_hpriydpu-895	hārāpāditakāntibhiḥ stanataṭaiḥ keyūribhir bāhubhiḥ /	hāra āpādita kāntibhiḥ stana taṭaiḥ keyūribhiḥ bāhubhiḥ 
SA_GK20_hpriydpu-896	karṇaiḥ kuṇḍalibhiḥ karaiḥ savalayaiḥ sasvastikair mūrdhajair	karṇaiḥ kuṇḍalibhiḥ karaiḥ sa valayaiḥ sa svastikaiḥ mūrdhajaiḥ 
SA_GK20_hpriydpu-897	devīnāṃ paricārikāparijano 'py eteṣu saṃdṛśyate // HPri_3.4 //	devīnām paricārikā parijanaḥ pi eteṣu saṃdṛśyate 
SA_GK20_hpriydpu-898	na khalu kiṃcid atrāpūrvam anuṣṭheyam /	na khalu kiṃcid atra apūrvam anuṣṭheyam 
SA_GK20_hpriydpu-899	kevalaṃ svāmyādeśa iti matvāhaṃ samādiṣṭas tad ājñāśeṣaṃ rājaputryai nivedayāmi /	kevalam svāmi ādeśaḥ iti matvā aham samādiṣṭaḥ tat ājñā śeṣam rāja putryai nivedayāmi 
SA_GK20_hpriydpu-900	(parikramyāvalokya ca /	parikramya avalokya ca 
SA_GK20_hpriydpu-901	) iyaṃ [p. 33] sā Vāsavadattā vīṇāhastayā Kāñcanamālayānugamyamānā gandharvaśālām praviṣṭā /	iyam p sā vāsavadattā vīṇā hastayā kāñcana mālayā anugamyamānā gandharva śālām praviṣṭā 
SA_GK20_hpriydpu-902	yāvad asyāḥ kathayāmi /	yāvat asyāḥ kathayāmi 
SA_GK20_hpriydpu-903	(parikrāmati /)	parikrāmati 
SA_GK20_hpriydpu-904	(tataḥ praviśati gṛhītaVāsavadattānepathyāsanasthāraṇyikā	tatas praviśati gṛhīta vāsavadattā nepathya āsana sthā araṇyikā 
SA_GK20_hpriydpu-905	vīṇāhastā Kāñcanamālā ca /)	vīṇā hastā kāñcana mālā ca 
SA_GK20_hpriydpu-906	Āraṇyikā - halā Kancaṇamāle kīsa uṇa cirāadi ajja vi vīṇāārio /	āraṇyikā halā kancaṇamāle kīsa uṇa ajja vi 
SA_GK20_hpriydpu-907	[halā Kāñcanamāle kasmāt punaś cirayaty adyāpi vīṇācāryaḥ /]	halā kāñcanamāle kasmāt punar cirayati adyā api vīṇā ācāryaḥ 
SA_GK20_hpriydpu-908	Kāñcanamālā - bhaṭṭidārie diṭṭho deṇa ekko ummatto /	kāñcanamālā bhaṭṭi dārie diṭṭhaḥ deṇaḥ ekkaḥ ummattaḥ 
SA_GK20_hpriydpu-909	tassa vaaṇaṃ suṇia citteṇa bhāvido ohasanto ciṭṭhai /	tassa vaaṇam suṇia citteṇa bhāvidaḥ ohasantaḥ ciṭṭhai 
SA_GK20_hpriydpu-910	[bhartṛdārike dṛṣṭas tenaika unmattaḥ /	bhartṛ dārike dṛṣṭaḥ tena ekaḥ unmattaḥ 
SA_GK20_hpriydpu-911	tasya vacanaṃ śrutvā citreṇa bhavito 'pahasaṃs tiṣṭhati /]	tasya vacanam śrutvā citreṇa bhavito pahasan tiṣṭhati 
SA_GK20_hpriydpu-912	Āraṇyikā - (sahastatālaṃ vihasya /	āraṇyikā sa hasta tālam vihasya 
SA_GK20_hpriydpu-913	) hanje suṭṭhu edaṃ pucchadi /	hanje suṭṭhu ā idam 
SA_GK20_hpriydpu-914	sarisā sarise ranjanti tti duve ettha ummattā /	sarisā sarise ranjanti tti duve ettha ummattā 
SA_GK20_hpriydpu-915	[hañje suṣṭhv etaṃ pṛcchati /	hañje suṣṭhu etam pṛcchati 
SA_GK20_hpriydpu-916	sadṛśāḥ sadṛśe rajanta iti dvāv atronmattau /]	sadṛśāḥ sadṛśe rajante iti dvau atra unmattau 
SA_GK20_hpriydpu-917	Sāṅkṛtyāyanī - rājaputryāḥ sadṛśam ākāram paśyāmy asyās tādṛśenākāreṇāvaśyaṃ tvadīyāṃ bhūmikāṃ saṃbhāvayiṣyati /	sāṅkṛtyāyanī rāja putryāḥ sadṛśam ākāram paśyāmi asyāḥ tādṛśena ākāreṇa avaśyam tvadīyām bhūmikām saṃbhāvayiṣyati 
SA_GK20_hpriydpu-918	kañcukī - (upasṛtya)	kañcukī upasṛtya 
SA_GK20_hpriydpu-919	rājaputri devas tvām ājñāpayati /	rāja putri devaḥ tvām ājñāpayati 
SA_GK20_hpriydpu-920	śvo 'vaśyam asmābhir vīṇāṃ vādayantī śrotavyā /	śvas vaśyam asmābhiḥ vīṇām vādayantī śrotavyā 
SA_GK20_hpriydpu-921	tat tvayā navatantrīsajjayā Ghoṣavatyā stheyam iti /	tat tvayā nava tantrī sajjayā ghoṣavatyā stheyam iti 
SA_GK20_hpriydpu-922	Āraṇyikā - ayya jai evvaṃ lahu vīṇāāriaṃ visajjehi /	āraṇyikā ayya jai evvam lahu vīṇā āriam visajjehi 
SA_GK20_hpriydpu-923	[ārya yady evaṃ laghu vīṇācāryaṃ visarjaya /]	ārya yadi evam laghu vīṇā ācāryam visarjaya 
SA_GK20_hpriydpu-924	kañcukī - eṣa Vatsarājaṃ preṣayāmi /	kañcukī eṣa vatsa rājam preṣayāmi 
SA_GK20_hpriydpu-925	(iti niṣkrāntaḥ /)	iti niṣkrāntaḥ 
SA_GK20_hpriydpu-926	Āraṇyikā - Kancaṇamāle uvaṇehi me Ghosavadīṃ jāva se taṃtīo parikkhemi /	āraṇyikā kancaṇa māle uvaṇehi me ghosavadīm jāva se taṃtīaḥ parikkhemi 
SA_GK20_hpriydpu-927	[Kāñcanamāle upanaya me Ghoṣavatīṃ yāvad asyās tantrīḥ parīkṣe /]	kāñcana māle upanaya me ghoṣavatīm yāvat asyāḥ tantrīḥ parīkṣe 
SA_GK20_hpriydpu-928	(Kāñcanamālā vīṇām arpayati /	kāñcana mālāḥ vīṇām arpayati 
SA_GK20_hpriydpu-929	Āraṇyikotsaṅge vīṇāṃ kṛtvā sārayati /)	āraṇyika utsaṅge vīṇām kṛtvā sārayati 
SA_GK20_hpriydpu-930	(tataḥ praviśati gṛhītaVatsarājanepathyā Manoramā /)	tatas praviśati gṛhīta vatsa rāja nepathyā manoramā 
SA_GK20_hpriydpu-931	[p. 34]	p 
SA_GK20_hpriydpu-932	Manoramā - (svagatam /	manoramā svagatam 
SA_GK20_hpriydpu-933	) ciraadi kkhu mahārāo kiṃ ṇa kahidaṃ Vasantaeṇa /	ciraadi kkhu mahā rāo kim ṇa kahidam vasantaeṇa 
SA_GK20_hpriydpu-934	ahavā devīe bhāadi /	ahavā devīe 
SA_GK20_hpriydpu-935	jai dāṇiṃ āacche tado ramaṇijjaṃ have /	jai dāṇim āacche tado ramaṇijjam have 
SA_GK20_hpriydpu-936	[cirayati khalu mahārājaḥ /	cirayati khalu mahā rājaḥ 
SA_GK20_hpriydpu-937	kiṃ na kathitaṃ Vasantakena /	kim na kathitam vasantakena 
SA_GK20_hpriydpu-938	athavā devyā bibheti /	athavā devyā bibheti 
SA_GK20_hpriydpu-939	yadīdānīm āgacchet tato ramanīyaṃ bhavet /]	yadi idānīm āgacchet tatas ramanīyam bhavet 
SA_GK20_hpriydpu-940	(tataḥ praviśati rājāvaguṇṭhitaśarīro vidūṣakaś ca /)	tatas praviśati rājā avaguṇṭhita śarīraḥ vidūṣakaḥ ca 
SA_GK20_hpriydpu-941	rājā -	rājā 
SA_GK20_hpriydpu-942	saṃtāpam prathamaṃ tathā na kurute śītāṃśur adyaiva me	saṃtāpam prathamam tathā na kurute śītāṃśuḥ adyā eva me 
SA_GK20_hpriydpu-943	niśvāsā glapayanty ajasram adhunaivoṣṇās tathā nādharam /	niśvāsāḥ glapayanti ajasram adhunā evā uṣṇāḥ tathā nā adharam 
SA_GK20_hpriydpu-944	saṃpraty eva mano na śūnyam alasāny aṅgāni no pūrvavad	saṃprati eva manaḥ na śūnyam alasāni aṅgāni no pūrvavat 
SA_GK20_hpriydpu-945	duḥkhaṃ yāti manoratheṣu tanutāṃ saṃcintyamāneṣv api // HPri_3.5 //	duḥkham yāti manoratheṣu tanu tām saṃcintyamāneṣu api 
SA_GK20_hpriydpu-946	vayasya satyam evoktam Manoramayā /	vayasya satyam evā uktam manoramayā 
SA_GK20_hpriydpu-947	yathaiṣā mama priyasakhī mahārājasya devyā darśanapathād api rakṣyate tad ayaṃ samāgamopāyaḥ /	yathā eṣā mama priya sakhī mahā rājasya devyāḥ darśana pathāt api rakṣyate tat ayam samāgama upāyaḥ 
SA_GK20_hpriydpu-948	adya rātrāv asmābhir Udayanacaritaṃ nāma nāṭakaṃ devyāḥ purato nartitavyam /	adya rātrau asmābhiḥ udayanacaritam nāma nāṭakam devyāḥ puratas nartitavyam 
SA_GK20_hpriydpu-949	tatra Āraṇyikā Vāsavadattā bhaviṣyati /	tatra āraṇyikā vāsavadattā bhaviṣyati 
SA_GK20_hpriydpu-950	aham api Vatsarājaḥ /	aham api vatsa rājaḥ 
SA_GK20_hpriydpu-951	tac caritenaiva sarvaṃ śikṣitavyam /	tat caritena eva sarvam śikṣitavyam 
SA_GK20_hpriydpu-952	tad āgatya svayam eva svāṃ bhūmikāṃ kurvāṇaḥ samāgamotsavam anubhavatv iti /	tat āgatya svayam eva svām bhūmikām kurvāṇaḥ samāgama utsavam anubhavatu iti 
SA_GK20_hpriydpu-953	vidūṣakaḥ - jai maṃ ṇa pattiāasi esā Maṇoramā tuha vesaṃ dhāraantī ciṭṭhai /	vidūṣakaḥ jai mam na pattiāasi esā maṇoramā tuha vesam dhāraantī ciṭṭhai 
SA_GK20_hpriydpu-954	tā uvasappia saaṃ evva puccha /	tāḥ uvasappia saam evva puccha 
SA_GK20_hpriydpu-955	[yadi māṃ na pratyāyayasy eṣā Manoramā tava veṣaṃ dhārayantī tiṣṭhati /	yadi mām na pratyāyayasi eṣā manoramā tava veṣam dhārayantī tiṣṭhati 
SA_GK20_hpriydpu-956	tad upasṛtya svayam eva pṛccha /]	tat upasṛtya svayam eva pṛccha 
SA_GK20_hpriydpu-957	rājā - (Manoramām upasṛtya /	rājā manoramām upasṛtya 
SA_GK20_hpriydpu-958	) Manorame satyam idaṃ yad Vasantako 'bhidhatte /	manorame satyam idam yat vasantakaḥ abhidhatte 
SA_GK20_hpriydpu-959	Manoramā - bhaṭṭā saccaṃ evva /	manoramā bhaṭṭā saccam evva 
SA_GK20_hpriydpu-960	maṇḍaa edehiṃ ābharaṇehiṃ appāṇaaṃ /	ābharaṇehiṃ 
SA_GK20_hpriydpu-961	[bhartaḥ satyam eva /	bhartar satyam eva 
SA_GK20_hpriydpu-962	maṇḍayaitair ābharaṇair ātmānam /]	maṇḍaya etaiḥ ābharaṇaiḥ ātmānam 
SA_GK20_hpriydpu-963	(ity ābharaṇāny aṅgād avatārya rājñe samarpayati /)	iti ābharaṇāni aṅgāt avatārya rājñe samarpayati 
SA_GK20_hpriydpu-964	(rājā paridadhāti /)	rājā paridadhāti 
SA_GK20_hpriydpu-965	[p. 35]	p 
SA_GK20_hpriydpu-966	vidūṣakaḥ - ede kkhu rāāṇo dāsīe vi evvaṃ ṇaccāvianti /	vidūṣakaḥ ede kkhu rāāṇaḥ dāsīe vi evvam 
SA_GK20_hpriydpu-967	aho kajjassa garuadā /	aho kajjassa garuadā 
SA_GK20_hpriydpu-968	[ete khalu rājāno dāsyāpi evaṃ nartyante /	ete khalu rājānaḥ dāsyā api evam nartyante 
SA_GK20_hpriydpu-969	aho kāryasya gurutā /]	aho kāryasya guru tā 
SA_GK20_hpriydpu-970	rājā - (vihasya /	rājā vihasya 
SA_GK20_hpriydpu-971	) mūrkha naiṣa kālaḥ parihāsasya /	mūrkha na eṣa kālaḥ parihāsasya 
SA_GK20_hpriydpu-972	nibhṛtena citraśālām praviśya Manoramayā sahāsmannṛttam paśyatā sthīyatām /	nibhṛtena citraśālām praviśya manoramayā saha asmad nṛttam paśyatā sthīyatām 
SA_GK20_hpriydpu-973	(ubhau tathā kurutaḥ /)	ubhau tathā kurutaḥ 
SA_GK20_hpriydpu-974	Āraṇyikā - Kancaṇamāle ciṭṭhadu vīṇā /	āraṇyikā kancaṇamāle ciṭṭhadu vīṇā 
SA_GK20_hpriydpu-975	puccchissaṃ dāva kiṃ vi /	pucchissam dāva kim vi 
SA_GK20_hpriydpu-976	[Kāñcanamāle tiṣṭhatu vīṇā /	kāñcana māle tiṣṭhatu vīṇā 
SA_GK20_hpriydpu-977	prakṣyāmi tāvat kim api /]	prakṣyāmi tāvat kim api 
SA_GK20_hpriydpu-978	rājā - śṛṇomi tāvat katamo 'yam uddeśo vartate /	rājā śṛṇomi tāvat katamaḥ yam uddeśaḥ vartate 
SA_GK20_hpriydpu-979	(ity avahitaḥ śṛṇoti /)	iti avahitaḥ śṛṇoti 
SA_GK20_hpriydpu-980	Kāñcanamālā - pucchadu bhaṭṭidāriā /	kāñcanamālā bhaṭṭidāriā 
SA_GK20_hpriydpu-981	[pṛcchatu bhartṛdārikā /]	pṛcchatu bhartṛ dārikā 
SA_GK20_hpriydpu-982	Āraṇyikā - saccaṃ evva tādo mantedi evvaṃ jahā jai vīṇaṃ vādaanto avaharedi maṃ Vaccharāo avassaṃ bandhaṇādo muncemi tti /	āraṇyikā saccam evva tādo mantedi evvam jahā jai vīṇam vāda antaḥ avaharedi mama vaccha rāo avassam bandhaṇāt muncemi tti 
SA_GK20_hpriydpu-983	[satyam eva tāto mantrayate evaṃ yathā - yadi vīṇāṃ vādayann apaharati māṃ Vatsarājo 'vaśyaṃ bandhanān muñcāmīti /]	satyam eva tātaḥ mantrayate evam yathā yadi vīṇām vādayan apaharati mām vatsa rājaḥ vaśyam bandhanāt muñcāmi iti 
SA_GK20_hpriydpu-984	rājā -(praviśya paṭākṣepeṇa saharṣaṃ vastrānte grathitam badhnāti /	rājā praviśya paṭa ākṣepeṇa sa harṣam vastra ante grathitam badhnāti 
SA_GK20_hpriydpu-985	) evam etat /	evam etat 
SA_GK20_hpriydpu-986	kaḥ saṃdehaḥ /	kaḥ saṃdehaḥ 
SA_GK20_hpriydpu-987	saparijanaṃ Pradyotaṃ vismayam upanīya vādayan vīṇām /	sa parijanam pradyotam vismayam upanīya vādayan vīṇām 
SA_GK20_hpriydpu-988	Vāsavadattām apaharāmi na cirād eveti paśyāmy // HPri_3.6 //	vāsavadattām apaharāmi na cirāt eva iti paśyāmi 
SA_GK20_hpriydpu-989	yataḥ susaṃvihitaṃ sarvaṃ Yaugandharāyaṇena /	yatas su saṃvihitam sarvam yaugandharāyaṇena 
SA_GK20_hpriydpu-990	Vāsavadattā -(sahasotthāya /	vāsavadattā sahasā utthāya 
SA_GK20_hpriydpu-991	) jedu jedu accautto /	jedu jedu accauttaḥ 
SA_GK20_hpriydpu-992	[jayatu jayatv āryaputraḥ /]	jayatu jayatu āryaputraḥ 
SA_GK20_hpriydpu-993	rājā - (svagatam /	rājā svagatam 
SA_GK20_hpriydpu-994	) kathaṃ pratyabhijñāto 'smi devyā /	katham pratyabhijñātaḥ smi devyā 
SA_GK20_hpriydpu-995	Sāṅkṛtyāyanī - (sasmitam /	sāṅkṛtyāyanī sa smitam 
SA_GK20_hpriydpu-996	) rājaputri alam alaṃ saṃbhrameṇa /	rāja putri alam alam saṃbhrameṇa 
SA_GK20_hpriydpu-997	prekṣaṇīyakam etat /	prekṣaṇīyakam etat 
SA_GK20_hpriydpu-998	[p. 36]	p 
SA_GK20_hpriydpu-999	rājā - (ātmagataṃ saharṣam)	rājā ātma gatam sa harṣam 
SA_GK20_hpriydpu-1000	idānīm ucchvāsito 'smi /	idānīm ucchvāsitaḥ smi 
SA_GK20_hpriydpu-1001	Vāsavadattā -(savilakṣasmitam upaviśya /	vāsavadattā sa vilakṣa smitam upaviśya 
SA_GK20_hpriydpu-1002	) kahaṃ Maṇoramā esā /	kaham maṇoramā esā 
SA_GK20_hpriydpu-1003	mae uṇa jāṇidaṃ ajjautto eso tti /	mae uṇa jāṇidam ajjauttaḥ esaḥ tti 
SA_GK20_hpriydpu-1004	sāhu Maṇorame sāhu /	sāhu maṇorame sāhu 
SA_GK20_hpriydpu-1005	sohaṇaṃ ṇaccidaṃ /	sohaṇam 
SA_GK20_hpriydpu-1006	[kathaṃ Manoramaiṣā /	katham manoramā eṣā 
SA_GK20_hpriydpu-1007	mayā punar jñātam āryaputra eṣa iti /	mayā punar jñātam āryaputraḥ eṣaḥ iti 
SA_GK20_hpriydpu-1008	sādhu Manorame sādhu /	sādhu manorame sādhu 
SA_GK20_hpriydpu-1009	śobhanaṃ nartitam /]	śobhanam nartitam 
SA_GK20_hpriydpu-1010	Sāṅkṛtyāyanī - rājaputri sthāna eva kṛtā bhrāntis te Manoramayā / paśya /	sāṅkṛtyāyanī rāja putri sthāne eva kṛtā bhrāntiḥ te manoramayā paśya 
SA_GK20_hpriydpu-1011	rūpaṃ tan nayanotsavāspadam idaṃ veṣaḥ sa evojjvalaḥ	rūpam tat nayana utsava āspadam idam veṣaḥ saḥ evā ujjvalaḥ 
SA_GK20_hpriydpu-1012	sā mattadviradocitā gatir iyaṃ tat sattvam atyūrjitam /	sā matta dvirada ucitā gatiḥ iyam tat sattvam ati ūrjitam 
SA_GK20_hpriydpu-1013	līlā saiva sa eva sāndrajaladahrādānukārī svaraḥ	līlā sā eva saḥ eva sāndra jalada hrāda anukārī svaraḥ 
SA_GK20_hpriydpu-1014	sākṣād darśita eṣa naḥ kuśalayā Vatseśa evānayā // HPri_3.7 //	sākṣāt darśitaḥ eṣa naḥ kuśalayā vatsa īśaḥ eva anayā 
SA_GK20_hpriydpu-1015	Vāsavadattā -hanje Indīvarie /	vāsavadattā hanje indīvarie 
SA_GK20_hpriydpu-1016	baddheṇa ajjautteṇa ahaṃ vīṇaṃ sikkhāvidā /	baddheṇa ajjautteṇa aham vīṇam sikkhā vidā 
SA_GK20_hpriydpu-1017	tā se karehi ṇīluppaladāmaeṇa ṇialaṇam /	tā se karehi ṇīluppala dāmaeṇa 
SA_GK20_hpriydpu-1018	[hañje Indīvarike baddhenāryaputreṇāhaṃ vīṇāṃ śikṣitā /	hañje indīvarike baddhena āryaputreṇa aham vīṇām śikṣitā 
SA_GK20_hpriydpu-1019	tad asya kuru nīlotpaladāmakena nigaḍanam /]	tat asya kuru nīlotpala dāmakena nigaḍanam 
SA_GK20_hpriydpu-1020	(śiraso 'panīya nīlotpaladāmārpayati /)	śirasā upanīya nīlotpala dāma arpayati 
SA_GK20_hpriydpu-1021	(Indīvarikā tathā kṛtvā punas tatraivopaviśati /)	indīvarikā tathā kṛtvā punar tatra eva upaviśati 
SA_GK20_hpriydpu-1022	Āraṇyikā - Kancaṇamāle kahehi kahehi /	āraṇyikā kancaṇamāle kahehi kahehi 
SA_GK20_hpriydpu-1023	ṇaṃ saccaṃ evva mantedi tādo jai vīṇaṃ vādaanto avaharedi maṃ Vaccharāo tado avassaṃ bandhaṇādo muñcemi tti /	ṇam saccam evva mantedi tādaḥ jai vīṇam vāda antaḥ avaharedi mama vaccha rāo tadas avassam bandhaṇāt muñcemi tti 
SA_GK20_hpriydpu-1024	[Kāñcanamāle kathaya kathaya /	kāñcana māle kathaya kathaya 
SA_GK20_hpriydpu-1025	nanu satyam eva mantrayate tāto yadi vīṇāṃ vādayat apaharati māṃ Vatsarājas tato 'vaśyaṃ bandhanān muñcāmīti /]	nanu satyam eva mantrayate tātaḥ yadi vīṇām vādayat apaharati mām vatsa rājaḥ tatas vaśyam bandhanāt muñcāmi iti 
SA_GK20_hpriydpu-1026	Kāñcanamālā - bhaṭṭhidārie saccaṃ /	kāñcanamālā bhaṭṭhi dārie saccam 
SA_GK20_hpriydpu-1027	taha karehi jaha Vaccharāassa avassaṃ bahumadā hosi /	taha karehi jaha vaccha rāassa avassam bahu madā hosi 
SA_GK20_hpriydpu-1028	[bhartṛdārike satyam /	bhartṛ dārike satyam 
SA_GK20_hpriydpu-1029	tathā kuru yathā Vatsa(rājasyāvaśyaṃ bahumatā bhavasi /]	tathā kuru yathā vatsa rājasya avaśyam bahu matā bhavasi 
SA_GK20_hpriydpu-1030	[p. 37]	p 
SA_GK20_hpriydpu-1031	rājā - niṣpāditam eva Kāñcanamālayā yat tad āsmābhir abhilaṣitam /	rājā niṣpāditam eva kāñcana mālayā yat tat ā asmābhiḥ abhilaṣitam 
SA_GK20_hpriydpu-1032	Āraṇyikā - jai evvaṃ tā ādareṇa vādaissaṃ /	āraṇyikā jai evvam tā ādareṇa 
SA_GK20_hpriydpu-1033	[yady evaṃ tad ādareṇa vādayiṣyāmi /	yadi evam tat ādareṇa vādayiṣyāmi 
SA_GK20_hpriydpu-1034	] (gāyantīvādayati)	gāyantī vādayati 
SA_GK20_hpriydpu-1035	ghaṇabandhaṇasaṃruddhaṃ gaaṇaṃ daṭṭhūṇa māṇasaṃ eduṃ /	ghaṇa bandhaṇa saṃruddham gaaṇam daṭṭhūṇa māṇasam edum 
SA_GK20_hpriydpu-1036	ahilasai rāahaṃso daiaṃ gheūṇa appaṇo vasaiṃ // HPri_3.8 //	ahilasai rāa haṃsaḥ daiam appaṇaḥ 
SA_GK20_hpriydpu-1037	[ghanabandhanasaṃruddhaṃ gaganaṃ dṛṣṭvā mānasam etum /	ghana bandhana saṃruddham gaganam dṛṣṭvā mānasam etum 
SA_GK20_hpriydpu-1038	abhilaṣati rājahaṃso dayitāṃ gṛhītvātmano vasatim // HPri_3.8 //]	abhilaṣati rājahaṃsaḥ dayitām gṛhītvā ātmanaḥ vasatim 
SA_GK20_hpriydpu-1039	(vidūṣako nidrāṃ nāṭayati /)	vidūṣakaḥ nidrām nāṭayati 
SA_GK20_hpriydpu-1040	Manoramā - (hastena cālayantī /	manoramā hastena cālayantī 
SA_GK20_hpriydpu-1041	) Vasantaa pekkha pekkha piasahī me ṇaccai /	vasantaa pekkha pekkha piasahī me 
SA_GK20_hpriydpu-1042	[Vasantaka paśya paśya /	vasantaka paśya paśya 
SA_GK20_hpriydpu-1043	priyasakhī me nṛtyati /]	priya sakhī me nṛtyati 
SA_GK20_hpriydpu-1044	vidūṣakaḥ - (saroṣam /	vidūṣakaḥ sa roṣam 
SA_GK20_hpriydpu-1045	) dāsīe sude tumaṃ vi ṇa desi suviduṃ /	dāsīe su de tumam vi na desi 
SA_GK20_hpriydpu-1046	jadappahudi piavaasseṇa Āraṇṇiā diṭṭhā tadappahudi teṇa saha mae rattiṃdivaṃ ṇiddā ṇa diṭṭhā /	jat appahudi pia vaasseṇa āraṇṇiā diṭṭhā tat appahudi teṇa saha mae rattiṃdivam ṇiddā ṇa diṭṭhā 
SA_GK20_hpriydpu-1047	tā aṇṇado ṇikkamia suvissaṃ /	tā aṇṇadaḥ ṇikkamia suvissam 
SA_GK20_hpriydpu-1048	[dāsyāḥ sute tvam api na dadāsi svaptum /	dāsyāḥ sute tvam api na dadāsi svaptum 
SA_GK20_hpriydpu-1049	yadāprabhṛti priyavayasyenāraṇyikā dṛṣṭā tadāprabhṛti tena saha mayā rātraṃdivaṃ nidrā na dṛṣṭā /	yadā prabhṛti priya vayasyena āraṇyikā dṛṣṭā tadā prabhṛti tena saha mayā rātraṃdivam nidrā na dṛṣṭā 
SA_GK20_hpriydpu-1050	tad anyato niṣkramya svapsyāmi /]	tat anyatas niṣkramya svapsyāmi 
SA_GK20_hpriydpu-1051	(niṣkramya śete)	niṣkramya śete 
SA_GK20_hpriydpu-1052	(Āraṇyikā punar gāyati /)	āraṇyikā punar gāyati 
SA_GK20_hpriydpu-1053	ahiṇavarāakkhittā mahuariā vāmaeṇa kāmeṇa /	mahuariā vāmaeṇa kāmeṇa 
SA_GK20_hpriydpu-1054	uttamai patthantīdaṭṭhuṃ piadaṃsaṇaṃ daiaṃ // HPri_3.9 //	uttamai patthantī daṭṭhum pia daṃsaṇam daiam 
SA_GK20_hpriydpu-1055	[abhinavarāgakṣiptā madhukarikā vāmakena kāmena /	abhinava rāga kṣiptā madhukarikā vāmakena kāmena 
SA_GK20_hpriydpu-1056	uttāmyati prārthayamānā draṣṭuṃ priyadarśanaṃ dayitam // HPri_3.9 //]	uttāmyati prārthayamānā draṣṭum priyadarśanam dayitam 
SA_GK20_hpriydpu-1057	rājā - (tatkṣaṇaṃ śrutvā sahasopasṛtya /	rājā tad kṣaṇam śrutvā sahasā upasṛtya 
SA_GK20_hpriydpu-1058	) sādhu rājaputri sādhu /	sādhu rāja putri sādhu 
SA_GK20_hpriydpu-1059	aho gītam aho vāditram / tathā hi /	aho gītam aho vāditram tathā hi 
SA_GK20_hpriydpu-1060	[p. 38]	p 
SA_GK20_hpriydpu-1061	vyaktir vyañjanadhātunā daśavidhenāpy atra labdhādhunā	vyaktiḥ vyañjana dhātunā daśavidhena api atra labdhā adhunā 
SA_GK20_hpriydpu-1062	vispaṣṭo drutamadhyalambitaparicchinnas tridhāyaṃ layaḥ /	vispaṣṭaḥ druta madhya lambita paricchinnaḥ tridhā ayam layaḥ 
SA_GK20_hpriydpu-1063	gopucchapramukhāḥ krameṇa yatayas tisro 'pi saṃpāditās	gopuccha pramukhāḥ krameṇa yatayaḥ tisraḥ pi saṃpāditāḥ 
SA_GK20_hpriydpu-1064	tatvaughānugatāś ca vādyavidhayaḥ samyak trayo darśitāḥ // HPri_3.10 //	tatvā ogha anugatāḥ ca vādya vidhayaḥ samyak trayaḥ darśitāḥ 
SA_GK20_hpriydpu-1065	Āraṇyikā - (vīṇāṃ pariṣvajyāsanād utthāya rājānaṃ sābhilāṣaṃ paśyantī /	āraṇyikā vīṇām pariṣvajya āsanāt utthāya rājānam sa abhilāṣam paśyantī 
SA_GK20_hpriydpu-1066	) uvājjhāa paṇamāmi /	paṇamāmi 
SA_GK20_hpriydpu-1067	[upādhyāya praṇamāmi /]	upādhyāya praṇamāmi 
SA_GK20_hpriydpu-1068	rājā - (sasmitam /	rājā sa smitam 
SA_GK20_hpriydpu-1069	) yad aham icchāmi tat te bhūyāt /	yat aham icchāmi tat te bhūyāt 
SA_GK20_hpriydpu-1070	[p. 39]	p 
SA_GK20_hpriydpu-1071	Kāñcanamālā - (Āraṇyikāyā āsanaṃ nirdiśya /	kāñcana mālā āraṇyikāyāḥ āsanam nirdiśya 
SA_GK20_hpriydpu-1072	) iha evva uvavisadu uvajjhāo /	iha evva uvavisadu uvajjhāo 
SA_GK20_hpriydpu-1073	[ihaivopaviśatu upādhyāyaḥ /]	iha eva upaviśatu upādhyāyaḥ 
SA_GK20_hpriydpu-1074	rājā - (upaviśya /	rājā upaviśya 
SA_GK20_hpriydpu-1075	) rājaputrī kvedānīm upaviśatu /	rāja putrī kva idānīm upaviśatu 
SA_GK20_hpriydpu-1076	Kañcanamālā -(sasmitam)	kañcana mālā sa smitam 
SA_GK20_hpriydpu-1077	dāṇiṃ evva bhaṭṭidāriā vijjāmāṇena paritosidā tumhehiṃ /	dāṇim evva bhaṭṭi dāriā vijjāmāṇena paritosidā tumhehiṃ 
SA_GK20_hpriydpu-1078	tā aruhadi evva esā uvajjhāapīṭhiāe /	tā evva esā 
SA_GK20_hpriydpu-1079	[idānīm eva bhartṛdārikā vidyāmānena paritoṣitā yuṣmābhiḥ /	idānīm eva bhartṛ dārikā vidyā mānena paritoṣitā yuṣmābhiḥ 
SA_GK20_hpriydpu-1080	tad arhaty evaiṣopādhyāyapīṭhikāyāḥ /]	tat arhati eva eṣā upādhyāya pīṭhikāyāḥ 
SA_GK20_hpriydpu-1081	rājā - upaviśatv arheyam ardhāsanasya /	rājā upaviśatu arhā iyam ardhāsanasya 
SA_GK20_hpriydpu-1082	rājaputri sthīyatām /	rāja putri sthīyatām 
SA_GK20_hpriydpu-1083	(Āraṇyikā Kāñcanamālāṃ paśyati /)	āraṇyikā kāñcana mālām paśyati 
SA_GK20_hpriydpu-1084	Kāñcanamālā - (sasmitam /	kāñcana mālā sa smitam 
SA_GK20_hpriydpu-1085	) bhaṭṭidārie uvavisa /	bhaṭṭi dārie uvavisa 
SA_GK20_hpriydpu-1086	ko ettha doso /	kaḥ ettha dosaḥ 
SA_GK20_hpriydpu-1087	sissavisesā khu tumaṃ /	sissa visesā khu tumam 
SA_GK20_hpriydpu-1088	[bhartṛdārike upaviśa /	bhartṛ dārike upaviśa 
SA_GK20_hpriydpu-1089	ko 'tra doṣaḥ /	kaḥ tra doṣaḥ 
SA_GK20_hpriydpu-1090	śiṣyaviśeṣā khalu tvam /]	śiṣya viśeṣā khalu tvam 
SA_GK20_hpriydpu-1091	(Āraṇyikā salajjam upaviśati /)	āraṇyikā sa lajjam upaviśati 
SA_GK20_hpriydpu-1092	Vāsavadattā -(salajjam /	vāsavadattā sa lajjam 
SA_GK20_hpriydpu-1093	) bhaavadīe (Kale -īye)	bhaavadīe kale īye 
SA_GK20_hpriydpu-1094	ahiaṃ kappidaṃ kavvaṃ /	ahiam kappidam kavvam 
SA_GK20_hpriydpu-1095	ṇa hu ahaṃ tassiṃ kāle ekkāsaṇe ajjautteṇa saha uvaviṭṭhā /	ṇa hu aham tassim kāle ekka āsaṇe ajjautteṇa saha uvaviṭṭhā 
SA_GK20_hpriydpu-1096	[bhagavaty ādhikaṃ kalpitaṃ kāvyam /	bhagavati ādhikam kalpitam kāvyam 
SA_GK20_hpriydpu-1097	na khalv ahaṃ tasmin kāla ekāsane āryaputreṇa sahopaviṣṭā /]	na khalu aham tasmin kāle eka āsane āryaputreṇa saha upaviṣṭā 
SA_GK20_hpriydpu-1098	rājā - rājaputri punaḥ śrotum icchāmi /	rājā rāja putri punar śrotum icchāmi 
SA_GK20_hpriydpu-1099	vādaya vīṇām /	vādaya vīṇām 
SA_GK20_hpriydpu-1100	Āraṇyikā - (sasmitam /	āraṇyikā sa smitam 
SA_GK20_hpriydpu-1101	) Kancaṇamāle ciraṃ khu mama vādaantīe parissamo jādo /	kancaṇa māle ciram khu mama vāda antīe parissamaḥ jādaḥ 
SA_GK20_hpriydpu-1102	dāṇiṃ ṇissahāiṃ aṅgāiṃ /	dāṇim ṇissahāim aṅgāim 
SA_GK20_hpriydpu-1103	tā ṇa sakkuṇomi vādaiduṃ /	tā na sakkuṇomi 
SA_GK20_hpriydpu-1104	[Kāñcanamāle ciraṃ khalu mama vādayantyāḥ pariśramo jātaḥ /	kāñcanamāle ciram khalu mama vādayantyāḥ pariśramaḥ jātaḥ 
SA_GK20_hpriydpu-1105	idānīṃ niḥsahāny aṅgāni /	idānīm niḥsahāni aṅgāni 
SA_GK20_hpriydpu-1106	tan na śaknomi vādayitum /]	tat na śaknomi vādayitum 
SA_GK20_hpriydpu-1107	Kāñcanamālā - uvajjhāa suṭṭhu parissantā bhaṭṭidāriā /	kāñcanamālā suṭṭhu parissantā bhaṭṭi dāriā 
SA_GK20_hpriydpu-1108	kavolatalabaddhasealavāe pekkha se vevanti aggahatthā /	pekkha se vevanti agga hatthā 
SA_GK20_hpriydpu-1109	tā samassattā hotu muhuttaaṃ /	tā samassattā hotu muhuttaam 
SA_GK20_hpriydpu-1110	[upādhyāya suṣṭhu pariśrāntā bhartṛdārikā /	upādhyāya suṣṭhu pariśrāntā bhartṛ dārikā 
SA_GK20_hpriydpu-1111	kapolatalabaddhasvedalavāyāḥ paśyāsyā vepete agrahastau /	kapola tala baddha sveda lavāyāḥ paśya āsyāḥ vepete agra hastau 
SA_GK20_hpriydpu-1112	tat samāśvastā bhavatu muhūrtam /]	tat samāśvastā bhavatu muhūrtam 
SA_GK20_hpriydpu-1113	rājā - Kāñcanamāle yuktam abhihitam /	rājā kāñcanamāle yuktam abhihitam 
SA_GK20_hpriydpu-1114	(hastena grahītum icchati /)	hastena grahītum icchati 
SA_GK20_hpriydpu-1115	(Āraṇyikā hastam apasārayati /)	āraṇyikā hastam apasārayati 
SA_GK20_hpriydpu-1116	[p. 40]	p 
SA_GK20_hpriydpu-1117	Vāsavadattā - (sāsūyam /	vāsavadattā sa asūyam 
SA_GK20_hpriydpu-1118	) bhaavadi ahiaṃ edaṃ vi tue kidaṃ /	bhaavadi ahiam edam vi tue kidam 
SA_GK20_hpriydpu-1119	ṇa hu ahaṃ (Kale aaṃ)	ṇa hu aham kale aaṃ 
SA_GK20_hpriydpu-1120	Kancaṇamālākavveṇa vancaidavvā /	kancaṇa mālā kavveṇa 
SA_GK20_hpriydpu-1121	[bhagavati adhikam etad api tvayā kṛtam /	bhagavati adhikam etat api tvayā kṛtam 
SA_GK20_hpriydpu-1122	na khalv ahaṃ Kāñcanamālā kāvyena vañcayitavyā /]	na khalu aham kāñcanamālā kāvyena vañcayitavyā 
SA_GK20_hpriydpu-1123	Sāṅkṛtyāyanī - (vihasya /	sāṅkṛtyāyanī vihasya 
SA_GK20_hpriydpu-1124	) āyuṣmati īdṛśam eva kāvyaṃ bhaviṣyati /	āyuṣmati īdṛśam eva kāvyam bhaviṣyati 
SA_GK20_hpriydpu-1125	Āraṇyikā - (saroṣam iva /	āraṇyikā sa roṣam iva 
SA_GK20_hpriydpu-1126	) avehi Kancaṇamāle avehi /	avehi kancaṇamāle avehi 
SA_GK20_hpriydpu-1127	ṇa me bahumadāsi /	ṇa me bahu madāsi 
SA_GK20_hpriydpu-1128	[apehi Kāñcanamāle apehi /	apehi kāñcanamāle apehi 
SA_GK20_hpriydpu-1129	na me bahumatāsi /]	na me bahu matā asi 
SA_GK20_hpriydpu-1130	Kāñcanamālā - (sasmitam /	kāñcana mālā sa smitam 
SA_GK20_hpriydpu-1131	) jai ahaṃ ciṭṭhantī ṇā bahumadā tā esā gacchamhi /	jai aham ciṭṭhantī nā bahu madā tā esā gacchamhi 
SA_GK20_hpriydpu-1132	[yady ahaṃ tiṣṭhantī na bahumatā tad eṣā gacchāmi /]	yadi aham tiṣṭhantī na bahu matā tat eṣā gacchāmi 
SA_GK20_hpriydpu-1133	(iti niṣkrāntā /)	iti niṣkrāntā 
SA_GK20_hpriydpu-1134	Āraṇyikā - (sasambhraman /	āraṇyikā sa sambhraman 
SA_GK20_hpriydpu-1135	) Kancaṇamāle ciṭṭha ciṭṭha /	kancaṇa māle ciṭṭha ciṭṭha 
SA_GK20_hpriydpu-1136	ahaṃ se aggahattho samappido /	aham se agga hatthaḥ 
SA_GK20_hpriydpu-1137	[Kāñcanamāle tiṣṭha tiṣṭha /	kāñcana māle tiṣṭha tiṣṭha 
SA_GK20_hpriydpu-1138	ayam asyāgrahastaḥ samarpitaḥ /]	ayam asya agra hastaḥ samarpitaḥ 
SA_GK20_hpriydpu-1139	rājā - (Āraṇyikāyā hastaṃ gṛhītvā /)	rājā āraṇyikāyāḥ hastam gṛhītvā 
SA_GK20_hpriydpu-1140	sadyo 'vaśyāyabinduvyatikaraśiśiraḥ kiṃ bhavet padmakośo	sadyas vaśyāya bindu vyatikara śiśiraḥ kim bhavet 
SA_GK20_hpriydpu-1141	hlāditvaṃ nāsya manye sadṛśam idam uṣasy eva vītātapasya /	hlādi tvam nā asya manye sadṛśam idam uṣasi eva vīta ātapasya 
SA_GK20_hpriydpu-1142	muñcanty ete himaughaṃ nakharajanikarāḥ pañca kiṃ so 'pi dāhī	muñcanti ete hima ogham nakhara janikarāḥ pañca kim saḥ dāhī 
SA_GK20_hpriydpu-1143	jñātaṃ svedāpadeśād aviratam amṛtaṃ syandate vyaktam etat // HPri_3.11 //	jñātam sveda apadeśāt aviratam amṛtam syandate vyaktam etat 
SA_GK20_hpriydpu-1144	api ca /	api ca 
SA_GK20_hpriydpu-1145	etena bālavidrumapallavaśobhāpahāradakṣeṇa /	etena bāla vidruma pallava śobhā apahāra dakṣeṇa 
SA_GK20_hpriydpu-1146	hṛdaye mama tvayāyaṃ nyasto rāgaḥ svahastena // HPri_3.12 //	hṛdaye mama tvayā ayam nyastaḥ rāgaḥ sva hastena 
SA_GK20_hpriydpu-1147	[p. 41]	p 
SA_GK20_hpriydpu-1148	Āraṇyikā - (sparśaviśeṣaṃ nāṭayantī /	āraṇyikā sparśa viśeṣam nāṭayantī 
SA_GK20_hpriydpu-1149	) ha ddhi ha ddhi /	ha ddhi ha ddhi 
SA_GK20_hpriydpu-1150	edaṃ Maṇoramaṃ parisantīe aṇatthaṃ evva me aṅgāiṃ karenti /	edam maṇoramam parisantīe anattham evva me aṅgāim karenti 
SA_GK20_hpriydpu-1151	[hā dhik hā dhik /	hā dhik hā dhik 
SA_GK20_hpriydpu-1152	etāṃ Manoramāṃ spṛśantyā anartham eva me 'ṅgāni kurvanti /]	etām manoramām spṛśantyāḥ anartham eva me ṅgāni kurvanti 
SA_GK20_hpriydpu-1153	Vāsavadattā -(sahasotthāya /	vāsavadattā sahasā utthāya 
SA_GK20_hpriydpu-1154	) bhaavadi pekkha tumaṃ /	bhaavadi pekkha tumam 
SA_GK20_hpriydpu-1155	ahaṃ uṇa aliaṃ ṇa pāremi pekkhiduṃ /	aham uṇa aliam ṇa pāremi pekkhidum 
SA_GK20_hpriydpu-1156	[bhagavati paśya tvam /	bhagavati paśya tvam 
SA_GK20_hpriydpu-1157	ahaṃ punar alīkaṃ na pārayāmi prekṣitum /]	aham punar alīkam na pārayāmi prekṣitum 
SA_GK20_hpriydpu-1158	Sāṅkṛtyāyanī - rājaputri dharmaśāstravihita eṣa gāndharvo vivāhaḥ /	sāṅkṛtyāyanī rāja putri dharma śāstra vihitaḥ eṣa gāndharvaḥ vivāhaḥ 
SA_GK20_hpriydpu-1159	kim atra lajjāsthānam /	kim atra lajjā sthānam 
SA_GK20_hpriydpu-1160	prekṣaṇīyakam idam /	prekṣaṇīyakam idam 
SA_GK20_hpriydpu-1161	tan na yuktam asthāne rasabhaṅgaṃ kṛtvā gantum /	tat na yuktam asthāne rasa bhaṅgam kṛtvā gantum 
SA_GK20_hpriydpu-1162	(Vāsavadattā parikrāmati /)	vāsavadattā parikrāmati 
SA_GK20_hpriydpu-1163	Indīvarikā - (vilokya /	indīvarikā vilokya 
SA_GK20_hpriydpu-1164	) bhaṭṭiṇi Vasantao cittasālāduvāre pasutto ciṭṭhai /	bhaṭṭiṇi cittasālā duvāre pasutto ciṭṭhai 
SA_GK20_hpriydpu-1165	[bhaṭṭini Vasantakaś citraśālādvāre prasuptas tiṣṭhati /]	bhaṭṭini vasantakaḥ citraśālā dvāre prasuptaḥ tiṣṭhati 
SA_GK20_hpriydpu-1166	Vāsavadattā -(nirūpya /	vāsavadattā nirūpya 
SA_GK20_hpriydpu-1167	) Vasantao evva eso /	vasantao evva esaḥ 
SA_GK20_hpriydpu-1168	(vicintya /	vicintya 
SA_GK20_hpriydpu-1169	) raṇṇā vi ettha hodavvaṃ /	raṇṇā vi ettha hodavvam 
SA_GK20_hpriydpu-1170	tā bodhia pucchissaṃ dāva ṇaṃ /	tā bodhia pucchissam dāva ṇam 
SA_GK20_hpriydpu-1171	[Vasantaka evaiṣaḥ /	vasantakaḥ eva eṣaḥ 
SA_GK20_hpriydpu-1172	(vicintya /	vicintya 
SA_GK20_hpriydpu-1173	) rājñāpy atra bhavitavyam /	rājñā api atra bhavitavyam 
SA_GK20_hpriydpu-1174	tad bodhayitvā prakṣyāmi tāvad enam /]	tat bodhayitvā prakṣyāmi tāvat enam 
SA_GK20_hpriydpu-1175	(prabodhayati /)	prabodhayati 
SA_GK20_hpriydpu-1176	vidūṣakaḥ - (nidrājaḍam utthāya sahasā vilokya /	vidūṣakaḥ nidrā jaḍam utthāya sahasā vilokya 
SA_GK20_hpriydpu-1177	) Maṇorame kiṃ ṇaccia āado piavaasso /	maṇorame kim ṇaccia āadaḥ pia vaassaḥ 
SA_GK20_hpriydpu-1178	ādu ṇaccadi evva /	ā tu ṇa c ca di evva 
SA_GK20_hpriydpu-1179	[Manorame kiṃ nartitv āgataḥ priyavayasyaḥ /	manorame kim nartitu āgataḥ priya vayasyaḥ 
SA_GK20_hpriydpu-1180	athavā nṛtyaty eva /]	athavā nṛtyati eva 
SA_GK20_hpriydpu-1181	Vāsavadattā -(saviṣādam)	vāsavadattā sa viṣādam 
SA_GK20_hpriydpu-1182	kahaṃ ajjautto ṇaccadi /	kaham ajjauttaḥ 
SA_GK20_hpriydpu-1183	Maṇoramā dāṇiṃ kahiṃ /	maṇoramā dāṇim kahim 
SA_GK20_hpriydpu-1184	[katham āryaputro nṛtyati /	katham āryaputraḥ nṛtyati 
SA_GK20_hpriydpu-1185	Manoramedānīṃ kutra /]	manoramā idānīm kutra 
SA_GK20_hpriydpu-1186	vidūṣakaḥ - esā cittasālāe ciṭṭhai /	vidūṣakaḥ esā citta sālāe ciṭṭhai 
SA_GK20_hpriydpu-1187	[eṣā citraśālāyāṃ tiṣṭhati /]	eṣā citra śālāyām tiṣṭhati 
SA_GK20_hpriydpu-1188	Manoramā - (sabhayam ātmagatam /	manoramā sa bhayam ātma gatam 
SA_GK20_hpriydpu-1189	) kahaṃ aṇṇahā evva hiae karia devīe mantidaṃ /	kaham aṇṇahā evva hiae devīe mantidam 
SA_GK20_hpriydpu-1190	edeṇa vi mukkhabaḍueṇa aṇṇahā evva buddhia savvaṃ āulīkidaṃ /	edeṇa vi mukkha baḍueṇa aṇṇahā evva buddhia savvam āulīkidam 
SA_GK20_hpriydpu-1191	[p. 42] [katham anyathaiva hṛdaye kṛtvā devyā mantritam /	katham anyathā eva hṛdaye kṛtvā devyā mantritam 
SA_GK20_hpriydpu-1192	etenāpi mūrkhabaṭukenānyathaiva buddhvā sarvam ākulīkṛtam /]	etena api mūrkha baṭukena anyathā eva buddhvā sarvam ākulīkṛtam 
SA_GK20_hpriydpu-1193	Vāsavadattā -(saroṣaṃ hasantī /	vāsavadattā sa roṣam hasantī 
SA_GK20_hpriydpu-1194	) sāhu Maṇorame sāhu /	sāhu maṇorame sāhu 
SA_GK20_hpriydpu-1195	sohaṇaṃ tue ṇaccidaṃ /	sohaṇam tue 
SA_GK20_hpriydpu-1196	[sādhu Manorame sādhu /	sādhu manorame sādhu 
SA_GK20_hpriydpu-1197	śobhanaṃ tvayā nartitam /]	śobhanam tvayā nartitam 
SA_GK20_hpriydpu-1198	Manoramā - (sabhayaṃ kampamānā pādayor nipatya /	manoramā sa bhayam kampamānā pādayoḥ nipatya 
SA_GK20_hpriydpu-1199	) bhaṭṭiṇi ṇa hu ahaṃ ettha avarajjhāmi /	bhaṭṭiṇi ṇa hu aham ettha avarajjhāmi 
SA_GK20_hpriydpu-1200	edeṇa kkhu hadāseṇa balādo alaṃkaraṇāiṃ geṇhia duvāraṭṭhideṇa iha ṇiruddhā /	edeṇa kkhu hadāseṇa balādaḥ alaṃkaraṇāim geṇhia duvāra ṭṭhideṇa iha niruddhā 
SA_GK20_hpriydpu-1201	ṇa uṇa maha akkandantīe saddo muraṇigghosantarido keṇa vi sudo /	ṇa uṇa maha akkandantīe saddaḥ keṇa vi sudaḥ 
SA_GK20_hpriydpu-1202	[bhaṭṭini na khalv aham atrāparādhyāmi /	bhaṭṭini na khalu aham atra aparādhyāmi 
SA_GK20_hpriydpu-1203	etena khalu hatāśena balād alaṃkaraṇāni gṛhītvā dvārasthiteneha niruddhā /	etena khalu hata āśena balāt alaṃkaraṇāni gṛhītvā dvāra sthitena iha niruddhā 
SA_GK20_hpriydpu-1204	na punar mamākrandantyāḥ śabdo murajanirghoṣāntaritaḥ kenāpi śrutaḥ /]	na punar mama ākrandantyāḥ śabdaḥ muraja nirghoṣa antaritaḥ kena api śrutaḥ 
SA_GK20_hpriydpu-1205	Vāsavadattā - hanje uṭṭhehi /	vāsavadattā hanje uṭṭhehi 
SA_GK20_hpriydpu-1206	jāṇidaṃ savvaṃ /	jāṇidam savvam 
SA_GK20_hpriydpu-1207	Vasantao kkhu Āraṇṇiāvuttantaṇāḍae suttadhāro /	vasantao kkhu suttadhāro 
SA_GK20_hpriydpu-1208	[hañje uttiṣṭha /	hañje uttiṣṭha 
SA_GK20_hpriydpu-1209	jñātaṃ sarvam /	jñātam sarvam 
SA_GK20_hpriydpu-1210	vasantakaḥ khalv Āraṇyikāvṛttāntanāṭake sūtradhāraḥ /]	vasantakaḥ khalu āraṇyikā vṛttānta nāṭake sūtradhāraḥ 
SA_GK20_hpriydpu-1211	vidūṣakaḥ - saaṃ evva cintehi /	vidūṣakaḥ saam evva cintehi 
SA_GK20_hpriydpu-1212	kahiṃ Āraṇṇiā kahiṃ Vasantao tti /	kahim āraṇṇiā kahim vasantao tti 
SA_GK20_hpriydpu-1213	[svayam eva cintaya /	svayam eva cintaya 
SA_GK20_hpriydpu-1214	kutrāraṇyikā kutra Vasantaka iti /]	kutra araṇyikā kutra vasantakaḥ iti 
SA_GK20_hpriydpu-1215	Vāsavadattā - Maṇorame suggahīdaṃ karia ṇaṃ āaccha dāva /	vāsavadattā maṇorame suggahīdam karia naṃ āaccha dāva 
SA_GK20_hpriydpu-1216	pekkhaṇīaṃ se pekkhamhi /	pekkhaṇīam se 
SA_GK20_hpriydpu-1217	[Manorame sugṛhītaṃ kṛtvainam āgaccha tāvat /	manorame su gṛhītam kṛtvā enam āgaccha tāvat 
SA_GK20_hpriydpu-1218	prekṣaṇīyam asya paśyāmi /]	prekṣaṇīyam asya paśyāmi 
SA_GK20_hpriydpu-1219	Manoramā - (svagatam /	manoramā svagatam 
SA_GK20_hpriydpu-1220	) dāṇiṃ samassasida mhi /	dāṇim samassasida mhi 
SA_GK20_hpriydpu-1221	(vidūṣakaṃ kare badhnāti /	vidūṣakam kare badhnāti 
SA_GK20_hpriydpu-1222	prakāśam /	prakāśam 
SA_GK20_hpriydpu-1223	) hadāsa dāṇiṃ aṇubhava attaṇo duṇṇaassa phalaṃ /	hadāsa dāṇim aṇubhava attaṇaḥ duṇṇaassa phalam 
SA_GK20_hpriydpu-1224	[idānīṃ samāśvasitāsmi /	idānīm samāśvasitā asmi 
SA_GK20_hpriydpu-1225	(vidūṣakaṃ kare badhnāti /	vidūṣakam kare badhnāti 
SA_GK20_hpriydpu-1226	prakāśam /	prakāśam 
SA_GK20_hpriydpu-1227	) hatāśa idānīm anubhavātmano durnayasya phalam /]	hata āśaḥ idānīm anubhava ātmanaḥ durnayasya phalam 
SA_GK20_hpriydpu-1228	Vāsavadattā - (sasaṃbhramam upasṛtya /	vāsavadattā sa saṃbhramam upasṛtya 
SA_GK20_hpriydpu-1229	) ajjautta paḍihadaṃ edaṃ amaṅgalaṃ /	ajjautta paḍihadam edam amaṅgalam 
SA_GK20_hpriydpu-1230	(iti pādayor nīlotpaladāmāpanayantī sotprāsam /	iti pādayoḥ nīlotpala dāmā apanayantī sa utprāsam 
SA_GK20_hpriydpu-1231	) marisadu ajjautto jaṃ Maṇorame tti karia ṇīluppaladāmaeṇa bandhāvido si /	ajjauttaḥ jam maṇorame tti karia ṇīla uppala dāmaeṇa bandhāvidaḥ si 
SA_GK20_hpriydpu-1232	[āryaputra pratihastam etad a(maṅgalam /	ārya putra pratihastam etat amaṅgalam 
SA_GK20_hpriydpu-1233	(iti pādayor nīlotpaladāmāpanayantī sotprāsam /	iti pādayoḥ nīlotpala dāmā apanayantī sa utprāsam 
SA_GK20_hpriydpu-1234	) marṣatv āryaputro yan Manorameti kṛtvā nīlotpaladāmakena bandhito 'si /]	marṣatu āryaputraḥ yat manoramā iti kṛtvā nīlotpala dāmakena bandhitaḥ si 
SA_GK20_hpriydpu-1235	(Āraṇyikā sabhayam apasṛtya tiṣṭhati /)	āraṇyikā sa bhayam apasṛtya tiṣṭhati 
SA_GK20_hpriydpu-1236	[p. 43]	p 
SA_GK20_hpriydpu-1237	rājā - (sahasotthāya vidūṣakam Manoramāṃ ca dṛṣṭvātmagatam /	rājā sahasā utthāya vidūṣakam manoramām ca dṛṣṭvā ātma gatam 
SA_GK20_hpriydpu-1238	) kathaṃ vijñāto 'smi devyā /	katham vijñātaḥ smi devyā 
SA_GK20_hpriydpu-1239	(vailakṣyaṃ nāṭayati /)	vailakṣyam nāṭayati 
SA_GK20_hpriydpu-1240	Sāṅkṛtyāyanī - (sarvān avalokya sasmitam /	sāṅkṛtyāyanī sarvān avalokya sa smitam 
SA_GK20_hpriydpu-1241	) katham anyad evedaṃ prekṣaṇīyakaṃ saṃvṛttam /	katham anyat eva idam prekṣaṇīyakam saṃvṛttam 
SA_GK20_hpriydpu-1242	abhūmir iyam asmadvidhānām /	abhūmiḥ iyam asmadvidhānām 
SA_GK20_hpriydpu-1243	(iti niṣkrāntā /)	iti niṣkrāntā 
SA_GK20_hpriydpu-1244	rājā - (svagatam /	rājā svagatam 
SA_GK20_hpriydpu-1245	) apūrvo 'yaṃ kopaprakāraḥ /	apūrvaḥ yam kopa prakāraḥ 
SA_GK20_hpriydpu-1246	durlabham atrānunayaṃ paśyāmi /	durlabham atra anunayam paśyāmi 
SA_GK20_hpriydpu-1247	(vicintya /	vicintya 
SA_GK20_hpriydpu-1248	) evaṃ tāvat kariṣye /	evam tāvat kariṣye 
SA_GK20_hpriydpu-1249	(prakāśam /	prakāśam 
SA_GK20_hpriydpu-1250	) devi tyajyatāṃ kopaḥ /	devi tyajyatām kopaḥ 
SA_GK20_hpriydpu-1251	Vāsavadattā -ajjautta ko ettha kuvido [āryaputra ko 'tra kupitaḥ /]	vāsavadattā ajjautta kaḥ ettha kuvidaḥ āryaputra kaḥ tra kupitaḥ 
SA_GK20_hpriydpu-1252	rājā - kathaṃ na kupitāsi /	rājā katham na kupitā asi 
SA_GK20_hpriydpu-1253	snigdhaṃ yady api vīkṣitaṃ nayanayos tāmrā tathāpi dyutir	snigdham yadi api vīkṣitam nayanayoḥ tāmrā tathā api dyutiḥ 
SA_GK20_hpriydpu-1254	mādhurye 'pi sati skhalaty anupadaṃ te gadgadā vāg iyam /	mādhurye sati skhalati anupadam te gadgadā vāc iyam 
SA_GK20_hpriydpu-1255	niśvāsā niyatā api stanabharotkampena saṃlakṣitāḥ	niśvāsāḥ niyatāḥ api stana bhara utkampena saṃlakṣitāḥ 
SA_GK20_hpriydpu-1256	kopas te prakaṭaprayatnavidhṛto 'py eṣa sphuṭaṃ lakṣyate // HPri_3.13 //	kopaḥ te prakaṭa prayatna vidhṛtaḥ pi eṣa sphuṭam lakṣyate 
SA_GK20_hpriydpu-1257	(pādayor nipatya)	pādayoḥ nipatya 
SA_GK20_hpriydpu-1258	prasīda priye prasīda /	prasīda priye prasīda 
SA_GK20_hpriydpu-1259	Vāsavadattā - Āraṇṇie tumaṃ kuvida tti saṃbhāvaanto ajjautto pie pasīda tti pasādaadi /	vāsavadattā āraṇṇie tumam kuvida tti saṃbhāvaantaḥ ajjauttaḥ pie pasīda tti 
SA_GK20_hpriydpu-1260	tā uvasappa /	tāḥ uvasappa 
SA_GK20_hpriydpu-1261	[Āraṇyike tvaṃ kupiteti saṃbhāvayann āryaputraḥ priye prasīdeti prasādayati /	āraṇyike tvam kupitā iti saṃbhāvayan āryaputraḥ priye prasīda iti prasādayati 
SA_GK20_hpriydpu-1262	tad upasarpa /]	tat upasarpa 
SA_GK20_hpriydpu-1263	(iti hastenākarṣati /)	iti hastena ākarṣati 
SA_GK20_hpriydpu-1264	Āraṇyikā - (sabhayam /	āraṇyikā sabhayam 
SA_GK20_hpriydpu-1265	) bhaṭṭiṇi ṇa hu ahaṃ kiṃ vi jāṇāmi /	bhaṭṭiṇi ṇa hu aham kim vi jāṇāmi 
SA_GK20_hpriydpu-1266	[bhaṭṭini na khalv ahaṃ kimapi jānāmi /]	bhaṭṭini na khalu aham kim api jānāmi 
SA_GK20_hpriydpu-1267	Vāsavadattā - Āraṇṇie tumaṃ kahaṃ ṇa āṇāsi /	vāsavadattā āraṇṇie tumam kaham ṇaḥ āṇāsi 
SA_GK20_hpriydpu-1268	dāṇiṃ de sikkhāvemi /	dāṇim de sikkhāvemi 
SA_GK20_hpriydpu-1269	Indīvarie geṇha edaṃ /	indīvarie geṇhe ā idam 
SA_GK20_hpriydpu-1270	[Āraṇyike tvaṃ kathaṃ na jānāsi /	āraṇyike tvam katham na jānāsi 
SA_GK20_hpriydpu-1271	idānīṃ te śikṣayāmi /	idānīm te śikṣayāmi 
SA_GK20_hpriydpu-1272	Indīvarike gṛhāṇainām /]	indīvarike gṛhāṇa enām 
SA_GK20_hpriydpu-1273	vidūṣakaḥ - hodi ajja komudīmahūsave tuha cittaṃ avahariduṃ vaasseṇa pekkhaṇīaṃ aṇuciṭṭhidaṃ /	vidūṣakaḥ hodi ajja komudī mahūsave tuha cittam avaharidum vaasseṇa pekkhaṇīam aṇuciṭṭhidam 
SA_GK20_hpriydpu-1274	[bhavati adya kaumudīmahotsave tava cittam apahartuṃ vayasyena prekṣaṇīyam anuṣṭhitam /]	bhavati adya kaumudī mahā utsave tava cittam apahartum vayasyena prekṣaṇīyam anuṣṭhitam 
SA_GK20_hpriydpu-1275	[p. 44]	p 
SA_GK20_hpriydpu-1276	Vāsavadattā - edaṃ tuṃhāṇaṃ duṇṇaaṃ pekkhia hāso me jāadi /	vāsavadattā ā idam tuṃhāṇam duṇṇaam pekkhia hāsaḥ me jāadi 
SA_GK20_hpriydpu-1277	[etaṃ yuṣmākaṃ durnayaṃ prekṣya hāso me jāyate /]	etam yuṣmākam durnayam prekṣya hāsaḥ me jāyate 
SA_GK20_hpriydpu-1278	rājā - devi alam anyathā vikalpitena / paśya /	rājā devi alam anyathā vikalpitena paśya 
SA_GK20_hpriydpu-1279	bhrūbhaṅgaiḥ kriyate lalāṭaśaśinaḥ kasmāt kalaṅko mudhā	bhrū bhaṅgaiḥ kriyate lalāṭa śaśinaḥ kasmāt kalaṅkaḥ mudhā 
SA_GK20_hpriydpu-1280	vātākampitabandhujīvasamatāṃ nīto 'dharaḥ kiṃ sphuran /	vāta akampita bandhujīva sama tām nītaḥ dharaḥ kim sphuran 
SA_GK20_hpriydpu-1281	madhyaś cādhikakampitastanabhareṇāyam punaḥ khidyate	madhyaḥ ca adhika kampita stana bhareṇa ayam punar khidyate 
SA_GK20_hpriydpu-1282	kopam muñca tavaiva cittaharaṇāyaitan mayā krīḍitam // HPri_3.14 //	kopam muñca tava eva citta haraṇāya etat mayā krīḍitam 
SA_GK20_hpriydpu-1283	devi prasīda prasīda /	devi prasīda prasīda 
SA_GK20_hpriydpu-1284	(iti pādayoḥ patati /)	iti pādayoḥ patati 
SA_GK20_hpriydpu-1285	Vāsavadattā - hanje ṇivuttaṃ pekkhaṇaaṃ /	vāsavadattā hanje ṇivuttam pekkhaṇaam 
SA_GK20_hpriydpu-1286	tā ehi /	tāḥ ehi 
SA_GK20_hpriydpu-1287	abbhantaraṃ evva pavisamha /	abbhantaram evva pavisamha 
SA_GK20_hpriydpu-1288	[hañje nivṛttaṃ prekṣaṇakam /	hañje nivṛttam prekṣaṇakam 
SA_GK20_hpriydpu-1289	tad ehi /	tat ehi 
SA_GK20_hpriydpu-1290	abhyantaram eva praviśāvaḥ /]	abhyantaram eva praviśāvaḥ 
SA_GK20_hpriydpu-1291	(iti niṣkrāntā /)	iti niṣkrāntā 
SA_GK20_hpriydpu-1292	iti garbhanāṭakam /	iti garbhanāṭakam 
SA_GK20_hpriydpu-1293	rājā - (vilokya /	rājā vilokya 
SA_GK20_hpriydpu-1294	) katham akṛtvaiva prasādaṃ gatā devī /	katham a kṛtvā eva prasādam gatā devī 
SA_GK20_hpriydpu-1295	svedāmbhaḥkaṇabhinnabhīṣaṇatarabhrūbhaṅgam ekaṃ ruṣā	sveda ambhaḥ kaṇa bhinna bhīṣaṇatara bhrū bhaṅgam ekam ruṣā 
SA_GK20_hpriydpu-1296	trāsenāparam utplutotplutamṛgavyālolanetrotpalam /	trāsena aparam utpluta utpluta mṛga vyālola netra utpalam 
SA_GK20_hpriydpu-1297	utpaśyann aham agrato mukham idaṃ devyāḥ priyāyās tathā	utpaśyan aham agratas mukham idam devyāḥ priyāyāḥ tathā 
SA_GK20_hpriydpu-1298	bhītaś cotsukamānasaś ca mahati kṣipto 'smy ahaṃ saṃkaṭe // HPri_3.15 //	bhītaḥ ca utsuka mānasaḥ ca mahati kṣiptaḥ smi aham saṃkaṭe 
SA_GK20_hpriydpu-1299	tad yāvad idānīṃ śayanīyaṃ gatvā devyāḥ prasādanopāyaṃ cintayāmi /	tat yāvat idānīm śayanīyam gatvā devyāḥ prasādana upāyam cintayāmi 
SA_GK20_hpriydpu-1300	(iti niṣkrāntāḥ sarve /)	iti niṣkrāntāḥ sarve 
SA_GK20_hpriydpu-1301	iti tṛtiyo 'ṅkaḥ / *	iti tṛtiyaḥ ṅkaḥ 
SA_GK20_hpriydpu-1302	[p. 45]	p 
SA_GK20_hpriydpu-1303	cathurtho 'ṅkaḥ	cathurthaḥ ṅkaḥ 
SA_GK20_hpriydpu-1304	(tataḥ praviśati Manoramā)	tatas praviśati manoramā 
SA_GK20_hpriydpu-1305	Manoramā - (sodvegam /	manoramā sa udvegam 
SA_GK20_hpriydpu-1306	) aho diggharosadā devīe /	aho diggharosadā devīe 
SA_GK20_hpriydpu-1307	ettiaṃ kālaṃ baddhāe piasahīe Āraṇṇiāe uvari aṇukampaṃ ṇa geṇhai /	ettiam kālam baddhāe piasahīe āraṇṇiāe uvari anukampam na geṇhai 
SA_GK20_hpriydpu-1308	sā tavassiṇī attaṇo bandhaṇassa kileseṇa taha ṇa saṃtappadi jaha bhaṭṭiṇo daṃsaṇaṇirāsadāe /	sā tavassiṇī bandhaṇassa kileseṇa taha ṇa saṃtappadi jaha bhaṭṭiṇaḥ daṃsaṇa nirāsa dāe 
SA_GK20_hpriydpu-1309	īrisaṃ ca se dukkhaṃ jeṇa ajja evva attāṇaṃ vāvādaantī mae kahaṃ vi ṇivāridā /	īrisam ca se dukkham jeṇa ajja evva attānam mae kaham vi nivāridā 
SA_GK20_hpriydpu-1310	edaṃ uttantaṃ bhaṭṭiṇo ṇivedehi tti Vasantaaṃ bhaṇia āada mhi /	edam uttantam bhaṭṭiṇaḥ nivedehi tti vasantaam bhaṇia mhi 
SA_GK20_hpriydpu-1311	[aho dīrgharoṣatā devyāḥ /	aho dīrgha roṣa tā devyāḥ 
SA_GK20_hpriydpu-1312	etāvantaṃ kālaṃ baddhāyā api priyasakhyā Āraṇyikāyā upary anukampāṃ na gṛhṇāti /	etāvantam kālam baddhāyāḥ api priya sakhyāḥ āraṇyikāyāḥ upari anukampām na gṛhṇāti 
SA_GK20_hpriydpu-1313	sā tapasviny ātmano bandhanasya kleśena tathā na saṃtapyate yathā bhartur darśananirāśatayā /	sā tapasvinī ātmanaḥ bandhanasya kleśena tathā na saṃtapyate yathā bhartuḥ darśana nirāśa tayā 
SA_GK20_hpriydpu-1314	īdṛśaṃ cāsyā duḥkhaṃ yenādyaivātmānaṃ vyāpādayantī mayā katham api nivāritā /	īdṛśam ca asyāḥ duḥkham yena adya eva ātmānam vyāpādayantī mayā katham api nivāritā 
SA_GK20_hpriydpu-1315	etaṃ vṛttāntaṃ bhartre nivedayeti Vasantakaṃ bhaṇitvāgatāsmi /	etam vṛttāntam bhartre nivedaya iti vasantakam bhaṇitvā āgatā asmi 
SA_GK20_hpriydpu-1316	(tataḥ praviśati Kāñcanamālā /)	tatas praviśati kāñcanamālā 
SA_GK20_hpriydpu-1317	Kāñcanamālā - kahaṃ aṇṇesantīe vi mae bhaavaī Saṃkiccāaṇī ṇa diṭṭhā /	kāñcanamālā kaham anṇesantīe vi mae bhaavaī ṇa diṭṭhā 
SA_GK20_hpriydpu-1318	tā edaṃ vi dāva Maṇoramaṃ pucchissam /	tā ā idam vi dāva maṇoramam pucchissam 
SA_GK20_hpriydpu-1319	(upasṛtya /	upasṛtya 
SA_GK20_hpriydpu-1320	) Maṇorame avi jāṇāsi kahiṃ bhaavaī Saṃkiccāaṇi tti /	maṇorame avi jāṇāsi kahim bhaavaī tti 
SA_GK20_hpriydpu-1321	[kathaṃ anviṣyantyāpi mayā bhagavatī Sāṅkṛtyāyanī na dṛṣṭā /	katham anviṣyantyā api mayā bhagavatī sāṅkṛtyāyanī na dṛṣṭā 
SA_GK20_hpriydpu-1322	(vilokya/	vilokya 
SA_GK20_hpriydpu-1323	) tad etām api tāvan Manoramāṃ prakṣyāmi /	tat etām api tāvat manoramām prakṣyāmi 
SA_GK20_hpriydpu-1324	(upasṛtya /	upasṛtya 
SA_GK20_hpriydpu-1325	) Manorame api jānāsi kutra bhagavatī Sāṅkṛtyāyanīti /]	manorame api jānāsi kutra bhagavatī sāṅkṛtyāyanī iti 
SA_GK20_hpriydpu-1326	Manoramā - (vilokyāśrūṇi pramṛjya /	manoramāḥ vilokya aśrūṇi pramṛjya 
SA_GK20_hpriydpu-1327	) halā Kancaṇamāle diṭṭhā /	halā kancaṇa māle diṭṭhā 
SA_GK20_hpriydpu-1328	kim uṇa tāe paoaṇam /	kim uṇa tāe paoaṇam 
SA_GK20_hpriydpu-1329	[halā Kāñcanamāle dṛṣṭā /	halā kāñcanamāle dṛṣṭā 
SA_GK20_hpriydpu-1330	kiṃ punas tayā prayojanam /]	kim punar tayā prayojanam 
SA_GK20_hpriydpu-1331	Kāñcanamālā - Maṇorame ajja devīe Aṃgāravadīe leho pesido /	kāñcanamālā maṇorame ajja devīe aṃgāravadīe lehaḥ pesidaḥ 
SA_GK20_hpriydpu-1332	tassi vācide bappha- puṇṇaṇaaṇā diḍhaṃ saṃtappiduṃ āraddhā devī /	tassi vācide bappha puṇṇa naaṇā diḍham saṃtappidum āraddhā devī 
SA_GK20_hpriydpu-1333	tā viṇodaṇaṇimittaṃ tāe bhaavadiṃ aṇṇesāmi /	tā viṇodaṇa nimittam tāe bhaavadim aṇṇesāmi 
SA_GK20_hpriydpu-1334	[Manorame adya devyāṅgāravatyā lekhaḥ preṣitaḥ /	manorame adya devyā aṅgāravatyā lekhaḥ preṣitaḥ 
SA_GK20_hpriydpu-1335	tasmin vācite bāṣpapūrṇanayanā dṛḍhaṃ saṃtaptum ārabdhā devī /	tasmin vācite bāṣpa pūrṇa nayanā dṛḍham saṃtaptum ārabdhā devī 
SA_GK20_hpriydpu-1336	tad vinodananimittaṃ tasyā bhagavatīṃ anviṣyāmi /]	tat vinodana nimittam tasyāḥ bhagavatīm anviṣyāmi 
SA_GK20_hpriydpu-1337	[p. 46]	p 
SA_GK20_hpriydpu-1338	Manoramā - halā kiṃ uṇa tassiṃ lehe ālihidaṃ /	manoramā halā kim uṇa tassim lehe ālihidam 
SA_GK20_hpriydpu-1339	[halā kiṃ punas tasmiṃl lekha ālikhitam /]	halā kim punar tasmin lekhe ālikhitam 
SA_GK20_hpriydpu-1340	Kāñcanamālā - jā maha bhaiṇī sā tava jaṇaṇī evva /	kāñcanamālā jā maha bhaiṇī sā tava jaṇaṇī evva 
SA_GK20_hpriydpu-1341	tāe bhattā Diḍhavammā tādo de /	tāe bhattā diḍhavammā tādaḥ de 
SA_GK20_hpriydpu-1342	tā tava kiṃ edaṃ āakkhidavvaṃ /	tā tava kim edam āakkhidavvam 
SA_GK20_hpriydpu-1343	tassa samahiaṃ saṃvaccharaṃ Kaliṃgahadaeṇa baddhassa /	tassa samahiam saṃvaccharam kaliṃga hadaeṇa baddhassa 
SA_GK20_hpriydpu-1344	tā ṇa juttaṃ edaṃ uttantaṃ aṇiṭṭhaṃ suṇia samīvaṭṭhidassa samatthassa bhattuṇo de evvam udāsīṇattaṇaṃ olambiduṃ tti /	tā ṇa juttam edam uttantam aṇiṭṭham suṇia samīva ṭṭhidassa samatthassa bhattuṇaḥ de evvam udāsīṇa ttaṇam olambidum tti 
SA_GK20_hpriydpu-1345	[yā mama bhaginī sā tava janany eva /	yā mama bhaginī sā tava jananī eva 
SA_GK20_hpriydpu-1346	tasyā bhartā Dṛḍhavarmā tātas te /	tasyāḥ bhartā dṛḍhavarmā tātaḥ te 
SA_GK20_hpriydpu-1347	tat tava kim etad ākhyātavyaṃ /	tat tava kim etat ākhyātavyam 
SA_GK20_hpriydpu-1348	tasya samadhikaṃ saṃvatsaraṃ Kaliṅgahatakena baddhasya /	tasya samadhikam saṃvatsaram kaliṅgahatakena baddhasya 
SA_GK20_hpriydpu-1349	tan na yuktam etaṃ vṛttāntam aniṣṭaṃ śrutvā samīpa sthitasya samarthasya bhartus ta evam udāsīnatvam avalambitum iti /]	tat na yuktam etam vṛttāntam aniṣṭam śrutvā samīpa sthitasya samarthasya bhartuḥ te evam udāsīna tvam avalambitum iti 
SA_GK20_hpriydpu-1350	Manoramā - halā Kancaṇamāle /	manoramā 
SA_GK20_hpriydpu-1351	jadā dāva aaṃ uttanto bhaṭṭiṇīe ṇa keṇa vi viṇṇaviidavvo tti bhaṭṭiṇā āṇattaṃ tā keṇa uṇa dāṇiṃ so leho suṇāvido /	jadā dāva aam uttantaḥ bhaṭṭiṇīe ṇa keṇa vi tti bhaṭṭiṇā āṇattam tā keṇa uṇa dāṇim saḥ lehaḥ 
SA_GK20_hpriydpu-1352	[halā Kāñcanamāle /	halā kāñcanamāle 
SA_GK20_hpriydpu-1353	yadā tāvad ayaṃ vṛttānto bhaṭṭinyai na kenāpi vijñāpitavya iti bhartrājñaptaṃ tat kena punar idānīṃ sa lekhaḥ śrāvitaḥ /]	yadā tāvat ayam vṛttāntaḥ bhaṭṭinyai na kena api vijñāpitavyaḥ iti bhartrā ājñaptam tat kena punar idānīm sa lekhaḥ śrāvitaḥ 
SA_GK20_hpriydpu-1354	Kāñcanamālā - aṇuvāia tuṇhīṃ (sic)	kāñcanamālā tuṇhīm sic 
SA_GK20_hpriydpu-1355	bhūdāe maha hatthādo geṇhia saaṃ evva bhaṭṭiṇīe vāido /	bhūdāe maha hatthādaḥ geṇhia saam evva bhaṭṭiṇīe vāidaḥ 
SA_GK20_hpriydpu-1356	[anuvācya tūṣṇīṃ bhūtāyā mama hastād gṛhītvā svayam eva bhaṭṭiṇyā vācitaḥ /]	anuvācya tūṣṇīm bhūtāyāḥ mama hastāt gṛhītvā svayam eva bhaṭṭiṇyā vācitaḥ 
SA_GK20_hpriydpu-1357	Manoramā - teṇa gaccha tumaṃ /	manoramā teṇa gaccha tumam 
SA_GK20_hpriydpu-1358	esā kkhu devī tāe evva saha dantavalahīe ciṭṭhai /	esā kkhu devī tāe evva saha dantavalahīe ciṭṭhai 
SA_GK20_hpriydpu-1359	teṇa gaccha tvaṃ /	teṇa gaccha tvam 
SA_GK20_hpriydpu-1360	[eṣā khalu devī tayaiva saha dantavalabhyāṃ tiṣṭhati /]	eṣā khalu devī tayā eva saha danta valabhyām tiṣṭhati 
SA_GK20_hpriydpu-1361	Kāñcanamālā - teṇa hi bhaṭṭiṇīsaāsaṃ gamissaṃ /	kāñcanamālā teṇa hi bhaṭṭiṇī saāsam gamissam 
SA_GK20_hpriydpu-1362	[tena hi bhaṭṭinīsakāśaṃ gamiṣyāmi /]	tena hi bhaṭṭinī sakāśam gamiṣyāmi 
SA_GK20_hpriydpu-1363	(iti niṣkrāntā /)	iti niṣkrāntā 
SA_GK20_hpriydpu-1364	Manoramā - ciraṃ khu me Āraṇṇiāsaāsādo āadāe /	manoramā ciram khu me āraṇṇi āsa āsādaḥ 
SA_GK20_hpriydpu-1365	diḍhaṃ ca ṇivviṇṇā sā tavassiṇī attaṇo jīvideṇa /	diḍham ca sā tavassiṇī jīvideṇa 
SA_GK20_hpriydpu-1366	kadāi accāhidaṃ bhave /	kadāi bhave 
SA_GK20_hpriydpu-1367	tā tahi evva gacchāmi (Kale : -ahmi) /	tā tahi evva gacchāmi kale ahmi 
SA_GK20_hpriydpu-1368	[ciraṃ khalu ma Āraṇyikāsakāśād āgatāyāḥ /	ciram khalu me āraṇyikā sakāśāt āgatāyāḥ 
SA_GK20_hpriydpu-1369	dṛḍhaṃ ca nirviṇṇā sā tapasviny ātmano jīvitena /	dṛḍham ca nirviṇṇā sā tapasvinī ātmanaḥ jīvitena 
SA_GK20_hpriydpu-1370	kadā cid atyāhitaṃ bhavet /	kadā cit atyāhitam bhavet 
SA_GK20_hpriydpu-1371	tat tatraiva gacchāmi /	tat tatra eva gacchāmi 
SA_GK20_hpriydpu-1372	(iti niṣkrāntā /)	iti niṣkrāntā 
SA_GK20_hpriydpu-1373	(iti praveśakaḥ /)	iti praveśakaḥ 
SA_GK20_hpriydpu-1374	[p. 47]	p 
SA_GK20_hpriydpu-1375	(tataḥ praviśati sodvegāsanasthā Vāsavadattā Sāṅkṛtyāyanī vibhavataś ca parivāraḥ)	tatas praviśati sa udvega āsana sthā vāsavadattā sāṅkṛtyāyanī vibhavataḥ ca parivāraḥ 
SA_GK20_hpriydpu-1376	Sāṅkṛtyāyanī - rājaputri alam udvegena /	sāṅkṛtyāyanī rāja putri alam udvegena 
SA_GK20_hpriydpu-1377	nedṛśo Vatsarājaḥ /	na īdṛśaḥ vatsa rājaḥ 
SA_GK20_hpriydpu-1378	katham itthaṃ gatam api bhavatyā mātṛṣvasṛpatiṃ vijñāya Vatsarājo niścintaṃ sthāsyati /	katham ittham gatam api bhavatyā mātṛṣvasṛ patim vijñāya vatsa rājaḥ niścintam sthāsyati 
SA_GK20_hpriydpu-1379	Vāsavadattā - (sāsram/	vāsavadattā sa asram 
SA_GK20_hpriydpu-1380	) bhaavadi adiujjuā dāṇiṃ tumaṃ /	bhaavadi adi ujjuā dāṇim tumam 
SA_GK20_hpriydpu-1381	jassa mae ṇa kajjaṃ tassa mamakerayeṇa kiṃ kajjaṃ /	jassa mae ṇa kajjam tassa kim kajjam 
SA_GK20_hpriydpu-1382	ajjuāe juttaṃ mama edaṃ ālihiduṃ /	ajjuāe juttam mama ā idam 
SA_GK20_hpriydpu-1383	sā uṇa ṇa āṇādi ajja vi tārisī ṇa Vāsavadatte tti /	sā uṇa naḥ āṇādi ajja vi tārisī na vāsavadatte tti 
SA_GK20_hpriydpu-1384	tuha uṇa edaṃ Āraṇṇiāe uttantaṃ paccakkhaṃ /	tuha uṇa edam āraṇṇiāe uttantam paccakkham 
SA_GK20_hpriydpu-1385	tā kahaṃ edaṃ bhaṇāsi /	tā kaham edam bhaṇāsi 
SA_GK20_hpriydpu-1386	[bhagavati ati(ṛjukedānīṃ tvam /	bhagavati ati ṛjukā idānīm tvam 
SA_GK20_hpriydpu-1387	yasya mayā na kāryaṃ tasya madīyena kiṃ kāryam /	yasya mayā na kāryam tasya madīyena kim kāryam 
SA_GK20_hpriydpu-1388	mātur yuktaṃ mamaitad ālikhituṃ /	mātuḥ yuktam mama etat ālikhitum 
SA_GK20_hpriydpu-1389	sā punar na jānāty adyāpi tādṛśī na Vāsavadatteti /	sā punar na jānāti adya api tādṛśī na vāsavadattā iti 
SA_GK20_hpriydpu-1390	tava punar eṣa Ārāṇyikāvṛttāntaḥ pratyakṣaḥ /	tava punar eṣaḥ ārāṇyikā vṛttāntaḥ pratyakṣaḥ 
SA_GK20_hpriydpu-1391	tat katham etad bhaṇāsi /	tat katham etat bhaṇāsi 
SA_GK20_hpriydpu-1392	Sāṅkṛtyāyanī - yata eva me pratyakṣaṃ tata eva bravīmi /	sāṅkṛtyāyanī yatas eva me pratyakṣam tatas eva bravīmi 
SA_GK20_hpriydpu-1393	tena nanu kaumudīmahotsave tvāṃ hāsayituṃ tathā krīḍitam /	tena nanu kaumudī mahā utsave tvām hāsayitum tathā krīḍitam 
SA_GK20_hpriydpu-1394	Vāsavadattā - bhaavadi edaṃ ettha saccaṃ /	vāsavadattā bhaavadi edam ettha saccam 
SA_GK20_hpriydpu-1395	taha hāsida mhi jeṇa bhaavadīe purado lajjāe kahaṃ vi ciṭṭhāmi /	taha mhi jeṇa bhaavadīe pura daḥ lajjāe kaham vi ciṭṭhāmi 
SA_GK20_hpriydpu-1396	tā kiṃ takkerakāe kahāe /	tā kim takkerakāe kahāe 
SA_GK20_hpriydpu-1397	ṇam edeṇa evva pakkhavādeṇa ettiaṃ bhūmiṃ ṇīda mhi /	ṇam edeṇa evva pakkha vādeṇa ettiam bhūmim mhi 
SA_GK20_hpriydpu-1398	[bhagavati etad atra satyam /	bhagavati etat atra satyam 
SA_GK20_hpriydpu-1399	tathā hāsitāsmi yena bhagavatyāḥ purato lajjayā katham api tiṣṭhāmi /	tathā hāsitā asmi yena bhagavatyāḥ puratas lajjayā katham api tiṣṭhāmi 
SA_GK20_hpriydpu-1400	tat kiṃ tadīyayā kathayā /	tat kim tadīyayā kathayā 
SA_GK20_hpriydpu-1401	nanv etenaiva pakṣapātenaitāvatīṃ bhūmiṃ nītāsmi / (iti roditi /)	nanu etena eva pakṣapātena etāvatīm bhūmim nītā asmi iti roditi 
SA_GK20_hpriydpu-1402	Sāṅkṛtyāyanī - alaṃ rājaputri ruditena /	sāṅkṛtyāyanī alam rāja putri ruditena 
SA_GK20_hpriydpu-1403	nedṛśo Vatsarājaḥ /	na īdṛśaḥ vatsa rājaḥ 
SA_GK20_hpriydpu-1404	(vilokya /	vilokya 
SA_GK20_hpriydpu-1405	) athavā prāpta evāyaṃ yas te manyupramārjanaṃ karoti /	athavā prāptaḥ eva ayam yaḥ te manyu pramārjanam karoti 
SA_GK20_hpriydpu-1406	Vāsavadattā - maṇorahā dāṇiṃ ede bhaavadīe /	vāsavadattā maṇorahā dāṇim ede bhaavadīe 
SA_GK20_hpriydpu-1407	[manorathā idānīm ete bhagavatyāḥ /]	manorathāḥ idānīm ete bhagavatyāḥ 
SA_GK20_hpriydpu-1408	(tataḥ praviśati rājā vidūśakaś ca /)	tatas praviśati rājā vidūśakaḥ ca 
SA_GK20_hpriydpu-1409	rājā - vayasya ka idānīm abhyupāyaḥ priyāṃ mocayitum /	rājā vayasya kaḥ idānīm abhyupāyaḥ priyām mocayitum 
SA_GK20_hpriydpu-1410	vidūṣakaḥ - bho vaassa munca visādaṃ /	vidūṣakaḥ bho vaassa munca visādam 
SA_GK20_hpriydpu-1411	ahaṃ de uvāaṃ kahaissaṃ /	aham de 
SA_GK20_hpriydpu-1412	[bho vayasya muñca viṣādam /	bho vayasya muñca viṣādam 
SA_GK20_hpriydpu-1413	ahaṃ ta upāyaṃ kathayiṣyāmi /]	aham te upāyam kathayiṣyāmi 
SA_GK20_hpriydpu-1414	[p. 48]	p 
SA_GK20_hpriydpu-1415	rājā - (saharṣam)	rājā sa harṣam 
SA_GK20_hpriydpu-1416	vayasya tvaritataram abhidhīyatām /	vayasya tvaritataram abhidhīyatām 
SA_GK20_hpriydpu-1417	vidūṣakaḥ - bho tumaṃ dāva aṇeasamara saṃghaṭṭhappahāvabāhusālī /	vidūṣakaḥ bho tumam dāva anea samara saṃghaṭṭha ppahāva bāhu sālī 
SA_GK20_hpriydpu-1418	puṇo vi aṇeagaaturaapaāiduvvisahabalasamudido /	puṇar vi aṇeaga aturaa paāi duvvisaha bala samudidaḥ 
SA_GK20_hpriydpu-1419	tā savvabalasaṃdoheṇa anteuraṃ supīḍiaṃ karia dāṇim evva Āraṇṇiaṃ muncāvehi /	tā savva bala saṃdoheṇa anteuram su pīḍiam karia dāṇim evva āraṇṇiam 
SA_GK20_hpriydpu-1420	[bho tvaṃ tāvad anekasamarasaṃghaṭṭaprabhāvabāhuśālī /	bho tvam tāvat aneka samara saṃghaṭṭa prabhāva bāhu śālī 
SA_GK20_hpriydpu-1421	punar apy anekagajaturagapadātidurviṣahabalasamuditaḥ /	punar api aneka gaja turaga padāti durviṣaha bala samuditaḥ 
SA_GK20_hpriydpu-1422	tat sarvabalasaṃdohenāntaḥpuraṃ supīḍitaṃ kṛtvedānīm evāraṇyikāṃ mocaya /]	tat sarva bala saṃdohena antaḥpuram su pīḍitam kṛtvā idānīm eva araṇyikām mocaya 
SA_GK20_hpriydpu-1423	rājā - vayasya aśakyam upadiṣṭam /	rājā vayasya aśakyam upadiṣṭam 
SA_GK20_hpriydpu-1424	vidūṣakaḥ - kim ettha asakkaṃ /	vidūṣakaḥ kim ettha 
SA_GK20_hpriydpu-1425	jado dāva kujjavāmaṇabuḍḍhaañcuivajjido maṇusso avaro ṇatthi tarhi /	jadaḥ dāva maṇussaḥ avaraḥ ṇa atthi tarhi 
SA_GK20_hpriydpu-1426	[kim atrāśakyam /	kim atra aśakyam 
SA_GK20_hpriydpu-1427	yatas tāvat kubjavāmanavṛddhakañcukivarjito manuṣyo 'paro nāsti tatra /]	yatas tāvat kubja vāmana vṛddha kañcuki varjitaḥ paraḥ nā asti tatra 
SA_GK20_hpriydpu-1428	rājā - (sāvajñam)	rājā sa avajñam 
SA_GK20_hpriydpu-1429	mūrkha kim asaṃbaddhaṃ pralapasi /	mūrkha kim asaṃbaddham pralapasi 
SA_GK20_hpriydpu-1430	devyāḥ prasādaṃ muktvā nānyas tasyā mokṣaṇābhyupāyaḥ /	devyāḥ prasādam muktvā nā anyaḥ tasyāḥ mokṣaṇa abhyupāyaḥ 
SA_GK20_hpriydpu-1431	tat kathaya kathaṃ devīṃ prasādayāmi /	tat kathaya katham devīm prasādayāmi 
SA_GK20_hpriydpu-1432	vidūṣakaḥ - bho māsovavāsaṃ karia jīvidaṃ dhārehi /	vidūṣakaḥ bho māsopavāsam jīvidam dhārehi 
SA_GK20_hpriydpu-1433	evvaṃ devī Caṇḍī pasīdissadi /	evvam devī caṇḍī pasīdissadi 
SA_GK20_hpriydpu-1434	[bhoḥ māsopavāsaṃ kṛtvā jīvitaṃ dhāraya /	bhoḥ māsopavāsam kṛtvā jīvitam dhāraya 
SA_GK20_hpriydpu-1435	evaṃ devī Caṇḍī prasatsyati /]	evam devī caṇḍī prasatsyati 
SA_GK20_hpriydpu-1436	rājā - (vihasya)	rājā vihasya 
SA_GK20_hpriydpu-1437	alaṃ parihāsena /	alam parihāsena 
SA_GK20_hpriydpu-1438	kathaya kathaṃ devīṃ prasādayāmi /	kathaya katham devīm prasādayāmi 
SA_GK20_hpriydpu-1439	dhṛṣṭaḥ kiṃ purato 'varudhya vihasan gṛhṇāmi kaṇṭhe priyāṃ	dhṛṣṭaḥ kim puratas varudhya vihasan gṛhṇāmi kaṇṭhe priyām 
SA_GK20_hpriydpu-1440	kiṃ vā cāṭuśataprapañcaracanāprītāṃ kariṣyāmi tām /	kim vā cāṭu śata prapañca racanā prītām kariṣyāmi tām 
SA_GK20_hpriydpu-1441	kiṃ tiṣṭhāmi kṛtāñjalir nipatito devyāḥ puraḥ pādayoḥ	kim tiṣṭhāmi kṛtāñjaliḥ nipatitaḥ devyāḥ puras pādayoḥ 
SA_GK20_hpriydpu-1442	satyaṃ satyam aho na vedmy anunayo devyāḥ kathaṃ syād iti // HPri_4.1 //	satyam satyam aho na vedmi anunayaḥ devyāḥ katham syāt iti 
SA_GK20_hpriydpu-1443	[p. 49]	p 
SA_GK20_hpriydpu-1444	tad ehi / devīsakāśam eva gacchāvaḥ /	tat ehi devī sakāśam eva gacchāvaḥ 
SA_GK20_hpriydpu-1445	vidūṣakaḥ - bho gaccha tumaṃ /	vidūṣakaḥ bho gaccha tumam 
SA_GK20_hpriydpu-1446	ahaṃ dāṇiṃ evva bandhaṇādo kahaṃ vi paribbhaṃsia āado mhi /	aham dāṇim evva bandhaṇādaḥ kaham vi paribbhaṃsia āadaḥ mhi 
SA_GK20_hpriydpu-1447	to ṇa gamissaṃ /	to ṇa gamissam 
SA_GK20_hpriydpu-1448	[bhoḥ gaccha tvam /	bhoḥ gaccha tvam 
SA_GK20_hpriydpu-1449	ahaṃ punar idānīm eva bandhanāt katham api paribhraśyāgato 'smi /	aham punar idānīm eva bandhanāt katham api paribhraśya āgataḥ smi 
SA_GK20_hpriydpu-1450	tan na gamiṣyāmi /]	tat na gamiṣyāmi 
SA_GK20_hpriydpu-1451	rājā - (vihasya kaṇṭhe gṛhītvā balān nivartayati /	rājā vihasya kaṇṭhe gṛhītvā balāt nivartayati 
SA_GK20_hpriydpu-1452	) mūrkha āgamyatām āgamyatām /	mūrkhaḥ āgamyatām āgamyatām 
SA_GK20_hpriydpu-1453	(parikramyāvalokya ca)	parikramya avalokya ca 
SA_GK20_hpriydpu-1454	iyaṃ devī dantabalabhīmadhyam adhyāste /	iyam devī danta bala bhī madhyam adhyāste 
SA_GK20_hpriydpu-1455	yāvad upasarpāmi /	yāvat upasarpāmi 
SA_GK20_hpriydpu-1456	(salajjam upasarpati)	sa lajjam upasarpati 
SA_GK20_hpriydpu-1457	(Vāsavadattā sakhedam āsanād uttiṣṭhati /)	vāsavadattā sa khedam āsanāt uttiṣṭhati 
SA_GK20_hpriydpu-1458	rājā -	rājā 
SA_GK20_hpriydpu-1459	kiṃ muktam āsanam alaṃ mayi sambhrameṇa	kim muktam āsanam alam mayi sambhrameṇa 
SA_GK20_hpriydpu-1460	notthātum ittham ucitaṃ mama tāntamadhye /	nā utthātum ittham ucitam mama tānta madhye 
SA_GK20_hpriydpu-1461	dṛṣṭiprasādavidhimātrahṛto jano 'yam	dṛṣṭi prasāda vidhi mātra hṛtaḥ janaḥ yam 
SA_GK20_hpriydpu-1462	atyādareṇa kim iti kriyate vilakṣaḥ // HPri_4.2 //	atyādareṇa kim iti kriyate vilakṣaḥ 
SA_GK20_hpriydpu-1463	Vāsavadattā - (mukhaṃ nirūpya)	vāsavadattā mukham nirūpya 
SA_GK20_hpriydpu-1464	ajjautta vilakkho dāṇiṃ tumaṃ hosi /	ajjautta vilakkhaḥ dāṇim tumam hosi 
SA_GK20_hpriydpu-1465	[āryaputra vilakṣa idānīṃ tvaṃ bhavasi /]	āryaputra vilakṣaḥ idānīm tvam bhavasi 
SA_GK20_hpriydpu-1466	rājā - priye satyam ahaṃ vilakṣaḥ /	rājā priye satyam aham vilakṣaḥ 
SA_GK20_hpriydpu-1467	yat pratyakṣa 'dṛṣṭāparādho 'pi bhavatīṃ prasādayituṃ vyavasito 'smi /	yat bhavatīm prasādayitum vyavasitaḥ smi 
SA_GK20_hpriydpu-1468	Sāṅkṛtyāyanī - (āsanaṃ nirdiśya /	sāṅkṛtyāyanī āsanam nirdiśya 
SA_GK20_hpriydpu-1469	) mahārāja kriyatām āsanaparigrahaḥ /	mahā rāja kriyatām āsana parigrahaḥ 
SA_GK20_hpriydpu-1470	rājā - (āsanaṃ nirdiśya /	rājā āsanam nirdiśya 
SA_GK20_hpriydpu-1471	) ita ito devy upaviśatu /	itas itas devī upaviśatu 
SA_GK20_hpriydpu-1472	(Vāsavadattā bhūmāv upaviśati)	vāsavadattā bhūmau upaviśati 
SA_GK20_hpriydpu-1473	rājā - āḥ kathaṃ bhūmāv upaviṣṭā devī /	rājā āḥ katham bhūmau upaviṣṭā devī 
SA_GK20_hpriydpu-1474	aham apy atraivopaviśāmi /	aham api atra eva upaviśāmi 
SA_GK20_hpriydpu-1475	(iti bhūmāv upaviśya kṛtāñjaliḥ /	iti bhūmau upaviśya kṛtāñjaliḥ 
SA_GK20_hpriydpu-1476	) priye prasīda prasīda /	priye prasīda prasīda 
SA_GK20_hpriydpu-1477	kim evaṃ praṇate 'pi mayi gambhīrataraṃ kopam udvahasi /	kim evam praṇate mayi gambhīrataram kopam udvahasi 
SA_GK20_hpriydpu-1478	[p. 50]	p 
SA_GK20_hpriydpu-1479	bhrūbhaṅgaṃ na karoṣi rodiṣi muhur mugdhekṣaṇe kevalaṃ	bhrū bhaṅgam na karoṣi rodiṣi muhur mugdha īkṣaṇe kevalam 
SA_GK20_hpriydpu-1480	nātiprasphuritādharānavarataṃ niḥśvāsam evojjhasi /	na ati prasphurita adhara anavaratam niḥśvāsam eva ujjhasi 
SA_GK20_hpriydpu-1481	vācaṃ nāpi dadāsi tiṣṭhasi paraṃ pradhyānanamrānanā	vācam nā api dadāsi tiṣṭhasi param pradhyāna namra ānanā 
SA_GK20_hpriydpu-1482	kopas te stimito nipīḍayati māṃ gūḍhaprahāropamaḥ // HPri_4.3 //	kopaḥ te stimitaḥ nipīḍayati mām gūḍha prahāra upamaḥ 
SA_GK20_hpriydpu-1483	priye prasīda prasīda /	priye prasīda prasīda 
SA_GK20_hpriydpu-1484	(iti pādayoḥ patati /)	iti pādayoḥ patati 
SA_GK20_hpriydpu-1485	Vāsavadattā - adisuhido ṇaṃ si /	vāsavadattā adi suhidaḥ ṇam si 
SA_GK20_hpriydpu-1486	kiṃ dāṇiṃ dukkhidaṃ jaṇaṃ viāresi /	kim dāṇim dukkhidam jaṇam viāresi 
SA_GK20_hpriydpu-1487	uṭṭhehi ko ettha kuvido /	uṭṭhehi kaḥ ettha kuvidaḥ 
SA_GK20_hpriydpu-1488	[atisukhito nanv asi /	ati sukhitaḥ nanu asi 
SA_GK20_hpriydpu-1489	kim idānīṃ duḥkhitaṃ janaṃ vikārayasi /	kim idānīm duḥkhitam janam vikārayasi 
SA_GK20_hpriydpu-1490	uttiṣṭha ko 'tra kupitaḥ /]	uttiṣṭha kaḥ tra kupitaḥ 
SA_GK20_hpriydpu-1491	Sāṅkṛtyāyanī - uttiṣṭha mahārāja /	sāṅkṛtyāyanī uttiṣṭha mahā rāja 
SA_GK20_hpriydpu-1492	kim anena /	kim anena 
SA_GK20_hpriydpu-1493	anyad eva tāvad udvegakāraṇam asyāḥ /	anyat eva tāvat udvega kāraṇam asyāḥ 
SA_GK20_hpriydpu-1494	rājā - (sasaṃbhramam /	rājā sa saṃbhramam 
SA_GK20_hpriydpu-1495	) bhagavati kim anyat /	bhagavati kim anyat 
SA_GK20_hpriydpu-1496	(Sāṅkrtyāyanī karṇe kathayati /)	sāṅkrtyāyanī karṇe kathayati 
SA_GK20_hpriydpu-1497	rājā - (vihasya)	rājā vihasya 
SA_GK20_hpriydpu-1498	yady evam alam udvegena mayāpi jñātam /	yadi evam alam udvegena mayā api jñātam 
SA_GK20_hpriydpu-1499	siddha evāsmin prayojane devīṃ tu diṣṭyā vardhayiṣyāmīti noktam /	siddhe eva asmin prayojane devīm tu diṣṭyā vardhayiṣyāmi iti nā uktam 
SA_GK20_hpriydpu-1500	anyathā katham ahaṃ Dṛḍhavarmavṛttānte visrabdhas tiṣṭhāmi /	anyathā katham aham dṛḍhavarma vṛttānte visrabdhaḥ tiṣṭhāmi 
SA_GK20_hpriydpu-1501	tat katipayāny ahāni tad vārtāyā āgatāyāḥ /	tat katipayāni ahāni tat vārtāyāḥ āgatāyāḥ 
SA_GK20_hpriydpu-1502	idaṃ ca tatra vartate /	idam ca tatra vartate 
SA_GK20_hpriydpu-1503	asmadbalair Vijayasenapuraḥsarais tair	asmad balaiḥ vijayasena puraḥsaraiḥ taiḥ 
SA_GK20_hpriydpu-1504	ākrāntabāhyaviṣayo vihatapratāpaḥ /	ākrānta bāhya viṣayaḥ vihata pratāpaḥ 
SA_GK20_hpriydpu-1505	durgaṃ Kaliṅgahatakaḥ sahasā praviśya	durgam kaliṅga hatakaḥ sahasā praviśya 
SA_GK20_hpriydpu-1506	prākāramātraśaraṇo 'śaraṇaḥ kṛto 'sau // HPri_4.4 //	prākāra mātra śaraṇaḥ śaraṇaḥ kṛtaḥ sau 
SA_GK20_hpriydpu-1507	[p. 51]	p 
SA_GK20_hpriydpu-1508	tad avasthaṃ ca taṃ	tat avastham ca tam 
SA_GK20_hpriydpu-1509	nirdiṣṭākrāntamandaṃ pratidinaviramadvīradāseravṛttaṃ	nirdiṣṭa ākrānta mandam prati dina viramat vīra dāseḥ avṛttam 
SA_GK20_hpriydpu-1510	śaśvatsaṃśīryamāṇadvipaturaganarakṣīṇaniḥśeṣasainyam /	śaśvat saṃśīryamāṇa dvipa turaga nara kṣīṇa niḥśeṣa sainyam 
SA_GK20_hpriydpu-1511	adya śvo vā vibhagne jhaṭiti mama balaiḥ sarvatas tatra durge	adya śvas vā vibhagne jhaṭiti mama balaiḥ sarvatas tatra durge 
SA_GK20_hpriydpu-1512	baddhaṃ yuddhe hataṃ vā bhagavati na cirāc chroṣyasi tvaṃ Kaliṅgam // HPri_4.5 //	baddham yuddhe hatam vā bhagavati na cirāt śroṣyasi tvam kaliṅgam 
SA_GK20_hpriydpu-1513	Sāṅkṛtyāyanī - rājaputri prathamataram eva bhavatyāḥ kathitaṃ mayā katham apratividhāya Vatsarājaḥ sthāsyatīti /	sāṅkṛtyāyanī rāja putri prathamataram eva bhavatyāḥ kathitam mayā katham a pratividhāya vatsa rājaḥ sthāsyati iti 
SA_GK20_hpriydpu-1514	Vāsavadattā - jai evvaṃ piaṃ me /	vāsavadattā jai evvam piam me 
SA_GK20_hpriydpu-1515	[yady evaṃ priyaṃ me /]	yadi evam priyam me 
SA_GK20_hpriydpu-1516	(praviśya /)	praviśya 
SA_GK20_hpriydpu-1517	pratīhārī - jedu jedu bhaṭṭā /	pratīhārī jedu jedu bhaṭṭā 
SA_GK20_hpriydpu-1518	eso kkhu Viaaseṇo Diḍhavammakañcuīsahido harisa- samupphullaloaṇo piaṃ ṇivedidukāmo duvāre ciṭṭhai /	esaḥ kkhu viaa seṇaḥ diḍha vamma kañcuī sahidaḥ samupphulla loaṇaḥ piam ṇivedidu kāmaḥ duvāre ciṭṭhai 
SA_GK20_hpriydpu-1519	[jayatu jayatu bhartā /	jayatu jayatu bhartā 
SA_GK20_hpriydpu-1520	eṣa khalu Vijayaseno Dṛḍhavarmakañcukisahito harṣasamutphullalocanaḥ priyaṃ nivedayitukāmo dvāre tiṣṭhati /]	eṣa khalu vijayasenaḥ dṛḍha varma kañcuki sahitaḥ harṣa samutphulla locanaḥ priyam nivedayitu kāmaḥ dvāre tiṣṭhati 
SA_GK20_hpriydpu-1521	Vāsavadattā - (sasmitam /	vāsavadattā sa smitam 
SA_GK20_hpriydpu-1522	) bhaavadi jaha takkemi paridosida mhi ajjautteṇetti [ bhagavati yathā tarkayāmi paritoṣitāsmy āryaputreṇeti /]	bhaavadi jaha takkemi paridosida mhi ajjautteṇa itti bhagavati yathā tarkayāmi paritoṣitā asmi āryaputreṇa iti 
SA_GK20_hpriydpu-1523	Sāṅkṛtyāyanī - Vatsarājapakṣapātinī khalv ahaṃ na kiṃ cid api bravīmi /	sāṅkṛtyāyanī vatsa rāja pakṣapātinī khalu aham na kim cit api bravīmi 
SA_GK20_hpriydpu-1524	rājā - śīghraṃ praveśaya tau /	rājā śīghram praveśaya tau 
SA_GK20_hpriydpu-1525	pratīhārī - taha / [tathā /]	pratīhārī tathā 
SA_GK20_hpriydpu-1526	(iti niśkrāntā)	iti niśkrāntā 
SA_GK20_hpriydpu-1527	(tataḥ praviśati Vijayasenaḥ Kañcukī ca /)	tatas praviśati vijayasenaḥ kañcukī ca 
SA_GK20_hpriydpu-1528	Vijayasenaḥ - bhoḥ kañcukin /	vijayasenaḥ bhoḥ kañcukin 
SA_GK20_hpriydpu-1529	adya svāmipādā draṣṭavyā iti yat satyam anupamaṃ kam api sukhātiśayam anubhavāmi /	adya svāmi pādāḥ draṣṭavyāḥ iti yat satyam anupamam kam api sukha atiśayam anubhavāmi 
SA_GK20_hpriydpu-1530	[p. 52]	p 
SA_GK20_hpriydpu-1531	kañcukī - Vijayasena avitatham etat / paśya /	kañcukī vijayasena avitatham etat paśya 
SA_GK20_hpriydpu-1532	sukhanirbharo 'nyathāpi svāminam avalokya bhavati bhṛtyajanaḥ /	sukha nirbharaḥ nyathā api svāminam avalokya bhavati bhṛtya janaḥ 
SA_GK20_hpriydpu-1533	kiṃ punar aribalavighaṭananirvyūḍhaprabhuniyogabharaḥ // HPri_4.6 //	kim punar ari bala vighaṭana nirvyūḍha prabhu niyoga bharaḥ 
SA_GK20_hpriydpu-1534	ubhau - (upasṛtya)	ubhau upasṛtya 
SA_GK20_hpriydpu-1535	jayatu jayatu svāmī /	jayatu jayatu svāmī 
SA_GK20_hpriydpu-1536	(rājā ubhāv api pariṣvajate /)	rājā ubhau api pariṣvajate 
SA_GK20_hpriydpu-1537	kañcukī - deva diṣṭyā vardhase /	kañcukī deva diṣṭyā vardhase 
SA_GK20_hpriydpu-1538	hatvā Kaliṅgahatakaṃ hy asmatsvāmī niveśito rājye /	hatvā kaliṅga hatakam hi asmad svāmī niveśitaḥ rājye 
SA_GK20_hpriydpu-1539	devasya samādeśo nirvyūḍho Vijayasenena // HPri_4.7 //	devasya samādeśaḥ nirvyūḍhaḥ vijayasenena 
SA_GK20_hpriydpu-1540	Vāsavadattā - ai bhaavai ahijāṇāsi edaṃ kañcuiṃ /	vāsavadattā ai bhaavai ahijāṇāsi 
SA_GK20_hpriydpu-1541	[ayi bhagavati abhijānāsy etaṃ kañcukinam /]	ayi bhagavati abhijānāsi etam kañcukinam 
SA_GK20_hpriydpu-1542	Sāṅkṛtyāyanī - kathaṃ nābhijānāmi /	sāṅkṛtyāyanī katham na abhijānāmi 
SA_GK20_hpriydpu-1543	nanu sa eṣa yasya haste mātṛṣvasā te patrikām anupreṣitavatī /	nanu saḥ eṣa yasya haste mātṛṣvasā te patrikām anupreṣitavatī 
SA_GK20_hpriydpu-1544	rājā - sādhu Vijayasenena mahāvyāpāro 'nuṣṭhitaḥ /	rājā sādhu vijayasenena mahā vyāpāraḥ nuṣṭhitaḥ 
SA_GK20_hpriydpu-1545	(Vijayasenaḥ pādayoḥ patati)	vijayasenaḥ pādayoḥ patati 
SA_GK20_hpriydpu-1546	rājā - devi diṣṭyā vardhase /	rājā devi diṣṭyā vardhase 
SA_GK20_hpriydpu-1547	pratiṣṭhito rājye Dṛḍhavarmā /	pratiṣṭhitaḥ rājye dṛḍhavarmā 
SA_GK20_hpriydpu-1548	Vāsavadattā - (saharṣam/	vāsavadattā sa harṣam 
SA_GK20_hpriydpu-1549	) aṇuggahida mhi /	aṇuggahida mhi 
SA_GK20_hpriydpu-1550	[anugṛhītāsmi /]	anugṛhītā asmi 
SA_GK20_hpriydpu-1551	vidūṣakaḥ - īrise abbhudae assiṃ rāaule edaṃ karaṇijjaṃ /	vidūṣakaḥ īrise abbhudae assim rāaule edam karaṇijjam 
SA_GK20_hpriydpu-1552	(rājānaṃ nirdiśya vīṇāvādanaṃ nāṭayan /	rājānam nirdiśya vīṇā vādanam nāṭayan 
SA_GK20_hpriydpu-1553	) gurupūā /	gurupūā 
SA_GK20_hpriydpu-1554	(ātmano yajñopavītaṃ darśayan/	ātmanaḥ yajñopavītam darśayan 
SA_GK20_hpriydpu-1555	) bamhaṇassa sakkāro /	bamhaṇassa sakkāraḥ 
SA_GK20_hpriydpu-1556	(Āraṇyikāṃ sūcayan/	āraṇyikām sūcayan 
SA_GK20_hpriydpu-1557	) savvabandhaṇamokkho tti /	savva bandhaṇa mokkho tti 
SA_GK20_hpriydpu-1558	[īdṛśe 'bhyudaye 'smin rājakula etat karaṇīyam /	īdṛśe bhyudaye smin rājakule etat karaṇīyam 
SA_GK20_hpriydpu-1559	(rājānaṃ nirdiśya vīṇāvādanaṃ nāṭayan /	rājānam nirdiśya vīṇā vādanam nāṭayan 
SA_GK20_hpriydpu-1560	) gurupūjā /	guru pūjā 
SA_GK20_hpriydpu-1561	(ātmano yajñopavītaṃ darśayan/	ātmanaḥ yajñopavītam darśayan 
SA_GK20_hpriydpu-1562	) brāhmaṇasya satkāraḥ /	brāhmaṇasya satkāraḥ 
SA_GK20_hpriydpu-1563	(Āraṇyikāṃ sūcayan/	āraṇyikām sūcayan 
SA_GK20_hpriydpu-1564	) sarvabandhanamokṣa iti /]	sarva bandhana mokṣaḥ iti 
SA_GK20_hpriydpu-1565	rājā - (Vāsavadattām apavārya choṭikāṃ dadat /	rājā vāsavadattām apavārya choṭikām dadat 
SA_GK20_hpriydpu-1566	) sādhu vayasya sādhu /	sādhu vayasya sādhu 
SA_GK20_hpriydpu-1567	[p . 53] vidūṣakaḥ - hodi kahaṃ tumaṃ ṇa kiṃ vi ettha samādisasi /	vidūṣakaḥ hodi kaham tumam na kim vi ettha samādisasi 
SA_GK20_hpriydpu-1568	[bhavati kathaṃ tvaṃ na kim apy atra samādiśasi /]	bhavati katham tvam na kim api atra samādiśasi 
SA_GK20_hpriydpu-1569	Vāsavadattā - (Sāṅkṛtyāyaṇīm avalokya sasmitam /	vāsavadattā sāṅkṛtyāyaṇīm avalokya sa smitam 
SA_GK20_hpriydpu-1570	) moidā kkhu hadāseṇa Āraṇṇiā /	moidā kkhu hadāseṇa āraṇṇiā 
SA_GK20_hpriydpu-1571	[mocitā khalu hatāśenāraṇyikā /]	mocitā khalu hata āśena araṇyikā 
SA_GK20_hpriydpu-1572	Sāṅkṛtyāyanī - kiṃ vā tapasvinyānayā baddhayā /	sāṅkṛtyāyanī kim vā tapasvinyā anayā baddhayā 
SA_GK20_hpriydpu-1573	Vāsavadattā - jaha bhaavadīe roadi /	vāsavadattā jaha bhaavadīe 
SA_GK20_hpriydpu-1574	[yathā bhagavatyai rocate /]	yathā bhagavatyai rocate 
SA_GK20_hpriydpu-1575	Sāṅkṛtyāyanī - yady evam aham eva gatvā tāṃ mocayiṣyāmi /	sāṅkṛtyāyanī yadi evam aham eva gatvā tām mocayiṣyāmi 
SA_GK20_hpriydpu-1576	(iti niṣkrāntā)	iti niṣkrāntā 
SA_GK20_hpriydpu-1577	kañcukī - idam aparaṃ saṃdiṣṭaṃ mahārājena Dṛḍhavarmaṇā /	kañcukī idam aparam saṃdiṣṭam mahā rājena dṛḍhavarmaṇā 
SA_GK20_hpriydpu-1578	tvatprasādāt sarvam eva yathābhilaṣitaṃ saṃpannaṃ /	tvad prasādāt sarvam eva yathā abhilaṣitam saṃpannam 
SA_GK20_hpriydpu-1579	tad ete prāṇās tvadīyāḥ /	tat ete prāṇāḥ tvadīyāḥ 
SA_GK20_hpriydpu-1580	yatheṣṭam imān viniyoktuṃ tvam eva pramāṇam iti /	yathā iṣṭam imān viniyoktum tvam eva pramāṇam iti 
SA_GK20_hpriydpu-1581	(rājā salajjam adhomukhas tiṣṭhati /)	rājā sa lajjam adhomukhaḥ tiṣṭhati 
SA_GK20_hpriydpu-1582	Vijayasenaḥ - deva na śakyam eva devaṃ prati prītiviśeṣaṃ Dṛḍhavarmaṇaḥ kathayitum /	vijayasenaḥ deva na śakyam eva devam prati prīti viśeṣam dṛḍhavarmaṇaḥ kathayitum 
SA_GK20_hpriydpu-1583	kañcukī - yady api tubhyaṃ pratipāditāyāḥ Priyadarśikāyā asmadduhituḥ paribhraṃśān na me saṃbandho jāta iti duḥkham āsīt tathāpi Vāsavadattāyāḥ  #	kañcukī yadi api tubhyam pratipāditāyāḥ priyadarśikāyāḥ asmad duhituḥ paribhraṃśāt na me saṃbandhaḥ jātaḥ iti duḥkham āsīt tathā api vāsavadattāyāḥ 
SA_GK20_hpriydpu-1584	pariṇetrāpi tvayā tad apanītam eva /	pariṇetrā api tvayā tat apanītam eva 
SA_GK20_hpriydpu-1585	Vāsavadattā - (sāsram /	vāsavadattā sa asram 
SA_GK20_hpriydpu-1586	) ajja kañcui kahaṃ me bhaiṇī paribbhaṭṭhā /	ajja kañcui kaham me bhaiṇī paribbhaṭṭhā 
SA_GK20_hpriydpu-1587	[ārya kañcukin kathaṃ me bhaginī paribhraṣṭā /]	ārya kañcukin katham me bhaginī paribhraṣṭā 
SA_GK20_hpriydpu-1588	kañcukī - rājaputri tasmin Kaliṅgahatakāvaskande vidruteṣv itas tato 'ntaḥpurajaneṣu diṣṭyā dṛṣṭām idānīṃ na yuktam atra sthātum iti tām ahaṃ  #	kañcukī rāja putri tasmin kaliṅga hataka avaskande vidruteṣu itas tatas ntaḥpura janeṣu diṣṭyā dṛṣṭām idānīm na yuktam atra sthātum iti tām aham 
SA_GK20_hpriydpu-1589	gṛhītvā Vatsarājāntikaṃ prasthitaḥ /	gṛhītvā vatsa rāja antikam prasthitaḥ 
SA_GK20_hpriydpu-1590	tataḥ saṃcintya tāṃ Vindhyaketor haste nikṣipya nirgato 'smi /	tatas saṃcintya tām vindhyaketoḥ haste nikṣipya nirgataḥ smi 
SA_GK20_hpriydpu-1591	yāvat pratīpam āgacchāmi tāvat kair api tat sthānaṃ saha Vindhyaketunā smartavyatāṃ nītam /	yāvat pratīpam āgacchāmi tāvat kaiḥ api tat sthānam saha vindhyaketunā smartavya tām nītam 
SA_GK20_hpriydpu-1592	[p. 54]	p 
SA_GK20_hpriydpu-1593	rājā - (sasmitam/	rājā sa smitam 
SA_GK20_hpriydpu-1594	) Vijayasena kiṃ kathayasi /	vijayasena kim kathayasi 
SA_GK20_hpriydpu-1595	kañcukī - tatra cānviṣyatā mayā na prāptā /	kañcukī tatra ca anviṣyatā mayā na prāptā 
SA_GK20_hpriydpu-1596	tadāprabhṛti nādyāpi vijñāyate kva vartata iti /	tadā prabhṛti na adya api vijñāyate kva vartate iti 
SA_GK20_hpriydpu-1597	(praviśya Manoramā /)	praviśya manoramā 
SA_GK20_hpriydpu-1598	Manoramā - bhaṭṭiṇī pāṇasaṃsae vaṭṭai sā tavassiṇī /	manoramā bhaṭṭiṇī pāṇa saṃsae vaṭṭai sā tavassiṇī 
SA_GK20_hpriydpu-1599	[bhaṭṭini prāṇasaṃśaye vartate sā tapasvinī /]	bhaṭṭini prāṇa saṃśaye vartate sā tapasvinī 
SA_GK20_hpriydpu-1600	Vāsavadattā - (sāsram /	vāsavadattā sa asram 
SA_GK20_hpriydpu-1601	) kim uṇa tumaṃ Piadaṃsaṇāuttantaṃ jāṇāsi /	kim uṇa tumam jāṇāsi 
SA_GK20_hpriydpu-1602	[kiṃ punas tvaṃ Priyadarśanā vṛttāntaṃ jānāsi /]	kim punar tvam priyadarśanāḥ vṛttāntam jānāsi 
SA_GK20_hpriydpu-1603	Manoramā - ṇa hu ahaṃ Piadaṃsaṇāuttantaṃ jāṇāmi /	manoramā ṇa hu aham jāṇāmi 
SA_GK20_hpriydpu-1604	esā kkhu Āraṇṇiā kalla- vvavadeseṇa āṇīdaṃ visaṃ pāia pāṇasaṃsae vaṭṭadi tti evvaṃ mae ṇivedidaṃ /	esā kkhu āraṇṇiā kalla vvavadeseṇa āṇīdam visam pāia pāṇa saṃsae vaṭṭadi tti evvam mae ṇivedidam 
SA_GK20_hpriydpu-1605	tā parittāadu bhaṭṭiṇī /	bhaṭṭiṇī 
SA_GK20_hpriydpu-1606	[na khalv ahaṃ Priyadarśanāvṛttāntaṃ jānāmi /	na khalu aham priyadarśanā vṛttāntam jānāmi 
SA_GK20_hpriydpu-1607	eṣā khalv Āraṇyikā kalyavyapadeśenānītaṃ viṣaṃ pītvā prāṇasaṃśaye vartata iti evaṃ mayā niveditam /	eṣā khalu āraṇyikā kalya vyapadeśena ānītam viṣam pītvā prāṇa saṃśaye vartate iti evam mayā niveditam 
SA_GK20_hpriydpu-1608	tat paritrāyatām bhaṭṭinī /]	tat paritrāyatām bhaṭṭinī 
SA_GK20_hpriydpu-1609	(rudatī pādayoḥ patati /)	rudatī pādayoḥ patati 
SA_GK20_hpriydpu-1610	Vāsavadattā - (svagatam/	vāsavadattā svagatam 
SA_GK20_hpriydpu-1611	) ha ddhi ha ddhi /	ha ddhi ha ddhi 
SA_GK20_hpriydpu-1612	Piadaṃsaṇādukkhaṃ vi me antaridaṃ Āraṇṇiāuttanteṇa /	pia daṃsaṇā dukkham vi me antar idam āraṇṇiā uttanteṇa 
SA_GK20_hpriydpu-1613	adidujjaṇo kkhu loo /	a did ujjaṇaḥ kkhu loaḥ 
SA_GK20_hpriydpu-1614	kadāi maṃ aṇṇahā saṃbhāvaissadi /	kadāi mama aṇṇahā 
SA_GK20_hpriydpu-1615	tā edaṃ ettha juttaṃ (prakāśam sasaṃbhramam / )/	tā edam ettha juttam prakāśam sa saṃbhramam 
SA_GK20_hpriydpu-1616	Maṇorame lahu iha evva āṇehi taṃ /	maṇorame lahu iha evva āṇehi tam 
SA_GK20_hpriydpu-1617	ṇāaloādo gahidavisavijjo ajjautto ettha kusalo /	ajjauttaḥ ettha kusalaḥ 
SA_GK20_hpriydpu-1618	[hā dhik hā dhik /	hā dhik hā dhik 
SA_GK20_hpriydpu-1619	Priyadarśanāduḥkham api me 'ntaritam Āraṇyikāvṛttāntena /	priyadarśanā duḥkham api me ntaritam āraṇyikā vṛttāntena 
SA_GK20_hpriydpu-1620	atidurjanaḥ khalu lokaḥ /	ati durjanaḥ khalu lokaḥ 
SA_GK20_hpriydpu-1621	kadācin mām anyathā saṃbhāvayiṣyati /	kadācid mām anyathā saṃbhāvayiṣyati 
SA_GK20_hpriydpu-1622	tad etad atra yuktam /	tat etat atra yuktam 
SA_GK20_hpriydpu-1623	(prakāśam sasaṃbhramam /	prakāśam sa saṃbhramam 
SA_GK20_hpriydpu-1624	) Manorame laghv ihaivānaya tām /	manorame laghu iha eva ānaya tām 
SA_GK20_hpriydpu-1625	nāgalokād gṛhītaviṣavidya āryaputro 'tra kuśalaḥ /	nāga lokāt gṛhīta viṣa vidyaḥ āryaputraḥ kuśalaḥ 
SA_GK20_hpriydpu-1626	(niṣkrāntā Manoramā /	niṣkrāntā manoramā 
SA_GK20_hpriydpu-1627	tataḥ praviśati Manoramayā dhṛtāsaviṣavegam ātmānaṃ nāṭayanty Āraṇyikā /)	tatas praviśati manoramayā dhṛta asa viṣa vegam ātmānam nāṭayantī āraṇyikā 
SA_GK20_hpriydpu-1628	Āraṇyikā - halā Maṇorame kīsa dāṇiṃ maṃ andhaāraṃ pavesesi /	āraṇyikā halā maṇorame kīsa dāṇim mama andhaāram pavesesi 
SA_GK20_hpriydpu-1629	halā Manorame kasmād idānīṃ mām andhakāraṃ praveśayasi /	halā manorame kasmāt idānīm mām andhakāram praveśayasi 
SA_GK20_hpriydpu-1630	Manoramā - (saviṣādam /	manoramā sa viṣādam 
SA_GK20_hpriydpu-1631	) haddhi haddhi /	haddhi haddhi 
SA_GK20_hpriydpu-1632	diṭṭhi vi se saṃkantā viseṇ'; evva /	vi se saṃkantā 
SA_GK20_hpriydpu-1633	(Vāsavadattāṃ dṛṣṭvā /	vāsavadattām dṛṣṭvā 
SA_GK20_hpriydpu-1634	) bhaṭṭini lahu parittāehi lahu parittāehi /	bhaṭṭini lahu parittāehi lahu parittāehi 
SA_GK20_hpriydpu-1635	gurubhūdaṃ se visaṃ /	se visam 
SA_GK20_hpriydpu-1636	[hā dhik hā dhik /	hā dhik hā dhik 
SA_GK20_hpriydpu-1637	dṛṣṭir api asyāḥ saṃkrāntā viṣeṇaiva /	dṛṣṭiḥ api asyāḥ saṃkrāntā viṣeṇa eva 
SA_GK20_hpriydpu-1638	(Vāsavadattāṃ dṛṣṭvā /	vāsavadattām dṛṣṭvā 
SA_GK20_hpriydpu-1639	) bhaṭṭini laghu paritrāyasva laghu [p. 55] paritrāyasva /	bhaṭṭini laghu paritrāyasva laghu p 
SA_GK20_hpriydpu-1640	gurū bhūtam asyā viṣam /]	gurū bhūtam asyāḥ viṣam 
SA_GK20_hpriydpu-1641	Vāsavadattā - (sasaṃbhramaṃ rājānaṃ haste gṛhītvā /	vāsavadattā sa saṃbhramam rājānam haste gṛhītvā 
SA_GK20_hpriydpu-1642	) ajjautta uṭṭhehi uṭṭhehi /	ajjautta uṭṭhehi uṭṭhehi 
SA_GK20_hpriydpu-1643	lahu vivajajjai kkhu esā tavassiṇī /	lahu kkhu esā tavassiṇī 
SA_GK20_hpriydpu-1644	[āryaputra uttiṣṭhottiṣṭha /	āryaputra uttiṣṭha uttiṣṭha 
SA_GK20_hpriydpu-1645	laghu vipadyate khalv eṣā tapasvinī /]	laghu vipadyate khalu eṣā tapasvinī 
SA_GK20_hpriydpu-1646	(sarve paśyanti /)	sarve paśyanti 
SA_GK20_hpriydpu-1647	kañcukī - (vilokya /	kañcukī vilokya 
SA_GK20_hpriydpu-1648	) susadṛśī khalv iyaṃ mama rājaputryāḥ Priyadarśanāyāḥ /	su sadṛśī khalu iyam mama rāja putryāḥ priyadarśanāyāḥ 
SA_GK20_hpriydpu-1649	(Vāsavadattāṃ nirdiśya)	vāsavadattām nirdiśya 
SA_GK20_hpriydpu-1650	rājaputri kuta iyaṃ kanyakā /	rāja putri kutas iyam kanyakā 
SA_GK20_hpriydpu-1651	Vāsavadattā - ajja Vinjhakeuṇo duhidā /	vāsavadattā ajja vinjhakeuṇaḥ duhidā 
SA_GK20_hpriydpu-1652	taṃ vāvādia Vijayaseṇeṇa āṇīdā /	tam vāvādia vijayaseṇeṇa āṇīdā 
SA_GK20_hpriydpu-1653	[ārya Vindhyaketor duhitā /	ārya vindhyaketoḥ duhitā 
SA_GK20_hpriydpu-1654	taṃ vyāpādya Vijayasenenānītā /]	tam vyāpādya vijayasenena ānītā 
SA_GK20_hpriydpu-1655	kañcukī - kutas tasya duhitā /	kañcukī kutas tasya duhitā 
SA_GK20_hpriydpu-1656	saiveyaṃ mama rājaputrī /	sā eva iyam mama rāja putrī 
SA_GK20_hpriydpu-1657	hā hato 'smi mandabhāgyaḥ /	hā hataḥ smi mandabhāgyaḥ 
SA_GK20_hpriydpu-1658	(iti nipatya bhūmāv utthāya /	iti nipatya bhūmau utthāya 
SA_GK20_hpriydpu-1659	) rājaputri iyaṃ sā Priyadarśikā bhaginī te /	rāja putri iyam sā priyadarśikā bhaginī te 
SA_GK20_hpriydpu-1660	Vāsavadattā - ajjautta parittāehi parittāehi /	vāsavadattā ajjautta parittāehi parittāehi 
SA_GK20_hpriydpu-1661	mama bhaiṇī vivajjai /	mama bhaiṇī vivajjai 
SA_GK20_hpriydpu-1662	[āryaputra paritrāyasva paritrāyasva /	āryaputra paritrāyasva paritrāyasva 
SA_GK20_hpriydpu-1663	mama bhaginī vipadyate /]	mama bhaginī vipadyate 
SA_GK20_hpriydpu-1664	rājā - samāśvasihi samāśvasihi /	rājā samāśvasihi samāśvasihi 
SA_GK20_hpriydpu-1665	paśyāmas tāvat /	paśyāmaḥ tāvat 
SA_GK20_hpriydpu-1666	kaṣṭaṃ bhoḥ kaṣṭam /	kaṣṭam bhoḥ kaṣṭam 
SA_GK20_hpriydpu-1667	saṃjātasāndramakarandarasāṃ krameṇa	saṃjāta sāndra makaranda rasām krameṇa 
SA_GK20_hpriydpu-1668	pātuṃ gataś ca kalikāṃ kamalasya bhṛṅgaḥ /	pātum gataḥ ca kalikām kamalasya bhṛṅgaḥ 
SA_GK20_hpriydpu-1669	dagdhā nipatya sahasaiva himena cāsau	dagdhā nipatya sahasā eva himena ca asau 
SA_GK20_hpriydpu-1670	vāme vidhau na hi phalanty abhivāñchitāni // HPri_4.8 //	vāme vidhau na hi phalanti abhivāñchitāni 
SA_GK20_hpriydpu-1671	Manorame pṛcchyatāṃ tāvat kiṃ te bodha iti /	manorame pṛcchyatām tāvat kim te bodhaḥ iti 
SA_GK20_hpriydpu-1672	Manoramā - sahi kiṃ de bodho /	manoramā sahi kim de bodho 
SA_GK20_hpriydpu-1673	(sāsraṃ punaś cālayantī )	sa asram punar cālayantī 
SA_GK20_hpriydpu-1674	sahi ṇaṃ bhaṇāmi kiṃ de bodho tti /	sahi nam bhaṇāmi kim de bodhaḥ tti 
SA_GK20_hpriydpu-1675	[sakhi kiṃ te bodhaḥ /	sakhi kim te bodhaḥ 
SA_GK20_hpriydpu-1676	(sāsraṃ punaś cālayantī)	sa asram punar cālayantī 
SA_GK20_hpriydpu-1677	sakhi nanu bhaṇāmi kiṃ te bodha iti /]	sakhi nanu bhaṇāmi kim te bodhaḥ iti 
SA_GK20_hpriydpu-1678	Priyadarśikā - (avispaṣṭam /	priyadarśikā avispaṣṭam 
SA_GK20_hpriydpu-1679	) jaṃ edaṃ avasthānaṃ (sic)	jaṃ ā idam avasthānam sic 
SA_GK20_hpriydpu-1680	gadāe vi mae ṇa mahārāo diṭṭho /	gadāe vi mae ṇa mahā rāo diṭṭhaḥ 
SA_GK20_hpriydpu-1681	[yad etad avasthāyāpi mayā na mahārājo dṛṣṭaḥ /]	yat etat avasthāya api mayā na mahā rājaḥ dṛṣṭaḥ 
SA_GK20_hpriydpu-1682	(ity ardhokte bhūmau patati /)	iti ardha ukte bhūmau patati 
SA_GK20_hpriydpu-1683	[p. 56]	p 
SA_GK20_hpriydpu-1684	rājā - (sāsram/)	rājā sa asram 
SA_GK20_hpriydpu-1685	eṣā mīlayatīdam īkṣaṇayugaṃ jātā mamāndhā diśaḥ	eṣā mīlayati idam īkṣaṇa yugam jātāḥ mama andhāḥ diśaḥ 
SA_GK20_hpriydpu-1686	kaṇṭho 'syāḥ pratirudhyate mama giro niryānti kṛcchrād imāḥ /	kaṇṭhaḥ syāḥ pratirudhyate mama giraḥ niryānti kṛcchrāt imāḥ 
SA_GK20_hpriydpu-1687	etasyāḥ śvasitaṃ hṛtaṃ mama tanur niśceṣṭatām āgatā	etasyāḥ śvasitam hṛtam mama tanuḥ niśceṣṭa tām āgatā 
SA_GK20_hpriydpu-1688	manye 'syā viṣavega eva hi paraṃ sarve tu duḥkhaṃ mama // HPri_4.9 //	manye syāḥ viṣa vegaḥ eva hi param sarve tu duḥkham mama 
SA_GK20_hpriydpu-1689	Vāsavadattā - (sāsram)	vāsavadattā sa asram 
SA_GK20_hpriydpu-1690	Piadaṃsaṇe uṭṭhehi uṭṭhehi /	pia daṃsaṇe uṭṭhehi uṭṭhehi 
SA_GK20_hpriydpu-1691	pekkha eso mahārāo ciṭṭhai /	pekkha esaḥ mahā rāo ciṭṭhai 
SA_GK20_hpriydpu-1692	kahaṃ veaṇā vi se ṇaṭṭhā /	kaham veaṇā vi se ṇaṭṭhā 
SA_GK20_hpriydpu-1693	kiṃ dāṇiṃ mae avarajjhaṃ aāṇantīe jeṇa kuvidā ṇālavasi /	kim dāṇim mae avarajjham a āṇantīe jeṇa kuvidā 
SA_GK20_hpriydpu-1694	tā pasīda pasīda /	tā pasīda pasīda 
SA_GK20_hpriydpu-1695	uṭṭhehi uṭṭhehi /	uṭṭhehi uṭṭhehi 
SA_GK20_hpriydpu-1696	ṇa hu puṇo avarajjhissaṃ /	ṇa hu puṇar avarajjhissam 
SA_GK20_hpriydpu-1697	(ūrdhvam avalokya)	ūrdhvam avalokya 
SA_GK20_hpriydpu-1698	hā devva hadaa kiṃ dāṇiṃ mae avakidaṃ jeṇa edāvatthaṃ gadā me bhaiṇī ādaṃsidā /	hā devva hadaa kim dāṇim mae avakidam jeṇa edāvattham gadā me bhaiṇī ādaṃsidā 
SA_GK20_hpriydpu-1699	[Priyadarśane uttiṣṭhottiṣṭha /	priyadarśane uttiṣṭha uttiṣṭha 
SA_GK20_hpriydpu-1700	paśyaiṣa mahārājas tiṣṭhati /	paśya eṣa mahā rājaḥ tiṣṭhati 
SA_GK20_hpriydpu-1701	kathaṃ vedanāpy asyā naṣṭā /	katham vedanā api asyāḥ naṣṭā 
SA_GK20_hpriydpu-1702	kim idānīṃ mayāparāddhaṃ ajānatyā yena kupitā nālapasi /	kim idānīm mayā aparāddham a jānatyā yena kupitā na ālapasi 
SA_GK20_hpriydpu-1703	tat prasīda prasīda /	tat prasīda prasīda 
SA_GK20_hpriydpu-1704	uttiṣṭhottiṣṭha /	uttiṣṭha uttiṣṭha 
SA_GK20_hpriydpu-1705	na khalu punar aparātsyāmi /	na khalu punar aparātsyāmi 
SA_GK20_hpriydpu-1706	(ūrdhvam avalokya)	ūrdhvam avalokya 
SA_GK20_hpriydpu-1707	hā daiva hataka /	hā daiva hataka 
SA_GK20_hpriydpu-1708	kim idānīṃ mayāpakṛtaṃ yenaitad avasthāṃ gatā me bhaginyādarśitā /]	kim idānīm mayā apakṛtam yena etat avasthām gatā me bhaginyā ādarśitā 
SA_GK20_hpriydpu-1709	(Priyadarśikāyā upari patati /)	priyadarśikāyāḥ upari patati 
SA_GK20_hpriydpu-1710	vidūṣakaḥ - bho vaassa kahaṃ tumaṃ mūḍho via ciṭṭhasi /	vidūṣakaḥ bho vaassa kaham tumam mūḍhaḥ via ciṭṭhasi 
SA_GK20_hpriydpu-1711	ṇa eso visādassa kālo /	ṇa esaḥ visādassa kālaḥ 
SA_GK20_hpriydpu-1712	visamā kkhu gaī visassa /	visamā kkhu gaī visassa 
SA_GK20_hpriydpu-1713	tā daṃsehi appaṇo vijjāpahāvaṃ /	tā daṃsehi appaṇaḥ vijjā pahāvam 
SA_GK20_hpriydpu-1714	[bho vayasya kathaṃ tvaṃ mūḍha iva tiṣṭhasi /	bho vayasya katham tvam mūḍhaḥ iva tiṣṭhasi 
SA_GK20_hpriydpu-1715	naiṣa viṣādasya kālaḥ /	na eṣa viṣādasya kālaḥ 
SA_GK20_hpriydpu-1716	viṣamā khalu gatir viṣasya /	viṣamā khalu gatiḥ viṣasya 
SA_GK20_hpriydpu-1717	tad darśaya ātmano vidyāprabhāvam /]	tat darśaya ātmanaḥ vidyā prabhāvam 
SA_GK20_hpriydpu-1718	rājā - satyam evaitat /	rājā satyam eva etat 
SA_GK20_hpriydpu-1719	(Priyadarśikām ālokya)	priyadarśikām ālokya 
SA_GK20_hpriydpu-1720	mūḍha evāham etāvatīṃ velām /	mūḍhaḥ eva aham etāvatīm velām 
SA_GK20_hpriydpu-1721	tad aham enāṃ jīvayāmi /	tat aham enām jīvayāmi 
SA_GK20_hpriydpu-1722	salilaṃ salilam /	salilam salilam 
SA_GK20_hpriydpu-1723	vidūṣakaḥ - (niṣkramya punaḥ praviśya) bho /	vidūṣakaḥ niṣkramya punar praviśya bho 
SA_GK20_hpriydpu-1724	edaṃ salilaṃ /	ā idam salilam 
SA_GK20_hpriydpu-1725	[bhoḥ etat salilam /]	bhoḥ etat salilam 
SA_GK20_hpriydpu-1726	(rājopasṛtya Priyadarśanāyā upari hastaṃ nidhāya mantrasmaraṇaṃ nāṭayati /	rājā upasṛtya priyadarśanāyāḥ upari hastam nidhāya mantra smaraṇam nāṭayati 
SA_GK20_hpriydpu-1727	Priyadarśikā śanair uttiṣṭhati /)	priyadarśikā śanais uttiṣṭhati 
SA_GK20_hpriydpu-1728	Vāsavadattā - ajjautta diṭṭhiā paccujjīvidā me bhaiṇī /	vāsavadattā ajjautta diṭṭhiā paccujjīvidā me bhaiṇī 
SA_GK20_hpriydpu-1729	[āryaputra diṣṭyā pratyujjīvitā me bhaginī /]	āryaputra diṣṭyā pratyujjīvitā me bhaginī 
SA_GK20_hpriydpu-1730	[p. 57]	p 
SA_GK20_hpriydpu-1731	Vijayasenaḥ - aho devasya vidyāprabhāvaḥ /	vijayasenaḥ aho devasya vidyā prabhāvaḥ 
SA_GK20_hpriydpu-1732	kañcukī - aho sarvatrāpratihatā narendratā devasya /	kañcukī aho sarvatra apratihatā narendra tā devasya 
SA_GK20_hpriydpu-1733	Priyadarśikā - (śanair utthāyopaviśya ca jṛmbhikāṃ nāṭayantī saviṣādam avispaṣṭam /	priyadarśikā śanais utthāya upaviśya ca jṛmbhikām nāṭayantī sa viṣādam avispaṣṭam 
SA_GK20_hpriydpu-1734	) Maṇorame ciraṃ khu sutta mhi /	maṇorame ciram khu sutta mhi 
SA_GK20_hpriydpu-1735	[Manorame ciraṃ khalu suptāsmi /]	manorame ciram khalu suptā asmi 
SA_GK20_hpriydpu-1736	vidūṣakaḥ - bho vaassa ṇivvūḍhaṃ de vedittaṇaṃ /	vidūṣakaḥ bho vaassa nivvūḍham de vedittaṇam 
SA_GK20_hpriydpu-1737	[bho vayasya nirvyūḍhaṃ te vaidyatvam /]	bho vayasya nirvyūḍham te vaidya tvam 
SA_GK20_hpriydpu-1738	(Priyadarśikā sābhilāṣaṃ rājānaṃ nirūpya salajjaṃ kiṃcid adhomukhī tiṣṭhati /)	priyadarśikā sa abhilāṣam rājānam nirūpya sa lajjam kiṃcid adhomukhī tiṣṭhati 
SA_GK20_hpriydpu-1739	Vāsavadattā - (saharṣam /	vāsavadattā sa harṣam 
SA_GK20_hpriydpu-1740	) ajjautta /	ajjautta 
SA_GK20_hpriydpu-1741	kiṃ dāṇiṃ vi esā aṇṇah';	kim dāṇim vi esā 
SA_GK20_hpriydpu-1742	evva karedi /	evva karedi 
SA_GK20_hpriydpu-1743	[āryaputra kim idānīm apy eṣānyathaiva karoti /]	ārya putra kim idānīm api eṣā anyathā eva karoti 
SA_GK20_hpriydpu-1744	rājā - (sasmitam /)	rājā sa smitam 
SA_GK20_hpriydpu-1745	svabhāvasthā dṛṣṭir na bhavati giro nāti viśadās	svabhāva sthā dṛṣṭiḥ na bhavati giraḥ na ati viśadāḥ 
SA_GK20_hpriydpu-1746	tanuḥ sīdaty eṣā prakaṭapulakasvedakaṇikā /	tanuḥ sīdati eṣā prakaṭa pulaka sveda kaṇikā 
SA_GK20_hpriydpu-1747	yathā cāyaṃ kampaḥ stanabharaparikleśajananas	yathā ca ayam kampaḥ stana bhara parikleśa jananaḥ 
SA_GK20_hpriydpu-1748	tathā nādyāpy asyā niyatam akhilaṃ śāmyati viṣam // HPri_4.10 //	tathā na adya api asyāḥ niyatam akhilam śāmyati viṣam 
SA_GK20_hpriydpu-1749	kañcukī - (Priyadarśikāṃ nirdiśya /	kañcukī priyadarśikām nirdiśya 
SA_GK20_hpriydpu-1750	) rājaputri eṣa te pitur ājñākaraḥ /	rāja putri eṣa te pituḥ ājñākaraḥ 
SA_GK20_hpriydpu-1751	(iti pādayoḥ patati /)	iti pādayoḥ patati 
SA_GK20_hpriydpu-1752	Priyadarśikā - (vilokya /	priyadarśikā vilokya 
SA_GK20_hpriydpu-1753	) kahaṃ kañcuī ajjaViṇaavasū /	kaham ajja viṇaa vasū 
SA_GK20_hpriydpu-1754	(sāsram /	sa asram 
SA_GK20_hpriydpu-1755	) hā tāda /	hā tāda 
SA_GK20_hpriydpu-1756	hā ajjūe /	hā ajjūe 
SA_GK20_hpriydpu-1757	[kathaṃ kañcukyārya Vinayavasuḥ /	katham kañcukī ārya vinayavasuḥ 
SA_GK20_hpriydpu-1758	(sāsram /	sa asram 
SA_GK20_hpriydpu-1759	) hā tāta / hā mātaḥ /]	hā tāta hā mātar 
SA_GK20_hpriydpu-1760	kañcukī - rājaputri alaṃ ruditena /	kañcukī rāja putri alam ruditena 
SA_GK20_hpriydpu-1761	kuśalinau te pitarau /	kuśalinau te pitarau 
SA_GK20_hpriydpu-1762	Vatsarājaprabhāvāt punas tad avastham eva rājyam /	vatsa rāja prabhāvāt punar tat avastham eva rājyam 
SA_GK20_hpriydpu-1763	Vāsavadattā - (sāsram /	vāsavadattā sa asram 
SA_GK20_hpriydpu-1764	) ehi aliasīle /	ehi aliasīle 
SA_GK20_hpriydpu-1765	dāṇiṃ vi dāva bhaiṇiā siṇehaṃ daṃsehi /	dāṇim vi dāva bhaiṇiā siṇeham daṃsehi 
SA_GK20_hpriydpu-1766	(kaṇṭhe gṛhītvā /	kaṇṭhe gṛhītvā 
SA_GK20_hpriydpu-1767	) dāṇiṃ samassattha mhi /	dāṇim samassattha mhi 
SA_GK20_hpriydpu-1768	[ehy alīkaśīle /	ehi alīka śīle 
SA_GK20_hpriydpu-1769	idānīm api tāvad bhaginī snehaṃ darśaya /	idānīm api tāvat bhaginī sneham darśaya 
SA_GK20_hpriydpu-1770	(kaṇṭhe gṛhītvā /	kaṇṭhe gṛhītvā 
SA_GK20_hpriydpu-1771	) idānīṃ samāśvasitāsmi /]	idānīm samāśvasitā asmi 
SA_GK20_hpriydpu-1772	[p. 58]	p 
SA_GK20_hpriydpu-1773	vidūṣakaḥ - hodi tumaṃ bhaiṇiṃ geṇhia kaṇṭhe evvaṃ parituṭṭhā si /	vidūṣakaḥ hodi tumam bhaiṇim geṇhia kaṇṭhe evvam parituṭṭhā si 
SA_GK20_hpriydpu-1774	vodiassa pāridosiaṃ visumaridaṃ /	vodiassa 
SA_GK20_hpriydpu-1775	[bhavati tvaṃ bhaginīṃ gṛhītvā kaṇṭha evaṃ parituṣṭāsi /	bhavati tvam bhaginīm gṛhītvā kaṇṭhe evam parituṣṭā asi 
SA_GK20_hpriydpu-1776	vaidyasya pāritoṣikaṃ vismṛtam /]	vaidyasya pāritoṣikam vismṛtam 
SA_GK20_hpriydpu-1777	Vāsavadattā - Vasantaa ṇa visumaridaṃ /	vāsavadattā 
SA_GK20_hpriydpu-1778	[Vasantaka na vismṛtam /]	vasantaka na vismṛtam 
SA_GK20_hpriydpu-1779	vidūṣakaḥ - (rājānaṃ nirdiśya sasmitam /	vidūṣakaḥ rājānam nirdiśya sa smitam 
SA_GK20_hpriydpu-1780	) vodia pasārehi hatthaṃ /	vodia pasārehi hattham 
SA_GK20_hpriydpu-1781	bhaiṇīe aggahatthaṃ de pāridosiaṃ dāvissaṃ /	bhaiṇīe agga hattham de pāridosiam dāvissam 
SA_GK20_hpriydpu-1782	[vaidya prasāraya hastam /	vaidya prasāraya hastam 
SA_GK20_hpriydpu-1783	bhaginyā agrahastaṃ te pāritoṣikaṃ dāpayiṣyāmi /]	bhaginyāḥ agra hastam te pāritoṣikam dāpayiṣyāmi 
SA_GK20_hpriydpu-1784	(rājā hastaṃ prasārayati /)	rājā hastam prasārayati 
SA_GK20_hpriydpu-1785	(Vāsavadattā Priyadarśikāhastam arpayati /)	vāsavadattā priyadarśikā hastam arpayati 
SA_GK20_hpriydpu-1786	rājā - (hastam upasaṃhṛtya /	rājā hastam upasaṃhṛtya 
SA_GK20_hpriydpu-1787	) kim anayā /	kim anayā 
SA_GK20_hpriydpu-1788	sampraty eva katham api prasāditāsi /	samprati eva katham api prasāditā asi 
SA_GK20_hpriydpu-1789	Vāsavadattā - ko tumaṃ agaṇhiduṃ /	vāsavadattā kaḥ tumam 
SA_GK20_hpriydpu-1790	puḍhamaṃ evva tādeṇa iaṃ diṇṇā /	puḍhamam evva tādeṇa iam diṇṇā 
SA_GK20_hpriydpu-1791	[kas tvam agrahītum /	kaḥ tvam a grahītum 
SA_GK20_hpriydpu-1792	prathamam eva tāteneyaṃ dattā /]	prathamam eva tātena iyam dattā 
SA_GK20_hpriydpu-1793	vidūṣakaḥ - bho māṇaṇīā kkhu devī /	vidūṣakaḥ bho māṇaṇīā kkhu devī 
SA_GK20_hpriydpu-1794	mā se paḍiūlaṃ karehi /	mā se paḍiūlam karehi 
SA_GK20_hpriydpu-1795	[bho mānanīyā khalu devī /	bho mānanīyā khalu devī 
SA_GK20_hpriydpu-1796	māsyāḥ pratikūlaṃ kuru /]	mā asyāḥ pratikūlam kuru 
SA_GK20_hpriydpu-1797	(Vāsavadattā rājño hastaṃ balād ākṛṣya Priyadarśikām arpayati /)	vāsavadattā rājñaḥ hastam balāt ākṛṣya priyadarśikām arpayati 
SA_GK20_hpriydpu-1798	rājā - (sasmitam /	rājā sa smitam 
SA_GK20_hpriydpu-1799	) devī prabhavati /	devī prabhavati 
SA_GK20_hpriydpu-1800	kuto 'smākam anyathā kartuṃ vibhavaḥ /	kutas smākam anyathā kartum vibhavaḥ 
SA_GK20_hpriydpu-1801	Vāsavadattā - ajjautta ado vi paraṃ kiṃ de piaṃ karīadu /	vāsavadattā ajjautta adaḥ vi param kim de piam 
SA_GK20_hpriydpu-1802	[āryaputra ato 'pi paraṃ kiṃ te priyaṃ kriyatām /]	āryaputra param kim te priyam kriyatām 
SA_GK20_hpriydpu-1803	rājā - kim ataḥ paraṃ priyam / paśya /	rājā kim atas param priyam paśya 
SA_GK20_hpriydpu-1804	niḥśeṣaṃ Dṛḍhavarmaṇā punar api svaṃ rājyam adhyāsitaṃ	niḥśeṣam dṛḍhavarmaṇā punar api svam rājyam adhyāsitam 
SA_GK20_hpriydpu-1805	tvaṃ kopena sudūram apy apahṛtā sadyaḥ prasannā mama /	tvam kopena su dūram api apahṛtā sadyas prasannā mama 
SA_GK20_hpriydpu-1806	jīvantī Priyadarśanā ca bhaginī bhūyas tvayā saṅgatā	jīvantī priyadarśanā ca bhaginī bhūyas tvayā saṅgatā 
SA_GK20_hpriydpu-1807	kiṃ tat syād aparaṃ priyaṃ priyatame yat sāmprataṃ prārthyate // HPri_4.11 //	kim tat syāt aparam priyam priyatame yat sāmpratam prārthyate 
SA_GK20_hpriydpu-1808	[p. 59]	p 
SA_GK20_hpriydpu-1809	tathāpīdam astu /	tathā api idam astu 
SA_GK20_hpriydpu-1810	(bharatavākyam /)	bharata vākyam 
SA_GK20_hpriydpu-1811	urvīm uddāmasasyāṃ janayatu visṛjan Vāsavo vṛṣṭim iṣṭām	urvīm uddāma sasyām janayatu visṛjan vāsavaḥ vṛṣṭim iṣṭām 
SA_GK20_hpriydpu-1812	iṣṭais traiviṣṭapānām vidadhatu vidhivat prīṇanaṃ vipramukhyāḥ /	iṣṭaiḥ traiviṣṭapānām vidadhatu vidhivat prīṇanam vipra mukhyāḥ 
SA_GK20_hpriydpu-1813	ākalpāntaṃ ca bhūyāt sthirasamupacitā saṃgatiḥ sajjanānāṃ	ākalpa antam ca bhūyāt sthira samupacitā saṃgatiḥ sat janānām 
SA_GK20_hpriydpu-1814	niḥśeṣaṃ yāntu śāntiṃ piśunajanagiro duḥsahā vajralepāḥ // HPri_4.12 //	niḥśeṣam yāntu śāntim piśuna jana giraḥ duḥsahāḥ vajra lepāḥ 
SA_GK20_hpriydpu-1815	(iti niṣkrāntāḥ sarve /)	iti niṣkrāntāḥ sarve 
SA_GK20_hpriydpu-1816	iti caturtho 'ṅkaḥ	iti caturthaḥ ṅkaḥ 
SA_GK20_hpriydpu-1817	samāpteyaṃ Priyadarśikā nāma nāṭikā /	samāptā iyam priyadarśikā nāma nāṭikā 
