segmentnr	original	analyzed
SA_GSP34_hathyopu-0	haṭha-yoga-pradīpikā (1)	        
SA_GSP34_hathyopu-1	prathamopadeśaḥ	prathama upadeśaḥ 
SA_GSP34_hathyopu-2	śrī-ādi-nāthāya namo'stu tasmai	śrī ādināthāya namaḥ astu tasmai 
SA_GSP34_hathyopu-3	yenopadiṣṭā haṭha-yoga-vidyā /	yena upadiṣṭā haṭha yoga vidyā 
SA_GSP34_hathyopu-4	vibhrājate pronnata-rāja-yogam	vibhrājate pronnata rājayogam 
SA_GSP34_hathyopu-5	āroḍhum icchor adhirohiṇīva // HYP_1.1 //	āroḍhum icchoḥ adhirohiṇī iva 
SA_GSP34_hathyopu-6	praṇamya śrī-guruṃ nāthaṃ svātmārāmeṇa yoginā /	praṇamya śrī gurum nātham sva ātma ārāmeṇa yoginā 
SA_GSP34_hathyopu-7	kevalaṃ rāja-yogāya haṭha-vidyopadiśyate // HYP_1.2 //	kevalam rājayogāya haṭhavidyā upadiśyate 
SA_GSP34_hathyopu-8	bhrāntyā bahumata-dhvānte rāja-yogam ajānatām /	bhrāntyā bahu mata dhvānte rājayogam a jānatām 
SA_GSP34_hathyopu-9	haṭha-pradīpikāṃ dhatte svātmārāmaḥ kṛpākaraḥ // HYP_1.3 //	              
SA_GSP34_hathyopu-10	haṭha-vidyāṃ hi matsyendra-gorakṣādyā vijānate /	haṭha vidyām hi matsyendra gorakṣa ādyāḥ vijānate 
SA_GSP34_hathyopu-11	svātmārāmo'thavā yogī jānīte tat-prasādataḥ // HYP_1.4 //	sva ātma ārāmaḥ athavā yogī jānīte tad prasādataḥ 
SA_GSP34_hathyopu-12	śrī-ādinātha-matsyendra-śāvarānanda-bhairavāḥ /	             
SA_GSP34_hathyopu-13	cauraṅgī-mīna-gorakṣa-virūpākṣa-bileśayāḥ // HYP_1.5 //	cauraṅgī mīna gorakṣa virūpākṣa bileśayāḥ 
SA_GSP34_hathyopu-14	manthāno bhairavo yogī siddhir buddhaś ca kanthaḍiḥ /	manthānaḥ bhairavaḥ yogī siddhiḥ buddhaḥ ca kanthaḍiḥ 
SA_GSP34_hathyopu-15	koraṃṭakaḥ surānandaḥ siddhapādaś ca carpaṭiḥ // HYP_1.6 //	koraṃṭakaḥ surānandaḥ siddhapādaḥ ca carpaṭiḥ 
SA_GSP34_hathyopu-16	kānerī pūjyapādaś ca nitya-nātho nirañjanaḥ /	          
SA_GSP34_hathyopu-17	kapālī bindunāthaś ca kākacaṇḍīśvarāhvayaḥ // HYP_1.7 //	             
SA_GSP34_hathyopu-18	allāmaḥ prabhudevaś ca ghoḍā colī ca ṭiṃṭiṇiḥ /	allāmaḥ prabhudevaḥ ca ghoḍā colī ca ṭiṃṭiṇiḥ 
SA_GSP34_hathyopu-19	bhānukī nāradevaś ca khaṇḍaḥ kāpālikas tathā // HYP_1.8 //	bhānukī nāradevaḥ ca khaṇḍaḥ kāpālikaḥ tathā 
SA_GSP34_hathyopu-20	ity ādayo mahāsiddhā haṭha-yoga-prabhāvataḥ /	iti ādayaḥ mahā siddhāḥ haṭhayoga prabhāvataḥ 
SA_GSP34_hathyopu-21	khaṇḍayitvā kāla-daṇḍaṃ brahmāṇḍe vicaranti te // HYP_1.9 //	khaṇḍayitvā kāladaṇḍam brahmāṇḍe vicaranti te 
SA_GSP34_hathyopu-22	aśeṣa-tāpa-taptānāṃ samāśraya-maṭho haṭhaḥ /	aśeṣa tāpa taptānām samāśraya maṭhaḥ haṭhaḥ 
SA_GSP34_hathyopu-23	aśeṣa-yoga-yuktānām ādhāra-kamaṭho haṭhaḥ // HYP_1.10 //	          
SA_GSP34_hathyopu-24	haṭha-vidyā paraṃ gopyā yoginā siddhim icchatā /	haṭhavidyā param gopyā yoginā siddhim icchatā 
SA_GSP34_hathyopu-25	bhaved vīryavatī guptā nirvīryā tu prakāśitā // HYP_1.11 //	bhavet vīryavatī guptā nirvīryā tu prakāśitā 
SA_GSP34_hathyopu-26	surājye dhārmike deśe subhikṣe nirupadrave /	su rājye dhārmike deśe subhikṣe nirupadrave 
SA_GSP34_hathyopu-27	dhanuḥ pramāṇa-paryantaṃ śilāgni-jala-varjite /	dhanuḥ pramāṇa paryantam śilā agni jala varjite 
SA_GSP34_hathyopu-28	ekānte maṭhikā-madhye sthātavyaṃ haṭha-yoginā // HYP_1.12 //	ekānte maṭhikā madhye sthātavyam haṭhayoginā 
SA_GSP34_hathyopu-29	alpa-dvāram arandhra-garta-vivaraṃ nātyucca-nīcāyataṃ	alpa dvāram arandhra garta vivaram na ati ucca nīca āyatam 
SA_GSP34_hathyopu-30	samyag-gomaya-sāndra-liptam amalaṃ niḥśesa-jantūjjhitam /	samyak gomaya sāndra liptam amalam niḥśesa jantu ujjhitam 
SA_GSP34_hathyopu-31	bāhye maṇḍapa-vedi-kūpa-ruciraṃ prākāra-saṃveṣṭitaṃ	bāhye maṇḍapa vedi kūpa ruciram prākāra saṃveṣṭitam 
SA_GSP34_hathyopu-32	proktaṃ yoga-maṭhasya lakṣaṇam idaṃ siddhair haṭhābhyāsibhiḥ // HYP_1.13 //	proktam yoga maṭhasya lakṣaṇam idam siddhaiḥ haṭha abhyāsibhiḥ 
SA_GSP34_hathyopu-33	evaṃ vidhe maṭhe sthitvā sarva-cintā-vivarjitaḥ /	evaṃvidhe maṭhe sthitvā sarva cintā vivarjitaḥ 
SA_GSP34_hathyopu-34	gurūpadiṣṭa-mārgeṇa yogam eva samabhyaset // HYP_1.14 //	guru upadiṣṭa mārgeṇa yogam eva samabhyaset 
SA_GSP34_hathyopu-35	atyāhāraḥ prayāsaś ca prajalpo niyamāgrahaḥ /	atyāhāraḥ prayāsaḥ ca prajalpaḥ niyama agrahaḥ 
SA_GSP34_hathyopu-36	jana-saṅgaś ca laulyaṃ ca ṣaḍbhir yogo vinaśyati // HYP_1.15 //	jana saṅgaḥ ca laulyam ca ṣaḍbhiḥ yogaḥ vinaśyati 
SA_GSP34_hathyopu-37	utsāhāt sāhasād dhairyāt tattva-jñānāś ca niścayāt /	utsāhāt sāhasāt dhairyāt tattva jñānāḥ ca niścayāt 
SA_GSP34_hathyopu-38	jana-saṅga-parityāgāt ṣaḍbhir yogaḥ prasiddhyati // HYP_1.16 //	jana saṅga parityāgāt ṣaḍbhiḥ yogaḥ prasiddhi ati 
SA_GSP34_hathyopu-39	atha yama-niyamāḥ	atha yama niyamāḥ 
SA_GSP34_hathyopu-40	ahiṃsā satyam asteyaṃ brahmacaryaṃ kṣamā dhṛtiḥ /	ahiṃsā satyam asteyam brahmacaryam kṣamā dhṛtiḥ 
SA_GSP34_hathyopu-41	dayārjavaṃ mitāhāraḥ śaucaṃ caiva yamā daśa // HYP_1.17 //	dayā ārjavam mita āhāraḥ śaucam ca eva yamāḥ daśa 
SA_GSP34_hathyopu-42	tapaḥ santoṣa āstikyaṃ dānam īśvara-pūjanam /	tapaḥ santoṣaḥ āstikyam dānam īśvara pūjanam 
SA_GSP34_hathyopu-43	siddhānta-vākya-śravaṇaṃ hrīmatī ca tapo hutam /	siddhānta vākya śravaṇam hrīmatī ca tapaḥ hutam 
SA_GSP34_hathyopu-44	niyamā daśa samproktā yoga-śāstra-viśāradaiḥ // HYP_1.18 //	niyamāḥ daśa samproktāḥ yoga śāstra viśāradaiḥ 
SA_GSP34_hathyopu-45	atha āsanam	atha āsanam 
SA_GSP34_hathyopu-46	haṭhasya prathamāṅgatvād āsanaṃ pūrvam ucyate /	haṭhasya prathama aṅga tvāt āsanam pūrvam ucyate 
SA_GSP34_hathyopu-47	kuryāt tad āsanaṃ sthairyam ārogyaṃ cāṅga-lāghavam // HYP_1.19 //	kuryāt tat āsanam sthairyam ārogyam ca aṅga lāghavam 
SA_GSP34_hathyopu-48	vaśiṣṭhādyaiś ca munibhir matsyendrādyaiś ca yogibhiḥ /	vaśiṣṭha ādyaiḥ ca munibhiḥ matsyendra ādyaiḥ ca yogibhiḥ 
SA_GSP34_hathyopu-49	aṅgīkṛtāny āsanāni kathyante kānicin mayā // HYP_1.20 //	aṅgīkṛtāni āsanāni kathyante kānicid mayā 
SA_GSP34_hathyopu-50	jānūrvor antare samyak kṛtvā pāda-tale ubhe /	jānu ūrvoḥ antare samyak kṛtvā pāda tale ubhe 
SA_GSP34_hathyopu-51	ṛju-kāyaḥ samāsīnaḥ svastikaṃ tat pracakṣate // HYP_1.21 //	ṛju kāyaḥ samāsīnaḥ svastikam tat pracakṣate 
SA_GSP34_hathyopu-52	savye dakṣiṇa-gulphaṃ tu pṛṣṭha-pārśve niyojayet /	savye dakṣiṇa gulpham tu pṛṣṭha pārśve niyojayet 
SA_GSP34_hathyopu-53	dakṣiṇe'pi tathā savyaṃ gomukhaṃ gomukhākṛtiḥ // HYP_1.22 //	dakṣiṇe api tathā savyam gomukham go mukha ākṛtiḥ 
SA_GSP34_hathyopu-54	ekaṃ pādaṃ tathaikasmin vinyased uruṇi sthiram /	ekam pādam tathā ekasmin vinyaset uruṇi sthiram 
SA_GSP34_hathyopu-55	itarasmiṃs tathā coruṃ vīrāsanam itīritam // HYP_1.23 //	itarasmin tathā ca ūrum vīrāsanam iti īritam 
SA_GSP34_hathyopu-56	gudaṃ nirudhya gulphābhyāṃ vyutkrameṇa samāhitaḥ /	gudam nirudhya gulphābhyām vyutkrameṇa samāhitaḥ 
SA_GSP34_hathyopu-57	kūrmāsanaṃ bhaved etad iti yoga-vido viduḥ // HYP_1.24 //	kūrmāsanam bhavet etat iti yoga vidaḥ viduḥ 
SA_GSP34_hathyopu-58	padmāsanaṃ tu saṃsthāpya jānūrvor antare karau /	padmāsanam tu saṃsthāpya jānu ūrvoḥ antare karau 
SA_GSP34_hathyopu-59	niveśya bhūmau saṃsthāpya vyomasthaṃ kukkuṭāsanam // HYP_1.25 //	niveśya bhūmau saṃsthāpya vyoma stham kukkuṭāsanam 
SA_GSP34_hathyopu-60	kukkuṭāsana-bandha-stho dorbhyāṃ sambadya kandharām /	kukkuṭāsana bandha sthaḥ dorbhyām sambadya kandharām 
SA_GSP34_hathyopu-61	bhaved kūrmavad uttāna etad uttāna-kūrmakam // HYP_1.26 //	bhavet kūrma vat uttānaḥ etat uttānakūrmakam 
SA_GSP34_hathyopu-62	pādāṅguṣṭhau tu pāṇibhyāṃ gṛhītvā śravaṇāvadhi /	pādāṅguṣṭhau tu pāṇibhyām gṛhītvā śravaṇa avadhi 
SA_GSP34_hathyopu-63	dhanur ākarṣaṇaṃ kuryād dhanur-āsanam ucyate // HYP_1.27 //	dhanuḥ ākarṣaṇam kuryāt dhanurāsanam ucyate 
SA_GSP34_hathyopu-64	vāmoru-mūlārpita-dakṣa-pādaṃ	vāma ūru mūla arpita dakṣa pādam 
SA_GSP34_hathyopu-65	jānor bahir veṣṭita-vāma-pādam /	jānoḥ bahis veṣṭita vāma pādam 
SA_GSP34_hathyopu-66	pragṛhya tiṣṭhet parivartitāṅgaḥ	pragṛhya tiṣṭhet parivartita aṅgaḥ 
SA_GSP34_hathyopu-67	śrī-matysanāthoditam āsanaṃ syāt // HYP_1.28 //	śrīmatī sanātha uditam āsanam syāt 
SA_GSP34_hathyopu-68	matsyendra-pīṭhaṃ jaṭhara-pradīptiṃ	matsyendra pīṭham jaṭhara pradīptim 
SA_GSP34_hathyopu-69	pracaṇḍa-rug maṇḍala-khaṇḍanāstram /	pracaṇḍa ruj maṇḍala khaṇḍana astram 
SA_GSP34_hathyopu-70	abhyāsataḥ kuṇḍalinī-prabodhaṃ	abhyāsataḥ kuṇḍalinīprabodham 
SA_GSP34_hathyopu-71	candra-sthiratvaṃ ca dadāti puṃsām // HYP_1.29 //	candra sthira tvam ca dadāti puṃsām 
SA_GSP34_hathyopu-72	prasārya pādau bhuvi daṇḍa-rūpau	prasārya pādau bhuvi daṇḍa rūpau 
SA_GSP34_hathyopu-73	dorbhyāṃ padāgra-dvitayaṃ gṛhītvā /	dorbhyām pada agra dvitayam gṛhītvā 
SA_GSP34_hathyopu-74	jānūparinyasta-lalāṭa-deśo	jānu upari nyasta lalāṭa deśaḥ 
SA_GSP34_hathyopu-75	vased idaṃ paścimatānam āhuḥ // HYP_1.30 //	vasā id idam paścimatānam āhuḥ 
SA_GSP34_hathyopu-76	iti paścimatānam āsanāgryaṃ	iti paścimatānam āsana agryam 
SA_GSP34_hathyopu-77	pavanaṃ paścima-vāhinaṃ karoti /	pavanam paścima vāhinam karoti 
SA_GSP34_hathyopu-78	udayaṃ jaṭharānalasya kuryād	udayam jaṭhara analasya kuryāt 
SA_GSP34_hathyopu-79	udare kārśyam arogatāṃ ca puṃsām // HYP_1.31 //	udare kārśyam aroga tām ca puṃsām 
SA_GSP34_hathyopu-80	dharām avaṣṭabhya kara-dvayena	dharām avaṣṭabhya kara dvayena 
SA_GSP34_hathyopu-81	tat-kūrpara-sthāpita-nābhi-pārśvaḥ /	tad kūrpara sthāpita nābhi pārśvaḥ 
SA_GSP34_hathyopu-82	uccāsano daṇḍavad utthitaḥ khe	ucca āsanaḥ daṇḍa vat utthitaḥ khe 
SA_GSP34_hathyopu-83	māyūram etat pravadanti pīṭham // HYP_1.32 //	māyūram etat pravadanti pīṭham 
SA_GSP34_hathyopu-84	harati sakala-rogān āśu gulmodarādīn	harati sakala rogān āśu gulmodara ādīn 
SA_GSP34_hathyopu-85	abhibhavati ca doṣān āsanaṃ śrī-mayūram /	abhibhavati ca doṣān āsanam śrī mayūram 
SA_GSP34_hathyopu-86	bahu kadaśana-bhuktaṃ bhasma kuryād aśeṣaṃ	bahu kadaśana bhuktam bhasma kuryāt aśeṣam 
SA_GSP34_hathyopu-87	janayati jaṭharāgniṃ jārayet kāla-kūṭam // HYP_1.33 //	janayati jaṭhara agnim jārayet kālakūṭam 
SA_GSP34_hathyopu-88	uttānaṃ śabavad bhūmau śayanaṃ tac chavāsanam /	uttānam śabavat bhūmau śayanam tat śavāsanam 
SA_GSP34_hathyopu-89	śavāsanaṃ śrānti-haraṃ citta-viśrānti-kārakam // HYP_1.34 //	            
SA_GSP34_hathyopu-90	caturaśīty āsanāni śivena kathitāni ca /	caturaśītī āsanāni śivena kathitāni ca 
SA_GSP34_hathyopu-91	tebhyaś catuṣkam ādāya sārabhūtaṃ bravīmy aham // HYP_1.35 //	tebhyaḥ catuṣkam ādāya sāra bhūtam bravīmi aham 
SA_GSP34_hathyopu-92	siddhaṃ padmaṃ tathā siṃhaṃ bhadraṃ veti catuṣṭayam /	siddham padmam tathā siṃham bhadram vā iti catuṣṭayam 
SA_GSP34_hathyopu-93	śreṣṭhaṃ tatrāpi ca sukhe tiṣṭhet siddhāsane sadā // HYP_1.36 //	śreṣṭham tatra api ca sukhe tiṣṭhet siddhāsane sadā 
SA_GSP34_hathyopu-94	atha siddhāsanam-	atha siddhāsanam 
SA_GSP34_hathyopu-95	yoni-sthānakam aṅghri-mūla-ghaṭitaṃ kṛtvā dṛḍhaṃ vinyaset	                        
SA_GSP34_hathyopu-96	meṇḍhre pādam athaikam eva hṛdaye kṛtvā hanuṃ susthiram /	meṇḍhre pādam atha ekam eva hṛdaye kṛtvā hanum su sthiram 
SA_GSP34_hathyopu-97	sthāṇuḥ saṃyamitendriyo'cala-dṛśā paśyed bhruvor antaraṃ	sthāṇuḥ saṃyamita indriya ucala dṛśā paśyet bhruvoḥ antaram 
SA_GSP34_hathyopu-98	hy etan mokṣa-kapāṭa-bheda-janakaṃ siddhāsanaṃ procyate // HYP_1.37 //	hi etat mokṣa kapāṭa bheda janakam siddhāsanam procyate 
SA_GSP34_hathyopu-99	meṇḍhrād upari vinyasya savyaṃ gulphaṃ tathopari /	meṇḍhrāt upari vinyasya savyam gulpham tathā upari 
SA_GSP34_hathyopu-100	gulphāntaraṃ ca nikṣipya siddhāsanam idaṃ bhavet // HYP_1.38 //	gulpha antaram ca nikṣipya siddhāsanam idam bhavet 
SA_GSP34_hathyopu-101	etat siddhāsanaṃ prāhur anye vajrāsanaṃ viduḥ /	etat siddhāsanam prāhuḥ anye vajrāsanam viduḥ 
SA_GSP34_hathyopu-102	muktāsanaṃ vadanty eke prāhur guptāsanaṃ pare // HYP_1.39 //	muktāsanam vadanti eke prāhuḥ guptāsanam pare 
SA_GSP34_hathyopu-103	yameṣv iva mitāhāram ahiṃsā niyameṣv iva /	yameṣu iva mita āhāram ahiṃsā niyameṣu iva 
SA_GSP34_hathyopu-104	mukhyaṃ sarvāsaneṣv ekaṃ siddhāḥ siddhāsanaṃ viduḥ // HYP_1.40 //	mukhyam sarva āsaneṣu ekam siddhāḥ siddhāsanam viduḥ 
SA_GSP34_hathyopu-105	caturaśīti-pīṭheṣu siddham eva sadābhyaset /	caturaśīti pīṭheṣu siddham eva sadā abhyaset 
SA_GSP34_hathyopu-106	dvāsaptati-sahasrāṇāṃ nāḍīnāṃ mala-śodhanam // HYP_1.41 //	dvāsaptati sahasrāṇām nāḍīnām mala śodhanam 
SA_GSP34_hathyopu-107	ātma-dhyāyī mitāhārī yāvad dvādaśa-vatsaram /	ātma dhyāyī mita āhārī yāvat dvādaśa vatsaram 
SA_GSP34_hathyopu-108	sadā siddhāsanābhyāsād yogī niṣpattim āpnuyāt // HYP_1.42 //	sadā siddhāsana abhyāsāt yogī niṣpattim āpnuyāt 
SA_GSP34_hathyopu-109	kim anyair bahubhiḥ pīṭhaiḥ siddhe siddhāsane sati /	kim anyaiḥ bahubhiḥ pīṭhaiḥ siddhe siddhāsane sati 
SA_GSP34_hathyopu-110	prāṇānile sāvadhāne baddhe kevala-kumbhake /	               
SA_GSP34_hathyopu-111	utpadyate nirāyāsāt svayam evonmanī kalā // HYP_1.43 //	utpadyate nirāyāsāt svayam evā unmanī kalā 
SA_GSP34_hathyopu-112	tathaikāsminn eva dṛḍhe siddhe siddhāsane sati /	tathā ekā asmin eva dṛḍhe siddhe siddhāsane sati 
SA_GSP34_hathyopu-113	bandha-trayam anāyāsāt svayam evopajāyate // HYP_1.44 //	bandha trayam anāyāsāt svayam eva upajāyate 
SA_GSP34_hathyopu-114	nāsanaṃ siddha-sadṛśaṃ na kumbhaḥ kevalopamaḥ /	na āsanam siddha sadṛśam na kumbhaḥ kevala upamaḥ 
SA_GSP34_hathyopu-115	na khecarī-samā mudrā na nāda-sadṛśo layaḥ // HYP_1.45 //	na khecarī samā mudrā na nāda sadṛśaḥ layaḥ 
SA_GSP34_hathyopu-116	atha padmāsanam-	atha padmāsanam 
SA_GSP34_hathyopu-117	vāmorūpari dakṣiṇaṃ ca caraṇaṃ saṃsthāpya vāmaṃ tathā	vāma ūru upari dakṣiṇam ca caraṇam saṃsthāpya vāmam tathā 
SA_GSP34_hathyopu-118	dakṣorūpari paścimena vidhinā dhṛtvā karābhyāṃ dṛḍham /	dakṣa ūru upari paścimena vidhinā dhṛtvā karābhyām dṛḍham 
SA_GSP34_hathyopu-119	aṅguṣṭhau hṛdaye nidhāya cibukaṃ nāsāgram ālokayet	aṅguṣṭhau hṛdaye nidhāya cibukam nāsā agram ālokayet 
SA_GSP34_hathyopu-120	etad vyādhi-vināśa-kāri yamināṃ padmāsanaṃ procyate // HYP_1.46 //	etat vyādhi vināśa kāri yaminām padmāsanam procyate 
SA_GSP34_hathyopu-121	uttānau caraṇau kṛtvā ūru-saṃsthau prayatnataḥ /	uttānau caraṇau kṛtvā ūru saṃsthau prayatnataḥ 
SA_GSP34_hathyopu-122	ūru-madhye tathottānau pāṇī kṛtvā tato dṛśau // HYP_1.47 //	ūru madhye tathā uttānau pāṇī kṛtvā tatas dṛśau 
SA_GSP34_hathyopu-123	nāsāgre vinyased rājad-anta-mūle tu jihvayā /	nāsā agre vinyaset rājadanta mūle tu jihvayā 
SA_GSP34_hathyopu-124	uttambhya cibukaṃ vakṣasy utthāpy pavanaṃ śanaiḥ // HYP_1.48 //	uttambhya cibukam vakṣasi utthāpī pavanam śanais 
SA_GSP34_hathyopu-125	idaṃ padmāsanaṃ proktaṃ sarva-vyādhi-vināśanam /	idam padmāsanam proktam sarva vyādhi vināśanam 
SA_GSP34_hathyopu-126	durlabhaṃ yena kenāpi dhīmatā labhyate bhuvi // HYP_1.49 //	durlabham yena kena api dhīmatā labhyate bhuvi 
SA_GSP34_hathyopu-127	kṛtvā sampuṭitau karau dṛḍhataraṃ baddhvā tu padmāsanaṃ	kṛtvā sampuṭitau karau dṛḍhataram baddhvā tu padmāsanam 
SA_GSP34_hathyopu-128	gāḍhaṃ vakṣasi sannidhāya cibukaṃ dhyāyaṃś ca tac cetasi /	gāḍham vakṣasi sannidhāya cibukam dhyāyan ca tat cetasi 
SA_GSP34_hathyopu-129	vāraṃ vāram apānam ūrdhvam anilaṃ protsārayan pūritaṃ	vāram vāram apānam ūrdhvam anilam protsārayan pūritam 
SA_GSP34_hathyopu-130	nyañcan prāṇam upaiti bodham atulaṃ śakti-prabhāvān naraḥ // HYP_1.50 //	nyañcan prāṇam upaiti bodham atulam śakti prabhāvāt naraḥ 
SA_GSP34_hathyopu-131	padmāsane sthito yogī nāḍī-dvāreṇa pūritam /	            
SA_GSP34_hathyopu-132	mārutaṃ dhārayed yas tu sa mukto nātra saṃśayaḥ // HYP_1.51 //	mārutam dhārayet yaḥ tu sa muktaḥ na atra saṃśayaḥ 
SA_GSP34_hathyopu-133	atha siṃhāsanam-	atha siṃhāsanam 
SA_GSP34_hathyopu-134	gulphau ca vṛṣaṇasyādhaḥ sīvanyāḥ pārśvayoḥ kṣipet /	gulphau ca vṛṣaṇasya adhas sīvanyāḥ pārśvayoḥ kṣipet 
SA_GSP34_hathyopu-135	dakṣiṇe savya-gulphaṃ tu dakṣa-gulphaṃ tu savyake // HYP_1.52 //	dakṣiṇe savya gulpham tu dakṣa gulpham tu savyake 
SA_GSP34_hathyopu-136	hastau tu jānvoḥ saṃsthāpya svāṅgulīḥ samprasārya ca /	hastau tu jānvoḥ saṃsthāpya sva aṅgulīḥ samprasārya ca 
SA_GSP34_hathyopu-137	vyātta-vaktro nirīkṣeta nāsāgraṃ susamāhitaḥ // HYP_1.53 //	vyātta vaktraḥ nirīkṣeta nāsā agram su samāhitaḥ 
SA_GSP34_hathyopu-138	siṃhāsanaṃ bhaved etat pūjitaṃ yogi-puṅgavaiḥ /	siṃhāsanam bhavet etat pūjitam yogi puṅgavaiḥ 
SA_GSP34_hathyopu-139	bandha-tritaya-sandhānaṃ kurute cāsanottamam // HYP_1.54 //	bandha tritaya sandhānam kurute ca āsana uttamam 
SA_GSP34_hathyopu-140	atha bhadrāsanam-	atha bhadrāsanam 
SA_GSP34_hathyopu-141	gulphau ca vṛṣaṇasyādhaḥ sīvanyāḥ pārśvayoḥ kṣipte /	gulphau ca vṛṣaṇasya adhas sīvanyāḥ pārśvayoḥ kṣipte 
SA_GSP34_hathyopu-142	savya-gulphaṃ tathā savye dakṣa-gulphaṃ tu dakṣiṇe // HYP_1.55 //	savya gulpham tathā savye dakṣa gulpham tu dakṣiṇe 
SA_GSP34_hathyopu-143	pārśva-pādau ca pāṇibhyāṃ dṛḍhaṃ baddhvā suniścalam /	pārśva pādau ca pāṇibhyām dṛḍham baddhvā su niścalam 
SA_GSP34_hathyopu-144	bhadrāsanaṃ bhaved etat sarva-vyādhi-vināśanam /	bhadrāsanam bhavet etat sarva vyādhi vināśanam 
SA_GSP34_hathyopu-145	gorakṣāsanam ity āhur idaṃ vai siddha-yoginaḥ // HYP_1.56 //	gorakṣāsanam iti āhuḥ idam vai siddha yoginaḥ 
SA_GSP34_hathyopu-146	evam āsana-bandheṣu yogīndro vigata-śramaḥ /	evam āsana bandheṣu yogi indraḥ vigata śramaḥ 
SA_GSP34_hathyopu-147	abhyasen nāḍikā-śuddhiṃ mudrādi-pavanī-kriyām // HYP_1.57 //	abhyaset nāḍikā śuddhim mudrā ādi pavanīkriyām 
SA_GSP34_hathyopu-148	āsanaṃ kumbhakaṃ citraṃ mudrākhyaṃ karaṇaṃ tathā /	āsanam kumbhakam citram mudrā ākhyam karaṇam tathā 
SA_GSP34_hathyopu-149	atha nādānusandhānam abhyāsānukramo haṭhe // HYP_1.58 //	atha nāda anusandhānam abhyāsa anukramaḥ haṭhe 
SA_GSP34_hathyopu-150	brahmacārī mitāhārī tyāgī yoga-parāyaṇaḥ /	            
SA_GSP34_hathyopu-151	abdād ūrdhvaṃ bhavet siddho nātra kāryā vicāraṇā // HYP_1.59 //	abdāt ūrdhvam bhavet siddhaḥ na atra kāryā vicāraṇā 
SA_GSP34_hathyopu-152	susnigdha-madhurāhāraś caturthāṃśa-vivarjitaḥ /	su snigdha madhura āhāraḥ caturtha aṃśa vivarjitaḥ 
SA_GSP34_hathyopu-153	bhujyate śiva-samprītyai mitāhāraḥ sa ucyate // HYP_1.60 //	bhujyate śiva samprītyai mita āhāraḥ saḥ ucyate 
SA_GSP34_hathyopu-154	kaṭvāmla-tīkṣṇa-lavaṇoṣṇa-harīta-śāka-	                 
SA_GSP34_hathyopu-155	sauvīra-taila-tila-sarṣapa-madya-matsyān /	sauvīra taila tila sarṣapa madya matsyān 
SA_GSP34_hathyopu-156	ājādi-māṃsa-dadhi-takra-kulatthakola-	āja ādi māṃsa dadhi takra kulattha kola 
SA_GSP34_hathyopu-157	piṇyāka-hiṅgu-laśunādyam apathyam āhuḥ // HYP_1.61 //	piṇyāka hiṅgu laśuna ādyam apathyam āhuḥ 
SA_GSP34_hathyopu-158	bhojanam ahitaṃ vidyāt punar asyoṣṇī-kṛtaṃ rūkṣam /	bhojanam ahitam vidyāt punar asya uṣṇīkṛtam rūkṣam 
SA_GSP34_hathyopu-159	atilavaṇam amla-yuktaṃ kadaśana-śākotkaṃ varjyam // HYP_1.62 //	ati lavaṇam amla yuktam kadaśana śāka utkam varjyam 
SA_GSP34_hathyopu-160	vahni-strī-pathi-sevānām ādau varjanam ācaret // HYP_1.63 //	vahni strī pathi sevānām ādau varjanam ācaret 
SA_GSP34_hathyopu-161	tathā hi gorakṣa-vacanam-	tathā hi gorakṣa vacanam 
SA_GSP34_hathyopu-162	varjayed durjana-prāntaṃ vahni-strī-pathi-sevanam /	varjayet durjana prāntam vahni strī pathi sevanam 
SA_GSP34_hathyopu-163	prātaḥ-snānopavāsādi kāya-kleśa-vidhiṃ tathā // HYP_1.64 //	prātaḥsnāna upavāsa ādi kāya kleśa vidhim tathā 
SA_GSP34_hathyopu-164	godhūma-śāli-yava-ṣāṣṭika-śobhanānnaṃ	             
SA_GSP34_hathyopu-165	kṣīrājya-khaṇḍa-navanīta-siddhā-madhūni /	kṣīra ājya khaṇḍa navanīta siddhā madhūni 
SA_GSP34_hathyopu-166	śuṇṭhī-paṭola-kaphalādika-pañca-śākaṃ	śuṇṭhī paṭolaka phala ādika pañca śākam 
SA_GSP34_hathyopu-167	mudgādi-divyam udakaṃ ca yamīndra-pathyam // HYP_1.65 //	mudga ādi divyam udakam ca yami indra pathyam 
SA_GSP34_hathyopu-168	puṣṭaṃ sumadhuraṃ snigdhaṃ gavyaṃ dhātu-prapoṣaṇam /	puṣṭam su madhuram snigdham gavyam dhātu prapoṣaṇam 
SA_GSP34_hathyopu-169	manobhilaṣitaṃ yogyaṃ yogī bhojanam ācaret // HYP_1.66 //	manaḥ abhilaṣitam yogyam yogī bhojanam ācaret 
SA_GSP34_hathyopu-170	yuvo vṛddho'tivṛddho vā vyādhito durbalo'pi vā /	vṛddha utivṛddhaḥ vā vyādhitaḥ durbalaḥ upi vā 
SA_GSP34_hathyopu-171	abhyāsāt siddhim āpnoti sarva-yogeṣv atandritaḥ // HYP_1.67 //	abhyāsāt siddhim āpnoti sarva yogeṣu atandritaḥ 
SA_GSP34_hathyopu-172	kriyā-yuktasya siddhiḥ syād akriyasya kathaṃ bhavet /	kriyā yuktasya siddhiḥ syāt akriyasya katham bhavet 
SA_GSP34_hathyopu-173	na śāstra-pāṭha-mātreṇa yoga-siddhiḥ prajāyate // HYP_1.68 //	na śāstra pāṭha mātreṇa yoga siddhiḥ prajāyate 
SA_GSP34_hathyopu-174	na veṣa-dhāraṇaṃ siddheḥ kāraṇaṃ na ca tat-kathā /	na veṣa dhāraṇam siddheḥ kāraṇam na ca tad kathā 
SA_GSP34_hathyopu-175	kriyaiva kāraṇaṃ siddheḥ satyam etan na saṃśayaḥ // HYP_1.69 //	kriyā eva kāraṇam siddheḥ satyam etat na saṃśayaḥ 
SA_GSP34_hathyopu-176	pīṭhāni kumbhakāś citrā divyāni karaṇāni ca /	pīṭhāni kumbhakāḥ citrāḥ divyāni karaṇāni ca 
SA_GSP34_hathyopu-177	sarvāṇy api haṭhābhyāse rāja-yoga-phalāvadhi // HYP_1.70 //	sarvāṇi api haṭha abhyāse rājayoga phala avadhi 
SA_GSP34_hathyopu-178	iti haṭha-pradīpikāyāṃ prathamopadeśaḥ / (2)	iti haṭhapradīpikāyām prathama upadeśaḥ 
SA_GSP34_hathyopu-179	dvitīyopadeśaḥ	dvitīya upadeśaḥ 
SA_GSP34_hathyopu-180	athāsane dṛdhe yogī vaśī hita-mitāśanaḥ /	atha āsane dṛdhe yogī vaśī hita mita aśanaḥ 
SA_GSP34_hathyopu-181	gurūpadiṣṭa-mārgeṇa prāṇāyāmān samabhyaset // HYP_2.1 //	guru upadiṣṭa mārgeṇa prāṇāyāmān samabhyaset 
SA_GSP34_hathyopu-182	cale vāte calaṃ cittaṃ niścale niścalaṃ bhavet // HYP_2.	cale vāte calam cittam niścale niścalam bhavet 
SA_GSP34_hathyopu-183	yogī sthāṇutvam āpnoti tato vāyuṃ nirodhayet // HYP_2.2 //	yogī sthāṇu tvam āpnoti tatas vāyum nirodhayet 
SA_GSP34_hathyopu-184	yāvad vāyuḥ sthito dehe tāvaj jīvanam ucyate /	yāvat vāyuḥ sthitaḥ dehe tāvat jīvanam ucyate 
SA_GSP34_hathyopu-185	maraṇaṃ tasya niṣkrāntis tato vāyuṃ nirodhayet // HYP_2.3 //	maraṇam tasya niṣkrāntiḥ tatas vāyum nirodhayet 
SA_GSP34_hathyopu-186	malākalāsu nāḍīṣu māruto naiva madhyagaḥ /	malākalāsu nāḍīṣu mārutaḥ na eva madhya gaḥ 
SA_GSP34_hathyopu-187	kathaṃ syād unmanībhāvaḥ kārya-siddhiḥ kathaṃ bhavet // HYP_2.4 //	katham syāt unmanībhāvaḥ kārya siddhiḥ katham bhavet 
SA_GSP34_hathyopu-188	śuddham eti yadā sarvaṃ nāḍī-cakraṃ malākulam /	śuddham eti yadā sarvam nāḍī cakram mala ākulam 
SA_GSP34_hathyopu-189	tadaiva jāyate yogī prāṇa-saṃgrahaṇe kṣamaḥ // HYP_2.5 //	tadā eva jāyate yogī prāṇa saṃgrahaṇe kṣamaḥ 
SA_GSP34_hathyopu-190	prāṇāyāmaṃ tataḥ kuryān nityaṃ sāttvikayā dhiyā /	prāṇāyāmam tatas kuryāt nityam sāttvikayā dhiyā 
SA_GSP34_hathyopu-191	yathā suṣumṇā-nāḍīsthā malāḥ śuddhiṃ prayānti ca // HYP_2.6 //	yathā suṣumṇā nāḍī sthāḥ malāḥ śuddhim prayānti ca 
SA_GSP34_hathyopu-192	baddha-padmāsano yogī prāṇaṃ candreṇa pūrayet /	baddha padmāsanaḥ yogī prāṇam candreṇa pūrayet 
SA_GSP34_hathyopu-193	dhārayitvā yathā-śakti bhūyaḥ sūryeṇa recayet // HYP_2.7 //	dhārayitvā yathāśakti bhūyas sūryeṇa recayet 
SA_GSP34_hathyopu-194	prāṇaṃ sūryeṇa cākṛṣya pūrayed udaraṃ śanaiḥ /	prāṇam sūryeṇa ca ākṛṣya pūrayet udaram śanais 
SA_GSP34_hathyopu-195	vidhivat kumbhakaṃ kṛtvā punaś candreṇa recayet // HYP_2.8 //	vidhivat kumbhakam kṛtvā punar candreṇa recayet 
SA_GSP34_hathyopu-196	yena tyajet tena pītvā dhārayed atirodhataḥ /	yena tyajet tena pītvā dhārayet ati rodhataḥ 
SA_GSP34_hathyopu-197	recayec ca tato'nyena śanair eva na vegataḥ // HYP_2.9 //	recayet ca tatonyena śanais eva na vegataḥ 
SA_GSP34_hathyopu-198	prāṇaṃ ced iḍayā piben niyamitaṃ bhūyo'nyathā recayet	prāṇam ced iḍayā pibet niyamitam bhūyas nyathā recayet 
SA_GSP34_hathyopu-199	pītvā piṅgalayā samīraṇam atho baddhvā tyajed vāmayā /	pītvā piṅgalayā samīraṇam atho baddhvā tyajet vāmayā 
SA_GSP34_hathyopu-200	sūrya-candramasor anena vidhinābhyāsaṃ sadā tanvatāṃ	sūrya candramasoḥ anena vidhinā abhyāsam sadā tanvatām 
SA_GSP34_hathyopu-201	śuddhā nāḍi-gaṇā bhavanti yamināṃ māsa-trayād ūrdhvataḥ // HYP_2.10 //	śuddhāḥ nāḍi gaṇāḥ bhavanti yaminām māsa trayāt ūrdhvatas 
SA_GSP34_hathyopu-202	prātar madhyandine sāyam ardha-rātre ca kumbhakān /	prātar madhyandine sāyam ardharātre ca kumbhakān 
SA_GSP34_hathyopu-203	śanair aśīti-paryantaṃ catur vāraṃ samabhyaset // HYP_2.11 //	śanais aśīti paryantam catuḥ vāram samabhyaset 
SA_GSP34_hathyopu-204	kanīyasi bhaved sveda kampo bhavati madhyame /	kanīyasi bhavet sveda kampaḥ bhavati madhyame 
SA_GSP34_hathyopu-205	uttame sthānam āpnoti tato vāyuṃ nibandhayet // HYP_2.12 //	uttame sthānam āpnoti tatas vāyum nibandhayet 
SA_GSP34_hathyopu-206	jalena śrama-jātena gātra-mardanam ācaret /	jalena śrama jātena gātra mardanam ācaret 
SA_GSP34_hathyopu-207	dṛḍhatā laghutā caiva tena gātrasya jāyate // HYP_2.13 //	dṛḍha tā laghu tā ca eva tena gātrasya jāyate 
SA_GSP34_hathyopu-208	abhyāsa-kāle prathame śastaṃ kṣīrājya-bhojanam /	abhyāsa kāle prathame śastam kṣīra ājya bhojanam 
SA_GSP34_hathyopu-209	tato'bhyāse dṛḍhībhūte na tādṛṅ-niyama-grahaḥ // HYP_2.14 //	tatobhyāse dṛḍhībhūte na tādṛś niyama grahaḥ 
SA_GSP34_hathyopu-210	yathā siṃho gajo vyāghro bhaved vaśyaḥ śanaiḥ śanaiḥ /	yathā siṃhaḥ gajaḥ vyāghraḥ bhavet vaśyaḥ śanais śanais 
SA_GSP34_hathyopu-211	tathaiva sevito vāyur anyathā hanti sādhakam // HYP_2.15 //	tathā eva sevitaḥ vāyuḥ anyathā hanti sādhakam 
SA_GSP34_hathyopu-212	prāṇāyāmena yuktena sarva-roga-kṣayo bhavet /	prāṇāyāmena yuktena sarva roga kṣayaḥ bhavet 
SA_GSP34_hathyopu-213	ayuktābhyāsa-yogena sarva-roga-samudgamaḥ // HYP_2.16 //	ayukta abhyāsa yogena sarva roga samudgamaḥ 
SA_GSP34_hathyopu-214	hikkā śvāsaś ca kāsaś ca śiraḥ-karṇākṣi-vedanāḥ /	hikkā śvāsaḥ ca kāsaḥ ca śiraḥ karṇa akṣi vedanāḥ 
SA_GSP34_hathyopu-215	bhavanti vividhāḥ rogāḥ pavanasya prakopataḥ // HYP_2.17 //	bhavanti vividhāḥ rogāḥ pavanasya prakopataḥ 
SA_GSP34_hathyopu-216	yuktaṃ yuktaṃ tyajed vāyuṃ yuktaṃ yuktaṃ ca pūrayet /	yuktam yuktam tyajet vāyum yuktam yuktam ca pūrayet 
SA_GSP34_hathyopu-217	yuktaṃ yuktaṃ ca badhnīyād evaṃ siddhim avāpnuyāt // HYP_2.18 //	yuktam yuktam ca badhnīyāt evam siddhim avāpnuyāt 
SA_GSP34_hathyopu-218	yadā tu nāḍī-śuddhiḥ syāt tathā cihnāni bāhyataḥ /	yadā tu nāḍī śuddhiḥ syāt tathā cihnāni bāhyatas 
SA_GSP34_hathyopu-219	kāyasya kṛśatā kāntis tadā jāyate niścitam // HYP_2.19 //	kāyasya kṛśa tā kāntiḥ tadā jāyate niścitam 
SA_GSP34_hathyopu-220	yatheṣṭaṃ dhāraṇaṃ vāyor analasya pradīpanam /	yathā iṣṭam dhāraṇam vāyoḥ analasya pradīpanam 
SA_GSP34_hathyopu-221	nādābhivyaktir ārogyaṃ jāyate nāḍi-śodhanāt // HYP_2.20 //	              
SA_GSP34_hathyopu-222	meda-śleṣmādhikaḥ pūrvaṃ ṣaṭ-karmāṇi samācaret /	meda śleṣma adhikaḥ pūrvam ṣaṭkarmāṇi samācaret 
SA_GSP34_hathyopu-223	anyas tu nācaret tāni doṣāṇāṃ samabhāvataḥ // HYP_2.21 //	anyaḥ tu na ācaret tāni doṣāṇām sama bhāvataḥ 
SA_GSP34_hathyopu-224	dhautir bastis tathā netis trāṭakaṃ naulikaṃ tathā /	dhautiḥ bastiḥ tathā netiḥ trāṭakam naulikam tathā 
SA_GSP34_hathyopu-225	kapāla-bhātiś caitāni ṣaṭ-karmāṇi pracakṣate // HYP_2.22 //	kapālabhātiḥ ca etāni ṣaṭkarmāṇi pracakṣate 
SA_GSP34_hathyopu-226	karma ṣaṭkam idaṃ gopyaṃ ghaṭa-śodhana-kārakam /	karma ṣaṭkam idam gopyam ghaṭa śodhana kārakam 
SA_GSP34_hathyopu-227	vicitra-guṇa-sandhāya pūjyate yogi-puṅgavaiḥ // HYP_2.23 //	vicitra guṇa sandhāya pūjyate yogi puṅgavaiḥ 
SA_GSP34_hathyopu-228	tatra dhautiḥ-	tatra dhautiḥ 
SA_GSP34_hathyopu-229	catur-aṅgula-vistāraṃ hasta-pañca-daśāyatam /	catur aṅgula vistāram hasta pañcadaśa āyatam 
SA_GSP34_hathyopu-230	gurūpadiṣṭa-mārgeṇa siktaṃ vastraṃ śanair graset /	guru upadiṣṭa mārgeṇa siktam vastram śanais graset 
SA_GSP34_hathyopu-231	punaḥ pratyāharec caitad uditaṃ dhauti-karma tat // HYP_2.24 //	punar pratyāharet ca etat uditam dhautikarma tat 
SA_GSP34_hathyopu-232	kāsa-śvāsa-plīha-kuṣṭhaṃ kapharogāś ca viṃśatiḥ /	kāsa śvāsa plīha kuṣṭham kapha rogāḥ ca viṃśatiḥ 
SA_GSP34_hathyopu-233	dhauti-karma-prabhāveṇa prayānty eva na saṃśayaḥ // HYP_2.25 //	dhautikarma prabhāveṇa prayānti eva na saṃśayaḥ 
SA_GSP34_hathyopu-234	atha bastiḥ-	atha bastiḥ 
SA_GSP34_hathyopu-235	nābhi-daghna-jale pāyau nyasta-nālotkaṭāsanaḥ /	nābhi daghna jale pāyau nyasta nāla utkaṭāsanaḥ 
SA_GSP34_hathyopu-236	ādhārākuñcanaṃ kuryāt kṣālanaṃ basti-karma tat // HYP_2.26 //	ādhāra ākuñcanam kuryāt kṣālanam basti karma tat 
SA_GSP34_hathyopu-237	gulma-plīhodaraṃ cāpi vāta-pitta-kaphodbhavāḥ /	gulma plīhodaram ca api vāta pitta kapha udbhavāḥ 
SA_GSP34_hathyopu-238	basti-karma-prabhāveṇa kṣīyante sakalāmayāḥ // HYP_2.27 //	basti karma prabhāveṇa kṣīyante sakala āmayāḥ 
SA_GSP34_hathyopu-239	dhāntvadriyāntaḥ-karaṇa-prasādaṃ	dhāntva driya antaḥkaraṇa prasādam 
SA_GSP34_hathyopu-240	dadhāc ca kāntiṃ dahana-pradīptam /	dadhāt ca kāntim dahana pradīptam 
SA_GSP34_hathyopu-241	aśeṣa-doṣopacayaṃ nihanyād	aśeṣa doṣa upacayam nihanyāt 
SA_GSP34_hathyopu-242	abhyasyamānaṃ jala-basti-karma // HYP_2.28 //	abhyasyamānam jalabasti karma 
SA_GSP34_hathyopu-243	atha netiḥ-	atha netiḥ 
SA_GSP34_hathyopu-244	sūtraṃ vitasti-susnigdhaṃ nāsānāle praveśayet /	sūtram vitasti su snigdham nāsā nāle praveśayet 
SA_GSP34_hathyopu-245	mukhān nirgamayec caiṣā netiḥ siddhair nigadyate // HYP_2.29 //	mukhāt nirgamayet ca eṣā netiḥ siddhaiḥ nigadyate 
SA_GSP34_hathyopu-246	kapāla-śodhinī caiva divya-dṛṣṭi-pradāyinī /	            
SA_GSP34_hathyopu-247	jatrūrdhva-jāta-rogaughaṃ netir āśu nihanti ca // HYP_2.30 //	jatru ūrdhva jāta roga ogham netiḥ āśu nihanti ca 
SA_GSP34_hathyopu-248	atha trāṭakam-	atha trāṭakam 
SA_GSP34_hathyopu-249	nirīkṣen niścala-dṛśā sūkṣma-lakṣyaṃ samāhitaḥ /	nirīkṣet niścala dṛśā sūkṣma lakṣyam samāhitaḥ 
SA_GSP34_hathyopu-250	aśru-sampāta-paryantam ācāryais trāṭakaṃ smṛtam // HYP_2.31 //	aśru sampāta paryantam ācāryaiḥ trāṭakam smṛtam 
SA_GSP34_hathyopu-251	mocanaṃ netra-rogāṇāṃ tandādrīṇāṃ kapāṭakam /	mocanam netra rogāṇām tanda adrīṇām kapāṭakam 
SA_GSP34_hathyopu-252	yatnatas trāṭakaṃ gopyaṃ yathā hāṭaka-peṭakam // HYP_2.32 //	yatnatas trāṭakam gopyam yathā hāṭaka peṭakam 
SA_GSP34_hathyopu-253	atha nauliḥ-	atha nauliḥ 
SA_GSP34_hathyopu-254	amandāvarta-vegena tundaṃ savyāpasavyataḥ /	amanda āvarta vegena tundam savya apasavyataḥ 
SA_GSP34_hathyopu-255	natāṃso bhrāmayed eṣā nauliḥ siddhaiḥ praśasyate // HYP_2.33 //	nata aṃsaḥ bhrāmayet eṣā nauliḥ siddhaiḥ praśasyate 
SA_GSP34_hathyopu-256	mandāgni-sandīpana-pācanādi-sandhāpikānanda-karī sadaiva /	                                        
SA_GSP34_hathyopu-257	aśeṣa-doṣa-maya-śoṣaṇī ca haṭha-kriyā maulir iyaṃ ca nauliḥ // HYP_2.34 //	aśeṣa doṣa maya śoṣaṇī ca haṭha kriyā mauliḥ iyam ca nauliḥ 
SA_GSP34_hathyopu-258	atha kapālabhātiḥ-	atha kapālabhātiḥ 
SA_GSP34_hathyopu-259	bhastrāval loha-kārasya reca-pūrau sasambhramau /	bhastrā vat lohakārasya reca pūrau sa sambhramau 
SA_GSP34_hathyopu-260	kapālabhātir vikhyātā kapha-doṣa-viśoṣaṇī // HYP_2.35 //	              
SA_GSP34_hathyopu-261	ṣaṭ-karma-nirgata-sthaulya-kapha-doṣa-malādikaḥ /	ṣaṭkarma nirgata sthaulya kapha doṣa mala ādikaḥ 
SA_GSP34_hathyopu-262	prāṇāyāmaṃ tataḥ kuryād anāyāsena siddhyati // HYP_2.36 //	prāṇāyāmam tatas kuryāt anāyāsena siddhi ati 
SA_GSP34_hathyopu-263	prāṇāyāmair eva sarve praśuṣyanti malā iti /	prāṇāyāmaiḥ eva sarve praśuṣyanti malāḥ iti 
SA_GSP34_hathyopu-264	ācāryāṇāṃ tu keṣāṃcid anyat karma na saṃmatam // HYP_2.37 //	ācāryāṇām tu keṣāṃcid anyat karma na saṃmatam 
SA_GSP34_hathyopu-265	atha gaja-karaṇī-	atha gajakaraṇī 
SA_GSP34_hathyopu-266	udara-gata-padārtham udvamanti	udara gata padārtham udvamanti 
SA_GSP34_hathyopu-267	pavanam apānam udīrya kaṇṭha-nāle /	pavanam apānam udīrya kaṇṭha nāle 
SA_GSP34_hathyopu-268	krama-paricaya-vaśya-nāḍi-cakrā	krama paricaya vaśyā nāḍi cakrā 
SA_GSP34_hathyopu-269	gaja-karaṇīti nigadyate haṭhajñaiḥ // HYP_2.38 //	gajakaraṇī iti nigadyate haṭha jñaiḥ 
SA_GSP34_hathyopu-270	brahmādayo'pi tridaśāḥ pavanābhyāsa-tatparāḥ /	brahma ādayaḥ api tridaśāḥ pavana abhyāsa tatparāḥ 
SA_GSP34_hathyopu-271	abhūvann antaka-bhyāt tasmāt pavanam abhyaset // HYP_2.39 //	abhūvan anta kabhyāt tasmāt pavanam abhyaset 
SA_GSP34_hathyopu-272	yāvad baddho marud dehe yāvac cittaṃ nirākulam /	yāvat baddhaḥ marut dehe yāvat cittam nirākulam 
SA_GSP34_hathyopu-273	yāvad dṛṣṭir bhruvor madhye tāvat kāla-bhayaṃ kutaḥ // HYP_2.40 //	yāvat dṛṣṭiḥ bhruvoḥ madhye tāvat kāla bhayam kutas 
SA_GSP34_hathyopu-274	vidhivat prāṇa-saṃyāmair nāḍī-cakre viśodhite /	vidhivat prāṇasaṃyāmaiḥ nāḍī cakre viśodhite 
SA_GSP34_hathyopu-275	suṣumṇā-vadanaṃ bhittvā sukhād viśati mārutaḥ // HYP_2.41 //	suṣumṇā vadanam bhittvā sukhāt viśati mārutaḥ 
SA_GSP34_hathyopu-276	atha manonmanī-	atha manonmanī 
SA_GSP34_hathyopu-277	mārute madhya-saṃcāre manaḥ-sthairyaṃ prajāyate /	mārute madhya saṃcāre manaḥ sthairyam prajāyate 
SA_GSP34_hathyopu-278	yo manaḥ-susthirī-bhāvaḥ saivāvasthā manonmanī // HYP_2.42 //	yaḥ manaḥ susthirībhāvaḥ sā eva avasthā manonmanī 
SA_GSP34_hathyopu-279	tat-siddhaye vidhānajñāś citrān kurvanti kumbhakān /	tad siddhaye vidhāna jñāḥ citrān kurvanti kumbhakān 
SA_GSP34_hathyopu-280	vicitra kumbhakābhyāsād vicitrāṃ siddhim āpnuyāt // HYP_2.43 //	kumbhaka abhyāsāt vicitrām siddhim āpnuyāt 
SA_GSP34_hathyopu-281	atha kumbhaka-bhedāḥ--	atha kumbhaka bhedāḥ 
SA_GSP34_hathyopu-282	sūrya-bhedanam ujjāyī sītkārī śītalī tathā /	         
SA_GSP34_hathyopu-283	bhastrikā bhrāmarī mūrcchā plāvinīty aṣṭa-kumbhakāḥ // HYP_2.44 //	                
SA_GSP34_hathyopu-284	pūrakānte tu kartavyo bandho jālandharābhidhaḥ /	pūraka ante tu kartavyaḥ bandhaḥ jālandhara abhidhaḥ 
SA_GSP34_hathyopu-285	kumbhakānte recakādau kartavyas tūḍḍiyānakaḥ // HYP_2.45 //	kumbhaka ante recaka ādau kartavyaḥ tu uḍḍiyānakaḥ 
SA_GSP34_hathyopu-286	adhastāt kuñcanenāśu kaṇṭha-saṅkocane kṛte /	adhastāt kuñcanena āśu kaṇṭha saṅkocane kṛte 
SA_GSP34_hathyopu-287	madhye paścima-tānena syāt prāṇo brahma-nāḍigaḥ // HYP_2.46 //	madhye paścimatānena syāt prāṇaḥ brahmanāḍi gaḥ 
SA_GSP34_hathyopu-288	āpānam ūrdhvam utthāpya prāṇaṃ kaṇṭhād adho nayet /	ā apānam ūrdhvam utthāpya prāṇam kaṇṭhāt adhas nayet 
SA_GSP34_hathyopu-289	yogī jarā-vimuktaḥ san ṣoḍaśābda-vayā bhavet // HYP_2.47 //	yogī jarā vimuktaḥ san ṣoḍaśa abda vayāḥ bhavet 
SA_GSP34_hathyopu-290	atha sūrya-bhedanam-	atha sūryabhedanam 
SA_GSP34_hathyopu-291	āsane sukhade yogī baddhvā caivāsanaṃ tataḥ /	āsane sukha de yogī baddhvā ca eva āsanam tatas 
SA_GSP34_hathyopu-292	dakṣa-nāḍyā samākṛṣya bahiḥsthaṃ pavanaṃ śanaiḥ // HYP_2.48 //	dakṣa nāḍyā samākṛṣya bahiḥstham pavanam śanais 
SA_GSP34_hathyopu-293	ākeśād ānakhāgrāc ca nirodhāvadhi kumbhayet /	ā keśāt ā nakha agrāt ca nirodha avadhi kumbhayet 
SA_GSP34_hathyopu-294	tataḥ śanaiḥ savya-nāḍyā recayet pavanaṃ śanaiḥ // HYP_2.49 //	tatas śanais savya nāḍyā recayet pavanam śanais 
SA_GSP34_hathyopu-295	kapāla-śodhanaṃ vāta-doṣa-ghnaṃ kṛmi-doṣa-hṛt /	               
SA_GSP34_hathyopu-296	punaḥ punar idaṃ kāryaṃ sūrya-bhedanam uttamam // HYP_2.50 //	punar punar idam kāryam sūryabhedanam uttamam 
SA_GSP34_hathyopu-297	atha ujjāyī-	atha ujjāyī 
SA_GSP34_hathyopu-298	mukhaṃ saṃyamya nāḍībhyām ākṛṣya pavanaṃ śanaiḥ /	mukham saṃyamya nāḍībhyām ākṛṣya pavanam śanais 
SA_GSP34_hathyopu-299	yathā lagati kaṇṭhāt tu hṛdayāvadhi sa-svanam // HYP_2.51 //	yathā lagati kaṇṭhāt tu hṛdaya avadhi sa svanam 
SA_GSP34_hathyopu-300	pūrvavat kumbhayet prāṇaṃ recayed iḍayā tathā /	pūrvavat kumbhayet prāṇam recayet iḍayā tathā 
SA_GSP34_hathyopu-301	śleṣma-doṣa-haraṃ kaṇṭhe dehānala-vivardhanam // HYP_2.52 //	                
SA_GSP34_hathyopu-302	nāḍī-jalodarādhātu-gata-doṣa-vināśanam /	                
SA_GSP34_hathyopu-303	gacchatā tiṣṭhatā kāryam ujjāyy ākhyaṃ tu kumbhakam // HYP_2.53 //	gacchatā tiṣṭhatā kāryam ujjāyī ākhyam tu kumbhakam 
SA_GSP34_hathyopu-304	atha sītkārī-	atha sītkārī 
SA_GSP34_hathyopu-305	sītkāṃ kuryāt tathā vaktre ghrāṇenaiva vijṛmbhikām /	sītkām kuryāt tathā vaktre ghrāṇena eva vijṛmbhikām 
SA_GSP34_hathyopu-306	evam abhyāsa-yogena kāma-devo dvitīyakaḥ // HYP_2.54 //	evam abhyāsa yogena kāmadevaḥ dvitīyakaḥ 
SA_GSP34_hathyopu-307	yoginī cakra-saṃmānyaḥ sṛṣṭi-saṃhāra-kārakaḥ /	            
SA_GSP34_hathyopu-308	na kṣudhā na tṛṣā nidrā naivālasyaṃ prajāyate // HYP_2.55 //	na kṣudhā na tṛṣā nidrā na eva ālasyam prajāyate 
SA_GSP34_hathyopu-309	bhavet sattvaṃ ca dehasya sarvopadrava-varjitaḥ /	bhavet sattvam ca dehasya sarva upadrava varjitaḥ 
SA_GSP34_hathyopu-310	anena vidhinā satyaṃ yogīndro bhūmi-maṇḍale // HYP_2.56 //	anena vidhinā satyam yogi indraḥ bhūmi maṇḍale 
SA_GSP34_hathyopu-311	atha śītalī-	atha śītalī 
SA_GSP34_hathyopu-312	jihvayā vāyum ākṛṣya pūrvavat kumbha-sādhanam /	jihvayā vāyum ākṛṣya pūrvavat kumbha sādhanam 
SA_GSP34_hathyopu-313	śanakair ghrāṇa-randhrābhyāṃ recayet pavanaṃ sudhīḥ // HYP_2.57 //	śanakais ghrāṇa randhrābhyām recayet pavanam sudhīḥ 
SA_GSP34_hathyopu-314	gulma-plīhādikān rogān jvaraṃ pittaṃ kṣudhāṃ tṛṣām /	gulma plīha ādikān rogān jvaram pittam kṣudhām tṛṣām 
SA_GSP34_hathyopu-315	viṣāṇi śītalī nāma kumbhikeyaṃ nihanti hi // HYP_2.58 //	viṣāṇi śītalī nāma kumbhikā iyam nihanti hi 
SA_GSP34_hathyopu-316	atha bhastrikā-	atha bhastrikā 
SA_GSP34_hathyopu-317	ūrvor upari saṃsthāpya śubhe pāda-tale ubhe /	ūrvoḥ upari saṃsthāpya śubhe pāda tale ubhe 
SA_GSP34_hathyopu-318	padmāsanaṃ bhaved etat sarva-pāpa-praṇāśanam // HYP_2.59 //	padmāsanam bhavet etat sarva pāpa praṇāśanam 
SA_GSP34_hathyopu-319	samyak padmāsanaṃ baddhvā sama-grīvodaraḥ sudhīḥ /	samyak padmāsanam baddhvā sama grīvā udaraḥ sudhīḥ 
SA_GSP34_hathyopu-320	mukhaṃ saṃyamya yatnena prāṇaṃ ghrāṇena recayet // HYP_2.60 //	mukham saṃyamya yatnena prāṇam ghrāṇena recayet 
SA_GSP34_hathyopu-321	yathā lagati hṛt-kaṇṭhe kapālāvadhi sa-svanam /	yathā lagati hṛd kaṇṭhe kapāla avadhi sa svanam 
SA_GSP34_hathyopu-322	vegena pūrayec cāpi hṛt-padmāvadhi mārutam // HYP_2.61 //	vegena pūrayet ca api hṛd padma avadhi mārutam 
SA_GSP34_hathyopu-323	punar virecayet tadvat pūrayec ca punaḥ punaḥ /	punar virecayet tadvat pūrayet ca punar punar 
SA_GSP34_hathyopu-324	yathaiva lohakāreṇa bhastrā vegena cālyate // HYP_2.62 //	yathā eva lohakāreṇa bhastrā vegena cālyate 
SA_GSP34_hathyopu-325	tathaiva sva-śarīra-sthaṃ cālayet pavanaṃ dhiyā /	tathā eva sva śarīra stham cālayet pavanam dhiyā 
SA_GSP34_hathyopu-326	yadā śramo bhaved dehe tadā sūryeṇa pūrayet // HYP_2.63 //	yadā śramaḥ bhavet dehe tadā sūryeṇa pūrayet 
SA_GSP34_hathyopu-327	yathodaraṃ bhavet pūrṇam anilena tathā laghu /	yathā udaram bhavet pūrṇam anilena tathā laghu 
SA_GSP34_hathyopu-328	dhārayen nāsikāṃ madhyā-tarjanībhyāṃ vinā dṛḍham // HYP_2.64 //	dhārayet nāsikām madhyā tarjanībhyām vinā dṛḍham 
SA_GSP34_hathyopu-329	vidhivat kumbhakaṃ kṛtvā recayed iḍayānilam /	vidhivat kumbhakam kṛtvā recayet iḍayā anilam 
SA_GSP34_hathyopu-330	vāta-pitta-śleṣma-haraṃ śarīrāgni-vivardhanam // HYP_2.65 //	               
SA_GSP34_hathyopu-331	kuṇḍalī bodhakaṃ kṣipraṃ pavanaṃ sukhadaṃ hitam /	             
SA_GSP34_hathyopu-332	brahma-nāḍī-mukhe saṃstha-kaphādy-argala-nāśanam // HYP_2.66 //	              
SA_GSP34_hathyopu-333	samyag gātra-samudbhūta-granthi-traya-vibhedakam /	samyak gātra samudbhūta granthi traya vibhedakam 
SA_GSP34_hathyopu-334	viśeṣeṇaiva kartavyaṃ bhastrākhyaṃ kumbhakaṃ tv idam // HYP_2.67 //	viśeṣeṇa eva kartavyam bhastrā ākhyam kumbhakam tu idam 
SA_GSP34_hathyopu-335	atha bhrāmarī-	atha bhrāmarī 
SA_GSP34_hathyopu-336	vegād ghoṣaṃ pūrakaṃ bhṛṅga-nādaṃ	vegāt ghoṣam pūrakam bhṛṅga nādam 
SA_GSP34_hathyopu-337	bhṛṅgī-nādaṃ recakaṃ manda-mandam /	bhṛṅgī nādam recakam mandamandam 
SA_GSP34_hathyopu-338	yogīndrāṇī̀am evam abhyāsa-yogāc	evam abhyāsa yogāt 
SA_GSP34_hathyopu-339	citte jātā kācid ānanda-līlā // HYP_2.68 //	citte jātā kācid ānanda līlā 
SA_GSP34_hathyopu-340	atha mūrcchā-	atha mūrcchā 
SA_GSP34_hathyopu-341	pūrakānte gāḍhataraṃ baddhvā jālandharaṃ śanaiḥ /	pūraka ante gāḍhataram baddhvā jālandharam śanais 
SA_GSP34_hathyopu-342	recayen mūrcchākhyeyaṃ mano-mūrcchā sukha-pradā // HYP_2.69 //	recayet mūrcchā ākhyeyam manomūrcchā sukha pradā 
SA_GSP34_hathyopu-343	atha plāvinī-	atha plāvinī 
SA_GSP34_hathyopu-344	antaḥ pravartitodāra-mārutāpūritodaraḥ /	antaḥ pravartita udāra māruta āpūrita udaraḥ 
SA_GSP34_hathyopu-345	payasy agādhe'pi sukhāt plavate padma-patravat // HYP_2.70 //	payasi agādhe api sukhāt plavate padma patra vat 
SA_GSP34_hathyopu-346	prāṇāyāmas tridhā prokto reca-pūraka-kumbhakaiḥ /	            
SA_GSP34_hathyopu-347	sahitaḥ kevalaś ceti kumbhako dvividho mataḥ // HYP_2.71 //	sahitaḥ kevalaḥ ca iti kumbhakaḥ dvividhaḥ mataḥ 
SA_GSP34_hathyopu-348	yāvat kevala-siddhiḥ syāt sahitaṃ tāvad abhyaset /	yāvat kevala siddhiḥ syāt sahitam tāvat abhyaset 
SA_GSP34_hathyopu-349	recakaṃ pūrakaṃ muktvā sukhaṃ yad vāyu-dhāraṇam // HYP_2.72 //	recakam pūrakam muktvā sukham yat vāyu dhāraṇam 
SA_GSP34_hathyopu-350	prāṇāyāmo'yam ity uktaḥ sa vai kevala-kumbhakaḥ /	prāṇāyāmaḥ iyam iti uktaḥ sa vai kevala kumbhakaḥ 
SA_GSP34_hathyopu-351	kumbhake kevale siddhe reca-pūraka-varjite // HYP_2.73 //	kumbhake kevale siddhe reca pūraka varjite 
SA_GSP34_hathyopu-352	na tasya durlabhaṃ kiṃcit triṣu lokeṣu vidyate /	na tasya durlabham kiṃcid triṣu lokeṣu vidyate 
SA_GSP34_hathyopu-353	śaktaḥ kevala-kumbhena yatheṣṭaṃ vāyu-dhāraṇāt // HYP_2.74 //	śaktaḥ kevala kumbhena yathā iṣṭam vāyu dhāraṇāt 
SA_GSP34_hathyopu-354	rāja-yoga-padaṃ cāpi labhate nātra saṃśayaḥ /	rājayoga padam ca api labhate na atra saṃśayaḥ 
SA_GSP34_hathyopu-355	kumbhakāt kuṇḍalī-bodhaḥ kuṇḍalī-bodhato bhavet /	kumbhakāt kuṇḍalī bodhaḥ kuṇḍalī bodhataḥ bhavet 
SA_GSP34_hathyopu-356	anargalā suṣumṇā ca haṭha-siddhiś ca jāyate // HYP_2.75 //	anargalā suṣumṇā ca haṭha siddhiḥ ca jāyate 
SA_GSP34_hathyopu-357	haṭhaṃ vinā rājayogo rāja-yogaṃ vinā haṭhaḥ /	haṭham vinā rājayogaḥ rājayogam vinā haṭhaḥ 
SA_GSP34_hathyopu-358	na sidhyati tato yugmam āniṣpatteḥ samabhyaset // HYP_2.76 //	na sidhyati tatas yugmam ā niṣpatteḥ samabhyaset 
SA_GSP34_hathyopu-359	kumbhaka-prāṇa-rodhānte kuryāc cittaṃ nirāśrayam /	                 
SA_GSP34_hathyopu-360	evam abhyāsa-yogena rāja-yoga-padaṃ vrajet // HYP_2.77 //	evam abhyāsa yogena rājayoga padam vrajet 
SA_GSP34_hathyopu-361	vapuḥ kṛśatvaṃ vadane prasannatā	vapuḥ kṛśa tvam vadane prasanna tā 
SA_GSP34_hathyopu-362	nāda-sphuṭatvaṃ nayane sunirmale /	nāda sphuṭa tvam nayane su nirmale 
SA_GSP34_hathyopu-363	arogatā bindu-jayo'gni-dīpanaṃ	            
SA_GSP34_hathyopu-364	nāḍī-viśuddhir haṭha-siddhi-lakṣaṇam // HYP_2.78 //	          
SA_GSP34_hathyopu-365	iti haṭha-pradīpikāyāṃ dvitīyopadeśaḥ /	iti haṭhapradīpikāyām dvitīya upadeśaḥ 
SA_GSP34_hathyopu-366	tṛtīyopadeśaḥ	tṛtīya upadeśaḥ 
SA_GSP34_hathyopu-367	sa-śaila-vana-dhātrīṇāṃ yathādhāro'hi-nāyakaḥ /	yathā ādhāraḥ hi nāyakaḥ 
SA_GSP34_hathyopu-368	sarveṣāṃ yoga-tantrāṇāṃ tathādhāro hi kuṇḍalī // HYP_3.1 //	sarveṣām yoga tantrāṇām tathā ādhāraḥ hi kuṇḍalī 
SA_GSP34_hathyopu-369	suptā guru-prasādena yadā jāgarti kuṇḍalī /	suptā guru prasādena yadā jāgarti kuṇḍalī 
SA_GSP34_hathyopu-370	tadā sarvāṇi padmāni bhidyante granthayo'pi ca // HYP_3.2 //	tadā sarvāṇi padmāni bhidyante granthayaḥ api ca 
SA_GSP34_hathyopu-371	prāṇasya śūnya-padavī tadā rājapathāyate /	prāṇasya śūnyapadavī tadā rājapathāyate 
SA_GSP34_hathyopu-372	tadā cittaṃ nirālambaṃ tadā kālasya vañcanam // HYP_3.3 //	tadā cittam nirālambam tadā kālasya vañcanam 
SA_GSP34_hathyopu-373	suṣumṇā śūnya-padavī brahma-randhraḥ mahāpathaḥ /	suṣumṇā śūnyapadavī brahmarandhraḥ mahāpathaḥ 
SA_GSP34_hathyopu-374	śmaśānaṃ śāmbhavī madhya-mārgaś cety eka-vācakāḥ // HYP_3.4 //	śmaśānam śāmbhavī madhya mārgaḥ ca iti ekavācakāḥ 
SA_GSP34_hathyopu-375	tasmāt sarva-prayatnena prabodhayitum īśvarīm /	tasmāt sarva prayatnena prabodhayitum īśvarīm 
SA_GSP34_hathyopu-376	brahma-dvāra-mukhe suptāṃ mudrābhyāsaṃ samācaret // HYP_3.5 //	brahmadvāra mukhe suptām mudrā abhyāsam samācaret 
SA_GSP34_hathyopu-377	mahāmudrā mahābandho mahāvedhaś ca khecarī /	             
SA_GSP34_hathyopu-378	uḍḍīyānaṃ mūlabandhaś ca bandho jālandharābhidhaḥ // HYP_3.6 //	uḍḍīyānam mūlabandhaḥ ca bandhaḥ jālandhara abhidhaḥ 
SA_GSP34_hathyopu-379	karaṇī viparītākhyā vajrolī śakti-cālanam /	           
SA_GSP34_hathyopu-380	idaṃ hi mudrā-daśakaṃ jarā-maraṇa-nāśanam // HYP_3.7 //	idam hi mudrā daśakam jarā maraṇa nāśanam 
SA_GSP34_hathyopu-381	ādināthoditaṃ divyam aṣṭaiśvarya-pradāyakam /	               
SA_GSP34_hathyopu-382	vallabhaṃ sarva-siddhānāṃ durlabhaṃ marutām api // HYP_3.8 //	vallabham sarva siddhānām durlabham marutām api 
SA_GSP34_hathyopu-383	gopanīyaṃ prayatnena yathā ratna-karaṇḍakam /	gopanīyam prayatnena yathā ratna karaṇḍakam 
SA_GSP34_hathyopu-384	kasyacin naiva vaktavyaṃ kula-strī-surataṃ yathā // HYP_3.9 //	kasyacid nā eva vaktavyam kulastrī suratam yathā 
SA_GSP34_hathyopu-385	atha mahā-mudrā-	atha mahāmudrā 
SA_GSP34_hathyopu-386	pāda-mūlena vāmena yoniṃ sampīḍya dakṣiṇām /	pāda mūlena vāmena yonim sampīḍya dakṣiṇām 
SA_GSP34_hathyopu-387	prasāritaṃ padaṃ kṛtvā karābhyāṃ dhārayed dṛḍham // HYP_3.10 //	prasāritam padam kṛtvā karābhyām dhārayet dṛḍham 
SA_GSP34_hathyopu-388	kaṇṭhe bandhaṃ samāropya dhārayed vāyum ūrdhvataḥ /	kaṇṭhe bandham samāropya dhārayet vāyum ūrdhvatas 
SA_GSP34_hathyopu-389	yathā daṇḍa-hataḥ sarpo daṇḍākāraḥ prajāyate // HYP_3.11 //	yathā daṇḍa hataḥ sarpaḥ daṇḍa ākāraḥ prajāyate 
SA_GSP34_hathyopu-390	ṛjvībhūtā tathā śaktiḥ kuṇḍalī sahasā bhavet /	ṛjvībhūtā tathā śaktiḥ kuṇḍalī sahasā bhavet 
SA_GSP34_hathyopu-391	tadā sā maraṇāvasthā jāyate dvipuṭāśrayā // HYP_3.12 //	tadā sā maraṇa avasthā jāyate dvi puṭa āśrayā 
SA_GSP34_hathyopu-392	tataḥ śanaiḥ śanair eva recayen naiva vegataḥ /	tatas śanais śanais eva recayet na eva vegataḥ 
SA_GSP34_hathyopu-393	mahā-mudrāṃ ca tenaiva vadanti vibudhottamāḥ // HYP_3.13 //	mahāmudrām ca tena eva vadanti vibudha uttamāḥ 
SA_GSP34_hathyopu-394	iyaṃ khalu mahāmudrā mahā-siddhaiḥ pradarśitā /	iyam khalu mahāmudrā mahāsiddhaiḥ pradarśitā 
SA_GSP34_hathyopu-395	mahā-kleśādayo doṣāḥ kṣīyante maraṇādayaḥ /	mahā kleśa ādayaḥ doṣāḥ kṣīyante maraṇa ādayaḥ 
SA_GSP34_hathyopu-396	mahā-mudrāṃ ca tenaiva vadanti vibudhottamāḥ // HYP_3.14 //	mahāmudrām ca tena eva vadanti vibudha uttamāḥ 
SA_GSP34_hathyopu-397	candrāṅge tu samabhyasya sūryāṅge punar abhyaset /	candra aṅge tu samabhyasya sūrya aṅge punar abhyaset 
SA_GSP34_hathyopu-398	yāvat-tulyā bhavet saṅkhyā tato mudrāṃ visarjayet // HYP_3.15 //	yāvat tulyā bhavet saṅkhyā tatas mudrām visarjayet 
SA_GSP34_hathyopu-399	na hi pathyam apathyaṃ vā rasāḥ sarve'pi nīrasāḥ /	na hi pathyam apathyam vā rasāḥ sarve api nīrasāḥ 
SA_GSP34_hathyopu-400	api bhuktaṃ viṣaṃ ghoraṃ pīyūṣam api jīryati // HYP_3.16 //	api bhuktam viṣam ghoram pīyūṣam api jīryati 
SA_GSP34_hathyopu-401	kṣaya-kuṣṭha-gudāvarta-gulmājīrṇa-purogamāḥ /	kṣaya kuṣṭha gudāvarta gulma ajīrṇa purogamāḥ 
SA_GSP34_hathyopu-402	tasya doṣāḥ kṣayaṃ yānti mahāmudrāṃ tu yo'bhyaset // HYP_3.17 //	tasya doṣāḥ kṣayam yānti mahāmudrām tu 
SA_GSP34_hathyopu-403	kathiteyaṃ mahāmudrā mahā-siddhi-karā nṝṇām /	kathitā iyam mahāmudrā mahā siddhi karā nṝṇām 
SA_GSP34_hathyopu-404	gopanīyā prayatnena na deyā yasya kasyacit // HYP_3.18 //	gopanīyā prayatnena na deyā yasya kasyacid 
SA_GSP34_hathyopu-405	atha mahā-bandhaḥ-	atha mahābandhaḥ 
SA_GSP34_hathyopu-406	pārṣṇiṃ vāmasya pādasya yoni-sthāne niyojayet /	pārṣṇim vāmasya pādasya yoni sthāne niyojayet 
SA_GSP34_hathyopu-407	vāmorūpari saṃsthāpya dakṣiṇaṃ caraṇaṃ tathā // HYP_3.19 //	vāma ūru upari saṃsthāpya dakṣiṇam caraṇam tathā 
SA_GSP34_hathyopu-408	pūrayitvā tato vāyuṃ hṛdaye cubukaṃ dṛḍham /	pūrayitvā tatas vāyum hṛdaye cubukam dṛḍham 
SA_GSP34_hathyopu-409	niṣpīḍyaṃ vāyum ākuñcya mano-madhye niyojayet // HYP_3.20 //	niṣpīḍyam vāyum ākuñcya manaḥ madhye niyojayet 
SA_GSP34_hathyopu-410	dhārayitvā yathā-śakti recayed anilaṃ śanaiḥ /	dhārayitvā yathāśakti recayet anilam śanais 
SA_GSP34_hathyopu-411	savyāṅge tu samabhyasya dakṣāṅge punar abhyaset // HYP_3.21 //	savya aṅge tu samabhyasya dakṣa aṅge punar abhyaset 
SA_GSP34_hathyopu-412	matam atra tu keṣāṃcit kaṇṭha-bandhaṃ vivarjayet /	matam atra tu keṣāṃcid kaṇṭha bandham vivarjayet 
SA_GSP34_hathyopu-413	rāja-danta-stha-jihvāyā bandhaḥ śasto bhaved iti // HYP_3.22 //	rājadanta stha jihvāyāḥ bandhaḥ śastaḥ bhavet iti 
SA_GSP34_hathyopu-414	ayaṃ tu sarva-nāḍīnām ūrdhvaṃ gati-nirodhakaḥ /	ayam tu sarva nāḍīnām ūrdhvam gati nirodhakaḥ 
SA_GSP34_hathyopu-415	ayaṃ khalu mahā-bandho mahā-siddhi-pradāyakaḥ // HYP_3.23 //	ayam khalu mahābandhaḥ mahā siddhi pradāyakaḥ 
SA_GSP34_hathyopu-416	kāla-pāśa-mahā-bandha-vimocana-vicakṣaṇaḥ /	            
SA_GSP34_hathyopu-417	triveṇī-saṅgamaṃ dhatte kedāraṃ prāpayen manaḥ // HYP_3.24 //	triveṇī saṅgamam dhatte kedāram prāpayet manaḥ 
SA_GSP34_hathyopu-418	rūpa-lāvaṇya-sampannā yathā strī puruṣaṃ vinā /	rūpa lāvaṇya sampannā yathā strī puruṣam vinā 
SA_GSP34_hathyopu-419	mahā-mudrā-mahā-bandhau niṣphalau vedha-varjitau // HYP_3.25 //	            
SA_GSP34_hathyopu-420	atha mahā-vedhaḥ-	atha mahāvedhaḥ 
SA_GSP34_hathyopu-421	mahā-bandha-sthito yogī kṛtvā pūrakam eka-dhīḥ /	mahābandha sthitaḥ yogī kṛtvā pūrakam eka dhīḥ 
SA_GSP34_hathyopu-422	vāyūnāṃ gatim āvṛtya nibhṛtaṃ kaṇṭha-mudrayā // HYP_3.26 //	vāyūnām gatim āvṛtya nibhṛtam kaṇṭha mudrayā 
SA_GSP34_hathyopu-423	sama-hasta-yugo bhūmau sphicau sanāḍayec chanaiḥ /	sama hasta yugaḥ bhūmau sphicau sa nāḍayet śanais 
SA_GSP34_hathyopu-424	puṭa-dvayam atikramya vāyuḥ sphurati madhyagaḥ // HYP_3.27 //	puṭa dvayam atikramya vāyuḥ sphurati madhya gaḥ 
SA_GSP34_hathyopu-425	soma-sūryāgni-sambandho jāyate cāmṛtāya vai /	soma sūrya agni sambandhaḥ jāyate ca amṛtāya vai 
SA_GSP34_hathyopu-426	mṛtāvasthā samutpannā tato vāyuṃ virecayet // HYP_3.28 //	mṛtāvasthā samutpannā tatas vāyum virecayet 
SA_GSP34_hathyopu-427	mahā-vedho'yam abhyāsān mahā-siddhi-pradāyakaḥ /	mahāvedhaḥ ayam abhyāsāt mahā siddhi pradāyakaḥ 
SA_GSP34_hathyopu-428	valī-palita-vepa-ghnaḥ sevyate sādhakottamaiḥ // HYP_3.29 //	valī palita vepa ghnaḥ sevyate sādhaka uttamaiḥ 
SA_GSP34_hathyopu-429	etat trayaṃ mahā-guhyaṃ jarā-mṛtyu-vināśanam /	etat trayam mahā guhyam jarā mṛtyu vināśanam 
SA_GSP34_hathyopu-430	vahni-vṛddhi-karaṃ caiva hy aṇimādi-guṇa-pradam // HYP_3.30 //	vahni vṛddhi karam ca eva hi aṇima ādi guṇa pradam 
SA_GSP34_hathyopu-431	aṣṭadhā kriyate caiva yāme yāme dine dine /	aṣṭadhā kriyate ca eva yāme yāme dine dine 
SA_GSP34_hathyopu-432	puṇya-saṃbhāra-sandhāya pāpaugha-bhiduraṃ sadā /	puṇya saṃbhāra sandhāya pāpa ogha bhiduram sadā 
SA_GSP34_hathyopu-433	samyak-śikṣāvatām evaṃ svalpaṃ prathama-sādhanam // HYP_3.31 //	samyak śikṣāvatām evam su alpam prathama sādhanam 
SA_GSP34_hathyopu-434	atha khecarī-	atha khecarī 
SA_GSP34_hathyopu-435	kapāla-kuhare jihvā praviṣṭā viparītagā /	kapāla kuhare jihvā praviṣṭā viparīta gā 
SA_GSP34_hathyopu-436	bhruvor antargatā dṛṣṭir mudrā bhavati khecarī // HYP_3.32 //	bhruvoḥ antargatā dṛṣṭiḥ mudrā bhavati khecarī 
SA_GSP34_hathyopu-437	chedana-cālana-dohaiḥ kalāṃ krameṇātha vardhayet tāvat /	chedana cālana dohaiḥ kalām krameṇa atha vardhayet tāvat 
SA_GSP34_hathyopu-438	sā yāvad bhrū-madhyaṃ spṛśati tadā khecarī-siddhiḥ // HYP_3.33 //	sā yāvat bhrūmadhyam spṛśati tadā khecarī siddhiḥ 
SA_GSP34_hathyopu-439	snuhī-patra-nibhaṃ śastraṃ sutīkṣṇaṃ snigdha-nirmalam /	snuhī patra nibham śastram su tīkṣṇam snigdha nirmalam 
SA_GSP34_hathyopu-440	samādāya tatas tena roma-mātraṃ samucchinet // HYP_3.34 //	samādāya tatas tena roma mātram samucchinet 
SA_GSP34_hathyopu-441	tataḥ saindhava-pathyābhyāṃ cūrṇitābhyāṃ pragharṣayet /	tatas saindhava pathyābhyām cūrṇitābhyām pragharṣayet 
SA_GSP34_hathyopu-442	punaḥ sapta-dine prāpte roma-mātraṃ samucchinet // HYP_3.35 //	punar saptadine prāpte roma mātram samucchinet 
SA_GSP34_hathyopu-443	evaṃ krameṇa ṣaṇ-māsaṃ nityaṃ yuktaḥ samācaret /	evam krameṇa ṣaṣ māsam nityam yuktaḥ samācaret 
SA_GSP34_hathyopu-444	ṣaṇmāsād rasanā-mūla-śirā-bandhaḥ praṇaśyati // HYP_3.36 //	ṣaṣ māsāt rasanā mūla sirā bandhaḥ praṇaśyati 
SA_GSP34_hathyopu-445	kalāṃ parāṅmukhīṃ kṛtvā tripathe pariyojayet /	kalām parāṅmukhīm kṛtvā tripathe pariyojayet 
SA_GSP34_hathyopu-446	sā bhavet khecarī mudrā vyoma-cakraṃ tad ucyate // HYP_3.37 //	sā bhavet khecarī mudrā vyomacakram tat ucyate 
SA_GSP34_hathyopu-447	rasanām ūrdhvagāṃ kṛtvā kṣaṇārdham api tiṣṭhati /	rasanām ūrdhva gām kṛtvā kṣaṇārdham api tiṣṭhati 
SA_GSP34_hathyopu-448	viṣair vimucyate yogī vyādhi-mṛtyu-jarādibhiḥ // HYP_3.38 //	viṣaiḥ vimucyate yogī vyādhi mṛtyu jarā ādibhiḥ 
SA_GSP34_hathyopu-449	na rogo maraṇaṃ tandrā na nidrā na kṣudhā tṛṣā /	na rogaḥ maraṇam tandrā na nidrā na kṣudhā tṛṣā 
SA_GSP34_hathyopu-450	na ca mūrcchā bhavet tasya yo mudrāṃ vetti khecarīm // HYP_3.39 //	na ca mūrcchā bhavet tasya yaḥ mudrām vetti khecarīm 
SA_GSP34_hathyopu-451	pīḍyate na sa rogeṇa lipyate na ca karmaṇā /	pīḍyate na sa rogeṇa lipyate na ca karmaṇā 
SA_GSP34_hathyopu-452	bādhyate na sa kālena yo mudrāṃ vetti khecarīm // HYP_3.40 //	bādhyate na sa kālena yaḥ mudrām vetti khecarīm 
SA_GSP34_hathyopu-453	cittaṃ carati khe yasmāj jihvā carati khe gatā /	cittam carati khe yasmāt jihvā carati khe gatā 
SA_GSP34_hathyopu-454	tenaiṣā khecarī nāma mudrā siddhair nirūpitā // HYP_3.41 //	tena eṣā khecarī nāma mudrā siddhaiḥ nirūpitā 
SA_GSP34_hathyopu-455	khecaryā mudritaṃ yena vivaraṃ lambikordhvataḥ /	khecaryā mudritam yena vivaram lambikā ūrdhvatas 
SA_GSP34_hathyopu-456	na tasya kṣarate binduḥ kāminyāḥ śleṣitasya ca // HYP_3.42 //	na tasya kṣarate binduḥ kāminyāḥ śleṣitasya ca 
SA_GSP34_hathyopu-457	calito'pi yadā binduḥ samprāpto yoni-maṇḍalam /	calitaḥ api yadā binduḥ samprāptaḥ yoni maṇḍalam 
SA_GSP34_hathyopu-458	vrajaty ūrdhvaṃ hṛtaḥ śaktyā nibaddho yoni-mudrayā // HYP_3.43 //	vrajati ūrdhvam hṛtaḥ śaktyā nibaddhaḥ yonimudrayā 
SA_GSP34_hathyopu-459	ūrdhva-jihvaḥ sthiro bhūtvā somapānaṃ karoti yaḥ /	ūrdhvajihvaḥ sthiraḥ bhūtvā soma pānam karoti yaḥ 
SA_GSP34_hathyopu-460	māsārdhena na sandeho mṛtyuṃ jayati yogavit // HYP_3.44 //	māsa ardhena na sandehaḥ mṛtyum jayati yoga vid 
SA_GSP34_hathyopu-461	nityaṃ soma-kalā-pūrṇaṃ śarīraṃ yasya yoginaḥ /	nityam soma kalā pūrṇam śarīram yasya yoginaḥ 
SA_GSP34_hathyopu-462	takṣakeṇāpi daṣṭasya viṣaṃ tasya na sarpati // HYP_3.45 //	takṣakeṇa api daṣṭasya viṣam tasya na sarpati 
SA_GSP34_hathyopu-463	indhanāni yathā vahnis taila-varti ca dīpakaḥ /	indhanāni yathā vahniḥ taila varti ca dīpakaḥ 
SA_GSP34_hathyopu-464	tathā soma-kalā-pūrṇaṃ dehī dehaṃ na muñcati // HYP_3.46 //	tathā soma kalā pūrṇam dehī deham na muñcati 
SA_GSP34_hathyopu-465	gomāṃsaṃ bhakṣayen nityaṃ pibed amara-vāruṇīm /	    bhakṣayet   pibet   
SA_GSP34_hathyopu-466	kulīnaṃ tam ahaṃ manye cetare kula-ghātakāḥ // HYP_3.47 //	kulīnam tam aham manye ca itare kula ghātakāḥ 
SA_GSP34_hathyopu-467	go-śabdenoditā jihvā tat praveśo hi tāluni /	go śabdena uditā jihvā tat praveśaḥ hi tāluni 
SA_GSP34_hathyopu-468	go-māṃsa-bhakṣaṇaṃ tat tu mahā-pātaka-nāśanam // HYP_3.48 //	go māṃsa bhakṣaṇam tat tu mahāpātaka nāśanam 
SA_GSP34_hathyopu-469	jihvā-praveśa-sambhūta-vahninotpāditaḥ khalu /	jihvā praveśa sambhūta vahninā utpāditaḥ khalu 
SA_GSP34_hathyopu-470	candrāt sravati yaḥ sāraḥ sā syād amara-vāruṇī // HYP_3.49 //	  sravati            
SA_GSP34_hathyopu-471	cumbantī yadi lambikāgram aniśaṃ jihvā-rasa-syandinī	cumbantī yadi lambikā agram aniśam jihvā rasa syandinī 
SA_GSP34_hathyopu-472	sa-kṣārā kaṭukāmla-dugdha-sadṛśī madhvājya-tulyā tathā /	sa kṣārā kaṭuka amla dugdha sadṛśī madhu ājya tulyā tathā 
SA_GSP34_hathyopu-473	vyādhīnāṃ haraṇaṃ jarānta-karaṇaṃ śastrāgamodīraṇaṃ	vyādhīnām haraṇam jarā anta karaṇam śastra āgama udīraṇam 
SA_GSP34_hathyopu-474	tasya syād amaratvam aṣṭa-guṇitaṃ siddhāṅganākarṣaṇam // HYP_3.50 //	tasya syāt amara tvam aṣṭa guṇitam siddha aṅganā ākarṣaṇam 
SA_GSP34_hathyopu-475	mūrdhnaḥ ṣoḍaśa-patra-padma-galitaṃ prāṇād avāptaṃ haṭhād	mūrdhnaḥ ṣoḍaśa patra padma galitam prāṇāt avāptam haṭhāt 
SA_GSP34_hathyopu-476	ūrdvhāsyo rasanāṃ niyamya vivare śaktiṃ parāṃ cintayan /	ūrdvhāsyaḥ rasanām niyamya vivare śaktim parām cintayan 
SA_GSP34_hathyopu-477	utkallola-kalā-jalaṃ ca vimalaṃ dhārāmayaṃ yaḥ piben	ca vimalam dhārā mayam yaḥ pibet 
SA_GSP34_hathyopu-478	nirvyādhiḥ sa mṛṇāla-komala-vapur yogī ciraṃ jīvati // HYP_3.51 //	nirvyādhiḥ sa mṛṇāla komala vapuḥ yogī ciram jīvati 
SA_GSP34_hathyopu-479	yat prāleyaṃ prahita-suṣiraṃ meru-mūrdhāntara-sthaṃ	yat prāleyam prahita suṣiram meru mūrdha antara stham 
SA_GSP34_hathyopu-480	tasmiṃs tattvaṃ pravadati sudhīs tan-mukhaṃ nimnagānām /	tasmin tattvam pravadati tad mukham nimnagānām 
SA_GSP34_hathyopu-481	candrāt sāraḥ sravati vapuṣas tena mṛtyur narāṇāṃ	candrāt sāraḥ sravati vapuṣaḥ tena mṛtyuḥ narāṇām 
SA_GSP34_hathyopu-482	tad badhnīyāt sukaraṇam adho nānyathā kāya-siddhiḥ // HYP_3.52 //	tat badhnīyāt su karaṇam adhas na anyathā kāya siddhiḥ 
SA_GSP34_hathyopu-483	suṣiraṃ jñāna-janakaṃ pañca-srotaḥ-samanvitam /	suṣiram jñāna janakam pañca srotaḥ samanvitam 
SA_GSP34_hathyopu-484	tiṣṭhate khecarī mudrā tasmin śūnye nirañjane // HYP_3.53 //	tiṣṭhate khecarī mudrā tasmin śūnye nirañjane 
SA_GSP34_hathyopu-485	ekaṃ sṛṣṭimayaṃ bījam ekā mudrā ca khecarī /	ekam sṛṣṭi mayam bījam ekā mudrā ca khecarī 
SA_GSP34_hathyopu-486	eko devo nirālamba ekāvasthā manonmanī // HYP_3.54 //	ekaḥ devaḥ nirālambaḥ ekā avasthā manonmanī 
SA_GSP34_hathyopu-487	atha uḍḍīyāna-bandhaḥ-	atha uḍḍīyāna bandhaḥ 
SA_GSP34_hathyopu-488	baddho yena suṣumṇāyāṃ prāṇas tūḍḍīyate yataḥ /	baddhaḥ yena suṣumṇāyām prāṇaḥ tu uḍḍīyate yatas 
SA_GSP34_hathyopu-489	tasmād uḍḍīyanākhyo'yaṃ yogibhiḥ samudāhṛtaḥ // HYP_3.55 //	tasmāt uḍḍīyana ākhyaḥ yam yogibhiḥ samudāhṛtaḥ 
SA_GSP34_hathyopu-490	uḍḍīnaṃ kurute yasmād aviśrāntaṃ mahā-khagaḥ /	uḍḍīnam kurute yasmāt aviśrāntam mahākhagaḥ 
SA_GSP34_hathyopu-491	uḍḍīyānaṃ tad eva syāt tava bandho'bhidhīyate // HYP_3.56 //	uḍḍīyānam tat eva syāt tava bandhaḥ abhidhīyate 
SA_GSP34_hathyopu-492	udare paścimaṃ tānaṃ nābher ūrdhvaṃ ca kārayet /	udare paścimam tānam nābheḥ ūrdhvam ca kārayet 
SA_GSP34_hathyopu-493	uḍḍīyāno hy asau bandho mṛtyu-mātaṅga-kesarī // HYP_3.57 //	uḍḍīyānaḥ hi asau bandhaḥ mṛtyu mātaṅga kesarī 
SA_GSP34_hathyopu-494	uḍḍīyānaṃ tu sahajaṃ guruṇā kathitaṃ sadā /	uḍḍīyānam tu sahajam guruṇā kathitam sadā 
SA_GSP34_hathyopu-495	abhyaset satataṃ yas tu vṛddho'pi taruṇāyate // HYP_3.58 //	abhyaset satatam yaḥ tu vṛddhaḥ api taruṇāyate 
SA_GSP34_hathyopu-496	nābher ūrdhvam adhaś cāpi tānaṃ kuryāt prayatnataḥ /	nābheḥ ūrdhvam adhas ca api tānam kuryāt prayatnataḥ 
SA_GSP34_hathyopu-497	ṣaṇmāsam abhyasen mṛtyuṃ jayaty eva na saṃśayaḥ // HYP_3.59 //	ṣaṣ māsam abhyaset mṛtyum jayati eva na saṃśayaḥ 
SA_GSP34_hathyopu-498	sarveṣām eva bandhānāṃ uttamo hy uḍḍīyānakaḥ /	sarveṣām eva bandhānām uttamaḥ hi uḍḍīyānakaḥ 
SA_GSP34_hathyopu-499	uḍḍiyāne dṛḍhe bandhe muktiḥ svābhāvikī bhavet // HYP_3.60 //	uḍḍiyāne dṛḍhe bandhe muktiḥ svābhāvikī bhavet 
SA_GSP34_hathyopu-500	atha mūla-bandhaḥ-	atha mūlabandhaḥ 
SA_GSP34_hathyopu-501	pārṣṇi-bhāgena sampīḍya yonim ākuñcayed gudam /	pārṣṇi bhāgena sampīḍya yonim ākuñcayet gudam 
SA_GSP34_hathyopu-502	apānam ūrdhvam ākṛṣya mūla-bandho'bhidhīyate // HYP_3.61 //	apānam ūrdhvam ākṛṣya mūlabandhaḥ abhidhīyate 
SA_GSP34_hathyopu-503	adho-gatim apānaṃ vā ūrdhvagaṃ kurute balāt /	adhogatim apānam vai ūrdhva gam kurute balāt 
SA_GSP34_hathyopu-504	ākuñcanena taṃ prāhur mūla-bandhaṃ hi yoginaḥ // HYP_3.62 //	ākuñcanena tam prāhuḥ mūlabandham hi yoginaḥ 
SA_GSP34_hathyopu-505	gudaṃ pārṣṇyā tu sampīḍya vāyum ākuñcayed balāt /	gudam pārṣṇyā tu sampīḍya vāyum ākuñcayet balāt 
SA_GSP34_hathyopu-506	vāraṃ vāraṃ yathā cordhvaṃ samāyāti samīraṇaḥ // HYP_3.63 //	vāram vāram yathā ca ūrdhvam samāyāti samīraṇaḥ 
SA_GSP34_hathyopu-507	prāṇāpānau nāda-bindū mūla-bandhena caikatām /	prāṇa apānau nāda bindū mūlabandhena ca eka tām 
SA_GSP34_hathyopu-508	gatvā yogasya saṃsiddhiṃ yacchato nātra saṃśayaḥ // HYP_3.64 //	gatvā yogasya saṃsiddhim yacchataḥ na atra saṃśayaḥ 
SA_GSP34_hathyopu-509	apāna-prāṇayor aikyaṃ kṣayo mūtra-purīṣayoḥ /	apāna prāṇayoḥ aikyam kṣayaḥ mūtra purīṣayoḥ 
SA_GSP34_hathyopu-510	yuvā bhavati vṛddho'pi satataṃ mūla-bandhanāt // HYP_3.65 //	yuvā bhavati vṛddhaḥ api satatam mūlabandhanāt 
SA_GSP34_hathyopu-511	apāna ūrdhvage jāte prayāte vahni-maṇḍalam /	apāne ūrdhva ge jāte prayāte vahni maṇḍalam 
SA_GSP34_hathyopu-512	tadānala-śikhā dīrghā jāyate vāyunāhatā // HYP_3.66 //	tadā anala śikhā dīrghā jāyate vāyunā āhatā 
SA_GSP34_hathyopu-513	tato yāto vahny-apānau prāṇam uṣṇa-svarūpakam /	tatas yātaḥ vahni apānau prāṇam uṣṇa svarūpakam 
SA_GSP34_hathyopu-514	tenātyanta-pradīptas tu jvalano dehajas tathā // HYP_3.67 //	tena atyanta pradīptaḥ tu jvalanaḥ deha jaḥ tathā 
SA_GSP34_hathyopu-515	tena kuṇḍalinī suptā santaptā samprabudhyate /	tena kuṇḍalinī suptā santaptā samprabudhyate 
SA_GSP34_hathyopu-516	daṇḍāhatā bhujaṅgīva niśvasya ṛjutāṃ vrajet // HYP_3.68 //	daṇḍa āhatā bhujaṅgī iva niśvasya ṛju tām vrajet 
SA_GSP34_hathyopu-517	bilaṃ praviṣṭeva tato brahma-nāḍyaṃ taraṃ vrajet /	bilam praviṣṭā iva tatas brahmanāḍyam taram vrajet 
SA_GSP34_hathyopu-518	tasmān nityaṃ mūla-bandhaḥ kartavyo yogibhiḥ sadā // HYP_3.69 //	tasmāt nityam mūlabandhaḥ kartavyaḥ yogibhiḥ sadā 
SA_GSP34_hathyopu-519	atha jalandhara-bandhaḥ-	atha jalandhara bandhaḥ 
SA_GSP34_hathyopu-520	kaṇṭham ākuñcya hṛdaye sthāpayec cibukaṃ dṛḍham /	kaṇṭham ākuñcya hṛdaye sthāpayet cibukam dṛḍham 
SA_GSP34_hathyopu-521	bandho jālandharākhyo'yaṃ jarā-mṛtyu-vināśakaḥ // HYP_3.70 //	bandhaḥ jālandhara ākhyaḥ yam jarā mṛtyu vināśakaḥ 
SA_GSP34_hathyopu-522	badhnāti hi sirājālam adho-gāmi nabho-jalam /	badhnāti hi sirā jālam adhogāmi nabhaḥ jalam 
SA_GSP34_hathyopu-523	tato jālandharo bandhaḥ kaṇṭha-duḥkhaugha-nāśanaḥ // HYP_3.71 //	tatas jālandharaḥ bandhaḥ kaṇṭha duḥkha ogha nāśanaḥ 
SA_GSP34_hathyopu-524	jālandhare kṛte bandhe kaṇṭha-saṃkoca-lakṣaṇe /	jālandhare kṛte bandhe kaṇṭha saṃkoca lakṣaṇe 
SA_GSP34_hathyopu-525	na pīyūṣaṃ pataty agnau na ca vāyuḥ prakupyati // HYP_3.72 //	na pīyūṣam patati agnau na ca vāyuḥ prakupyati 
SA_GSP34_hathyopu-526	kaṇṭha-saṃkocanenaiva dve nāḍyau stambhayed dṛḍham /	kaṇṭha saṃkocanena eva dve nāḍyau stambhayet dṛḍham 
SA_GSP34_hathyopu-527	madhya-cakram idaṃ jñeyaṃ ṣoḍaśādhāra-bandhanam // HYP_3.73 //	            
SA_GSP34_hathyopu-528	mūla-sthānaṃ samākuñcya uḍḍiyānaṃ tu kārayet /	mūlasthānam samākuñcya uḍḍiyānam tu kārayet 
SA_GSP34_hathyopu-529	iḍāṃ ca piṅgalāṃ baddhvā vāhayet paścime pathi // HYP_3.74 //	iḍām ca piṅgalām baddhvā vāhayet paścime pathi 
SA_GSP34_hathyopu-530	anenaiva vidhānena prayāti pavano layam /	anena eva vidhānena prayāti pavanaḥ layam 
SA_GSP34_hathyopu-531	tato na jāyate mṛtyur jarā-rogādikaṃ tathā // HYP_3.75 //	tatas na jāyate mṛtyuḥ jarā roga ādikam tathā 
SA_GSP34_hathyopu-532	bandha-trayam idaṃ śreṣṭhaṃ mahā-siddhaiś ca sevitam /	bandha trayam idam śreṣṭham mahā siddhaiḥ ca sevitam 
SA_GSP34_hathyopu-533	sarveṣāṃ haṭha-tantrāṇāṃ sādhanaṃ yogino viduḥ // HYP_3.76 //	sarveṣām haṭha tantrāṇām sādhanam yoginaḥ viduḥ 
SA_GSP34_hathyopu-534	yat kiṃcit sravate candrād amṛtaṃ divya-rūpiṇaḥ /	yat kiṃcid sravate candrāt amṛtam divya rūpiṇaḥ 
SA_GSP34_hathyopu-535	tat sarvaṃ grasate sūryas tena piṇḍo jarāyutaḥ // HYP_3.77 //	tat sarvam grasate sūryaḥ tena piṇḍaḥ jarā yutaḥ 
SA_GSP34_hathyopu-536	atha viparīta-karaṇī mudrā-	atha viparītakaraṇī mudrā 
SA_GSP34_hathyopu-537	tatrāsti karaṇaṃ divyaṃ sūryasya mukha-vañcanam /	tatra asti karaṇam divyam sūryasya mukha vañcanam 
SA_GSP34_hathyopu-538	gurūpadeśato jñeyaṃ na tu śāstrārtha-koṭibhiḥ // HYP_3.78 //	guru upadeśataḥ jñeyam na tu śāstra artha koṭibhiḥ 
SA_GSP34_hathyopu-539	ūrdhva-nābher adhas tālor ūrdhvaṃ bhānur adhaḥ śaśī /	ūrdhva nābheḥ adhas tāloḥ ūrdhvam bhānuḥ adhas śaśī 
SA_GSP34_hathyopu-540	karaṇī viparītākhā guru-vākyena labhyate // HYP_3.79 //	karaṇī viparīta ākhā guru vākyena labhyate 
SA_GSP34_hathyopu-541	nityam abhyāsa-yuktasya jaṭharāgni-vivardhanī /	nityam abhyāsa yuktasya jaṭhara agni vivardhanī 
SA_GSP34_hathyopu-542	āhāro bahulas tasya sampādyaḥ sādhakasya ca // HYP_3.80 //	āhāraḥ bahulaḥ tasya sampādyaḥ sādhakasya ca 
SA_GSP34_hathyopu-543	alpāhāro yadi bhaved agnir dahati tat-kṣaṇāt /	alpa āhāraḥ yadi bhavet agniḥ dahati tad kṣaṇāt 
SA_GSP34_hathyopu-544	adhaḥ-śirāś cordhva-pādaḥ kṣaṇaṃ syāt prathame dine // HYP_3.81 //	adhaḥśirāḥ ca ūrdhva pādaḥ kṣaṇam syāt prathame dine 
SA_GSP34_hathyopu-545	kṣaṇāc ca kiṃcid adhikam abhyasec ca dine dine /	kṣaṇāt ca kiṃcid adhikam abhyaset ca dine dine 
SA_GSP34_hathyopu-546	valitaṃ palitaṃ caiva ṣaṇmāsordhvaṃ na dṛśyate /	valitam palitam ca eva ṣaṣ māsa ūrdhvam na dṛśyate 
SA_GSP34_hathyopu-547	yāma-mātraṃ tu yo nityam abhyaset sa tu kālajit // HYP_3.82 //	yāma mātram tu yaḥ nityam abhyaset sa tu kāla jit 
SA_GSP34_hathyopu-548	atha vajrolī-	atha vajrolī 
SA_GSP34_hathyopu-549	svecchayā vartamāno'pi yogoktair niyamair vinā /	sva icchayā vartamānaḥ api yoga uktaiḥ niyamaiḥ vinā 
SA_GSP34_hathyopu-550	vajrolīṃ yo vijānāti sa yogī siddhi-bhājanam // HYP_3.83 //	vajrolīm yaḥ vijānāti sa yogī siddhi bhājanam 
SA_GSP34_hathyopu-551	tatra vastu-dvayaṃ vakṣye durlabhaṃ yasya kasyacit /	tatra vastu dvayam vakṣye durlabham yasya kasyacid 
SA_GSP34_hathyopu-552	kṣīraṃ caikaṃ dvitīyaṃ tu nārī ca vaśa-vartinī // HYP_3.84 //	kṣīram ca ekam dvitīyam tu nārī ca vaśa vartinī 
SA_GSP34_hathyopu-553	mehanena śanaiḥ samyag ūrdhvākuñcanam abhyaset /	mehanena śanais samyak ūrdhva ākuñcanam abhyaset 
SA_GSP34_hathyopu-554	puruṣo'py athavā nārī vajrolī-siddhim āpnuyāt // HYP_3.85 //	puruṣaḥ api athavā nārī vajrolī siddhim āpnuyāt 
SA_GSP34_hathyopu-555	yatnataḥ śasta-nālena phūtkāraṃ vajra-kandare /	yatnatas śasta nālena phūtkāram vajrakandare 
SA_GSP34_hathyopu-556	śanaiḥ śanaiḥ prakurvīta vāyu-saṃcāra-kāraṇāt // HYP_3.86 //	śanais śanais prakurvīta vāyu saṃcāra kāraṇāt 
SA_GSP34_hathyopu-557	nārī-bhage padad-bindum abhyāsenordhvam āharet /	nārī bhage abhyāsena ūrdhvam āharet 
SA_GSP34_hathyopu-558	calitaṃ ca nijaṃ bindum ūrdhvam ākṛṣya rakṣayet // HYP_3.87 //	calitam ca nijam bindum ūrdhvam ākṛṣya rakṣayet 
SA_GSP34_hathyopu-559	evaṃ saṃrakṣayed binduṃ jayati yogavit /	evam saṃrakṣayet bindum jayati yoga vid 
SA_GSP34_hathyopu-560	maraṇaṃ bindu-pātena jīvanaṃ bindu-dhāraṇāt // HYP_3.88 //	maraṇam bindu pātena jīvanam bindu dhāraṇāt 
SA_GSP34_hathyopu-561	sugandho yogino dehe jāyate bindu-dhāraṇāt /	sugandhaḥ yoginaḥ dehe jāyate bindu dhāraṇāt 
SA_GSP34_hathyopu-562	yāvad binduḥ sthiro dehe tāvat kāla-bhayaṃ kutaḥ // HYP_3.89 //	yāvat binduḥ sthiraḥ dehe tāvat kāla bhayam kutas 
SA_GSP34_hathyopu-563	cittāyattaṃ nṝṇāṃ śukraṃ śukrāyattaṃ ca jīvitam /	citta āyattam nṝṇām śukram śukra āyattam ca jīvitam 
SA_GSP34_hathyopu-564	tasmāc chukraṃ manaś caiva rakṣaṇīyaṃ prayatnataḥ // HYP_3.90 //	tasmāt śukram manaḥ ca eva rakṣaṇīyam prayatnataḥ 
SA_GSP34_hathyopu-565	ṛtumatyā rajo'py evaṃ nijaṃ binduṃ ca rakṣayet /	ṛtumatyāḥ rajaḥ pi evam nijam bindum ca rakṣayet 
SA_GSP34_hathyopu-566	meḍhreṇākarṣayed ūrdhvaṃ samyag abhyāsa-yoga-vit // HYP_3.91 //	meḍhreṇa ākarṣayet ūrdhvam samyak abhyāsa yoga vid 
SA_GSP34_hathyopu-567	atha sahajoliḥ-	atha sahajoliḥ 
SA_GSP34_hathyopu-568	sahajoliś cāmarolir vajrolyā bheda ekataḥ /	sahajoliḥ ca amaroliḥ vajrolyāḥ bhedaḥ ekatas 
SA_GSP34_hathyopu-569	jale subhasma nikṣipya dagdha-gomaya-sambhavam // HYP_3.92 //	jale subhasma nikṣipya dagdha gomaya sambhavam 
SA_GSP34_hathyopu-570	vajrolī-maithunād ūrdhvaṃ strī-puṃsoḥ svāṅga-lepanam /	vajrolī maithunāt ūrdhvam strī puṃsoḥ sva aṅga lepanam 
SA_GSP34_hathyopu-571	āsīnayoḥ sukhenaiva mukta-vyāpārayoḥ kṣaṇāt // HYP_3.93 //	āsīnayoḥ sukhena eva mukta vyāpārayoḥ kṣaṇāt 
SA_GSP34_hathyopu-572	sahajolir iyaṃ proktā śraddheyā yogibhiḥ sadā /	           
SA_GSP34_hathyopu-573	ayaṃ śubha-karo yogo bhoga-yukto'pi muktidaḥ // HYP_3.94 //	ayam śubha karaḥ yogaḥ bhoga yuktaḥ api mukti daḥ 
SA_GSP34_hathyopu-574	ayaṃ yogaḥ puṇyavatāṃ dhīrāṇāṃ tattva-darśinām /	ayam yogaḥ puṇyavatām dhīrāṇām tattva darśinām 
SA_GSP34_hathyopu-575	nirmatsarāṇāṃ vai sidhyen na tu matsara-śālinām // HYP_3.95 //	nirmatsarāṇām vai sidhyet na tu matsara śālinām 
SA_GSP34_hathyopu-576	atha amarolī-	atha amarolī 
SA_GSP34_hathyopu-577	pittolbaṇatvāt prathamāmbu-dhārāṃ	pitta ulbaṇa tvāt prathama ambu dhārām 
SA_GSP34_hathyopu-578	vihāya niḥsāratayānty adhārām /	vihāya 
SA_GSP34_hathyopu-579	niṣevyate śītala-madhya-dhārā	niṣevyate śītala madhya dhārā 
SA_GSP34_hathyopu-580	kāpālike khaṇḍamate'marolī // HYP_3.96 //	kāpālike 
SA_GSP34_hathyopu-581	amarīṃ yaḥ piben nityaṃ nasyaṃ kurvan dine dine /	amarīm yaḥ pibet nityam nasyam kurvan dine dine 
SA_GSP34_hathyopu-582	vajrolīm abhyaset samyak sāmarolīti kathyate // HYP_3.97 //	vajrolīm abhyaset samyak sā amarolī iti kathyate 
SA_GSP34_hathyopu-583	abhyāsān niḥsṛtāṃ cāndrīṃ vibhūtyā saha miśrayet /	abhyāsāt niḥsṛtām cāndrīm vibhūtyā saha miśrayet 
SA_GSP34_hathyopu-584	dhārayed uttamāṅgeṣu divya-dṛṣṭiḥ prajāyate // HYP_3.98 //	dhārayet uttamāṅgeṣu divya dṛṣṭiḥ prajāyate 
SA_GSP34_hathyopu-585	puṃso binduṃ samākuñcya samyag abhyāsa-pāṭavāt /	puṃsaḥ bindum samākuñcya samyak abhyāsa pāṭavāt 
SA_GSP34_hathyopu-586	yadi nārī rajo rakṣed vajrolyā sāpi yoginī // HYP_3.99 //	yadi nārī rajaḥ rakṣet vajrolyā sā api yoginī 
SA_GSP34_hathyopu-587	tasyāḥ kiṃcid rajo nāśaṃ na gacchati na saṃśayaḥ /	tasyāḥ kiṃcid rajaḥ nāśam na gacchati na saṃśayaḥ 
SA_GSP34_hathyopu-588	tasyāḥ śarīre nādaś ca bindutām eva gacchati // HYP_3.100 //	tasyāḥ śarīre nādaḥ ca bindu tām eva gacchati 
SA_GSP34_hathyopu-589	sa bindus tad rajaś caiva ekībhūya svadehagau /	sa binduḥ tat rajaḥ ca eva ekībhūya sva deha gau 
SA_GSP34_hathyopu-590	vajroly-abhyāsa-yogena sarva-siddhiṃ prayacchataḥ // HYP_3.101 //	vajrolī abhyāsa yogena sarva siddhim prayacchataḥ 
SA_GSP34_hathyopu-591	rakṣed ākuñcanād ūrdhvaṃ yā rajaḥ sā hi yoginī /	rakṣet ākuñcanāt ūrdhvam yā rajaḥ sā hi yoginī 
SA_GSP34_hathyopu-592	atītānāgataṃ vetti khecarī ca bhaved dhruvam // HYP_3.102 //	atīta anāgatam vetti khecarī ca bhavet dhruvam 
SA_GSP34_hathyopu-593	deha-siddhiṃ ca labhate vajroly-abhyāsa-yogataḥ /	deha siddhim ca labhate vajrolī abhyāsa yogataḥ 
SA_GSP34_hathyopu-594	ayaṃ puṇya-karo yogo bhoge bhukte'pi muktidaḥ // HYP_3.103 //	ayam puṇya karaḥ yogaḥ bhoge bhukte api mukti daḥ 
SA_GSP34_hathyopu-595	atha śakti-cālanam-	atha śakticālanam 
SA_GSP34_hathyopu-596	kuṭilāṅgī kuṇḍalinī bhujaṅgī śaktir īśvarī /	            
SA_GSP34_hathyopu-597	kuṇḍaly arundhatī caite śabdāḥ paryāya-vācakāḥ // HYP_3.104 //	kuṇḍalī arundhatī ca ete śabdāḥ paryāya vācakāḥ 
SA_GSP34_hathyopu-598	udghāṭayet kapāṭaṃ tu yathā kuṃcikayā haṭhāt /	udghāṭayet kapāṭam tu yathā kuṃcikayā haṭhāt 
SA_GSP34_hathyopu-599	kuṇḍalinyā tathā yogī mokṣadvāraṃ vibhedayet // HYP_3.105 //	kuṇḍalinyā tathā yogī mokṣa dvāram vibhedayet 
SA_GSP34_hathyopu-600	yena mārgeṇa gantavyaṃ brahma-sthānaṃ nirāmayam /	yena mārgeṇa gantavyam brahma sthānam nirāmayam 
SA_GSP34_hathyopu-601	mukhenācchādya tad vāraṃ prasuptā parameśvarī // HYP_3.106 //	mukhena ācchādya tat vāram prasuptā parameśvarī 
SA_GSP34_hathyopu-602	kandordhve kuṇḍalī śaktiḥ suptā mokṣāya yoginām /	kanda ūrdhve kuṇḍalī śaktiḥ suptā mokṣāya yoginām 
SA_GSP34_hathyopu-603	bandhanāya ca mūḍhānāṃ yas tāṃ vetti sa yogavit // HYP_3.107 //	bandhanāya ca mūḍhānām yaḥ tām vetti sa yoga vid 
SA_GSP34_hathyopu-604	kuṇḍalī kuṭilākārā sarpavat parikīrtitā /	kuṇḍalī kuṭila ākārā sarpa vat parikīrtitā 
SA_GSP34_hathyopu-605	sā śaktiś cālitā yena sa mukto nātra saṃśayaḥ // HYP_3.108 //	sā śaktiḥ cālitā yena sa muktaḥ na atra saṃśayaḥ 
SA_GSP34_hathyopu-606	gaṅgā-yamunayor madhye bāla-raṇḍāṃ tapasvinīm /	gaṅgā yamunayoḥ madhye bāla raṇḍām tapasvinīm 
SA_GSP34_hathyopu-607	balātkāreṇa gṛhṇīyāt tad viṣṇoḥ paramaṃ padam // HYP_3.109 //	balātkāreṇa gṛhṇīyāt tat viṣṇoḥ paramam padam 
SA_GSP34_hathyopu-608	iḍā bhagavatī gaṅgā piṅgalā yamunā nadī /	iḍā bhagavatī gaṅgā piṅgalā yamunā nadī 
SA_GSP34_hathyopu-609	iḍā-piṅgalayor madhye bālaraṇḍā ca kuṇḍalī // HYP_3.110 //	iḍā piṅgalayoḥ madhye bāla raṇḍā ca kuṇḍalī 
SA_GSP34_hathyopu-610	pucche pragṛhya bhujaṅgīṃ suptām udbodhayec ca tām /	pucche pragṛhya bhujaṅgīm suptām udbodhayet ca tām 
SA_GSP34_hathyopu-611	nidrāṃ vihāya sā śaktir ūrdhvam uttiṣṭhate haṭhāt // HYP_3.111 //	nidrām vihāya sā śaktiḥ ūrdhvam uttiṣṭhate haṭhāt 
SA_GSP34_hathyopu-612	avasthitā caiva phaṇāvatī sā	avasthitā ca eva phaṇāvatī sā 
SA_GSP34_hathyopu-613	prātaś ca sāyaṃ praharārdha-mātram /	prātar ca sāyam prahara ardha mātram 
SA_GSP34_hathyopu-614	prapūrya sūryāt paridhāna-yuktyā	prapūrya sūryāt paridhāna yuktyā 
SA_GSP34_hathyopu-615	pragṛhya nityaṃ paricālanīyā // HYP_3.112 //	pragṛhya nityam paricālanīyā 
SA_GSP34_hathyopu-616	ūrdhvaṃ vitasti-mātraṃ tu vistāraṃ caturaṅgulam /	ūrdhvam vitasti mātram tu vistāram catur aṅgulam 
SA_GSP34_hathyopu-617	mṛdulaṃ dhavalaṃ proktaṃ veṣṭitāmbara-lakṣaṇam // HYP_3.113 //	mṛdulam dhavalam proktam veṣṭita ambara lakṣaṇam 
SA_GSP34_hathyopu-618	sati vajrāsane pādau karābhyāṃ dhārayed dṛḍham /	sati vajrāsane pādau karābhyām dhārayet dṛḍham 
SA_GSP34_hathyopu-619	gulpha-deśa-samīpe ca kandaṃ tatra prapīḍayet // HYP_3.114 //	gulpha deśa samīpe ca kandam tatra prapīḍayet 
SA_GSP34_hathyopu-620	vajrāsane sthito yogī cālayitvā ca kuṇḍalīm /	vajrāsane sthitaḥ yogī cālayitvā ca kuṇḍalīm 
SA_GSP34_hathyopu-621	kuryād anantaraṃ bhastrāṃ kuṇḍalīm āśu bodhayet // HYP_3.115 //	kuryāt anantaram bhastrām kuṇḍalīm āśu bodhayet 
SA_GSP34_hathyopu-622	bhānor ākuñcanaṃ kuryāt kuṇḍalīṃ cālayet tataḥ /	bhānoḥ ākuñcanam kuryāt kuṇḍalīm cālayet tatas 
SA_GSP34_hathyopu-623	mṛtyu-vaktra-gatasyāpi tasya mṛtyu-bhayaṃ kutaḥ // HYP_3.116 //	mṛtyu vaktra gatasya api tasya mṛtyu bhayam kutas 
SA_GSP34_hathyopu-624	muhūrta-dvaya-paryantaṃ nirbhayaṃ cālanād asau /	muhūrta dvaya paryantam nirbhayam cālanāt asau 
SA_GSP34_hathyopu-625	ūrdhvam ākṛṣyate kiṃcit suṣumṇāyāṃ samudgatā // HYP_3.117 //	ūrdhvam ākṛṣyate kiṃcid suṣumṇāyām samudgatā 
SA_GSP34_hathyopu-626	tena kuṇḍalinī tasyāḥ suṣumṇāyā mukhaṃ dhruvam /	tena kuṇḍalinī tasyāḥ suṣumṇāyāḥ mukham dhruvam 
SA_GSP34_hathyopu-627	jahāti tasmāt prāṇo'yaṃ suṣumṇāṃ vrajati svataḥ // HYP_3.118 //	jahāti tasmāt prāṇaḥ yam suṣumṇām vrajati svatas 
SA_GSP34_hathyopu-628	tasmāt saṃcālayen nityaṃ sukha-suptām arundhatīm /	tasmāt saṃcālayet nityam sukha suptām arundhatīm 
SA_GSP34_hathyopu-629	tasyāḥ saṃcālanenaiva yogī rogaiḥ pramucyate // HYP_3.119 //	tasyāḥ saṃcālanena eva yogī rogaiḥ pramucyate 
SA_GSP34_hathyopu-630	yena saṃcālitā śaktiḥ sa yogī siddhi-bhājanam /	yena saṃcālitā śaktiḥ sa yogī siddhi bhājanam 
SA_GSP34_hathyopu-631	kim atra bahunoktena kālaṃ jayati līlayā // HYP_3.120 //	kim atra bahunā uktena kālam jayati līlayā 
SA_GSP34_hathyopu-632	brahmacarya-ratasyaiva nityaṃ hita-mitāśinaḥ /	brahmacarya ratasya eva nityam hita mita āśinaḥ 
SA_GSP34_hathyopu-633	maṇḍalād dṛśyate siddhiḥ kuṇḍaly-abhyāsa-yoginaḥ // HYP_3.121 //	maṇḍalāt dṛśyate siddhiḥ kuṇḍalī abhyāsa yoginaḥ 
SA_GSP34_hathyopu-634	kuṇḍalīṃ cālayitvā tu bhastrāṃ kuryād viśeṣataḥ /	kuṇḍalīm cālayitvā tu bhastrām kuryāt viśeṣataḥ 
SA_GSP34_hathyopu-635	evam abhyasyato nityaṃ yamino yama-bhīḥ kutaḥ // HYP_3.122 //	evam abhyasyataḥ nityam yaminaḥ yama bhīḥ kutas 
SA_GSP34_hathyopu-636	dvā-saptati-sahasrāṇāṃ nāḍīnāṃ mala-śodhane /	dvāsaptati sahasrāṇām nāḍīnām mala śodhane 
SA_GSP34_hathyopu-637	kutaḥ prakṣālanopāyaḥ kuṇḍaly-abhyasanād ṛte // HYP_3.123 //	kutas prakṣālana upāyaḥ kuṇḍalī abhyasanāt ṛte 
SA_GSP34_hathyopu-638	iyaṃ tu madhyamā nāḍī dṛḍhābhyāsena yoginām /	iyam tu madhyamā nāḍī dṛḍha abhyāsena yoginām 
SA_GSP34_hathyopu-639	āsana-prāṇa-saṃyāma-mudrābhiḥ saralā bhavet // HYP_3.124 //	āsana prāṇasaṃyāma mudrābhiḥ saralā bhavet 
SA_GSP34_hathyopu-640	abhyāse tu vinidrāṇāṃ mano dhṛtvā samādhinā /	abhyāse tu vinidrāṇām manaḥ dhṛtvā samādhinā 
SA_GSP34_hathyopu-641	rudrāṇī vā parā mudrā bhadrāṃ siddhiṃ prayacchati // HYP_3.125 //	rudrāṇī vā parā mudrā bhadrām siddhim prayacchati 
SA_GSP34_hathyopu-642	rāja-yogaṃ vinā pṛthvī rāja-yogaṃ vinā niśā /	rājayogam vinā pṛthvī rājayogam vinā niśā 
SA_GSP34_hathyopu-643	rāja-yogaṃ vinā mudrā vicitrāpi na śobhate // HYP_3.126 //	rājayogam vinā mudrā vicitrā api na śobhate 
SA_GSP34_hathyopu-644	mārutasya vidhiṃ sarvaṃ mano-yuktaṃ samabhyaset /	mārutasya vidhim sarvam manaḥ yuktam samabhyaset 
SA_GSP34_hathyopu-645	itaratra na kartavyā mano-vṛttir manīṣiṇā // HYP_3.127 //	itaratra na kartavyā manīṣiṇā 
SA_GSP34_hathyopu-646	iti mudrā daśa proktā ādināthena śambhunā /	iti mudrāḥ daśa proktāḥ ādināthena śambhunā 
SA_GSP34_hathyopu-647	ekaikā tāsu yamināṃ mahā-siddhi-pradāyinī // HYP_3.128 //	ekaikā tāsu yaminām mahā siddhi pradāyinī 
SA_GSP34_hathyopu-648	upadeśaṃ hi mudrāṇāṃ yo datte sāmpradāyikam /	upadeśam hi mudrāṇām yaḥ datte sāmpradāyikam 
SA_GSP34_hathyopu-649	sa eva śrī-guruḥ svāmī sākṣād īśvara eva saḥ // HYP_3.129 //	saḥ eva śrī guruḥ svāmī sākṣāt īśvaraḥ eva saḥ 
SA_GSP34_hathyopu-650	tasya vākya-paro bhūtvā mudrābhyāse samāhitaḥ /	tasya vākya paraḥ bhūtvā mudrā abhyāse samāhitaḥ 
SA_GSP34_hathyopu-651	aṇimādi-guṇaiḥ sārdhaṃ labhate kāla-vañcanam // HYP_3.130 //	aṇima ādi guṇaiḥ sārdham labhate kāla vañcanam 
SA_GSP34_hathyopu-652	iti haṭha-pradīpikāyāṃ tṛtīyopadeśaḥ / (4)	iti haṭhapradīpikāyām tṛtīya upadeśaḥ 
SA_GSP34_hathyopu-653	caturthopadeśaḥ	caturtha upadeśaḥ 
SA_GSP34_hathyopu-654	namaḥ śivāya gurave nāda-bindu-kalātmane /	namaḥ śivāya gurave nāda bindu kalā ātmane 
SA_GSP34_hathyopu-655	nirañjana-padaṃ yāti nityaṃ tatra parāyaṇaḥ // HYP_4.1 //	nirañjana padam yāti nityam tatra parāyaṇaḥ 
SA_GSP34_hathyopu-656	athedānīṃ pravakṣyāmi samādhikramam uttamam /	atha idānīm pravakṣyāmi samādhi kramam uttamam 
SA_GSP34_hathyopu-657	mṛtyughnaṃ ca sukhopāyaṃ brahmānanda-karaṃ param // HYP_4.2 //	mṛtyu ghnam ca sukha upāyam brahma ānanda karam param 
SA_GSP34_hathyopu-658	rāja-yogaḥ samādhiś ca unmanī ca manonmanī /	rājayogaḥ samādhiḥ ca unmanī ca manonmanī 
SA_GSP34_hathyopu-659	amaratvaṃ layas tattvaṃ śūnyāśūnyaṃ paraṃ padam // HYP_4.3 //	              
SA_GSP34_hathyopu-660	amanaskaṃ tathādvaitaṃ nirālambaṃ nirañjanam /	amanaskam tathā advaitam nirālambam nirañjanam 
SA_GSP34_hathyopu-661	jīvanmuktiś ca sahajā turyā cety eka-vācakāḥ // HYP_4.4 //	jīvanmuktiḥ ca sahajā turyā ca iti ekavācakāḥ 
SA_GSP34_hathyopu-662	salile saindhavaṃ yadvat sāmyaṃ bhajati yogataḥ /	salile saindhavam yadvat sāmyam bhajati yogataḥ 
SA_GSP34_hathyopu-663	tathātma-manasor aikyaṃ samādhir abhidhīyate // HYP_4.5 //	tathā ātma manasoḥ aikyam samādhiḥ abhidhīyate 
SA_GSP34_hathyopu-664	yadā saṃkṣīyate prāṇo mānasaṃ ca pralīyate /	yadā saṃkṣīyate prāṇaḥ mānasam ca pralīyate 
SA_GSP34_hathyopu-665	tadā samarasatvaṃ ca samādhir abhidhīyate // HYP_4.6 //	tadā sama rasa tvam ca samādhiḥ abhidhīyate 
SA_GSP34_hathyopu-666	tat-samaṃ ca dvayor aikyaṃ jīvātma-paramātmanoḥ /	tad samam ca dvayoḥ aikyam jīvātma paramātmanoḥ 
SA_GSP34_hathyopu-667	pranaṣṭa-sarva-saṅkalpaḥ samādhiḥ so'bhidhīyate // HYP_4.7 //	pranaṣṭa sarva saṅkalpaḥ samādhiḥ saḥ abhidhīyate 
SA_GSP34_hathyopu-668	rāja-yogasya māhātmyaṃ ko vā jānāti tattvataḥ /	rājayogasya māhātmyam kaḥ vā jānāti tattvataḥ 
SA_GSP34_hathyopu-669	jñānaṃ muktiḥ sthitiḥ siddhir guru-vākyena labhyate // HYP_4.8 //	jñānam muktiḥ sthitiḥ siddhiḥ guru vākyena labhyate 
SA_GSP34_hathyopu-670	durlabho viṣaya-tyāgo durlabhaṃ tattva-darśanam /	durlabhaḥ viṣaya tyāgaḥ durlabham tattva darśanam 
SA_GSP34_hathyopu-671	durlabhā sahajāvasthā sad-guroḥ karuṇāṃ vinā // HYP_4.9 //	durlabhā sahaja avasthā sat guroḥ karuṇām vinā 
SA_GSP34_hathyopu-672	vividhair āsanaiḥ kubhair vicitraiḥ karaṇair api /	vividhaiḥ āsanaiḥ kubhaiḥ vicitraiḥ karaṇaiḥ api 
SA_GSP34_hathyopu-673	prabuddhāyāṃ mahā-śaktau prāṇaḥ śūnye pralīyate // HYP_4.10 //	prabuddhāyām mahā śaktau prāṇaḥ śūnye pralīyate 
SA_GSP34_hathyopu-674	utpanna-śakti-bodhasya tyakta-niḥśeṣa-karmaṇaḥ /	utpanna śakti bodhasya tyakta niḥśeṣa karmaṇaḥ 
SA_GSP34_hathyopu-675	yoginaḥ sahajāvasthā svayam eva prajāyate // HYP_4.11 //	yoginaḥ sahaja avasthā svayam eva prajāyate 
SA_GSP34_hathyopu-676	suṣumṇā-vāhini prāṇe śūnye viśati mānase /	suṣumṇā vāhini prāṇe śūnye viśati mānase 
SA_GSP34_hathyopu-677	tadā sarvāṇi karmāṇi nirmūlayati yogavit // HYP_4.12 //	tadā sarvāṇi karmāṇi nirmūlayati yoga vid 
SA_GSP34_hathyopu-678	amarāya namas tubhyaṃ so'pi kālas tvayā jitaḥ /	amarāya namaḥ tubhyam saḥ api kālaḥ tvayā jitaḥ 
SA_GSP34_hathyopu-679	patitaṃ vadane yasya jagad etac carācaram // HYP_4.13 //	patitam vadane yasya jagat etat carācaram 
SA_GSP34_hathyopu-680	citte samatvam āpanne vāyau vrajati madhyame /	citte samatvam āpanne vāyau vrajati madhyame 
SA_GSP34_hathyopu-681	tadāmarolī vajrolī sahajolī prajāyate // HYP_4.14 //	tadā amarolī vajrolī sahajolī prajāyate 
SA_GSP34_hathyopu-682	jñānaṃ kuto manasi sambhavatīha tāvat	jñānam kutas manasi sambhavati iha tāvat 
SA_GSP34_hathyopu-683	prāṇo'pi jīvati mano mriyate na yāvat /	prāṇaḥ api jīvati manaḥ mriyate na yāvat 
SA_GSP34_hathyopu-684	prāṇo mano dvayam idaṃ vilayaṃ nayed yo	prāṇaḥ manaḥ dvayam idam vilayam nayet yaḥ 
SA_GSP34_hathyopu-685	mokṣaṃ sa gacchati naro na kathaṃcid anyaḥ // HYP_4.15 //	mokṣam sa gacchati naraḥ na kathaṃcid anyaḥ 
SA_GSP34_hathyopu-686	jñātvā suṣumṇāsad-bhedaṃ kṛtvā vāyuṃ ca madhyagam /	jñātvā suṣumṇā sat bhedam kṛtvā vāyum ca madhya gam 
SA_GSP34_hathyopu-687	sthitvā sadaiva susthāne brahma-randhre nirodhayet // HYP_4.16 //	sthitvā sadā eva susthāne brahmarandhre nirodhayet 
SA_GSP34_hathyopu-688	sūrya-candramasau dhattaḥ kālaṃ rātrindivātmakam /	sūrya candramasau dhattaḥ kālam rātrindiva ātmakam 
SA_GSP34_hathyopu-689	bhoktrī suṣumnā kālasya guhyam etad udāhṛtam // HYP_4.17 //	bhoktrī suṣumnā kālasya guhyam etat udāhṛtam 
SA_GSP34_hathyopu-690	dvā-saptati-sahasrāṇi nāḍī-dvārāṇi pañjare /	dvāsaptati sahasrāṇi nāḍī dvārāṇi pañjare 
SA_GSP34_hathyopu-691	suṣumṇā śāmbhavī śaktiḥ śeṣās tv eva nirarthakāḥ // HYP_4.18 //	suṣumṇā śāmbhavī śaktiḥ śeṣāḥ tu eva nirarthakāḥ 
SA_GSP34_hathyopu-692	vāyuḥ paricito yasmād agninā saha kuṇḍalīm /	vāyuḥ paricitaḥ yasmāt agninā saha kuṇḍalīm 
SA_GSP34_hathyopu-693	bodhayitvā suṣumṇāyāṃ praviśed anirodhataḥ // HYP_4.19 //	bodhayitvā suṣumṇāyām praviśet anirodhataḥ 
SA_GSP34_hathyopu-694	suṣumṇā-vāhini prāṇe siddhyaty eva manonmanī /	suṣumṇā vāhini prāṇe siddhyati eva manonmanī 
SA_GSP34_hathyopu-695	anyathā tv itarābhyāsāḥ prayāsāyaiva yoginām // HYP_4.20 //	anyathā tu itara abhyāsāḥ prayāsāya eva yoginām 
SA_GSP34_hathyopu-696	pavano badhyate yena manas tenaiva badhyate /	pavanaḥ badhyate yena manaḥ tena eva badhyate 
SA_GSP34_hathyopu-697	manaś ca badhyate yena pavanas tena badhyate // HYP_4.21 //	manaḥ ca badhyate yena pavanaḥ tena badhyate 
SA_GSP34_hathyopu-698	hetu-dvayaṃ tu cittasya vāsanā ca samīraṇaḥ /	hetu dvayam tu cittasya vāsanā ca samīraṇaḥ 
SA_GSP34_hathyopu-699	tayor vinaṣṭa ekasmin tau dvāv api vinaśyataḥ // HYP_4.22 //	tayoḥ vinaṣṭe ekasmin tau dvau api vinaśyataḥ 
SA_GSP34_hathyopu-700	mano yatra vilīyeta pavanas tatra līyate /	manaḥ yatra vilīyeta pavanaḥ tatra līyate 
SA_GSP34_hathyopu-701	pavano līyate yatra manas tatra vilīyate // HYP_4.23 //	pavanaḥ līyate yatra manaḥ tatra vilīyate 
SA_GSP34_hathyopu-702	dugdhāmbuvat saṃmilitāv ubhau tau	dugdha ambu vat saṃmilitau ubhau tau 
SA_GSP34_hathyopu-703	tulya-kriyau mānasa-mārutau hi /	tulya kriyau mānasa mārutau hi 
SA_GSP34_hathyopu-704	yato marut tatra manaḥ-pravṛttir	yatas marut tatra manaḥ pravṛttiḥ 
SA_GSP34_hathyopu-705	yato manas tatra marut-pravṛttiḥ // HYP_4.24 //	yatas manaḥ tatra marut pravṛttiḥ 
SA_GSP34_hathyopu-706	tatraika-nāśād aparasya nāśa	tatra eka nāśāt aparasya 
SA_GSP34_hathyopu-707	eka-pravṛtter apara-pravṛttiḥ /	eka pravṛtteḥ apara pravṛttiḥ 
SA_GSP34_hathyopu-708	adhvas tayoś cendriya-varga-vṛttiḥ	adhvaḥ tayoḥ ca indriya varga vṛttiḥ 
SA_GSP34_hathyopu-709	pradhvas tayor mokṣa-padasya siddhiḥ // HYP_4.25 //	pradhvaḥ tayoḥ mokṣa padasya siddhiḥ 
SA_GSP34_hathyopu-710	rasasya manasaś caiva cañcalatvaṃ svabhāvataḥ /	rasasya manasaḥ ca eva cañcala tvam svabhāvataḥ 
SA_GSP34_hathyopu-711	raso baddho mano baddhaṃ kiṃ na siddhyati bhūtale // HYP_4.26 //	rasaḥ baddhaḥ manaḥ baddham kim na siddhi ati bhū tale 
SA_GSP34_hathyopu-712	mūrcchito harate vyādhīn mṛto jīvayati svayam /	mūrcchitaḥ harate vyādhīn mṛtaḥ jīvayati svayam 
SA_GSP34_hathyopu-713	baddhaḥ khecaratāṃ dhatte raso vāyuś ca pārvati // HYP_4.27 //	baddhaḥ khecara tām dhatte rasaḥ vāyuḥ ca pārvati 
SA_GSP34_hathyopu-714	manaḥ sthairyaṃ sthiro vāyus tato binduḥ sthiro bhavet /	manaḥ sthairyam sthiraḥ vāyuḥ tatas binduḥ sthiraḥ bhavet 
SA_GSP34_hathyopu-715	bindu-sthairyāt sadā sattvaṃ piṇḍa-sthairyaṃ prajāyate // HYP_4.28 //	bindu sthairyāt sadā sattvam piṇḍa sthairyam prajāyate 
SA_GSP34_hathyopu-716	indriyāṇāṃ mano nātho manonāthas tu mārutaḥ /	indriyāṇām manaḥ nāthaḥ manaḥ nāthaḥ tu mārutaḥ 
SA_GSP34_hathyopu-717	mārutasya layo nāthaḥ sa layo nādam āśritaḥ // HYP_4.29 //	mārutasya layaḥ nāthaḥ sa layaḥ nādam āśritaḥ 
SA_GSP34_hathyopu-718	so'yam evāstu mokṣākhyo māstu vāpi matāntare /	saḥ uyam evā astu mokṣa ākhyaḥ mā astu vā api mata antare 
SA_GSP34_hathyopu-719	manaḥ-prāṇa-laye kaścid ānandaḥ sampravartate // HYP_4.30 //	manaḥ prāṇa laye kaścid ānandaḥ sampravartate 
SA_GSP34_hathyopu-720	pranaṣṭa-śvāsa-niśvāsaḥ pradhvasta-viṣaya-grahaḥ /	pranaṣṭa śvāsa niśvāsaḥ pradhvasta viṣaya grahaḥ 
SA_GSP34_hathyopu-721	niśceṣṭo nirvikāraś ca layo jayati yoginām // HYP_4.31 //	niśceṣṭaḥ nirvikāraḥ ca layaḥ jayati yoginām 
SA_GSP34_hathyopu-722	ucchinna-sarva-saṅkalpo niḥśeṣāśeṣa-ceṣṭitaḥ /	ucchinna sarva saṅkalpaḥ niḥśeṣa aśeṣa ceṣṭitaḥ 
SA_GSP34_hathyopu-723	svāvagamyo layaḥ ko'pi jāyate vāg-agocaraḥ // HYP_4.32 //	sva avagamyaḥ layaḥ kaḥ api jāyate vāc agocaraḥ 
SA_GSP34_hathyopu-724	yatra dṛṣṭir layas tatra bhūtendriya-sanātanī /	yatra dṛṣṭiḥ layaḥ tatra bhūta indriya sanātanī 
SA_GSP34_hathyopu-725	sā śaktir jīva-bhūtānāṃ dve alakṣye layaṃ gate // HYP_4.33 //	sā śaktiḥ jīva bhūtānām dve alakṣye layam gate 
SA_GSP34_hathyopu-726	layo laya iti prāhuḥ kīdṛśaṃ laya-lakṣaṇam /	layaḥ layaḥ iti prāhuḥ kīdṛśam laya lakṣaṇam 
SA_GSP34_hathyopu-727	apunar-vāsanotthānāl layo viṣaya-vismṛtiḥ // HYP_4.34 //	a punar vāsanā utthānāt layaḥ viṣaya vismṛtiḥ 
SA_GSP34_hathyopu-728	veda-śāstra-purāṇāni sāmānya-gaṇikā iva /	veda śāstra purāṇāni sāmānyagaṇikā iva 
SA_GSP34_hathyopu-729	ekaiva śāmbhavī mudrā guptā kula-vadhūr iva // HYP_4.35 //	ekā eva śāmbhavī mudrā guptā kula vadhūḥ iva 
SA_GSP34_hathyopu-730	atha śāmbhavī-	atha śāmbhavī 
SA_GSP34_hathyopu-731	antar lakṣyaṃ bahir dṛṣṭir nimeṣonmeṣa-varjitā /	antar lakṣyam bahis dṛṣṭiḥ nimeṣa unmeṣa varjitā 
SA_GSP34_hathyopu-732	eṣā sā śāmbhavī mudrā veda-śāstreṣu gopitā // HYP_4.36 //	eṣā sā śāmbhavī mudrā veda śāstreṣu gopitā 
SA_GSP34_hathyopu-733	antar lakṣya-vilīna-citta-pavano yogī yadā vartate	antar lakṣya vilīna citta pavanaḥ yogī yadā vartate 
SA_GSP34_hathyopu-734	dṛṣṭyā niścala-tārayā bahir adhaḥ paśyann apaśyann api /	dṛṣṭyā niścala tārayā bahis adhas paśyan a paśyan api 
SA_GSP34_hathyopu-735	mudreyaṃ khalu śāmbhavī bhavati sā labdhā prasādād guroḥ	mudrā iyam khalu śāmbhavī bhavati sā labdhā prasādāt guroḥ 
SA_GSP34_hathyopu-736	śūnyāśūnya-vilakṣaṇaṃ sphurati tat tattvaṃ padaṃ śāmbhavam // HYP_4.37 //	śūnyāśūnya vilakṣaṇam sphurati tat tattvam padam śāmbhavam 
SA_GSP34_hathyopu-737	śrī-śāmbhavyāś ca khecaryā avasthā-dhāma-bhedataḥ /	śrī śāmbhavyāḥ ca khecaryāḥ avasthā dhāma bhedataḥ 
SA_GSP34_hathyopu-738	bhavec citta-layānandaḥ śūnye cit-sukha-rūpiṇi // HYP_4.38 //	bhavet citta laya ānandaḥ śūnye cit sukha rūpiṇi 
SA_GSP34_hathyopu-739	tāre jyotiṣi saṃyojya kiṃcid unnamayed bhruvau /	tāre jyotiṣi saṃyojya kiṃcid unnamayet bhruvau 
SA_GSP34_hathyopu-740	pūrva-yogaṃ mano yuñjann unmanī-kārakaḥ kṣaṇāt // HYP_4.39 //	pūrva yogam manaḥ yuñjan unmanī kārakaḥ kṣaṇāt 
SA_GSP34_hathyopu-741	kecid āgama-jālena kecin nigama-saṅkulaiḥ /	kecid āgama jālena kecid nigama saṅkulaiḥ 
SA_GSP34_hathyopu-742	kecit tarkeṇa muhyanti naiva jānanti tārakam // HYP_4.40 //	kecid tarkeṇa muhyanti na eva jānanti tārakam 
SA_GSP34_hathyopu-743	ardhonmīlita-locanaḥ sthira-manā nāsāgra-dattekṣaṇaś	ardha unmīlita locanaḥ sthira manāḥ nāsā agra datta īkṣaṇaḥ 
SA_GSP34_hathyopu-744	candrārkāv api līnatām upanayan nispanda-bhāvena yaḥ /	candra arkau api līnatām upanayan nispanda bhāvena yaḥ 
SA_GSP34_hathyopu-745	jyotī-rūpam aśeṣa-bījam akhilaṃ dedīpyamānaṃ paraṃ	jyotīrūpam aśeṣa bījam akhilam dedīpyamānam param 
SA_GSP34_hathyopu-746	tattvaṃ tat-padam eti vastu paramaṃ vācyaṃ kim atrādhikam // HYP_4.41 //	tattvam tat padam eti vastu paramam vācyam kim atra adhikam 
SA_GSP34_hathyopu-747	divā na pūjayel liṅgaṃ rātrau caiva na pūjayet /	divā na pūjayet liṅgam rātrau ca eva na pūjayet 
SA_GSP34_hathyopu-748	sarvadā pūjayel liṅgaṃ divārātri-nirodhataḥ // HYP_4.42 //	sarvadā pūjayet liṅgam divā rātri nirodhataḥ 
SA_GSP34_hathyopu-749	atha khecarī-	atha khecarī 
SA_GSP34_hathyopu-750	savya-dakṣiṇa-nāḍī-stho madhye carati mārutaḥ /	savya dakṣiṇa nāḍī sthaḥ madhye carati mārutaḥ 
SA_GSP34_hathyopu-751	tiṣṭhate khecarī mudrā tasmin sthāne na saṃśayaḥ // HYP_4.43 //	tiṣṭhate khecarī mudrā tasmin sthāne na saṃśayaḥ 
SA_GSP34_hathyopu-752	iḍā-piṅgalayor madhye śūnyaṃ caivānilaṃ graset /	iḍā piṅgalayoḥ madhye śūnyam ca eva anilam graset 
SA_GSP34_hathyopu-753	tiṣṭhate khecarī mudrā tatra satyaṃ punaḥ punaḥ // HYP_4.44 //	tiṣṭhate khecarī mudrā tatra satyam punar punar 
SA_GSP34_hathyopu-754	sūrcyācandramasor madhye nirālambāntare punaḥ /	sūrcyā candramasoḥ madhye nirālamba antare punar 
SA_GSP34_hathyopu-755	saṃsthitā vyoma-cakre yā sā mudrā nāma khecarī // HYP_4.45 //	saṃsthitā vyomacakre yā sā mudrā nāma khecarī 
SA_GSP34_hathyopu-756	somād yatroditā dhārā sākṣāt sā śiva-vallabhā /	somāt yatra uditā dhārā sākṣāt sā śivavallabhā 
SA_GSP34_hathyopu-757	pūrayed atulāṃ divyāṃ suṣumṇāṃ paścime mukhe // HYP_4.46 //	pūrayet atulām divyām suṣumṇām paścime mukhe 
SA_GSP34_hathyopu-758	purastāc caiva pūryeta niścitā khecarī bhavet /	purastāt ca eva pūryeta niścitā khecarī bhavet 
SA_GSP34_hathyopu-759	abhyastā khecarī mudrāpy unmanī samprajāyate // HYP_4.47 //	abhyastā khecarī mudrā api unmanī samprajāyate 
SA_GSP34_hathyopu-760	bhruvor madhye śiva-sthānaṃ manas tatra vilīyate /	bhruvoḥ madhye śiva sthānam manaḥ tatra vilīyate 
SA_GSP34_hathyopu-761	jñātavyaṃ tat-padaṃ turyaṃ tatra kālo na vidyate // HYP_4.48 //	jñātavyam tat padam turyam tatra kālaḥ na vidyate 
SA_GSP34_hathyopu-762	abhyaset khecarīṃ tāvad yāvat syād yoga-nidritaḥ /	abhyaset khecarīm tāvat yāvat syāt yoga nidritaḥ 
SA_GSP34_hathyopu-763	samprāpta-yoga-nidrasya kālo nāsti kadācana // HYP_4.49 //	samprāpta yoganidrasya kālaḥ na asti kadācana 
SA_GSP34_hathyopu-764	nirālambaṃ manaḥ kṛtvā na kiṃcid api cintayet /	nirālambam manaḥ kṛtvā na kiṃcid api cintayet 
SA_GSP34_hathyopu-765	sa-bāhyābhyantaraṃ vyomni ghaṭavat tiṣṭhati dhruvam // HYP_4.50 //	sa bāhya abhyantaram vyomni ghaṭa vat tiṣṭhati dhruvam 
SA_GSP34_hathyopu-766	bāhya-vāyur yathā līnas tathā madhyo na saṃśayaḥ /	bāhya vāyuḥ yathā līnaḥ tathā madhyaḥ na saṃśayaḥ 
SA_GSP34_hathyopu-767	sva-sthāne sthiratām eti pavano manasā saha // HYP_4.51 //	sva sthāne sthiratām eti pavanaḥ manasā saha 
SA_GSP34_hathyopu-768	evam abhyasyatas tasya vāyu-mārge divāniśam /	evam abhyasyataḥ tasya vāyu mārge divāniśam 
SA_GSP34_hathyopu-769	abhyāsāj jīryate vāyur manas tatraiva līyate // HYP_4.52 //	abhyāsāt jīryate vāyuḥ manaḥ tatra eva līyate 
SA_GSP34_hathyopu-770	amṛtaiḥ plāvayed deham āpāda-tala-mastakam /	            
SA_GSP34_hathyopu-771	siddhyaty eva mahā-kāyo mahā-bala-parākramaḥ // HYP_4.53 //	siddhi ati eva mahā kāyaḥ mahā bala parākramaḥ 
SA_GSP34_hathyopu-772	śakti-madhye manaḥ kṛtvā śaktiṃ mānasa-madhyagām /	śakti madhye manaḥ kṛtvā śaktim mānasa madhya gām 
SA_GSP34_hathyopu-773	manasā mana ālokya dhārayet paramaṃ padam // HYP_4.54 //	manasā manaḥ ālokya dhārayet paramam padam 
SA_GSP34_hathyopu-774	kha-madhye kuru cātmānam ātma-madhye ca khaṃ kuru /	kha madhye kuru ca ātmānam ātma madhye ca kham kuru 
SA_GSP34_hathyopu-775	sarvaṃ ca kha-mayaṃ kṛtvā na kiṃcid api cintayet // HYP_4.55 //	sarvam ca kha mayam kṛtvā na kiṃcid api cintayet 
SA_GSP34_hathyopu-776	antaḥ śūnyo bahiḥ śūnyaḥ śūnyaḥ kumbha ivāmbare /	antar śūnyaḥ bahis śūnyaḥ śūnyaḥ kumbhaḥ iva ambare 
SA_GSP34_hathyopu-777	antaḥ pūrṇo bahiḥ pūrṇaḥ pūrṇaḥ kumbha ivārṇave // HYP_4.56 //	antar pūrṇaḥ bahis pūrṇaḥ pūrṇaḥ kumbhaḥ iva arṇave 
SA_GSP34_hathyopu-778	bāhya-cintā na kartavyā tathaivāntara-cintanam /	bāhya cintā na kartavyā tathā eva antara cintanam 
SA_GSP34_hathyopu-779	sarva-cintāṃ parityajya na kiṃcid api cintayet // HYP_4.57 //	sarva cintām parityajya na kiṃcid api cintayet 
SA_GSP34_hathyopu-780	saṅkalpa-mātra-kalanaiva jagat samagraṃ	saṅkalpa mātra kalanā eva jagat samagram 
SA_GSP34_hathyopu-781	saṅkalpa-mātra-kalanaiva mano-vilāsaḥ /	saṅkalpa mātra kalanā eva manaḥ vilāsaḥ 
SA_GSP34_hathyopu-782	saṅkalpa-mātra-matim utsṛja nirvikalpam	saṅkalpa mātra matim utsṛja nirvikalpam 
SA_GSP34_hathyopu-783	āśritya niścayam avāpnuhi rāma śāntim // HYP_4.58 //	āśritya niścayam avāpnuhi rāma śāntim 
SA_GSP34_hathyopu-784	karpūram anale yadvat saindhavaṃ salile yathā /	karpūram anale yadvat saindhavam salile yathā 
SA_GSP34_hathyopu-785	tathā sandhīyamānaṃ ca manas tattve vilīyate // HYP_4.59 //	tathā sandhīyamānam ca manaḥ tattve vilīyate 
SA_GSP34_hathyopu-786	jñeyaṃ sarvaṃ pratītaṃ ca jñānaṃ ca mana ucyate /	jñeyam sarvam pratītam ca jñānam ca manaḥ ucyate 
SA_GSP34_hathyopu-787	jñānaṃ jñeyaṃ samaṃ naṣṭaṃ nānyaḥ panthā dvitīyakaḥ // HYP_4.60 //	jñānam jñeyam samam naṣṭam na anyaḥ panthāḥ dvitīyakaḥ 
SA_GSP34_hathyopu-788	mano-dṛśyam idaṃ sarvaṃ yat kiṃcit sa-carācaram /	manaḥ dṛśyam idam sarvam yat kiṃcid sacarācaram 
SA_GSP34_hathyopu-789	manaso hy unmanī-bhāvād dvaitaṃ naivolabhyate // HYP_4.61 //	manasaḥ hi unmanībhāvāt dvaitam na eva upalabhyate 
SA_GSP34_hathyopu-790	jñeya-vastu-parityāgād vilayaṃ yāti mānasam /	jñeya vastu parityāgāt vilayam yāti mānasam 
SA_GSP34_hathyopu-791	manaso vilaye jāte kaivalyam avaśiṣyate // HYP_4.62 //	manasaḥ vilaye jāte kaivalyam avaśiṣyate 
SA_GSP34_hathyopu-792	evaṃ nānā-vidhopāyāḥ samyak svānubhavānvitāḥ /	evam nānāvidha upāyāḥ samyak sva anubhava anvitāḥ 
SA_GSP34_hathyopu-793	samādhi-mārgāḥ kathitāḥ pūrvācāryair mahātmabhiḥ // HYP_4.63 //	samādhi mārgāḥ kathitāḥ pūrva ācāryaiḥ mahātmabhiḥ 
SA_GSP34_hathyopu-794	suṣumṇāyai kuṇḍalinyai sudhāyai candra-janmane /	suṣumṇāyai kuṇḍalinyai sudhāyai candra janmane 
SA_GSP34_hathyopu-795	manonmanyai namas tubhyaṃ mahā-śaktyai cid-ātmane // HYP_4.64 //	manonmanyai namaḥ tubhyam mahā śaktyai cit ātmane 
SA_GSP34_hathyopu-796	aśakya-tattva-bodhānāṃ mūḍhānām api saṃmatam /	aśakya tattva bodhānām mūḍhānām api saṃmatam 
SA_GSP34_hathyopu-797	proktaṃ gorakṣa-nāthena nādopāsanam ucyate // HYP_4.65 //	proktam gorakṣa nāthena nāda upāsanam ucyate 
SA_GSP34_hathyopu-798	śrī-ādināthena sa-pāda-koṭi-	        
SA_GSP34_hathyopu-799	laya-prakārāḥ kathitā jayanti /	laya prakārāḥ kathitāḥ jayanti 
SA_GSP34_hathyopu-800	nādānusandhānakam ekam eva	nāda anusandhānakam ekam eva 
SA_GSP34_hathyopu-801	manyāmahe mukhyatamaṃ layānām // HYP_4.66 //	manyāmahe mukhyatamam layānām 
SA_GSP34_hathyopu-802	muktāsane sthito yogī mudrāṃ sandhāya śāmbhavīm /	muktāsane sthitaḥ yogī mudrām sandhāya śāmbhavīm 
SA_GSP34_hathyopu-803	śṛṇuyād dakṣiṇe karṇe nādam antāstham ekadhīḥ // HYP_4.67 //	śṛṇuyāt dakṣiṇe karṇe nādam anta āstham eka dhīḥ 
SA_GSP34_hathyopu-804	śravaṇa-puṭa-nayana-yugala-	śravaṇa puṭa nayana yugala 
SA_GSP34_hathyopu-805	ghrāṇa-mukhānāṃ nirodhanaṃ kāryam /	ghrāṇa mukhānām nirodhanam kāryam 
SA_GSP34_hathyopu-806	śuddha-suṣumṇā-saraṇau	śuddha suṣumṇā saraṇau 
SA_GSP34_hathyopu-807	sphuṭam amalaḥ śrūyate nādaḥ // HYP_4.68 //	sphuṭam amalaḥ śrūyate nādaḥ 
SA_GSP34_hathyopu-808	ārambhaś ca ghaṭaś caiva tathā paricayo'pi ca /	ārambhaḥ ca ghaṭaḥ ca eva tathā paricayaḥ api ca 
SA_GSP34_hathyopu-809	niṣpattiḥ sarva-yogeṣu syād avasthā-catuṣṭayam // HYP_4.69 //	niṣpattiḥ sarva yogeṣu syāt avasthācatuṣṭayam 
SA_GSP34_hathyopu-810	atha ārambhāvasthā-	atha ārambha avasthā 
SA_GSP34_hathyopu-811	brahma-granther bhaved bhedo hy ānandaḥ śūnya-sambhavaḥ /	brahmagrantheḥ bhavet bhedaḥ hi ānandaḥ śūnya sambhavaḥ 
SA_GSP34_hathyopu-812	vicitraḥ kvaṇako dehe'nāhataḥ śrūyate dhvaniḥ // HYP_4.70 //	vicitraḥ kvaṇakaḥ dehena āhataḥ śrūyate dhvaniḥ 
SA_GSP34_hathyopu-813	divya-dehaś ca tejasvī divya-gandhas tvarogavān /	divya dehaḥ ca tejasvī divya gandhaḥ tva rogavān 
SA_GSP34_hathyopu-814	sampūrṇa-hṛdayaḥ śūnya ārambhe yogavān bhavet // HYP_4.71 //	sampūrṇa hṛdayaḥ śūnye ārambhe yogavān bhavet 
SA_GSP34_hathyopu-815	atha ghaṭāvasthā-	atha ghaṭa avasthā 
SA_GSP34_hathyopu-816	dvitīyāyāṃ ghaṭīkṛtya vāyur bhavati madhyagaḥ /	dvitīyāyām ghaṭīkṛtya vāyuḥ bhavati madhya gaḥ 
SA_GSP34_hathyopu-817	dṛḍhāsano bhaved yogī jñānī deva-samas tadā // HYP_4.72 //	dṛḍha āsanaḥ bhavet yogī jñānī deva samaḥ tadā 
SA_GSP34_hathyopu-818	viṣṇu-granthes tato bhedāt paramānanda-sūcakaḥ /	              
SA_GSP34_hathyopu-819	atiśūnye vimardaś ca bherī-śabdas tadā bhavet // HYP_4.73 //	ati śūnye vimardaḥ ca bherī śabdaḥ tadā bhavet 
SA_GSP34_hathyopu-820	atha paricayāvasthā-	atha paricaya avasthā 
SA_GSP34_hathyopu-821	tṛtīyāyāṃ tu vijñeyo vihāyo mardala-dhvaniḥ /	tṛtīyāyām tu vijñeyaḥ vihāyaḥ mardala dhvaniḥ 
SA_GSP34_hathyopu-822	mahā-śūnyaṃ tadā yāti sarva-siddhi-samāśrayam // HYP_4.74 //	mahāśūnyam tadā yāti sarva siddhi samāśrayam 
SA_GSP34_hathyopu-823	cittānandaṃ tadā jitvā sahajānanda-sambhavaḥ /	citta ānandam tadā jitvā sahaja ānanda sambhavaḥ 
SA_GSP34_hathyopu-824	doṣa-duḥkha-jarā-vyādhi-kṣudhā-nidrā-vivarjitaḥ // HYP_4.75 //	               
SA_GSP34_hathyopu-825	atha niṣpatty-avasthā-	atha niṣpatti avasthā 
SA_GSP34_hathyopu-826	rudra-granthiṃ yadā bhittvā śarva-pīṭha-gato'nilaḥ /	rudragranthim yadā bhittvā śarva pīṭha gata unilaḥ 
SA_GSP34_hathyopu-827	niṣpattau vaiṇavaḥ śabdaḥ kvaṇad-vīṇā-kvaṇo bhavet // HYP_4.76 //	niṣpattau vaiṇavaḥ śabdaḥ kvaṇat vīṇā kvaṇaḥ bhavet 
SA_GSP34_hathyopu-828	ekībhūtaṃ tadā cittaṃ rāja-yogābhidhānakam /	ekībhūtam tadā cittam rājayoga abhidhānakam 
SA_GSP34_hathyopu-829	sṛṣṭi-saṃhāra-kartāsau yogīśvara-samo bhavet // HYP_4.77 //	sṛṣṭi saṃhāra kartā asau yogi īśvara samaḥ bhavet 
SA_GSP34_hathyopu-830	astu vā māstu vā muktir atraivākhaṇḍitaṃ sukham /	astu vā mā astu vā muktiḥ atra eva akhaṇḍitam sukham 
SA_GSP34_hathyopu-831	layodbhavam idaṃ saukhyaṃ rāja-yogād avāpyate // HYP_4.78 //	laya udbhavam idam saukhyam rājayogāt avāpyate 
SA_GSP34_hathyopu-832	rāja-yogam ajānantaḥ kevalaṃ haṭha-karmiṇaḥ /	rājayogam a jānantaḥ kevalam haṭha karmiṇaḥ 
SA_GSP34_hathyopu-833	etān abhyāsino manye prayāsa-phala-varjitān // HYP_4.79 //	etān abhyāsinaḥ manye prayāsa phala varjitān 
SA_GSP34_hathyopu-834	unmany-avāptaye śīghraṃ bhrū-dhyānaṃ mama saṃmatam /	unmanī avāptaye śīghram bhrū dhyānam mama saṃmatam 
SA_GSP34_hathyopu-835	rāja-yoga-padaṃ prāptuṃ sukhopāyo'lpa-cetasām /	rājayoga padam prāptum sukha upāya ulpa cetasām 
SA_GSP34_hathyopu-836	sadyaḥ pratyaya-sandhāyī jāyate nādajo layaḥ // HYP_4.80 //	sadyas pratyaya sandhāyī jāyate nāda jaḥ layaḥ 
SA_GSP34_hathyopu-837	nādānusandhāna-samādhi-bhājāṃ	nāda anusandhāna samādhi bhājām 
SA_GSP34_hathyopu-838	yogīśvarāṇāṃ hṛdi vardhamānam /	yogi īśvarāṇām hṛdi vardhamānam 
SA_GSP34_hathyopu-839	ānandam ekaṃ vacasām agamyaṃ	ānandam ekam vacasām agamyam 
SA_GSP34_hathyopu-840	jānāti taṃ śrī-gurunātha ekaḥ // HYP_4.81 //	jānāti tam śrī guru nāthaḥ ekaḥ 
SA_GSP34_hathyopu-841	karṇau pidhāya hastābhyāṃ yaḥ śṛṇoti dhvaniṃ muniḥ /	karṇau pidhāya hastābhyām yaḥ śṛṇoti dhvanim muniḥ 
SA_GSP34_hathyopu-842	tatra cittaṃ sthirīkuryād yāvat sthira-padaṃ vrajet // HYP_4.82 //	tatra cittam sthirīkuryāt yāvat sthira padam vrajet 
SA_GSP34_hathyopu-843	abhyasyamāno nādo'yaṃ bāhyam āvṛṇute dhvanim /	abhyasyamānaḥ nādaḥ iyam bāhyam āvṛṇute dhvanim 
SA_GSP34_hathyopu-844	pakṣād vikṣepam akhilaṃ jitvā yogī sukhī bhavet // HYP_4.83 //	pakṣāt vikṣepam akhilam jitvā yogī sukhī bhavet 
SA_GSP34_hathyopu-845	śrūyate prathamābhyāse nādo nānā-vidho mahān /	śrūyate prathama abhyāse nādaḥ nānāvidhaḥ mahān 
SA_GSP34_hathyopu-846	tato'bhyāse vardhamāne śrūyate sūkṣma-sūkṣmakaḥ // HYP_4.84 //	tatobhyāse vardhamāne śrūyate sūkṣma sūkṣmakaḥ 
SA_GSP34_hathyopu-847	ādau jaladhi-jīmūta-bherī-jharjhara-sambhavāḥ /	ādau jaladhi jīmūta bherī jharjhara sambhavāḥ 
SA_GSP34_hathyopu-848	madhye mardala-śaṅkhotthā ghaṇṭā-kāhalajās tathā // HYP_4.85 //	madhye mardala śaṅkha utthāḥ ghaṇṭā kāhala jāḥ tathā 
SA_GSP34_hathyopu-849	ante tu kiṅkiṇī-vaṃśa-vīṇā-bhramara-niḥsvanāḥ /	ante tu kiṅkiṇī vaṃśa vīṇā bhramara niḥsvanāḥ 
SA_GSP34_hathyopu-850	iti nānāvidhā nādāḥ śrūyante deha-madhyagāḥ // HYP_4.86 //	iti nānāvidhāḥ nādāḥ śrūyante deha madhya gāḥ 
SA_GSP34_hathyopu-851	mahati śrūyamāṇe'pi megha-bhery-ādike dhvanau /	mahati śrūyamāṇe api megha bherī ādike dhvanau 
SA_GSP34_hathyopu-852	tatra sūkṣmāt sūkṣmataraṃ nādam eva parāmṛśet // HYP_4.87 //	tatra sūkṣmāt sūkṣmataram nādam eva parāmṛśet 
SA_GSP34_hathyopu-853	ghanam utsṛjya vā sūkṣme sūkṣmam utsṛjya vā ghane /	ghanam utsṛjya vā sūkṣme sūkṣmam utsṛjya vā ghane 
SA_GSP34_hathyopu-854	ramamāṇam api kṣiptaṃ mano nānyatra cālayet // HYP_4.88 //	ramamāṇam api kṣiptam manaḥ na anyatra cālayet 
SA_GSP34_hathyopu-855	yatra kutrāpi vā nāde lagati prathamaṃ manaḥ /	yatra kutra api vā nāde lagati prathamam manaḥ 
SA_GSP34_hathyopu-856	tatraiva susthirībhūya tena sārdhaṃ vilīyate // HYP_4.89 //	tatra eva susthirībhūya tena sārdham vilīyate 
SA_GSP34_hathyopu-857	makarandaṃ piban bhṛṅgī gandhaṃ nāpekṣate yathā /	makarandam piban bhṛṅgī gandham nā apekṣate yathā 
SA_GSP34_hathyopu-858	nādāsaktaṃ tathā cittaṃ viṣayān nahi kāṅkṣate // HYP_4.90 //	nāda āsaktam tathā cittam viṣayān nahi kāṅkṣate 
SA_GSP34_hathyopu-859	mano-matta-gajendrasya viṣayodyāna-cāriṇaḥ /	manaḥ matta gaja indrasya viṣaya udyāna cāriṇaḥ 
SA_GSP34_hathyopu-860	samartho'yaṃ niyamane nināda-niśitāṅkuśaḥ // HYP_4.91 //	samarthaḥ yam niyamane nināda niśita aṅkuśaḥ 
SA_GSP34_hathyopu-861	baddhaṃ tu nāda-bandhena manaḥ santyakta-cāpalam /	baddham tu nāda bandhena manaḥ san tyakta cāpalam 
SA_GSP34_hathyopu-862	prayāti sutarāṃ sthairyaṃ chinna-pakṣaḥ khago yathā // HYP_4.92 //	prayāti sutarām sthairyam chinna pakṣaḥ khagaḥ yathā 
SA_GSP34_hathyopu-863	sarva-cintāṃ parityajya sāvadhānena cetasā /	sarva cintām parityajya sa avadhānena cetasā 
SA_GSP34_hathyopu-864	nāda evānusandheyo yoga-sāmrājyam icchatā // HYP_4.93 //	nādaḥ eva anusandheyaḥ yoga sāmrājyam icchatā 
SA_GSP34_hathyopu-865	nādo'ntaraṅga-sāraṅga-bandhane vāgurāyate /	vāgurāyate 
SA_GSP34_hathyopu-866	antaraṅga-kuraṅgasya vadhe vyādhāyate'pi ca // HYP_4.94 //	antaraṅga kuraṅgasya vadhe ca 
SA_GSP34_hathyopu-867	antaraṅgasya yamino vājinaḥ parighāyate /	antaraṅgasya yaminaḥ vājinaḥ parighāyate 
SA_GSP34_hathyopu-868	nādopāsti-rato nityam avadhāryā hi yoginā // HYP_4.95 //	nāda upāstiḥ atas nityam avadhāryā hi yoginā 
SA_GSP34_hathyopu-869	baddhaṃ vimukta-cāñcalyaṃ nāda-gandhaka-jāraṇāt /	baddham vimukta cāñcalyam nāda gandhaka jāraṇāt 
SA_GSP34_hathyopu-870	manaḥ-pāradam āpnoti nirālambākhya-khe'ṭanam // HYP_4.96 //	              
SA_GSP34_hathyopu-871	nāda-śravaṇataḥ kṣipram antaraṅga-bhujaṅgamam /	nāda śravaṇataḥ kṣipram antaraṅga bhujaṅgamam 
SA_GSP34_hathyopu-872	vismṛtaya sarvam ekāgraḥ kutracin nahi dhāvati // HYP_4.97 //	vismṛtaya sarvam ekāgraḥ kutracid nahi dhāvati 
SA_GSP34_hathyopu-873	kāṣṭhe pravartito vahniḥ kāṣṭhena saha śāmyati /	kāṣṭhe pravartitaḥ vahniḥ kāṣṭhena saha śāmyati 
SA_GSP34_hathyopu-874	nāde pravartitaṃ cittaṃ nādena saha līyate // HYP_4.98 //	nāde pravartitam cittam nādena saha līyate 
SA_GSP34_hathyopu-875	ghaṇṭādināda-sakta-stabdhāntaḥ-karaṇa-hariṇasya /	ghaṇṭā ādi nāda sakta stabdha antaḥkaraṇa hariṇasya 
SA_GSP34_hathyopu-876	praharaṇam api sukaraṃ syāc chara-sandhāna-pravīṇaś cet // HYP_4.99 //	praharaṇam api sukaram syāt śara sandhāna pravīṇaḥ ced 
SA_GSP34_hathyopu-877	anāhatasya śabdasya dhvanir ya upalabhyate /	anāhatasya śabdasya dhvaniḥ yaḥ upalabhyate 
SA_GSP34_hathyopu-878	dhvaner antargataṃ jñeyaṃ jñeyasyāntargataṃ manaḥ /	dhvaneḥ antargatam jñeyam jñeyasya antargatam manaḥ 
SA_GSP34_hathyopu-879	manas tatra layaṃ yāti tad viṣṇoḥ paramaṃ padam // HYP_4.100 //	manaḥ tatra layam yāti tat viṣṇoḥ paramam padam 
SA_GSP34_hathyopu-880	tāvad ākāśa-saṅkalpo yāvac chabdaḥ pravartate /	tāvat ākāśa saṅkalpaḥ yāvat śabdaḥ pravartate 
SA_GSP34_hathyopu-881	niḥśabdaṃ tat-paraṃ brahma paramāteti gīyate // HYP_4.101 //	niḥśabdam tat param brahma paramātā iti gīyate 
SA_GSP34_hathyopu-882	yat kiṃcin nāda-rūpeṇa śrūyate śaktir eva sā /	yat kiṃcid nāda rūpeṇa śrūyate śaktiḥ eva sā 
SA_GSP34_hathyopu-883	yas tattvānto nirākāraḥ sa eva parameśvaraḥ // HYP_4.102 //	yaḥ tattva antaḥ nirākāraḥ saḥ eva parameśvaraḥ 
SA_GSP34_hathyopu-884	iti nādānusandhānam	iti nāda anusandhānam 
SA_GSP34_hathyopu-885	sarve haṭha-layopāyā rājayogasya siddhaye /	sarve haṭha laya upāyāḥ rājayogasya siddhaye 
SA_GSP34_hathyopu-886	rāja-yoga-samārūḍhaḥ puruṣaḥ kāla-vañcakaḥ // HYP_4.103 //	rājayoga samārūḍhaḥ puruṣaḥ kāla vañcakaḥ 
SA_GSP34_hathyopu-887	tattvaṃ bījaṃ haṭhaḥ kṣetram audāsīnyaṃ jalaṃ tribhiḥ /	tattvam bījam haṭhaḥ kṣetram audāsīnyam jalam tribhiḥ 
SA_GSP34_hathyopu-888	unmanī kalpa-latikā sadya eva pravartate // HYP_4.104 //	unmanī kalpa latikā sadyas eva pravartate 
SA_GSP34_hathyopu-889	sadā nādānusandhānāt kṣīyante pāpa-saṃcayāḥ /	sadā nāda anusandhānāt kṣīyante pāpa saṃcayāḥ 
SA_GSP34_hathyopu-890	nirañjane vilīyete niścitaṃ citta-mārutau // HYP_4.105 //	nirañjane vilīyete niścitam citta mārutau 
SA_GSP34_hathyopu-891	śaṅkha-dundhubhi-nādaṃ ca na śṛṇoti kadācana /	śaṅkha dundhubhi nādam ca na śṛṇoti kadācana 
SA_GSP34_hathyopu-892	kāṣṭhavaj jāyate deha unmanyāvasthayā dhruvam // HYP_4.106 //	kāṣṭha vat jāyate dehaḥ unmanyā avasthayā dhruvam 
SA_GSP34_hathyopu-893	sarvāvasthā-vinirmuktaḥ sarva-cintā-vivarjitaḥ /	sarva avasthā vinirmuktaḥ sarva cintā vivarjitaḥ 
SA_GSP34_hathyopu-894	mṛtavat tiṣṭhate yogī sa mukto nātra saṃśayaḥ // HYP_4.107 //	mṛta vat tiṣṭhate yogī sa muktaḥ na atra saṃśayaḥ 
SA_GSP34_hathyopu-895	khādyate na ca kālena bādhyate na ca karmaṇā /	khādyate na ca kālena bādhyate na ca karmaṇā 
SA_GSP34_hathyopu-896	sādhyate na sa kenāpi yogī yuktaḥ samādhinā // HYP_4.108 //	sādhyate na sa kena api yogī yuktaḥ samādhinā 
SA_GSP34_hathyopu-897	na gandhaṃ na rasaṃ rūpaṃ na ca sparśaṃ na niḥsvanam /	na gandham na rasam rūpam na ca sparśam na niḥsvanam 
SA_GSP34_hathyopu-898	nātmānaṃ na paraṃ vetti yogī yuktaḥ samādhinā // HYP_4.109 //	na ātmānam na param vetti yogī yuktaḥ samādhinā 
SA_GSP34_hathyopu-899	cittaṃ na suptaṃ nojāgrat smṛti-vismṛti-varjitam /	cittam na suptam na ujāgrat smṛti vismṛti varjitam 
SA_GSP34_hathyopu-900	na cāstam eti nodeti yasyāsau mukta eva saḥ // HYP_4.110 //	na ca astam eti nā udeti yasya asau muktaḥ eva saḥ 
SA_GSP34_hathyopu-901	na vijānāti śītoṣṇaṃ na duḥkhaṃ na sukhaṃ tathā /	na vijānāti śīta uṣṇam na duḥkham na sukham tathā 
SA_GSP34_hathyopu-902	na mānaṃ nopamānaṃ ca yogī yuktaḥ samādhinā // HYP_4.111 //	na mānam na upamānam ca yogī yuktaḥ samādhinā 
SA_GSP34_hathyopu-903	svastho jāgrad avasthāyāṃ suptavad yo'vatiṣṭhate /	svasthaḥ jāgrat avasthāyām supta vat yaḥ uvatiṣṭhate 
SA_GSP34_hathyopu-904	niḥśvāsocchvāsa-hīnaś ca niścitaṃ mukta eva saḥ // HYP_4.112 //	niḥśvāsa ucchvāsa hīnaḥ ca niścitam muktaḥ eva saḥ 
SA_GSP34_hathyopu-905	avadhyaḥ sarva-śastrāṇām aśakyaḥ sarva-dehinām /	avadhyaḥ sarva śastrāṇām aśakyaḥ sarva dehinām 
SA_GSP34_hathyopu-906	agrāhyo mantra-yantrāṇāṃ yogī yuktaḥ samādhinā // HYP_4.113 //	agrāhyaḥ mantra yantrāṇām yogī yuktaḥ samādhinā 
SA_GSP34_hathyopu-907	yāvan naiva praviśati caran māruto madhya-mārge	yāvat na eva praviśati caran mārutaḥ madhya mārge 
SA_GSP34_hathyopu-908	yāvad vidur na bhavati dṛḍhaḥ prāṇa-vāta-prabandhāt /	yāvat viduḥ na bhavati dṛḍhaḥ prāṇa vāta prabandhāt 
SA_GSP34_hathyopu-909	yāvad dhyāne sahaja-sadṛśaṃ jāyate naiva tattvaṃ	yāvat dhyāne sahaja sadṛśam jāyate nā eva tattvam 
SA_GSP34_hathyopu-910	tāvaj jñānaṃ vadati tad idaṃ dambha-mithyā-pralāpaḥ // HYP_4.114 //	tāvat jñānam vadati tat idam dambha mithyā pralāpaḥ 
SA_GSP34_hathyopu-911	iti haṭha-yoga-pradīpikāyāṃ samādhi-lakṣaṇaṃ nāma	iti haṭhayogapradīpikāyām samādhilakṣaṇam nāma 
SA_GSP34_hathyopu-912	caturthopadeśaḥ /	caturtha upadeśaḥ 
