segmentnr	original	analyzed
SA_GSP30_pratyabu-0	oṃ namo maṅgalamūrtaye /	om namaḥ maṅgala mūrtaye 
SA_GSP30_pratyabu-1	atha pratyabhijñāhṛdayam // [1]	atha pratyabhijñāhṛdayam 
SA_GSP30_pratyabu-2	namaḥ śivāya satataṃ pañcakṛtyavidhāyine /	namaḥ śivāya satatam pañcakṛtya vidhāyine 
SA_GSP30_pratyabu-3	cidānandaghanasvātmaparamārthāvabhāsine // [2]	              
SA_GSP30_pratyabu-4	śāṅkaropaniṣatsārapratyabhijñāmahodadheḥ /	             
SA_GSP30_pratyabu-5	kṣemeṇoddhṛyate sāraḥ saṃsāraviṣaśāntaye //	kṣemeṇa uddhṛyate sāraḥ saṃsāra viṣa śāntaye 
SA_GSP30_pratyabu-6	iha ye sukumāramatayo 'kṛtatīkṣṇatarkaśāstrapariśramāḥ	iha ye kṛta tīkṣṇa tarka śāstra pariśramāḥ 
SA_GSP30_pratyabu-7	śaktipātonmiṣitapārameśvarasamāveśābhilāṣiṇaḥ katicit bhaktibhājaḥ	śaktipāta unmiṣita pārameśvara samāveśa abhilāṣiṇaḥ katicid bhakti bhājaḥ 
SA_GSP30_pratyabu-8	teṣām īśvarapratyabhijñopadeśatattvaṃ manāk unmīlyate / tatra	teṣām īśvara pratyabhijñā upadeśa tattvam manāk unmīlyate tatra 
SA_GSP30_pratyabu-9	svātmadevatāyā eva sarvatra kāraṇatvaṃ sukhopāyaprāpyatvaṃ mahāphalatva.= m	sva ātma devatāyāḥ eva sarvatra kāraṇa tvam sukha upāya prāpya tvam mahā phala tvam 
SA_GSP30_pratyabu-10	ca abhivyaṅktum āha	ca abhivyaṅktum āha 
SA_GSP30_pratyabu-11	citiḥ svatantrā viśvasiddhihetuḥ // 1 //	         
SA_GSP30_pratyabu-12	viśvasya sadāśivādeḥ bhūmyantasya siddhau niṣpattau prakāśane	viśvasya sadāśiva ādeḥ bhūmi antasya siddhau niṣpattau prakāśane 
SA_GSP30_pratyabu-13	sthityātmani parapramātṛviśrāntyātmani ca saṃhāre parāśaktirūpā citir	sthiti ātmani para pramātṛ viśrānti ātmani ca saṃhāre parāśakti rūpā citiḥ 
SA_GSP30_pratyabu-14	eva bhagavatī svatantrā anuttaravimarśamayī śivabhaṭṭārakābhinnā hetuḥ	eva bhagavatī svatantrā anuttara vimarśa mayī śiva bhaṭṭāraka abhinnā hetuḥ 
SA_GSP30_pratyabu-15	kāraṇam / asyāṃ hi prasarantyāṃ jagat unmiṣati vyavatiṣṭhate ca	kāraṇam asyām hi prasarantyām jagat unmiṣati vyavatiṣṭhate ca 
SA_GSP30_pratyabu-16	nivṛttaprasarāyāṃ ca nimiṣati iti svānubhava eva atra sākṣī /	nivṛtta prasarāyām ca nimiṣati iti sva anubhavaḥ eva atra sākṣī 
SA_GSP30_pratyabu-17	anyasya tu māyāprakṛtyādeḥ citprakāśabhinnasya aprakāśamānatvena	anyasya tu māyā prakṛti ādeḥ cit prakāśa bhinnasya aprakāśamāna tvena 
SA_GSP30_pratyabu-18	asattvān na kvacid api hetutvam prakāśamānatve tu prakāśaikātmyāt	asattvāt na kvacid api hetu tvam prakāśamāna tve tu prakāśa aikātmyāt 
SA_GSP30_pratyabu-19	prakāśarūpā citir eva hetuḥ na tv asau kaścit /	prakāśa rūpā citiḥ eva hetuḥ na tu asau kaścid 
SA_GSP30_pratyabu-20	ata eva deśakālākārā etatsṛṣṭā etadanuprāṇitāś ca naitatsvarūpaṃ	atas eva deśa kāla ākārāḥ etad sṛṣṭāḥ etad anuprāṇitāḥ ca na etad svarūpam 
SA_GSP30_pratyabu-21	bhettum alam iti vyāpakanityoditaparipūrṇarūpā iyam ity arthalabhyam eva	bhettum alam iti vyāpaka nitya udita paripūrṇa rūpā iyam iti artha labhyam eva 
SA_GSP30_pratyabu-22	etat / nanu jagad api cito bhinnaṃ naiva kiṃcit abhede ca kathaṃ	etat nanu jagat api citaḥ bhinnam na eva kiṃcid abhede ca katham 
SA_GSP30_pratyabu-23	hetuhetumadbhāvaḥ ucyate /	hetu hetumat bhāvaḥ ucyate 
SA_GSP30_pratyabu-24	cid eva bhagavatī svacchasvatantrarūpā	cit eva bhagavatī svaccha svatantra rūpā 
SA_GSP30_pratyabu-25	tattadanantajagadātmanā sphurati ity etāvat paramārtho 'yaṃ	tad tad ananta jagat ātmanā sphurati iti etāvat paramārthaḥ yam 
SA_GSP30_pratyabu-26	kāryakāraṇabhāvaḥ /	kārya kāraṇa bhāvaḥ 
SA_GSP30_pratyabu-27	yataś ca iyam eva pramātṛpramāṇaprameyamayasya	yatas ca iyam eva pramātṛ pramāṇa prameya mayasya 
SA_GSP30_pratyabu-28	viśvasya siddhau prakāśane hetuḥ tato 'syāḥ	viśvasya siddhau prakāśane hetuḥ syāḥ 
SA_GSP30_pratyabu-29	svatantrāparicchinnasvaprakāśarūpāyāḥ siddhau abhinavārthaprakāśanarūpa.= m	svatantra aparicchinna sva prakāśa rūpāyāḥ siddhau 
SA_GSP30_pratyabu-30	na pramāṇavarākam upayuktam upapannaṃ vā /	na pramāṇa varākam upayuktam upapannam vā 
SA_GSP30_pratyabu-31	tad uktam trikasāre	tat uktam trikasāre 
SA_GSP30_pratyabu-32	svapadā svaśiraśchāyāṃ yadval laṅghitum īhate /	sva padā sva śiraḥ chāyām yadvat laṅghitum īhate 
SA_GSP30_pratyabu-33	pādoddeśe śiro na syāt tatheyaṃ baindavī kalā // iti /	pāda uddeśe śiraḥ na syāt tathā iyam baindavī kalā iti 
SA_GSP30_pratyabu-34	yataś ca iyaṃ viśvasya siddhau parādvayasamārasyāpādanātmani ca saṃhare	yatas ca iyam viśvasya siddhau parā advaya samārasya āpādana ātmani ca saṃhare 
SA_GSP30_pratyabu-35	hetuḥ tata eva svatantrā /	hetuḥ tatas eva svatantrā 
SA_GSP30_pratyabu-36	pratyabhijñātasvātantryā satī	pratyabhijñāta svātantryā satī 
SA_GSP30_pratyabu-37	bhogamokṣasvarūpāṇāṃ viśvasiddhīnāṃ hetuḥ /	bhoga mokṣa svarūpāṇām viśva siddhīnām hetuḥ 
SA_GSP30_pratyabu-38	ity āvṛttyā vyākhyeyam /	iti āvṛttyā vyākhyeyam 
SA_GSP30_pratyabu-39	api ca viśvaṃ nīlasukhadehaprāṇādi tasya yā	api ca viśvam nīla sukha deha prāṇa ādi tasya yā 
SA_GSP30_pratyabu-40	siddhiḥ pramānopārohakrameṇa vimarśamayapramātrāveśaḥ saiva hetuḥ	siddhiḥ pramāna upāroha krameṇa vimarśa maya pramātṛ āveśaḥ sā eva hetuḥ 
SA_GSP30_pratyabu-41	parijñāne upāyo yasyāḥ /	parijñāne upāyaḥ yasyāḥ 
SA_GSP30_pratyabu-42	anena ca sukhopāyatvam uktam / yad uktaṃ	anena ca sukha upāya tvam uktam yat uktam 
SA_GSP30_pratyabu-43	śrīvijñānabhaṭṭārake	             
SA_GSP30_pratyabu-44	grāhyagrāhakasaṃvittiḥ sāmānyā sarvadehinām /	grāhya grāhaka saṃvittiḥ sāmānyā sarva dehinām 
SA_GSP30_pratyabu-45	yogināṃ tu viśeṣo 'yaṃ saṃbandhe sāvadhānatā [3] // iti /	yoginām tu viśeṣaḥ yam saṃbandhe sāvadhāna tā 
SA_GSP30_pratyabu-46	citiḥ iti ekavacanaṃ deśakālādyanavacchinnatām abhidadhat	citiḥ iti ekavacanam deśa kāla ādi anavacchinna tām abhidadhat 
SA_GSP30_pratyabu-47	samastabhedavādānām avāstavatāṃ vyanakti /	samasta bheda vādānām avāstava tām vyanakti 
SA_GSP30_pratyabu-48	svatantraśabdo	svatantra śabdaḥ 
SA_GSP30_pratyabu-49	brahmavādavailakṣaṇyam ācakṣāṇaḥ cito māheśvaryasāratāṃ brūte /	brahma vāda vailakṣaṇyam ācakṣāṇaḥ citaḥ māheśvarya sāra tām brūte 
SA_GSP30_pratyabu-50	viśva ityādipadam aśeṣaśaktitvaṃ sarvakāraṇatvaṃ sukhopāyatvaṃ	                      
SA_GSP30_pratyabu-51	mahāphalaṃ ca āha //	mahā phalam ca āha 
SA_GSP30_pratyabu-52	nanu viśvasya yadi citiḥ hetuḥ tat asyā upādānādyapekṣāyāṃ	nanu viśvasya yadi citiḥ hetuḥ tat asyāḥ upādāna ādi apekṣāyām 
SA_GSP30_pratyabu-53	bhedavādāparityāgaḥ syāt	bheda vāda a parityāgaḥ syāt 
SA_GSP30_pratyabu-54	ity āśaṅkya āha	iti āśaṅkya āha 
SA_GSP30_pratyabu-55	svecchayā svabhittau viśvam unmīlayati // 2 //	svecchayā svabhittau viśvam unmīlayati 
SA_GSP30_pratyabu-56	svecchayā na tu brahmādivad anyecchayā /	sva icchayā na tu brahma ādi vat anya icchayā 
SA_GSP30_pratyabu-57	tayaiva ca na tu upādānādyapekṣay= ā	tayā eva ca na tu upādāna ādi apekṣay ā 
SA_GSP30_pratyabu-58	/ evaṃ hi prāguktasvātantryahānyā cittvam eva na ghaṭeta /	evam hi prāc ukta svātantrya hānyā cit tvam eva na ghaṭeta 
SA_GSP30_pratyabu-59	svabhittau na	sva bhittau na 
SA_GSP30_pratyabu-60	tu anyatra kvāpi /	tu anyatra kvāpi 
SA_GSP30_pratyabu-61	prāk nirṇītaṃ viśvaṃ darpaṇe nagaravat abhinnam api	prāk nirṇītam viśvam darpaṇe nagara vat abhinnam api 
SA_GSP30_pratyabu-62	bhinnam iva unmīlayati /	bhinnam iva unmīlayati 
SA_GSP30_pratyabu-63	unmīlanaṃ ca avasthitasyaiva prakaṭīkaraṇaṃ it= y	unmīlanam ca avasthitasya eva prakaṭīkaraṇam 
SA_GSP30_pratyabu-64	anena jagataḥ prakaśaikātmyenāvasthānam uktam //	anena jagataḥ prakaśa aikātmyena avasthānam uktam 
SA_GSP30_pratyabu-65	atha viśvasya svarūpaṃ vibhāgena pratipādayitum āha	atha viśvasya svarūpam vibhāgena pratipādayitum āha 
SA_GSP30_pratyabu-66	tan nānā anurūpagrāhyagrāhakabhedāt // 3 //	tat nānā anurūpa grāhya grāhaka bhedāt 
SA_GSP30_pratyabu-67	tad viśvaṃ nānā anekaprakāram /	tat viśvam nānā aneka prakāram 
SA_GSP30_pratyabu-68	katham anurūpāṇāṃ	katham anurūpāṇām 
SA_GSP30_pratyabu-69	parasparaucityāvasthīnāṃ grāhyāṇāṃ grāhakāṇāṃ ca bhedād vaicitryāt /	paraspara aucitya avasthīnām grāhyāṇām grāhakāṇām ca bhedāt vaicitryāt 
SA_GSP30_pratyabu-70	tathā ca sadāśivatattve 'hantācchāditāsphuṭedantāmayaṃ yādṛśaṃ	tathā ca sadāśivatattve yādṛśam 
SA_GSP30_pratyabu-71	parāpararūpaṃ viśvaṃ grāhyaṃ tādṛg eva	parāpara rūpam viśvam grāhyam tādṛś eva 
SA_GSP30_pratyabu-72	śrīsadāśivabhaṭṭārakādhiṣṭhito mantramaheśvarākhyaḥ pramātṛvargaḥ	                     
SA_GSP30_pratyabu-73	parameśvarecchāvakalpitatathāvasthānaḥ /	             
SA_GSP30_pratyabu-74	īśvaratattve sphuṭedantāhantāsāmānādhikaraṇyātma yādṛg viśvaṃ grāhya.= m	īśvara tattve viśvam grāhya 
SA_GSP30_pratyabu-75	tathāvidha eva īśvarabhaṭṭārakādhiṣṭhito mantreśvaravargaḥ /	tathāvidhaḥ eva īśvara bhaṭṭāraka dhiṣṭhitaḥ mantreśvara vargaḥ 
SA_GSP30_pratyabu-76	vidyāpade śrīmadanantabhaṭṭārakādhiṣṭhitā bahuśākhāvāntarabhedabhinnā	vidyāpade śrīmat ananta bhaṭṭāraka adhiṣṭhitā bahu śākhā avāntarabheda bhinnā 
SA_GSP30_pratyabu-77	yathābhūtā mantrāḥ pramātāraḥ tathābhūtam eva bhedaikasāraṃ viśvam api	yathābhūtāḥ mantrāḥ pramātāraḥ tathābhūtam eva bheda eka sāram viśvam api 
SA_GSP30_pratyabu-78	prameyam / māyordhve yādṛśā vijñānākalāḥ	prameyam māyā ūrdhve yādṛśāḥ vijñānākalāḥ 
SA_GSP30_pratyabu-79	kartṛtāśūnyaśuddhabodhātmānaḥ tādṛg eva tadabhedasāraṃ	kartṛtā śūnya śuddha bodha ātmānaḥ tādṛś eva tad abheda sāram 
SA_GSP30_pratyabu-80	sakalapralayākalātmakapūrvāvasthāparicitam eṣāṃ prameyam / māyāyāṃ	sakala pralaya akala ātmaka pūrva avasthā paricitam eṣām prameyam māyāyām 
SA_GSP30_pratyabu-81	śūnyapramātṝṇāṃ pralayakevalināṃ svocitaṃ pralīnakalpaṃ prameyam /	śūnya pramātṝṇām pralaya kevalinām svocitam pralīna kalpam prameyam 
SA_GSP30_pratyabu-82	kṣitiparyantāvasthitānāṃtu sakalānāṃ sarvato bhinnānāṃ parimitānāṃ	kṣiti paryanta avasthitānām tu sakalānām sarvatas bhinnānām parimitānām 
SA_GSP30_pratyabu-83	tathābhūtam eva prameyam /	tathābhūtam eva prameyam 
SA_GSP30_pratyabu-84	taduttīrṇaśivabhaṭṭārakasya	tad uttīrṇa śiva bhaṭṭārakasya 
SA_GSP30_pratyabu-85	prakāśaikavapuṣaḥ prakāśaikarūpā eva bhāvāḥ /	prakāśa eka vapuṣaḥ prakāśa eka rūpāḥ eva bhāvāḥ 
SA_GSP30_pratyabu-86	śrīmatparamaśivasya	śrīmat paramaśivasya 
SA_GSP30_pratyabu-87	punaḥ viśvottīrṇaviśvātmakaparamānandamayaprakāśaikaghanasya	punar viśva uttīrṇa viśva ātmaka parama ānanda maya prakāśa eka ghanasya 
SA_GSP30_pratyabu-88	evaṃvidham eva śivādidharaṇyantam akhilaṃ abhedenaiva sphurati / na tu	evaṃvidham eva śiva ādi dharaṇī antam akhilam abhedena eva sphurati na tu 
SA_GSP30_pratyabu-89	vastutaḥ anyat kiṃcit grāhyaṃ grāhakaṃ vā / api tu	vastutaḥ anyat kiṃcid grāhyam grāhakam vā api tu 
SA_GSP30_pratyabu-90	śrīparamaśivabhaṭṭāraka eva itthaṃ nānāvaicitryasahasraiḥ sphuratīty	śrī paramaśiva bhaṭṭārakaḥ eva ittham nānā vaicitrya sahasraiḥ sphurati iti 
SA_GSP30_pratyabu-91	abhihitaprāyam //	abhihita prāyam 
SA_GSP30_pratyabu-92	yathā ca bhagavān viśvaśarīraḥ tathā	yathā ca bhagavān viśva śarīraḥ tathā 
SA_GSP30_pratyabu-93	citisaṃkocātmā cetano 'pi saṃkucitaviśvamayaḥ // 4 //	citi saṃkoca ātmā saṃkucita viśva mayaḥ 
SA_GSP30_pratyabu-94	śrīparamaśivaḥ svātmaikyena sthitaṃ viśvaṃ sadāśivādyucitena rūpena	śrī paramaśivaḥ sva ātma aikyena sthitam viśvam sadāśiva ādi ucitena rūpena 
SA_GSP30_pratyabu-95	avabibhāsayiṣuḥ pūrvaṃ	avabibhāsayiṣuḥ pūrvam 
SA_GSP30_pratyabu-96	cidaikyākhyātimayānāśritaśivaparyāyaśūnyātiśūnyātmatayā prakāśābhedena	cit aikya ākhyāti maya anāśrita śiva paryāya śūnya ati śūnya ātma tayā prakāśa abhedena 
SA_GSP30_pratyabu-97	prakāśamānatayā sphurati / tataḥ	prakāśamāna tayā sphurati tatas 
SA_GSP30_pratyabu-98	cidrasāśyānatārūpāśeṣatattvabhuvanabhāvatattatpramātrādyātmatayāpi	cit rasa āśyāna tā rūpa aśeṣa tattva bhuvana bhāva tad tad pramātṛ ādi ātma tayā api 
SA_GSP30_pratyabu-99	prathate / yathā ca evaṃ bhagavān viśvaśarīraḥ tathā citisaṃkocātmā	prathate                               
SA_GSP30_pratyabu-100	saṃkucitacidrūpaḥ cetano grāhako 'pi vaṭadhānikāvat	saṃkucita cit rūpaḥ cetanaḥ vaṭa dhānikā vat 
SA_GSP30_pratyabu-101	saṃkucitāśeṣaviśvarūpaḥ /	saṃkucita aśeṣa viśva rūpaḥ 
SA_GSP30_pratyabu-102	tathā ca siddhāntavacanam	tathā ca siddhānta vacanam 
SA_GSP30_pratyabu-103	vigraho vigrahī caiva sarvavigrahavigrahī / iti /	vigrahaḥ vigrahī ca eva sarva vigraha vigrahī iti 
SA_GSP30_pratyabu-104	triśiromate 'pi=20	triśiromate 
SA_GSP30_pratyabu-105	sarvadevamayaḥ kāyas taṃ cedānīṃ śṛṇu priye /	sarva deva mayaḥ kāyaḥ tam ca idānīm śṛṇu priye 
SA_GSP30_pratyabu-106	pṛthivī kaṭhinatvena dravatve 'mbhaḥ prakīrtitam //	pṛthivī kaṭhina tvena drava tve mbhaḥ prakīrtitam 
SA_GSP30_pratyabu-107	ity upakramya=20	iti 
SA_GSP30_pratyabu-108	triśirobhairavaḥ sākṣād vyāpya viśvaṃ vyavasthitaḥ /	triśiraḥ bhairavaḥ sākṣāt vyāpya viśvam vyavasthitaḥ 
SA_GSP30_pratyabu-109	ity antena granthena grāhakasya saṃkucitaviśvamayatvam eva vyāharati /	iti antena granthena grāhakasya saṃkucita viśva maya tvam eva vyāharati 
SA_GSP30_pratyabu-110	ayaṃ cātrāśayaḥ grāhako 'pi ayaṃ prakāśaikātmyena uktāgamayuktyā ca	ayam ca atra āśayaḥ ayam prakāśa aikātmyena ukta āgama yuktyā ca 
SA_GSP30_pratyabu-111	viśvaśarīraśivaikarūpa eva kevalaṃ tanmāyāśaktyā	viśva śarīra śiva ekarūpaḥ eva kevalam tad māyā śaktyā 
SA_GSP30_pratyabu-112	anabhivyaktasvarūpatvāt saṃkucita iva ābhāti /	anabhivyakta svarūpa tvāt saṃkucitaḥ iva ābhāti 
SA_GSP30_pratyabu-113	saṃkoco 'pi vicāryamāṇaḥ	saṃkocaḥ pi vicāryamāṇaḥ 
SA_GSP30_pratyabu-114	cidaikātmyena prathamānatvāt cinmaya eva /	cit aikātmyena prathamāna tvāt cit mayaḥ eva 
SA_GSP30_pratyabu-115	anyathā tu na kiṃcit iti sarvo	anyathā tu na kiṃcid iti 
SA_GSP30_pratyabu-116	grāhako viśvaśarīraḥ śivabhaṭṭāraka eva /	              
SA_GSP30_pratyabu-117	tad uktaṃ mayaiva	tat uktam mayā eva 
SA_GSP30_pratyabu-118	akhyātir yadi na khyāti khyātir evāvaśiṣyate /	akhyātiḥ yadi na khyāti khyātiḥ eva avaśiṣyate 
SA_GSP30_pratyabu-119	khyāti cet khyātirūpatvāt khyātir evāvaśiṣyate // iti /	khyāti ced khyāti rūpa tvāt khyātiḥ eva avaśiṣyate iti 
SA_GSP30_pratyabu-120	anenaivāśayena śrīspandaśāstreṣu	anena eva āśayena śrī spandaśāstreṣu 
SA_GSP30_pratyabu-121	yasmāt sarvamayo jīvaḥ ............................ /	yasmāt sarva mayaḥ jīvaḥ 
SA_GSP30_pratyabu-122	ity upakramya=20	iti 
SA_GSP30_pratyabu-123	tena śabdārthacintāsu na sāvasthā na yaḥ śivaḥ [4] /	tena śabda artha cintāsu na sā avasthā na yaḥ śivaḥ 
SA_GSP30_pratyabu-124	ityādinā śivajīvayor abheda evoktaḥ /	ityādinā śiva jīvayoḥ abhedaḥ eva uktaḥ 
SA_GSP30_pratyabu-125	etattattvaparijñānam eva muktiḥ /	etad tattva parijñānam eva muktiḥ 
SA_GSP30_pratyabu-126	etattattvāparijñānam eva ca bandha iti bhaviṣyati eva etat //	etad tattva aparijñānam eva ca bandhaḥ iti bhaviṣyati eva etat 
SA_GSP30_pratyabu-127	nanu grāhako 'yaṃ vikalpamayaḥ vikalpanaṃ ca cittahetukaṃ sati ca citte	nanu grāhakaḥ yam vikalpa mayaḥ vikalpanam ca citta hetukam sati ca citte 
SA_GSP30_pratyabu-128	katham asya śivātmakatvaṃ iti śaṅktvā cittam eva nirnetum āha	katham asya śiva ātmaka tvam iti śaṅktvā cittam eva nirnetum āha 
SA_GSP30_pratyabu-129	citir eva cetanapadād avarūḍhā cetyasaṃkocinī	citiḥ eva cetana padāt avarūḍhā cetya saṃkocinī 
SA_GSP30_pratyabu-130	cittam // 5 //	cittam 
SA_GSP30_pratyabu-131	na cittaṃ nāma anyat kiṃcit api tu saiva bhagavatī tat /	na cittam nāma anyat kiṃcid api tu sā eva bhagavatī tat 
SA_GSP30_pratyabu-132	tathā hi sā sva.= m	tathā hi sā sva m 
SA_GSP30_pratyabu-133	svarūpaṃ gopayitvā yadā saṃkocaṃ gṛhṇāti tadā dvayī gatiḥ / kadācid	sva rūpam gopayitvā yadā saṃkocam gṛhṇāti tadā dvayī gatiḥ kadācid 
SA_GSP30_pratyabu-134	ullasitam api saṃkocaṃ guṇīkṛtya citprādhānyena sphurati / kadācit	ullasitam api saṃkocam guṇīkṛtya cit prādhānyena sphurati kadācid 
SA_GSP30_pratyabu-135	saṃkocapradhānatayā /	saṃkoca pradhāna tayā 
SA_GSP30_pratyabu-136	citprādhānyapakṣe sahajaṃ prakāśamātrapradhānatve	                 
SA_GSP30_pratyabu-137	vijñānākalatā /	     
SA_GSP30_pratyabu-138	prakāśaparāmarśapradhānatve tu vidyāpramātṛtā / tatrāpi	                                               
SA_GSP30_pratyabu-139	krameṇa saṃkocasya tanutāyāṃ īśasadāśivānāśritarūpatā /	krameṇa saṃkocasya tanu tāyām īśa sadāśiva anāśrita rūpa tā 
SA_GSP30_pratyabu-140	samādhiprayatnopārjite tu citpradhānatve śuddhādhvapramātṛtā kramāt	samādhi prayatna upārjite tu cit pradhāna tve śuddha adhva pramātṛ tā kramāt 
SA_GSP30_pratyabu-141	kramaṃ prakarṣavatī /	kramam prakarṣavatī 
SA_GSP30_pratyabu-142	saṃkocaprādhānye tu śūnyādipramātṛtā / evam	saṃkoca prādhānye tu śūnya ādi pramātṛ tā evam 
SA_GSP30_pratyabu-143	avasthite sati citir eva saṃkucitagrāhakarūpā cetanapadāt avarūḍhā	avasthite sati citiḥ eva saṃkucita grāhaka rūpā cetana padāt avarūḍhā 
SA_GSP30_pratyabu-144	arthagrahaṇonmukhī satī cetyena nīlasukhādinā saṃkocinī	artha grahaṇa unmukhī satī cetyena nīla sukha ādinā saṃkocinī 
SA_GSP30_pratyabu-145	ubhayasaṃkocasaṃkucitaiva	ubhaya saṃkoca saṃkucitā eva 
SA_GSP30_pratyabu-146	cittam / tathā ca=20	cittam tathā 
SA_GSP30_pratyabu-147	svāṅgarūpeṣu bhāveṣu patyur jñānaṃ kriyā ca yā /	sva aṅga rūpeṣu bhāveṣu patyuḥ jñānam kriyā ca yā 
SA_GSP30_pratyabu-148	māyā tṛtīye te eva paśoḥ sattvaṃ rajas tamaḥ [5] // ityādinā	māyā tṛtīye te eva paśoḥ sattvam rajaḥ tamaḥ ityādinā 
SA_GSP30_pratyabu-149	svātantryātmā citiśaktir eva jñānakriyāmāyāśaktirūpā paśudaśāyāṃ	svātantrya ātmā citi śaktiḥ eva jñāna kriyā māyā śakti rūpā paśu daśāyām 
SA_GSP30_pratyabu-150	saṃkocaprakarṣāt sattvarajastamaḥsvabhāvacittātmatayā sphuratīti	saṃkoca prakarṣāt sattva rajaḥ tamaḥ svabhāva citta ātma tayā sphurati iti 
SA_GSP30_pratyabu-151	śrīpratyabhijñāyām uktam /	śrī pratyabhijñāyām uktam 
SA_GSP30_pratyabu-152	ata eva śrītattvagarbhastotre vikalpadaśāyām	atas eva śrī tattvagarbhastotre vikalpa daśāyām 
SA_GSP30_pratyabu-153	api tāttvikasvarūpasadbhāvāt tadanusaraṇābhiprāyeṇoktam	api tāttvika svarūpa sadbhāvāt tad anusaraṇa abhiprāyeṇa uktam 
SA_GSP30_pratyabu-154	ata eva tu ye kecit paramārthānusāriṇaḥ /	atas eva tu ye kecid parama artha anusāriṇaḥ 
SA_GSP30_pratyabu-155	teṣāṃ tatra svarūpasya svajyotiṣṭvaṃ na lupyate // iti //	teṣām tatra sva rūpasya sva jyotiḥ tvam na lupyate iti 
SA_GSP30_pratyabu-156	cittam eva tu māyāpramātuḥ svarūpam ity āha	cittam eva tu māyā pramātuḥ svarūpam iti āha 
SA_GSP30_pratyabu-157	tanmayo māyāpramātā // 6 //	       
SA_GSP30_pratyabu-158	dehaprāṇapadaṃ tāvat cittapradhānam eva /	deha prāṇa padam tāvat citta pradhānam eva 
SA_GSP30_pratyabu-159	śūnyabhūmir api	śūnya bhūmiḥ api 
SA_GSP30_pratyabu-160	cittasaṃskāravaty eva /	citta saṃskāravatī eva 
SA_GSP30_pratyabu-161	anyathā tato vyutthitasya	anyathā tatas vyutthitasya 
SA_GSP30_pratyabu-162	svakartavyānudhāvanābhāvaḥ syād iti cittamaya eva māyīyaḥ pramātā /	sva kartavya anudhāvana abhāvaḥ syāt iti citta mayaḥ eva māyīyaḥ pramātā 
SA_GSP30_pratyabu-163	amunaiva āśayena śivasūtreṣu vastuvṛttānusāreṇa “caitanyam ātmā” [6]	amunā eva āśayena śivasūtreṣu vastu vṛtta anusāreṇa caitanyam ātmā 
SA_GSP30_pratyabu-164	ity abhidhāya māyāpramātṛlakṣaṇāvasare punaḥ “cittam ātmā” [7] ity ukta= m //	iti abhidhāya māyā pramātṛ lakṣaṇa avasare punar cittam ātmā iti 
SA_GSP30_pratyabu-165	asyaiva samyak svarūpajñānāt yato muktiḥ asamyak tu saṃsāraḥ tataḥ	asya eva samyak sva rūpa jñānāt yatas muktiḥ asamyak tu saṃsāraḥ tatas 
SA_GSP30_pratyabu-166	tilaśa etatsvarūpaṃ nirbhaṅktum āha	tilaśas etat svarūpam nirbhaṅktum āha 
SA_GSP30_pratyabu-167	sa caiko dvirūpas trimayaś caturātmā	sa ca ekaḥ dvi rūpaḥ tri mayaḥ catur ātmā 
SA_GSP30_pratyabu-168	saptapañcakasvabhāvaḥ // 7 //	          
SA_GSP30_pratyabu-169	nirṇītadṛśā cidātmā śivabhaṭṭāraka eva eka ātmā na tu anyaḥ kaścit	nirṇīta dṛśā cit ātmā śivabhaṭṭārakaḥ eva ekaḥ ātmā na tu anyaḥ kaścid 
SA_GSP30_pratyabu-170	prakāśasya deśakālādibhiḥ bhedāyogāt /	prakāśasya deśa kāla ādibhiḥ bheda ayogāt 
SA_GSP30_pratyabu-171	jaḍasya tu grāhakatvānupapatteḥ	jaḍasya tu grāhaka tva anupapatteḥ 
SA_GSP30_pratyabu-172	/ prakāśa eva yataḥ svātantryāt gṛhītaprāṇādisaṃkocaḥ	prakāśaḥ eva yatas svātantryāt gṛhīta prāṇa ādi saṃkocaḥ 
SA_GSP30_pratyabu-173	saṃkucitārthagrāhakatām aśnute tato 'sau	saṃkucita artha grāhaka tām aśnute sau 
SA_GSP30_pratyabu-174	prakāśarūpatvasaṃkocāvabhāsavattvābhyāṃ dvirūpaḥ /	prakāśa rūpatva saṃkoca avabhāsavat tvābhyām dvirūpaḥ 
SA_GSP30_pratyabu-175	āṇavamāyīyakārmamalāvṛtatvāt trimayaḥ /	āṇava māyīya kārma mala āvṛta tvāt tri mayaḥ 
SA_GSP30_pratyabu-176	śūnyaprāṇapuryaṣṭakaśarīrasvabhāvatvāt caturātmā /	śūnya prāṇa puryaṣṭaka śarīra svabhāva tvāt catur ātmā 
SA_GSP30_pratyabu-177	saptapañcakāni	sapta pañcakāni 
SA_GSP30_pratyabu-178	śivādipṛthivyantāni pañcatriṃśattattvāni tatsvabhāvaḥ /	śiva ādi pṛthivī antāni pañcatriṃśat tattvāni tad svabhāvaḥ 
SA_GSP30_pratyabu-179	tathā śivādisakalāntapramātṛsaptakasvarūpaḥ /	tathā śiva ādi sakala anta pramātṛ saptaka svarūpaḥ 
SA_GSP30_pratyabu-180	cidānandecchājñānakriyāśaktirūpatve 'pi akhyātivaśāt	                                                                          
SA_GSP30_pratyabu-181	kalāvidyārāgakālaniyatikañcukavalitatvāt pañcakasvarūpaḥ / evaṃ ca	kalā vidyā rāga kāla niyati kañcuka valita tvāt pañcaka svarūpaḥ evam ca 
SA_GSP30_pratyabu-182	śivaikarūpatvena pañcatriṃśattattvamayatvena pramātṛsaptakasvabhāvatven= a	śiva eka rūpa tvena pañcatriṃśat tattva maya tvena pramātṛ saptaka svabhāva tven 
SA_GSP30_pratyabu-183	cidādiśaktipañcakātmakatvena ca ayaṃ pratyabhijñāyamāno muktiḥ / anyathā	cit ādi śakti pañcaka ātmaka tvena ca ayam pratyabhijñāyamānaḥ muktiḥ anyathā 
SA_GSP30_pratyabu-184	tu saṃsārahetuḥ //	tu saṃsāra hetuḥ 
SA_GSP30_pratyabu-185	evaṃ ca	evam ca 
SA_GSP30_pratyabu-186	tadbhūmikāḥ sarvadarśanasthitayaḥ // 8 //	tad bhūmikāḥ sarva darśana sthitayaḥ 
SA_GSP30_pratyabu-187	sarveṣāṃ cārvākādidarśanānāṃ sthitayaḥ siddhāntāḥ tasya etasya ātmano	sarveṣām cārvāka ādi darśanānām sthitayaḥ siddhāntāḥ tasya etasya ātmanaḥ 
SA_GSP30_pratyabu-188	naṭasyeva svecchāvagṛhītāḥ kṛtrimā bhūmikāḥ / tathā ca	naṭasya iva sva icchā avagṛhītāḥ kṛtrimāḥ bhūmikāḥ tathā ca 
SA_GSP30_pratyabu-189	caitanyaviśiṣṭaṃ śarīram ātmā iti cārvākāḥ /	caitanya viśiṣṭam śarīram ātmā iti cārvākāḥ 
SA_GSP30_pratyabu-190	naiyāyikādayo	naiyāyika ādayaḥ 
SA_GSP30_pratyabu-191	jñānādiguṇagaṇāśrayaṃ buddhitattvaprāyam eva ātmānaṃ saṃsṛtau	jñāna ādi guṇa gaṇa āśrayam buddhi tattva prāyam eva ātmānam saṃsṛtau 
SA_GSP30_pratyabu-192	manyante / apavarge tu tad ucchede śūnyaprāyam /	manyante apavarge tu tat ucchede śūnya prāyam 
SA_GSP30_pratyabu-193	ahaṃpratītipratyeyaḥ sukhaduḥkhādyupādhibhiḥ tiraskṛtātmā manvānā	aham pratīti pratyeyaḥ sukha duḥkha ādi upādhibhiḥ tiraskṛta ātmā manvānā 
SA_GSP30_pratyabu-194	mīmāṃsakā 'pi buddhāv eva niviṣṭā /	mīmāṃsakā pi buddhau eva niviṣṭā 
SA_GSP30_pratyabu-195	jñānasantāna eva tattvaṃ iti saugat= ā	jñāna santānaḥ eva tattvam iti saugat ā 
SA_GSP30_pratyabu-196	buddhivṛttiṣv eva paryavasitāḥ /	buddhi vṛttiṣu eva paryavasitāḥ 
SA_GSP30_pratyabu-197	prāṇa evātmeti kecit śrutyantavidaḥ = /	prāṇaḥ eva ātmā iti kecid śruti anta vidaḥ 
SA_GSP30_pratyabu-198	asad eva idam āsīd ity abhāvabrahmavādinaḥ śūnyabhuvam avagāhya sthitāḥ = /	asat eva idam āsīt iti abhāva brahma vādinaḥ śūnya bhuvam avagāhya sthitāḥ 
SA_GSP30_pratyabu-199	mādhyamikāpi evam eva /	mādhyamikā api evam eva 
SA_GSP30_pratyabu-200	parā prakṛtir bhagavān vāsudevaḥ tadvisphuliṅgaprāyā eva jīvā iti	parā prakṛtiḥ bhagavān vāsudevaḥ tad visphuliṅga prāyāḥ eva jīvāḥ iti 
SA_GSP30_pratyabu-201	pāñcarātrāḥ parasyāḥ prakṛteḥ pariṇāmābhyupagamāt avyakta	pāñcarātrāḥ parasyāḥ prakṛteḥ pariṇāma abhyupagamāt avyakta 
SA_GSP30_pratyabu-202	evābhiniviṣṭāḥ /	eva abhiniviṣṭāḥ 
SA_GSP30_pratyabu-203	sāṃkhyādayas tu vijñānakalaprāyāṃ bhūmiṃ avalambante /	sāṃkhya ādayaḥ tu vijñāna kala prāyām bhūmim avalambante 
SA_GSP30_pratyabu-204	sad eva idam agra āsīd iti īśvaratattvapadam āśritā apare śrutyantavida.=	sat eva idam agre āsīt iti īśvara tattva padam āśritāḥ apare śruti anta vida 
SA_GSP30_pratyabu-205	h /=20	h 
SA_GSP30_pratyabu-206	śabdabrahmamayaṃ paśyantīrūpaṃ ātmatattvam iti vaiyākaraṇāḥ	śabdabrahma mayam paśyantī rūpam ātma tattvam iti vaiyākaraṇāḥ 
SA_GSP30_pratyabu-207	śrīsadāśivapadamadhyāsitāḥ /	śrī sadāśiva padam adhyāsitāḥ 
SA_GSP30_pratyabu-208	evam anyad api anumantavyam /	evam anyat api anumantavyam 
SA_GSP30_pratyabu-209	etac ca āgameṣu	etat ca āgameṣu 
SA_GSP30_pratyabu-210	buddhitattve sthitā bauddhā guṇeṣv evārhatāḥ sthitāḥ /	buddhi tattve sthitāḥ bauddhāḥ guṇeṣu eva ārhatāḥ sthitāḥ 
SA_GSP30_pratyabu-211	sthitā vedavidaḥ puṃsi avyakte pāñcarātrikāḥ //	sthitāḥ vedavidaḥ puṃsi avyakte pāñcarātrikāḥ 
SA_GSP30_pratyabu-212	ityādinā nirūpitam /	ityādinā nirūpitam 
SA_GSP30_pratyabu-213	viśvottīrṇam ātmatattvam iti tāntrikāḥ /	viśva uttīrṇam ātma tattvam iti tāntrikāḥ 
SA_GSP30_pratyabu-214	viśvamayam iti	viśva mayam iti 
SA_GSP30_pratyabu-215	kulādyāmnāyaniviṣṭāḥ /	kula ādi āmnāya niviṣṭāḥ 
SA_GSP30_pratyabu-216	viśvottīrṇaṃ viśvamayaṃ ca iti	viśva uttīrṇam viśva mayam ca iti 
SA_GSP30_pratyabu-217	trikādidarśanavidaḥ /	trika ādi darśana vidaḥ 
SA_GSP30_pratyabu-218	evaṃ ekasyaiva cidātmano bhagavataḥ	evam ekasya eva cit ātmanaḥ bhagavataḥ 
SA_GSP30_pratyabu-219	svātantryāvabhāsitāḥ sarvā imā bhūmikāḥ	svātantrya avabhāsitāḥ sarvāḥ imāḥ bhūmikāḥ 
SA_GSP30_pratyabu-220	svātantryapracchādanonmīlanatāratamyabheditāḥ / ata eka eva	svātantrya pracchādana unmīlana tāratamya bheditāḥ atas eke eva 
SA_GSP30_pratyabu-221	etāvadvyāptikātmā /	etāvat vyāptika ātmā 
SA_GSP30_pratyabu-222	mitadṛṣṭayas tu aṃśāṃśikāsu tadicchayaiva	mita dṛṣṭayaḥ tu aṃśa aṃśikāsu tad icchayā eva 
SA_GSP30_pratyabu-223	abhimānaṃ grāhitāḥ yena dehādiṣu bhūmiṣu	abhimānam grāhitāḥ yena deha ādiṣu bhūmiṣu 
SA_GSP30_pratyabu-224	pūrvapūrvapramātṛvyāptisāratāprathāyām api uktarūpāṃ	             api      
SA_GSP30_pratyabu-225	mahāvyaptiṃ paraśaktipātaṃ vinā na labhante /	mahāvyaptim para śaktipātam vinā na labhante 
SA_GSP30_pratyabu-226	vaiṣṇavādyās tu ye kecit vidyārāgeṇa rañjitāḥ /	vaiṣṇava ādyāḥ tu ye kecid vidyā rāgeṇa rañjitāḥ 
SA_GSP30_pratyabu-227	na vidanti paraṃ devaṃ sarvajñaṃ jñānaśālinam // iti /	na vidanti param devam sarvajñam jñāna śālinam iti 
SA_GSP30_pratyabu-228	bhramayaty eva tān māyā hy amokṣe mokṣalipsayā [8] / iti /	bhramayati eva tān māyā hi amokṣe mokṣa lipsayā iti 
SA_GSP30_pratyabu-229	ta ātmopāsakāḥ śaivaṃ na gacchanti paraṃ padam [9] / iti ca /	te ātma upāsakāḥ śaivam na gacchanti param padam          
SA_GSP30_pratyabu-230	api ca sarveṣāṃ darśanānāṃ samastānāṃ nīlasukhādijñānānāṃ yāḥ	api ca sarveṣām darśanānām samastānām nīla sukha ādi jñānānām yāḥ 
SA_GSP30_pratyabu-231	sthitayaḥ antarmukharūpā viśrāntayaḥ tāḥ tadbhūmikāḥ	sthitayaḥ antar mukha rūpāḥ viśrāntayaḥ tāḥ tad bhūmikāḥ 
SA_GSP30_pratyabu-232	cidānandaghanasvātmasvarūpābhivyaktyupāyāḥ /	                    
SA_GSP30_pratyabu-233	tathā hi yadā yadā bahirmukhaṃ rūpaṃ svarūpe viśrāmyati	tathā hi yadā yadā bahirmukham rūpam sva rūpe viśrāmyati 
SA_GSP30_pratyabu-234	tadā tadā bāhyavastūpasaṃhāraḥ antaḥpraśāntapadāvasthitiḥ	tadā tadā bāhya vastu upasaṃhāraḥ antar praśānta pada avasthitiḥ 
SA_GSP30_pratyabu-235	tattadudeṣyatsaṃvitsantatyāsūtraṇaṃ iti sṛṣṭisthitisaṃhāramelanarūp= ā	iti sṛṣṭi sthiti saṃhāra melana rūp ā 
SA_GSP30_pratyabu-236	iyaṃ turīyā saṃvidbhaṭṭārikā tattatsṛṣṭyādibhedān udvamantī	iyam turīyā saṃvid bhaṭṭārikā tat tat sṛṣṭi ādi bhedān udvamantī 
SA_GSP30_pratyabu-237	saṃharantī ca sadā pūrṇā ca kṛśā ca ubhayarūpā ca anubhayātmā ca akrama= m	saṃharantī ca sadā pūrṇā ca kṛśā ca ubhaya rūpā ca anubhaya ātmā ca akrama mad 
SA_GSP30_pratyabu-238	eva sphurantī sthitā /	eva sphurantī sthitā 
SA_GSP30_pratyabu-239	uktaṃ ca śrīpratyabhijñāṭīkāyāṃ	uktam ca śrī pratyabhijñā ṭīkāyām 
SA_GSP30_pratyabu-240	tāvad arthāvalehena uttiṣṭhati pūrṇā ca bhavati / iti /	tāvat artha avalehena uttiṣṭhati pūrṇā ca bhavati iti 
SA_GSP30_pratyabu-241	eṣā ca bhaṭṭārikā kramāt kramaṃ adhikam anuśīlyamānā svātmasātkaroty	eṣā ca bhaṭṭārikā kramāt kramam adhikam anuśīlyamānā svātmasātkaroti 
SA_GSP30_pratyabu-242	eva bhaktajanam //	eva bhakta janam 
SA_GSP30_pratyabu-243	yadi evaṃbhūtasya ātmano vibhūtiḥ tat kathaṃ ayaṃ malāvṛto 'ṇuḥ	yadi evaṃbhūtasya ātmanaḥ vibhūtiḥ tat katham ayam mala āvṛtaḥ ṇuḥ 
SA_GSP30_pratyabu-244	kalādivalitaḥ saṃsārī abhidhīyate ityāha	kalā ādi valitaḥ saṃsārī abhidhīyate iti āha 
SA_GSP30_pratyabu-245	cidvat tac chaktisaṃkocāt malāvṛtaḥ saṃsārī // 9 //	cit vat tad śakti saṃkocāt mala āvṛtaḥ saṃsārī 
SA_GSP30_pratyabu-246	yadā cidātmā parameśvaraḥ svasvātantryāt abhedavyāptiṃ nimajjya	yadā cit ātmā parameśvaraḥ sva svātantryāt abheda vyāptim nimajjya 
SA_GSP30_pratyabu-247	bhedavyāptim avalambate tadā tadīyā icchādiśaktayaḥ asaṃkucitā api	bheda vyāptim avalambate tadā tadīyāḥ icchā ādi śaktayaḥ asaṃkucitāḥ api 
SA_GSP30_pratyabu-248	saṃkocavatyo bhānti /	saṃkocavatyaḥ bhānti 
SA_GSP30_pratyabu-249	tadānīm eva ayaṃ malāvṛtaḥ saṃsārī bhavati /	tadānīm eva ayam mala āvṛtaḥ saṃsārī bhavati 
SA_GSP30_pratyabu-250	tathā ca apratihatasvātantryarūpā icchāśaktiḥ saṃkucitā satī	tathā ca apratihata svātantrya rūpā icchāśaktiḥ saṃkucitā satī 
SA_GSP30_pratyabu-251	apūrṇamanyatārūpaṃ [10] āṇavaṃ malam /	āṇavam malam 
SA_GSP30_pratyabu-252	jñānaśaktiḥ krameṇa saṃkocāt	jñānaśaktiḥ krameṇa saṃkocāt 
SA_GSP30_pratyabu-253	bhede sarvajñatvasya kiṃcijjñatvāpteḥ	bhede sarvajñatvasya kiṃcijjñatva āpteḥ 
SA_GSP30_pratyabu-254	antaḥkaraṇabuddhīndriyatāpattipūrvaṃ atyantasaṃkocagrahaṇena [11]	antaḥkaraṇa buddhīndriya tā āpatti pūrvam atyanta saṃkoca grahaṇena 
SA_GSP30_pratyabu-255	bhinnavedyaprathārūpaṃ māyīyaṃ malam /	bhinna vedya prathā rūpam māyīyam malam 
SA_GSP30_pratyabu-256	kriyāśaktiḥ krameṇa bhede sarvakartṛtvasya kiṃcitkartṛtvāpteḥ	kriyāśaktiḥ krameṇa bhede sarva kartṛ tvasya kiṃcitkartṛtva āpteḥ 
SA_GSP30_pratyabu-257	karmendriyarūpasaṃkocagrahaṇapūrvaṃ atyantaparimitatāṃ [12] prāptā	karmendriya rūpa saṃkoca grahaṇa pūrvam atyanta parimita tām prāptā 
SA_GSP30_pratyabu-258	śubhāśubhānuṣṭānamayaṃ kārmaṃ malam /	śubha aśubha anuṣṭāna mayam kārmam malam 
SA_GSP30_pratyabu-259	tathā sarvakartṛtvasarvajñatvapūrṇatvanityatvavyāpakatvaśaktayaḥ	tathā sarva kartṛ tva sarvajña tva pūrṇa tva nitya tva vyāpaka tva śaktayaḥ 
SA_GSP30_pratyabu-260	saṃkocaṃ gṛhṇānā yathākramaṃ kalāvidyārāgakālaniyatirūpatayā bhānti /	saṃkocam gṛhṇānāḥ yathākramam kalā vidyā rāga kāla niyati rūpa tayā bhānti 
SA_GSP30_pratyabu-261	tathāvidhaś ca ayaṃ śaktidaridraḥ saṃsārī ucyate /	tathāvidhaḥ ca ayam śakti daridraḥ saṃsārī ucyate 
SA_GSP30_pratyabu-262	svaśaktivikāse tu	sva śakti vikāse tu 
SA_GSP30_pratyabu-263	śiva eva //	śivaḥ eva 
SA_GSP30_pratyabu-264	nanu saṃsāryavasthāyām asya kiṃcit śivatocitaṃ abhijñānam asti yena	nanu saṃsāri avasthāyām asya kiṃcid śiva tā ucitam abhijñānam asti yena 
SA_GSP30_pratyabu-265	śiva eva tathāvasthita ity udghoṣyate astītyāha	śivaḥ eva tathā avasthitaḥ iti udghoṣyate asti iti āha 
SA_GSP30_pratyabu-266	tathāpi tadvat pañcakṛtyāni karoti // 10 //	tathā api tadvat pañcakṛtyāni karoti 
SA_GSP30_pratyabu-267	iha īśvarādvayadarśanasya brahmavādibhyaḥ ayam eva viśeṣaḥ /	iha īśvara advaya darśanasya brahma vādibhyaḥ ayam eva viśeṣaḥ 
SA_GSP30_pratyabu-268	sṛṣṭisaṃhārakartāraṃ vilayasthitikārakam /	            
SA_GSP30_pratyabu-269	anugrahakaraṃ devaṃ praṇatārtivināśanam [13] // iti	anugraha karam devam praṇata ārti vināśanam iti 
SA_GSP30_pratyabu-270	śrimatsvacchandādiśāsanoktanītyā sadā pañcavidhakṛtyakāritvaṃ cidātmano	śrimat svacchanda ādi śāsana ukta nītyā sadā pañcavidha kṛtya kāri tvam cit ātmanaḥ 
SA_GSP30_pratyabu-271	bhagavataḥ /	bhagavataḥ 
SA_GSP30_pratyabu-272	yathā ca bhagavān śuddhetarādhvasphāraṇakrameṇa	yathā ca bhagavān śuddha itara adhva sphāraṇa krameṇa 
SA_GSP30_pratyabu-273	svarūpavikāsarūpāṇi sṛṣṭyādīni karoti tathā saṃkucitacicchaktyā	svarūpa vikāsa rūpāṇi sṛṣṭi ādīni karoti tathā saṃkucita cicchaktyā 
SA_GSP30_pratyabu-274	saṃsārabhūmikāyām api pañcakṛtyāni	saṃsāra bhūmikāyām api pañcakṛtyāni 
SA_GSP30_pratyabu-275	vidhatte / tathā hi	vidhatte tathā hi 
SA_GSP30_pratyabu-276	tad evaṃ vyavahāre 'pi prabhur dehādim āviśan /	tat evam vyavahāre pi prabhuḥ deha ādim āviśan 
SA_GSP30_pratyabu-277	bhāntam evāntararthaugham icchayā bhāsayed bahiḥ [14] //	            
SA_GSP30_pratyabu-278	iti pratyabhijñākārikoktārthadṛṣṭyā dehaprāṇādipadaṃ āviśan cidrūpo	iti pratyabhijñā kārikā ukta artha dṛṣṭyā deha prāṇa ādi padam āviśan cit rūpaḥ 
SA_GSP30_pratyabu-279	maheśvaro bahirmukhībhāvāvasare nīlādikam arthaṃ niyatadeśakālāditayā	                                                      
SA_GSP30_pratyabu-280	yadā ābhāsayati tadā niyatadeśakālādyābhāsāṃśe asya sraṣṭṛtā /	yadā ābhāsayati tadā niyata deśa kāla ādi ābhāsa aṃśe asya sraṣṭṛ tā 
SA_GSP30_pratyabu-281	anyadeśakālādyābhāsāṃśe asya saṃhartṛtā /	anya deśa kāla ādi ābhāsa aṃśe asya saṃhartṛ tā 
SA_GSP30_pratyabu-282	nīlādyābhāsāṃśe sthāpakatā /	          
SA_GSP30_pratyabu-283	bhedena ābhāsāṃśe vilayakāritā /	bhedena ābhāsa aṃśe vilaya kāri tā 
SA_GSP30_pratyabu-284	prakāśaikyena prakāśane anugrahītṛtā /	         
SA_GSP30_pratyabu-285	yathā ca sadā	yathā ca sadā 
SA_GSP30_pratyabu-286	pañcavidhakṛtyakāritvaṃ bhagavataḥ tathā mayā vitatya spandasandohe	pañcavidha kṛtya kāri tvam bhagavataḥ tathā mayā vitatya spanda sandohe 
SA_GSP30_pratyabu-287	nirnītam / evam idaṃ pañcavidhakṛtyakāritvaṃ ātmīyaṃ sadā	nirnītam evam idam pañcavidha kṛtya kāri tvam ātmīyam sadā 
SA_GSP30_pratyabu-288	dṛḍhapratipattyā pariśīlyamānaṃ māheśvaryaṃ unmīlayaty eva	dṛḍha pratipattyā pariśīlyamānam māheśvaryam unmīlayati eva 
SA_GSP30_pratyabu-289	bhaktibhājām /	bhakti bhājām 
SA_GSP30_pratyabu-290	ata eva ye sadā etat pariśīlayanti te svarūpavikāsamayaṃ	atas eva ye sadā etat pariśīlayanti te svarūpa vikāsa mayam 
SA_GSP30_pratyabu-291	viśvaṃ jānānā jīvanmuktā ity āmnātāḥ /	viśvam jānānāḥ jīvanmuktāḥ iti āmnātāḥ 
SA_GSP30_pratyabu-292	ye tu na tathā te sarvato	ye tu na tathā te sarvatas 
SA_GSP30_pratyabu-293	vibhinnaṃ meyajātaṃ paśyanto baddhātmanaḥ //	vibhinnam meya jātam paśyantaḥ baddha ātmanaḥ 
SA_GSP30_pratyabu-294	na ca ayam eva prakāraḥ pañcavidhakṛtyakāritve yāvad anyo 'pi kaścit	na ca ayam eva prakāraḥ pañcavidha kṛtya kāri tve yāvat kaścid 
SA_GSP30_pratyabu-295	rahasyarūpo 'stīty āha	rahasya rūpaḥ sti iti āha 
SA_GSP30_pratyabu-296	ābhāsanaraktivimarśanabījāvasthāpanavilāpanatas	ābhāsana rakti vimarśana bīja avasthāpana vilāpanataḥ 
SA_GSP30_pratyabu-297	tāni // 11 //	tāni 
SA_GSP30_pratyabu-298	pañcavidhakṛtyāni karoti iti pūrvataḥ saṃbadhyate /	pañcavidha kṛtyāni karoti iti pūrvatas saṃbadhyate 
SA_GSP30_pratyabu-299	śrīmanmahārthadṛṣṭyā dṛgādidevīprasaraṇakrameṇa yad yad ābhāti tat	                                            
SA_GSP30_pratyabu-300	tat sṛjyate /	tat sṛjyate 
SA_GSP30_pratyabu-301	tathā sṛṣṭe pade tatra yadā praśāntanimeṣaṃ kaṃcit	tathā sṛṣṭe pade tatra yadā praśānta nimeṣam kaṃcid 
SA_GSP30_pratyabu-302	kālaṃ rajyati tadā sthitidevyā tat sthapyate /	kālam rajyati tadā sthitidevyā tat sthapyate 
SA_GSP30_pratyabu-303	camatkārāparaparyāyavimarśanasamaye tu saṃhriyate /	camatkāra apara paryāya vimarśana samaye tu saṃhriyate 
SA_GSP30_pratyabu-304	yathoktaṃ śrīrāmena	yathā uktam śrī rāmena 
SA_GSP30_pratyabu-305	samādhivajreṇāpy anyair abhedyo bhedabhūdharaḥ /	samādhi vajreṇa api anyaiḥ abhedyaḥ bheda bhūdharaḥ 
SA_GSP30_pratyabu-306	parāmṛṣṭaś ca naṣṭaś ca tvadbhaktibalaśālibhiḥ // iti /	parāmṛṣṭaḥ ca naṣṭaḥ ca tvad bhakti bala śālibhiḥ iti 
SA_GSP30_pratyabu-307	yadā tu saṃhriyamāṇam api etat antaḥ vicitrāśaṅkādisaṃskāraṃ ādhatte	yadā tu saṃhriyamāṇam api etat antar vicitra āśaṅkā ādi saṃskāram ādhatte 
SA_GSP30_pratyabu-308	tadā tat punar udbhaviṣyat saṃsārabījabhāvam āpannaṃ	tadā tat punar udbhaviṣyat saṃsāra bīja bhāvam āpannam 
SA_GSP30_pratyabu-309	vilayapadamadhyāropitam /	vilaya padam adhyāropitam 
SA_GSP30_pratyabu-310	yadā punaḥ tat tathāntaḥsthāpitaṃ anyad	yadā punar tat tathā antar sthāpitam anyat 
SA_GSP30_pratyabu-311	vānubhūyamānam eva haṭhapākakrameṇālaṃgrāsayuktyā cidagnisādbhāvam	vā anubhūyamānam eva haṭha pāka krameṇa alaṃgrāsa yuktyā cit agnisāt bhāvam 
SA_GSP30_pratyabu-312	āpadyate tadā pūrṇatāpādanena anugṛhyata eva / īdṛśaṃ ca	āpadyate tadā pūrṇa tā āpādanena anugṛhyate eva īdṛśam ca 
SA_GSP30_pratyabu-313	pañcavidhakṛtyakāritvaṃ sarvasya sadā sannihitam api sadgurūpadeśaṃ vin= ā	pañcavidha kṛtya kāri tvam sarvasya sadā sannihitam api sat guru upadeśam ā 
SA_GSP30_pratyabu-314	na prakāśata iti sadgurusaparyaiva etatprathārtham anusartavyā //	na prakāśate iti sat guru saparyā eva etad prathā artham anusartavyā 
SA_GSP30_pratyabu-315	yasya punaḥ sadgurūpadeśaṃ vinā etatparijñānaṃ nāsti	yasya punar sat guru upadeśam vinā etat parijñānam na asti 
SA_GSP30_pratyabu-316	tasyāvacchāditasvasvarūpābhiḥ nijābhiḥ śaktibhiḥ vyāmohitatvaṃ	tasya avacchādita sva svarūpābhiḥ nijābhiḥ śaktibhiḥ vyāmohita tvam 
SA_GSP30_pratyabu-317	bhavatīty āha	bhavati iti āha 
SA_GSP30_pratyabu-318	tadaparijñāne svaśaktibhir vyāmohitatā	tad aparijñāne sva śaktibhiḥ vyāmohita tā 
SA_GSP30_pratyabu-319	saṃsāritvam // 12 //	saṃsāri tvam 
SA_GSP30_pratyabu-320	tasyaitasya sadā saṃbhavataḥ pañcavidhakṛtyakāritvasya aparijñāne	tasya etasya sadā saṃbhavataḥ pañcavidha kṛtya kāri tvasya a parijñāne 
SA_GSP30_pratyabu-321	śaktipātahetukasvabalonmīlanābhāvāt aprakāśane svabhiḥ śaktibhiḥ	śaktipāta hetuka sva bala unmīlana abhāvāt aprakāśane svabhiḥ śaktibhiḥ 
SA_GSP30_pratyabu-322	vyāmohitatvaṃ vividhalaukikaśāstrīyaśaṅkāśaṅkukīlitatvaṃ yat idam ev= a	vyāmohita tvam vividha laukika śāstrīya śaṅkā śaṅku kīlita tvam yat idam eva a 
SA_GSP30_pratyabu-323	saṃsāritvam /	saṃsāri tvam 
SA_GSP30_pratyabu-324	tad uktaṃ śrīsarvavīrabhaṭṭārake	                                             
SA_GSP30_pratyabu-325	ajñānāc chaṅkate lokas tataḥ sṛṣṭiś ca saṃhṛtiḥ / iti /	ajñānāt śaṅkate lokaḥ tatas sṛṣṭiḥ ca saṃhṛtiḥ iti 
SA_GSP30_pratyabu-326	mantrā varṇātmakāḥ sarve sarve varṇāḥ śivātmakāḥ / iti ca /	mantrāḥ varṇa ātmakāḥ sarve sarve varṇāḥ śiva ātmakāḥ iti ca 
SA_GSP30_pratyabu-327	tathā hi citprakāśāt avyatiriktā nityoditamahāmantrarūpā	tathā hi cit prakāśāt a vyatiriktā nitya udita mahāmantra rūpā 
SA_GSP30_pratyabu-328	pūrṇāhaṃvimarśamayī yeyaṃ parāvākchaktiḥ	pūrṇa aham vimarśa mayī yā iyam parā vāc śaktiḥ 
SA_GSP30_pratyabu-329	ādikṣāntarūpāśeṣaśakticakragarbhiṇī sā tāvat	ādi kṣānta rūpa aśeṣa śakti cakra garbhiṇī sā tāvat 
SA_GSP30_pratyabu-330	paśyantīmadhyamādikrameṇa grāhakabhūmikāṃ bhāsayati /	paśyantī madhyama ādi krameṇa grāhaka bhūmikām bhāsayati 
SA_GSP30_pratyabu-331	tatra ca parārūpatvena svarūpaṃ aprathayantī māyāpramātuḥ	tatra ca parā rūpa tvena sva rūpam a prathayantī māyā pramātuḥ 
SA_GSP30_pratyabu-332	asphuṭāsādhāraṇārthāvabhāsarūpāṃ pratikṣaṇaṃ navanavāṃ vikalpakriyā.= m	asphuṭa asādhāraṇa artha avabhāsa rūpām pratikṣaṇam nava navām vikalpa kriyā m
SA_GSP30_pratyabu-333	ullāsayati /	ullāsayati 
SA_GSP30_pratyabu-334	śuddhām api ca avikalpabhūmiṃ tadācchāditām eva darśayati /	śuddhām api ca avikalpa bhūmim tad ācchāditām eva darśayati 
SA_GSP30_pratyabu-335	tatra ca brāhmyādidevatādhiṣṭhitakakārādivicitraśaktibhiḥ vyāmohito	tatra ca brāhmī ādi devatā adhiṣṭhita kakāra ādi vicitra śaktibhiḥ 
SA_GSP30_pratyabu-336	dehaprāṇādim eva parimitaṃ avaśaṃ ātmānaṃ manyate mūḍhajanaḥ /	deha prāṇa ādim eva parimitam avaśam ātmānam manyate mūḍha janaḥ 
SA_GSP30_pratyabu-337	brāhmyādidevyaḥ paśudaśāyāṃ bhedaviṣaye sṛṣṭisthitī abhedaviṣaye c= a	brāhmī ādi devyaḥ paśu daśāyām bheda viṣaye sṛṣṭi sthitī abheda viṣaye c 
SA_GSP30_pratyabu-338	saṃhāraṃ prathayantyaḥ parimitavikalpapātratām eva saṃpādayanti /	saṃhāram prathayantyaḥ parimita vikalpa pātra tām eva saṃpādayanti 
SA_GSP30_pratyabu-339	patidaśāyāṃ tu bhede saṃhāraṃ abhede ca sargasthitī prakaṭayantyaḥ	pati daśāyām tu bhede saṃhāram abhede ca sarga sthitī prakaṭayantyaḥ 
SA_GSP30_pratyabu-340	kramāt kramaṃ vikalpanirhrāsanena śrīmadbhairavamudrānupraveśamayīṃ	kramāt kramam vikalpa nirhrāsanena śrīmat bhairava mudrā anupraveśa mayīm 
SA_GSP30_pratyabu-341	mahatīm avikalpabhūmim eva unmīlayanti /	mahatīm avikalpa bhūmim eva unmīlayanti 
SA_GSP30_pratyabu-342	sarvo mamāyaṃ vibhava ity evaṃ parijānataḥ /	sarvaḥ mama ayam vibhavaḥ iti evam parijānataḥ 
SA_GSP30_pratyabu-343	viśvātmano vikalpānāṃ prasare 'pi maheśatā [15] //	viśvātmanaḥ vikalpānām prasare maheśa tā 
SA_GSP30_pratyabu-344	ityādirūpāṃ cidānandāveśamagnāṃ śuddhavikalpaśaktim ullāsayanti /	ityādi rūpām cit ānanda āveśa magnām śuddha vikalpa śaktim ullāsayanti 
SA_GSP30_pratyabu-345	tataḥ uktanītyā svaśaktivyāmohitataiva saṃsāritvam /	tatas ukta nītyā sva śakti vyāmohita tā eva saṃsāri tvam 
SA_GSP30_pratyabu-346	kiṃ ca citiśaktir eva bhagavatī viśvavamanāt saṃsāravāmācāratvāc ca	kim ca citi śaktiḥ eva bhagavatī viśva vamanāt saṃsāra vāma ācāra tvāt ca 
SA_GSP30_pratyabu-347	vāmeśvaryākhyā satī khecarīgocarīdikcarībhūcarīrūpaiḥ aśeṣaiḥ	vāmeśvarī ākhyā satī khecarī gocarī dikcarī bhūcarī rūpaiḥ aśeṣaiḥ 
SA_GSP30_pratyabu-348	pramātrantaḥkaraṇabahiṣkaraṇabhāvasvabhāvaiḥ parisphurantī	pramātṛ antaḥkaraṇa bahiṣkaraṇa bhāva svabhāvaiḥ parisphurantī 
SA_GSP30_pratyabu-349	paśubhūmikāyāṃ śūnyapadaviśrāntā	paśu bhūmikāyām śūnya pada viśrāntā 
SA_GSP30_pratyabu-350	kiṃcitkartṛtvādyātmakakalādiśaktyātmanā khecarīcakreṇa	                                                                  
SA_GSP30_pratyabu-351	gopitapāramārthikacidgaganacarītvasvarūpeṇa cakasti /	gopita pāramārthika cit gagana carī tva svarūpeṇa cakasti 
SA_GSP30_pratyabu-352	bhedaniścayābhimānavikalpanapradhānāntaḥkaraṇadevīrūpeṇa gocarīcakrena	bheda niścaya abhimāna vikalpana pradhāna antaḥkaraṇa devī rūpeṇa gocarī cakrena 
SA_GSP30_pratyabu-353	gopitābhedaniścayādyātmakapāramārthikasvarūpeṇa prakāśate /	gopita abheda niścaya ādi ātmaka pāramārthika svarūpeṇa prakāśate 
SA_GSP30_pratyabu-354	bhedālocanādipradhānabahiṣkaraṇadevatātmanā ca dikcarīcakreṇa	bheda ālocanā ādi pradhāna bahiṣkaraṇa devatā ātmanā ca dikcarī cakreṇa 
SA_GSP30_pratyabu-355	gopitābhedaprathātmakapāramārthikasvarūpeṇa sphurati / sarvato	gopita abheda prathā ātmaka pāramārthika svarūpeṇa sphurati sarvatas 
SA_GSP30_pratyabu-356	vyavacchinnābhāsasvabhāvaprameyātmanā ca bhūcarīcakreṇa	vyavacchinna ābhāsa svabhāva prameya ātmanā ca bhūcarī cakreṇa 
SA_GSP30_pratyabu-357	gopitasārvātmyasvarūpeṇa paśuhṛdayavyāmohinā	gopita sārvātmya svarūpeṇa paśu hṛdaya vyāmohinā 
SA_GSP30_pratyabu-358	bhāti / patibhūmikāyāṃ tu sarvakartṛtvādiśaktyātmakacidgaganacarītvena	bhāti pati bhūmikāyām tu sarva kartṛ tva ādi śakti ātmaka cit gagana carī tvena 
SA_GSP30_pratyabu-359	abhedaniścayādyātmanā gocarītvena abhedālocanādyātmanā dikcarītvena	                           
SA_GSP30_pratyabu-360	svāṅgakalpādvayaprathāsāraprameyātmanā ca bhūcarītvena patihṛdayavikāsinā	sva aṅga kalpa advaya prathā sāra prameya ātmanā ca bhūcarī tvena pati hṛdaya vikāsinā 
SA_GSP30_pratyabu-361	sphurati / tathā coktaṃ sahajacamatkāraparijanitākṛtakādareṇa	sphurati tathā ca uktam sahaja camatkāra parijanita akṛtaka ādareṇa 
SA_GSP30_pratyabu-362	bhaṭṭadāmodareṇa vimuktakeṣu	bhaṭṭa dāmodareṇa vimuktakeṣu 
SA_GSP30_pratyabu-363	pūrṇāvacchinnamātrāntarbahiṣkaraṇabhāvagāḥ /	pūrṇa avacchinna mātra antar bahiṣkaraṇa bhāva gāḥ 
SA_GSP30_pratyabu-364	vāmeśādyāḥ parijñānājñānāt syur muktibandhadāḥ // iti /	vāma īśa ādyāḥ parijñāna ajñānāt syuḥ mukti bandha dāḥ iti 
SA_GSP30_pratyabu-365	evaṃ ca nijaśaktivyāmohitataiva saṃsaritvam /	evam ca nija śakti vyāmohita tā eva saṃsari tvam 
SA_GSP30_pratyabu-366	api ca cidātmanaḥ	api ca cit ātmanaḥ 
SA_GSP30_pratyabu-367	parameśvarasya svā anapāyinī ekaiva sphurattāsārakartṛtātmā	parameśvarasya svā anapāyinī ekā eva sphurat tā sāra kartṛ tā ātmā 
SA_GSP30_pratyabu-368	aiśvaryaśaktiḥ /	aiśvarya śaktiḥ 
SA_GSP30_pratyabu-369	sā yadā svarūpaṃ gopayitvā pāśave pade	sā yadā sva rūpam gopayitvā pāśave pade 
SA_GSP30_pratyabu-370	prāṇāpānasamānaśaktidaśābhiḥ jāgratsvapnasuṣuptabhūmibhiḥ	                                                                                      
SA_GSP30_pratyabu-371	dehaprāṇapuryaṣṭakakalābhiś ca vyāmohayati tadā tadvyāmohitatā	deha prāṇa puryaṣṭaka kalābhiḥ ca vyāmohayati tadā tad vyāmohita tā 
SA_GSP30_pratyabu-372	saṃsāritvam /	saṃsāri tvam 
SA_GSP30_pratyabu-373	yadā tu madhyadhāmollāsāṃ udānaśaktiṃ viśvavyāptisārāṃ	yadā tu madhya dhāma ullāsām udāna śaktim viśva vyāpti sārām 
SA_GSP30_pratyabu-374	ca vyānaśaktiṃ turyadaśārūpāṃ turyātītadaśārūpāṃ ca cidānandaghanāṃ	ca vyāna śaktim turya daśā rūpām turyātīta daśā rūpām ca cit ānanda ghanām 
SA_GSP30_pratyabu-375	unmīlayati tadā dehādyavasthāyām api patidaśātmā jīvanmuktir bhavati /	unmīlayati tadā deha ādi avasthāyām api pati daśā ātmā jīvanmuktiḥ bhavati 
SA_GSP30_pratyabu-376	evaṃ tridhā svaśaktivyāmohitatā vyākhyātā /	evam tridhā sva śakti vyāmohita tā vyākhyātā 
SA_GSP30_pratyabu-377	cidvat iti sūtre [16] citprakāśo gṛhītasaṃkocaḥ saṃsārī ity uktam / ih= a	cit vat iti sūtre cit prakāśaḥ gṛhīta saṃkocaḥ saṃsārī iti uktam iha 
SA_GSP30_pratyabu-378	tu svaśaktivyāmohitatvena asya saṃsāritvaṃ bhavati iti bhaṅgyantareṇa	tu sva śakti vyāmohita tvena asya saṃsāri tvam bhavati iti bhaṅgī antareṇa 
SA_GSP30_pratyabu-379	uktam / evaṃ saṃkucitaśaktiḥ prāṇādimān api yadā svaśaktivyāmohito na	uktam evam saṃkucita śaktiḥ prāṇa ādimān api yadā sva śakti vyāmohitaḥ na 
SA_GSP30_pratyabu-380	bhavati tadā ayaṃ śarīrī parameśvaraḥ ity āmnāyasthityā	bhavati tadā ayam śarīrī parameśvaraḥ iti āmnāya sthityā 
SA_GSP30_pratyabu-381	śivabhaṭṭāraka eva iti bhaṅgyā nirūpitaṃ bhavati /	śiva bhaṭṭārakaḥ eva iti bhaṅgyā nirūpitam bhavati 
SA_GSP30_pratyabu-382	manuṣyadeham āsthāya channās te parameśvarāḥ / iti /	manuṣya deham āsthāya channāḥ te parameśvarāḥ iti 
SA_GSP30_pratyabu-383	uktam ca pratyabhijñāṭīkāyāṃ “śarīram eva ghaṭādy api vā ye	uktam ca pratyabhijñā ṭīkāyām śarīram eva ghaṭa ādi api vā ye 
SA_GSP30_pratyabu-384	ṣaṭtriṃśattattvamayaṃ śivarūpatayāpaśyanti te 'pi sidhyanti” iti //	ṣaṭtriṃśat tattva mayam śiva rūpa tayā paśyanti te sidhyanti iti 
SA_GSP30_pratyabu-385	uktasūtrārthaprātipakṣyeṇa tattvadṛṣṭiṃ darśayitum āha	ukta sūtra artha prātipakṣyeṇa tattva dṛṣṭim darśayitum āha 
SA_GSP30_pratyabu-386	tatparijñāne cittam eva antarmukhībhāvena	tad parijñāne cittam eva antar mukhībhāvena 
SA_GSP30_pratyabu-387	cetanapadādhyārohāt citiḥ // 13 //	cetana pada adhyārohāt citiḥ 
SA_GSP30_pratyabu-388	pūrvasūtravyākhyāprasaṅgena prameyadṛṣṭyā vitatya vyākhyātaprāyam etat	pūrva sūtra vyākhyā prasaṅgena prameya dṛṣṭyā vitatya vyākhyāta prāyam etat 
SA_GSP30_pratyabu-389	sūtram / śabdasaṃgatyā tu adhunā vyākhyāyate /	sūtram śabda saṃgatyā tu adhunā vyākhyāyate 
SA_GSP30_pratyabu-390	tasyātmīyasya	tasya ātmīyasya 
SA_GSP30_pratyabu-391	pañcakṛtyakāritvasya parijñāne sati aparijñānalakṣaṇakāraṇāpagamāt	pañcakṛtya kāri tvasya parijñāne sati aparijñāna lakṣaṇa kāraṇa apagamāt 
SA_GSP30_pratyabu-392	svaśaktivyāmohitatānivṛttau svātantryalabhāt prāk vyākhyātaṃ yat cittaṃ	sva śakti vyāmohita tā nivṛttau svātantrya labhāt prāk vyākhyātam yat cittam 
SA_GSP30_pratyabu-393	tad eva saṃkocinīṃ bahirmukhatāṃ jahat antarmukhībhāvena	tat eva saṃkocinīm bahirmukha tām jahat antarmukhībhāvena 
SA_GSP30_pratyabu-394	cetanapadādhyārohāt grāhakabhūmikākramaṇakrameṇa saṃkocakalāyā api	cetana pada adhyārohāt grāhaka bhūmikā kramaṇa krameṇa saṃkoca kalāyāḥ api 
SA_GSP30_pratyabu-395	vigalanena svarūpāpattyā citir bhavati /	vigalanena sva rūpa āpattyā citiḥ bhavati 
SA_GSP30_pratyabu-396	svāṃ cinmayīṃ parāṃ bhūmim	svām cit mayīm parām bhūmim 
SA_GSP30_pratyabu-397	āviśatīty arthaḥ //	āviśati iti arthaḥ 
SA_GSP30_pratyabu-398	nanu yadi pāramārthikaṃ cicchaktipadaṃ sakalabhedakavalanasvabhāvaṃ [17]	nanu yadi pāramārthikam cicchakti padam sakala bheda kavalana svabhāvam 
SA_GSP30_pratyabu-399	tad asya māyāpade 'pi tathārūpeṇa bhavitavyaṃ yathā jaladācchāditasyāpi	tat asya māyā pade tathārūpeṇa bhavitavyam yathā jalada ācchāditasya api 
SA_GSP30_pratyabu-400	bhānoḥ bhāvāvabhāsakatvaṃ ity āśaṅkyāha	bhānoḥ bhāva avabhāsaka tvam iti āśaṅkya āha 
SA_GSP30_pratyabu-401	citivahnir arohapade channo 'pi mātrayā	citi vahniḥ a roha pade channaḥ u pi mātrayā 
SA_GSP30_pratyabu-402	meyendhanaṃ pluṣyati // 14 //	meya indhanam pluṣyati  /
SA_GSP30_pratyabu-403	citir eva viśvagrasanaśīlatvāt vahniḥ /	citiḥ eva viśvak rasana śīla tvāt vahniḥ 
SA_GSP30_pratyabu-404	asau eva avarohapade	asau eva avarohapade 
SA_GSP30_pratyabu-405	māyāpramātṛtāyāṃ channo 'pi svātantryāt ācchāditasvabhāvo 'pi	māyā pramātṛ tāyām channaḥ u pi svātantryāt ācchādita svabhāvaḥ u pi 
SA_GSP30_pratyabu-406	bhūribhūtichannāgnivat mātrayā aṃśena nīlapītādiprameyendhanaṃ pluṣyati	bhūri bhūti channa agni vat mātrayā aṃśena nīla pīta ādi prameya indhanam pluṣyati 
SA_GSP30_pratyabu-407	svātmasātkaroti /	svātmasātkaroti 
SA_GSP30_pratyabu-408	mātrāpadasyedam ākūtaṃ yat kavalayann api sārvātmyena na	mātrā padasya idam ākūtam yat kavalayan api sārvātmyena na 
SA_GSP30_pratyabu-409	grasate api tu aṃśena saṃskārātmanā utthāpayati /	grasate api tu aṃśena saṃskāra ātmanā utthāpayati 
SA_GSP30_pratyabu-410	grāsakatvaṃ ca sarvapramātṝṇāṃ svānubhavata eva siddham / yad uktaṃ	grāsaka tvam ca sarva pramātṝṇām sva anubhavataḥ eva siddham yat uktam 
SA_GSP30_pratyabu-411	śrīmadutpaladevapādaiḥ nijastotreṣu	                 
SA_GSP30_pratyabu-412	vartante jantavo 'śeṣā api brahmendraviṣṇavaḥ /	vartante śeṣāḥ api brahma indra viṣṇavaḥ 
SA_GSP30_pratyabu-413	grasamānās tato vande deva viśvaṃ bhavanmayam [18] // iti //	grasamānāḥ tatas vande deva viśvam bhavat mayam iti 
SA_GSP30_pratyabu-414	yadā punaḥ karaṇeśvarīprasarasaṃkocaṃ saṃpādya	yadā punar karaṇa īśvarī prasara saṃkocam saṃpādya 
SA_GSP30_pratyabu-415	sargasaṃhārakramapariśīlanayuktiṃ āviśati tadā	sarga saṃhāra krama pariśīlana yuktim āviśati tadā 
SA_GSP30_pratyabu-416	balalābhe viśvam ātmasātkaroti // 15 //	bala lābhe viśvam ātmasātkaroti  /
SA_GSP30_pratyabu-417	citir eva dehaprāṇādyācchādananimajjanena svarūpaṃ unmagnatvena	citiḥ eva deha prāṇa ādi ācchādana nimajjanena svarūpam unmagna tvena 
SA_GSP30_pratyabu-418	sphārayantī balam / yathoktam	sphārayantī balam yathā uktam 
SA_GSP30_pratyabu-419	tadākramya balaṃ mantrāḥ ... ... [19] / iti /	tat ākramya balam mantrāḥ        
SA_GSP30_pratyabu-420	evaṃ ca balalābhe unmagnasvarūpāśrayaṇe kṣityādisadāśivāntaṃ viśvaṃ	evam ca bala lābhe unmagna sva rūpa āśrayaṇe kṣiti ādi sadāśiva antam viśvam 
SA_GSP30_pratyabu-421	ātmasātkaroti svasvarūpābhedena nirbhāsayati /	ātmasātkaroti sva svarūpa abhedena nirbhāsayati 
SA_GSP30_pratyabu-422	tad uktaṃ pūrvagurubhiḥ svabhāṣāmayeṣu kramasūtreṣu	tat uktam pūrva gurubhiḥ sva bhāṣā mayeṣu kramasūtreṣu 
SA_GSP30_pratyabu-423	yathā vahnir udbodhito dāhyaṃ dahati tathā viṣayapāśān bhakṣayet / iti = /	yathā vahniḥ udbodhitaḥ dāhyam dahati tathā viṣaya pāśān bhakṣayet iti 
SA_GSP30_pratyabu-424	na caivaṃ vaktavyam =AD viśvātmasātkārarūpā samāveśabhūḥ kādācitkī /	na ca evam vaktavyam viśva ātmasātkāra rūpā samāveśa bhūḥ kādācitkī 
SA_GSP30_pratyabu-425	kathaṃ upādeyā iyaṃ syād iti yato dehādyunmajjananimajjanavaśena iyaṃ	katham upādeyā iyam syāt iti yatas deha ādi unmajjana nimajjana vaśena iyam 
SA_GSP30_pratyabu-426	asyāḥ kādācitkatvam iva ābhāti /	asyāḥ kādācitkatvam iva ābhāti 
SA_GSP30_pratyabu-427	vastutas tu	vastutas tu 
SA_GSP30_pratyabu-428	citisvātantryāvabhāsitadehādyunmajjanād eva kādācitkatvam /	                      
SA_GSP30_pratyabu-429	eṣā tu sadaiva prakāśamānā /	eṣā tu sadā eva prakāśamānā 
SA_GSP30_pratyabu-430	anyathā tad dehādy api na prakāśeta /	anyathā tat deha ādi api na prakāśeta 
SA_GSP30_pratyabu-431	ata eva dehādipramātṛtābhimānanimajjanāya abhyāsaḥ / na tu	atas eva deha ādi pramātṛ tā abhimāna nimajjanāya abhyāsaḥ na tu 
SA_GSP30_pratyabu-432	sadāprathamānatāsārapramātṛtāprāptyarthaṃ iti śrīpratyabhijñākārāḥ //	iti śrī pratyabhijñā kārāḥ 
SA_GSP30_pratyabu-433	evaṃ ca	evam ca 
SA_GSP30_pratyabu-434	cidānandalābhe dehādiṣu cetyamāneṣv api	                   
SA_GSP30_pratyabu-435	cidaikātmyapratipattidārḍhyaṃ jīvanmuktiḥ // 16 //	        
SA_GSP30_pratyabu-436	viśvātmasātkārātmani samāveśarūpe cidānande labdhe vyutthānadaśāyāṃ	                  
SA_GSP30_pratyabu-437	dalakalpatayā dehaprāṇanīlasukhādiṣu ābhāsamāneṣv api yat	dala kalpa tayā deha prāṇa nīla sukha ādiṣu ābhāsamāneṣu api yat 
SA_GSP30_pratyabu-438	samāveśasaṃskārabalāt pratipādayiṣyamāṇayuktikramopabṛṃhitāt	                               
SA_GSP30_pratyabu-439	cidaikātmyapratipattidārḍhyam /	cit aikātmya pratipatti dārḍhyam 
SA_GSP30_pratyabu-440	avicalā cidekatvaprathā saiva jīvanmuktiḥ jīvataḥ prāṇān api dhārayato	avicalā cit eka tva prathā sā eva jīvanmuktiḥ jīvataḥ prāṇān api 
SA_GSP30_pratyabu-441	muktiḥ pratyabhijñātanijasvarūpavidrāvitāśeṣapāśarāśitvāt /	                      
SA_GSP30_pratyabu-442	yathoktaṃ spandaśāstre	yathā uktam spandaśāstre 
SA_GSP30_pratyabu-443	iti vā yasya saṃvittiḥ krīḍātvenākhilaṃ jagat /	iti vā yasya saṃvittiḥ krīḍā tvena akhilam jagat 
SA_GSP30_pratyabu-444	sa paśyan satataṃ yukto jīvanmukto na saṃśayaḥ [20] // iti //	sa paśyan satatam yuktaḥ jīvanmuktaḥ na saṃśayaḥ iti 
SA_GSP30_pratyabu-445	atha kathaṃ cidānandalābho bhavati ity āha	atha katham cidānanda lābhaḥ bhavati iti āha 
SA_GSP30_pratyabu-446	madhyavikāsāc cidānandalābhaḥ // 17 //	         
SA_GSP30_pratyabu-447	sarvāntaratamatvena vartamānatvāt tadbhittilagnatāṃ vinā ca kasyacid api	sarva antaratama tvena vartamāna tvāt tad bhitti lagna tām vinā ca kasyacid api 
SA_GSP30_pratyabu-448	svarūpānupapatteḥ saṃvid eva bhagavatī madhyam /	svarūpa anupapatteḥ saṃvid eva bhagavatī madhyam 
SA_GSP30_pratyabu-449	sā tu māyādaśāyāṃ	sā tu māyā daśāyām 
SA_GSP30_pratyabu-450	tathābhūtāpi svarūpaṃ gūhayitvā “prāk saṃvit prāṇe pariṇatā ” iti nītyā	tathābhūtā api sva rūpam gūhayitvā prāk saṃvid prāṇe pariṇatā iti nītyā 
SA_GSP30_pratyabu-451	prāṇaśaktibhūmiṃ svīkṛtya avarohakrameṇa buddhidehādibhuvaṃ	prāṇa śakti bhūmim svīkṛtya avaroha krameṇa buddhi deha ādi bhuvam 
SA_GSP30_pratyabu-452	adhiśayānā nāḍīsahasrasaraṇim anusṛtā /	adhiśayānā nāḍī sahasra saraṇim anusṛtā 
SA_GSP30_pratyabu-453	tatrāpi ca palāśaparṇamadhyaśākhānyāyena ābrahmarandhrāt	tatra api ca palāśa parṇa madhya śākhā nyāyena ā brahmarandhrāt 
SA_GSP30_pratyabu-454	adhovaktraparyantaṃ prāṇaśaktibrahmāśrayamadhyamanāḍīrūpatayā	adhas vaktra paryantam prāṇa śakti brahma āśraya madhyamanāḍī rūpa tayā 
SA_GSP30_pratyabu-455	prādhānyena sthitā /	prādhānyena sthitā 
SA_GSP30_pratyabu-456	tata eva sarvavṛttīnām udayāt tatraiva ca viśrāmāt /	tatas eva sarva vṛttīnām udayāt tatra eva ca viśrāmāt 
SA_GSP30_pratyabu-457	evaṃbhūtāpy eṣā paśūnāṃ nimīlitasvarūpaiva sthitā /	evaṃbhūtā api eṣā paśūnām nimīlita svarūpā eva sthitā 
SA_GSP30_pratyabu-458	yadā tu uktayuktikrameṇa sarvāntaratamatve [21] madhyabhūtā saṃvid	yadā tu ukta yukti krameṇa sarva antaratama tve madhya bhūtā saṃvid 
SA_GSP30_pratyabu-459	bhagavatī vikasati yadi vā vakṣyamāṇakrameṇa madhyabhūtā brahmanāḍī	bhagavatī vikasati yadi vā vakṣyamāṇa krameṇa madhya bhūtā brahmanāḍī 
SA_GSP30_pratyabu-460	vikasati tadā tadvikāsāc cidānandasya uktarūpasya lābhaḥ prāptiḥ bhavati = /	vikasati tadā tad vikāsāt cit ānandasya ukta rūpasya lābhaḥ prāptiḥ bhavati 
SA_GSP30_pratyabu-461	tataś ca prāg uktā jīvanmuktiḥ //	tatas ca prāk uktā jīvanmuktiḥ 
SA_GSP30_pratyabu-462	madhyavikāse yuktim āha	madhya vikāse yuktim āha 
SA_GSP30_pratyabu-463	vikalpakṣayaśaktisaṃkocavikāsavāhacchedādyantakoṭinibhālanādaya	vikalpa kṣaya śakti saṃkoca vikāsa vāha cheda ādi anta koṭi nibhālana ādaya 
SA_GSP30_pratyabu-464	iha upāyāḥ // 18 //	iha upāyāḥ 
SA_GSP30_pratyabu-465	iha madhyaśaktivikāse vikalpakṣayādaya upāyāḥ /	iha madhya śakti vikāse vikalpa kṣaya ādayaḥ upāyāḥ 
SA_GSP30_pratyabu-466	prāgupadiṣṭapañcavidhakṛtyakāritvādyanusaraṇena sarvamadhyabhūtāyāḥ	prāk upadiṣṭa pañcavidha kṛtya kāri tva ādi anusaraṇena sarva madhya bhūtāyāḥ 
SA_GSP30_pratyabu-467	saṃvido vikāso jāyata ity abhihitaprāyam /	saṃvidaḥ vikāsaḥ jāyate iti abhihita prāyam 
SA_GSP30_pratyabu-468	upāyāntaram api tu ucyate	upāya antaram api tu ucyate 
SA_GSP30_pratyabu-469	prāṇāyāmamudrābandhādisamastayantraṇātantratroṭanena sukhopāyam eva	                                                                      
SA_GSP30_pratyabu-470	hṛdaye nihitacittaḥ uktayuktyā svasthitipratibandhakaṃ vikalpaṃ	                 
SA_GSP30_pratyabu-471	akiṃciccintakatvena praśamayan avikalpaparāmarśena	a kiṃcid cintaka tvena praśamayan a vikalpa parāmarśena 
SA_GSP30_pratyabu-472	dehādyakaluṣasvacitpramātṛtānibhālanapravaṇaḥ acirād eva	                        eva 
SA_GSP30_pratyabu-473	unmiṣadvikāsāṃ turyaturyātītasamāveśadaśāṃ āsādayati /	unmiṣat vikāsām turya turya atīta samāveśa daśām āsādayati 
SA_GSP30_pratyabu-474	vikalpahānenaikāgryāt krameṇeśvaratāpadam [22] /	vikalpa hānena aikāgryāt krameṇa īśvara tā padam 
SA_GSP30_pratyabu-475	iti śrīpratyabhijñāyām /	iti śrī pratyabhijñāyām 
SA_GSP30_pratyabu-476	śrīspande 'pi=20	       
SA_GSP30_pratyabu-477	yadā kṣobhaḥ pralīyeta tadā syāt paramaṃ padam [23] / iti /	yadā kṣobhaḥ pralīyeta tadā syāt paramam padam iti 
SA_GSP30_pratyabu-478	śrījñānagarbhe 'pi	śrī jñānagarbhe pi 
SA_GSP30_pratyabu-479	vihāya sakalāḥ kriyā janani mānasīḥ sarvato	vihāya sakalāḥ kriyāḥ janani mānasīḥ sarvatas 
SA_GSP30_pratyabu-480	vimuktakaraṇakriyānusṛtipāratantryojjvalam /	vimukta karaṇa kriyā anusṛti pāratantrya ujjvalam 
SA_GSP30_pratyabu-481	sthitais tvadanubhāvataḥ sapadi vedyate sā parā	sthitaiḥ tvad anubhāvataḥ sapadi vedyate sā parā 
SA_GSP30_pratyabu-482	daśā nṛbhir atandritāsamasukhāmṛtasyandinī // iti /	daśā nṛbhiḥ atandrita asama sukha amṛta syandinī iti 
SA_GSP30_pratyabu-483	ayaṃ ca upāyo mūrdhanyatvāt pratyabhijñāyāṃ [24] pratipāditatvāt ādāv	ayam ca upāyaḥ mūrdhanya tvāt pratyabhijñāyām pratipādita tvāt ādau 
SA_GSP30_pratyabu-484	uktaḥ / śaktisaṃkocādayas tu yady api pratyabhijñāyāṃ na pratipāditāḥ	uktaḥ śakti saṃkoca ādayaḥ tu yadi api pratyabhijñāyām na pratipāditāḥ 
SA_GSP30_pratyabu-485	tathāpi āmnāyikatvāt asmābhiḥ prasaṅgāt pradarśyante / bahuṣu hi	tathā api āmnāyika tvāt asmābhiḥ prasaṅgāt pradarśyante bahuṣu hi 
SA_GSP30_pratyabu-486	pradarśiteṣu kaścit kenacit pravekṣyatīti /	pradarśiteṣu kaścid kenacid pravekṣyati iti 
SA_GSP30_pratyabu-487	śakteḥ saṃkoca	śakteḥ saṃkoca 
SA_GSP30_pratyabu-488	indriyadvāreṇa prasarantyā evākuñcanakrameṇa unmukhīkaraṇam / yathoktaṃ	indriya dvāreṇa prasarantyāḥ eva ākuñcana krameṇa unmukhīkaraṇam yathā uktam 
SA_GSP30_pratyabu-489	ātharvaṇikopaniṣatsu kaṭhavallyāṃ caturthavallīprathamamantre	ātharvaṇika upaniṣatsu kaṭhavallyām caturtha vallī prathama mantre 
SA_GSP30_pratyabu-490	parāñci khāni vyatṛṇat svayaṃbhūḥ	parāñci khāni vyatṛṇat svayaṃbhūḥ 
SA_GSP30_pratyabu-491	tasmāt parāṅ paśyati nāntarātman /	tasmāt parāṅ paśyati na antarātman 
SA_GSP30_pratyabu-492	kaścid dhīraḥ pratyag ātmānam aikṣad	kaścid dhīraḥ pratyak ātmānam aikṣat 
SA_GSP30_pratyabu-493	āvṛttacakṣur amṛtatvam aśnan [25] // iti /	āvṛtta cakṣuḥ amṛta tvam aśnan   / iti 
SA_GSP30_pratyabu-494	prasṛtāyā api vā kūrmāṅgasaṃkocavat trāsasamaye hṛtpraveśavac ca	prasṛtāyāḥ api vā kūrma aṅga saṃkoca vat trāsa samaye hṛd praveśa vat ca 
SA_GSP30_pratyabu-495	sarvato nivartanam /	sarvatas nivartanam 
SA_GSP30_pratyabu-496	yathoktaṃ “tadapoddhṛte nityoditasthitiḥ” iti /	yathā uktam tad apoddhṛte nitya udita sthitiḥ iti 
SA_GSP30_pratyabu-497	śakter vikāsaḥ antarnigūḍhāyā akramam eva sakalakaraṇacakravisphāraṇen= a	śakteḥ vikāsaḥ antar nigūḍhāyāḥ akramam eva 
SA_GSP30_pratyabu-498	“antarlakṣyo bahirdṛṣṭiḥ nimeṣonmeṣavarjitaḥ ” iti /	antar lakṣyaḥ bahis dṛṣṭiḥ nimeṣa unmeṣa varjitaḥ iti 
SA_GSP30_pratyabu-499	bhairavīyamudrānupraveśayuktyā bahiḥ prasaraṇam / yathoktaṃ	                                
SA_GSP30_pratyabu-500	sarvāḥ śaktīḥ cetasā darśanādyāḥ	sarvāḥ śaktīḥ cetasā darśanādyāḥ 
SA_GSP30_pratyabu-501	sve sve vedye yaugapadyena viṣvak /	sve sve vedye yaugapadyena 
SA_GSP30_pratyabu-502	kṣiptvā madhye hāṭakastambhabhūtaḥ	kṣiptvā madhye hāṭaka stambha bhūtaḥ 
SA_GSP30_pratyabu-503	tiṣṭan viśvādhāra eko 'vabhāsi // iti /	tiṣṭan viśva ādhāraḥ ekaḥ vabhāsi iti 
SA_GSP30_pratyabu-504	śrībhaṭṭakallaṭenāpi uktam “rūpādiṣu pariṇāmāt tatsiddhiḥ ” iti /	śrī bhaṭṭa kallaṭena api uktam rūpa ādiṣu pariṇāmāt tad siddhiḥ iti 
SA_GSP30_pratyabu-505	śakteś ca saṃkocavikāsau	śakteḥ ca saṃkoca vikāsau 
SA_GSP30_pratyabu-506	nāsāpuṭaspandanakramonmiṣatsūkṣmaprāṇaśaktyā bhrūbhedanena	                     
SA_GSP30_pratyabu-507	kramāsāditordhvakuṇḍalinīpade prasaraviśrāntidaśāpariśīlanam /	                
SA_GSP30_pratyabu-508	adhaḥkuṇḍalinyāṃ ca ṣaṣṭavaktrarūpāyāṃ praguṇīkṛtya śaktiṃ	adhas kuṇḍalinyām ca ṣaṣṭavaktra rūpāyām praguṇīkṛtya śaktim 
SA_GSP30_pratyabu-509	tanmūlatadagratanmadhyabhūmisparśāveśaḥ /	tad mūla tad agra tad madhya bhūmi sparśa āveśaḥ 
SA_GSP30_pratyabu-510	yathoktaṃ vijñānabhaṭṭārake	yathā uktam vijñānabhaṭṭārake 
SA_GSP30_pratyabu-511	vahner viṣasya madhye tu cittaṃ sukhamayaṃ kṣipet /	vahneḥ viṣasya madhye tu cittam sukha mayam kṣipet 
SA_GSP30_pratyabu-512	kevalaṃ vāyupūrṇaṃ vā smarānandena yujyate [26] // iti /	kevalam vāyu pūrṇam vā smara ānandena yujyate iti 
SA_GSP30_pratyabu-513	atra vahniḥ anupraveśakrameṇa saṃkocabhūḥ /	atra vahniḥ anupraveśa krameṇa saṃkoca bhūḥ 
SA_GSP30_pratyabu-514	viṣasthānaṃ prasarayukty= ā	viṣa sthānam prasara yuktī ā 
SA_GSP30_pratyabu-515	“viṣḷ vyāptau” ity arthānugamāt /	vyāptau iti artha anugamāt 
SA_GSP30_pratyabu-516	vāhayoḥ vāmadakṣiṇagatayoḥ	vāhayoḥ vāma dakṣiṇa gatayoḥ 
SA_GSP30_pratyabu-517	prāṇāpānayoḥ chedo hṛdayaviśrāntipuraḥsaraṃ	               
SA_GSP30_pratyabu-518	antaḥkakārahakārādiprāyānackavarṇoccāreṇa vicchedanam /	antar kakāra hakāra ādi prāya an acka varṇa uccāreṇa vicchedanam 
SA_GSP30_pratyabu-519	yathoktaṃ jñānagarbhe	yathā uktam jñānagarbhe 
SA_GSP30_pratyabu-520	anackakakṛtāyatiprasṛtapārśvanāḍīdvayacchido	an a c ka ka kṛta āyati prasṛta pārśva nāḍī dvaya chidaḥ 
SA_GSP30_pratyabu-521	vidhṛtacetaso hṛdayapaṅkajasyodare /	vidhṛta cetasaḥ hṛdaya paṅkajasya udare 
SA_GSP30_pratyabu-522	udeti tava dāritāndhatamasaḥ sa vidyāṅkuro	udeti tava dārita andha tamasaḥ sa vidyā aṅkuro 
SA_GSP30_pratyabu-523	ya eṣa parameśatāṃ janayituṃ paśor api alam // iti /	yaḥ eṣa parama īśa tām janayitum paśoḥ api alam iti 
SA_GSP30_pratyabu-524	ādikoṭiḥ hṛdayam /	ādikoṭiḥ hṛdayam 
SA_GSP30_pratyabu-525	antakoṭiḥ dvādaśāntaḥ / tayoḥ	          
SA_GSP30_pratyabu-526	prāṇollāsaviśrāntyavasare nibhālanaṃ cittaniveśanena pariśīlanam /	               
SA_GSP30_pratyabu-527	yathoktaṃ vijñānabhairave	yathā uktam vijñānabhairave 
SA_GSP30_pratyabu-528	hṛdyākāśe nilīnākṣaḥ padmasaṃpuṭamadhyagaḥ /	hṛdi ākāśe nilīna akṣaḥ padma saṃpuṭa madhya gaḥ 
SA_GSP30_pratyabu-529	ananyacetāḥ subhage paraṃ saubhāgyam āpnuyāt [27] // iti /	an anya cetāḥ subhage param saubhāgyam āpnuyāt     
SA_GSP30_pratyabu-530	yathā tathā yatra tatra dvādaśānte manaḥ kṣipet /	yathā tathā yatra tatra dvādaśānte manaḥ kṣipet 
SA_GSP30_pratyabu-531	pratikṣaṇaṃ kṣīṇavṛtteḥ vailakṣaṇyaṃ dinair bhavet [28] // iti /	pratikṣaṇam kṣīṇa vṛtteḥ vailakṣaṇyam dinaiḥ bhavet   iti 
SA_GSP30_pratyabu-532	ādipadāt unmeṣadaśāniṣevaṇam / yathoktaṃ	ādi padāt unmeṣa daśā niṣevaṇam yathoktam 
SA_GSP30_pratyabu-533	unmeṣaḥ sa tu vijñeyaḥ svayaṃ tam upalakṣayet [29] /	unmeṣaḥ sa tu vijñeyaḥ svayam tam upalakṣayet 
SA_GSP30_pratyabu-534	iti spande /	iti spande 
SA_GSP30_pratyabu-535	tathā ramaṇīyaviṣayacarvaṇādayaś ca saṃgṛhītāḥ /	tathā ramaṇīya viṣaya carvaṇā ādayaḥ ca saṃgṛhītāḥ 
SA_GSP30_pratyabu-536	yathoktaṃ śrīvijñānabhairava eva	yathā uktam śrī vijñānabhairave eva 
SA_GSP30_pratyabu-537	jagdhipānakṛtollāsarasānandavijṛmbhaṇāt /	jagdhi pāna kṛta ullāsa rasa ānanda vijṛmbhaṇāt 
SA_GSP30_pratyabu-538	bhāvayed bharitāvasthāṃ mahānandamayo bhavet //	bhāvayet bharita avasthām mahā ānanda mayaḥ bhavet 
SA_GSP30_pratyabu-539	gītādiviṣayāsvādāsamasaukhyaikatātmanaḥ /	                
SA_GSP30_pratyabu-540	yoginas tanmayatvena manorūḍhes tadātmatā //	yoginaḥ tad maya tvena manaḥ rūḍheḥ tad ātma tā 
SA_GSP30_pratyabu-541	yatra yatra manastuṣṭir manas tatraiva dhārayet /	yatra yatra manaḥ tuṣṭiḥ manaḥ tatra eva dhārayet 
SA_GSP30_pratyabu-542	tatra tatra parānandasvarūpaṃ saṃprakāśate [30] // iti /	tatra tatra parānanda sva rūpam saṃprakāśate iti 
SA_GSP30_pratyabu-543	evam anyad api ānandapūrṇasvātmabhāvanādikaṃ anumantavyam / ity	evam anyat api ānanda pūrṇa sva ātma bhāvanā ādikam anumantavyam iti 
SA_GSP30_pratyabu-544	evamādayaḥ atra madhyavikāse upāyāḥ //	evamādayaḥ atra madhya vikāse upāyāḥ 
SA_GSP30_pratyabu-545	madhyavikāsāc cidānandalābhaḥ /	          
SA_GSP30_pratyabu-546	sa eva ca paramayoginaḥ	saḥ eva ca parama yoginaḥ 
SA_GSP30_pratyabu-547	samāveśasamapattyādiparyāyaḥ samādhiḥ /	           
SA_GSP30_pratyabu-548	tasya nityoditatve yuktim āha	tasya nitya udita tve yuktim āha 
SA_GSP30_pratyabu-549	samādhisaṃskāravati vyutthāne bhūyo bhūyaḥ	samādhi saṃskāravati vyutthāne bhūyas bhūyas 
SA_GSP30_pratyabu-550	cidaikyāmarśān nityoditasamādhilābhaḥ // 19 //	            
SA_GSP30_pratyabu-551	āsāditasamāveśo yogivaro vyutthāne 'pi samādhirasasaṃskāreṇa kṣība iva	āsādita samāveśaḥ yogi varaḥ vyutthāne samādhi rasa saṃskāreṇa kṣībaḥ iva 
SA_GSP30_pratyabu-552	sānandaṃ ghūrṇamāno bhāvarāśiṃ śaradabhralavaṃ iva cidgagana eva	sa ānandam ghūrṇamānaḥ bhāva rāśim śarad abhra lavam iva cit gaganaḥ eva 
SA_GSP30_pratyabu-553	līyamānaṃ paśyan bhūyo bhūyaḥ antarmukhatāṃ eva samavalambamāno	līyamānam paśyan bhūyas bhūyas antarmukha tām eva samavalambamānaḥ 
SA_GSP30_pratyabu-554	nimīlanasamādhikrameṇa cidaikyam eva vimṛśan vyutthānābhimatāvasare 'pi	                                    
SA_GSP30_pratyabu-555	samādhyekarasa eva bhavati /	samādhi ekarasaḥ eva bhavati 
SA_GSP30_pratyabu-556	yathoktaṃ kramasūtreṣu	yathā uktam kramasūtreṣu 
SA_GSP30_pratyabu-557	“kramamudrayā antaḥsvarūpayā bahirmukhaḥ [31] samāviṣṭo bhavati	                bhavati 
SA_GSP30_pratyabu-558	sādhakaḥ /	sādhakaḥ 
SA_GSP30_pratyabu-559	tatrādau bāhyāt antaḥpraveśaḥ ābhyantarāt bāhyasvarūpe praveśaḥ	tatra ādau bāhyāt antar praveśaḥ ābhyantarāt bāhya svarūpe praveśaḥ 
SA_GSP30_pratyabu-560	āveśavaśāt jāyate iti sabāhyābhyantaro 'yaṃ mudrākramaḥ ” iti /	āveśa vaśāt jāyate iti sa bāhya abhyantaraḥ yam mudrā kramaḥ iti 
SA_GSP30_pratyabu-561	atrāyam arthaḥ sṛṣṭisthitisaṃhṛtisaṃviccakrātmakaṃ kramaṃ mudrayat= i	atra ayam arthaḥ sṛṣṭi sthiti saṃhṛti saṃvid cakra ātmakam kramam mudrayat i 
SA_GSP30_pratyabu-562	svādhiṣṭhitaṃ ātmasātkaroti yeyaṃ turīyā citiśaktiḥ tayā kramamudrayā	svādhiṣṭhitam ātmasātkaroti yā iyam turīyā citiśaktiḥ tayā krama mudrayā 
SA_GSP30_pratyabu-563	antar iti pūrṇāhantāsvarūpayā [32] bahirmukha iti viṣayeṣu vyāpṛto 'pi	antar iti bahirmukhaḥ iti viṣayeṣu 
SA_GSP30_pratyabu-564	samāviṣṭaḥ sākṣātkṛtaparaśaktisphāraḥ sādhakaḥ paramayogī bhavati /	samāviṣṭaḥ sākṣātkṛta para śakti sphāraḥ sādhakaḥ parama yogī bhavati 
SA_GSP30_pratyabu-565	tatra ca bāhyāt grasyamānāt viṣayagrāmāt antaḥ parasyāṃ citibhūmau	tatra ca bāhyāt grasyamānāt viṣaya grāmāt antar parasyām citi bhūmau 
SA_GSP30_pratyabu-566	grasanakrameṇaiva praveśaḥ samāveśo bhavati /	grasana krameṇa eva praveśaḥ samāveśaḥ bhavati 
SA_GSP30_pratyabu-567	ābhyantarāt	ābhyantarāt 
SA_GSP30_pratyabu-568	citiśaktisvarūpāt ca sākṣātkṛtāt āveśavaśāt samāveśasāmarthyād eva	citi śakti svarūpāt ca sākṣātkṛtāt āveśa vaśāt samāveśa sāmarthyāt eva 
SA_GSP30_pratyabu-569	bāhyasvarūpe idantānirbhāse viṣayagrāme vamanayuktyā praveśaḥ	                 
SA_GSP30_pratyabu-570	cidrasāśyānatāprathanātmā samāveśo jāyate iti	                     jāyate iti 
SA_GSP30_pratyabu-571	sabāhyābhyantaro 'yaṃ nityoditasamāveśātmā mudo harṣasya vitaraṇāt	sa bāhya abhyantaraḥ yam nitya udita samāveśa ātmā mudaḥ harṣasya vitaraṇāt 
SA_GSP30_pratyabu-572	paramānandasvarūpatvāt pāśadrāvaṇāt viśvasya antaḥturīyasattāyāṃ	                                         
SA_GSP30_pratyabu-573	mudraṇāt ca mudrātmā kramo 'pi sṛṣṭyādikramābhāsakatvāt	mudraṇāt ca mudrā ātmā sṛṣṭi ādi krama ābhāsaka tvāt 
SA_GSP30_pratyabu-574	tatkramābhāsarūpatvāt ca krama iti abhidhīyata iti //	tad krama ābhāsa rūpa tvāt ca kramaḥ iti abhidhīyate iti 
SA_GSP30_pratyabu-575	idānīm asya samādhilābhasya phalam āha	idānīm asya samādhi lābhasya phalam āha 
SA_GSP30_pratyabu-576	tadā prakāśānandasāramahāmantravīryātmakapūrṇāhantāveśāt sadā	tadā prakāśa ānanda sāra mahāmantra vīrya ātmaka pūrṇa ahantā āveśāt sadā 
SA_GSP30_pratyabu-577	sarvasargasaṃhārakārinijasaṃviddevatācakreśvaratāpraptir	                                                                            
SA_GSP30_pratyabu-578	bhavatīti śivam // 20 //	bhavati iti śivam 
SA_GSP30_pratyabu-579	nityodite samādhau labdhe sati prakāśānandasārā cidāhlādaikaghanā [33]	                       
SA_GSP30_pratyabu-580	mahatī mantravīryātmikā sarvamantrajīvitabhūtā pūrṇā parābhaṭṭārikārūpā	mahatī mantra vīrya ātmikā sarva mantra jīvita bhūtā pūrṇā parā bhaṭṭārikā rūpā 
SA_GSP30_pratyabu-581	yeyaṃ ahantā akṛtrimaḥ svātmacamatkāraḥ tatra āveśāt sadā kālāgnyādeḥ	yā iyam ahantā akṛtrimaḥ svātma camatkāraḥ tatra āveśāt sadā kālāgni ādeḥ 
SA_GSP30_pratyabu-582	caramakalāparyantasya viśvasya yau sargasaṃhārau vicitrau sṛṣṭipralaya= u	carama kalā paryantasya viśvasya yau sarga saṃhārau vicitrau sṛṣṭi pralaye u 
SA_GSP30_pratyabu-583	tatkāri yat nijaṃ saṃviddevatācakraṃ tadaiśvaryasya prāptiḥ āsādanaṃ	tad kāri yat nijam saṃvid devatā cakram tad aiśvaryasya prāptiḥ āsādanam 
SA_GSP30_pratyabu-584	bhavati / prākaraṇikasya paramayogina ity arthaḥ /	bhavati prākaraṇikasya parama yoginaḥ iti arthaḥ 
SA_GSP30_pratyabu-585	iti etat sarvaṃ śivasvarūpam evety upasaṃhāra iti saṃgatiḥ /	iti etat sarvam śiva svarūpam eva iti upasaṃhāraḥ iti saṃgatiḥ 
SA_GSP30_pratyabu-586	tatra yāvat idaṃ kiṃcit saṃvedyate tasya saṃvedanam eva svarūpam /	tatra yāvat idam kiṃcid saṃvedyate tasya saṃvedanam eva svarūpam 
SA_GSP30_pratyabu-587	tasyāpi antarmukhavimarśamayāḥ pramātāraḥ tattvam / teṣām api	tasya api antar mukha vimarśa mayāḥ pramātāraḥ tattvam teṣām api 
SA_GSP30_pratyabu-588	vigalitadehādyupādhisaṃkocābhimānā aśeṣaśarīrā sadāśiveśvarataiva	vigalita deha ādi upādhi saṃkoca abhimānā aśeṣa śarīrā sadāśiva īśvara tā eva 
SA_GSP30_pratyabu-589	sāram / asyā api prakāśaikasadbhāvāpāditāśeṣaviśvacamatkāramayaḥ	sāram asyāḥ api prakāśa eka sadbhāva āpādita aśeṣa viśva camatkāra mayaḥ 
SA_GSP30_pratyabu-590	śrīmānmaheśvara eva paramārthaḥ /	śrīmān maheśvaraḥ eva parama arthaḥ 
SA_GSP30_pratyabu-591	na hi pāramārthikaprakāśāveśaṃ vinā	na hi pāramārthika prakāśa āveśam vinā 
SA_GSP30_pratyabu-592	kasyāpi prakāśamānatā ghaṭate /	kasya api prakāśamāna tā ghaṭate 
SA_GSP30_pratyabu-593	sa ca parameśvaraḥ svātantryasāratvāt	sa ca parameśvaraḥ svātantrya sāra tvāt 
SA_GSP30_pratyabu-594	ādikṣāntāmāyīyaśabdarāśiparāmarśamayatvenaiva	ādi kṣānta a māyīya śabdarāśi parāmarśa maya tvena eva 
SA_GSP30_pratyabu-595	etatsvīkṛtasamastavācyavācakamayāśeṣajagadānandasadbhāvāpādanāt paraṃ	                                                                                       
SA_GSP30_pratyabu-596	paripūrṇatvāt sarvākāṅkṣāśūnyatayā ānandaprasaranirbharaḥ /	paripūrṇa tvāt sarva ākāṅkṣā śūnyatayā ānanda prasara nirbharaḥ 
SA_GSP30_pratyabu-597	ata eva anuttarākulasvarūpāt akārāt ārabhya śaktisphārarūpahakalāparyanta.= m	atas eva anuttara ākula svarūpāt akārāt ārabhya śakti sphāra rūpa ha kalā paryanta m 
SA_GSP30_pratyabu-598	yat viśvaṃ prabhṛtaṃ kṣakārasya prasaraśamanarūpatvāt tat	yat viśvam prabhṛtam kṣakārasya prasara śamana rūpa tvāt tat 
SA_GSP30_pratyabu-599	akārahakārābhyām eva saṃpuṭīkārayuktyā pratyāhāranyāyena antaḥsvīkṛtaṃ	akāra hakārābhyām eva saṃpuṭīkāra yuktyā pratyāhāra nyāyena antar svīkṛtam 
SA_GSP30_pratyabu-600	sat avibhāgavedanātmakabindurūpatayā sphuritaṃ anuttara eva viśrāmyati /	sat avibhāga vedanā ātmaka bindu rūpa tayā sphuritam anuttaraḥ eva viśrāmyati 
SA_GSP30_pratyabu-601	iti śabdarāśisvarūpa eva ayaṃ akṛtako vimarśaḥ /	iti śabdarāśi svarūpaḥ eva ayam akṛtakaḥ vimarśaḥ 
SA_GSP30_pratyabu-602	prakāśasyātmaviśrāntir ahaṃbhāvo hi kīrtitaḥ /	prakāśasya ātma viśrāntiḥ ahaṃbhāvaḥ hi kīrtitaḥ 
SA_GSP30_pratyabu-603	uktā ca saiva viśrāntiḥ sarvāpekṣānirodhataḥ //	uktā ca sā eva viśrāntiḥ sarva apekṣā nirodhataḥ 
SA_GSP30_pratyabu-604	svātantryam atha kartṛtvaṃ mukhyam īśvaratāpi ca [34] / iti /	svātantryam atha kartṛ tvam mukhyam īśvara tā api ca iti 
SA_GSP30_pratyabu-605	eṣaiva ca ahantā sarvamantrāṇāṃ udayaviśrāntisthānatvāt etadbalenaiva c= a	eṣā eva ca ahantā sarva mantrāṇām udaya viśrānti sthāna tvāt etad balena eva c a 
SA_GSP30_pratyabu-606	tattadarthakriyākāritvāt mahatī vīryabhūmiḥ / tad uktam	tad tad artha kriyā kāri tvāt mahatī vīrya bhūmiḥ tat uktam 
SA_GSP30_pratyabu-607	tadākramya balaṃ mantrā ..... / ityādi	tat ākramya balam mantrāḥ ityādi 
SA_GSP30_pratyabu-608	..... ta ete śivadharmiṇaḥ [35] /	te ete śiva dharmiṇaḥ 
SA_GSP30_pratyabu-609	ityantaṃ śrīspande /	         
SA_GSP30_pratyabu-610	śivasūtreṣv api=20	śivasūtreṣu 
SA_GSP30_pratyabu-611	mahāhrādānusaṃdhānān mantravīryānubhavaḥ [36] / iti /	mahā hrāda anusaṃdhānāt mantra vīrya anubhavaḥ iti 
SA_GSP30_pratyabu-612	tad atra mahāmantravīryātmakāyāṃ pūrṇāhantāyāṃ āveśo	tat atra mahā mantra vīrya ātmakāyām pūrṇāhantāyām 
SA_GSP30_pratyabu-613	dehaprāṇādinimajjanāt tatpadāvāptyavaṣṭambhena dehādīnāṃ nīlādīnām api	deha prāṇa ādi nimajjanāt tad pada avāpti avaṣṭambhena deha ādīnām nīla ādīnām api 
SA_GSP30_pratyabu-614	tadrasāplāvanena tanmayīkaraṇam /	tad rasa āplāvanena tanmayīkaraṇam 
SA_GSP30_pratyabu-615	tathā hi dehasukhanīlādi yatkiṃcit	tathā hi deha sukha nīla ādi yat kiṃcid 
SA_GSP30_pratyabu-616	prathate adhyavasīyate smaryate saṃkalpyate vā tatra sarvatraiva bhagavatī	prathate adhyavasīyate smaryate saṃkalpyate vā tatra sarvatra eva bhagavatī 
SA_GSP30_pratyabu-617	citiśaktimayī prathā bhittibhūtaiva sphurati /	citiśakti mayī prathā bhitti bhūtā eva sphurati 
SA_GSP30_pratyabu-618	“tadasphuraṇe kasyāpi	tad asphuraṇe kasya api 
SA_GSP30_pratyabu-619	asphuraṇāt ” iti uktatvāt kevalaṃ tathā sphuranty api sā tanmāyāśaktyā	asphuraṇāt iti ukta tvāt kevalam tathā sphurantī api sā tad māyā śaktyā 
SA_GSP30_pratyabu-620	avabhāsitadehanīlādyuparāgadattābhimānavaśāt bhinnabhinnasvabhāvā iva	avabhāsita deha nīla ādi uparāga datta abhimāna vaśāt bhinna bhinna svabhāvāḥ iva 
SA_GSP30_pratyabu-621	bhāntī jñānasaṃkalpādhyavasāyādirūpatayā māyāpramātṛbhiḥ abhimanyate /	bhāntī jñāna saṃkalpa adhyavasāya ādi rūpa tayā māyā pramātṛbhiḥ abhimanyate 
SA_GSP30_pratyabu-622	vastutas tu ekaiva asau citiśaktiḥ / yathoktam	vastutas tu ekā eva asau citiśaktiḥ yathā uktam 
SA_GSP30_pratyabu-623	yā caiṣā pratibhā tattatpadārthakramarūṣitā /	yā ca eṣā pratibhā tad tad padārtha krama rūṣitā 
SA_GSP30_pratyabu-624	akramānantacidrūpaḥ pramātā sa maheśvaraḥ [37] // iti /	                               
SA_GSP30_pratyabu-625	māyāśaktyā vibhoḥ saiva bhinnasaṃvedyagocarā /	māyā śaktyā vibhoḥ sā eva bhinna saṃvedya gocarā 
SA_GSP30_pratyabu-626	kathitā jñānasaṃkalpādhyavasāyādināmabhiḥ [38] // iti /	kathitā jñāna saṃkalpa adhyavasāya ādi nāmabhiḥ    
SA_GSP30_pratyabu-627	evam eṣā sarvadaśāsu ekaiva citiśaktiḥ vijṛmbhamāṇā yadi	evam eṣā sarva daśāsu ekā eva citiśaktiḥ vijṛmbhamāṇā yadi 
SA_GSP30_pratyabu-628	tadanupraveśatadavaṣṭambhayuktyā samāsādyate tat tadāveśāt	tad anupraveśa tad avaṣṭambha yuktyā samāsādyate tat tad āveśāt 
SA_GSP30_pratyabu-629	pūrvoktayuktyā karaṇonmīlananimīlanakrameṇa sarvasya sarvamayatvāt	                                       
SA_GSP30_pratyabu-630	tattatsaṃhārādau api sadā sarvasargasaṃhārakāri yat	tad tad saṃhāra ādau api sadā sarva sarga saṃhāra kāri yat 
SA_GSP30_pratyabu-631	sahajasaṃvittidevatācakraṃ amāyīyāntarbahiṣkaraṇamarīcipuñjaḥ tatra	                     
SA_GSP30_pratyabu-632	īśvaratāsāmrajyaṃ parabhairavātmatā tatprāptiḥ bhavati	īśvara tā sāmrajyam para bhairava ātma tā tad prāptiḥ bhavati 
SA_GSP30_pratyabu-633	paramayoginaḥ / yathoktam	parama yoginaḥ yathā uktam 
SA_GSP30_pratyabu-634	yadā tv ekatra saṃrūḍhas tadā tasya layodbhavau /	yadā tu ekatra saṃrūḍhaḥ tadā tasya laya udbhavau 
SA_GSP30_pratyabu-635	niyacchan bhoktṛtām eti tataś cakreśvaro bhavet [39] // iti /	niyacchan bhoktṛ tām eti tatas cakreśvaraḥ bhavet    iti 
SA_GSP30_pratyabu-636	atra ekatra iti “ekatrāropayet sarvaṃ” [40] iti citsāmānyaspandabhūḥ	atra ekatra iti ekatra āropayet sarvam iti cit sāmānya spanda bhūḥ 
SA_GSP30_pratyabu-637	unmeṣātmā vyākhyātavyā /	unmeṣa ātmā vyākhyātavyā 
SA_GSP30_pratyabu-638	tasya iti anena “puryaṣṭakena saṃruddha” [41] iti /	tasya iti anena puryaṣṭakena saṃruddha iti 
SA_GSP30_pratyabu-639	upakrāntaṃ	upakrāntam 
SA_GSP30_pratyabu-640	puryaṣṭakam eva parāmraṣṭavyam na tu yathā vivaraṇakṛtaḥ ekatra	puryaṣṭakam eva parāmraṣṭavyam na tu yathā vivaraṇakṛtaḥ ekatra 
SA_GSP30_pratyabu-641	sūkṣme sthūle śarīre vā iti vyākṛtavantaḥ /	sūkṣme sthūle śarīre vā iti vyākṛtavantaḥ 
SA_GSP30_pratyabu-642	stutaṃ ca mayā	stutam ca mayā 
SA_GSP30_pratyabu-643	svatantraś citicakrāṇāṃ cakravartī maheśvaraḥ /	svatantraḥ citi cakrāṇām cakravartī maheśvaraḥ 
SA_GSP30_pratyabu-644	saṃvittidevatācakrajuṣṭaḥ ko 'pi jayaty asau // iti /	saṃvitti devatā cakra juṣṭaḥ kaḥ pi jayati asau iti 
SA_GSP30_pratyabu-645	itiśabda upasaṃhāre /	iti śabdaḥ upasaṃhāre 
SA_GSP30_pratyabu-646	yat etāvat uktaprakaraṇaśarīraṃ tat sarvaṃ	yat etāvat ukta prakaraṇa śarīram tat sarvam 
SA_GSP30_pratyabu-647	śivaṃ śivaprāptihetutvāt śivāt prasṛtatvāt śivasvarūpābhinnatvāc ca	śivam śiva prāpti hetu tvāt śivāt prasṛta tvāt śiva svarūpa abhinna tvāt ca 
SA_GSP30_pratyabu-648	śivamayam eva iti śivam /	śiva mayam eva iti śivam 
SA_GSP30_pratyabu-649	dehaprāṇasukhādibhiḥ pratikalaṃ saṃrudhyamāno janaḥ	deha prāṇa sukha ādibhiḥ pratikalam saṃrudhyamānaḥ janaḥ 
SA_GSP30_pratyabu-650	pūrṇānandaghanām imāṃ na cinute māheśvarīṃ svāṃ citim /	pūrṇa ānanda ghanām imām na cinute māheśvarīm svām citim 
SA_GSP30_pratyabu-651	madhyebodhasudhābdhi viśvam abhitas tatphenapiṇḍopamaṃ	viśvam abhitas tad phena piṇḍa upamam 
SA_GSP30_pratyabu-652	yaḥ paśyed upadeśatas tu kathitaḥ sākṣāt sa ekaḥ śivaḥ //	yaḥ paśyet upadeśataḥ tu kathitaḥ sākṣāt saḥ ekaḥ śivaḥ 
SA_GSP30_pratyabu-653	yeṣāṃ vṛttaḥ śāṅkaraḥ śaktipāto	yeṣām vṛttaḥ śāṅkaraḥ śaktipātaḥ 
SA_GSP30_pratyabu-654	ye 'nabhyāsāt tīkṣṇayuktiṣv ayogyāḥ /	ye na abhyāsāt tīkṣṇa yuktiṣu ayogyāḥ 
SA_GSP30_pratyabu-655	śaktā jñātuṃ neśvarapratyabhijñām	śaktāḥ jñātum na īśvara pratyabhijñām 
SA_GSP30_pratyabu-656	uktas teṣām eṣa tattvopadeśaḥ //	uktaḥ teṣām eṣa tattva upadeśaḥ 
SA_GSP30_pratyabu-657	samāptam idaṃ pratyabhijñāhṛdayam kṛtis	samāptam idam pratyabhijñā hṛdayam kṛtis 
SA_GSP30_pratyabu-658	tatrabhavanmahāmāheśvarācāryavaryaśrīmadabhinavaguptapādapadmopajīvinaḥ	tatrabhavat mahā māheśvara ācārya varya śrīmat abhinavagupta pāda padma upajīvinaḥ 
SA_GSP30_pratyabu-659	śrīmato rājānakakṣemarājācaryasya	śrīmataḥ rājānaka kṣemarāja ācaryasya 
SA_GSP30_pratyabu-660	śubham astu @------------------------------------------------------------------------	śubham astu 
SA_GSP30_pratyabu-661	[1] Pratyabhijñāhṛdayam ,	      
SA_GSP30_pratyabu-662	The secret of recognition ,	the secret of recognition 
SA_GSP30_pratyabu-663	ṅerman transl. by E.	ṅerman transl bi e 
SA_GSP30_pratyabu-664	Baer, transl. into English by K. F. Leidecker. Adyar Library, 1938.	baer transl into english by k f leidecker adyar library 
SA_GSP30_pratyabu-665	Pratyabhijñāhṛdayam ,	pratyabhijñāhṛdayam 
SA_GSP30_pratyabu-666	Sanskrit text with English Translation, Notes and	sanskrit text with english translation notes and 
SA_GSP30_pratyabu-667	Introduction by J. Singh. I=B0ed. Delhi 1963	introduction by j singh  delhi 
SA_GSP30_pratyabu-668	[2] Con questo verso Kṣemarāja fa iniziare anche il Bodhavilāsa .	kṣemarāja 
SA_GSP30_pratyabu-669	[3] VBh. 106	vbh 
SA_GSP30_pratyabu-670	[4] SpK. II. 3-4	spr2Im 
SA_GSP30_pratyabu-671	[7] Citazione riconducibile a S'S. III. 1 (ātmā cittam )	ātmā cittam 
SA_GSP30_pratyabu-672	[8] Sv.T X. 1141 c	ro fl 
SA_GSP30_pratyabu-673	[9] Netra T. VIII. 30 b . La versione originale cui si richiama Kṣemarāja = =E8	netra t viii b la versione originale kṣemarāja 
SA_GSP30_pratyabu-674	la seguente:=20	la 
SA_GSP30_pratyabu-675	ta ātmopāsakāḥ śaive na gacchanti paraṃ śivam .	te ātma upāsakāḥ śaive na gacchanti param śivam 
SA_GSP30_pratyabu-676	[10] ed. apūrṇaṃ manyatārūpaṃ .	ā id a pūrṇam manyata a rūpam 
SA_GSP30_pratyabu-677	[11] mss. Adyar Library (No=B0 XXII. F. 38; No=B0 XIX. I. 25)	nob xxii 
SA_GSP30_pratyabu-678	. l'edizione del	ledizione del 
SA_GSP30_pratyabu-679	testo segue invece la lezione:	testo segue invece la lezione 
SA_GSP30_pratyabu-680	atyantaṃ saṃkocagrahaṇena .	atyantam saṃkoca grahaṇena 
SA_GSP30_pratyabu-681	[12] mss. Adyar Library (No=B0 XXII. F. 38; No=B0 XIX. I. 25)	nob xxii 
SA_GSP30_pratyabu-682	. ed. : atyantaṃ	e t atyantam 
SA_GSP30_pratyabu-683	parimitatāṃ .	parimita tām 
SA_GSP30_pratyabu-684	[13] Sv.T. I. 3	svt i 
SA_GSP30_pratyabu-685	[16] trattasi del Sūtra 9 .	trat tasi de l sūtra 
SA_GSP30_pratyabu-686	[17] var. sakalabhedakabalanasvabhāvaṃ .	var sakala bhedaka balana svabhāvam 
SA_GSP30_pratyabu-687	[18] S'ivastotravalī . XX. 17	    
SA_GSP30_pratyabu-688	[19] SpK. II. 10	spr2Im 
SA_GSP30_pratyabu-689	[20] SpK. II, 5	spr2Im 
SA_GSP30_pratyabu-690	[21] var. sarvāntaratamatvena .	var sarva antaratama tvena 
SA_GSP30_pratyabu-691	[23] SpK. I. 9	spr2Im 
SA_GSP30_pratyabu-692	[24] var. pratyabhijñāyāṃ ca .	var pratyabhijñāyām ca 
SA_GSP30_pratyabu-693	[25] Kaṭha Up. IV. 1; aśnan in luogo dell'originale icchan .	icchan 
SA_GSP30_pratyabu-694	[26] Vbh. 68	vbh 
SA_GSP30_pratyabu-695	[27] Vbh. 49	vbh 
SA_GSP30_pratyabu-696	[28] Vbh. 51	vbh 
SA_GSP30_pratyabu-697	[29] SpK. III. 9	spr2 fl 
SA_GSP30_pratyabu-698	[30] Vbh. 72-74	vbh 
SA_GSP30_pratyabu-699	[31] omesso in alcuni mss.	omessaḥ in a l cuni mss
SA_GSP30_pratyabu-700	[32] var. =B0svarūpatayā .	var 
SA_GSP30_pratyabu-701	[33] var. cidāhlādaikadhanā .	         
SA_GSP30_pratyabu-702	[34] Utpaladeva: Ajaḍaprāmatṛsiddhi . 22-23	      
SA_GSP30_pratyabu-703	[35] SpK. II. 1-2	spr2Im 
SA_GSP30_pratyabu-704	[39] SpK. III. 19	spr2 fl 
SA_GSP30_pratyabu-705	[40] SpK. III. 12	spr2 fl 
SA_GSP30_pratyabu-706	[41] SpK. III. 17 @------------------------------------------------------------------------	ro-0 
SA_GSP30_pratyabu-707	ṅandharva-nagaram /	ṅan dharva nagaram 
SA_GSP30_pratyabu-708	DSO Sanskrit Archive	dso sanskrit archive 
SA_GSP30_pratyabu-709	http://popḷet.uniroma1.it/ DSO/	dsaḥ 
SA_GSP30_pratyabu-710	archive/	archive 
SA_GSP30_pratyabu-711	sanskritḥtm	san skrit ḥ tm 
