segmentnr	original	analyzed
SA_GV06_dantyovu-0	atharvāṇam ṛṣiṃ devaṃ devahayaśirodharam /	atharvāṇam ṛṣim devam deva haya śiraḥ dharam 
SA_GV06_dantyovu-1	praṇamya sampravakṣyāmi dantyoṣṭhavidhivistaram // 1.1 //	praṇamya sampravakṣyāmi dantī oṣṭha vidhi vistaram 
SA_GV06_dantyovu-2	chandasy adhyayane prāpte viduṣām atha dhīmatām /	chandasi adhyayane prāpte viduṣām atha dhīmatām 
SA_GV06_dantyovu-3	bakāre saṃśayo nityam auṣṭhyaṃ dantyam iti sma ha // 1.2 //	bakāre saṃśayaḥ nityam auṣṭhyam dantyam iti sma ha 
SA_GV06_dantyovu-4	tasmāt tadvidhi nirṇaye saṃśayachedanāya ca /	tasmāt tadvidhi nirṇaye saṃśaya chedanāya ca 
SA_GV06_dantyovu-5	muktā dantyā prayojyāma auṣṭhyān vakṣye kramāhitaḥ // 1.3 //	muktāḥ dantyā prayojyāmaḥ auṣṭhyān vakṣye krama āhitaḥ 
SA_GV06_dantyovu-6	bhaparaṃ yatra dṛśyetāniṃgye sparśanaṃ kva cit /	bha param yatra dṛśyeta aniṃgye sparśanam kva cit 
SA_GV06_dantyovu-7	auṣṭyaṃ tatra pade dhīro bibhīto bibhratīr yathā // 1.4 //	auṣṭyam tatra pade dhīraḥ bibhītaḥ bibhratīḥ yathā 
SA_GV06_dantyovu-8	ādyudātte bale bāṇe bila śabde tathaiva ca /	ādi udātte bale bāṇe bila śabde tathā eva ca 
SA_GV06_dantyovu-9	samaste 'pi yatra syātām antodātto viśiṣyate // 1.5 //	samaste pi yatra syātām anta udāttaḥ viśiṣyate  /
SA_GV06_dantyovu-10	baladābalānugrāhabaladhanvā tathaiva ca /	balada abala anugrāha baladhanvā tathā eva ca 
SA_GV06_dantyovu-11	balāsaṃ bāhū ācāryāḥ sarvāsv eva vibhaktiṣu // 1.6 //	balāsam bāhū ācāryāḥ sarvāsu eva vibhaktiṣu 
SA_GV06_dantyovu-12	balī balena barhiś cābalena balīyase /	balī balena barhiḥ ca abalena balīyase 
SA_GV06_dantyovu-13	bradhnaḥ kilbiṣaṃ vaḥ ketuḥ kumbaṃ bādhiṣṭa bāliti // 1.7 //	bradhnaḥ kilbiṣam vaḥ ketuḥ kumbam bādhiṣṭa bāliti  /
SA_GV06_dantyovu-14	bāhuṃ bohi tathā baṃdhur bahubādhe bṛhac ca yat /	bāhum tathā baṃdhuḥ bahu bādhe bṛhat ca yat 
SA_GV06_dantyovu-15	pibati bruvate caiva yathārthāḥ samprakīrttitāḥ // 1.8 //	pibati bruvate ca eva yathā arthāḥ samprakīrttitāḥ 
SA_GV06_dantyovu-16	bastavāsino bāhvaṃkair bāhuvīrye tathaiva ca /	bastavāsinaḥ bāhu aṃkaiḥ bāhu vīrye tathā eva ca 
SA_GV06_dantyovu-17	bahavaḥ kābavaṃ bāhvor bodha bahve tathaiva ca // 1.9 //	bahavaḥ bāhvoḥ bodha tathā eva ca 
SA_GV06_dantyovu-18	tathāa badhnyaṃ tābuvaṃ bahvīr navamaḥ saṃprakīrttitāḥ /	badhnyam tābuvam bahvīḥ navamaḥ saṃprakīrttitāḥ 
SA_GV06_dantyovu-19	ete sarveṣu śabdeṣu prathamasparśyā hi matāḥ // 1.10 //	ete sarveṣu śabdeṣu prathama sparśyāḥ hi matāḥ 
SA_GV06_dantyovu-20	vaibādha devabandhuṃ ca vibaddhas tu vibandhuṣu /	vaibādha devabandhum ca vibaddhaḥ tu vibandhuṣu 
SA_GV06_dantyovu-21	dvitīya sparśyo vijñeyo vibabādhe tathaiva ca // 1.11 //	dvitīya sparśyaḥ vijñeyaḥ vibabādhe tathā eva ca 
SA_GV06_dantyovu-22	bāhau bāhavo bahulaṃ budhnyaṃ baddhkam eva ca /	bāhau bāhavaḥ bahulam budhnyam baddhkam eva ca 
SA_GV06_dantyovu-23	ete sarve bhavanty oṣṭhyā ye noktās te tu dantajāḥ // 1.12 //	ete sarve bhavanti oṣṭhyāḥ ye na uktāḥ te tu danta jāḥ  /
SA_GV06_dantyovu-24	iti prathamo 'dhyāyaḥ /	iti prathamaḥ dhyāyaḥ 
SA_GV06_dantyovu-25	adharād uttare bhāge bhāgāt prativibhāgaśaḥ /	adharāt uttare bhāge bhāgāt prativibhāgaśaḥ 
SA_GV06_dantyovu-26	daśanāgreṇa saṃspṛṣṭyo na tu pīḍāsu yojayet // 2.1 //	daśana agreṇa saṃspṛṣṭyaḥ na tu pīḍāsu yojayet  /
SA_GV06_dantyovu-27	kambalaṃ balbajaṃ bījaṃ libujā baṇmhāṃ asi /	kambalam balbajam bījam libujā asi 
SA_GV06_dantyovu-28	biṣkale brahma barjahye śabale bedhiṣe bayaḥ // 2.2 //	biṣkale brahma barjahye śabale bedhiṣe bayaḥ   
SA_GV06_dantyovu-29	bahiṣṭhaḥ budhnyaḥ paḍbīśam arbudaṃ badhiras tathā /	bahiṣṭhaḥ budhnyaḥ paḍbīśam arbudam badhiraḥ tathā 
SA_GV06_dantyovu-30	ābayobinduḥ saṃbiṃbaṃ kāhābām udumbalam // 2.3 //	ā abayaḥ binduḥ saṃbiṃbam kāha ābām udumbalam 
SA_GV06_dantyovu-31	kabru pībasi baṃdhuraṃ kaṃbūkāṃ balinas tathā /	kabru pībasi baṃdhuram kaṃbūkām balinaḥ tathā 
SA_GV06_dantyovu-32	kuberaḥ stambajaṃ babhraupabdaiḥ paribedhire // 2.4 //	kuberaḥ stamba jam babhraupabdaiḥ paribedhire  /
SA_GV06_dantyovu-33	asaṃbādhe nairbādhyena baddhe buddhāni kulbajaṃ /	asaṃbādhe nairbādhyena baddhe buddhāni kulbajam 
SA_GV06_dantyovu-34	bato batāsi bandhuṃ ca bisaṃ klībaṃ buje bujaḥ // 2.5 //	bataḥ bata asi bandhum ca bisam klībam buje bujaḥ  
SA_GV06_dantyovu-35	badhāna prābaṃdhāyāś colbaṃ kāberkas tathā /	badhāna prābaṃdhāyāḥ ca ulbam kāberkaḥ tathā 
SA_GV06_dantyovu-36	ābedhur ailabaś caivābedhe balhikāni ca // 2.6 //	ābedhuḥ ailabaḥ ca eva ābedhe balhikāni ca 
SA_GV06_dantyovu-37	abodhi bārhatsāme ghoṣabuddhā tathaiva ca /	abodhi bārhatsāme ghoṣabuddhā tathā eva ca 
SA_GV06_dantyovu-38	baṃdhanaṃ yatra śeṣaṃ syād ābadhe me nidraśanam // 2.7 //	baṃdhanam yatra śeṣam syāt me 
SA_GV06_dantyovu-39	alābu bajaḥ bāṇaṃ syād ādyudātto yadā bhavet /	alābu bajaḥ bāṇam syāt ādi udāttaḥ yadā bhavet 
SA_GV06_dantyovu-40	brahma śabdaṃ tu sarvārtham auṣṭhyam eva vidur budhāḥ // 2.8 //	brahma śabdam tu sarva artham auṣṭhyam eva viduḥ budhāḥ  
SA_GV06_dantyovu-41	chubukābdaṣkaye bāle keśabāle tathaiva ca /	chubuka abdaṣkaye bāle keśa bāle tathā eva ca 
SA_GV06_dantyovu-42	adhibāle vayaḥ proktaḥ śeṣeṣu parimāṇataḥ // 2.9 //	adhibāle vayaḥ proktaḥ śeṣeṣu parimāṇataḥ  /
SA_GV06_dantyovu-43	bibhed ādiṣu bhedāś ca pari pūrvaṃ bale tathā /	bibhet ādiṣu bhedāḥ ca pari pūrvam bale tathā 
SA_GV06_dantyovu-44	baṃdhu vā siṃdhurapara eteṣāṃ tu balaḥ kva cit // 2.10 //	baṃdhu vā siṃdhuḥ aparaḥ eteṣām tu balaḥ kva cit 
SA_GV06_dantyovu-45	tuchubdaś cubukaś caiva babhūvuś ca babhūvuṣī /	tuchubdaḥ cubukaḥ ca eva babhūvuḥ ca babhūvuṣī 
SA_GV06_dantyovu-46	ete sarve parityajya bakāronyonya bhakṣana // 2.11 //	ete sarve parityajya 
SA_GV06_dantyovu-47	// iti dvitīyo 'adhyāyaḥ //	iti dvitīyaḥ adhyāyaḥ 
SA_GV06_dantyovu-48	// dantyoṣṭhavidhiḥ samāptaḥ //	        
