segmentnr	original	analyzed
SA_K01_prmosufu-0	(PrMoSū_Mū-LCh)Pār.2 yaḥ punar bhikṣur grāmagatam araṇyagataṃ vā pareṣāṃ adattaṃ	yaḥ punar bhikṣuḥ grāma gatam araṇya gatam vā pareṣām adattam 
SA_K01_prmosufu-1	steyasaṃkhyātam ādadīta yadrūpeṇādattādānena rājā vainaṃ gṛhītvā rājamātro vā hanyād	steya saṃkhyātam ādadīta yat rūpeṇa ādatta ādānena rājā vā enam gṛhītvā rājamātraḥ vā hanyāt 
SA_K01_prmosufu-2	vā badhnīyād vā pravāsayed vā evaṃ cainaṃ vadet tvaṃ bhoḥ puruṣa bālo 'si mūḍho 'si	vā badhnīyāt vā pravāsayet vā evam ca enam vadet tvam bhoḥ puruṣa bālaḥ si mūḍhaḥ si 
SA_K01_prmosufu-3	steyo 'sīty evaṃrūpaṃ bhikṣur adattaṃ ādadāvaḥ ayam api bhikṣuḥ pārājayiko bhavaty asaṃvāsyaḥ	evaṃrūpam bhikṣuḥ adattam ayam api bhikṣuḥ pārājayikaḥ bhavati a saṃvāsyaḥ 
SA_K01_prmosufu-4	(PrMoSū-LCh)Pār.3 yaḥ punar bhikṣur manuṣyaṃ vā manuṣyavigrahaṃ vā svahastaṃ saṃcintya	yaḥ punar bhikṣuḥ manuṣyam vā manuṣya vigraham vā sva hastam saṃcintya 
SA_K01_prmosufu-5	jīvitād vyaparopayec chastraṃ vainam ādhārayec chastrādhārakaṃ vāsya paryeṣeta maraṇāya	jīvitāt vyaparopayet śastram vā enam ādhārayet śastra ādhārakam vā asya paryeṣeta maraṇāya 
SA_K01_prmosufu-6	vainaṃ samādāpayen maraṇavarṇaṃ vāsyānusaṃvarṇayed evaṃ cainaṃ vaded dhaṃ bhoḥ puruṣo	vā enam samādāpayet maraṇa varṇam vā asya anusaṃvarṇayet evam ca enam vadet ham bhoḥ puruṣaḥ 
SA_K01_prmosufu-7	kiṃ te anena pāpakenāśucinā durjīvitena mṛtaṃ te bhoḥ puruṣa jīvitād varam iti cintānumataiś	kim te anena pāpakena aśucinā durjīvitena mṛtam te bhoḥ puruṣa jīvitāt varam iti cintā anumataiḥ 
SA_K01_prmosufu-8	cittasaṃkalpair anekaparyāyeṇa maraṇāya vainaṃ samādāpayen maraṇavarṇaṃ vāsyānusaṃvarṇayet	citta saṃkalpaiḥ aneka paryāyeṇa maraṇāya vā enam samādāpayet maraṇa varṇam vā asya anusaṃvarṇayet 
SA_K01_prmosufu-9	sa ca tena kālaṃ kuryād ayam api bhikṣuḥ pārājiko bhavaty asaṃvāsyaḥ //	sa ca tena kālam kuryāt ayam api bhikṣuḥ pārājikaḥ bhavati a saṃvāsyaḥ 
SA_K01_prmosufu-10	(PrMoSū-LCh)Pār.4 yaḥ punar bhikṣur anabhijānann aparijānann asantam asaṃvidyamānam.	yaḥ punar bhikṣuḥ an abhijānan a parijānan asantam a saṃvidyamānam 
SA_K01_prmosufu-11	... viśeṣādhigamaṃ jñānaṃ vā darśanaṃ vā sparśavihāratāṃ vā pratijānīyād idaṃ jānāmīdaṃ	viśeṣa adhigamam jñānam vā darśanam vā sparśavihāra tām vā pratijānīyāt idam jānāmi idam 
SA_K01_prmosufu-12	paśyāmīti sa pareṇa samayena samanuyujyamāno vā asamanuyujyamāno vā āpanno viśuddhiprekṣy	paśyāmi iti sa pareṇa samayena samanuyujyamānaḥ vā a samanuyujyamānaḥ vā āpannaḥ viśuddhi prekṣī 
SA_K01_prmosufu-13	evaṃ vaded ajānaty evāham āyuṣmanto 'vocaṃ jānāmīty apaśyann evā ... ayam api bhikṣuḥ	evam vadet a jānatī eva aham āyuṣmantaḥ vocam jānāmi iti a paśyan eva a ayam api bhikṣuḥ 
SA_K01_prmosufu-14	pārājiko bhavaty asaṃvāsyaḥ //	pārājikaḥ bhavati a saṃvāsyaḥ 
SA_K01_prmosufu-15	uddiṣṭā me āyuṣmantaś catvāraḥ pārājikā dharmā yeṣāṃ bhikṣur anyatamānyatamam āpattim	uddiṣṭāḥ me āyuṣmantaḥ catvāraḥ pārājikāḥ dharmāḥ yeṣām bhikṣuḥ anyatama anyatamam āpattim 
SA_K01_prmosufu-16	adhyāpatya na labhate bhikṣubhiḥ sārdhaṃ saṃvāsaṃ bhogaṃ vā yathāpūrvaṃ tathāpaścāt	adhyāpatya na labhate bhikṣubhiḥ sārdham saṃvāsam bhogam vā yathāpūrvam tathā apaścāt 
SA_K01_prmosufu-17	pārājiko bhavaty asaṃvāsyaḥ //	pārājikaḥ bhavati a saṃvāsyaḥ 
SA_K01_prmosufu-18	tatrāham āyuṣmantaḥ paripṛcchāmi ... dvir api trir api paripṛcchāmi kaccit sthātra pariśuddhāḥ pariśuddhā atrāyuṣmanto yasmāt tūṣṇīm evam etad	tatra aham āyuṣmantaḥ paripṛcchāmi dvis api tris api paripṛcchāmi kaccit stha atra pariśuddhāḥ pariśuddhāḥ atra āyuṣmantaḥ yasmāt tūṣṇīm evam etat 
SA_K01_prmosufu-19	Uddāna SA.4-13: ... caryā sāṃcaritraṃ kuṭikā mahallakaḥ amūlaka leśika saṃghabhedas tasyānuvarti kuladūṣaka daurvacasya ...	uddāna caryā sāṃcaritram kuṭikā mahallakaḥ amūlaka leśika saṃgha bhedaḥ tasya anuvarti kula dūṣaka daurvacasya 
SA_K01_prmosufu-20	ime khalv āyuṣmantas trayodaśa saṃghāvaśeṣā dharmā anvardhamāsaṃ prātimokṣasūtroddeśam āgacchanti	ime khalu āyuṣmantaḥ trayodaśa saṃgha avaśeṣāḥ dharmāḥ anvardha māsam prātimokṣa sūtra uddeśam āgacchanti 
SA_K01_prmosufu-21	(PrMoSū-LCh)SA.1 saṃcintya śukravisṛṣṭir anyatra svapnāntarāt saṃghāvaśeṣaḥ	saṃcintya śukra visṛṣṭiḥ anyatra svapna antarāt saṃgha avaśeṣaḥ 
SA_K01_prmosufu-22	(PrMoSū-LCh)SA.2 yaḥ punar bhikṣur avalavipariṇatena cittena mātṛgrāmeṇa sārdhaṃ kāyasaṃsargaṃ samāpadyeta hastagrahaṇaṃ vā bāhu ...	yaḥ punar bhikṣuḥ a vala vipariṇatena cittena mātṛgrāmeṇa sārdham kāya saṃsargam samāpadyeta hasta grahaṇam vā bāhu 
SA_K01_prmosufu-23	(PrMoSū-LCh)Pāy.33 pāyantikā //	pāyantikā 
SA_K01_prmosufu-24	dvau trīn vā pātrapūrān pratigṛhya bahir ārāmaṃ gatvā santo bhikṣavaḥ saṃvibhaktavyā ātmanā ca paribhoktavyaṃ ayaṃ tatra samayaḥ //	dvau trīn vā pātra pūrān pratigṛhya bahis ārāmam gatvā santaḥ bhikṣavaḥ saṃvibhaktavyāḥ ātmanā ca paribhoktavyam ayam tatra samayaḥ 
SA_K01_prmosufu-25	(PrMoSū-LCh)Pāy.34 yaḥ punar bhikṣur bhuktavān pravāritaḥ akṛtaniriktaṃ khādanīyabhojanīyaṃ khāded bhuṃjīta vā pāyantikā //	yaḥ punar bhikṣuḥ bhuktavān pravāritaḥ a kṛta niriktam khādanīya bhojanīyam khādet bhuṃjīta vā pāyantikā 
SA_K01_prmosufu-26	(PrMoSū-LCh)Pāy.35 yaḥ punar bhikṣur jānan bhikṣuṃ bhuktavantaṃ pravāritam akṛta	yaḥ punar bhikṣuḥ jānan bhikṣum bhuktavantam pravāritam akṛta 
SA_K01_prmosufu-27	atiriktena khādanīyabhojanīyenātyarthaṃ pravārayed idam āyuṣmaṃ khāda idaṃ bhuṃkṣva	atiriktena khādanīya bhojanīyena atyartham pravārayet idam āyuṣmam khāde idam bhuṃkṣva 
SA_K01_prmosufu-28	ity āsādanaprekṣī kaścid eṣa bhikṣur āsādito bhaviṣyaty etad eva pratyayaṃ kṛtvā pāyantikā //	iti āsādana prekṣī kaścid eṣa bhikṣuḥ āsāditaḥ bhaviṣyati etat eva pratyayam kṛtvā pāyantikā 
SA_K01_prmosufu-29	(PrMoSū-LCh)Pāy.36 gaṇabhojanād anyatra samayāt pāyantikā //	gaṇa bhojanāt anyatra samayāt pāyantikā 
SA_K01_prmosufu-30	tatrāyaṃ samayaḥ :	tatra ayam samayaḥ 
SA_K01_prmosufu-31	glānasamayaḥ karmasamayo 'dhvasamayo nāvādhirohaṇaṃ mahāsamājaḥ śramaṇabhaktam ayaṃ tatra samayaḥ //	glāna samayaḥ karma samayaḥ dhva samayaḥ nāvā adhirohaṇam mahā samājaḥ śramaṇa bhaktam ayam tatra samayaḥ 
SA_K01_prmosufu-32	(PrMoSū-LCh)Pāy.37 yaḥ punar bhikṣur akāle khādanīyabhojanīyaṃ khāded bhuṃjīta vā pāyantikā //	yaḥ punar bhikṣuḥ akāle khādanīya bhojanīyam khādet bhuṃjīta vā 
SA_K01_prmosufu-33	(PrMoSū-LCh)Pāy.38 yaḥ punar bhikṣuḥ saṃnihitaṃ khādanīyabhojanīyaṃ khāded bhuṃjīta vā pāyantikā //	yaḥ punar bhikṣuḥ saṃnihitam khādanīya bhojanīyam khādet bhuṃjīta vā 
SA_K01_prmosufu-34	(PrMoSū-LCh)Pāy.39 yaḥ punar bhikṣur adattaṃ mukhābhyavahāryam āhāram āhared anyatrodakadantakāṣṭhāt pāyantikā //	yaḥ punar bhikṣuḥ adattam mukhābhyavahāryam āhāram āharet anyatra udaka dantakāṣṭhāt pāyantikā 
SA_K01_prmosufu-35	(PrMoSū-LCh)Pāy.40 yāni tāni bhagavatā bhikṣūṇāṃ praṇītabhojanāny akhyātāni tadyathā kṣīraṃ dadhi navanītaṃ matsyo māṃsavallūrā //	yāni tāni bhagavatā bhikṣūṇām praṇīta bhojanāni a khyātāni tat yathā kṣīram dadhi navanītam matsyaḥ māṃsa vallūrā 
SA_K01_prmosufu-36	yaḥ punar bhikṣur imāny evaṃrūpāṇi praṇītabhojanāny ātmārtham aglānaḥ parakulebhyo vijñāpya khāded bhuṃjītā vā pāyantikā // //	yaḥ punar bhikṣuḥ imāni evaṃrūpāṇi praṇīta bhojanāni ātma artham a glānaḥ para kulebhyaḥ vijñāpya khādet bhuṃjīta ā vā pāyantikā  /
SA_K01_prmosufu-37	(PrMoSū-LCh)Pāy.41-50 uddānaṃ //	uddānam 
SA_K01_prmosufu-38	saprāṇabhojane sthānaṃ niṣadyācela senayā dvirātraudyūṣikāṃ gacchet prahārodgūra duṣṭhulāḥ // //	sa prāṇabhojane sthānam niṣadya a cela senayā dvi rātra audyūṣikām gacchet duṣṭhulāḥ 
SA_K01_prmosufu-39	(PrMoSū-LCh)Pāy.41 yaḥ punar bhikṣur jānan saprāṇakam udakaṃ paribhuṃjīta pāyantikā //	yaḥ punar bhikṣuḥ jānan sa prāṇakam udakam paribhuṃjīta pāyantikā 
SA_K01_prmosufu-40	(PrMoSū-LCh)Pāy.42 yaḥ punar bhikṣur jānan sabhojane kule anupraskadyāsane niṣadyāṃ kalpayet pāyantikā //	yaḥ punar bhikṣuḥ jānan sa bhojane kule anupraskadya āsane niṣadyām kalpayet pāyantikā 
SA_K01_prmosufu-41	(PrMoSū-LCh)Pāy.43 yaḥ punar bhikṣur jānan sabhojane kule rahasi praticchanne 'titiṣṭhet pāyantikā //	yaḥ punar bhikṣuḥ jānan sa bhojane kule rahasi praticchanne titiṣṭhet pāyantikā 
SA_K01_prmosufu-42	(PrMoSū-LCh)Pāy.44 yaḥ punar bhikṣur acelakāya vā acelikāyai vā parivrājakāya vā parivrājikāyai vāstamāstaṃ ?	yaḥ punar bhikṣuḥ acelakāya vā acelikāyai vā parivrājakāya vā parivrājikāyai vā astam astam 
SA_K01_prmosufu-43	khādanīyabhojanīyaṃ dadyāt pāyantikā //	khādanīya bhojanīyam dadyāt pāyantikā 
SA_K01_prmosufu-44	(PrMoSū-LCh)Pāy.45 yaḥ punar bhikṣur udyuktāṃ senāṃ darśanāyopasaṃkrāmet pāyantikā //	yaḥ punar bhikṣuḥ udyuktām senām darśanāya upasaṃkrāmet pāyantikā 
SA_K01_prmosufu-45	(PrMoSū-LCh)Pāy.46 syāt khalu bhikṣoḥ tadrūpaḥ pratyaya udyuktāṃ senāṃ darśanāyopasaṃkramituṃ	syāt khalu bhikṣoḥ tad rūpaḥ pratyayaḥ udyuktām senām darśanāya upasaṃkramitum 
SA_K01_prmosufu-46	dvirātraparamaṃ tena bhikṣuṇā tasyāṃ senāyāṃ vipravastavyaṃ tata uttari vipravaset	dvi rātra paramam tena bhikṣuṇā tasyām senāyām vipravastavyam tatas uttari vipravaset 
SA_K01_prmosufu-47	pāyantikā // = // = //	pāyantikā 
SA_K01_prmosufu-48	(PrMoSū-LCh)Pāy.47 dvirātram api ced bhikṣus tasyāṃ senāyāṃ vipravasann udyūṣikāṃ vā gacched dhvajāgraṃ vā balāgraṃ vā senāvyūham anīkasaṃdarśanaṃ  #	dvi rātram api ced bhikṣuḥ tasyām senāyām vipravasan udyūṣikām vā gacchet dhvaja agram vā bala agram vā senā vyūham anīka saṃdarśanam 
SA_K01_prmosufu-49	vā pratyanubhavet pāyantikā //	vā pratyanubhavet pāyantikā 
SA_K01_prmosufu-50	(PrMoSū-LCh)Pāy.48 yaḥ punar bhikṣur abhiṣaktaḥ kupitaś caṇḍībhūto 'nāttamanā bhikṣoḥ prahāraṃ dadyāt pāyantikā //	yaḥ punar bhikṣuḥ abhiṣaktaḥ kupitaḥ caṇḍībhūtaḥ na ātta manāḥ bhikṣoḥ prahāram dadyāt pāyantikā 
SA_K01_prmosufu-51	(PrMoSū-LCh)Pāy.49 yaḥ punar bhikṣur abhiṣaktaḥ kupitaś caṇḍībhūto 'nāttamanā bhikṣoḥ prahāram udgūrayed antatas talaśaktikā pāyantikā //	yaḥ punar bhikṣuḥ abhiṣaktaḥ kupitaḥ caṇḍībhūtaḥ na ātta manāḥ bhikṣoḥ prahāram udgūrayet antatas talaśaktikā pāyantikā 
SA_K01_prmosufu-52	(PrMoSū-LCh)Pāy.50 yaḥ punar bhikṣur jānan bhikṣor duṣṭhūlām āpattiṃ praticchādayet pāyantikā // //	yaḥ punar bhikṣuḥ jānan bhikṣoḥ duṣṭhūlām āpattim praticchādayet pāyantikā 
SA_K01_prmosufu-53	uddānaṃ sparśo jyotiś chando 'nupasaṃpādanena dharmavādī ca śramaṇoddeśo daurvarṇyaṃ ratnaparidāhasamayaś ca // //	uddānam sparśaḥ jyotiḥ chandaḥ n upasaṃpādanena dharma vādī ca śramaṇa uddeśaḥ daurvarṇyam ratna paridāha samayaḥ ca 
SA_K01_prmosufu-54	(PrMoSū-LCh)Pāy.51 yaḥ punar bhikṣur bhikṣum evaṃ vaded ehy āyuṣman kulāny upasaṃkramiṣyāvaḥ	yaḥ punar bhikṣuḥ bhikṣum evam vadet ehi āyuṣman kulāni upasaṃkramiṣyāvaḥ 
SA_K01_prmosufu-55	tatra te dāpayiṣyāmi praṇītaṃ khādanīyabhojanīyaṃ yāvad āpta sa tasyādāpayitvā tataḥ	tatra te dāpayiṣyāmi praṇītam khādanīya bhojanīyam yāvat āpta sa tasya ā dāpayitvā tatas 
SA_K01_prmosufu-56	paścād eva vaded gaccha tvam āyuṣman na cet tvayā sārdhaṃ sparśo bhavati kathāyāṃ	paścāt eva vadet gaccha tvam āyuṣman na ced tvayā sārdham sparśaḥ bhavati kathāyām 
SA_K01_prmosufu-57	vā niṣadyāyāṃ vā api tv ekākina eva me sparśo bhavati kathāyāṃ vā niṣadyāyāṃ vā ity	vā niṣadyāyām vā api tu ekākinaḥ eva me sparśaḥ bhavati kathāyām vā niṣadyāyām vā iti 
SA_K01_prmosufu-58	udyojanaprekṣī kaścid eṣa bhikṣur udyojito bhaviṣyatīty etad eva pratyayaṃ kṛtvā pāyantikā //	udyojana prekṣī kaścid eṣa bhikṣuḥ udyojitaḥ bhaviṣyati iti etat eva pratyayam kṛtvā pāyantikā 
SA_K01_prmosufu-59	(PrMoSū-LCh)Pāy.52 yaḥ punar bhikṣur ātmārtham aglāno vitapanaprekṣī jyotiḥ samavadadhyāt samavadhāpayed vā pāyantikā //	yaḥ punar bhikṣuḥ ātma artham a glānaḥ vitapana prekṣī jyotiḥ samavadadhyāt samavadhāpayet vā pāyantikā 
SA_K01_prmosufu-60	(PrMoSū-LCh)Pāy.53 yaḥ punar bhikṣur dhārmike saṃghakaraṇīye bhikṣoś chandaṃ datvā	yaḥ punar bhikṣuḥ dhārmike saṃgha karaṇīye bhikṣoḥ chandam da tvā 
SA_K01_prmosufu-61	paścād abhiṣaktaḥ kupitaś caṇḍībhūto nāttamanāḥ kṣepadharmam āpadyeta āhara bhikṣo	paścāt abhiṣaktaḥ kupitaḥ caṇḍībhūtaḥ na ātta manāḥ kṣepa dharmam āpadyeta āhara bhikṣo 
SA_K01_prmosufu-62	cchandaṃ na te dadāmīti pāyantikā //	chandam na te dadāmi iti pāyantikā 
SA_K01_prmosufu-63	(PrMoSū-LCh)Pāy.54 yaḥ punar bhikṣur anupasaṃpannena pudgalena sārdhaṃ dvirātrād ūrdhvaṃ sahāgāraśayyāṃ prakalpayet pāyantikā //	yaḥ punar bhikṣuḥ anupasaṃpannena pudgalena sārdham dvi rātrāt ūrdhvam sahāgāra śayyām prakalpayet pāyantikā 
SA_K01_prmosufu-64	(PrMoSū-LCh)Pāy.55 yaḥ punar bhikṣur evaṃ vadet tathāhaṃ bhagavato dharmaṃ deśitam	yaḥ punar bhikṣuḥ evam vadet tathā aham bhagavataḥ dharmam deśitam 
SA_K01_prmosufu-65	ājānāmi yathā ye āntarāyikā dharmā uktā bhagavatā tenāpratisevyamānā nālam antarāyāyeti	ājānāmi yathā ye āntarāyikāḥ dharmāḥ uktāḥ bhagavatā tena a pratisevyamānāḥ na alam antarāyāya iti 
SA_K01_prmosufu-66	sa bhikṣur bhikṣubhir idaṃ syād vacanīyo mā tvam āyuṣmann evaṃ vocas tathāhaṃ bhagavato	sa bhikṣuḥ bhikṣubhiḥ idam syāt vacanīyaḥ mā tvam āyuṣman evam vocaḥ tathā aham bhagavataḥ 
SA_K01_prmosufu-67	dharmaṃ deśitam ājānāmi yathā ye āntarāyikā dharmā uktā bhagavatā te ca pratisevyamānā	dharmam deśitam ājānāmi yathā ye āntarāyikāḥ dharmāḥ uktāḥ bhagavatā te ca pratisevyamānā 
SA_K01_prmosufu-68	nālam antarāyāyeti mā bhagavantam abhyācakṣu na sādhu bhavati bhagavato 'bhyākhyānaṃ	na alam antarāyāya iti mā bhagavantam abhyācakṣu na sādhu bhavati bhagavataḥ bhyākhyānam 
SA_K01_prmosufu-69	na ca punar bhagavān evam āha anekaparyāyeṇāyuṣmann āntarāyikā dharmāḥ santa āntarāyikā	na ca punar bhagavān evam āha aneka paryāyeṇa āyuṣman āntarāyikāḥ dharmāḥ santaḥ āntarāyikā 
SA_K01_prmosufu-70	evoktā bhagavatā te ca pratisevyamānā alam antarāyāyeti //	eva uktāḥ bhagavatā te ca pratisevyamānāḥ alam antarāyāya iti 
SA_K01_prmosufu-71	niḥsṛja tvam āyuṣmann idam evaṃrūpaṃ pāpakaṃ dṛṣṭigatam evaṃ cet sa bhikṣur bhikṣubhir	niḥsṛja tvam āyuṣman idam evaṃrūpam pāpakam dṛṣṭi gatam evam ced sa bhikṣuḥ bhikṣubhiḥ 
SA_K01_prmosufu-72	ucyamānas tad vastu pratiniḥsṛjed ity evaṃ kuśalaṃ no cet pratiniḥsṛjed dvir api	ucyamānaḥ tat vastu pratiniḥsṛjet iti evam kuśalam no ced pratiniḥsṛjet dvis api 
SA_K01_prmosufu-73	trir api samanuyoktavyaḥ samanuśāsitavyas tasya vastunaḥ pratiniḥsargāya dvir api	tris api samanuyoktavyaḥ samanuśāsitavyaḥ tasya vastunaḥ pratiniḥsargāya dvis api 
SA_K01_prmosufu-74	trir api samanuyujyamānaḥ samanuśiṣyamāṇas tad vastu pratiniḥsṛjed ity evaṃ kuśalaṃ	tris api samanuyujyamānaḥ samanuśiṣyamāṇaḥ tat vastu pratiniḥsṛjet iti evam kuśalam 
SA_K01_prmosufu-75	no cet pratiniḥsṛjet pāyantikā //	no ced pratiniḥsṛjet pāyantikā 
SA_K01_prmosufu-76	(PrMoSū-LCh)Pāy.56 yaḥ punar bhikṣur jānaṃs tathāvādinaṃ pudgalam akṛtānudharmāṇam	yaḥ punar bhikṣuḥ jānan tathāvādinam pudgalam a kṛta anudharmāṇam 
SA_K01_prmosufu-77	apratiniḥsṛṣṭe tasmin pāpake dṛṣṭigate ālapet saṃlapet saṃvaset saṃbhuṃjīta tena	a pratiniḥsṛṣṭe tasmin pāpake dṛṣṭi gate ālapet saṃlapet saṃvaset saṃbhuṃjīta tena 
SA_K01_prmosufu-78	vā sārdhaṃ sahāgāraśayyāṃ kalpayet pāyantikā //	vā sārdham saha āgāra śayyām kalpayet pāyantikā 
SA_K01_prmosufu-79	(PrMoSū-LCh)Pāy.57 śramaṇoddeśaś cāpy evaṃ vadet tathāhaṃ bhagavato dharmaṃ deśitam	śramaṇa uddeśaḥ ca api evam vadet tathā aham bhagavataḥ dharmam deśitam 
SA_K01_prmosufu-80	ājānāmi yathā ye āntarāyikāḥ kāmā uktā bhagavatā tena pratisevyamānā nālam antarāyāyeti	ājānāmi yathā ye āntarāyikāḥ kāmāḥ uktāḥ bhagavatā tena pratisevyamānāḥ na alam antarāyāya iti 
SA_K01_prmosufu-81	sa śramaṇoddeśo bhikṣubhir idaṃ syād vacanīyo mā tvam āyuṣmaṃ cchramaṇoddeśa evaṃ	sa śramaṇa uddeśaḥ bhikṣubhiḥ idam syāt vacanīyaḥ mā tvam āyuṣman śramaṇa uddeśe evam 
SA_K01_prmosufu-82	vocas tathāhaṃ bhagavato dharmaṃ deśitam ājānāmi yathā ye āntarāyikāḥ kāmā uktā bhagavatā	vocaḥ tathā aham bhagavataḥ dharmam deśitam ājānāmi yathā ye āntarāyikāḥ kāmāḥ uktāḥ bhagavatā 
SA_K01_prmosufu-83	pratisevyamānā nālam antarāyāyeti mā bhagavantam abhyācakṣu na sādhu bhavati bhagavato	pratisevyamānāḥ na alam antarāyāya iti mā bhagavantam abhyācakṣu na sādhu bhavati bhagavataḥ 
SA_K01_prmosufu-84	'bhyākhyānaṃ na ca punar bhagavān evam āha anekaparyāyeṇa ya ... āntarāyikāḥ kāmāḥ	abhyākhyānam na ca punar bhagavān evam āha aneka paryāyeṇa ye āntarāyikāḥ kāmāḥ 
SA_K01_prmosufu-85	santa āntarāyikā evoktā bhagavatā te ca pratisevyamānā alam antarāyāyeti niḥsṛja	santaḥ āntarāyikāḥ eva uktāḥ bhagavatā te ca pratisevyamānāḥ alam antarāyāya iti niḥsṛja 
SA_K01_prmosufu-86	tvam āyuṣmaṃ cchramaṇoddeśa idam evaṃrūpaṃ pāpakaṃ dṛṣṭigatam evaṃ cet sa śramaṇoddeśo	tvam āyuṣman śramaṇa uddeśaḥ idam evaṃrūpam pāpakam dṛṣṭi gatam evam ced sa śramaṇa uddeśaḥ 
SA_K01_prmosufu-87	bhikṣubhir ucyamānas tad vastu pratiniḥsṛjed ity evaṃ kuśalaṃ no cet pratiniḥsṛjed	bhikṣubhiḥ ucyamānaḥ tat vastu pratiniḥsṛjet iti evam kuśalam no ced pratiniḥsṛjet 
SA_K01_prmosufu-88	dvir api trir api samanuyoktavyaḥ samanuśāsitavyas tasya vastunaḥ pratiniḥsargāya	dvis api tris api samanuyoktavyaḥ samanuśāsitavyaḥ tasya vastunaḥ pratiniḥsargāya 
SA_K01_prmosufu-89	dvir api trir api samanuyujyamānaḥ samanuśiṣyamāṇas tad vastu pratiniḥsṛjed ity evaṃ	dvis api tris api samanuyujyamānaḥ samanuśiṣyamāṇaḥ tat vastu pratiniḥsṛjet iti evam 
SA_K01_prmosufu-90	kuśalaṃ no cet pratiniḥsṛjet sa śramaṇoddeśo bhikṣubhir idaṃ syād vacanīyaḥ adyāgreṇa	kuśalam no ced pratiniḥsṛjet sa śramaṇa uddeśaḥ bhikṣubhiḥ idam syāt vacanīyaḥ adya agreṇa 
SA_K01_prmosufu-91	te āyuṣmaṃ cchramaṇoddeśa nāsau bhagavāṃs tathāgato 'rhan samyaksaṃbuddhaḥ śāstā	te āyuṣman śramaṇa uddeśa na asau bhagavān tathāgataḥ rhan samyaksaṃbuddhaḥ śāstā 
SA_K01_prmosufu-92	vyapadeṣṭavyo nāpy anyatamānyatamo vijño gurusthānīyaḥ sabrahmacārī pṛṣṭhataḥ pṛṣṭhataḥ	vyapadeṣṭavyaḥ na api anyatama anyatamaḥ vijñaḥ guru sthānīyaḥ sabrahmacārī pṛṣṭhatas pṛṣṭhatas 
SA_K01_prmosufu-93	samanubaddhavyo yad apy anye śramaṇoddeśā labhante kaścid asya bhikṣor muhūrtam apy	samanubaddhavyaḥ yat api anye śramaṇa uddeśāḥ labhante kaścid asya bhikṣoḥ muhūrtam api 
SA_K01_prmosufu-94	asparśo bhaviṣyatīty etad eva pratyayaṃ kṛtvā pāyantikā //	asparśaḥ bhaviṣyati iti etat eva pratyayam kṛtvā pāyantikā 
SA_K01_prmosufu-95	{on p. 7 = FE 10.3-7, 9.1-3 again parts of Pāy. 57,	on p   fe   again parts of 
SA_K01_prmosufu-96	differs from labhante onwards:	differs from labhante onwards 
SA_K01_prmosufu-97	} labhante bhikṣubhiḥ sārdhaṃ dvirātraparamaṃ sahāgāraśayyāṃ sāpi te 'dyāgreṇa nāsti cara pareṇa mohapuruṣa naśya tvaṃ //	labhante bhikṣubhiḥ sārdham dvi rātra paramam saha āgāra śayyām sā api te dyā agreṇa na asti cara pareṇa moha puruṣa naśya tvam 
SA_K01_prmosufu-98	yaḥ punar bhikṣur jānaṃs tathānāśitaṃ śramaṇoddeśam upasthāpayed upalāḍayet tena vā sārdhaṃ sahāgāraśayyāṃ kalpayet pāyantikā //	yaḥ punar bhikṣuḥ jānan tathā anāśitam śramaṇa uddeśam upasthāpayet upalāḍayet tena vā sārdham saha āgāra śayyām kalpayet pāyantikā 
SA_K01_prmosufu-99	(PrMoSū-LCh)Pāy.58 na ca cīvarapratilambhād bhikṣuṇā trayāṇāṃ durvarṇīkaraṇānām anyatamānyatamad	na ca cīvara pratilambhāt bhikṣuṇā trayāṇām durvarṇīkaraṇānām anyatama anyatama d
SA_K01_prmosufu-100	durvarṇīkaraṇaṃ nīlaṃ vā kardamaṃ vā kaṣāyaṃ vā anādāya ced bhikṣus trayāṇāṃ durvarṇīkaraṇānām	durvarṇīkaraṇam nīlam vā kardamam vā kaṣāyam vā an ādāya ced bhikṣuḥ trayāṇām durvarṇīkaraṇānām 
SA_K01_prmosufu-101	anyatamānyatamaḥ durvarṇīkaraṇaṃ nīlaṃ vā kardamaṃ vā kaṣāyaṃ vā navaṃ cīvaraṃ paribhuṃjīta pāyantikā //	anyatama anyatamaḥ durvarṇīkaraṇam nīlam vā kardamam vā kaṣāyam vā navam cīvaram paribhuṃjīta pāyantikā 
SA_K01_prmosufu-102	(PrMoSū-LCh)Pāy.59 yaḥ punar bhikṣu ratnaṃ vā ratnasaṃmataṃ vā svahastam udgṛhṇīyād udgrāhayed vā anyatrādhyārāmagatād vā adhyāvāsagatād vā  #	yaḥ punar bhikṣu ratnam vā ratna saṃmatam vā sva hastam udgṛhṇīyāt udgrāhayet vā anyatra adhi ārāma gatāt vā adhyāvāsa gatāt vā 
SA_K01_prmosufu-103	pāyantikā //	pāyantikā 
SA_K01_prmosufu-104	adhyārāmagatena bhikṣu ... adhyāvāsa /// **************	adhyārāma gatena bhikṣu 
SA_K01_prmosufu-105	{text missing} **************	text missing 
SA_K01_prmosufu-106	(PrMoSū-LCh)Pāy.63 aṅgulipratodanāt pāyantikā //	aṅguli pratodanāt pāyantikā 
SA_K01_prmosufu-107	(PrMoSū-LCh)Pāy.64. udakaharṣaṇāt pāyantikā //	udaka harṣaṇāt pāyantikā 
SA_K01_prmosufu-108	(PrMoSū-LCh)Pāy.65 yaḥ punar bhikṣur mātṛgrāmeṇa sārdhaṃ sahāgāraśayyāṃ kalpayet pāyantikā //	yaḥ punar bhikṣuḥ mātṛgrāmeṇa sārdham saha āgāra śayyām kalpayet pāyantikā 
SA_K01_prmosufu-109	(PrMoSū-LCh)Pāy.66 yaḥ punar bhikṣur bhikṣuṃ bhīṣayed bhīṣāpayed vā anantato hāsyaprekṣy api pāyantikā //	yaḥ punar bhikṣuḥ bhikṣum bhīṣayet bhīṣāpayet vā anantataḥ hāsya prekṣī api pāyantikā 
SA_K01_prmosufu-110	(PrMoSū-LCh)Pāy.67 yaḥ punar bhikṣur bhikṣor vā bhikṣuṇyā vā śikṣamāṇāyā vā śrāmaṇerakasya	yaḥ punar bhikṣuḥ bhikṣoḥ vā bhikṣuṇyāḥ vā śikṣamāṇāyāḥ vā śrāmaṇerakasya 
SA_K01_prmosufu-111	vā śrāmaṇerikāyā vā pātraṃ vā cīvaraṃ vā śikyaṃ vā saritaṃ vā kāyabandhanaṃ vā anyatamānyatamaṃ	vā śrāmaṇerikāyāḥ vā pātram vā cīvaram vā śikyam vā saritam vā kāya bandhanam vā anyatama anyatamam 
SA_K01_prmosufu-112	vā śrāmaṇakaṃ jīvitapariṣkāram upanidadhyād upanidhāpayed vānyatra tadrūpāt pratyayāt pāyantikā //	vā śrāmaṇakam jīvita pariṣkāram upanidadhyāt upanidhāpayet vā anyatra tad rūpāt pratyayāt pāyantikā 
SA_K01_prmosufu-113	(PrMoSū-LCh)Pāy.68 yaḥ punar bhikṣur bhikṣoś cīvaram vā datvā tataḥ paścād apratyuddhārya paribhuṃjīta pāyantikā //	yaḥ punar bhikṣuḥ bhikṣoḥ cīvaram vā da tvā tatas paścāt a pratyuddhārya paribhuṃjīta 
SA_K01_prmosufu-114	(PrMoSū-LCh)Pāy.69 yaḥ punar bhikṣur dviṣṭo dveṣād apratītaḥ śuddhaṃ bhikṣum anāpannam amūlakena saṃghāvaśeṣeṇa dharmeṇānudhvaṃsayet pāyantikā	yaḥ punar bhikṣuḥ dviṣṭaḥ dveṣāt a pratītaḥ śuddham bhikṣum an āpannam amūlakena saṃgha avaśeṣeṇa dharmeṇa anudhvaṃsayet pāyantikā 
SA_K01_prmosufu-115	(PrMoSū-LCh)Pāy.70 yaḥ punar bhikṣur apuruṣayā striyā sārdham adhvānamārgaṃ pratipadyetāntato grāmāntaram api pāyantikā // //	yaḥ punar bhikṣuḥ apuruṣayā striyā sārdham adhvāna mārgam pratipadyeta antatas grāma antaram api pāyantikā 
SA_K01_prmosufu-116	uddānam* // steyonaviṃśati khanet pravāraṇā śikṣitavyaṃ kalahānāṃ tūṣṇīṃ viprakrāmed anādarāt surāpānam akāle ca // //	uddānam steya ūnaviṃśati khanet pravāraṇā śikṣitavyam kalahānām tūṣṇīm viprakrāmet anādarāt surā pānam akāle ca 
SA_K01_prmosufu-117	(PrMoSū-LCh)Pāy.71 yaḥ punar bhikṣuḥ steyasārthena sārdham adhvamārgaṃ pratipadyetāntato grāmāntaram api pāyantikā //	yaḥ punar bhikṣuḥ steya sārthena sārdham adhva mārgam pratipadyeta antatas grāma antaram api pāyantikā 
SA_K01_prmosufu-118	(PrMoSū-LCh)Pāy.72 yaḥ punar bhikṣur ūnaviṃśativarṣaṃ pudgalaṃ bhikṣubhāvāyopasaṃpādayet pāyantikā //	yaḥ punar bhikṣuḥ ūnaviṃśati varṣam pudgalam bhikṣu bhāvāya upasaṃpādayet pāyantikā 
SA_K01_prmosufu-119	sa ca pudgalo 'nupasaṃpannas te ca bhikṣavo garhyā ayaṃ tatra samayaḥ //	sa ca pudgalaḥ n upasaṃpannaḥ te ca bhikṣavaḥ garhyāḥ ayam tatra samayaḥ 
SA_K01_prmosufu-120	(PrMoSū-LCh)Pāy.73 yaḥ punar bhikṣuḥ svahastaṃ pṛthivīṃ khanet khānayed vā pāyantikā //	yaḥ punar bhikṣuḥ sva hastam pṛthivīm khanet khānayet vā 
SA_K01_prmosufu-121	(PrMoSū-LCh)Pāy.74 cāturmāsikī bhikṣuṇā pravāraṇā svīkartavyā anyatra samayāt pāyantikā //	cāturmāsikī bhikṣuṇā pravāraṇā svīkartavyā anyatra samayāt pāyantikā 
SA_K01_prmosufu-122	tatrāyaṃ samayaḥ pratyekapratyekapravāraṇā punaḥ punaḥ pravāraṇā atyarthapravāraṇā nityapravāraṇā ayaṃ tatra samayaḥ //	tatra ayam samayaḥ pratyeka pratyeka pravāraṇā punar punar pravāraṇā atyartha pravāraṇā nitya pravāraṇā ayam tatra samayaḥ 
SA_K01_prmosufu-123	(PrMoSū-LCh)Pāy.75 yaḥ punar bhikṣur bhikṣubhir ucyamāno syāt te āyuṣmaṃ cchikṣāyāṃ	yaḥ punar bhikṣuḥ bhikṣubhiḥ ucyamānaḥ syāt te āyuṣman śikṣāyām 
SA_K01_prmosufu-124	śikṣitavyaṃ sa evaṃ vaden nāhaṃ yuṣmākaṃ bālānāṃ mūḍhānām avyaktānām akuśalānāṃ vacanenāsyāṃ	śikṣitavyam saḥ evam vadet na aham yuṣmākam bālānām mūḍhānām avyaktānām akuśalānām vacanena asyām 
SA_K01_prmosufu-125	śikṣāyāṃ śikṣiṣye yāvan nāham anyān bhikṣūn prakṣyāmi sūtradharān vinayadharān mātṛkādharān iti pāyantikā //	śikṣāyām śikṣiṣye yāvat na aham anyān bhikṣūn prakṣyāmi sūtradharān vinaya dharān mātṛkādharān iti pāyantikā 
SA_K01_prmosufu-126	ājñātukāmena bhikṣuṇā tasyāṃ ca śikṣāyāṃ śikṣitavyaṃ bhikṣavaḥ praṣṭavyāḥ sūtradharā vinayadharā mātṛkādharā ayaṃ tatra samayaḥ //	ājñātu kāmena bhikṣuṇā tasyām ca śikṣāyām śikṣitavyam bhikṣavaḥ praṣṭavyāḥ sūtra dharāḥ vinaya dharāḥ mātṛkā dharāḥ ayam tatra samayaḥ 
SA_K01_prmosufu-127	(PrMoSū-LCh)Pāy 76 yaḥ punar bhikṣur bhikṣūṇāṃ kalahajātānāṃ viharatāṃ bhaṇḍanajātānāṃ	yaḥ punar bhikṣuḥ bhikṣūṇām kalaha jātānām viharatām bhaṇḍana jātānām 
SA_K01_prmosufu-128	vigṛhītānāṃ vivādam āpannānāṃ tūṣṇīm aupaśrutikayā tiṣṭhed yad ete bhikṣavo vakṣyanti	vigṛhītānām vivādam āpannānām tūṣṇīm aupaśrutikayā tiṣṭhet yat ete bhikṣavaḥ vakṣyanti 
SA_K01_prmosufu-129	tad ahaṃ śrutvā tathā tathānuvyahariṣyāmīty etad eva pratyayaṃ kṛtvā pāyantikā //	tat aham śrutvā tathā tathā anuvyahariṣyāmi iti etat eva pratyayam kṛtvā pāyantikā 
SA_K01_prmosufu-130	(PrMoSū-LCh)Pāy.77 yaḥ punar bhikṣuḥ saṃghasya dharmyāyāṃ viniścayakathāyāṃ kathyamānāyāṃ tūṣṇīṃ viprakrāmet santaṃ bhikṣum anavalokyānyatra  #	yaḥ punar bhikṣuḥ saṃghasya dharmyāyām viniścaya kathāyām kathyamānāyām tūṣṇīm viprakrāmet santam bhikṣum an avalokya anyatra 
SA_K01_prmosufu-131	tadrūpāt pratyayāt pāyantikā //	tad rūpāt pratyayāt pāyantikā 
SA_K01_prmosufu-132	(PrMoSū-LCh)Pāy.78 anādarāt pāyantikā //	an ādarāt pāyantikā 
SA_K01_prmosufu-133	(PrMoSū-LCh)Pāy.79 surāmaireyamadyapānāt pāyantikā //	          
SA_K01_prmosufu-134	(PrMoSū-LCh)Pāy.80 yaḥ punar bhikṣur akāle grāmaṃ praviśet santaṃ bhikṣum anavalokyānyatra tadrūpāt pratyayāt pāyantikā // ṛ //	yaḥ punar bhikṣuḥ akāle grāmam praviśet santam bhikṣum an avalokya anyatra tad rūpāt pratyayāt 
SA_K01_prmosufu-135	uddānam* sabhojane 'ruṇe dānīṃ sūcīgṛhakapādakāḥ nahyān niṣadanaṃ kaṇḍū śāṭī sugatacīvaraṃ // ṛ //	uddānam sa bhojane dānīm sūcīgṛhaka pādakāḥ nahyāt niṣadanam śāṭī sugata cīvaram 
SA_K01_prmosufu-136	(PrMoSū-LCh)Pāy.81 yaḥ punar bhikṣuḥ sabhojane kule upanimantritaḥ pūrvabhaktaṃ paścādbhaktaṃ	yaḥ punar bhikṣuḥ sa bhojane kule upanimantritaḥ pūrva bhaktam paścādbhaktam 
SA_K01_prmosufu-137	kuleṣu cāritram āpadyeta santaṃ gṛhiṇam anavalokyānyatra tadrūpāt pratyayāt pāyantikā //	kuleṣu cāritram āpadyeta santam gṛhiṇam an avalokya anyatra tad rūpāt pratyayāt pāyantikā 
SA_K01_prmosufu-138	(PrMoSū-LCh)Pāy.82 yaḥ punar bhikṣur anirgatāyāṃ rajanyām anudgate 'ruṇe anirhṛteṣu	yaḥ punar bhikṣuḥ a nirgatāyām rajanyām an udgate ruṇe a nirhṛteṣu 
SA_K01_prmosufu-139	ratneṣu vā ratnasaṃmateṣu vā rājñaḥ kṣatriyasya mūrdhābhiṣiktasyaindrakīlaṃ vā indrakīlasāmantakaṃ vā samabhiḥ ///	ratneṣu vā ratna saṃmateṣu vā rājñaḥ kṣatriyasya mūrdhābhiṣiktasya aindrakīlam vā indrakīla sāmantakam vā 
SA_K01_prmosufu-140	Pay.Schl. pariśuddhā atrāyuṣmanto yasmāt tuṣṇīm evam etad dhārayāmi // //	pariśuddhāḥ atra āyuṣmantaḥ yasmāt tuṣṇīm evam etat dhārayāmi 
SA_K01_prmosufu-141	uddānam // grāmam antargṛhaṃ caiva śaikṣāṇy āraṇyakena ca prātideśyāni coktāni buddhena hitavādinā // //	uddānam grāmam antargṛham ca eva śaikṣāṇi āraṇyakena ca prātideśyāni ca uktāni buddhena hita vādinā 
SA_K01_prmosufu-142	ime punar āyuṣmantaś catvāraḥ pratideśanīyā dharmā anvardhamāsaṃ prātimokṣasūtroddeśam āgacchanti	ime punar āyuṣmantaḥ catvāraḥ pratideśanīyāḥ dharmāḥ anvardha māsam prātimokṣa sūtra uddeśam āgacchanti 
SA_K01_prmosufu-143	(PrMoSū-LCh)Pratid.1 yaḥ punar bhikṣur ajñātikāyā bhikṣuṇyā rathyāgatāyā grāmaṃ piṇḍāya	yaḥ punar bhikṣuḥ ajñātikāyāḥ bhikṣuṇyāḥ rathyā gatāyāḥ grāmam piṇḍāya 
SA_K01_prmosufu-144	carantyā antikāt svahastaṃ khādanīyabhojanīyaṃ pratigṛhya khāded bhuñjīta vā tena	carantyāḥ antikāt sva hastam khādanīya bhojanīyam pratigṛhya khādet bhuñjīta vā tena 
SA_K01_prmosufu-145	bhikṣuṇā bahir ārāmaṃ gatvā bhikṣūṇām antike pratideśayitavyam garhyam asmy āyuṣmantaḥ	bhikṣuṇā bahis ārāmam gatvā bhikṣūṇām antike pratideśayitavyam garhyam asmi āyuṣmantaḥ 
SA_K01_prmosufu-146	sthānam āpanno 'sātmyaṃ pratideśanīyaṃ taṃ dharmaṃ pratideśayāmy ayaṃ dharmaḥ pratideśanīyaḥ //	sthānam āpanno sātmyam pratideśanīyam tam dharmam pratideśayāmi ayam dharmaḥ pratideśanīyaḥ 
SA_K01_prmosufu-147	(PrMoSū-LCh)Pratid.2 bhikṣavaḥ khalu saṃbahulāḥ kuleṣūpanimantritā bhuṃja tatra ced	bhikṣavaḥ khalu saṃbahulāḥ kuleṣu upanimantritāḥ tatra ced 
SA_K01_prmosufu-148	bhikṣuṇī vyapadiśati sthitā syād iha khādyakaṃ dehi iha odanaṃ dehi iha sūpikaṃ dehi	bhikṣuṇī vyapadiśati sthitā syāt iha khādyakam dehi iha odanam dehi iha sūpikam dehi 
SA_K01_prmosufu-149	iha bhūyo dehīti sā bhikṣuṇī tair bhikṣubhir idaṃ syād vacanīyā āgamaya tāvat tvaṃ	iha bhūyaḥ dehi iti sā bhikṣuṇī taiḥ bhikṣubhiḥ idam syāt vacanīyā āgamaya tāvat tvam 
SA_K01_prmosufu-150	bhagini muhūrtaṃ tūṣṇī yāvad ime bhikṣavo bhuṃjate ekabhikṣor api cen na pratibhāyantāṃ	bhagini muhūrtam tūṣṇī yāvat ime bhikṣavaḥ bhuṃjate ekabhikṣoḥ api ced na pratibhāyantām 
SA_K01_prmosufu-151	bhikṣuṇīm evaṃ vaktuṃ sarvais tair bhikṣubhir idaṃ syād vacanīya bahir ārāmaṃ gatvā	bhikṣuṇīm evam vaktum sarvaiḥ taiḥ bhikṣubhiḥ idam syāt bahis ārāmam gatvā 
SA_K01_prmosufu-152	bhikṣūṇām antike pratideśayitavyaṃ garhyaṃ vayam āyuṣmantaḥ sthānam āpannā āsātmyaṃ	bhikṣūṇām antike pratideśayitavyam garhyam vayam āyuṣmantaḥ sthānam āpannāḥ ā sātmyam 
SA_K01_prmosufu-153	pratideśanīyaṃ dharmaṃ pratideśayāmo 'yam api dharmaḥ pratideśanīyaḥ	pratideśanīyam dharmam pratideśayāmaḥ yam api dharmaḥ pratideśanīyaḥ 
SA_K01_prmosufu-154	(PrMoSū-LCh)Pratid.3 yāni tāni saṃghasya śaikṣāṇi kulāni bhavanti śikṣāsaṃvṛtisaṃmatāni //	yāni tāni saṃghasya śaikṣāṇi kulāni bhavanti śikṣā saṃvṛti saṃmatāni 
SA_K01_prmosufu-155	yaḥ punar bhikṣus tadrūpeṣu saṃghasya śaikṣeṣu kuleṣu śikṣāsaṃvṛtisaṃmateṣu pūrvam	yaḥ punar bhikṣuḥ tad rūpeṣu saṃghasya śaikṣeṣu kuleṣu śikṣā saṃvṛti saṃmateṣu pūrvam 
SA_K01_prmosufu-156	apravāritaḥ san upasaṃkramya svahastaṃ khādanīyabhojanīyaṃ pratigṛhya khāded bhuṃjīta	a pravāritaḥ san upasaṃkramya sva hastam khādanīya bhojanīyam pratigṛhya khādet bhuṃjīta 
SA_K01_prmosufu-157	vā tena bhikṣuṇā bahir ārāmaṃ gatvā bhikṣūṇām antike pratideśayitavyaṃ garhyam asmy	vā tena bhikṣuṇā bahis ārāmam gatvā bhikṣūṇām antike pratideśayitavyam garhyam asmi 
SA_K01_prmosufu-158	āyuṣmantaḥ sthānam āpanno 'sātmyaṃ pratideśanīyaṃ taṃ dharmaṃ pratideśayāmy ayam	āyuṣmantaḥ sthānam āpanno sātmyam pratideśanīyam tam dharmam pratideśayāmi ayam 
SA_K01_prmosufu-159	api dharmaḥ pratideśanīyaḥ	api dharmaḥ pratideśanīyaḥ 
SA_K01_prmosufu-160	(PrMoSū-LCh)Pratid.4 yāni tāni saṃghasyāraṇyakāni śayanāsanāni bhavanti sāśaṃkasaṃmatāni sabhayasaṃmatāni sapratibhayabhairavasaṃmatāni //	yāni tāni saṃghasya āraṇyakāni śayanāsanāni bhavanti sa āśaṃka saṃmatāni sa bhaya saṃmatāni sa pratibhaya bhairava saṃmatāni 
SA_K01_prmosufu-161	yaḥ punar bhikṣus tadrūpeṣu saṃghasyāraṇyakeṣu śayanāsaneṣu sāśaṃkasaṃmateṣu sabhayasaṃmateṣu	yaḥ punar bhikṣuḥ tad rūpeṣu saṃghasya āraṇyakeṣu śayanāsaneṣu sa āśaṃka saṃmateṣu sa bhaya saṃmateṣu 
SA_K01_prmosufu-162	sapratibhayabhairavasaṃmateṣu sarvam apratisaṃvidite vane bahir ārāmasya khādanīyabhojanīyaṃ	sa pratibhaya bhairava saṃmateṣu sarvam a pratisaṃvidite vane bahis ārāmasya khādanīya bhojanīyam 
SA_K01_prmosufu-163	pratigṛhyānte ārāmasya khāded bhuṃjīta vā tena bhikṣuṇā bhikṣūṇām antike pratideśayitavyaṃ	pratigṛhya ante ārāmasya khādet bhuṃjīta vā tena bhikṣuṇā bhikṣūṇām antike pratideśayitavyam 
SA_K01_prmosufu-164	garhyam asmy āyuṣmantaḥ sthānam āpanno 'sātmyaṃ pratideśanīyaṃ taṃ dharmaṃ pratideśayāmy	garhyam asmi āyuṣmantaḥ sthānam āpanno sātmyam pratideśanīyam tam dharmam pratideśayāmi 
SA_K01_prmosufu-165	ayam api dharmaḥ pratideśanīyaḥ //	ayam api dharmaḥ pratideśanīyaḥ 
SA_K01_prmosufu-166	uddiṣṭā me āyuṣmantaś catvāraḥ pratideśanīyā dharmās tatrāham āyuṣmantaḥ paripṛcchāmi	uddiṣṭāḥ me āyuṣmantaḥ catvāraḥ pratideśanīyāḥ dharmāḥ tatra aham āyuṣmantaḥ paripṛcchāmi 
SA_K01_prmosufu-167	kaccit sthātra pariśuddhāḥ dvir api trir api paripṛcchāmi kaccit sthātra pariśuddhāḥ	kaccit stha atra pariśuddhāḥ dvis api tris api paripṛcchāmi kaccit stha atra pariśuddhāḥ 
SA_K01_prmosufu-168	pariśuddhā atrāyuṣmanto yasmāt tūṣṇīm evam etad dhārayāmi // //	pariśuddhāḥ atra āyuṣmantaḥ yasmāt tūṣṇīm evam etat dhārayāmi 
SA_K01_prmosufu-169	uddānaṃ // nivāsanena sapta syus trayaś copari cīvare saṃvṛtodguṇṭhikollaṃghikayā kāyena + + + // //	uddānam nivāsanena sapta syuḥ trayaḥ ca upari cīvare saṃvṛta udguṇṭhikā ullaṃghikayā kāyena       
SA_K01_prmosufu-170	ime khalv āyuṣmantaḥ saṃbahulāḥ śaikṣā dharmā anvardhamāsaṃ prātimokṣasūtroddeśam āgacchanti //	ime khalu āyuṣmantaḥ saṃbahulāḥ śaikṣāḥ dharmāḥ anvardha māsam prātimokṣa sūtra uddeśam āgacchanti 
SA_K01_prmosufu-171	(PrMoSū-LCh)Śai.1 parimaṇḍalaṃ nivāsanaṃ nivāsayiṣyāma iti śikṣā karaṇīyā //	parimaṇḍalam nivāsanam nivāsayiṣyāmaḥ iti śikṣā karaṇīyā 
SA_K01_prmosufu-172	(PrMoSū-LCh)Śai.2-7 nātyutkṛṣṭaṃ nātyapakṛṣṭaṃ na hastiśuṇḍakaṃ na tālavṛndakaṃ na kulmāṣapiṇḍakaṃ na nāgaśīrṣakaṃ nivāsanaṃ nivāsayiṣyāma  #	na ati utkṛṣṭam na ati apakṛṣṭam na hasti śuṇḍakam na tāla vṛndakam na kulmāṣa piṇḍakam na nāgaśīrṣakam nivāsanam nivāsayiṣyāma 
SA_K01_prmosufu-173	iti śikṣā karaṇīyā //	iti śikṣā karaṇīyā 
SA_K01_prmosufu-174	(PrMoSū-LCh)Śai.8 parimaṇḍalaṃ cīvaraṃ prāvariṣyāma iti śikṣā karaṇīyā //	parimaṇḍalam cīvaram prāvariṣyāmaḥ iti śikṣā karaṇīyā 
SA_K01_prmosufu-175	(PrMoSū-LCh)Śai.9-10 nātyutkṛṣṭaṃ nātyapakṛṣṭaṃ cīvaraṃ prāvariṣyāma iti śikṣā karaṇīyā //	na ati utkṛṣṭam na ati apakṛṣṭam cīvaram prāvariṣyāmaḥ iti śikṣā karaṇīyā 
SA_K01_prmosufu-176	(PrMoSū-LCh)Śai.11-15 susaṃvṛtā supraticchannā alpaśabdā anutkṣiptacakṣuṣo yugamātradarśino 'ntargṛhaṃ gamiṣyāma iti śikṣā karaṇīyā //	su saṃvṛtā su praticchannā alpa śabdāḥ an utkṣipta cakṣuṣaḥ yuga mātra darśinaḥ ntargṛham gamiṣyāmaḥ iti śikṣā karaṇīyā 
SA_K01_prmosufu-177	(PrMoSū-LCh)Śai.16-20 nodguṇṭhikā notkṛṣṭikayā notsaktikayā na vyastikayā na paryastikayā antargṛhaṃ gamiṣyāma iti śikṣā karaṇīyā //	na udguṇṭhikā na utkṛṣṭikayā na utsaktikayā na vyastikayā na paryastikayā antargṛham gamiṣyāmaḥ iti śikṣā karaṇīyā 
SA_K01_prmosufu-178	(PrMoSū-LCh)Śai.21-25 nollaṃghikayā nojjaṃghikayā notkuṭukikayā na nikuṭotkuṭukikayā na khaṃbhākṛtā antargṛhaṃ gamiṣyāma iti śikṣā karaṇīyā	na ullaṃghikayā na ujjaṃghikayā na utkuṭukikayā na nikuṭa utkuṭukikayā na khaṃbhā kṛtāḥ antargṛham gamiṣyāmaḥ iti śikṣā karaṇīyā 
SA_K01_prmosufu-179	(PrMoSū-LCh)Śai.26-30 na kāyapracālakaṃ na bāhupracālakaṃ na śīrṣapracālakaṃ nāṃsotḍhaukikayā na hastasaṃlagnikayā antargṛhaṃ gamiṣyāma iti  #	na kāya pracālakam na bāhu pracālakam na śīrṣa pracālakam na aṃsa utḍhaukikayā na hasta saṃlagnikayā antargṛham gamiṣyāmaḥ iti 
SA_K01_prmosufu-180	śikṣā karaṇīyā // //	śikṣā karaṇīyā 
SA_K01_prmosufu-181	uddānaṃ kuryān na viniṣatsyāmīty aṣṭau cāpi pratigrahe paṃca catus sapta paṃca satkṛtyādi tu bhojane // //	uddānam kuryāt na viniṣatsyāmi iti aṣṭau ca api pratigrahe paṃca catuḥ sapta paṃca satkṛtya ādi tu bhojane 
SA_K01_prmosufu-182	(PrMoSū-LCh)Śai.31 nānanujñātā antargṛhe āsane niṣatsyāma iti śikṣā karaṇīyā //	na ananujñātāḥ antargṛhe āsane niṣatsyāmaḥ iti śikṣā karaṇīyā 
SA_K01_prmosufu-183	(PrMoSū-LCh)Śai.32-39 nāpratyavekṣyāsanaṃ sarvakāyaṃ samavadhāya na pāde pādam ādhāya	na a pratyavekṣya āsanam sarva kāyam samavadhāya na pāde pādam ādhāya 
SA_K01_prmosufu-184	na gulphe gulpham ādhāya na sakthani sakthi ādhāya na saṃkṣipya pādau na vikṣipya	na gulphe gulpham ādhāya na sakthani sakthi ādhāya na saṃkṣipya pādau na vikṣipya 
SA_K01_prmosufu-185	pādau na viḍaṃgikayā antargṛha āsane niṣatsyāma iti śikṣā karaṇīyā //	pādau na viḍaṃgikayā antargṛha āsane niṣatsyāmaḥ iti śikṣā karaṇīyā 
SA_K01_prmosufu-186	(PrMoSū-LCh)Śai.40 satkṛtya piṇḍapātaṃ pratigrahīṣyāma iti śikṣā karaṇīyā //	satkṛtya piṇḍapātam pratigrahīṣyāmaḥ iti śikṣā karaṇīyā 
SA_K01_prmosufu-187	(PrMoSū-LCh)Śai.41-43 na samatittikaṃ samasūpikaṃ sāvadānaṃ pātrasaṃjñinaṃ piṇḍapātaṃ pratigrahīṣyāma iti śikṣā karaṇīyā //	na sama tittikam sama sūpikam sa avadānam pātra saṃjñinam piṇḍapātam pratigrahīṣyāmaḥ iti śikṣā karaṇīyā 
