segmentnr	original	analyzed
SA_K01_prmosulu-0	Prātimokṣasūtram*	prātimokṣasūtram 
SA_K01_prmosulu-1	namo bhagavate vītarāgāya /	namaḥ bhagavate vīta rāgāya 
SA_K01_prmosulu-2	narendradevendrasuvanditena trilokavighuṣṭaviśālakīrtinā /	                                    
SA_K01_prmosulu-3	buddhena lokārthacareṇa tāyinā sudeśitaṃ prātimokṣaṃ vidunā // 1 //	buddhena loka artha careṇa tāyinā su deśitam prātimokṣam vidunā 
SA_K01_prmosulu-4	taṃ prātimokṣaṃ bhavaduḥkhamokṣaṃ śrutvāna dhīrāḥ sugatasya bhāṣitaṃ /	tam prātimokṣam bhava duḥkha mokṣam dhīrāḥ sugatasya bhāṣitam 
SA_K01_prmosulu-5	ṣaḍindriyasaṃvarasaṃvṛtatvāt karonti jātīmaraṇasya antaṃ // 2 //	ṣaṣ indriya saṃvara saṃvṛta tvāt karonti jātī maraṇasya antam 
SA_K01_prmosulu-6	cirasya labdhvā ratanāni trīṇi buddhotpādaṃ mānuṣikāñ ca śraddhāṃ /	cirasya labdhvā ratanāni trīṇi buddha utpādam mānuṣikām ca śraddhām 
SA_K01_prmosulu-7	dauḥśīlyavadyaṃ parivarjayitvā viśuddhaśīlā bhavathāpramattāḥ // 3 //	dauḥśīlya vadyam parivarjayitvā viśuddha śīlāḥ bhavatha apramattāḥ 
SA_K01_prmosulu-8	śīlena yukto śramaṇo 'tiveti śīlena yukto brāhmaṇo 'tiveti /	śīlena yuktaḥ śramaṇaḥ tivā iti śīlena yuktaḥ brāhmaṇaḥ tivā iti 
SA_K01_prmosulu-9	śīlena yukto naradevapūjyo śīlena yuktasya hi prātimokṣaṃ // 4 //	śīlena yuktaḥ śīlena yuktasya hi 
SA_K01_prmosulu-10	anekabuddhānumataṃ viśuddhaṃ śīlaṃ pratiṣṭhā dharaṇīva sānuṃ /	aneka buddha anumatam viśuddham śīlam pratiṣṭhā dharaṇī iva sānum 
SA_K01_prmosulu-11	udāhariṣyāmy ahaṃ saṃghamadhye hitāya lokasya sadevakasya // 5 //	udāhariṣyāmi aham saṃgha madhye hitāya lokasya sa devakasya 
SA_K01_prmosulu-12	[iti] upodghātaḥ //	iti upodghātaḥ 
SA_K01_prmosulu-13	kiṃ jīvitena teṣāṃ yeṣām ihākuśalamūlajālāni /	kim jīvitena teṣām yeṣām iha akuśala mūla jālāni 
SA_K01_prmosulu-14	pracchādayanti hṛdayaṃ gaganam iva samunnatā meghāḥ //	pracchādayanti hṛdayam gaganam iva samunnatāḥ meghāḥ 
SA_K01_prmosulu-15	atijīvitaṃ ca teṣāṃ yeṣām ihākuśalamūlajālāni /	ati jīvitam ca teṣām yeṣām iha akuśala mūla jālāni 
SA_K01_prmosulu-16	vilayaṃ vrajanti kṣipraṃ divasakarahatāndhakāram iva // 6-7 //	vilayam vrajanti kṣipram divasakara hata andhakāram iva 
SA_K01_prmosulu-17	kiṃ poṣadhena teṣāṃ ye te sāvadyaśīlacaritrāḥ /	kim poṣadhena teṣām ye te sāvadya śīla caritrāḥ 
SA_K01_prmosulu-18	jarāmaraṇapañjaragatā amaravitarkehi khādyanti //	jarā maraṇa pañjara gatāḥ amara vitarkehi khādyanti 
SA_K01_prmosulu-19	kāryaṃ ca poṣadhena teṣāṃ ye te anavadyaśīlacāritrāḥ /	kāryam ca poṣadhena teṣām ye te anavadya śīla cāritrāḥ 
SA_K01_prmosulu-20	jarāmaraṇāntakarā mārabalapramardanā dhīrāḥ // 8-9 //	jarā maraṇa anta karāḥ māra bala pramardanāḥ dhīrāḥ 
SA_K01_prmosulu-21	kiṃ poṣadhena teṣām alajjināṃ bhinnavṛttaśīlānāṃ /	kim poṣadhena teṣām a lajjinām bhinna vṛtta śīlānām 
SA_K01_prmosulu-22	mithyājīvaratānām asaraṇam iva carantānāṃ //	mithyā jīva ratānām a saraṇam iva carantānām 
SA_K01_prmosulu-23	kāryaṃ ca poṣadhena teṣāṃ lajjinām abhinnavṛttaśīlānāṃ /	kāryam ca poṣadhena teṣām lajjinām abhinna vṛtta śīlānām 
SA_K01_prmosulu-24	samyagjīvaratānām adhyāśayaśuddhaśīlānāṃ // 10-11 //	samyak jīva ratānām adhyāśaya śuddha śīlānām 
SA_K01_prmosulu-25	kiṃ poṣadhena teṣāṃ ye te duḥśīlapāpakarmāntāḥ /	kim poṣadhena teṣām ye te duḥśīla pāpa karmāntāḥ 
SA_K01_prmosulu-26	kuṇapam iva samudrato samutkṣiptāḥ śāstu prāvacanāt //	kuṇapam iva samudrato samutkṣiptāḥ śāstu prāvacanāt 
SA_K01_prmosulu-27	kāryaṃ ca poṣadhena teṣāṃ ye te traidhātuke anupaliptāḥ /	kāryam ca poṣadhena teṣām ye te traidhātuke an upaliptāḥ 
SA_K01_prmosulu-28	ākāśe viya pāṇi śuddhānāṃ vimuktacittānāṃ // 12-13 //	ākāśe śuddhānām vimukta cittānām 
SA_K01_prmosulu-29	kiṃ poṣadhena teṣāṃ ṣaḍindriyaṃ yehi yehi surakṣitaṃ nityaṃ /	kim poṣadhena teṣām ṣaṣ indriyam yehi yehi su rakṣitam nityam 
SA_K01_prmosulu-30	patitānāṃ māraviṣaye svagocaraṃ varjayantānāṃ //	patitānām māra viṣaye sva gocaram 
SA_K01_prmosulu-31	kāryaṃ ca poṣadhena teṣāṃ ṣaḍindriyaṃ yehi surakṣitaṃ nityaṃ /	kāryam ca poṣadhena teṣām ṣaṣ indriyam su rakṣitam nityam 
SA_K01_prmosulu-32	yuktānāṃ śāstur vacane jinavacane śāsanaratānāṃ // 14-15 //	yuktānām śāstuḥ vacane jina vacane śāsana ratānām 
SA_K01_prmosulu-33	kiṃ poṣadhena teṣām ātmaśīlehi ye hy upavadanti /	kim poṣadhena teṣām ye hi upavadanti 
SA_K01_prmosulu-34	sabrahmacāriṇaś ca śastā devamanuṣyāś ca duḥśīlāḥ //	sabrahmacāriṇaḥ ca śastāḥ deva manuṣyāḥ ca duḥśīlāḥ 
SA_K01_prmosulu-35	kāryaṃ ca poṣadhena teṣāṃ śīlehi nāsti gārhyaṃ /	kāryam ca poṣadhena teṣām śīle hi na asti gārhyam 
SA_K01_prmosulu-36	sarvatra nopavadyā vijñānāṃ vai sadevake loke // 16-17 //	sarvatra na upavadyā vijñānām vai sa devake loke  /
SA_K01_prmosulu-37	kiṃ poṣadhena teṣāṃ virāgitaṃ śāstuḥ śāsanaṃ yehi /	kim poṣadhena teṣām virāgitam śāstuḥ śāsanam yehi 
SA_K01_prmosulu-38	āsevitā ca yehi vipattīyo pañca cāpattīḥ //	āsevitā ca pañca ca āpattīḥ 
SA_K01_prmosulu-39	kāryaṃ ca poṣadhena teṣāṃ yuktānāṃ śāsane daśabalasya /	kāryam ca poṣadhena teṣām yuktānām śāsane daśabalasya 
SA_K01_prmosulu-40	sarvajñasya sarvadarśino maitrīpadā yehi paricīrṇāḥ // 18-19 //	sarvajñasya sarva darśinaḥ maitrī padāḥ paricīrṇāḥ 
SA_K01_prmosulu-41	yeṣāṃ ca vasati hṛdaye śāstā dharmo gaṇottamo /	yeṣām ca vasati hṛdaye śāstā dharmaḥ 
SA_K01_prmosulu-42	śikṣā uddeśo saṃvāso saṃbhogo śāstuno vacanaṃ //	śikṣā uddeśaḥ saṃvāsaḥ saṃbhogaḥ śāstunaḥ vacanam 
SA_K01_prmosulu-43	teṣām upoṣadho 'dya aparityaktāni yehi etāni /	teṣām a parityaktāni etāni 
SA_K01_prmosulu-44	paricarya dharmarājaṃ te yānti asaṃskṛtaṃ sthānaṃ // 20-21 //	paricarya dharmarājam te yānti asaṃskṛtam sthānam 
SA_K01_prmosulu-45	śuddhasya vai sadā phalguḥ sadā śuddhasya poṣadho /	śuddhasya vai sadā phalguḥ sadā śuddhasya poṣadho 
SA_K01_prmosulu-46	śuddhasya śucikarmasya sadā sampadyate vrataṃ // 22 //	śuddhasya śuci karmasya sadā sampadyate vratam 
SA_K01_prmosulu-47	yāvat sūtrapratikṣepo gaṇamadhye na bheṣyati /	yāvat sūtra pratikṣepaḥ gaṇa madhye na 
SA_K01_prmosulu-48	tāvat sthāsyati saddharmo sāmagrī ca gaṇottame // 23 //	tāvat sthāsyati sāmagrī ca gaṇa uttame 
SA_K01_prmosulu-49	yāvac ca deśayitāraḥ pratipattāraś ca dharmaratnasya /	yāvat ca deśayitāraḥ pratipattāraḥ ca dharma ratnasya 
SA_K01_prmosulu-50	tāvat sthāsyati saddharmmo hitāya sarvalokasya // 24 //	tāvat sthāsyati saddharmmaḥ hitāya sarva lokasya 
SA_K01_prmosulu-51	tasmāt samagrāḥ sahitāḥ sagauravāḥ bhaviyā anyamanyaṃ paricaratha /	tasmāt samagrāḥ sahitāḥ sa gauravāḥ anyam anyam paricaratha 
SA_K01_prmosulu-52	dharmarājam adhigacchatha nirvāṇam atandritā acyutam padam aśokam iti // 25 //	dharmarājam adhigacchatha nirvāṇam atandritāḥ acyutam padam aśokam iti 
SA_K01_prmosulu-53	(iti) vastu /	iti vastu 
SA_K01_prmosulu-54	PrMoSū(Mā-L)Einl. abhikrāntāḥ suvihitāḥ śuddhā nipuṇā anusaṅgāyanto upaniṣaṇṇā,	abhikrāntāḥ su vihitāḥ śuddhāḥ nipuṇāḥ upaniṣaṇṇā 
SA_K01_prmosulu-55	cāritāḥ śalākā,	cāritāḥ śalākā 
SA_K01_prmosulu-56	gaṇitā bhikḥū sīmāprāptā ettakā janāḥ /	gaṇitāḥ bhikṣū sīmāprāptāḥ ettakāḥ janāḥ 
SA_K01_prmosulu-57	anāgatānām āyuḥmanto bhikḥūṇāṃ cchandapāriśuddhim ārocettha,	anāgatānām āyuḥmantaḥ bhikḥūṇām chanda pāriśuddhim 
SA_K01_prmosulu-58	ārocitaṃ ca prativedetha /	ārocitam ca prativedetha 
SA_K01_prmosulu-59	ko bhikḥu bhikḥuṇīnāṃ cchandahārako?	kaḥ bhikṣu bhikḥuṇīnām 
SA_K01_prmosulu-60	nāsti cātra kaścid anupasaṃpanno nāsti utkḥiptako /	na asti ca atra kaścid an upasaṃpannaḥ na asti utkṛiptakaḥ 
SA_K01_prmosulu-61	nāsti mātṛghātī,	na asti mātṛ ghātī 
SA_K01_prmosulu-62	nāsti pitṛghātī /	na asti pitṛ ghātī 
SA_K01_prmosulu-63	nāsti arhantaghātako,	na asti arhanta ghātako 
SA_K01_prmosulu-64	nāsti saṃghabhedako,	na asti saṃgha bhedakaḥ 
SA_K01_prmosulu-65	nāsti tathāgatasya duḥṭacittarudhirotpādako /	na asti tathāgatasya 
SA_K01_prmosulu-66	nāsti bhikḥuṇīdūḥako /	na asti 
SA_K01_prmosulu-67	nāsti stainyasaṃvāsiko,	na asti stainyasaṃvāsikaḥ 
SA_K01_prmosulu-68	nāsti nānāsaṃvāsiko,	na asti nānāsaṃvāsikaḥ 
SA_K01_prmosulu-69	nāsti asaṃvāsiko /	na asti asaṃvāsikaḥ 
SA_K01_prmosulu-70	nāsti tīrthikāpakrāntako /	na asti 
SA_K01_prmosulu-71	nāsti svayaṃsannaddhako /	na asti svayaṃsannaddhakaḥ 
SA_K01_prmosulu-72	tad evaṃ samanvāharantu bhagavato śrāvakāṇāṃ nityaviśuddhānāṃ pariśuddhaśīlānāṃ /	tat evam samanvāharantu bhagavataḥ śrāvakāṇām nitya viśuddhānām pariśuddha śīlānām 
SA_K01_prmosulu-73	śṛṇotu me bhante saṃgho Ō adya saṃghasya cāturdaśiko vā sandhipoṣadho vā viśuddhinakṣatraṃ /	śṛṇotu me bhante saṃghaḥ adya saṃghasya cāturdaśikaḥ vā sandhi poṣadhaḥ vā viśuddhi nakṣatram 
SA_K01_prmosulu-74	ettakaṃ ṛtusya nirgataṃ /	ettakam ṛtusya nirgatam 
SA_K01_prmosulu-75	etta[ka]m avaśiṣṭaṃ /	ettakam avaśiṣṭam 
SA_K01_prmosulu-76	kiṃ saṃghasya pūrvakṛtyaṃ?	kim saṃghasya pūrva kṛtyam 
SA_K01_prmosulu-77	alpakṛtyo bhagavataḥ śrāvakasaṃgho so bhavati /	alpa kṛtyaḥ bhagavataḥ śrāvaka saṃghaḥ saḥ bhavati 
SA_K01_prmosulu-78	śṛṇotu me bhante saṃgho Ō adya saṃghasya pāñcadaśiko poṣadho viśuddhinakṣatraṃ /	śṛṇotu me bhante saṃghaḥ adya saṃghasya pāñcadaśikaḥ poṣadhaḥ viśuddhi nakṣatram 
SA_K01_prmosulu-79	yadi saṃghasya prāptakālaṃ saṃgho imasmin pṛthivīpradeśe yāvatakaṃ bhikṣusaṃghenābhigṛhītaṃ	yadi saṃghasya prāpta kālam saṃghaḥ imasmin pṛthivī pradeśe yāvatakam bhikṣu saṃghena abhigṛhītam 
SA_K01_prmosulu-80	samantanavyāmamātraṃ atrāntare pāñcadaśikaṃ poṣadhaṃ kuryāt prātimokṣaṃ ca sūtram uddiśeyyā /	samantana vyāma mātram atra antare pāñcadaśikam poṣadham kuryāt prātimokṣam ca sūtram 
SA_K01_prmosulu-81	ovayikā eṣā jñaptiḥ /	ovayikā eṣā jñaptiḥ 
SA_K01_prmosulu-82	kariṣyati bhante saṃgho imasmin pṛthivīpradeśe yāvatakaṃ bhikṣusaṃghenābhigṛhītaṃ samantanavyāmamātram atrāntare pāñcadaśikaṃ poṣadhaṃ prātimokṣaṃ  #	kariṣyati bhante saṃghaḥ imasmin pṛthivī pradeśe yāvatakam bhikṣu saṃghena abhigṛhītam samantana vyāma mātram atra antare pāñcadaśikam poṣadham prātimokṣam 
SA_K01_prmosulu-83	ca sūtram uddiśiṣyati /	ca sūtram uddiśiṣyati 
SA_K01_prmosulu-84	kṣamate taṃ saṃghasya,	kṣamate tam saṃghasya 
SA_K01_prmosulu-85	yasmāt tūṣṇīm evam etaṃ dhārayāmi /	yasmāt tūṣṇīm evam etam dhārayāmi 
SA_K01_prmosulu-86	abhimukhaṃ krāmati jarāmaraṇaṃ kṣīyati jīvitendriyaṃ,	abhimukham krāmati jarā maraṇam kṣīyati jīvita indriyam 
SA_K01_prmosulu-87	hāyati saddharmo astameti dharmolko,	hāyati saddharmaḥ astam eti dharma ulkaḥ 
SA_K01_prmosulu-88	nirvāyanti deśayitāraḥ,	nirvāyanti deśayitāraḥ 
SA_K01_prmosulu-89	parīttā bhavanti pratipattāraḥ /	parīttāḥ bhavanti pratipattāraḥ 
SA_K01_prmosulu-90	gacchanti kṣaṇalavamuhūrttarātrindivasamāsārdhamāsaṛtusaṃvatsarāḥ /	gacchanti kṣaṇa lava muhūrtta rātrin divasa māsa ardha māsa ṛtu saṃvatsarāḥ 
SA_K01_prmosulu-91	girinadījalacapalacañcalopamā āyuḥ saṃskārā muhūrttam api nāvatiṣṭhante /	giri nadī jala capala cañcala upamāḥ āyuḥ saṃskārāḥ muhūrttam api na avatiṣṭhante 
SA_K01_prmosulu-92	apramādenāyuṣmantehi sampādayitavyaṃ /	apramādena āyuṣmant ehi sampādayitavyam 
SA_K01_prmosulu-93	tat kasya hetoḥ?	tat kasya hetoḥ 
SA_K01_prmosulu-94	apramādādhigatānāṃ hi tathāgatānām arhatāṃ samyaksaṃbuddhānāṃ bodhiḥ /	a pramāda adhigatānām hi tathāgatānām arhatām samyaksaṃbuddhānām bodhiḥ 
SA_K01_prmosulu-95	apramādādhigato cānuttaro upadhisaṃkṣayo ti vadāmi /	a pramāda adhigataḥ ca anuttaraḥ upadhi saṃkṣayaḥ ti vadāmi 
SA_K01_prmosulu-96	tenāpramādenāyuṣmantehi saṃpādayitavyaṃ /	tena apramādena āyuṣmant ehi saṃpādayitavyam 
SA_K01_prmosulu-97	daśārthavaśān sampaśyamānās tathāgatārhantaḥ samyaksaṃbuddhāḥ śrāvakāṇām adhiśīlaṃ śikṣāpadaṃ prajñāpayanti,	daśārtha vaśān sampaśyamānāḥ tathāgata arhantaḥ samyaksaṃbuddhāḥ śrāvakāṇām adhiśīlam śikṣā padam prajñāpayanti 
SA_K01_prmosulu-98	pratimokṣaṃ ca sūtram uddiśanti /	pratimokṣam ca sūtram uddiśanti 
SA_K01_prmosulu-99	katamān daśa?	katamān daśa 
SA_K01_prmosulu-100	saṃyyathīdaṃ (1)	saṃyyathī idam 
SA_K01_prmosulu-101	saṃghasaṃgrahāya (2)	saṃgha saṃgrahāya 
SA_K01_prmosulu-102	saṃghasuṣṭhutāya (3)	saṃgha suṣṭhutāya 
SA_K01_prmosulu-103	durmaṅkūnāṃ pudgalānāṃ nigrahāya (4)	durmaṅkūnām pudgalānām nigrahāya 
SA_K01_prmosulu-104	peśalānāṃ ca bhikṣūṇāṃ phāsuvihārāya (5)	peśalānām ca bhikṣūṇām phāsu vihārāya 
SA_K01_prmosulu-105	aprasannānāṃ prasādāya (6)	a prasannānām prasādāya 
SA_K01_prmosulu-106	prasannānāṃ ca bhūyobhāvāya dṛṣṭadhārmikāṇām āśravāṇāṃ nirghātāya (8)	prasannānām ca bhūyobhāvāya dṛṣṭa dhārmikāṇām āśravāṇām nirghātāya 
SA_K01_prmosulu-107	samparāyikāṇām āśravāṇām āyatyām ananuśravaṇatāya (9)	samparāyikāṇām āśravāṇām āyatyām an anuśravaṇa tāya 
SA_K01_prmosulu-108	yathemaṃ syāt prāvacanaṃ cirasthitikaṃ (10)	yathā imam syāt prāvacanam cirasthitikam 
SA_K01_prmosulu-109	bāhujanyaṃ vivṛtaṃ suprakāśitaṃ yāvad devamanuṣyeṣv iti /	bāhujanyam vivṛtam su prakāśitam yāvat deva manuṣyeṣu iti 
SA_K01_prmosulu-110	imān daśārthavaśān saṃpaśyamānās tathāgatā arhantaḥ samyaksambuddhāḥ śrāvakāṇām adhiśīlaṃ śikṣāpadaṃ prajñāpayanti prātimokṣaṃ ca sūtram uddiśanti	imān daśa artha vaśān saṃpaśyamānāḥ tathāgatāḥ arhantaḥ samyaksambuddhāḥ śrāvakāṇām adhi śīlam śikṣā padam prajñāpayanti prātimokṣam ca sūtram uddiśanti 
SA_K01_prmosulu-111	prātimokṣam āyuṣmanto sūtram uddiśiṣyāmi /	prātimokṣam āyuṣmantaḥ sūtram uddiśiṣyāmi 
SA_K01_prmosulu-112	taṃ śṛṇuta sādhu ca suṣṭhu ca manasi kuruta /	tam śṛṇuta sādhu ca suṣṭhu ca manasi kuruta 
SA_K01_prmosulu-113	bhāṣiṣyāmi /	bhāṣiṣyāmi 
SA_K01_prmosulu-114	yasya vo siyāpattiḥ so 'viṣkarotu,	yasya vaḥ siyā āpattiḥ saḥ viṣkarotu 
SA_K01_prmosulu-115	asantīye āpattīye tūṣṇīṃ bhavitavyaṃ /	asantīye āpattīye tūṣṇīm bhavitavyam 
SA_K01_prmosulu-116	tūṣṇīmbhāvena kho punar āyuṣmanto pariśuddhā iti vedayiṣyāmi /	tūṣṇīmbhāvena khalu punar āyuṣmantaḥ pariśuddhāḥ iti vedayiṣyāmi 
SA_K01_prmosulu-117	yathā kho punar āyuṣmanto pratyekaṃ pratyekaṃ pṛcchitasya bhikṣusya vyākaraṇaṃ bhavati evam eva rūpāye bhikṣuparṣāye yāvantṛtīyakaṃ samanuśrāvayiṣyati	yathā kho punar āyuṣmantaḥ pratyekam pratyekam pṛcchitasya bhikṣusya vyākaraṇam bhavati evam eva rūpāye bhikṣu parṣāye yāvantṛtīyakam samanuśrāvayiṣyati 
SA_K01_prmosulu-118	yo puna bhikṣu evaṃrūpāye bhikṣuparṣāye yāvantṛtīyakaṃ samanuśrāviyamāṇo smaramāṇo santīm āpattiṃ nāviṣkaroti saṃprajānamṛṣāvādo se bhavati	punar evaṃrūpāye bhikṣu parṣāye yāvantṛtīyakam samanuśrāviyamāṇaḥ smaramāṇaḥ santīm āpattim na āviṣkaroti saṃprajāna mṛṣāvādaḥ se bhavati 
SA_K01_prmosulu-119	saṃprajānamṛṣāvādo kho punar āyuṣmanto āntarāyiko dharmo ukto bhagavatā /	saṃprajāna mṛṣāvādaḥ kho punar āyuṣmantaḥ āntarāyikaḥ dharmaḥ uktaḥ bhagavatā 
SA_K01_prmosulu-120	tasmāt smaramāṇena bhikṣuṇā āpannena viśuddhiprekṣeṇa santī āpattī āviṣkartavyā /	tasmāt smaramāṇena bhikṣuṇā āpannena viśuddhi prekṣeṇa santī āpattī āviṣkartavyā 
SA_K01_prmosulu-121	āviṣkṛtvā ca se phāsu bhavati,	āviṣkṛtvā ca se phāsu bhavati 
SA_K01_prmosulu-122	no anāviṣkṛtvā /	na u an āviṣkṛtvā 
SA_K01_prmosulu-123	// [iti] nidānaṃ //	iti nidānam 
SA_K01_prmosulu-124	[I. catvāraḥ pārājikā dharmāḥ]	i catvāraḥ pārājikāḥ dharmāḥ 
SA_K01_prmosulu-125	ime kho punar āyuṣmanto catvāraḥ pārājikā dharmā anvardhamāsaṃ sūtre prātimokṣe uddeśam āgacchanti /	ime khalu punar āyuṣmantaḥ catvāraḥ pārājikāḥ dharmāḥ anvardha māsam sūtre prātimokṣe uddeśam āgacchanti 
SA_K01_prmosulu-126	PrMoSū(Mā-L)Pār.1. yo puna bhikṣu bhikṣūṇāṃ śikṣāsāmīcīsamāpanno śikṣām apratyākhyāya	yaḥ puna bhikṣu bhikṣūṇām śikṣā sāmīcī samāpannaḥ śikṣām a pratyākhyāya 
SA_K01_prmosulu-127	daurbalyam anāviṣkṛtvā maithunaṃ grāmyadharmaṃ pratiṣeveya antamaśato tiryagyonigatāyam	daurbalyam an āviṣkṛtvā maithunam grāmya dharmam pratiṣeveya tiryagyoni gatā ayam 
SA_K01_prmosulu-128	api sādham ayaṃ bhikṣuḥ pārājiko bhavaty asaṃvāsyo,	api sādham ayam bhikṣuḥ pārājikaḥ bhavati a saṃvāsyaḥ 
SA_K01_prmosulu-129	na labhate bhikṣūhi sārdhasaṃvāsaṃ /	na labhate bhikṣūhi sārdha saṃvāsam 
SA_K01_prmosulu-130	idaṃ bhagavatā veśālīyaṃ śikṣāpadaṃ prajñaptaṃ pañcavarṣābhisaṃbuddhena hemantapakṣe pañcame,	idam bhagavatā veśālīyam śikṣā padam prajñaptam pañca varṣa abhisaṃbuddhena hemanta pakṣe pañcame 
SA_K01_prmosulu-131	divase dvādaśame,	divase dvādaśame 
SA_K01_prmosulu-132	purebhaktam uttarāmukhaniṣaṇṇena dvyardhapauruṣāyāṃ cchāyāyāṃ,	purebhaktam uttarā mukha niṣaṇṇena dvi ardha pauruṣāyām chāyāyām 
SA_K01_prmosulu-133	āyuṣmantaṃ yaśikaṃ kalandakaputram ārabhya /	āyuṣmantam yaśikam kalandakaputram ārabhya 
SA_K01_prmosulu-134	imasya ca śikṣāpadasya prajñaptir dharmo,	imasya ca śikṣā padasya prajñaptiḥ 
SA_K01_prmosulu-135	yathāpraṇihitasya ca yā anuvartanatā ayam ucyate anudharmo /	yathā praṇihitasya ca yā anuvartana tā ayam ucyate 
SA_K01_prmosulu-136	PrMoSū(Mā-L)Pār.2. yo puna bhikṣu grāmād vā araṇyād vā adinnam anyātakaṃ stainasaṃskāram	yaḥ puna bhikṣu grāmāt vā araṇyāt vā a dinnam an yātakam staina saṃskāram 
SA_K01_prmosulu-137	ādiyeya yathārūpeṇādinnādānena [rā]jāno gṛhītvā haneṃsu vā bandheṃsu vā pravrājeṃsu	ādiyeya yathārūpeṇa adinna ādānena rājānaḥ gṛhītvā haneṃsu vā bandheṃsu vā pravrājeṃsu 
SA_K01_prmosulu-138	vā hambho puruṣa coro 'si bālo 'si mūḍho 'si stainyo 'sīti vā vadeṃsu,	vā hambho puruṣa coraḥ si bālaḥ si mūḍhaḥ si stainyaḥ si iti vā vadeṃsu 
SA_K01_prmosulu-139	tathārūpaṃ bhikṣur adinnam ādiyamāno ayam pi bhikṣuḥ pārājiko bhavaty asaṃvāsyo,	tathārūpam bhikṣuḥ a dinnam ādiyamānaḥ ayam pi bhikṣuḥ pārājikaḥ bhavati a saṃvāsyaḥ 
SA_K01_prmosulu-140	na labhate bhikṣūhi sārdhasaṃvāsaṃ /	na labhate bhikṣūhi sārdha saṃvāsam 
SA_K01_prmosulu-141	idaṃ bhagavatā rājagṛhe śikṣāpadaṃ prajñaptaṃ ṣaḍvarṣābhisambuddhena hemantapakṣe dvitī[ye,	idam bhagavatā rājagṛhe śikṣā padam prajñaptam ṣaṣ varṣa abhisambuddhena hemanta pakṣe dvitīye 
SA_K01_prmosulu-142	di]vase navame,	divase navame 
SA_K01_prmosulu-143	paścādbhaktaṃ purastān mukhaniṣaṇṇena aḍḍhātīyapauruṣāyāṃ cchāyāyām āyuṣmantaṃ dhanikaṃ kumbhakārajātīyam ārabhya rājānaṃ ca śreṇīyaṃ bimbasāraṃ  #	paścāt bhaktam purastāt mukha niṣaṇṇena aḍḍhātīya pauruṣāyām chāyāyām āyuṣmantam dhanikam kumbhakāra jātīyam ārabhya rājānam ca śreṇīyam bimbasāram 
SA_K01_prmosulu-144	pāṃsukūlikaṃ ca bhikṣaṃ /	pāṃsukūlikam ca bhikṣam 
SA_K01_prmosulu-145	imasya ca śikṣāpadasya prajñaptir dharmo yathāpraṇihitasya ca yā anuvartanatā ayam ucyate anudharmo /	imasya ca śikṣā padasya prajñaptiḥ dharmaḥ yathā praṇihitasya ca yā anuvartana tā ayam ucyate 
SA_K01_prmosulu-146	PrMoSū(Mā-L)Pār.3. yo puna bhikṣuḥ svahastaṃ manuṣyavigrahaṃ jīvitād vyaparopeya śastrahārakaṃ vāsya paryeṣeya,	yaḥ puna bhikṣuḥ sva hastam manuṣya vigraham jīvitāt vyaparopeya śastra hārakam vā asya paryeṣeya 
SA_K01_prmosulu-147	maraṇāya cainaṃ samādāpeya,	maraṇāya ca enam 
SA_K01_prmosulu-148	maraṇavarṇaṃ vāsya saṃvarṇeya Ō hambho puruṣa kiṃ te iminā pāpakena durjīvitena dhigjīvitena,	maraṇa varṇam vā asya saṃvarṇeya hambho puruṣa kim te iminā pāpakena durjīvitena dhik jīvitena 
SA_K01_prmosulu-149	mṛtaṃ te jīvitāc chreyo Ō iti cittam alaṃ cittasaṃkalpam anekaparyāyeṇa maraṇāya vainaṃ samādāpeya maraṇavarṇaṃ vāsya saṃvarṇeya,	mṛtam te jīvitāt śreyaḥ iti cittam alam citta saṃkalpam aneka paryāyeṇa maraṇāya vā enam samādāpeya maraṇa varṇam vā asya saṃvarṇeya 
SA_K01_prmosulu-150	so ca puruṣo tenopakrameṇa kālaṃ kuryān nānyena,	saḥ ca tena upakrameṇa kālam kuryāt na anyena 
SA_K01_prmosulu-151	ayaṃ pi bhikṣuḥ pārājiko bhavaty asaṃvāsyo,	ayam pi bhikṣuḥ pārājikaḥ bhavati a saṃvāsyaḥ 
SA_K01_prmosulu-152	na labhate bhikṣūhi sārdhasaṃvāsaṃ /	na labhate bhikṣūhi sārdha saṃvāsam 
SA_K01_prmosulu-153	idaṃ bhagavatā veśālīyaṃ śikṣāpadaṃ prajñaptaṃ ṣaḍvarṣābhisambuddhena hemantapakṣe tṛtīye,	idam bhagavatā veśālīyam śikṣā padam prajñaptam ṣaṣ varṣa abhisambuddhena hemanta pakṣe tṛtīye 
SA_K01_prmosulu-154	divase daśame,	divase daśame 
SA_K01_prmosulu-155	paścādbhaktaṃ purastān mukhaniṣaṇṇena aḍḍhātīyapauruṣāyāṃ cchāyāyāṃ sambahulān gilānopasthāpakān bhikṣūn ārabhya mṛgadaṇḍikaṃ ca parivrājakaṃ	paścāt bhaktam purastāt mukha niṣaṇṇena aḍḍhātīya pauruṣāyām chāyāyām sambahulān gilāna upasthāpakān bhikṣūn ārabhya mṛgadaṇḍikam ca parivrājakam 
SA_K01_prmosulu-156	imasya ca śikṣāpadasya prajñaptir dharmo,	imasya ca śikṣā padasya prajñaptiḥ 
SA_K01_prmosulu-157	yathāpraṇihitasya ca yā anuvartanatā ayam ucyate anudharmo /	yathā praṇihitasya ca yā anuvartana tā ayam ucyate 
SA_K01_prmosulu-158	PrMoSū(Mā-L)Pār.4. yo puna bhikṣur anabhijānann aparijānann ātmopanāyikam uttarimanuṣyadharmam alamāryajñānadarśanaṃ viśeṣādhigamaṃ prātajāneya  #	yaḥ puna bhikṣuḥ an abhijānan a parijānan ātma upanāyikam uttari manuṣya dharmam alam ārya jñāna darśanam viśeṣa adhigamam 
SA_K01_prmosulu-159	ita jānāmi ita paśyāmīti /	ita jānāmi ita paśyāmi iti 
SA_K01_prmosulu-160	so tad apareṇa samayena samanugrāhiyamāṇo vā asa[ma]nugrāhiyamāṇo vā āpanno viśuddhiprekṣo evam avaci Ō ajānann evāham āyuṣmanto avaci jānāmi,	saḥ tat apareṇa samayena samanugrāhiyamāṇaḥ vā a samanugrāhiyamāṇaḥ vā āpannaḥ viśuddhi prekṣaḥ evam avaci a jānan eva aham āyuṣmantaḥ avaci jānāmi 
SA_K01_prmosulu-161	apaśyan paśyāmīti /	a paśyan paśyāmi iti 
SA_K01_prmosulu-162	iti tucchaṃ mṛṣā vilāpam anyatrābhimānāt* ayaṃ pi bhikṣuḥ pārājiko bhavaty asaṃvāsyo na labhate bhikṣūhi sārdhasaṃvāsaṃ /	iti tuccham mṛṣā vilāpam anyatra abhimānāt ayam pi bhikṣuḥ pārājikaḥ bhavati a saṃvāsyaḥ na labhate bhikṣūhi sārdha saṃvāsam 
SA_K01_prmosulu-163	idaṃ bhagavatā śrāvastīyaṃ śikṣāpadaṃ prajñaptaṃ ṣaḍvarṣābhisambuddhena hemantapakṣe caturthe,	idam bhagavatā śrāvastīyam śikṣā padam prajñaptam ṣaṣ varṣa abhisambuddhena hemanta pakṣe caturthe 
SA_K01_prmosulu-164	divase trayodaśame,	divase trayodaśame 
SA_K01_prmosulu-165	purebhaktaṃ uttarāmukhaniṣaṇṇena aḍḍhucchapauruṣāyāṃ cchāyāyāṃ saṃbahulān grāmavāsikān bhikṣūn ārabhya ābhiyānikaṃ ca bhikṣuṃ /	purebhaktam uttarā mukha niṣaṇṇena aḍḍhuccha pauruṣāyām chāyāyām saṃbahulān grāmavāsikān bhikṣūn ārabhya ābhiyānikam ca bhikṣum 
SA_K01_prmosulu-166	imasya ca śikṣāpadasya prajñaptir dharmo,	imasya ca śikṣā padasya prajñaptiḥ 
SA_K01_prmosulu-167	yathā praṇihitasya ca yā anuvartanatā ayam ucyate anudharmo /	yathā praṇihitasya ca yā anuvartana tā ayam ucyate 
SA_K01_prmosulu-168	uddānaṃ	uddānam 
SA_K01_prmosulu-169	(1) maithunam (2) adinnādānaṃ (3)	maithunam a dinna ādānam 
SA_K01_prmosulu-170	vadho manuṣyavigrahasyā- (4)	vadhaḥ manuṣya vigrahasya ā 
SA_K01_prmosulu-171	bhūtena cottarimanuṣyadharmaṃ pratijānātīti /	bhūtena ca uttari manuṣya dharmam pratijānāti iti 
SA_K01_prmosulu-172	uddiṣṭāḥ kho punar āyuṣmanto catvāraḥ pārājikā dharmāḥ /	uddiṣṭāḥ khalu punar āyuṣmantaḥ catvāraḥ pārājikāḥ dharmāḥ 
SA_K01_prmosulu-173	yeṣāṃ bhikṣur ito 'nyatarām āpattim āpadyitvā pārājiko bhavaty asaṃvāsyo na labhate bhikṣūhi sārdhasaṃvāsaṃ /	yeṣām bhikṣuḥ itas nyatarām āpattim āpadyitvā pārājikaḥ bhavati a saṃvāsyaḥ na labhate bhikṣūhi sārdha saṃvāsam 
SA_K01_prmosulu-174	yathā pūrve tathā paścād yathā paścāt tathā pūrve pārājiko bhavaty asaṃvāsyo na labhate bhikṣūhi saṃvāsaṃ ḥ tatrāyuṣmanto pṛcchāmi kaccittha	yathā pūrve tathā paścāt yathā paścāt tathā pūrve pārājikaḥ bhavati a saṃvāsyaḥ na labhate saṃvāsam tatra āyuṣmantaḥ pṛcchāmi 
SA_K01_prmosulu-175	dvitīyaṃ pi āyuṣmanto pṛcchāmi kaccittha pariśuddhāḥ?	dvitīyam pi āyuṣmantaḥ pṛcchāmi kaccit tha pariśuddhāḥ 
SA_K01_prmosulu-176	tṛtīyaṃ pi āyuṣmanto pṛcchāmi kaccittha pariśuddhāḥ?	tṛtīyam pi āyuṣmantaḥ pṛcchāmi kaccit tha pariśuddhāḥ 
SA_K01_prmosulu-177	pariśuddhātrāyuṣmanto yasmāt tūṣṇīm evam etaṃ dhārayāmi ḥ	pariśuddhāḥ atra āyuṣmantaḥ yasmāt tūṣṇīm evam etam dhārayāmi 
SA_K01_prmosulu-178	[II. trayodaśa saṃghātiśeṣā dharmāḥ]	trayodaśa saṃgha atiśeṣāḥ dharmāḥ 
SA_K01_prmosulu-179	ime kho punar āyuṣmanto trayodaśa saṃghātiśeṣā dharmā anvardhamāsaṃ sūtre prātimokṣe uddeśam āgacchanti /	ime khalu punar āyuṣmantaḥ trayodaśa saṃgha atiśeṣāḥ dharmāḥ anvardha māsam sūtre prātimokṣe uddeśam āgacchanti 
SA_K01_prmosulu-180	PrMoSū(Mā-L)SA.1. saṃcetanikāye śukrasya visṛṣṭīye anyatra svapnāntare saṃghātiśeṣo /	saṃceta nikāye śukrasya visṛṣṭīye anyatra svapna antare 
SA_K01_prmosulu-181	PrMoSū(Mā-L)SA.2. yo puna bhikṣu otīrṇo vipariṇatena cittena mātṛgrāmeṇa sārdhaṃ	yaḥ puna bhikṣu otīrṇaḥ vipariṇatena cittena mātṛgrāmeṇa sārdham 
SA_K01_prmosulu-182	kāyasaṃsargaṃ samāpadyeya saṃyathīdaṃ hastagrahaṇaṃ vā veṇīgrahaṇaṃ vā anyatarānyatarasya	kāya saṃsargam samāpadyeya saṃ yathā idam hasta grahaṇam vā veṇī grahaṇam vā anyatara anyatarasya 
SA_K01_prmosulu-183	vā punar aṅgajātasya āmoṣaṇaparāmoṣaṇaṃ sādiyeya saṃghātiśeṣo /	vā punar aṅga jātasya āmoṣaṇa parāmoṣaṇam sādiyeya saṃgha atiśeṣaḥ 
SA_K01_prmosulu-184	PrMoSū(Mā-L)SA.3. yo puna bhikṣu otīrṇo vipariṇatena cittena mātṛgrāmaṃ duṣṭhullāya vācāya obhāṣeya pāpikāya maithunopasaṃhitāya saṃyathīdaṃ  #	yaḥ puna bhikṣu otīrṇaḥ vipariṇatena cittena mātṛgrāmam duṣṭhullāya vācāya obhāṣeya pāpikāya maithuna upasaṃhitāya saṃyathī idam 
SA_K01_prmosulu-185	yuvāṃ yuvatīti saṃghātiśeṣo /	yuvām yuvatī iti saṃgha atiśeṣaḥ 
SA_K01_prmosulu-186	PrMoSū(Mā-L)SA.4. yo puna bhikṣu otīrṇo vipariṇatena cittena mātṛgrāmasya antike	yaḥ puna bhikṣu otīrṇaḥ vipariṇatena cittena mātṛgrāmasya antike 
SA_K01_prmosulu-187	ātmikāye paricaryāye varṇaṃ bhāṣeya Ō etad agraṃ bhagini paricaryāṇāṃ yā mādṛśaṃ	varṇam bhāṣeya etat agram bhagini paricaryāṇām yā mādṛśam 
SA_K01_prmosulu-188	śramaṇaṃ śīlavantaṃ kalyāṇadharmaṃ brahmacāriṃ etena dharmeṇa upasthiheya paricareya	śramaṇam śīlavantam kalyāṇa dharmam brahmacārim etena dharmeṇa upasthiheya paricareya 
SA_K01_prmosulu-189	yaduta maithunopasaṃhiteneti saṃghātiśeṣo /	yat uta maithuna upasaṃhitena iti saṃgha atiśeṣaḥ 
SA_K01_prmosulu-190	PrMoSū(Mā-L)SA.5. yo puna bhikṣuḥ saṃcaritraṃ samāpadyeya istriyāye mataṃ puruṣasyopasaṃhareya	yaḥ punar bhikṣuḥ saṃcaritram samāpadyeya matam puruṣasya upasaṃhareya 
SA_K01_prmosulu-191	puruṣasya vā mataṃ istriyāye upasaṃhareya jāyattanena vā jārtanena vā antamaśato	puruṣasya vā matam upasaṃhareya jāyattanena vā jārtanena vā 
SA_K01_prmosulu-192	tatkṣaṇikāyām api saṃghātiśeṣo /	tad kṣaṇikāyām api saṃgha atiśeṣaḥ 
SA_K01_prmosulu-193	PrMoSū(Mā-L)SA.6. svayaṃ yācikāya bhikṣuṇā kuṭī kārayamāṇena asvāmikātmoddeśikā kuṭī kārāpayitavyā /	svayam yācikāya bhikṣuṇā kuṭī kārayamāṇena asvāmikā ātmoddeśikā kuṭī kārāpayitavyā 
SA_K01_prmosulu-194	tatredaṃ pramāṇaṃ Ō dīrghaśo dvādaśa vitastīyo sugatavitastinā /	tatra idam pramāṇam dīrghaśas dvādaśa sugata vitastinā 
SA_K01_prmosulu-195	tiryak saptāntaraṃ /	tiryak sapta antaram 
SA_K01_prmosulu-196	bhikṣū cānenābhinetavyā vastudeśanāya /	bhikṣū ca anena abhinetavyāḥ vastu deśanāya 
SA_K01_prmosulu-197	tehi bhikṣuhi vastu deśayitavyaṃ /	tehi bhikṣuhi vastu deśayitavyam 
SA_K01_prmosulu-198	anāraṃbhaṃ saparikramaṇaṃ /	anāraṃbham sa parikramaṇam 
SA_K01_prmosulu-199	sāraṃbhe ced bhikṣu vastusminn aparikramaṇe svayaṃyācikāya kuṭīṃ kārāpeya asvāmikām ātmoddeśikāṃ bhikṣūn vā nābhineya vastudesanāya,	sa āraṃbhe ced bhikṣu vastusmin a parikramaṇe svayaṃyācikāya kuṭīm kārāpeya asvāmikām ātma uddeśikām bhikṣūn vā na abhineya vastu desanāya 
SA_K01_prmosulu-200	pramāṇaṃ vā atikrameya,	pramāṇam vai atikrameya 
SA_K01_prmosulu-201	adeśite vastusminn aparikramaṇe saṃghātiśeṣo /	a deśite vastusmin a parikramaṇe saṃgha atiśeṣaḥ 
SA_K01_prmosulu-202	PrMoSū(Mā-L)SA.7. mahālakaṃ bhikṣuṇā vihāraṃ [kārā]payamāṇena sasvāmikam ātmoddeśikaṃ bhikṣū cānenābhinetavyā vastudeśanāya /	mahālakam bhikṣuṇā vihāram kārāpayamāṇena sa svāmikam ātmoddeśikam bhikṣū ca anena abhinetavyāḥ vastu deśanāya 
SA_K01_prmosulu-203	tehi bhikṣūhi vastu deśayitavyaṃ /	tehi bhikṣūhi vastu deśayitavyam 
SA_K01_prmosulu-204	anāraṃbhaṃ saparikramaṇaṃ /	anāraṃbham sa parikramaṇam 
SA_K01_prmosulu-205	sāraṃbhe ced bhikṣu vastusminn aparikramaṇe mahallakaṃ vihāraṃ kārāpeya sasvāmikam ātmoddeśikaṃ bhikṣūn vā nābhineya vastudeśanāya,	sa āraṃbhe ced bhikṣu vastusmin a parikramaṇe mahallakam vihāram kārāpeya sa svāmikam ātmoddeśikam bhikṣūn vā na abhineya vastu deśanāya 
SA_K01_prmosulu-206	adeśite vastusminn aparikramaṇe saṃghātiśeṣo /	a deśite vastusmin a parikramaṇe saṃgha atiśeṣaḥ 
SA_K01_prmosulu-207	PrMoSū(Mā-L)SA.8. yo puna bhikṣu bhikṣusya duṣṭo,	yaḥ puna bhikṣu bhikṣusya duṣṭaḥ 
SA_K01_prmosulu-208	doṣāt kupito,	doṣāt kupitaḥ 
SA_K01_prmosulu-209	anāttamano śuddhaṃ bhikṣum anāpattikam amūlakena pārājikena dharmeṇa anudhvaṃseya apy evaṃ nāma imaṃ bhikṣuṃ brahmacaryāto cyāveyaṃ ti,	an ātta mano śuddham bhikṣum anāpattikam amūlakena pārājikena dharmeṇa anudhvaṃseya api evam nāma imam bhikṣum brahmacaryāt cyāveyam ti 
SA_K01_prmosulu-210	so tad apareṇa samayena samanugrāhiyamāṇo vā asamanugrāhiyamāṇo vā amūlakam eva tam adhikaraṇaṃ bhavati /	saḥ tat apareṇa samayena samanugrāhiyamāṇaḥ vā a samanugrāhiyamāṇaḥ vā amūlakam eva tam adhikaraṇam bhavati 
SA_K01_prmosulu-211	amūlakasya ca adhikaraṇasya ca adharmo upādinno bhavati,	amūlakasya ca adhikaraṇasya ca adharmaḥ upādinnaḥ bhavati 
SA_K01_prmosulu-212	bhikṣu ca doṣe pratiṣṭhihati doṣād avacāmīti saṃghātiśeṣo /	bhikṣu ca doṣe pratiṣṭhihati doṣāt avacāmi iti saṃgha atiśeṣaḥ 
SA_K01_prmosulu-213	PrMoSū(Mā-L)SA.9. yo puna bhikṣu bhikṣusya duṣṭo,	yaḥ puna bhikṣu bhikṣusya duṣṭaḥ 
SA_K01_prmosulu-214	doṣāt kupito,	doṣāt kupitaḥ 
SA_K01_prmosulu-215	anāttamano anyabhāgīyasyādhikaraṇasya kiñcid eva leśamātrakaṃ dharmam upādāya aparājikaṃ	an ātta manaḥ anya bhāgīyasya adhikaraṇasya kiñcid eva leśa mātrakam dharmam upādāya aparājikam 
SA_K01_prmosulu-216	bhikṣuṃ pārājikena dharmeṇa anudhvaṃseya apy eva nāma imaṃ bhikṣuṃ brahmacaryāto cyāveyaṃ ti,	bhikṣum pārājikena dharmeṇa anudhvaṃseya api eva nāma imam bhikṣum brahmacaryāt cyāveyam ti 
SA_K01_prmosulu-217	so tad apareṇa samayena samanugrāhiyamāṇo vā asamanugrāhiyamāṇo vā anyabhāgīyam eva tam adhikaraṇaṃ bhavati,	saḥ u tat apareṇa samayena samanugrāhiyamāṇaḥ vā a samanugrāhiyamāṇaḥ vā anya bhāgīyam eva tam adhikaraṇam bhavati 
SA_K01_prmosulu-218	anyabhāgīyasya cādhikaraṇasya kocid e[va] leśamātrako dharmo upādinno bhavati,	anya bhāgīyasya ca adhikaraṇasya kocid eva leśa mātrakaḥ dharmaḥ upādinnaḥ bhavati 
SA_K01_prmosulu-219	bhikṣu ca doṣe pratiṣṭhihati doṣād avacāmīti saṃghātiśeṣo /	bhikṣu ca doṣe pratiṣṭhihati doṣāt avacāmi iti saṃgha atiśeṣaḥ 
SA_K01_prmosulu-220	PrMoSū(Mā-L)SA.10. yo puna bhikṣuḥ samagrasya saṃghasya bhedāya parākrameya bhedanasaṃvartanīyaṃ vādhikaraṇaṃ samādāya pragṛhya tiṣṭheya,	yaḥ puna bhikṣuḥ samagrasya saṃghasya bhedāya parākrameya bhedana saṃvartanīyam vā adhikaraṇam samādāya pragṛhya tiṣṭheya 
SA_K01_prmosulu-221	so bhikṣu bhikṣūhi evam asya vacanīyo Ō mā āyuṣman samagrasya saṃghasya bhedāya parākramehi,	saḥ bhikṣu bhikṣūhi evam asya vacanīyaḥ mā āyuṣman samagrasya saṃghasya bhedāya parākramehi 
SA_K01_prmosulu-222	bhedanasaṃvartanīyaṃ vā adhikaraṇaṃ samādāya pragṛhya tiṣṭhāhi /	bhedana saṃvartanīyam vā adhikaraṇam samādāya pragṛhya tiṣṭhāhi 
SA_K01_prmosulu-223	sametu āyuṣmān sārdhaṃ saṃghena,	sametu āyuṣmān sārdham saṃghena 
SA_K01_prmosulu-224	samagro hi saṃgho sahito sammodamāno avivadamāno ekuddeśo kṣīrodakībhūto śāstuḥ śāsanaṃ dīpayamāno sukhaṃ ca phāsuṃ ca viharati /	samagraḥ hi saṃghaḥ sahitaḥ sammodamānaḥ a vivadamānaḥ eka uddeśaḥ kṣīra udakībhūtaḥ śāstuḥ śāsanam dīpayamānaḥ sukham ca phāsum ca viharati 
SA_K01_prmosulu-225	evaṃ ca so bhikṣu bhikṣūhi vucyamāno taṃ vastuṃ pratinissareya ity etaṃ kuśalaṃ /	evam ca saḥ bhikṣu bhikṣūhi vucyamānaḥ tam vastum pratinissareya iti etam kuśalam 
SA_K01_prmosulu-226	no ca pratinissareya,	no ca pratinissareya 
SA_K01_prmosulu-227	so bhikṣu bhikṣūhi yāvantṛtīyakaṃ samanugrāhitavyo samanubhāṣitavyo tasya vastusya pratinissargāya /	saḥ bhikṣu bhikṣūhi yāvantṛtīyakam samanugrāhitavyaḥ samanubhāṣitavyaḥ tasya vastusya pratinissargāya 
SA_K01_prmosulu-228	yāvantṛtīyakaṃ samanugrāhiyamāṇo vā samanubhāṣiyamāṇo vā taṃ vastuṃ pratinissareya ity etaṃ kuśalaṃ /	yāvantṛtīyakam samanugrāhiyamāṇaḥ vā samanubhāṣiyamāṇaḥ vā tam vastum pratinissareya iti etam kuśalam 
SA_K01_prmosulu-229	no ca pratinissareya tam eva vastuṃ samādāya pragṛhya tiṣṭheya saṃghātiśeṣo /	no ca pratinissareya tam eva vastum samādāya pragṛhya tiṣṭheya saṃgha atiśeṣaḥ 
SA_K01_prmosulu-230	PrMoSū(Mā-L)SA.11. tasya kho puna bhikṣusya bhikṣū sahāyakā bhonti eko vā,	tasya kho puna bhikṣusya bhikṣū sahāyakāḥ bhonti ekaḥ vā 
SA_K01_prmosulu-231	dvau vā trayo vā saṃbahulā vā,	dvau vā trayaḥ vā saṃbahulāḥ vā 
SA_K01_prmosulu-232	vargavādakā anuvartakāḥ samanujñāḥ saṃghabhedāya /	varga vādakāḥ anuvartakāḥ samanujñāḥ saṃgha bhedāya 
SA_K01_prmosulu-233	te bhikṣū tān bhikṣūn evaṃ vadeṃsu Ō mā āyuṣmanto etaṃ bhikṣuṃ kiñcid vadatha kalyāṇaṃ vā pāpakaṃ vā /	te bhikṣū tān bhikṣūn evam vadeṃsu mā āyuṣmantaḥ etam bhikṣum kiñcid vadatha kalyāṇam vā pāpakam vā 
SA_K01_prmosulu-234	dharmavādī caiṣo bhikṣur vina[ya]vādī caiṣo bhikṣu,	dharma vādī ca eṣaḥ bhikṣuḥ vinaya vādī ca eṣaḥ bhikṣu 
SA_K01_prmosulu-235	asmākaṃ caiṣo bhikṣu cchandaṃ ca ruciṃ ca samādāya pragṛhya vyavaharati /	asmākam ca eṣaḥ bhikṣu chandam ca rucim ca samādāya pragṛhya vyavaharati 
SA_K01_prmosulu-236	yaṃ caitasya bhikṣusya kṣamate ca rocate ca asmākam api taṃ kṣamate ca rocate ca /	yam ca etasya bhikṣusya kṣamate ca rocate ca asmākam api tam kṣamate ca rocate ca 
SA_K01_prmosulu-237	jānan caiṣo bhikṣu bhāṣate no ajānan /	jānan ca eṣaḥ bhikṣu bhāṣate no a jānan 
SA_K01_prmosulu-238	te bhikṣu bhikṣūhi evam asya vacanīyā Ō mā āyuṣmanto evaṃ vadatha,	te bhikṣu bhikṣūhi evam asya vacanīyāḥ mā āyuṣmantaḥ evam vadatha 
SA_K01_prmosulu-239	na eṣo bhikṣur dharmavādī,	na eṣaḥ bhikṣuḥ dharma vādī 
SA_K01_prmosulu-240	na eṣo bhikṣur vinayavādī,	na eṣaḥ bhikṣuḥ vinaya vādī 
SA_K01_prmosulu-241	adharmavādī caiṣo bhikṣu,	adharma vādī ca eṣaḥ bhikṣu 
SA_K01_prmosulu-242	avinayavādī caiṣo bhikṣu,	a vinaya vādī ca eṣaḥ bhikṣu 
SA_K01_prmosulu-243	ajānan* caiṣo bhikṣu bhāṣate no jānan* /	a jānan ca eṣaḥ bhikṣu bhāṣate na u jānan 
SA_K01_prmosulu-244	mā āyuṣmanto saṃghabhedaṃ rocentu,	mā āyuṣmantaḥ saṃgha bhedam rocentu 
SA_K01_prmosulu-245	saṃghasāmagrīm evāyuṣmanto rocentu /	saṃgha sāmagrīm eva āyuṣmantaḥ rocentu 
SA_K01_prmosulu-246	samentu āyuṣmanto sārdhaṃ saṃghena /	samentu āyuṣmantaḥ sārdham saṃghena 
SA_K01_prmosulu-247	samagro hi sahito sammodamāno avivadamāno ekuddeśo kṣīrodakībhūto śāstuḥ śāsanaṃ dīpayamāno sukhaṃ ca phāsuṃ ca viharati /	samagraḥ hi sahitaḥ sammodamānaḥ a vivadamānaḥ eka uddeśaḥ kṣīra udakībhūtaḥ śāstuḥ śāsanam dīpayamānaḥ sukham ca phāsum ca viharati 
SA_K01_prmosulu-248	evaṃ ca te bhikṣū bhikṣūhi vucyamānās taṃ vastuṃ pratinissareṃsu ity etaṃ kuśalaṃ,	evam ca te bhikṣū bhikṣūhi vucyamānāḥ tam vastum pratinissareṃsu iti etam kuśalam 
SA_K01_prmosulu-249	no ca pratinissareṃsu te bhikṣū bhikṣūhi yāvantṛtīyakaṃ samanugrāhitavyāḥ samanubhāṣitavyāḥ tasya vastusya pratinissargāya /	no ca pratinissareṃsu te bhikṣū bhikṣūhi yāvantṛtīyakam samanugrāhitavyāḥ samanubhāṣitavyāḥ tasya vastusya pratinissargāya 
SA_K01_prmosulu-250	yāvantṛtīyakaṃ samanugrāhiyamāṇā vā samanubhāṣiyamāṇā vā taṃ vastuṃ pratinissareṃsu i[ty e]taṃ kuśalaṃ,	yāvantṛtīyakam samanugrāhiyamāṇāḥ vā samanubhāṣiyamāṇāḥ vā tam vastum pratinissareṃsu iti etam kuśalam 
SA_K01_prmosulu-251	no ca pratinissareṃsu tam eva ca vastuṃ samādāya pragṛhya tiṣṭheṃsu saṃghātiśeṣo /	no ca pratinissareṃsu tam eva ca vastum samādāya pragṛhya tiṣṭheṃsu saṃgha atiśeṣaḥ 
SA_K01_prmosulu-252	PrMoSū(Mā-L)SA.12. bhikṣuḥ kho puna durvacakajātīyo bhoti /	bhikṣuḥ kho puna durvacaka jātīyaḥ bhoti 
SA_K01_prmosulu-253	so uddeśaparyāpannehi śikṣāpadehi bhikṣūhi śikṣāyāṃ saha dharmeṇa saha vinayena vucyamāno ātmānam avacanīyaṃ karoti /	saḥ uddeśa paryāpannehi śikṣā padehi bhikṣūhi śikṣāyām saha dharmeṇa saha vinayena vucyamānaḥ ātmānam avacanīyam karoti 
SA_K01_prmosulu-254	so evam āha Ō mā me āyuṣmanto kiñcid vadatha kalyāṇaṃ vā pāpakaṃ vā /	saḥ evam āha mā me āyuṣmantaḥ kiñcid vadatha kalyāṇam vā pāpakam vā 
SA_K01_prmosulu-255	aham apy āyuṣmantānāṃ na kiñcid vakṣyāmi kalyāṇaṃ vā pāpakaṃ vā /	aham api āyuṣmantānām na kiñcid vakṣyāmi kalyāṇam vā pāpakam vā 
SA_K01_prmosulu-256	viramathāyuṣmanto mama vacanāya /	viramatha āyuṣmantaḥ mama vacanāya 
SA_K01_prmosulu-257	so bhikṣu bhikṣūhi evam asya vacanīyo Ō mā āyuṣmann uddeśaparyāpannehi śikṣāpadehi bhikṣūhi śikṣāyāṃ saha dharmeṇa saha vinayena vucyamāno  #	saḥ bhikṣu bhikṣūhi evam asya vacanīyaḥ mā āyuṣman uddeśa paryāpannehi śikṣā padehi bhikṣūhi śikṣāyām saha dharmeṇa saha vinayena vucyamānaḥ 
SA_K01_prmosulu-258	ātmānam avacanīyaṃ karohi /	ātmānam a vacanīyam karohi 
SA_K01_prmosulu-259	[a]vacanīyam evāyuṣmān ātmānaṃ karotu /	a vacanīyam eva āyuṣmān ātmānam karotu 
SA_K01_prmosulu-260	bhikṣū pi āyuṣmantaṃ vakṣyanti śikṣāyāṃ saha dharmeṇa saha vina[yena] /	bhikṣū pi āyuṣmantam vakṣyanti śikṣāyām saha dharmeṇa saha vinayena 
SA_K01_prmosulu-261	āyuṣmān api bhikṣūn vadatu śikṣāyāṃ saha dharmeṇa saha vinayena /	āyuṣmān api bhikṣūn vadatu śikṣāyām saha dharmeṇa saha vinayena 
SA_K01_prmosulu-262	evaṃ saṃbaddhā kho punas tasya bhagavato tathāgatasyārhataḥ samyaksambuddhasya parṣā yad idam anyamanyasya vacanīyā,	evam saṃbaddhā kho punar tasya bhagavataḥ tathāgatasya arhataḥ samyaksambuddhasya parṣā yat idam anya manyasya vacanīyā 
SA_K01_prmosulu-263	anyonyāpatti vyutthāpanīyā /	anyonya āpatti vyutthāpanīyā 
SA_K01_prmosulu-264	evaṃ ca so bhikṣū bhikṣūhi vucyamāno taṃ vastuṃ pratinissareya ity etaṃ kuśalaṃ,	evam ca saḥ bhikṣuḥ bhikṣūhi vucyamānaḥ tam vastum pratinissareya iti etam kuśalam 
SA_K01_prmosulu-265	no ca pratinissareya so bhikṣu bhikṣūhi yāvantṛtīyakaṃ samanugrāhitavyo samanubhāṣitavyo tasya vastusya pratinissargāya /	no ca pratinissareya saḥ bhikṣu bhikṣūhi yāvantṛtīyakam samanugrāhitavyaḥ samanubhāṣitavyaḥ tasya vastusya pratinissargāya 
SA_K01_prmosulu-266	yāvantṛtīyakaṃ samanugrāhiyamāṇo vā taṃ vastuṃ pratinissareya ity etaṃ kuśalaṃ,	yāvantṛtīyakam vā tam vastum pratinissareya iti etam kuśalam 
SA_K01_prmosulu-267	no ca pratinissareya tam eva vastuṃ samādāya pragṛhya tiṣṭheya saṃghātiśeṣo /	no ca pratinissareya tam eva vastum samādāya pragṛhya tiṣṭheya saṃgha atiśeṣaḥ 
SA_K01_prmosulu-268	PrMoSū(Mā-L)SA. saṃbahulā bhikṣū kho punar anyataraṃ grāmam vā nagaraṃ vā nigamaṃ vā upaniśrāya viharanti kuladūṣakāḥ pāpasamācārāḥ /	saṃbahulāḥ bhikṣū kho punar anyataram grāmam vā nagaram vā nigamam vā upaniśrāya viharanti kula dūṣakāḥ pāpa samācārāḥ 
SA_K01_prmosulu-269	teṣāṃ te pāpakāḥ samācārā dṛśyante ca śrūyante ca /	teṣām te pāpakāḥ samācārāḥ dṛśyante ca śrūyante ca 
SA_K01_prmosulu-270	kulāny api duṣṭāni dṛśyante ca śrūyante ca /	kulāni api duṣṭāni dṛśyante ca śrūyante ca 
SA_K01_prmosulu-271	kuladūṣakāś ca punar bhavanti pāpasamācārāḥ /	kula dūṣakāḥ ca punar bhavanti pāpa samācārāḥ 
SA_K01_prmosulu-272	te bhikṣū bhikṣūhi evam asya vacanīyāḥ Ō āyuṣmantānāṃ khalu pāpakāḥ samācārāḥ dṛśyante ca śrūyante ca /	te bhikṣū bhikṣūhi evam asya vacanīyāḥ ō āyuṣmantānām khalu pāpakāḥ samācārāḥ dṛśyante ca śrūyante ca 
SA_K01_prmosulu-273	kulāny api duṣṭāni dṛśyante ca śrūyante ca /	kulāni api duṣṭāni dṛśyante ca śrūyante ca 
SA_K01_prmosulu-274	kuladūṣakāś ca punar āyuṣmantaḥ pāpasamācārāḥ /	kula dūṣakāḥ ca punar āyuṣmantaḥ pāpa samācārāḥ 
SA_K01_prmosulu-275	prakramathāyuṣmanto imasmād āvāsād alaṃ vo iha vustena /	prakramatha āyuṣmantaḥ imasmāt āvāsāt alam vaḥ iha 
SA_K01_prmosulu-276	evaṃ ca te bhikṣū bhikṣūhi vucyamānās te bhikṣū tān bhikṣūn evaṃ vadeṃsu Ō cchandagāmī cāyuṣmanto doṣagāmī cāyuṣmanto saṃgho,	evam ca te bhikṣū bhikṣūhi vucyamānāḥ te bhikṣū tān bhikṣūn evam vadeṃsu chanda gāmī ca āyuṣmantaḥ doṣa gāmī ca āyuṣmantaḥ saṃghaḥ 
SA_K01_prmosulu-277	mohagāmī cāyuṣmanto saṃgho,	moha gāmī ca āyuṣmantaḥ saṃghaḥ 
SA_K01_prmosulu-278	bhayagāmī cāyuṣmanto saṃgho,	bhaya gāmī ca āyuṣmantaḥ saṃghaḥ 
SA_K01_prmosulu-279	saṃgho ca tāhi tādṛśikāhi āpattīhi ekatyān bhikṣūn pravrājeti ekatyān bhikṣūn na pravrājeti /	saṃghaḥ ca tāhi tādṛśikāhi āpattīhi ekatyān bhikṣūn pravrāja iti ekatyān bhikṣūn na pravrāja iti 
SA_K01_prmosulu-280	te bhikṣū bhikṣūhi evam asya vacanīyāḥ Ō mā āyuṣmanto evaṃ vadatha /	te bhikṣū bhikṣūhi evam asya vacanīyāḥ mā āyuṣmantaḥ evam vadatha 
SA_K01_prmosulu-281	na saṃgho cchandagāmī,	na saṃghaḥ chanda gāmī 
SA_K01_prmosulu-282	na saṃgho doṣagāmī,	na saṃghaḥ doṣa gāmī 
SA_K01_prmosulu-283	na saṃgho mohagāmī,	na saṃghaḥ moha gāmī 
SA_K01_prmosulu-284	na saṃgho bhayagāmī /	na saṃghaḥ bhaya gāmī 
SA_K01_prmosulu-285	na ca saṃgho tāhi tādṛśikāhi āpattīhi ekatyān bhikṣūn pravrājeti,	na ca saṃghaḥ tāhi tādṛśikāhi āpattīhi ekatyān bhikṣūn pravrāja iti 
SA_K01_prmosulu-286	ekatyān bhikṣūn na pravrājeti /	ekatyān bhikṣūn na pravrāja iti 
SA_K01_prmosulu-287	āyuṣmantānām eva khalu pāpakāḥ samācārāḥ dṛśyante ca śrūyante ca /	āyuṣmantānām eva khalu pāpakāḥ samācārāḥ dṛśyante ca śrūyante ca 
SA_K01_prmosulu-288	kulāny api duṣṭāni dṛśyante ca śrūyante ca /	kulāni api duṣṭāni dṛśyante ca śrūyante ca 
SA_K01_prmosulu-289	kuladūṣakāś ca punar āyuṣmantaḥ pāpasamācārāḥ /	kula dūṣakāḥ ca punar āyuṣmantaḥ pāpa samācārāḥ 
SA_K01_prmosulu-290	prakramathāyuṣmanto imasmād āvāsād alaṃ vo iha vustena /	prakramatha āyuṣmantaḥ imasmāt āvāsāt alam vaḥ iha 
SA_K01_prmosulu-291	evaṃ ca te bhikṣū bhikṣūhi vucyamānā taṃ vastuṃ pratinissareṃsu ity etaṃ kuśalaṃ /	evam ca te bhikṣū bhikṣūhi vucyamānā tam vastum pratinissareṃsu iti etam kuśalam 
SA_K01_prmosulu-292	no ca pratinissareṃsu te bhikṣū bhikṣūhi yāvantṛtīyakaṃ samanugrāhitavyā samanubhāṣitavyās tasya vastusya pratinissargāya /	no ca pratinissareṃsu te bhikṣū bhikṣūhi yāvantṛtīyakam samanugrāhitavyā samanubhāṣitavyāḥ tasya vastusya pratinissargāya 
SA_K01_prmosulu-293	yāvantṛtīyakaṃ samanugrāhiyamāṇā vā samanubhāṣiyamāṇā vā taṃ vastuṃ prati[ni]ssareṃsu ity etaṃ kuśalaṃ /	yāvantṛtīyakam samanugrāhiyamāṇāḥ vā samanubhāṣiyamāṇāḥ vā tam vastum pratinissareṃsu iti etam kuśalam 
SA_K01_prmosulu-294	no ca pratinissareṃsu tam eva vastuṃ samādāya pragṛhya tiṣṭheṃsu saṃghātiśeṣo /	no ca pratinissareṃsu tam eva vastum samādāya pragṛhya tiṣṭheṃsu saṃgha atiśeṣaḥ 
SA_K01_prmosulu-295	// uddānaṃ //	uddānam 
SA_K01_prmosulu-296	(1) saṃcetanikā (2)	saṃcetanikā 
SA_K01_prmosulu-297	hastagraho (3)	hasta grahaḥ 
SA_K01_prmosulu-298	obhāṣo (4)	obhāṣaḥ 
SA_K01_prmosulu-299	paricaryā atha (5)	paricaryā atha 
SA_K01_prmosulu-300	saṃcaritraṃ (6)	saṃcaritram 
SA_K01_prmosulu-301	kuṭīṃ (7)	kuṭīm 
SA_K01_prmosulu-302	vihāro (8-9)	vihāraḥ 
SA_K01_prmosulu-303	dve cābhūtena (10)	dve ca abhūtena 
SA_K01_prmosulu-304	saṃghasya ca bhedāyopakrāmati /	saṃghasya ca bhedāya upakrāmati 
SA_K01_prmosulu-305	(11) tasya cānuvartakāḥ (12)	tasya ca anuvartakāḥ 
SA_K01_prmosulu-306	durvacako (13)	durvacakaḥ 
SA_K01_prmosulu-307	kuladūṣakāś ca //	kula dūṣakāḥ ca 
SA_K01_prmosulu-308	uddiṣṭā kho punar āyuṣmanto trayodaśa saṃghātiśeṣā dharmāḥ /	uddiṣṭā kho punar āyuṣmantaḥ trayodaśa saṃgha atiśeṣāḥ dharmāḥ 
SA_K01_prmosulu-309	tatra nava prathamāpattikāś catvāro yāvantṛtīyakā,	tatra nava prathama āpattikāḥ catvāraḥ yāvat tṛtīyakā 
SA_K01_prmosulu-310	yeṣāṃ bhikṣur ato 'nyatarām āpattim āpadyitvā yāvatakaṃ jānan* cchādeti tāvatakaṃ tena bhikṣuṇā akāmaparivāsaṃ parivasitavyaṃ /	yeṣām bhikṣuḥ atas nyatarām āpattim āpadyitvā yāvatakam jānan chādā iti tāvatakam tena bhikṣuṇā a kāma parivāsam parivasitavyam 
SA_K01_prmosulu-311	parivustaparivāsena bhikṣuṇā uttariṣaḍāhaṃ bhikṣusaṃghe mānatvaṃ caritavyaṃ /	parivusta parivāsena bhikṣuṇā uttari ṣaḍāham bhikṣu saṃghe māna tvam caritavyam 
SA_K01_prmosulu-312	cīrṇamānatvo bhikṣuḥ kṛtānudharmo āhvayanapratibaddho yatra syād viṃśagaṇo bhikṣusaṃgho tatra so bhikṣu āhvayitavyo /	cīrṇa māna tvaḥ bhikṣuḥ kṛta anudharmaḥ āhvayana pratibaddhaḥ yatra syāt viṃśa gaṇaḥ bhikṣu saṃghaḥ tatra saḥ bhikṣu āhvayitavyaḥ 
SA_K01_prmosulu-313	ekabhikṣuṇāpi ced ūnoviṃśatigaṇo bhikṣusaṃgho taṃ bhikṣum āhveya,	eka bhikṣuṇā api ced ūnoviṃśati gaṇaḥ bhikṣu saṃghaḥ tam bhikṣum 
SA_K01_prmosulu-314	so ca bhikṣu anāhūto te ca bhikṣū garhyāḥ /	saḥ ca bhikṣu anāhūtaḥ te ca bhikṣū garhyāḥ 
SA_K01_prmosulu-315	iyam atra sāmīcī /	iyam atra sāmīcī 
SA_K01_prmosulu-316	tatrāyuṣmanto pṛcchāmi kaccittha pariśuddhāḥ?	tatra āyuṣmantaḥ pṛcchāmi kaccit tha pariśuddhāḥ 
SA_K01_prmosulu-317	dvitīyaṃ pi āyuṣmanto pṛcchāmi kaccittha pariśuddhāḥ?	dvitīyam pi āyuṣmantaḥ pṛcchāmi kaccit tha pariśuddhāḥ 
SA_K01_prmosulu-318	tṛtīyaṃ pi āyuṣmanto pṛcchāmi kaccittha pariśuddhāḥ?	tṛtīyam pi āyuṣmantaḥ pṛcchāmi kaccit tha pariśuddhāḥ 
SA_K01_prmosulu-319	pariśuddhā atrāyuṣmanto yasmāt tūṣṇīm evam etaṃ dhārayāmi /	pariśuddhāḥ atra āyuṣmantaḥ yasmāt tūṣṇīm evam etam dhārayāmi 
SA_K01_prmosulu-320	[III. duve aniyatā dharmāḥ /]	iii duve aniyatāḥ dharmāḥ 
SA_K01_prmosulu-321	PrMoSū(Mā-L)Aniy. ime kho punar āyuṣmanto duve aniyatā dharmā anvardhamāsaṃ sūtre prātimokṣe uddeśam āgacchanti Ō	ime kho punar āyuṣmantaḥ duve aniyatāḥ dharmāḥ anvardha māsam sūtre prātimokṣe uddeśam āgacchanti 
SA_K01_prmosulu-322	PrMoSū(Mā-L)Aniy.1. yo puna bhikṣu mātṛgrāmeṇa sārdhaṃ praticchannāsane alaṃkarmaṇīye eko [ekā]ya raho niṣadyāṃ kalpeya,	yaḥ puna mātṛgrāmeṇa sārdham praticchanna āsane alaṃkarmaṇīye ekaḥ ekāya rahaḥ niṣadyām kalpeya 
SA_K01_prmosulu-323	tam enaṃ śraddheyavacasā upāsikā dṛṣṭvā trayāṇāṃ dharmāṇām anyatarānyatareṇa dharmeṇa vadeya pārājikena vā saṃghātiśeṣeṇa vā pācattikena vā	tam enam śraddheya vacasā upāsikā dṛṣṭvā trayāṇām dharmāṇām anyatara anyatareṇa dharmeṇa vadeya pārājikena vā saṃgha atiśeṣeṇa vā pācattikena vā 
SA_K01_prmosulu-324	niṣadyāṃ bhikṣuḥ pratijānamāno trayāṇāṃ dharmāṇām anyatarānyatareṇa dharmeṇa kārāpayitavyo	niṣadyām bhikṣuḥ pratijānamānaḥ trayāṇām dharmāṇām anyatara anyatareṇa dharmeṇa kārāpayitavyaḥ 
SA_K01_prmosulu-325	pārājikena vā saṃghātiśeṣeṇa vā pācattikena vā yena yena vā punar asya śraddheyavacasā	pārājikena vā saṃgha ati śeṣeṇa vā pācattikena vā yena yena vā punar asya śraddheya vacasā 
SA_K01_prmosulu-326	upāsikā dṛṣṭvā dharmeṇa vadeya,	upāsikāḥ dṛṣṭvā dharmeṇa vadeya 
SA_K01_prmosulu-327	tena so bhikṣu dharmeṇa kārāpayitavyo /	tena saḥ bhikṣu dharmeṇa kārāpayitavyaḥ 
SA_K01_prmosulu-328	ayaṃ dharmo aniyato /	ayam dharmaḥ aniyataḥ 
SA_K01_prmosulu-329	PrMoSū(Mā-L)Aniy.2. na haiva kho punaḥ praticchannāsanaṃ bhavati,	na ha eva khalu punar praticchanna āsanam bhavati 
SA_K01_prmosulu-330	nālaṃ karmaṇīyaṃ,	na alam karmaṇīyam 
SA_K01_prmosulu-331	alaṃ kho puna mātṛgrāmaṃ duṣṭhullāya vācāya obhāṣituṃ pāpikāya maithunopasaṃhitāya /	alam kho punar mātṛgrāmam duṣṭhullāya vācāya obhāṣitum pāpikāya maithuna upasaṃhitāya 
SA_K01_prmosulu-332	tathārūpe ca bhikṣu āsane mātṛgrāmeṇa sārdham eko ekāya raho niṣadyāṃ kalpeya,	tathārūpe ca bhikṣu āsane mātṛgrāmeṇa sārdham ekaḥ ekāya rahaḥ niṣadyām kalpeya 
SA_K01_prmosulu-333	tam enaṃ śraddheyavacasā upāsikā dṛṣṭvā dvinnāṃ dharmāṇām anyatarānyatareṇa dharmeṇa vadeya saṃghātiśeṣeṇa vā pācattikena vā /	tam enam śraddheya vacasā upāsikā dṛṣṭvā dvinnām dharmāṇām anyatara anyatareṇa dharmeṇa vadeya saṃgha atiśeṣeṇa vā pācattikena vā 
SA_K01_prmosulu-334	niṣadyāṃ bhikṣuḥ pratijānamāno dvinnāṃ dharmāṇām anyatarāntareṇa dharmeṇa kārāpayitavyo saṃghātiśeṣeṇa vā pācattikena vā,	niṣadyām bhikṣuḥ pratijānamānaḥ dvinnām dharmāṇām anyatara antareṇa dharmeṇa kārāpayitavyaḥ saṃgha atiśeṣeṇa vā pācattikena vā 
SA_K01_prmosulu-335	yena yena vā punar asya śraddheyavacasā upāsikā dṛṣṭvā dharmeṇa vadeya,	yena yena vā punar asya śraddheya vacasā upāsikā dṛṣṭvā dharmeṇa vadeya 
SA_K01_prmosulu-336	tena tena so bhikṣu dharmeṇa kārāpayitavyo /	tena tena saḥ bhikṣu dharmeṇa kārāpayitavyaḥ 
SA_K01_prmosulu-337	ayaṃ pi dharmo aniyato /	ayam pi dharmaḥ aniyataḥ 
SA_K01_prmosulu-338	// uddānaṃ //	uddānam 
SA_K01_prmosulu-339	(1) praticchannāsanaṃ (2)	praticchanna āsanam 
SA_K01_prmosulu-340	rahoniṣadyā ca /	rahoniṣadyā ca 
SA_K01_prmosulu-341	uddiṣṭāḥ kho punar āyuṣmanto duve aniyatā dharmāḥ /	uddiṣṭāḥ kho punar āyuṣmantaḥ duve aniyatāḥ dharmāḥ 
SA_K01_prmosulu-342	tatrāyuṣmanto pṛcchāmi kaccittha pariśuddhāḥ?	tatra āyuṣmantaḥ pṛcchāmi kaccit tha pariśuddhāḥ 
SA_K01_prmosulu-343	dvitīyaṃ pi āyuṣmanto pṛcchāmi kaccittha pariśuddhā?	dvitīyam pi āyuṣmantaḥ pṛcchāmi kaccit tha pariśuddhā 
SA_K01_prmosulu-344	tṛtīyaṃ pi āyuṣmanto pṛcchāmi kaccittha pariśuddhāḥ?	tṛtīyam pi āyuṣmantaḥ pṛcchāmi kaccit tha pariśuddhāḥ 
SA_K01_prmosulu-345	pariśuddhā atrāyuṣmanto yasmāt tūṣṇīm evam etaṃ dhārayāmi /	pariśuddhāḥ atra āyuṣmantaḥ yasmāt tūṣṇīm evam etam dhārayāmi 
SA_K01_prmosulu-346	[IV. triṃśan nissargikapācattikā dharmāḥ]	iv triṃśat nissargika pācattikāḥ dharmāḥ 
SA_K01_prmosulu-347	ime kho punar āyuṣmanto triṃśan nissargikapācattikā dharmā anvardhamāsaṃ sūtre prātimokṣe uddeśam āgacchanti Ō	ime kho punar āyuṣmantaḥ triṃśat nissargika pācattikāḥ dharmāḥ anvardha māsam sūtre prātimokṣe uddeśam āgacchanti 
SA_K01_prmosulu-348	PrMoSū(Mā-L)NP.1. kṛtacīvarehi bhikṣūhi uddhṛtasmin kaṭhine daśāhaparamaṃ bhikṣuṇā atirekacīvaraṃ dhārayitavyaṃ /	kṛta cīvarehi bhikṣūhi uddhṛtasmin kaṭhine daśa aha paramam bhikṣuṇā atireka cīvaram dhārayitavyam 
SA_K01_prmosulu-349	taduttariṃ dhāreya,	tat uttarim dhāreya 
SA_K01_prmosulu-350	nissargikapācattikaṃ /	nissargika pācattikam 
SA_K01_prmosulu-351	PrMoSū(Mā-L)NP.2. kṛtacīvarehi bhikṣūhi uddhṛtasmin kaṭhine ekarātraṃ pi ced bhikṣuḥ trayāṇāṃ cīvarāṇām anyatarānyatareṇa vipravaseya anyatra	kṛta cīvarehi bhikṣūhi uddhṛtasmin kaṭhine eka rātram ced bhikṣuḥ trayāṇām cīvarāṇām anyatara anyatareṇa vipravaseya anyatra 
SA_K01_prmosulu-352	nissargikapācattikaṃ /	nissargika pācattikam 
SA_K01_prmosulu-353	PrMoSū(Mā-L)NP.3. kṛtacīvarehi bhikṣūhi uddhṛtasmin kaṭhine utpadyeya bhikṣusya akālacīvaram ākāṃkṣamāṇena bhikṣuṇā pratigṛhṇitavyaṃ /	kṛta cīvarehi bhikṣūhi uddhṛtasmin kaṭhine utpadyeya bhikṣusya akāla cīvaram ākāṃkṣamāṇena bhikṣuṇā pratigṛhṇitavyam 
SA_K01_prmosulu-354	pratigṛhṇitvā kṣipram eva taṃ cīvaraṃ kārāpayitavyaṃ /	pratigṛhṇitvā kṣipram eva tam cīvaram kārāpayitavyam 
SA_K01_prmosulu-355	kārāpayato ca tasya bhikṣusya taṃ cīvaraṃ na paripūreya,	ca tasya bhikṣusya tam cīvaram na paripūreya 
SA_K01_prmosulu-356	māsaparamaṃ tena bhikṣuṇā taṃ cīvaraṃ nikṣipitavyaṃ ūnasya pāripūrīye santīye pratyāśāye /	māsa paramam tena bhikṣuṇā tam cīvaram nikṣipitavyam ūnasya pāripūrīye santīye 
SA_K01_prmosulu-357	taduttariṃ nikṣipeya santīye vā asantīye vā pratyāśāye nissargikapācattikaṃ /	tad uttarim nikṣipeya santīye vā a santīye vā nissargika pācattikam 
SA_K01_prmosulu-358	PrMoSū(Mā-L)NP.4. yo puna bhikṣur anyātikāye bhikṣuṇīye cīvaraṃ pratigṛhṇeya anyatra pallaṭṭhakena nissargikapācattikaṃ /	yaḥ puna bhikṣuḥ anya atikāye bhikṣuṇīye cīvaram pratigṛhṇeya anyatra pallaṭṭhakena nissargika pācattikam 
SA_K01_prmosulu-359	PrMoSū(Mā-L)NP.5. yo puna bhikṣur anyātikāye bhikṣuṇīye purāṇacīvaraṃ dhovāpeya vā rañjāpeya vā ākoṭāpeya vā nissargikapācattikaṃ /	yaḥ puna bhikṣuḥ anya atikāye bhikṣuṇīye purāṇa cīvaram dhovāpeya vā rañjāpeya vā ākoṭāpeya vā nissargika pācattikam 
SA_K01_prmosulu-360	PrMoSū(Mā-L)NP.6. yo puna bhikṣur anyātakaṃ gṛhapatiṃ vā gṛhapatiputraṃ [?	yaḥ puna bhikṣuḥ anyātakam gṛhapatim vā gṛhapati putram 
SA_K01_prmosulu-361	Śtipatinīṃ] vā cīvaraṃ yāceya anyatra samaye nissargikapācattikaṃ /	vā cīvaram yāceya anyatra samaye nissargika pācattikam 
SA_K01_prmosulu-362	tatrāyaṃ samayo Ō ācchinnacīvaro bhikṣur bhavati /	tatra ayam samayaḥ ācchinna cīvaraḥ bhikṣuḥ bhavati 
SA_K01_prmosulu-363	ayam atra samayo /	ayam atra samayaḥ 
SA_K01_prmosulu-364	PrMoSū(Mā-L)NP.7. ācchinnacīvareṇa bhikṣuṇā kṣamate anyātakaṃ gṛhapatiṃ vā gṛhapatiputrīṃ [Śtipatinīṃ] vā cīvaraṃ yācituṃ /	ācchinna cīvareṇa bhikṣuṇā kṣamate anyātakam gṛhapatim vā gṛhapati putrīm śti patinīm vā cīvaram yācitum 
SA_K01_prmosulu-365	tam enam abhihṛṣṭo samāno saṃbahulehi cīvarehi pravāreya,	tam enam abhihṛṣṭaḥ samānaḥ saṃbahulehi cīvarehi pravāreya 
SA_K01_prmosulu-366	tathāpravāritena bhikṣuṇā sāntarottaraparamaṃ cīvaraṃ sādayitavyaṃ /	tathā pravāritena bhikṣuṇā sa antara uttara paramam cīvaram sādayitavyam 
SA_K01_prmosulu-367	taduttariṃ sādiyeya nissargikapācattikaṃ /	tad uttarim sādiyeya nissargika pācattikam 
SA_K01_prmosulu-368	PrMoSū(Mā-L)NP.8. bhikṣuṃ kho punar uddiśya anyatareṣāṃ dvinnāṃ gṛhapatikānāṃ cīvaracetāpanāny	bhikṣum kho punar uddiśya anyatareṣām dvinnām gṛhapatikānām cīvara cetāpanāni 
SA_K01_prmosulu-369	abhisaṃskṛtāni bhavanti abhisaṃcetayitāni Ō imehi vayaṃ cīvaracetāpanehi civaraṃ	abhisaṃskṛtāni bhavanti abhisaṃcetayitāni imehi vayam cīvara cetāpanehi civaram 
SA_K01_prmosulu-370	cetāpayitvā itthanāmaṃ bhikṣuṃ cīvareṇācchadayiṣyāmaḥ /	cetāpayitvā itthanāmam bhikṣum cīvareṇa ācchadayiṣyāmaḥ 
SA_K01_prmosulu-371	tatra ca bhikṣuḥ pūrvaṃ apravārito upasaṃkramitvā vikalpam āpadyeya Ō sādhu kho puna	tatra ca bhikṣuḥ pūrvam a pravāritaḥ upasaṃkramitvā vikalpam āpadyeya sādhu kho punar 
SA_K01_prmosulu-372	yūyam āyuṣmanto imehi cīvaracetāpanehi cīvaraṃ cetāpayitvā itthaṃnāmaṃ bhikṣuṃ cīvareṇācchādetha /	yūyam āyuṣmantaḥ imehi cīvara cetāpanehi cīvaram cetāpayitvā itthaṃnāmam bhikṣum cīvareṇa ācchādetha 
SA_K01_prmosulu-373	evaṃrūpeṇa vā [evaṃrūpeṇa vā] ubhau pi sahitau ekena kalyāṇakāmatām upādāya /	evaṃrūpeṇa vā evaṃrūpeṇa vā ubhau sahitau ekena kalyāṇa kāmatām upādāya 
SA_K01_prmosulu-374	abhiniṣpanne cīvare ni[ssa]rgikapācattikaṃ /	abhiniṣpanne cīvare nissargika pācattikam 
SA_K01_prmosulu-375	PrMoSū(Mā-L)NP.9. bhikṣuṃ kho punar uddiśya anyatareṣāṃ dvinnāṃ gṛhapatikasya gṛhapatinīye ca pratyekacīvaracetāpanāni abhisaṃskṛtāni bhavanti,	bhikṣum kho punar uddiśya anyatareṣām dvinnām gṛhapatikasya gṛhapatinīye ca pratyeka cīvara cetāpanāni abhisaṃskṛtāni bhavanti 
SA_K01_prmosulu-376	abhisaṃcetayitāni Ō imehi vayaṃ pratyekacīvaracetāpanehi pratyekaṃ pratyekaṃ cīvaraṃ cetāpayitvā itthaṃnāmaṃ bhikṣuṃ pratyekaṃ pratyekaṃ cīvareṇācchadayiṣyāmaḥ	abhisaṃcetayitāni ū imehi vayam pratyeka cīvara cetāpanehi pratyekam pratyekam cīvaram cetāpayitvā itthaṃnāmam bhikṣum pratyekam pratyekam cīvareṇa ācchadayiṣyāmaḥ 
SA_K01_prmosulu-377	tatra ca bhikṣuḥ pūrvaṃ apravārito upasaṃkramitvā vikalpam āpadyeya Ō sādhu kho punas tvam āyuṣman,	tatra ca bhikṣuḥ pūrvam a pravāritaḥ upasaṃkramitvā vikalpam āpadyeya sādhu kho punar tvam āyuṣman 
SA_K01_prmosulu-378	tvaṃ ca bhagini,	tvam ca bhagini 
SA_K01_prmosulu-379	imehi pratyekacīvaracetāpanehi pratyekaṃ cīvaraṃ cetāpayitvā itthaṃnāmaṃ bhikṣuṃ	imehi pratyeka cīvara cetāpanehi pratyekam cīvaram cetāpayitvā itthaṃnāmam bhikṣum 
SA_K01_prmosulu-380	pratyekaṃ cīvareṇācchādetha evaṃrūpeṇa vā evaṃrūpeṇa vā ubhau pi sahitau ekena kalyāṇakāmatām upādāya /	pratyekam cīvareṇa ācchādetha evaṃrūpeṇa vā evaṃrūpeṇa vā ubhau sahitau ekena kalyāṇa kāmatām upādāya 
SA_K01_prmosulu-381	abhiniṣpanne cīvare nissargikapācattikaṃ /	abhiniṣpanne cīvare nissargika pācattikam 
SA_K01_prmosulu-382	PrMoSū(Mā-L)NP.10. bhikṣuṃ kho punar uddiśya anyataro rājā vā rājabhogyo vā dūtena cīvaracetāpanāni preṣeya /	bhikṣum kho punar uddiśya anyataraḥ rājā vā rāja bhogyaḥ vā dūtena cīvara cetāpanāni preṣeya 
SA_K01_prmosulu-383	so bhikṣus tenopasaṃkramitvā taṃ bhikṣum evaṃ vadeya Ō imāni khalv āryam uddiśya itthaṃnāmena rājñā ca rājabhogyena vā dūtena cīvaracetāpanāni	saḥ bhikṣuḥ tena upasaṃkramitvā tam bhikṣum evam vadeya imāni khalu āryam uddiśya itthaṃnāmena rājñā ca rāja bhogyena vā dūtena cīvara cetāpanāni 
SA_K01_prmosulu-384	tāni āryo pratigṛhṇātu /	tāni āryo pratigṛhṇātu 
SA_K01_prmosulu-385	tena bhikṣuṇā so dūto evam asya vacanīyo Ō na kho punar āyuṣman kṣamate bhikṣusya cīvaracetāpanāni pratigṛhṇituṃ /	tena bhikṣuṇā saḥ dūtaḥ evam asya vacanīyaḥ na kho punar āyuṣman kṣamate bhikṣusya cīvara cetāpanāni pratigṛhṇitum 
SA_K01_prmosulu-386	cīvaraṃ tu vayaṃ pratigṛhṇāmaḥ kālena samayena kalpikaṃ dīyamānaṃ /	cīvaram tu vayam pratigṛhṇāmaḥ kālena samayena kalpikam dīyamānam 
SA_K01_prmosulu-387	evam ukte so dūto taṃ bhikṣum evaṃ vadeya [sa]nti punar ārya kecid bhikṣūṇāṃ vaiyāpṛtyakarāti /	evam ukte saḥ dūtaḥ tam bhikṣum evam vadeya santi punar ārya kecid bhikṣūṇām 
SA_K01_prmosulu-388	ākāṃkṣamāṇena bhikṣuṇā santā vaiyāpṛtyakarā vyapadiśitavyāḥ ārāmikā vā /	ākāṃkṣamāṇena bhikṣuṇā santāḥ vaiyāpṛtya karāḥ vyapadiśitavyāḥ ārāmikāḥ vā 
SA_K01_prmosulu-389	ete āyuṣman bhikṣūṇāṃ vaiyāpṛtyakarā ye bhikṣūṇāṃ vaiyāpṛtyaṃ karonti /	ete āyuṣman bhikṣūṇām vaiyāpṛtya karāḥ ye bhikṣūṇām vaiyāpṛtyam karonti 
SA_K01_prmosulu-390	evam ukte so dūto yena vaiyāpṛtyakarās tenopasaṃkramitvā tān vaiyāpṛtyakarān evaṃ	evam ukte saḥ dūtaḥ yena vaiyāpṛtya karāḥ tena upasaṃkramitvā tān vaiyāpṛtya karān evam 
SA_K01_prmosulu-391	vadeya Ō sādhu kho puna yūyam āyuṣmanto vaiyāpṛtyakarā imehi cīvaracetāpanehi cīvaraṃ	vadeya sādhu khalu puna yūyam āyuṣmantaḥ vaiyāpṛtya karāḥ imehi cīvara cetāpanehi cīvaram 
SA_K01_prmosulu-392	cetāpayitvā itthaṃnāma bhikṣuṃ cīvareṇācchādetha kālena samayena kalpikenānavadyena /	cetāpayitvā itthaṃnāma bhikṣum cīvareṇa ācchādetha kālena samayena kalpikena anavadyena 
SA_K01_prmosulu-393	so ca dūto tān vaiyāpṛtyakarān saṃjñapayitvā yena so bhikṣus tenopasaṃkramitvā na	saḥ ca dūtaḥ tān vaiyāpṛtya karān saṃjñapayitvā yena saḥ bhikṣuḥ tena upasaṃkramitvā na 
SA_K01_prmosulu-394	bhikṣum eva vadeya ye khu te āryeṇa vaiyāpṛtyakarā vyapadiṣṭās te mayā saṃjñaptās	bhikṣum eva vadeya ye khu te āryeṇa vaiyāpṛtya karāḥ vyapadiṣṭāḥ te mayā saṃjñaptāḥ 
SA_K01_prmosulu-395	tān upasaṃkrameyāmi /	tān upasaṃkrameyāmi 
SA_K01_prmosulu-396	ācchādayiṣyanti te cīvareṇa kālena samayena kalpikenānavadyena /	ācchādayiṣyanti te cīvareṇa kālena samayena kalpikena anavadyena 
SA_K01_prmosulu-397	ākāṃkṣamāṇena bhikṣuṇā cīvarārthikena [yena] te vaiyāpṛtyakarās tenopasaṃkramitvā	ākāṃkṣamāṇena bhikṣuṇā cīvara arthikena yena te vaiyāpṛtya karāḥ tena upasaṃkramitvā 
SA_K01_prmosulu-398	te vaiyāpṛtyakarāḥ sakṛt* dvikkhutto trikkhutto codayitavyā vijñāpayitavyāḥ Ō artho	te vaiyāpṛtya karāḥ sakṛt dvikkhutto trikkhutto codayitavyāḥ vijñāpayitavyāḥ artho 
SA_K01_prmosulu-399	āyuṣmanto bhikṣusya cīvareṇeti /	āyuṣmantaḥ bhikṣusya cīvareṇa iti 
SA_K01_prmosulu-400	sakṛt* dvikkhutto trikkhutto codayanto vijñāpayanto taṃ cīvaram abhiniṣpādeya ity etat kuśalaṃ,	sakṛt dvi kkhuttaḥ tri kkhuttaḥ codayantaḥ vijñāpayantaḥ tam cīvaram abhiniṣpādeya iti etat kuśalam 
SA_K01_prmosulu-401	no ced abhiniṣpādeya catukkhutto pañcakhutto ṣaṭkhuttoparamaṃ tena bhikṣuṇā tūṣṇībhūtena uddeśe sthātavyaṃ /	no ced abhiniṣpādeya catukkhutto pañcakhutto ṣaṣ khutta uparamam tena bhikṣuṇā tūṣṇībhūtena uddeśe sthātavyam 
SA_K01_prmosulu-402	catukkhutto pañcakkhutto ṣaṭkkhuttoparamaṃ tūṣṇībhūto uddeśe tiṣṭhanto taṃ cīvaram abhiniṣpādeya,	catur khuttaḥ pañca khuttaḥ ṣaṣ khutta uparamam tūṣṇībhūtaḥ uddeśe tiṣṭhantaḥ tam cīvaram abhiniṣpādeya 
SA_K01_prmosulu-403	ity etat kuśalaṃ,	iti etat kuśalam 
SA_K01_prmosulu-404	no ced abhiniṣpādeya tad uttapanto vā vyāyamanto vā taṃ cīvaram abhiniṣpādeya,	na u ced abhiniṣpādeya tat uttapantaḥ vā vyāyamantaḥ vā tam cīvaram abhiniṣpādeya 
SA_K01_prmosulu-405	abhiniṣpanne cīvare nissargikapācattikaṃ /	abhiniṣpanne cīvare nissargika pācattikam 
SA_K01_prmosulu-406	no ced abhiniṣpādeya yena se tāni rājñā vā rājabhogyena vā dūtena cīvaracetāpanāni preṣitāni tatra tena bhikṣuṇā svayaṃ vā gantavyaṃ,	no ced yena se tāni rājñā vā rājabhogyena vā dūtena cīvara cetāpanāni preṣitāni tatra tena bhikṣuṇā svayam vā gantavyam 
SA_K01_prmosulu-407	dūto vā pratirūpo preṣayitavyo,	dūtaḥ vā pratirūpaḥ preṣayitavyaḥ 
SA_K01_prmosulu-408	yāni khu āyuṣmantehi itthaṃnāmaṃ bhikṣum uddiśya dūtena cīvaracetāpanāni preṣitāni na khu tāni tasya bhikṣusya kiñcid arthaṃ spharanti,	yāni khu itthaṃnāmam bhikṣum uddiśya dūtena cīvara cetāpanāni preṣitāni na khu tāni tasya bhikṣusya kiñcid artham spharanti 
SA_K01_prmosulu-409	pratyanveṣatha,	pratyanveṣatha 
SA_K01_prmosulu-410	na svakaṃ dharmo /	na svakam 
SA_K01_prmosulu-411	vo vipraṇaśiṣyatīti iyam atra sāmīcī /	vaḥ vipraṇaśiṣyati iti iyam atra sāmīcī 
SA_K01_prmosulu-412	// uddānaṃ //	uddānam 
SA_K01_prmosulu-413	(1) daśāhaṃ (2) vipravāso (3)	daśa aham vipravāsaḥ 
SA_K01_prmosulu-414	akāle ca (4)	akāle ca 
SA_K01_prmosulu-415	pratigraho (5)	pratigrahaḥ 
SA_K01_prmosulu-416	dhovanā (6)	dhovanā 
SA_K01_prmosulu-417	yācanā caṃva /	yācanā caṃva 
SA_K01_prmosulu-418	(7) sāntarottaraṃ (8-9)	sa antara uttaram 
SA_K01_prmosulu-419	dve ca vikalpena (10) rājā ca //	dve ca vikalpena rājā ca 
SA_K01_prmosulu-420	prathamo vargaḥ //	prathamaḥ vargaḥ 
SA_K01_prmosulu-421	PrMoSū(Mā-L)NP.11. yo puna bhikṣuḥ śuddhakālakānām eḍakalomānāṃ navaṃ santhataṃ kārāpeya nissargikapācattikaṃ /	yaḥ puna bhikṣuḥ śuddha kālakānām eḍaka lomānām navam santhatam kārāpeya nissargika pācattikam 
SA_K01_prmosulu-422	PrMoSū(Mā-L)NP.12. navaṃ santhataṃ bhikṣuṇā kārāpayamāṇena śuddhakālakānām eḍakalomānāṃ dve bhāgā ādayitavyās tṛtīyo odātikānāṃ caturtho gocarikāṇāṃ	navam santhatam bhikṣuṇā kārāpayamāṇena śuddha kālakānām eḍaka lomānām dve bhāgāḥ ādayitavyāḥ tṛtīyaḥ odātikānām caturthaḥ gocarikāṇām 
SA_K01_prmosulu-423	taduttarim ādiyeya nissargikapācattikaṃ /	tad uttarim ādiyeya nissargika pācattikam 
SA_K01_prmosulu-424	PrMoSū(Mā-L)NP.13. yo puna bhikṣuḥ kauśeyamiśrāṇām eḍakalomānāṃ navaṃ santhataṃ kārāpeya nissargikapācattikaṃ /	yaḥ puna bhikṣuḥ kauśeya miśrāṇām eḍaka lomānām navam santhatam kārāpeya nissargika pācattikam 
SA_K01_prmosulu-425	PrMoSū(Mā-L)NP.14. navaṃ santhataṃ bhikṣuṇā kārāpayamāṇena akāmaṃ ṣaḍvarṣāṇi dhārayitavyaṃ /	navam santhatam bhikṣuṇā kārāpayamāṇena akāmam ṣaṣ varṣāṇi dhārayitavyam 
SA_K01_prmosulu-426	tato ca bhikṣuḥ pratyoreṇa taṃ purāṇaṃ santhataṃ visarjayitvā vā avisarjayitvā vā anyaṃ navaṃ santhataṃ kārāpeya kalyāṇakāmatām upādāya,	tatas ca bhikṣuḥ pratyoreṇa tam purāṇam santhatam visarjayitvā vā a visarjayitvā vā anyam navam santhatam kārāpeya kalyāṇa kāma tām upādāya 
SA_K01_prmosulu-427	anyatra namatasaṃmutīye nissargikapācattikaṃ /	anyatra na mata saṃmutīye nissargika pācattikam 
SA_K01_prmosulu-428	PrMoSū(Mā-L)NP.15. navaṃ santhataniṣīdanaṃ bhikṣuṇā kārāpayamāṇena tato purāṇasanthatāto samantāt sugatavitastinā bhāgo ādayitavyo navasya	navam santhata niṣīdanam bhikṣuṇā kārāpayamāṇena samantāt sugata vitastinā bhāgaḥ ādayitavyaḥ navasya 
SA_K01_prmosulu-429	tato ca bhikṣur anādāya navasanthataṃ niṣīdanaṃ kārāpeya nissargikapācattikaṃ /	tatas ca bhikṣuḥ an ādāya navasanthatam niṣīdanam kārāpeya nissargika pācattikam 
SA_K01_prmosulu-430	PrMoSū(Mā-L)NP.16. bhikṣusya kho punar adhvānamārge pratipannasya utpadyeṃsu e[ḍa]kalomāni /	bhikṣusya kho punar adhvāna mārge pratipannasya utpadyeṃsu eḍaka lomāni 
SA_K01_prmosulu-431	ākāṃkṣamāṇena bhikṣuṇā pratigṛhṇitavyaṃ /	ākāṃkṣamāṇena bhikṣuṇā pratigṛhṇitavyam 
SA_K01_prmosulu-432	pratigṛhṇitvā sāmaṃ triyojanaparamaṃ hartavyam asante anyasmi[n] hārake taduttariṃ hāreya sante vā asante vā anyasmi[n] hārake,	pratigṛhṇitvā sāmam tri yojana paramam hartavyam asante anyasmin hārake tad uttarim hāreya sante vā asante vā anyasmin hārake 
SA_K01_prmosulu-433	nissargikapācattikaṃ /	nissargika pācattikam 
SA_K01_prmosulu-434	PrMoSū(Mā-L)NP.17. yo puna bhikṣur anyātikāye bhikṣuṇīye eḍakalomādi dhovāpeya vā raṃjāpe[ya] vā vivaṭāpaye vā,	yaḥ puna bhikṣuḥ anya atikāye bhikṣuṇīye eḍaka loma ādi vā vā vivaṭāpaye vā 
SA_K01_prmosulu-435	nissargikapācattikaṃ /	nissargika pācattikam 
SA_K01_prmosulu-436	PrMoSū(Mā-L)NP.18. yo puna bhikṣuḥ svahastaṃ jātarūparajatam udgṛhṇeya vā udgṛhṇāpeya vā antamasato iha nikṣipehīti vā vadeya,	yaḥ punar bhikṣuḥ sva hastam jātarūpa rajatam udgṛhṇeya vā vā iha nikṣipehi iti vā vadeya 
SA_K01_prmosulu-437	upanikṣiptaṃ vā sādiyeya nissargikapācattikaṃ /	upanikṣiptam vā sādiyeya nissargika pācattikam 
SA_K01_prmosulu-438	PrMoSū(Mā-L)NP.19. yo puna bhikṣur anekavidhaṃ krayavikrayavyavahāraṃ samāpadyeya saṃyyathīdaṃ imaṃ kriṇa ito kriṇa ettakamettake[na krī]ṇāhīti  #	punar bhikṣuḥ anekavidham kraya vikraya vyavahāram samāpadyeya saṃyyathī idam imam kriṇe ito kriṇe ettakam ettakena krīṇāhi iti 
SA_K01_prmosulu-439	vā vadeya,	vā vadeya 
SA_K01_prmosulu-440	nissargikapācattikaṃ /	nissargika pācattikam 
SA_K01_prmosulu-441	PrMoSū(Mā-L)NP.20. yo puna bhikṣur anekavidhaṃ jātarūparajatavikṛtivyavahāraṃ samāpadyeya nissargikapācattikam //	yaḥ puna bhikṣuḥ anekavidham jātarūpa rajata vikṛti vyavahāram samāpadyeya nissargika pācattikam 
SA_K01_prmosulu-442	// uddānaṃ //	uddānam 
SA_K01_prmosulu-443	(11) śuddhakālakānāṃ (12)	śuddha kālakānām 
SA_K01_prmosulu-444	dve bhāgā (13)	dve bhāgā 
SA_K01_prmosulu-445	kauśeyamiśra (14)	kauśeya miśra 
SA_K01_prmosulu-446	ṣaḍvarṣāṇi (15)	ṣaṣ varṣāṇi 
SA_K01_prmosulu-447	niṣīdanaṃ (16)	niṣīdanam 
SA_K01_prmosulu-448	adhvānamārgo (17)	adhvāna mārgaḥ 
SA_K01_prmosulu-449	vivaṭā vā (18)	vivaṭā vā 
SA_K01_prmosulu-450	svahastaṃ (19)	sva hastam 
SA_K01_prmosulu-451	krayavikraya (20)	kraya vikraya 
SA_K01_prmosulu-452	vikṛtivyavahāreṇa //	vikṛti vyavahāreṇa 
SA_K01_prmosulu-453	dvitīyo vargaḥ //	dvitīyaḥ vargaḥ 
SA_K01_prmosulu-454	PrMoSū(Mā-L)NP.21. daśāhaparamaṃ bhikṣuṇā atirekapātraṃ dhārayitavyaṃ /	daśa aha paramam bhikṣuṇā atireka pātram dhārayitavyam 
SA_K01_prmosulu-455	taduttariṃ dhāreya nissargikapācattikaṃ /	tad uttarim dhāreya nissargika pācattikam 
SA_K01_prmosulu-456	PrMoSū(Mā-L)NP.22. yo puna bhikṣu ūnapañcabandhanabaddhena pātreṇa anyaṃ navaṃ pātraṃ paryeṣeya kāmātām upādāya,	yaḥ puna ūna pañca bandhana baddhena pātreṇa anyam navam pātram paryeṣeya kāmātām upādāya 
SA_K01_prmosulu-457	tena bhikṣuṇā taṃ pātraṃ bhikṣuparṣāye nissaritavyaṃ /	tena bhikṣuṇā tam pātram bhikṣu parṣāye nissaritavyam 
SA_K01_prmosulu-458	yo tahi bhikṣuparṣāye pātraparyanto bhavati so tasya bhikṣusya anupradātavyo Ō evaṃ te āyuṣman pātro dhārayitavyo yāvad bhedanaṃ,	yaḥ tahi bhikṣu parṣāye pātra paryantaḥ bhavati saḥ tasya bhikṣusya anupradātavyaḥ evam te āyuṣman pātraḥ dhārayitavyaḥ yāvat bhedanam 
SA_K01_prmosulu-459	nissargikapācattikaṃ /	nissargika pācattikam 
SA_K01_prmosulu-460	PrMoSū(Mā-L)NP.23. yāni kho punar imāni gilānapratiṣevaṇīyāni bhaiṣajyāni bhavanti sayyathīdaṃ sarpistailamadhuphāṇitaṃ Ō evaṃrūpāṇi gilānena  #	yāni khalu punar imāni gilāna pratiṣevaṇīyāni bhaiṣajyāni bhavanti sayyathī idam sarpiḥ taila madhu phāṇitam evaṃrūpāṇi gilānena 
SA_K01_prmosulu-461	bhikṣuṇā satkṛtyābhigṛhītāni,	bhikṣuṇā satkṛtya abhigṛhītāni 
SA_K01_prmosulu-462	kṣamate saptāhaṃ sannidhikāraṃ paribhuñjituṃ,	kṣamate sapta aham sannidhi kāram paribhuñjitum 
SA_K01_prmosulu-463	santaṃ śeṣaṃ nissaritavyaṃ tad uttaritavyaṃ /	santam śeṣam nissaritavyam tat uttaritavyam 
SA_K01_prmosulu-464	taduttariṃ khādeya vā bhuṃjeya vā santaṃ vā śeṣabhū[taṃ] nissareya nissargikapācattikaṃ /	tad uttarim khādeya vā bhuṃjeya vā santam vā śeṣa bhūtam nissareya nissargika pācattikam 
SA_K01_prmosulu-465	PrMoSū(Mā-L)NP.24. yo puna bhikṣu bhikṣusya cīvaraṃ datvā yathā duṣṭo doṣāt kupito anāttamāno ācchindeya vā ācchindāpayeya vā Ō āhara bhikṣu	yaḥ puna bhikṣu bhikṣusya cīvaram da tvā yathā duṣṭaḥ doṣāt kupitaḥ an ātta mānaḥ ācchindeya vā ācchindāpayeya vā āhara bhikṣu 
SA_K01_prmosulu-466	na te 'haṃ demīti vā vadeya,	na te ham demi iti vā vadeya 
SA_K01_prmosulu-467	nissargikapācattikaṃ /	nissargika pācattikam 
SA_K01_prmosulu-468	PrMoSū(Mā-L)NP.25. māso śeṣo grīṣmāṇām iti bhikṣuṇā varṣāsāṭikācīvaraṃ paryeṣitavyaṃ /	māsaḥ śeṣaḥ grīṣmāṇām iti bhikṣuṇā varṣā sāṭikā cīvaram paryeṣitavyam 
SA_K01_prmosulu-469	ardhamāso avaśiṣṭo ti kṛtvā snapitavyam /	ardha māsaḥ avaśiṣṭaḥ ti kṛtvā snapitavyam 
SA_K01_prmosulu-470	tato ca bhikṣuḥ pra[tyo]reṇa varṣāsāṭikācīvaraṃ paryeṣeya,	tatas ca bhikṣuḥ pratyoreṇa varṣāsāṭikā cīvaram paryeṣeya 
SA_K01_prmosulu-471	kṛtvā vā snāpeya,	kṛtvā vā snāpeya 
SA_K01_prmosulu-472	nissargikapācattikaṃ /	nissargika pācattikam 
SA_K01_prmosulu-473	PrMoSū(Mā-L)NP.26. yo puna bhikṣuḥ svayaṃyācikāya sūtraṃ tantuvāyena cīvaraṃ vunāpeya nissargikapācattikaṃ /	yaḥ puna bhikṣuḥ svayaṃyācikāya sūtram tantuvāyena cīvaram nissargika pācattikam 
SA_K01_prmosulu-474	PrMoSū(Mā-L)NP.27. bhikṣuṃ kho punar uddiśya anyataro gṛhapatir vā gṛhapatiputro vā tantuvāyena cīvaraṃ vunāpeya,	bhikṣum kho punar uddiśya anyataraḥ gṛhapatiḥ vā gṛhapati putraḥ vā tantuvāyena cīvaram 
SA_K01_prmosulu-475	tena ca bhikṣuḥ pūrvaṃ apravārito upasaṃkramitvā vikalpam āpadyeya Ō sādhu kho punas tvam āyuṣmann imaṃ cīvaram āyataṃ ca karohi,	tena ca bhikṣuḥ pūrvam a pravāritaḥ upasaṃkramitvā vikalpam āpadyeya sādhu kho punar tvam āyuṣman imam cīvaram āyatam ca karohi 
SA_K01_prmosulu-476	vistṛtaṃ ca karohi,	vistṛtam ca karohi 
SA_K01_prmosulu-477	suvutaṃ ca karohi,	suvutam ca karohi 
SA_K01_prmosulu-478	sutacchitaṃ ca karohi,	suta śitam ca karohi 
SA_K01_prmosulu-479	suvilikhitaṃ ca karohi /	su vilikhitam ca karohi 
SA_K01_prmosulu-480	apy eva nāma vayaṃ pi tava kiñcid eva mātrām upasaṃharema,	api eva nāma vayam tava kiñcid eva mātrām upasaṃharema 
SA_K01_prmosulu-481	māṣakaṃ vā māṣakārhaṃ vā piṇḍapātaṃ vā piṇḍapātārhaṃ vā /	māṣakam vā māṣaka arham vā piṇḍapātam vā piṇḍapāta arham vā 
SA_K01_prmosulu-482	tatra ca so bhikṣur evaṃ vaditvā na kiñcid eva mātrām upasaṃhareya māṣakaṃ vā māṣakārhaṃ vā piṇḍapātaṃ vā piṇḍapātārhaṃ vā,	tatra ca saḥ bhikṣuḥ evam vaditvā na kiñcid eva mātrām upasaṃhareya māṣakam vā māṣaka arham vā piṇḍapātam vā piṇḍapāta arham vā 
SA_K01_prmosulu-483	abhiniṣpanne cīvare nissargikapācattikaṃ /	abhiniṣpanne cīvare nissargika pācattikam 
SA_K01_prmosulu-484	PrMoSū(Mā-L)NP.28. daśāhānāgataṃ kho puna tremāsaṃ kārttikī paurṇamāsī utpadyeya bhikṣusya ātyāyikaṃ cīvaram ātyāyikaṃ manyamāno na bhikṣuṇā  #	daśa aha anāgatam kho puna tri māsam kārttikī paurṇamāsī utpadyeya bhikṣusya ātyāyikam cīvaram ātyāyikam manyamānaḥ na bhikṣuṇā 
SA_K01_prmosulu-485	pratigṛhṇitavyaṃ /	pratigṛhṇitavyam 
SA_K01_prmosulu-486	pratigṛhṇitvā yāvac cīvaradānakālasamayaṃ nikṣipitavyaṃ /	pratigṛhṇitvā yāvat cīvara dāna kāla samayam nikṣipitavyam 
SA_K01_prmosulu-487	taduttariṃ nikṣipeya nissargikapācattikam /	tad uttarim nikṣipeya nissargika pācattikam 
SA_K01_prmosulu-488	PrMoSū(Mā-L)NP.29. upavarṣaṃ kho punaḥ tremāsaṃ kārttikī paurṇamāsī bhikṣu cāraṇyake śayanāsane viharanti samaye sapratibhaye sāśaṃkasaṃmate	upa varṣam kho punar tri māsam kārttikī paurṇamāsī bhikṣu ca āraṇyake śayanāsane viharanti samaye sa pratibhaye sa āśaṃka saṃmate 
SA_K01_prmosulu-489	ākāṃkṣamāṇena bhikṣuṇā trayāṇāṃ cīvarāṇām anyatarānyataraṃ cīvaram antaragṛhe nikṣipitavyaṃ,	ākāṃkṣamāṇena bhikṣuṇā trayāṇām cīvarāṇām anyatara anyataram cīvaram antara gṛhe nikṣipitavyam 
SA_K01_prmosulu-490	syāt tasya bhikṣusya kocid eva pratyayo tasmāc cīvarād vipravāsāya,	syāt tasya bhikṣusya kaścid eva tasmāt cīvarāt vipravāsāya 
SA_K01_prmosulu-491	ṣaḍāhaparamaṃ tena bhikṣuṇā tasmāc cīvarād vipravasitavyaṃ /	ṣaḍāha paramam tena bhikṣuṇā tasmāt cīvarāt vipravasitavyam 
SA_K01_prmosulu-492	taduttariṃ vipravaseya anyatra bhikṣu saṃmutīye nissargikapācattikam /	tad uttarim vipravaseya anyatra bhikṣu saṃmutīye nissargika pācattikam 
SA_K01_prmosulu-493	PrMoSū(Mā-L)NP.30. yo puna bhikṣur jānan sāṃghikāṃ lābhaṃ saṃghe pariṇatam ātmano pariṇāmeya nissargikapācattikam //	yaḥ puna bhikṣuḥ jānan sāṃghikām lābham saṃghe pariṇatam nissargika pācattikam 
SA_K01_prmosulu-494	// uddānaṃ //	uddānam 
SA_K01_prmosulu-495	(21) pātra (22) bandhanaṃ (23)	pātra bandhanam 
SA_K01_prmosulu-496	bhaiṣajyam (24)	bhaiṣajyam 
SA_K01_prmosulu-497	ācchedo (25)	ācchedaḥ 
SA_K01_prmosulu-498	varṣāśāṭikā /	varṣāśāṭikā 
SA_K01_prmosulu-499	(26-27) tantuvāyena dve (28)	tantuvāyena dve 
SA_K01_prmosulu-500	daśāhānāgatam (29)	daśa aha anāgatam 
SA_K01_prmosulu-501	upavarṣaṃ (30)	upavarṣam 
SA_K01_prmosulu-502	pariṇāmanena //	pariṇāmanena 
SA_K01_prmosulu-503	tṛtīyo vargaḥ //	tṛtīyaḥ vargaḥ 
SA_K01_prmosulu-504	uddiṣṭāḥ kho punar āyuṣmanto triṃśan nissarggikapācattikā dharmmāḥ /	uddiṣṭāḥ kho punar āyuṣmantaḥ triṃśat nissarggika pācattikāḥ dharmmāḥ 
SA_K01_prmosulu-505	tatrāyuṣmanto pṛcchāmi kaccittha pariśuddhāḥ?	tatra āyuṣmantaḥ pṛcchāmi kaccit tha pariśuddhāḥ 
SA_K01_prmosulu-506	dvitīyaṃ pi āyuṣmanto pṛcchāmi kaccittha pariśuddhāḥ?	dvitīyam pi āyuṣmantaḥ pṛcchāmi kaccit tha pariśuddhāḥ 
SA_K01_prmosulu-507	tṛtīyaṃ pi āyuṣmanto pṛcchāmi kaccittha pariśuddhāḥ?	tṛtīyam pi āyuṣmantaḥ pṛcchāmi kaccit tha pariśuddhāḥ 
SA_K01_prmosulu-508	pariśuddhā atrāyuṣmanto yasmāt tūṣṇīm evam etaṃ dhārayāmi /	pariśuddhāḥ atra āyuṣmantaḥ yasmāt tūṣṇīm evam etam dhārayāmi 
SA_K01_prmosulu-509	[V. dvānavati śuddhapācattikā dharmāḥ]	u dvānavati śuddha pācattikāḥ dharmāḥ 
SA_K01_prmosulu-510	ime kho punar āyuṣmanto dvānavatiṃ śuddhapācattikā dharmā anvardhamāsaṃ sūtre prātimokṣe uddeśam āgacchanti Ō	ime kho punar āyuṣmantaḥ dvānavatim śuddha pācattikāḥ dharmāḥ anvardha māsam sūtre prātimokṣe uddeśam āgacchanti 
SA_K01_prmosulu-511	PrMoSū(Mā-L)Pāc.1. saṃprajānamṛṣāvāde pācattikaṃ /	saṃprajāna mṛṣāvāde pācattikam 
SA_K01_prmosulu-512	PrMoSū(Mā-L)Pāc.2. omṛṣyavāde pācattikaṃ /	om ṛṣya vāde pācattikam 
SA_K01_prmosulu-513	PrMoSū(Mā-L)Pāc.3. bhikṣupaiśunye pācattikaṃ /	bhikṣu paiśunye pācattikam 
SA_K01_prmosulu-514	PrMoSū(Mā-L)Pāc.4. yo puna bhikṣur jānaṃ saṃghasyādhikaraṇāni dharmeṇa vinayena vihitāni	yaḥ puna bhikṣuḥ jānan saṃghasya adhikaraṇāni dharmeṇa vinayena vihitāni 
SA_K01_prmosulu-515	vyupaśāntāni punaḥ karmāya utkhoṭeya Ō idaṃ punaḥ karma kartavyaṃ bhaviṣyatīti Ō	vyupaśāntāni punar karmāya utkhoṭeya idam punar karma kartavyam bhaviṣyati iti 
SA_K01_prmosulu-516	etad eva pratyayaṃ kṛtvā ananyam imaṃ tasya bhikṣusya utkhoṭanaṃ pācattikaṃ /	etat eva pratyayam kṛtvā ananyam imam tasya bhikṣusya utkhoṭanam pācattikam 
SA_K01_prmosulu-517	PrMoSū(Mā-L)Pāc.5. yo puna bhikṣur akalpiyakāro mātṛgrāmasya dharmaṃ deśeya uttari cchahi pañcahi vācāhi anyatra vijñapuruṣapudgalena pācattikaṃ	puna bhikṣuḥ a kalpiya kāraḥ mātṛgrāmasya dharmam deśeyaḥ uttari pañcahi anyatra vijña puruṣa pudgalena pācattikam 
SA_K01_prmosulu-518	PrMoSū(Mā-L)Pāc.6. yo puna bhikṣur anupasaṃpannaṃ pudgalaṃ padaśo dharmaṃ vāceya pācattikaṃ /	yaḥ puna bhikṣuḥ an upasaṃpannam pudgalam padaśas dharmam vāceya pācattikam 
SA_K01_prmosulu-519	PrMoSū(Mā-L)Pāc.7. yo puna bhikṣur anupasaṃpannasya pudgalasya santike ātmopanāyikam	yaḥ puna bhikṣuḥ an upasaṃpannasya pudgalasya santike ātma upanāyikam 
SA_K01_prmosulu-520	uttarimanuṣyadharmam alamāryajñānadarśanaṃ viśeṣādhigamaṃ pratijāneya Ō iti jānāmi	uttari manuṣya dharmam alam ārya jñāna darśanam viśeṣa adhigamam pratijāneya iti jānāmi 
SA_K01_prmosulu-521	iti paśyāmīti bhūtasmiṃ pācattikaṃ /	iti paśyāmi iti bhūtasmin pācattikam 
SA_K01_prmosulu-522	PrMoSū(Mā-L)Pāc.8. yo puna bhikṣur jānan bhikṣusya duṣṭhullām āpattim anupasaṃpannasya pudgalasya santike āroceya anyatra kṛtāye prakāśanāsaṃmutīye  #	yaḥ puna bhikṣuḥ jānan bhikṣusya duṣṭhullām āpattim anupasaṃpannasya pudgalasya santike āroceya anyatra kṛtāye prakāśanāsaṃmutīye 
SA_K01_prmosulu-523	pācattikaṃ /	pācattikam 
SA_K01_prmosulu-524	PrMoSū(Mā-L)Pāc.9. yo puna bhikṣur jānan sāṃghike lābhe bhājīyamāne pūrve samanujño bhūtvā paścāt kṣiyādharmam āpadyeya Ō yathāsaṃstutam evāyuṣmanto,	yaḥ puna bhikṣuḥ jānan sāṃghike lābhe bhājīyamāne pūrve samanujñaḥ bhūtvā paścāt kṣiyā dharmam āpadyeya yathā saṃstutam eva āyuṣmantaḥ 
SA_K01_prmosulu-525	jānan sāṃghikaṃ lābhaṃ saṃghe pariṇataṃ pudgalo pudgalasya pariṇāmayatīti pācattikaṃ /	jānan sāṃghikam lābham saṃghe pariṇatam pudgalaḥ pudgalasya pariṇāmayati iti pācattikam 
SA_K01_prmosulu-526	PrMoSū(Mā-L)Pāc.10. yo puna bhikṣur anvardhamāsaṃ sūtre prātimokṣe uddiśyamāne evaṃ	yaḥ puna bhikṣuḥ anvardha māsam sūtre prātimokṣe uddiśyamāne evam 
SA_K01_prmosulu-527	vadeya Ō kiṃ punar āyuṣmanto imehi kṣudrānukṣūdrehi śikṣāpadehi uddiṣṭehi yāvad eva	vadeya kim punar āyuṣmantaḥ imehi kṣudra anukṣūdrehi śikṣā padehi uddiṣṭehi yāvat eva 
SA_K01_prmosulu-528	bhikṣūṇāṃ kaukṛtyāya vighātāya vilekhāya saṃvartantīti,	bhikṣūṇām kaukṛtyāya vighātāya vilekhāya saṃvartanti iti 
SA_K01_prmosulu-529	śikṣāvigarhaṇe pācattikaṃ /	śikṣā vigarhaṇe pācattikam 
SA_K01_prmosulu-530	// uddānam //	uddānam 
SA_K01_prmosulu-531	(1) mṛṣā (2) omṛṣya (3)	mṛṣā omṛṣya 
SA_K01_prmosulu-532	paiśunya (4)	paiśunya 
SA_K01_prmosulu-533	utkhoṭana (5)	utkhoṭana 
SA_K01_prmosulu-534	dharmadeśanā /	dharma deśanā 
SA_K01_prmosulu-535	(6) padaśo (7) viśeṣaṇam (8)	padaśas viśeṣaṇam 
SA_K01_prmosulu-536	ārocanā (9)	ārocanā 
SA_K01_prmosulu-537	yathāsaṃstuta (10)	yathā a saṃstuta 
SA_K01_prmosulu-538	vigarhaṇena ca //	vigarhaṇena ca 
SA_K01_prmosulu-539	prathamo vargaḥ //	prathamaḥ vargaḥ 
SA_K01_prmosulu-540	PrMoSū(Mā-L)Pāc.11. bījagrāmabhūtagrāmapātāpanake pācattikaṃ /	bīja grāma bhūta grāma pātāpanake pācattikam 
SA_K01_prmosulu-541	PrMoSū(Mā-L)Pāc.12. anyavādavihiṃsanake pācattikaṃ /	anya vāda vihiṃsanake pācattikam 
SA_K01_prmosulu-542	PrMoSū(Mā-L)Pāc.13. odhyāyanakṣīyanake pācattikaṃ /	ā odhyāyana kṣīyanake pācattikam 
SA_K01_prmosulu-543	PrMoSū(Mā-L)Pāc.14. yo puna bhikṣuḥ sāṃghike bhikṣuvihāre abhyavakāśe mañcaṃ vā pīṭhaṃ	yaḥ puna bhikṣuḥ sāṃghike bhikṣuvihāre abhyavakāśe mañcam vā pīṭham 
SA_K01_prmosulu-544	vā viśikaṃ vā caturaśrakaṃ vā kurcaṃ vā bimbohanaṃ vā prajñāpetvā vā prajñāpayitvā	vā viśikam vā caturaśrakam vā kurcam vā bimbohanam vā prajñāpetvā vā prajñāpayitvā 
SA_K01_prmosulu-545	vā tato prakramanto na uddhareya vā,	vā tatas prakramantaḥ naḥ uddhareya vā 
SA_K01_prmosulu-546	na uddharāpeya vā,	na uddhara apeya vā 
SA_K01_prmosulu-547	anāmantrayitvā vā prakrameya pācattikaṃ /	an āmantrayitvā vā prakrameya pācattikam 
SA_K01_prmosulu-548	PrMoSū(Mā-L)Pāc.15. yo punar bhikṣuḥ sāṃghike bhikṣuvihāre antośayyāṃ prajñāpetvā prajñāpayitvā vā tato prakramanto na uddhareya vā,	yaḥ punar bhikṣuḥ sāṃghike bhikṣuvihāre antar śayyām prajñāpetvā prajñāpayitvā vā tatas prakramantaḥ na uddhareya vā 
SA_K01_prmosulu-549	na uddharāpeya vā,	na uddhara apeya vā 
SA_K01_prmosulu-550	anāmantrayitvā vā prakrameya pācattikaṃ /	an āmantrayitvā vā prakrameya pācattikam 
SA_K01_prmosulu-551	PrMoSū(Mā-L)Pāc.16. yo punar bhikṣu bhikṣusya duṣṭo doṣāt kupito anāttamano sāṃghikād	yaḥ punar bhikṣu bhikṣusya duṣṭaḥ doṣāt kupitaḥ an ātta manaḥ sāṃghikāt 
SA_K01_prmosulu-552	bhikṣuvihārād bhikṣuṃ nikaḍḍheya vā nikaḍḍhāpeya vā antamasato neha bhikṣū ti vā vadeya pācattikaṃ /	bhikṣuvihārāt bhikṣum nikaḍḍheya vā nikaḍḍhāpeya vā antam asataḥ na iha bhikṣū ti vā vadeya pācattikam 
SA_K01_prmosulu-553	PrMoSū(Mā-L)Pāc.17. yo puna bhikṣu sāṃghike bhikṣuvihāre jānan bhikṣūṇāṃ pūrvaprajñaptāhi śayyāhi paścād āgatvā madhyeśayyāṃ prajñāpeya yasyodvahiṣyati  #	yaḥ puna bhikṣu sāṃghike bhikṣuvihāre jānan bhikṣūṇām pūrva prajñaptāhi śayyāhi paścāt āgatvā madhyeśayyām yasya udvahiṣyati 
SA_K01_prmosulu-554	so prakramiṣyatīti /	sā u prakramiṣyati iti 
SA_K01_prmosulu-555	etad eva pratyayaṃ kṛtvā,	etat eva pratyayam kṛtvā 
SA_K01_prmosulu-556	ananyam imaṃ tasya bhikṣusya udvāhanapācattikaṃ /	ananyam imam tasya bhikṣusya udvāhana pācattikam 
SA_K01_prmosulu-557	PrMoSū(Mā-L)Pāc.18. yo puna bhikṣuḥ sāṃghike bhikṣuvihāre upari vaihāyasakuṭikāye āhatya pādake mañce vā pīṭhe vā abhiniṣīdeya vā abhinipadyeya  #	yaḥ puna bhikṣuḥ sāṃghike bhikṣuvihāre upari vaihāyasa kuṭi kāye āhatya pādake mañce vā pīṭhe vā abhiniṣīdeya vā abhinipadyeya 
SA_K01_prmosulu-558	vā pācattikaṃ /	vā pācattikam 
SA_K01_prmosulu-559	PrMoSū(Mā-L)Pāc.19. yo puna bhikṣur jānan saprāṇakenodakena tṛṇaṃ vā mṛttikāṃ vā siñceya vā siñcāpeya vā pācattikaṃ /	yaḥ puna bhikṣuḥ jānan sa prāṇakena udakena tṛṇam vā mṛttikām vā siñceya vā vā pācattikam 
SA_K01_prmosulu-560	PrMoSū(Mā-L)Pāc.20. mahallakaṃ bhikṣuṇā vihāraṃ chādāpayamānena yāvad dvārakoṣārgalapratiṣṭhānam	mahallakam bhikṣuṇā vihāram chādāpayamānena yāvat dvāra koṣa argala pratiṣṭhānam 
SA_K01_prmosulu-561	ālokasandhiparikarmam upādāya dve vā trayo vā cchādanaparyāyā adhiṣṭhihitavyāḥ alpaharite sthitena /	āloka sandhi parikarmam upādāya dve vā trayaḥ vā chādana paryāyāḥ adhiṣṭhihitavyāḥ alpa harite sthitena 
SA_K01_prmosulu-562	taduttariṃ adhiṣṭhiheya alpaharite sthito pi pācattikaṃ /	tad uttarim adhiṣṭhiheya alpa harite sthitaḥ pi pācattikam 
SA_K01_prmosulu-563	// uddānaṃ //	uddānam 
SA_K01_prmosulu-564	(11) bījam (12) anyavādaṃ (13)	bījam anya vādam 
SA_K01_prmosulu-565	odhyāyanaṃ (14)	odhyāyanam 
SA_K01_prmosulu-566	mañca (15)	mañca 
SA_K01_prmosulu-567	śayyā (16)	śayyā 
SA_K01_prmosulu-568	nikaḍḍhanaṃ /	nikaḍḍhanam 
SA_K01_prmosulu-569	(17) pūrvopagataṃ (18)	pūrva upagatam 
SA_K01_prmosulu-570	vaihāyasaṃ (19)	vaihāyasam 
SA_K01_prmosulu-571	udaka (20)	udaka 
SA_K01_prmosulu-572	cchādanena //	chādanena 
SA_K01_prmosulu-573	dvitīyo vargaḥ //	dvitīyaḥ vargaḥ 
SA_K01_prmosulu-574	PrMoSū(Mā-L)Pāc.21. yo puna bhikṣu asaṃmato bhikṣuṇīm ovadeya pācattikaṃ /	yaḥ puna a saṃmataḥ bhikṣuṇīm ovadeya pācattikam 
SA_K01_prmosulu-575	PrMoSū(Mā-L)Pāc.22. saṃmato vāpi bhikṣuḥ bhikṣūṇīm ovadeya vikāle,	saṃmataḥ vā api bhikṣuḥ bhikṣūṇīm ovadeya vikāle 
SA_K01_prmosulu-576	astaṃgate sūrye,	astaṃgate sūrye 
SA_K01_prmosulu-577	anūhate aruṇe pācattikaṃ /	anūhate aruṇe pācattikam 
SA_K01_prmosulu-578	PrMoSū(Mā-L)Pāc.23. yo puna bhikṣu ovādaprekṣo bhikṣuṇīupāśrayam upasaṃkrameya santaṃ bhikṣum anāmantrayitvā,	yaḥ punar bhikṣu ovāda prekṣaḥ bhikṣuṇī upāśrayam upasaṃkrameya santam bhikṣum an āmantrayitvā 
SA_K01_prmosulu-579	anyatra samaye pācattikaṃ /	anyatra samaye pācattikam 
SA_K01_prmosulu-580	tatrāyaṃ samayo Ō gilānā bhikṣuṇī ovaditavyā anuśāsitavyā bhavati /	tatra ayam samayaḥ u gilānā bhikṣuṇī ovaditavyā anuśāsitavyā bhavati 
SA_K01_prmosulu-581	ayam atra samayo /	ayam atra samayaḥ 
SA_K01_prmosulu-582	PrMoSū(Mā-L)Pāc.24. yo puna bhikṣu bhikṣum evaṃ vadeya Ō āmiṣahetor āyuṣman bhikṣu bhikṣuṇīṃ te ovadatīti pācattikaṃ /	yaḥ puna bhikṣu bhikṣum evam vadeya āmiṣa hetoḥ āyuṣman bhikṣu bhikṣuṇīm te ovadati iti pācattikam 
SA_K01_prmosulu-583	PrMoSū(Mā-L)Pāc.25. yo puna bhikṣu bhikṣuṇīya sārdham eko ekāya raho niṣadyāṃ kalpeya pācattikaṃ /	yaḥ puna bhikṣu bhikṣuṇīya sārdham ekaḥ ekāya rahaḥ niṣadyām kalpeya pācattikam 
SA_K01_prmosulu-584	PrMoSū(Mā-L)Pāc.26. yo puna bhikṣu bhikṣuṇīya sārdhaṃ saṃvidhāya adhvānamārgaṃ pratipadyeya antamasato grāmāntaraṃ pi,	puna bhikṣu bhikṣuṇīya sārdham saṃvidhāya adhvāna mārgam pratipadyeya antam asataḥ grāma antaram 
SA_K01_prmosulu-585	anyatra samaye,	anyatra samaye 
SA_K01_prmosulu-586	pācattikaṃ /	pācattikam 
SA_K01_prmosulu-587	tatrāyaṃ samayo Ō mārgo bhavati sabhayo sapratibhayo sāśaṃkasaṃmato /	tatra ayam mārgaḥ bhavati sa bhayaḥ sa pratibhayaḥ sa āśaṃka saṃmataḥ 
SA_K01_prmosulu-588	ayam atra samayo /	ayam atra samayaḥ 
SA_K01_prmosulu-589	PrMoSū(Mā-L)Pāc.27. yo puna bhikṣu bhikṣuṇīya sārdhaṃ saṃvidhāya ekanāvāṃ abhiruheya ūrdhvagāminīṃ vā adhogāminīṃ vā,	punar bhikṣu bhikṣuṇīya sārdham saṃvidhāya eka nāvām abhiruheya ūrdhva gāminīm vā adhas gāminīm vā 
SA_K01_prmosulu-590	anyatra tiryottaraṇāya pācattikaṃ /	anyatra tirya uttaraṇāya pācattikam 
SA_K01_prmosulu-591	PrMoSū(Mā-L)Pāc.28. yo puna bhikṣu anyātikāye bhikṣuṇīye cīvaraṃ dadyād anyatra pallaṭṭhakena pācattikaṃ /	yaḥ puna anya atikāye bhikṣuṇīye cīvaram dadyāt anyatra pallaṭṭhakena pācattikam 
SA_K01_prmosulu-592	PrMoSū(Mā-L)Pāc.29. yo puna bhikṣur anyātikāye bhikṣuṇīye cīvaraṃ sīveya vā sīvāpeya vā pācattikaṃ /	yaḥ puna bhikṣuḥ anya atikāye bhikṣuṇīye cīvaram sīveya vā sīvāpeya vā pācattikam 
SA_K01_prmosulu-593	PrMoSū(Mā-L)Pāc.30. yo puna bhikṣur jānan bhikṣuṇīparipācitaṃ pinḍapātaṃ paribhuñjeya,	yaḥ puna bhikṣuḥ jānan bhikṣuṇī paripācitam pinḍapātam paribhuñjeya 
SA_K01_prmosulu-594	anyatra pūrve gṛhīsamārambhe pācattikaṃ /	anyatra pūrve gṛhī samārambhe pācattikam 
SA_K01_prmosulu-595	// uddānaṃ //	uddānam 
SA_K01_prmosulu-596	(21) asaṃmato (22) saṃmato cāpi (23)	a saṃmataḥ saṃmataḥ ca api 
SA_K01_prmosulu-597	ovādo (24)	ovādaḥ 
SA_K01_prmosulu-598	āmiṣaṃ (25) niṣadyā ca /	āmiṣam niṣadyā ca 
SA_K01_prmosulu-599	(26) adhvānamārgo (27)	adhvāna mārgaḥ 
SA_K01_prmosulu-600	nāvā ca (28)	nāvā ca 
SA_K01_prmosulu-601	deti (29)	dā iti 
SA_K01_prmosulu-602	sīveti (30)	sīvā iti 
SA_K01_prmosulu-603	paripācanena //	paripācanena 
SA_K01_prmosulu-604	tṛtīyo vargaḥ //	tṛtīyaḥ vargaḥ 
SA_K01_prmosulu-605	PrMoSū(Mā-L)Pāc.31. ekāhaparamaṃ bhikṣuṇā agilānena āvasathapiṇḍapāto paribhuñjitavyo,	eka aha paramam bhikṣuṇā a gilānena āvasatha piṇḍapātaḥ paribhuñjitavyaḥ 
SA_K01_prmosulu-606	taduttariṃ paribhuṃjeya pācattikaṃ /	tad uttarim paribhuṃjeya pācattikam 
SA_K01_prmosulu-607	PrMoSū(Mā-L)Pāc.32. paramparābhojane anyatra samaye pācattikaṃ /	paramparā bhojane anyatra samaye pācattikam 
SA_K01_prmosulu-608	tatrāyaṃ samayo gilānasamayo cīvaradānakālasamayo /	tatra ayam samayaḥ gilāna samayaḥ cīvara dāna kāla samayaḥ 
SA_K01_prmosulu-609	ayam atra samayo /	ayam atra samayaḥ 
SA_K01_prmosulu-610	PrMoSū(Mā-L)Pāc.33. yo puna bhikṣur bhuṃjāvī pravārito utthito āsanāto,	yaḥ puna bhikṣuḥ bhuṃjāvī pravāritaḥ utthitaḥ 
SA_K01_prmosulu-611	anatiriktaṃ kṛtaṃ khādanīyaṃ vā bhojanīyaṃ vā khādeya vā bhuṃjeya vā pācattikaṃ /	an atiriktam kṛtam khādanīyam vā bhojanīyam vā khādeya vā bhuṃjeya vā pācattikam 
SA_K01_prmosulu-612	PrMoSū(Mā-L)Pāc.34. yo puna bhikṣur jānan bhikṣu bhuktāvī pravāritam utthitam āsanāto āsādanāprekṣo anatiriktakṛtena khādanīyena vā bhojanīyena  #	yaḥ puna bhikṣuḥ jānan bhikṣu bhuktāvī pravāritam utthitam āsanātaḥ an atirikta kṛtena khādanīyena vā bhojanīyena 
SA_K01_prmosulu-613	vā upanimantreya,	vai upanimantreya 
SA_K01_prmosulu-614	ehi bhikṣu khādāhi bhuṃjāhīti vā vadeya bhuktasmiṃ pācattikaṃ /	ehi bhikṣu khādāhi bhuṃjāhi iti vā vadeya bhuktasmin pācattikam 
SA_K01_prmosulu-615	PrMoSū(Mā-L)Pāc.35. yo puna bhikṣur adinnam apratigrāhitaṃ mukhadvārikam āhāram āhāreya anyatrodakadantapoṇe pācattikaṃ /	yaḥ puna bhikṣuḥ a dinnam a pratigrāhitam mukhadvārikam āhāram anyatra udaka danta poṇe pācattikam 
SA_K01_prmosulu-616	PrMoSū(Mā-L)Pāc.36. vikālābhojane pācattikaṃ /	vikāla abhojane pācattikam 
SA_K01_prmosulu-617	PrMoSū(Mā-L)Pāc.37. sannidhikārabhojane pācattikaṃ /	sannidhi kāra bhojane pācattikam 
SA_K01_prmosulu-618	PrMoSū(Mā-L)Pāc.38. bhikṣuṃ kho punaḥ kulehi upasaṃkrāntaṃ pravāreṃsu pūpehi vā manthehi vā /	bhikṣum kho punar kulehi upasaṃkrāntam pūpehi vā manthehi vā 
SA_K01_prmosulu-619	tathāpravāritena bhikṣuṇā yāvattripātrapūraparamaṃ tato pratigṛhṇitavyaṃ /	tathā pravāritena bhikṣuṇā yāvat tri pātra pūra paramam pratigṛhṇitavyam 
SA_K01_prmosulu-620	pratigṛhṇitvā bahirdhā nīharitavyaṃ /	pratigṛhṇitvā bahirdhā nīharitavyam 
SA_K01_prmosulu-621	bahirdhā nīharitvā agilānakehi bhikṣūhi sārdhaṃ saṃvibhajitvā khāditavyaṃ bhuṃjitavyaṃ /	bahirdhā nīharitvā a gilānakehi bhikṣūhi sārdham saṃvibhajitvā khāditavyam bhuṃjitavyam 
SA_K01_prmosulu-622	taduttariṃ pratigṛhṇitvā bahirdhā nīharitvā agilānakehi bhikṣūhi sārdhaṃ saṃvibhajitvā vā asaṃvibhajitvā vā khādeya vā bhuṃjeya vā pācattikaṃ	tad uttarim pratigṛhṇitvā bahirdhā nīharitvā a gilānakehi bhikṣūhi sārdham saṃvibhajitvā vā a saṃvibhajitvā vā khādeya vā bhuṃjeya vā pācattikam 
SA_K01_prmosulu-623	PrMoSū(Mā-L)Pāc.39. yāni kho punar imāni praṇītasaṃmatāni bhojanāni bhavanti saṃyyathīdaṃ	yāni khalu punar imāni praṇīta saṃmatāni bhojanāni bhavanti saṃyyathīdam 
SA_K01_prmosulu-624	sarpistailaṃ madhu phāṇitaṃ dugdhaṃ dadhi matsyaṃ māṃsaṃ yo puna bhikṣur evaṃrūpāṇi	sarpiḥ tailam madhu phāṇitam dugdham dadhi matsyam māṃsam yaḥ punar bhikṣuḥ evaṃrūpāṇi 
SA_K01_prmosulu-625	praṇītasaṃmatāni bhojanāni ātmārthāya agilāno kulehi vijñapetvā vā vijñāpāyetvā vā	praṇīta saṃmatāni bhojanāni ātma arthāya a gilānaḥ kulehi vijñapetvā vā vijñāpāyetvā vā 
SA_K01_prmosulu-626	khādeya vā bhuṃjeya vā pācattikaṃ /	khādeya vā bhuṃjeya vā pācattikam 
SA_K01_prmosulu-627	PrMoSū(Mā-L)Pāc.40. gaṇabhojane anyatra samaye pācattikaṃ /	gaṇa bhojane anyatra samaye pācattikam 
SA_K01_prmosulu-628	tatrāyaṃ samayo Ō gilānasamayo cīvaradānakālasamayo adhvānagamanasamayo nāvābhirohaṇasamayo mahāsamayo śravaṇabhaktaṃ /	tatra ayam samayaḥ gilāna samayaḥ cīvara dāna kāla samayaḥ adhvāna gamana samayaḥ nāvā abhirohaṇa samayaḥ mahā samayaḥ śravaṇa bhaktam 
SA_K01_prmosulu-629	ayam atra samayo /	ayam atra samayaḥ 
SA_K01_prmosulu-630	// uddānaṃ //	uddānam 
SA_K01_prmosulu-631	(31) āvasatho (32) parampara (33)	āvasatho parampara 
SA_K01_prmosulu-632	pravāraṇā (34)	pravāraṇā 
SA_K01_prmosulu-633	āsādanā (35) adinnaṃ /	āsādanāḥ a dinnam 
SA_K01_prmosulu-634	(36) vikālaṃ (37) sannidhiṃ (38)	vikālam sannidhim 
SA_K01_prmosulu-635	manthā (39)	manthā 
SA_K01_prmosulu-636	vijñaptiḥ (40)	vijñaptiḥ 
SA_K01_prmosulu-637	gaṇabhojanena //	gaṇa bhojanena 
SA_K01_prmosulu-638	caturtho vargaḥ //	caturthaḥ vargaḥ 
SA_K01_prmosulu-639	PrMoSū(Mā-L)Pāc.41. yo puna bhikṣur ātmārthāya agilāno jyotismiṃ vitāpanāprekṣo tṛṇaṃ	yaḥ puna bhikṣuḥ ātma arthāya a gilānaḥ jyotismin tṛṇam 
SA_K01_prmosulu-640	vā kāṣṭhaṃ vā gomayaṃ vā sakalikāṃ vā tuṣaṃ vā saṃkāraṃ vā ādaheya vā ādahāpeya vā	vā kāṣṭham vā gomayam vā sa kalikām vā tuṣam vā saṃkāram vā ādaheya vā vā 
SA_K01_prmosulu-641	anyatra samaye pācattikaṃ /	anyatra samaye pācattikam 
SA_K01_prmosulu-642	PrMoSū(Mā-L)Pāc.42. yo puna bhikṣur anupasaṃpannena pudgalena sārdhaṃ uttari dvirātraṃ trirātraṃ vā sahagāraśayyāṃ kalpeya pācattikaṃ /	yaḥ puna bhikṣuḥ anupasaṃpannena pudgalena sārdham uttari dvi rātram tri rātram vā sahagāra śayyām kalpeya pācattikam 
SA_K01_prmosulu-643	PrMoSū(Mā-L)Pāc.43. yo puna bhikṣu bhikṣūṇāṃ karmaṇā cchandaṃ datvā paścād duṣṭo doṣāt kupito anāttamano evaṃ vadeya Ō adinno me chando,	yaḥ punar bhikṣu bhikṣūṇām karmaṇā chandam da tvā paścāt duṣṭaḥ doṣāt kupitaḥ an ātta manaḥ evam vadeya a dinnaḥ me chandaḥ 
SA_K01_prmosulu-644	durdinno me chando,	durdinnaḥ me chandaḥ 
SA_K01_prmosulu-645	akṛtāny etāni karmāṇi duṣkṛtāny etāni karmāṇi,	a kṛtāni etāni karmāṇi duṣkṛtāni etāni karmāṇi 
SA_K01_prmosulu-646	nāham eteṣāṃ karmaṇāṃ cchandaṃ demīti vadeya pācattikaṃ /	na aham eteṣām karmaṇām chandam demi iti vadeya pācattikam 
SA_K01_prmosulu-647	PrMoSū(Mā-L)Pāc.44. yo puna bhikṣu bhikṣum evaṃ vadeya Ō ehi tvam āyuṣman grāmaṃ pinḍāya praviśiṣyāmaḥ /	yaḥ puna bhikṣu bhikṣum evam vadeya ehi tvam āyuṣman grāmam pinḍāya praviśiṣyāmaḥ 
SA_K01_prmosulu-648	ahaṃ ca te tatra kiṃcid dāpayiṣyaṃ /	aham ca te tatra kiṃcid dāpayiṣyam 
SA_K01_prmosulu-649	so tatra tasya kiñcid dāpayitvā vā adāpayitvā vā paścād udyojanaprekṣo evaṃ vadeya Ō gaccha tvam āyuṣman na me tvayā sārdhaṃ phāsu bhavati  #	sa u tatra tasya kiñcid dāpayitvā vā a dāpayitvā vā paścāt udyojana prekṣaḥ evam vadeya gaccha tvam āyuṣman na me tvayā sārdham phāsu bhavati  /
SA_K01_prmosulu-650	kathāya vā niṣadyāya vā,	kathāya vā niṣadyāya vā 
SA_K01_prmosulu-651	ekasyaiva mama phāsu bhavati kathāya vā niṣadyāya vā /	ekasya eva mama phāsu bhavati kathāya vā niṣadyāya vā 
SA_K01_prmosulu-652	etad eva pratyayaṃ kṛtvā ananyam,	etat eva pratyayam kṛtvā ananyam 
SA_K01_prmosulu-653	imaṃ tasya bhikṣusya udyojanapācattikaṃ /	imam tasya bhikṣusya udyojana pācattikam 
SA_K01_prmosulu-654	PrMoSū(Mā-L)Pāc.45. yo puna bhikṣu bhikṣūn evaṃ vadeya /	yaḥ puna bhikṣu bhikṣūn evam vadeya 
SA_K01_prmosulu-655	tathāham āyuṣmanto bhagavatā dharmaṃ deśitam ājānāmi yathā ye ime antarāyikā dharmā uktā bhagavatā tān pratisevato nālam antarāyāya /	tathā aham āyuṣmantaḥ bhagavatā dharmam deśitam ājānāmi yathā ye ime antarāyikāḥ dharmāḥ uktāḥ bhagavatā tān pratisevataḥ na alam antarāyāya 
SA_K01_prmosulu-656	so bhikṣu bhikṣūhi evam asya vacanīyo Ō mā āyuṣmann evaṃ vada,	saḥ bhikṣu bhikṣūhi evam asya vacanīyaḥ mā āyuṣman evam vada 
SA_K01_prmosulu-657	mā bhagavantam abhyācakṣa asatā durgṛhītena /	mā bhagavantam abhyācakṣa asatā durgṛhītena 
SA_K01_prmosulu-658	antarāyikā evāyuṣman dharmāḥ samānā antarāyikā dharmā uktā bhagavatā,	antarāyikāḥ eva āyuṣman dharmāḥ samānāḥ antarāyikāḥ dharmāḥ uktāḥ bhagavatā 
SA_K01_prmosulu-659	alaṃ ca punas tān pratiṣevato antarāyāya /	alam ca punar tān pratiṣevataḥ antarāyāya 
SA_K01_prmosulu-660	evaṃ ca so bhikṣu bhikṣūhi vucyamāno taṃ vastuṃ pratinissareya ity etaṃ kuśalaṃ /	evam ca saḥ bhikṣu bhikṣūhi vucyamānaḥ tam vastum pratinissareya iti etam kuśalam 
SA_K01_prmosulu-661	no ca pratinissareya so bhikṣu bhikṣūhi yāvantṛtīyakaṃ samanugrāhitavyo samanubhāṣitavyo tasya vastusya pratinissargāya /	no ca pratinissareya saḥ bhikṣu bhikṣūhi yāvantṛtīyakam samanugrāhitavyaḥ samanubhāṣitavyaḥ tasya vastusya pratinissargāya 
SA_K01_prmosulu-662	yāvantṛtīyakaṃ samanugrāhiyamāṇo vā samanubhāṣiyamāṇo vā taṃ vastuṃ pratinissareya ity etaṃ kuśalaṃ /	yāvantṛtīyakam samanugrāhiyamāṇaḥ vā samanubhāṣiyamāṇaḥ vā tam vastum pratinissareya iti etam kuśalam 
SA_K01_prmosulu-663	no ca pratinissareya so bhikṣuḥ samagreṇa saṃghena utkṣipitavyo /	no ca pratinissareya saḥ bhikṣuḥ samagreṇa saṃghena utkṣipitavyaḥ 
SA_K01_prmosulu-664	imaṃ tasya bhikṣusya utkṣepaṇapācattikaṃ /	imam tasya bhikṣusya utkṣepaṇa pācattikam 
SA_K01_prmosulu-665	PrMoSū(Mā-L)Pāc.46. yo puna bhikṣur jānan bhikṣuṃ tathā utkṣiptaṃ samagreṇa saṃghena	yaḥ puna bhikṣuḥ jānan bhikṣum tathā utkṣiptam samagreṇa saṃghena 
SA_K01_prmosulu-666	dharmeṇa vinayena yathāvādiṃ tathākāriṃ tāṃ pāpikāṃ dṛṣṭiṃ apratinissarantaṃ akṛtānudharmaṃ	dharmeṇa vinayena yathāvādim tathākārim tām pāpikām dṛṣṭim a pratinissarantam a kṛta anudharmam 
SA_K01_prmosulu-667	saṃbhuñjeya vā saṃvaseya vā sahagāraśayyāṃ vā kalpeya pācattikaṃ /	saṃbhuñjeya vā saṃvaseya vā sahagāra śayyām vā kalpeya pācattikam 
SA_K01_prmosulu-668	PrMoSū(Mā-L)Pāc.47. śramaṇuddeso pi ced evaṃ vadeya tathāham āyuṣmanto bhagavatā	śramaṇa uddesaḥ pi ced evam vadeya tathā aham āyuṣmantaḥ bhagavatā 
SA_K01_prmosulu-669	dharmaṃ deśitam ājānāmi yathā ye ime antarāyikā kāmā uktā bhagavatā tān pratisevato nālam antarāyāya /	dharmam deśitam ājānāmi yathā ye ime kāmāḥ uktāḥ bhagavatā tān pratisevataḥ na alam antarāyāya 
SA_K01_prmosulu-670	so śramaṇuddeśo bhikṣūhi evam asya vacanīyo Ō mā āyuṣman cchramaṇuddeśa evaṃ vada,	saḥ śramaṇa uddeśaḥ bhikṣūhi evam asya vacanīyaḥ mā āyuṣman śramaṇa uddeśaḥ evam vada 
SA_K01_prmosulu-671	mā bhagavantam abhyācakṣa asattā durgṛhītena /	mā bhagavantam abhyācakṣa asattā durgṛhītena 
SA_K01_prmosulu-672	antarāyikā evāyuṣman cchramaṇuddeśa kāmāḥ samānā antarāyikāḥ kāmā uktā bhagavatā /	antarāyikāḥ eva āyuṣman śramaṇa uddeśa kāmāḥ samānāḥ antarāyikāḥ kāmāḥ uktāḥ bhagavatā 
SA_K01_prmosulu-673	alaṃ ca punas tān pratisevato antarāyāya /	alam ca punar tān pratisevataḥ antarāyāya 
SA_K01_prmosulu-674	evaṃ ca so śramaṇuddeśo bhikṣūhi vucyamāno taṃ vastuṃ pratinissareya ity etaṃ kuśalaṃ /	evam ca saḥ śramaṇa uddeśaḥ bhikṣūhi vucyamānaḥ tam vastum pratinissareya iti etam kuśalam 
SA_K01_prmosulu-675	no ca pratinissareya so śramaṇuddeśo bhikṣūhi yāvantṛtīyakaṃ samanugrāhitavyo samanubhāṣitavyo	no ca pratinissareya saḥ śramaṇa uddeśaḥ bhikṣūhi yāvantṛtīyakam samanugrāhitavyaḥ samanubhāṣitavyaḥ 
SA_K01_prmosulu-676	tasya vastusya pratinissargāya yāvantṛtīyakaṃ samanugrāhiyamāṇo vā samanubhāṣiyamāṇo	tasya vastusya pratinissargāya yāvantṛtīyakam samanugrāhiyamāṇaḥ vā samanubhāṣiyamāṇaḥ 
SA_K01_prmosulu-677	vā taṃ vastuṃ pratinissareya ity etaṃ kuśalaṃ,	vā tam vastum pratinissareya iti etam kuśalam 
SA_K01_prmosulu-678	no ca pratinissareya so śramaṇuddeśo bhikṣūhi nāśayitavyo Ō adyadagreṇa te āyuṣman śramaṇuddeśa na caiva so bhagavāṃs tathāgato 'rhan samyaksaṃbuddho  #	no ca pratinissareya saḥ śramaṇa uddeśaḥ bhikṣūhi nāśayitavyaḥ adya agreṇa te āyuṣman śramaṇa uddeśa na ca eva saḥ bhagavān tathāgataḥ rhan samyaksaṃbuddhaḥ  /
SA_K01_prmosulu-679	śāstā vyapadiśitavyo /	śāstā vyapadiśitavyaḥ 
SA_K01_prmosulu-680	yaṃ pi ca dāni labhasi bhikṣūhi sārdhaṃ dvirātraṃ vā trirātraṃ vā sahagāraśayyāṃ sāpi te adyadagreṇa nāsti /	yam pi ca dāni labhasi bhikṣūhi sārdham dvi rātram vā tri rātram vā sahagāra śayyām sā api te adya agreṇa na asti 
SA_K01_prmosulu-681	gaccha naśya cala prapalāhi /	gaccha naśya cala prapalāhi 
SA_K01_prmosulu-682	yo puna bhikṣur jānan tathānāśitaṃ śramaṇuddeśaṃ yathāvādīṃ tathākāriṃ tāṃ pāpikāṃ	yaḥ punar bhikṣuḥ jānan tathānāśitam śramaṇa uddeśam yathāvādīm tathākārim tām pāpikām 
SA_K01_prmosulu-683	dṛṣṭim apratinissarantaṃ akṛtānudharmaṃ upasthāpeya vā upalāpeya vā saṃbhuṃjeya vā	dṛṣṭim a pratinissarantam a kṛta anudharmam upasthāpeya vā upalāpeya vā saṃbhuṃjeya vā 
SA_K01_prmosulu-684	saṃvaseya vā sahagāraśayyāṃ vā kalpeya pācattikaṃ /	saṃvaseya vā sahagāra śayyām vā kalpeya pācattikam 
SA_K01_prmosulu-685	PrMoSū(Mā-L)Pāc.48. navacīvaralābhinā bhikṣuṇā trayāṇāṃ durvarṇīkaraṇānām anyatarānyataraṃ durvaṇīkaraṇam ādayitavyaṃ Ō nīlaṃ vā kardamaṃ vā  #	nava cīvara lābhinā bhikṣuṇā trayāṇām durvarṇīkaraṇānām anyatara anyataram durvaṇīkaraṇam ādayitavyam nīlam vā kardamam vā 
SA_K01_prmosulu-686	kālaśyāmaṃ vā /	kālaśyāmam vā 
SA_K01_prmosulu-687	tato ca bhikṣur anādāya navaṃ cīvaraṃ paribhuṃjeya pācattikaṃ /	tatas ca bhikṣuḥ an ādāya navam cīvaram paribhuṃjeya pācattikam 
SA_K01_prmosulu-688	PrMoSū(Mā-L)Pāc.49. yo puna bhikṣur anyatra adhyārāme vā adhyāvasathe vā ratanaṃ vā ratanasaṃmataṃ vā udgṛhṇeya vā udgṛhṇāpeya vā,	yaḥ puna bhikṣuḥ anyatra adhyārāme vā adhyāvasathe vā ratanam vā ratana saṃmatam vā udgṛhṇeya vā vā 
SA_K01_prmosulu-689	pācattikaṃ /	pācattikam 
SA_K01_prmosulu-690	ākāṃkṣamāṇena bhikṣuṇā ratanaṃ vā ratanasaṃmataṃ vā adhyārāme vā adhyāvasathe vā udgṛhṇitavyaṃ vā udgṛhṇāpayitavyaṃ vā Ō yasya bhaviṣyati so  #	ākāṃkṣamāṇena bhikṣuṇā ratanam vā ratana saṃmatam vā adhyārāme vā adhyāvasathe vā udgṛhṇitavyam vā udgṛhṇāpayitavyam vā yasya bhaviṣyati saḥ 
SA_K01_prmosulu-691	hariṣyatīti /	hariṣyati iti 
SA_K01_prmosulu-692	etad eva pratyayaṃ kṛtvā, ananyam /	etat eva pratyayam kṛtvā ananyam 
SA_K01_prmosulu-693	iyam atra sāmīcī /	iyam atra sāmīcī 
SA_K01_prmosulu-694	PrMoSū(Mā-L)Pāc.50. anvardhamāsaṃ snānam uktaṃ bhagavatā /	anvardha māsam snānam uktam bhagavatā 
SA_K01_prmosulu-695	anyatra samaye pācattikaṃ /	anyatra samaye pācattikam 
SA_K01_prmosulu-696	tatrāyaṃ samayo Ō dvyardho māso śeṣo grīṣmāṇāṃ,	tatra ayam samayaḥ dvi ardhaḥ māsaḥ śeṣaḥ grīṣmāṇām 
SA_K01_prmosulu-697	varṣāṇāṃ ca purimo māso ity ete aḍḍhātīyamāsāḥ,	varṣāṇām ca purimaḥ māsaḥ iti ete aḍḍhātīya māsāḥ 
SA_K01_prmosulu-698	paridāhakālasamayo,	paridāha kāla samayaḥ 
SA_K01_prmosulu-699	adhvānagamanakālasamayo,	adhvāna gamana kāla samayaḥ 
SA_K01_prmosulu-700	gilānasamayo,	gilāna samayaḥ 
SA_K01_prmosulu-701	karmasamayo,	karma samayaḥ 
SA_K01_prmosulu-702	vātasamayo,	vāta samayaḥ 
SA_K01_prmosulu-703	vṛṣṭisamayo /	vṛṣṭi samayaḥ 
SA_K01_prmosulu-704	ayam atra samayo /	ayam atra samayaḥ 
SA_K01_prmosulu-705	// uddānam //	uddānam 
SA_K01_prmosulu-706	(41) jyotiḥ (42) sahagāra (43)	jyotiḥ sahagāra 
SA_K01_prmosulu-707	cchandam (44)	chandam 
SA_K01_prmosulu-708	udyojanā (45-47)	udyojanā 
SA_K01_prmosulu-709	trayo 'ntarāyikā (48)	trayaḥ ntarāyikā 
SA_K01_prmosulu-710	akṛtakalpaṃ (49)	a kṛta kalpam 
SA_K01_prmosulu-711	ratanaṃ (50) snānena //	ratanam snānena 
SA_K01_prmosulu-712	pañcamo vargaḥ //	pañcamaḥ vargaḥ 
SA_K01_prmosulu-713	PrMoSū(Mā-L)Pāc.51. yo puna bhikṣur jānan saprāṇakam udakaṃ paribhuñjeya pācattikaṃ /	yaḥ puna bhikṣuḥ jānan sa prāṇakam udakam paribhuñjeya pācattikam 
SA_K01_prmosulu-714	PrMoSū(Mā-L)Pāc.52. yo puna bhikṣu acelakasya vā acelikāya vā parivrājakasya vā parivrājakāye vā svahastaṃ khādanīyaṃ vā bhojanīyaṃ vā dadyāt  #	yaḥ puna bhikṣu acelakasya vā acelikāya vā parivrājakasya vā parivrāja kāye vā sva hastam khādanīyam vā bhojanīyam vā dadyāt 
SA_K01_prmosulu-715	pācattikaṃ /	pācattikam 
SA_K01_prmosulu-716	PrMoSū(Mā-L)Pāc.53. yo puna bhikṣur jānan saṃbhojanīye kule anupakhajjāsane niṣadyāṃ kalpeya pācattikaṃ /	yaḥ puna bhikṣuḥ jānan saṃbhojanīye kule an upakhajja āsane niṣadyām kalpeya pācattikam 
SA_K01_prmosulu-717	PrMoSū(Mā-L)Pāc.54. yo puna bhikṣur jānan saṃbhojanīye kule praticchannāsane niṣadyāṃ kalpeya pācattikaṃ /	yaḥ puna bhikṣuḥ jānan saṃbhojanīye kule praticchanna āsane niṣadyām kalpeya pācattikam 
SA_K01_prmosulu-718	PrMoSū(Mā-L)Pāc.55. yo puna bhikṣur udyuktāṃ senāṃ darśanāya gaccheya pācattikaṃ /	yaḥ puna bhikṣuḥ udyuktām senām darśanāya gaccheya pācattikam 
SA_K01_prmosulu-719	PrMoSū(Mā-L)Pāc.56. syāt tasya bhikṣusya kocid eva pratyayo senāyāṃ gamanāya,	syāt tasya bhikṣusya kaścid eva pratyayaḥ senāyām gamanāya 
SA_K01_prmosulu-720	dvirātraṃ vā trirātraṃ vā tena bhikṣuṇā senāyāṃ vasitavyaṃ /	dvi rātram vā tri rātram vā tena bhikṣuṇā senāyām vasitavyam 
SA_K01_prmosulu-721	taduttariṃ vaseya pācattikaṃ /	tad uttarim vaseya pācattikam 
SA_K01_prmosulu-722	PrMoSū(Mā-L)Pāc.57. tatrāpi ca bhikṣu dvirātraṃ vā trirātraṃ vā senāyāṃ vasamāno āyūhikaṃ vā niyūddhikaṃ vā anekavyūhaṃ vā saṃgrāmaśīrṣaṃ vā  #	tatra api ca bhikṣu dvi rātram vā tri rātram vā senāyām vasamānaḥ āyūhikam vā niyūddhikam vā aneka vyūham vā saṃgrāma śīrṣam vā 
SA_K01_prmosulu-723	darśanāya gaccheya pācattikaṃ /	darśanāya gaccheya pācattikam 
SA_K01_prmosulu-724	PrMoSū(Mā-L)Pāc.58. yo puna bhikṣu bhikṣuṃ prahareya pācattikaṃ /	yaḥ puna bhikṣu bhikṣum prahareya pācattikam 
SA_K01_prmosulu-725	PrMoSū(Mā-L)Pāc.59. yo puna bhikṣu bhikṣusya talaśaktikām āvarjeya pācattikaṃ /	yaḥ puna bhikṣu bhikṣusya tala śaktikām āvarjeya pācattikam 
SA_K01_prmosulu-726	PrMoSū(Mā-L)Pāc.60. yo puna bhikṣur jānan bhikṣusya duṣṭhullām āpattiṃ kṛtām adhyācīrṇāṃ cchādeya,	yaḥ puna bhikṣuḥ jānan bhikṣusya duṣṭhullām āpattim kṛtām adhyācīrṇām chādeya 
SA_K01_prmosulu-727	so na pareṣām āroceya kiṃ ti se mā pare jānantū ti /	saḥ na pareṣām āroceya kim ti se mā pare jānantu ti 
SA_K01_prmosulu-728	avadya praticchādane pācattikaṃ /	avadya praticchādane pācattikam 
SA_K01_prmosulu-729	// uddānaṃ //	uddānam 
SA_K01_prmosulu-730	(51) saprāṇakam (52)	sa prāṇakam 
SA_K01_prmosulu-731	acelako (53)	a celakaḥ 
SA_K01_prmosulu-732	anupakhajjaṃ (54)	an upakhajjam 
SA_K01_prmosulu-733	praticchannāsanaṃ (55-57)	praticchanna āsanam 
SA_K01_prmosulu-734	trayaṃ senāyāṃ (58)	trayam senāyām 
SA_K01_prmosulu-735	praharati (59)	praharati 
SA_K01_prmosulu-736	talaśaktikā (60)	tala śaktikā 
SA_K01_prmosulu-737	praticchādanena //	praticchādanena 
SA_K01_prmosulu-738	ṣaṣṭho vargaḥ //	ṣaṣṭhaḥ vargaḥ 
SA_K01_prmosulu-739	PrMoSū(Mā-L)Pāc.61. yo puna bhikṣuḥ saṃcintya tiryagyonigataṃ prāṇinaṃ jīvitād vyaparopeya pācattikaṃ /	yaḥ puna bhikṣuḥ saṃcintya tiryagyoni gatam prāṇinam jīvitāt vyaparopeya pācattikam 
SA_K01_prmosulu-740	PrMoSū(Mā-L)Pāc.62. yo puna bhikṣu bhikṣusya saṃcintya kaukṛtyam upasaṃhareya kiṃ ti se muhūrtaṃ pi aphāsu bhavatū ti pācattikaṃ /	yaḥ puna bhikṣu bhikṣusya saṃcintya kaukṛtyam upasaṃhareya kim ti se muhūrtam pi aphāsu bhavatu ti pācattikam 
SA_K01_prmosulu-741	PrMoSū(Mā-L)Pāc.63. yo puna bhikṣu bhikṣusya vā bhikṣuṇīye vā śrāmaṇerasya vā śrāmaṇerīye vā śikṣamāṇāye vā cīvaraṃ datvā apratyuddhareya paribhuṃjeya,	yaḥ punar bhikṣu bhikṣusya vā bhikṣuṇīye vā śrāmaṇerasya vā śrāmaṇerīye vā śikṣamāṇāye vā cīvaram da tvā a pratyuddhareya paribhuṃjeya 
SA_K01_prmosulu-742	apratyuddhāraparibhoge pācattikaṃ /	a pratyuddhāra paribhoge pācattikam 
SA_K01_prmosulu-743	PrMoSū(Mā-L)Pāc.64. yo puna bhikṣu bhikṣusya pātraṃ vā cīvaraṃ vā niṣīdanaṃ vā sūcīvigrahaṃ vā apaniheya vā apanihāpeya vā antamaśato hāsyārthaṃ  #	yaḥ puna bhikṣu bhikṣusya pātram vā cīvaram vā niṣīdanam vā sūcī vigraham vā apaniheya vā apanihāpeya vā 
SA_K01_prmosulu-744	pi pācattikaṃ /	pi pācattikam 
SA_K01_prmosulu-745	PrMoSū(Mā-L)Pāc.65. yo puna bhikṣur bhikṣuṃ bhīṣeya pācattikam /	yaḥ puna bhikṣuḥ bhikṣum bhīṣeya pācattikam 
SA_K01_prmosulu-746	PrMoSū(Mā-L)Pāc.66. udakahastasaṃmardanāt pācattikaṃ /	udaka hasta saṃmardanāt pācattikam 
SA_K01_prmosulu-747	PrMoSū(Mā-L)Pāc.67. aṅgulipratodanake pācattikaṃ /	aṅguli pratodanake pācattikam 
SA_K01_prmosulu-748	PrMoSū(Mā-L)Pāc.68. yo puna bhikṣu mātṛgrāmeṇa sārdhaṃ saṃvidhāya adhvānamārgaṃ pratipadyeya antamaśato grāmāntaraṃ pi pācattikaṃ /	yaḥ puna mātṛgrāmeṇa sārdham saṃvidhāya adhvāna mārgam pratipadyeya grāma antaram pi pācattikam 
SA_K01_prmosulu-749	PrMoSū(Mā-L)Pāc.69. yo puna bhikṣu mātṛgrāmeṇa sārdhaṃ sahagāraśayyāṃ kalpeya pācattikaṃ /	yaḥ puna mātṛgrāmeṇa sārdham sahagāra śayyām kalpeya pācattikam 
SA_K01_prmosulu-750	PrMoSū(Mā-L)Pāc.70. yo puna bhikṣu mātṛgrāmeṇa sārdhaṃ eko ekāya raho niṣadyāṃ kalpeya pācattikaṃ /	yaḥ puna mātṛgrāmeṇa sārdham ekaḥ ekāya rahaḥ niṣadyām kalpeya pācattikam 
SA_K01_prmosulu-751	// uddānam //	uddānam 
SA_K01_prmosulu-752	(61) saṃcintya (62) kaukṛtyam (63)	saṃcintya kaukṛtyam 
SA_K01_prmosulu-753	apratyuddharitvā (64) apaniheya /	a pratyuddharitvā apaniheya 
SA_K01_prmosulu-754	(65) bhīṣeya (66) udaka (67)	bhīṣeya udaka 
SA_K01_prmosulu-755	aṅguli (68)	aṅguli 
SA_K01_prmosulu-756	saṃvidhāya (69)	saṃvidhāya 
SA_K01_prmosulu-757	sahagāra (70) niṣadyāya //	sahagāra niṣadyāya 
SA_K01_prmosulu-758	saptamo vargaḥ //	saptamaḥ vargaḥ 
SA_K01_prmosulu-759	PrMoSū(Mā-L)Pāc.71. yo puna bhikṣur jānan ūnaviṃśativarṣapudgalaṃ bhikṣubhāvāya upasaṃpādeya,	yaḥ puna bhikṣuḥ jānan ūnaviṃśati varṣa pudgalam bhikṣu bhāvāya upasaṃpādeya 
SA_K01_prmosulu-760	so ca pudgalo anupasaṃpanno,	saḥ ca pudgalaḥ an upasaṃpannaḥ 
SA_K01_prmosulu-761	te ca bhikṣū gārhyāṃ,	te ca bhikṣū gārhyām 
SA_K01_prmosulu-762	imaṃ teṣāṃ bhikṣūṇāṃ garhaṇapācattikaṃ /	imam teṣām bhikṣūṇām garhaṇa pācattikam 
SA_K01_prmosulu-763	PrMoSū(Mā-L)Pāc.72. yo puna bhikṣur jānan stainyasārthena sārdhaṃ saṃvidhāya adhvānamārgaṃ pratipadyeya antamaśato grāmāntaraṃ pi pācattikaṃ	yaḥ puna bhikṣuḥ jānan stainya sārthena sārdham saṃvidhāya adhvāna mārgam pratipadyeya grāma antaram pi pācattikam 
SA_K01_prmosulu-764	PrMoSū(Mā-L)Pāc.73. yo puna bhikṣuḥ svahastaṃ pṛthivīṃ khaneya vā khanāpeya vā antamaśato iha khanehīti vā vadeya pācattikaṃ /	yaḥ puna bhikṣuḥ sva hastam pṛthivīm khaneya vā vā iha khanehi iti vā vadeya pācattikam 
SA_K01_prmosulu-765	PrMoSū(Mā-L)Pāc.74. cāturmāsikā bhikṣuṇā pratyekapravāraṇā sādayitavyā /	cāturmāsikā bhikṣuṇā pratyeka pravāraṇā sādayitavyā 
SA_K01_prmosulu-766	taduttariṃ sādiyeya,	tat uttarim sādiyeya 
SA_K01_prmosulu-767	anyatra punaḥ pravāraṇe,	anyatra punar pravāraṇe 
SA_K01_prmosulu-768	anyatra yāvajjīvikāye pācattikaṃ /	anyatra yāvajjīvikāye pācattikam 
SA_K01_prmosulu-769	PrMoSū(Mā-L)Pāc.75. yo puna bhikṣu bhikṣūhi evaṃ vucyamāno Ō imehi te āyuṣman pañcahi āpattikāyehi anadhyāvācāya śikṣā karaṇīyeti,	puna bhikṣu bhikṣūhi evam vucyamānaḥ imehi te āyuṣman pañcahi āpatti kāyehi an adhyāvācāya śikṣā karaṇīyā iti 
SA_K01_prmosulu-770	so bhikṣu tān bhikṣūn evaṃ vadeya Ō na yāvad aham āyuṣmantānāṃ vacanena śikṣiṣyaṃ	saḥ tān bhikṣūn evam vadeya na yāvat aham āyuṣmantānām vacanena śikṣiṣyam 
SA_K01_prmosulu-771	yāvad ahaṃ na drakṣyāmi sthavirān bhikṣūn sūtradharān vinayadharān mātṛkādharān madhyamān	yāvat aham na drakṣyāmi sthavirān bhikṣūn sūtra dharān vinaya dharān mātṛkā dharān madhyamān 
SA_K01_prmosulu-772	bhikṣūn sūtradharān vinayadharān mātṛkādharān,	bhikṣūn sūtra dharān vinaya dharān mātṛkā dharān 
SA_K01_prmosulu-773	navakān bhikṣūn sūtradharān vinayadharān mātṛkādharān /	navakān bhikṣūn sūtra dharān vinaya dharān mātṛkā dharān 
SA_K01_prmosulu-774	tāṃs tāvad aham upasaṃkramya paripṛcchiṣyaṃ paripraśnīkariṣyaṃ ti,	tān tāvat aham upasaṃkramya paripṛcchiṣyam paripraśnīkariṣyam ti 
SA_K01_prmosulu-775	pācattikaṃ /	pācattikam 
SA_K01_prmosulu-776	śikṣākāmena bhikṣuṇā ājñātavyam upalakṣayitavyaṃ upadhārayitavyaṃ //	śikṣā kāmena bhikṣuṇā ājñātavyam upalakṣayitavyam upadhārayitavyam 
SA_K01_prmosulu-777	PrMoSū(Mā-L)Pāc.76. surāmaireyamadya[pānaṃ] pācattikaṃ /	surā maireya madya pānam pācattikam 
SA_K01_prmosulu-778	PrMoSū(Mā-L)Pāc.77. bhikṣunādarye pācattikaṃ /	bhikṣu nādarye pācattikam 
SA_K01_prmosulu-779	PrMoSū(Mā-L)Pāc.78. yo puna bhikṣu bhikṣūhi kalahajātehi bhaṇḍanajātehi vigrahavivādāpannehi	yaḥ puna bhikṣu bhikṣūhi kalaha jātehi bhaṇḍana jātehi vigraha vivāda āpannehi 
SA_K01_prmosulu-780	viharantehi upaśrotrasthāne tiṣṭheya Ō yaṃ ete vadiṣyanti taṃ paścād upasaṃhariṣyāmīti /	viharantaḥ ihi upaśrotra sthāne tiṣṭheya yam ete vadiṣyanti tam paścāt upasaṃhariṣyāmi iti 
SA_K01_prmosulu-781	etad eva pratyayaṃ kṛtvā,	etat eva pratyayam kṛtvā 
SA_K01_prmosulu-782	ananyam,	ananyam 
SA_K01_prmosulu-783	imaṃ tasya bhikṣusya upaśrotrasthāne pācattikaṃ /	imam tasya bhikṣusya upaśrotrasthāne pācattikam 
SA_K01_prmosulu-784	PrMoSū(Mā-L)Pāc.79. yo puna bhikṣuḥ saṃghe viniścayakathāhi vartamānāhi utthāyāsanāt prakrameya santaṃ bhikṣum anāmantrayitvā,	yaḥ puna bhikṣuḥ saṃghe viniścaya kathāhi vartamānāhi utthāya āsanāt prakrameya santam bhikṣum an āmantrayitvā 
SA_K01_prmosulu-785	anyatra tathārūpe atyāyike karaṇīye pācattikaṃ /	anyatra tathārūpe atyāyike karaṇīye pācattikam 
SA_K01_prmosulu-786	PrMoSū(Mā-L)Pāc.80. yo puna bhikṣu āraṇyake śayyāsane viharanto vikāle grāmaṃ praviśeya santaṃ bhikṣum anāmantrayitvā,	puna āraṇyake śayyā āsane viharantaḥ vikāle grāmam praviśeya santam bhikṣum an āmantrayitvā 
SA_K01_prmosulu-787	anyatra tathārūpe atyāyike karaṇīye pācattikaṃ /	anyatra tathārūpe atyāyike karaṇīye pācattikam 
SA_K01_prmosulu-788	// uddānaṃ //	uddānam 
SA_K01_prmosulu-789	(71) ūnaviṃśati (72)	ūnaviṃśati 
SA_K01_prmosulu-790	stainyasārtho (73)	stainya sārthaḥ 
SA_K01_prmosulu-791	pṛthivī (74)	pṛthivī 
SA_K01_prmosulu-792	pravāraṇā (75)	pravāraṇā 
SA_K01_prmosulu-793	na śikṣiṣyaṃ (76)	na śikṣiṣyam 
SA_K01_prmosulu-794	madyapānam (77)	madya pānam 
SA_K01_prmosulu-795	anādaryam (78)	anādaryam 
SA_K01_prmosulu-796	upaśrotra (79)	upaśrotra 
SA_K01_prmosulu-797	viniścaya (80)	viniścaya 
SA_K01_prmosulu-798	āraṇyakena //	āraṇyakena 
SA_K01_prmosulu-799	aṣṭamo vargaḥ //	aṣṭamaḥ vargaḥ 
SA_K01_prmosulu-800	PrMoSū(Mā-L)Pāc.81. yo puna bhikṣu sabhakto samāno purebhaktaṃ paścādbhaktaṃ vā kuleṣu cāritram āpadyeya santaṃ bhikṣum anāmantrayitvā,	yaḥ puna bhikṣu sabhaktaḥ samānaḥ purebhaktam paścādbhaktam vā kuleṣu cāritram āpadyeya santam bhikṣum an āmantrayitvā 
SA_K01_prmosulu-801	anyatra samaye pācattikaṃ /	anyatra samaye pācattikam 
SA_K01_prmosulu-802	tatrāyam samayo Ō cīvaradānakālasamayo /	tatra ayam samayaḥ cīvara dāna kāla samayaḥ 
SA_K01_prmosulu-803	ayam atra samayaḥ /	ayam atra samayaḥ 
SA_K01_prmosulu-804	PrMoSū(Mā-L)Pāc.82. yo puna bhikṣu rājñaḥ kṣatriyasya mūrdhābhiṣiktasya janapadasthāmavīryaprāptasya antaḥpuraṃ praviśeyāniṣkrānte rājāne,	puna bhikṣu rājñaḥ kṣatriyasya mūrdhābhiṣiktasya janapada sthāma vīrya prāptasya antaḥpuram praviśeya a niṣkrānte rājāne 
SA_K01_prmosulu-805	aniṣkrānte antaḥpure,	a niṣkrānte antaḥpure 
SA_K01_prmosulu-806	anirgatehi ratanehi antamaśato indrakīlaṃ pi atikrameya pācattikaṃ /	anirgatehi ratanehi indrakīlam pi atikrameya pācattikam 
SA_K01_prmosulu-807	PrMoSū(Mā-L)Pāc.83. yo puna bhikṣu dantamayaṃ vā asthimayaṃ vā śṛṅgamayaṃ vā suvarṇamayaṃ vā rūpyamayaṃ vā ratanamayaṃ vā sūcīvigrahaṃ kārāpeya  #	yaḥ punar bhikṣu danta mayam vā asthi mayam vā śṛṅga mayam vā suvarṇa mayam vā rūpya mayam vā ratana mayam vā sūcī vigraham kārāpeya 
SA_K01_prmosulu-808	bhedanapācattikaṃ /	bhedana pācattikam 
SA_K01_prmosulu-809	PrMoSū(Mā-L)Pāc.84. mañcaṃ vā pīṭhaṃ vā bhikṣuṇā kārāpayamāṇena sugatāṣṭāṅgulapramāṇāḥ pādakāḥ kārāpayitavyāḥ anyatrāṭṭanīye,	mañcam vā pīṭham vā bhikṣuṇā kārāpayamāṇena sugata aṣṭa aṅgula pramāṇāḥ pādakāḥ kārāpayitavyāḥ anyatra aṭṭanīye 
SA_K01_prmosulu-810	taduttariṃ kārāpeya cchedanapācattikaṃ /	tad uttarim kārāpeya chedana pācattikam 
SA_K01_prmosulu-811	PrMoSū(Mā-L)Pāc.85. yo puna bhikṣuḥ tūlasaṃstṛte mañce vā pīṭhe vā abhiniṣīdeya vā abhi[ni]padyeya vā uddālanapācattikaṃ /	yaḥ puna bhikṣuḥ tūla saṃstṛte mañce vā pīṭhe vā abhiniṣīdeya vā abhinipadyeya vā uddālana pācattikam 
SA_K01_prmosulu-812	PrMoSū(Mā-L)Pāc.86. niṣīdanaṃ bhikṣuṇā kārāpayamāṇena prāmāṇikaṃ kārāpayitavyaṃ /	niṣīdanam bhikṣuṇā kārāpayamāṇena prāmāṇikam kārāpayitavyam 
SA_K01_prmosulu-813	tatredaṃ pramāṇaṃ Ō dīrghaśo dve vitastīyo sugatavitastinā tiryag dvyardham anyatra daśavitastikaṃ /	tatra idam pramāṇam dīrghaśas dve sugata vitastinā tiryak dvi ardham anyatra daśa vitastikam 
SA_K01_prmosulu-814	taduttariṃ kārāpeya cchedanapācattikaṃ /	tad uttarim kārāpeya chedana pācattikam 
SA_K01_prmosulu-815	PrMoSū(Mā-L)Pāc.87. kaṇḍūpraticchādanaṃ bhikṣuṇā kārāpayamāṇena prāmāṇikaṃ kārāpayitavyaṃ /	kaṇḍū praticchādanam bhikṣuṇā kārāpayamāṇena prāmāṇikam kārāpayitavyam 
SA_K01_prmosulu-816	tatredaṃ pramāṇaṃ Ō dīrghaśo catvāri vitastīyo sugatavitastinā, tiryag dve /	tatra idam pramāṇam catvāri sugata vitastinā tiryak dve 
SA_K01_prmosulu-817	taduttariṃ kārāpeya cchedanapācattikaṃ /	tad uttarim kārāpeya chedana pācattikam 
SA_K01_prmosulu-818	PrMoSū(Mā-L)Pāc.88. varṣāśāṭikā bhikṣuṇā kārāpayamāṇena prāmāṇikā kārāpayitavyā /	varṣā śāṭikā bhikṣuṇā kārāpayamāṇena prāmāṇikā kārāpayitavyā 
SA_K01_prmosulu-819	tatredaṃ pramāṇaṃ Ō dīrghaśo ṣaḍvitastīyo sugatavitastinā,	tatra idam pramāṇam sugata vitastinā 
SA_K01_prmosulu-820	tiryag aḍḍhatīyaṃ /	tiryak aḍḍhatīyam 
SA_K01_prmosulu-821	taduttariṃ kārāpeya cchedanapācattikaṃ /	tad uttarim kārāpeya chedana pācattikam 
SA_K01_prmosulu-822	PrMoSū(Mā-L)Pāc.89. yo puna bhikṣuḥ sugatacīvarapramāṇaṃ cīvaraṃ kārāpeya Ō kiñca tasya bhagavato tathāgatasyārhataḥ samyaksaṃbuddhasya sugatasya	yaḥ puna bhikṣuḥ sugata cīvara pramāṇam cīvaram kārāpeyaḥ kiñca tasya bhagavataḥ tathāgatasya arhataḥ samyaksaṃbuddhasya sugatasya 
SA_K01_prmosulu-823	dirghaśo nava vitastīyo sugatavitastinā, tiryak ṣaṭ /	dirghaśas nava sugata vitastinā tiryak ṣaṭ 
SA_K01_prmosulu-824	idaṃ tasya bhagavato tathāgatasyārhataḥ samyaksaṃbuddhasya sugatasya sugatacīvarapramāṇaṃ /	idam tasya bhagavataḥ tathāgatasya arhataḥ samyaksaṃbuddhasya sugatasya sugata cīvara pramāṇam 
SA_K01_prmosulu-825	tato vā punar uttariṃ kārāpeya cchedanapācattikaṃ /	tatas vā punar uttarim kārāpeya chedana pācattikam 
SA_K01_prmosulu-826	PrMoSū(Mā-L)Pāc.90. yo puna bhikṣu bhikṣusya duṣṭo doṣāt kupito anāttamano amūlakena saṃghātiśeṣeṇa dharmeṇānudhvaṃseya pācattikaṃ /	yaḥ puna bhikṣu bhikṣusya duṣṭaḥ doṣāt kupitaḥ an ātta manaḥ amūlakena saṃgha atiśeṣeṇa dharmeṇa anudhvaṃseya pācattikam 
SA_K01_prmosulu-827	PrMoSū(Mā-L)Pāc.91. yo puna bhikṣur jānan sāṃghikaṃ lābhaṃ saṃghe pariṇataṃ pudgalo pudgalasya pariṇāmeya pācattikaṃ /	yaḥ puna bhikṣuḥ jānan sāṃghikam lābham saṃghe pariṇatam pudgalaḥ pudgalasya pācattikam 
SA_K01_prmosulu-828	PrMoSū(Mā-L)Pāc.92. yo puna bhikṣur anvardhamāsaṃ sūtre prātimokṣe uddiśyamāne evaṃ vadeya Ō adya punar ahaṃ jānāmi,	puna bhikṣuḥ anvardha māsam sūtre prātimokṣe uddiśyamāne evam vadeya adya punar aham jānāmi 
SA_K01_prmosulu-829	idānīṃ punar ahaṃ jānāmi Ō ayaṃ pi dharmo sūtrāgato sūtraparyāpanno anvardhamāsaṃ sūtre prātimokṣe uddeśam āgacchati /	idānīm punar aham jānāmi ayam pi dharmaḥ sūtra āgataḥ sūtra paryāpannaḥ anvardha māsam sūtre prātimokṣe uddeśam āgacchati 
SA_K01_prmosulu-830	yāvad ahaṃ na jānāmi tāvan nāstītthaṃ mahyam āpattir jāneṃsu ca te bhikṣu taṃ bhikṣuṃ sakṛd dvikkhuto trikkhuto āgatapūrvaṃ pi sanniṣaṇṇapūrvaṃ	yāvat aham na jānāmi tāvat na asti ittham mahyam āpattiḥ jāneṃsu ca te bhikṣu tam bhikṣum sakṛt dvikkhutaḥ trikkhutaḥ āgata pūrvam pi sanniṣaṇṇa pūrvam 
SA_K01_prmosulu-831	kaḥ punar vādo bahuśo /	kaḥ punar vādaḥ bahuśas 
SA_K01_prmosulu-832	nāsti kho punas tasya bhikṣusya ajñānena muktiḥ /	na asti kho punar tasya bhikṣusya ajñānena muktiḥ 
SA_K01_prmosulu-833	atha khu yāṃ pi ca so bhikṣur āpattim āpanno tāṃ kṣipram eva yathādharmmaṃ yathāvinayaṃ kārāpayitavyo,	atha khu yām pi ca saḥ bhikṣuḥ āpattim āpannaḥ tām kṣipram eva yathādharmmam yathāvinayam kārāpayitavyaḥ 
SA_K01_prmosulu-834	uttariṃ ca saṃmoham āpādayitavyo /	uttarim ca saṃmoham āpādayitavyaḥ 
SA_K01_prmosulu-835	tasya te āyuṣman lābhā durlabdhā yas tvaṃ anvardhamāsaṃ sūtre prātimokṣe uddiśyamāne nāsthīkṛtvā na manasikṛtvā na sarvacetasā samanvāhṛtya  #	tasya te āyuṣman lābhāḥ durlabdhāḥ yaḥ tvam anvardha māsam sūtre prātimokṣe uddiśyamāne na asthīkṛtvā na manasi kṛtvā na sarva cetasā samanvāhṛtya 
SA_K01_prmosulu-836	avahitaśroto satkṛtya dharmaṃ śṛṇoṣīti /	avahitaśroto satkṛtya dharmam śṛṇoṣi iti 
SA_K01_prmosulu-837	imaṃ tasya bhikṣusya saṃmohapācattikaṃ /	imam tasya bhikṣusya saṃmoha pācattikam 
SA_K01_prmosulu-838	// uddānam //	uddānam 
SA_K01_prmosulu-839	(81) sabhakto (82) rājño (83)	sa bhaktaḥ rājñaḥ 
SA_K01_prmosulu-840	sūcī gṛhaṃ (84)	sūcī gṛham 
SA_K01_prmosulu-841	mañca (85)	mañca 
SA_K01_prmosulu-842	tūla (86) niṣīdanaṃ /	tūla niṣīdanam 
SA_K01_prmosulu-843	(87) kaṇḍū (88) varṣāśāṭikā (89)	      
SA_K01_prmosulu-844	sugatacīvaram (90)	sugata cīvaram 
SA_K01_prmosulu-845	abhyākhyānaṃ (91)	abhyākhyānam 
SA_K01_prmosulu-846	pariṇāmanam (92)	pariṇāmanam 
SA_K01_prmosulu-847	ajñānakena //	ajñānakena 
SA_K01_prmosulu-848	navamo vargaḥ //	navamaḥ vargaḥ 
SA_K01_prmosulu-849	// vargāṇām uddānaṃ //	vargāṇām uddānam 
SA_K01_prmosulu-850	(1) mṛṣā (2) bījaṃ (3)	mṛṣā bījam 
SA_K01_prmosulu-851	asaṃmato (4)	a saṃmataḥ 
SA_K01_prmosulu-852	ekāhaparamo /	eka aha paramaḥ 
SA_K01_prmosulu-853	(5) jyoti (6) saprāṇakaṃ (7)	jyoti sa prāṇakam 
SA_K01_prmosulu-854	sañcintya (8)	sañcintya 
SA_K01_prmosulu-855	ūnaviṃśati (9)	ūnaviṃśati 
SA_K01_prmosulu-856	sabhaktakena navamaḥ /	sa bhaktakena navamaḥ 
SA_K01_prmosulu-857	uddiṣṭāḥ kho punar āyuṣmanto dvānavati śuddhapācattikā dharmāḥ /	uddiṣṭāḥ kho punar āyuṣmantaḥ dvānavati śuddha pācattikāḥ dharmāḥ 
SA_K01_prmosulu-858	tatrāyuṣmanto pṛcchāmi kaccittha pariśuddhāḥ?	tatra āyuṣmantaḥ pṛcchāmi kaccit tha pariśuddhāḥ 
SA_K01_prmosulu-859	dvitīyaṃ pi āyuṣmanto pṛcchāmi kaccittha pariśuddhāḥ?	dvitīyam pi āyuṣmantaḥ pṛcchāmi kaccit tha pariśuddhāḥ 
SA_K01_prmosulu-860	tṛtīyaṃ pi āyuṣmanto pṛcchāmi kaccittha pariśuddhāḥ?	tṛtīyam pi āyuṣmantaḥ pṛcchāmi kaccit tha pariśuddhāḥ 
SA_K01_prmosulu-861	pariśuddhā atrāyuṣmanto yasmāt tūṣṇīm evam etaṃ dhārayāmi /	pariśuddhāḥ atra āyuṣmantaḥ yasmāt tūṣṇīm evam etam dhārayāmi 
SA_K01_prmosulu-862	[VI. catvāraḥ prātideśanikā dharmāḥ]	vi catvāraḥ prātideśanikāḥ dharmāḥ 
SA_K01_prmosulu-863	ime kho punar āyuṣmanto catvāraḥ prātideśanikā dharmā anvardhamāsaṃ sūtre prātimokṣe uddeśam āgacchanti Ō	ime kho punar āyuṣmantaḥ catvāraḥ prātideśanikāḥ dharmāḥ anvardha māsam sūtre prātimokṣe uddeśam āgacchanti 
SA_K01_prmosulu-864	PrMoSū(Mā-L)Pratid.1. yo puna bhikṣu āraṇyake śayanāsane viharanto pūrve apratisaṃveditaṃ bahirdhā apratigṛhītaṃ,	puna bhikṣu āraṇyake śayanāsane viharantaḥ pūrve a pratisaṃveditam bahirdhā a pratigṛhītam 
SA_K01_prmosulu-865	antovāsavastusminn agilāno svahastaṃ khādanīyaṃ vā bhojanīyaṃ vā pratigṛhṇitvā khādeya	antovāsa vastusmin a gilānaḥ sva hastam khādanīyam vā bhojanīyam vā pratigṛhṇitvā khādeya 
SA_K01_prmosulu-866	vā bhuñjeya vā bhuktāvinā tena bhikṣuṇā pratideśayitavyaṃ Ō asaṃpreyaṃ me āyuṣman	vā bhuñjeya vā bhuktāvinā tena bhikṣuṇā pratideśayitavyam me āyuṣman 
SA_K01_prmosulu-867	gārhyaṃ prātideśanikaṃ dharmam āpanno /	gārhyam prātideśanikam dharmam āpannaḥ 
SA_K01_prmosulu-868	taṃ dharmaṃ pratideśayāmi /	tam dharmam pratideśayāmi 
SA_K01_prmosulu-869	ayaṃ dharmo prātideśaniko //	ayam 
SA_K01_prmosulu-870	PrMoSū(Mā-L)Pratid.2. yo puna bhikṣur anyātikāye bhikṣuṇīye antaragṛhaṃ praviṣṭāye	yaḥ puna bhikṣuḥ anya atikāye bhikṣuṇīye antara gṛham 
SA_K01_prmosulu-871	agilāno svahastaṃ khādanīyaṃ vā bhojanīyaṃ vā pratigṛhṇitvā khādeya vā bhuṃjeya vā	a gilānaḥ sva hastam khādanīyam vā bhojanīyam vā pratigṛhṇitvā khādeya vā bhuṃjeya vā 
SA_K01_prmosulu-872	bhuktāvinā tena bhikṣuṇā pratideśayitavyaṃ Ō asaṃpreyaṃ me āyuṣman gārhyaṃ prātideśanikaṃ dharmam āpanno /	bhuktāvinā tena bhikṣuṇā pratideśayitavyam ō asaṃpreyam me āyuṣman gārhyam prātideśanikam dharmam āpannaḥ 
SA_K01_prmosulu-873	taṃ dharmmaṃ pratideśayāmi /	tam dharmmam pratideśayāmi 
SA_K01_prmosulu-874	ayaṃ pi dharmo prātideśaniko /	ayam pi dharmaḥ prātideśanikaḥ 
SA_K01_prmosulu-875	PrMoSū(Mā-L)Pratid.3. bhikṣu kho punar antaragṛhe nimantritakā bhuñjanti /	bhikṣu kho punar antara gṛhe nimantritakāḥ bhuñjanti 
SA_K01_prmosulu-876	tatra ca bhikṣuṇī viśvāsamānarūpā sthitā bhavati /	tatra ca bhikṣuṇī viśvāsamāna rūpā sthitā bhavati 
SA_K01_prmosulu-877	sā evam āha Ō iha odanaṃ dehi,	sā evam āha ō iha odanam dehi 
SA_K01_prmosulu-878	iha sūpaṃ dehi,	iha sūpam dehi 
SA_K01_prmosulu-879	iha vyañjanaṃ dehīti vā vadeya /	iha vyañjanam dehi iti vā vadeya 
SA_K01_prmosulu-880	sarvehi tehi bhikṣuhi sā bhikṣuṇī evam asya vacanīyā Ō āgamaya tāva tvaṃ bhagini yāvad bhikṣū bhuñjantīti /	sarvehi tehi bhikṣuhi sā bhikṣuṇī evam asya vacanīyā ā āgamaya tāva tvam bhagini yāvat bhikṣū bhuñjanti iti 
SA_K01_prmosulu-881	ekabhikṣū pi ca tāṃ bhikṣuṇīṃ neva vadeya Ō āgamaya tāva tvaṃ bhagini yāvad bhikṣū bhuñjantīti,	ca tām bhikṣuṇīm na iva vadeya āgamaya tāva tvam bhagini yāvat bhikṣū bhuñjanti iti 
SA_K01_prmosulu-882	bhuktāvīhi tehi bhikṣūhi pratideśayitavyaṃ Ō asaṃpreyaṃ me āyuṣman gārhyaṃ prātideśanikaṃ dharmam āpanno /	bhuktāvīhi tehi bhikṣūhi pratideśayitavyam asaṃpreyam me āyuṣman gārhyam prātideśanikam dharmam āpannaḥ 
SA_K01_prmosulu-883	taṃ dharmaṃ pratideśayāmi /	tam dharmam pratideśayāmi 
SA_K01_prmosulu-884	ayaṃ pi dharmo prātideśaniko //	ayam pi dharmaḥ prātideśanikaḥ 
SA_K01_prmosulu-885	PrMoSū(Mā-L)Pratid.4. yāni kho punar imāni śaikṣasaṃmatāni kulāni bhavanti tatra	yāni kho punar imāni śaikṣa saṃmatāni kulāni bhavanti tatra 
SA_K01_prmosulu-886	ca bhikṣuḥ pūrve apravārito upasaṃkramitvā svahastaṃ khādanīyaṃ vā bhojanīyaṃ vā	ca bhikṣuḥ pūrve a pravāritaḥ upasaṃkramitvā sva hastam khādanīyam vā bhojanīyam vā 
SA_K01_prmosulu-887	pratigṛhṇitvā khādeya vā bhuñjeya vā bhuktāvinā tena bhikṣuṇā pratideśayitavyaṃ Ō	pratigṛhṇitvā khādeya vā bhuñjeya vā bhuktāvinā tena bhikṣuṇā pratideśayitavyam 
SA_K01_prmosulu-888	asaṃpreyaṃ me āyuṣman gārhyaṃ prātideśanikaṃ dharmam āpanno /	asaṃpreyam me āyuṣman gārhyam prātideśanikam dharmam āpannaḥ 
SA_K01_prmosulu-889	taṃ dharmaṃ pratideśayāmi /	tam dharmam pratideśayāmi 
SA_K01_prmosulu-890	ayaṃ pi dharmo prātideśaniko //	ayam pi dharmaḥ prātideśanikaḥ 
SA_K01_prmosulu-891	// uddānam //	uddānam 
SA_K01_prmosulu-892	(1) āraṇyakam (2) antaragṛhe (3)	āraṇyakam antara gṛhe 
SA_K01_prmosulu-893	bhikṣū ca nimantritakāḥ (4)	bhikṣū ca nimantritakāḥ 
SA_K01_prmosulu-894	śaikṣasaṃmatena caturthaḥ //	śaikṣa saṃmatena caturthaḥ 
SA_K01_prmosulu-895	uddiṣṭāḥ kho punar āyuṣmanto catvāraḥ prātideśanikā dharmāḥ /	uddiṣṭāḥ kho punar āyuṣmantaḥ catvāraḥ prātideśanikāḥ dharmāḥ 
SA_K01_prmosulu-896	tatrāyuṣmanto pṛcchāmi kaccittha pariśuddhāḥ?	tatra āyuṣmantaḥ pṛcchāmi kaccit tha pariśuddhāḥ 
SA_K01_prmosulu-897	dvitīyaṃ pi āyuṣmanto pṛcchāmi kaccittha pariśuddhāḥ?	dvitīyam pi āyuṣmantaḥ pṛcchāmi kaccit tha pariśuddhāḥ 
SA_K01_prmosulu-898	tṛtīyaṃ pi āyuṣmanto pṛcchāmi kaccittha pariśuddhāḥ?	tṛtīyam pi āyuṣmantaḥ pṛcchāmi kaccit tha pariśuddhāḥ 
SA_K01_prmosulu-899	pariśuddhā atrāyuṣmanto yasmāt tūṣṇīm evam etaṃ dhārayāmi /	pariśuddhāḥ atra āyuṣmantaḥ yasmāt tūṣṇīm evam etam dhārayāmi 
SA_K01_prmosulu-900	[VII. sātirekapañcāśac chaikṣā dharmāḥ]	sa atireka pañcāśat śaikṣāḥ dharmāḥ 
SA_K01_prmosulu-901	ime kho punar āyuṣmanto sātirekapañcāśac chaikṣā dharmā anvardhamāsaṃ sūtre prātimokṣe uddeśam āgacchanti Ō	ime kho punar āyuṣmantaḥ sa atireka pañcāśat śaikṣāḥ dharmāḥ anvardha māsam sūtre prātimokṣe uddeśam āgacchanti 
SA_K01_prmosulu-902	PrMoSū(Mā-L)Śai.1. parimaṇḍalaṃ nivasanaṃ nivāsayiṣyāmīti śikṣā karaṇīyā /	parimaṇḍalam nivasanam nivāsayiṣyāmi iti śikṣā karaṇīyā 
SA_K01_prmosulu-903	PrMoSū(Mā-L)Śai.2. parimaṇḍalaṃ cīvaraṃ prāvariṣyāmīti śikṣā karaṇīyā /	parimaṇḍalam cīvaram prāvariṣyāmi iti śikṣā karaṇīyā 
SA_K01_prmosulu-904	PrMoSū(Mā-L)Śai.3. susaṃvṛto antaragṛham upasaṃkramiṣyāmīti śikṣā karaṇīyā /	su saṃvṛtaḥ antara gṛham upasaṃkramiṣyāmi iti śikṣā karaṇīyā 
SA_K01_prmosulu-905	PrMoSū(Mā-L)Śai.4. na utkṣiptacakṣur antaragṛham upasaṃkramiṣyāmīti śikṣā karaṇīyā /	na utkṣipta cakṣuḥ antara gṛham upasaṃkramiṣyāmi iti śikṣā karaṇīyā 
SA_K01_prmosulu-906	PrMoSū(Mā-L)Śai.5. alpaśabdo antaragṛham upasaṃkramiṣyāmīti śikṣā karaṇīyā /	alpa śabdaḥ antara gṛham upasaṃkramiṣyāmi iti śikṣā karaṇīyā 
SA_K01_prmosulu-907	PrMoSū(Mā-L)Śai.6. na uccagghikāya antaragṛham upasaṃkramiṣyāmīti śikṣā karaṇīyā /	na uccagghikāya antaragṛham upasaṃkramiṣyāmi iti śikṣā karaṇīyā 
SA_K01_prmosulu-908	PrMoSū(Mā-L)Śai.7. na oguṇṭhikāya antaragṛham upasaṃkramiṣyāmīti śikṣā karaṇīyā /	na oguṇṭhikāya antaragṛham upasaṃkramiṣyāmi iti śikṣā karaṇīyā 
SA_K01_prmosulu-909	PrMoSū(Mā-L)Śai.8. na utkṣiptikāya antaragṛham upasaṃkramiṣyāmīti śikṣā karaṇīyā /	na utkṣiptikāya antara gṛham upasaṃkramiṣyāmi iti śikṣā karaṇīyā 
SA_K01_prmosulu-910	PrMoSū(Mā-L)Śai.9. na utkuṭukāya antaragṛham upasaṃkramiṣyāmīti śikṣā karaṇīyā /	na utkuṭukāya antara gṛham upasaṃkramiṣyāmi iti śikṣā karaṇīyā 
SA_K01_prmosulu-911	PrMoSū(Mā-L)Śai.10. na khambhakṛto antaragṛham upasaṃkramiṣyāmīti śikṣā karaṇīyā /	na khambhakṛtaḥ antara gṛham upasaṃkramiṣyāmi iti śikṣā karaṇīyā 
SA_K01_prmosulu-912	PrMoSū(Mā-L)Śai.11. na kāyapracālakam antaragṛham upasaṃkramiṣyāmīti śikṣā karaṇīyā /	na kāyapracālakam antaragṛham upasaṃkramiṣyāmi iti śikṣā karaṇīyā 
SA_K01_prmosulu-913	PrMoSū(Mā-L)Śai.12. na śīrṣapracālakam antaragṛham upasaṃkramiṣyāmīti śikṣā karaṇīyā /	na śīrṣapracālakam antaragṛham upasaṃkramiṣyāmi iti śikṣā karaṇīyā 
SA_K01_prmosulu-914	PrMoSū(Mā-L)Śai.13. na bāhuvikṣepakam antaragṛham upasaṃkramiṣyāmīti śikṣā karaṇīyā /	na bāhu vikṣepakam antara gṛham upasaṃkramiṣyāmi iti śikṣā karaṇīyā 
SA_K01_prmosulu-915	// uddānam //	uddānam 
SA_K01_prmosulu-916	(1) nivasanaṃ (2) prāvaraṇaṃ (3)	nivasanam prāvaraṇam 
SA_K01_prmosulu-917	susaṃvṛto (4)	su saṃvṛtaḥ 
SA_K01_prmosulu-918	cakṣuḥ (5)	cakṣuḥ 
SA_K01_prmosulu-919	śabda (6)	śabda 
SA_K01_prmosulu-920	noccagghikā (7)	na uccagghikā 
SA_K01_prmosulu-921	na oguṇṭhikā (8)	na oguṇṭhikā 
SA_K01_prmosulu-922	notkṣiptikā (9)	na utkṣiptikā 
SA_K01_prmosulu-923	na utkuṭukā (10)	na utkuṭukā 
SA_K01_prmosulu-924	na khambha (11)	na khambha 
SA_K01_prmosulu-925	na kāya (12)	na kāya 
SA_K01_prmosulu-926	na śīrṣa (13)	na śīrṣa 
SA_K01_prmosulu-927	na bāhukena //	na bāhukena 
SA_K01_prmosulu-928	prathamo vargaḥ //	prathamaḥ vargaḥ 
SA_K01_prmosulu-929	PrMoSū(Mā-L)Śai.14. susaṃvṛto antaragṛhe niṣīdiṣyāmīti śikṣā karaṇīyā /	su saṃvṛtaḥ antara gṛhe niṣīdiṣyāmi iti śikṣā karaṇīyā 
SA_K01_prmosulu-930	PrMoSū(Mā-L)Śai.15. na utkṣiptacakṣu antaragṛhe niṣīdiṣyāmīti śikṣā karaṇīyā /	na utkṣipta cakṣu antara gṛhe niṣīdiṣyāmi iti śikṣā karaṇīyā 
SA_K01_prmosulu-931	PrMoSū(Mā-L)Śai.16. alpaśabdo antaragṛhe niṣīdiṣyāmīti śikṣā karaṇīyā /	alpa śabdaḥ antara gṛhe niṣīdiṣyāmi iti śikṣā karaṇīyā 
SA_K01_prmosulu-932	PrMoSū(Mā-L)Śai.17. na uccagghikāya antaragṛhe niṣīdiṣyāmīti śikṣā karaṇīyā /	na uccagghikāya antara gṛhe niṣīdiṣyāmi iti śikṣā karaṇīyā 
SA_K01_prmosulu-933	PrMoSū(Mā-L)Śai.18. na oguṇṭhikāya antaragṛhe niṣīdiṣyāmīti śikṣā karaṇīyā /	na oguṇṭhikāya antara gṛhe niṣīdiṣyāmi iti śikṣā karaṇīyā 
SA_K01_prmosulu-934	PrMoSū(Mā-L)Śai.19. na utkṣiptikāya antaragṛhe niṣīdiṣyāmīti śikṣā karaṇīyā /	na utkṣiptikāya antara gṛhe niṣīdiṣyāmi iti śikṣā karaṇīyā 
SA_K01_prmosulu-935	PrMoSū(Mā-L)Śai.20. na osaktikāya antaragṛhe niṣīdiṣyāmīti śikṣā karaṇīyā /	na osaktikāya antara gṛhe niṣīdiṣyāmi iti śikṣā karaṇīyā 
SA_K01_prmosulu-936	PrMoSū(Mā-L)Śai.21. na pallatthikāya antaragṛhe niṣīdiṣyāmīti śikṣā karaṇīyā /	na pallatthikāya antara gṛhe niṣīdiṣyāmi iti śikṣā karaṇīyā 
SA_K01_prmosulu-937	PrMoSū(Mā-L)Śai.22. na khambhakṛto antaragṛhe niṣīdiṣyāmīti śikṣā karaṇīyā /	na khambhakṛtaḥ antara gṛhe niṣīdiṣyāmi iti śikṣā karaṇīyā 
SA_K01_prmosulu-938	PrMoSū(Mā-L)Śai.23. na antaragṛhe niṣaṇṇo hastakaukṛtyaṃ pādakaukṛtyaṃ vā kariṣyāmīti śikṣā karaṇīyā /	na antara gṛhe niṣaṇṇaḥ hasta kaukṛtyam pāda kaukṛtyam vā kariṣyāmi iti śikṣā karaṇīyā 
SA_K01_prmosulu-939	// uddānaṃ //	uddānam 
SA_K01_prmosulu-940	(14) susaṃvṛto (15) cakṣuḥ (16)	susaṃvṛto cakṣuḥ 
SA_K01_prmosulu-941	śabda (17)	śabda 
SA_K01_prmosulu-942	noccagghikā (18)	na uccagghikā 
SA_K01_prmosulu-943	na oguṇṭhikā (19)	na oguṇṭhikā 
SA_K01_prmosulu-944	notkṣiptikā (20)	na utkṣiptikā 
SA_K01_prmosulu-945	nosaktikā (21)	nosaktikā 
SA_K01_prmosulu-946	na pallatthikā (22)	na pallatthikā 
SA_K01_prmosulu-947	na khambha (23)	na khambha 
SA_K01_prmosulu-948	na hastapādakaukṛtyena //	na hasta pāda kaukṛtyena 
SA_K01_prmosulu-949	dvitīyo vargaḥ //	dvitīyaḥ vargaḥ 
SA_K01_prmosulu-950	PrMoSū(Mā-L)Śai.24. satkṛtya piṇḍapātaṃ pratigṛhṇiṣyāmīti śikṣā karaṇīyā /	satkṛtya piṇḍapātam pratigṛhṇiṣyāmi iti śikṣā karaṇīyā 
SA_K01_prmosulu-951	PrMoSū(Mā-L)Śai.25. samasūpaṃ piṇḍapātaṃ paribhuṃjiṣyāmīti śikṣā karaṇīyā /	sama sūpam piṇḍapātam paribhuṃjiṣyāmi iti śikṣā karaṇīyā 
SA_K01_prmosulu-952	PrMoSū(Mā-L)Śai.26. na stūpakārakaṃ piṇḍapātaṃ paribhuṃjiṣyāmīti śikṣā karaṇīyā /	na stūpa kārakam piṇḍapātam paribhuṃjiṣyāmi iti śikṣā karaṇīyā 
SA_K01_prmosulu-953	PrMoSū(Mā-L)Śai.27. nāvakīrṇakārakaṃ piṇḍapātaṃ paribhuṃjiṣyāmīti śikṣā karaṇīyā /	na avakīrṇa kārakam piṇḍapātam paribhuṃjiṣyāmi iti śikṣā karaṇīyā 
SA_K01_prmosulu-954	PrMoSū(Mā-L)Śai.28. nāvagaṇḍakārakaṃ piṇḍapātaṃ paribhuṃjiṣyāmīti śikṣā karaṇīyā /	na avagaṇḍakārakam piṇḍapātam paribhuṃjiṣyāmi iti śikṣā karaṇīyā 
SA_K01_prmosulu-955	PrMoSū(Mā-L)Śai.29. na jihvānicārakaṃ piṇḍapātaṃ paribhuṃjiṣyāmīti śikṣā karaṇīyā /	na jihvā nicārakam piṇḍapātam paribhuṃjiṣyāmi iti śikṣā karaṇīyā 
SA_K01_prmosulu-956	PrMoSū(Mā-L)Śai.30. nātimahantehi kavaḍehi piṇḍapātaṃ paribhuṃjiṣyāmīti śikṣā karaṇīyā /	na ati mahantehi kavaḍehi piṇḍapātam paribhuṃjiṣyāmi iti śikṣā karaṇīyā 
SA_K01_prmosulu-957	PrMoSū(Mā-L)Śai.31. nānāgate kavaḍe mukhadvāraṃ vivariṣyāmīti śikṣā karaṇīyā /	nānāgate kavaḍe mukha dvāram vivariṣyāmi iti śikṣā karaṇīyā 
SA_K01_prmosulu-958	PrMoSū(Mā-L)Śai.32. na kavaḍotkṣepakaṃ piṇḍapātaṃ paribhuṃjiṣyāmīti śikṣā karaṇīyā /	na kavaḍa utkṣepakam piṇḍapātam paribhuṃjiṣyāmi iti śikṣā karaṇīyā 
SA_K01_prmosulu-959	PrMoSū(Mā-L)Śai.33. na kavaḍacchedakaṃ piṇḍapātaṃ paribhuṃjiṣyāmīti śikṣā karaṇīyā /	na kavaḍa chedakam piṇḍapātam paribhuṃjiṣyāmi iti śikṣā karaṇīyā 
SA_K01_prmosulu-960	PrMoSū(Mā-L)Śai.34. na sakavaḍena mukhena vācaṃ bhāṣiṣyamīti śikṣā karaṇīyā /	na sa kavaḍena mukhena vācam bhāṣiṣyami iti śikṣā karaṇīyā 
SA_K01_prmosulu-961	// uddānaṃ //	uddānam 
SA_K01_prmosulu-962	(24) satkṛtya (25) samasūpa (26)	satkṛtya samasūpa 
SA_K01_prmosulu-963	na stūpa (27)	na stūpa 
SA_K01_prmosulu-964	nāvakīrṇa (28)	na avakīrṇa 
SA_K01_prmosulu-965	nāvagaṇḍa (29)	na avagaṇḍa 
SA_K01_prmosulu-966	na jihvā (30)	na jihvā 
SA_K01_prmosulu-967	nātimahantaṃ (31)	na atimahantam 
SA_K01_prmosulu-968	nānāgataṃ (32)	na anāgatam 
SA_K01_prmosulu-969	na kavaḍotkṣepaka (33)	na kavaḍa utkṣepaka 
SA_K01_prmosulu-970	na kavaḍacchedaka (34)	na kavaḍa chedaka 
SA_K01_prmosulu-971	na sakavaḍena mukhena vācaṃ //	na sa kavaḍena mukhena vācam 
SA_K01_prmosulu-972	tṛtīyo vargaḥ //	tṛtīyaḥ vargaḥ 
SA_K01_prmosulu-973	PrMoSū(Mā-L)Śai.35. na pātranirlehakaṃ piṇḍapātaṃ paribhuṃjiṣyāmīti śikṣā karaṇīyā /	na pātra nirlehakam piṇḍapātam paribhuṃjiṣyāmi iti śikṣā karaṇīyā 
SA_K01_prmosulu-974	PrMoSū(Mā-L)Śai.36. na hastanirlehakaṃ piṇḍapātaṃ paribhuṃjiṣyāmīti śikṣā karaṇīyā /	na hasta nirlehakam piṇḍapātam paribhuṃjiṣyāmi iti śikṣā karaṇīyā 
SA_K01_prmosulu-975	PrMoSū(Mā-L)Śai.37. nāṅgulinirlehakaṃ piṇḍapātaṃ paribhuṃjiṣyāmīti śikṣā karaṇīyā /	na aṅguli nirlehakam piṇḍapātam paribhuṃjiṣyāmi iti śikṣā karaṇīyā 
SA_K01_prmosulu-976	PrMoSū(Mā-L)Śai.38. na cuccukāraṃ piṇḍapātaṃ paribhuṃjiṣyāmīti śikṣā karaṇīyā /	na cuccukāram piṇḍapātam paribhuṃjiṣyāmi iti śikṣā karaṇīyā 
SA_K01_prmosulu-977	PrMoSū(Mā-L)Śai.39. na surusurukāraṃ piṇḍapātaṃ paribhuṃjiṣyāmīti śikṣā karaṇīyā /	na surusurukāram piṇḍapātam paribhuṃjiṣyāmi iti śikṣā karaṇīyā 
SA_K01_prmosulu-978	PrMoSū(Mā-L)Śai.40. na gulugulukārakaṃ piṇḍapātaṃ paribhuṃjiṣyāmīti śikṣā karaṇīyā /	na gulugulukārakam piṇḍapātam paribhuṃjiṣyāmi iti śikṣā karaṇīyā 
SA_K01_prmosulu-979	PrMoSū(Mā-L)Śai.41. na hastanirdhūnakaṃ piṇḍapātaṃ paribhuṃjiṣyāmīti śikṣā karaṇīyā /	na hasta nirdhūnakam piṇḍapātam paribhuṃjiṣyāmi iti śikṣā karaṇīyā 
SA_K01_prmosulu-980	{Ed. hastanirdhūtakaṃ}	e t hasta nirdhūtakam 
SA_K01_prmosulu-981	PrMoSū(Mā-L)Śai.42. na sitthāpakārakaṃ piṇḍapātaṃ paribhuṃjiṣyāmīti śikṣā karaṇīyā /	na sittha apakārakam piṇḍapātam paribhuṃjiṣyāmi iti śikṣā karaṇīyā 
SA_K01_prmosulu-982	PrMoSū(Mā-L)Śai.43. nātivelaṃ parasya pātraṃ nidhyāyiṣyāmi odhyāyanakarmatām upādāyeti śikṣā karaṇīyā /	na ativelam parasya pātram nidhyāyiṣyāmi odhyāyana karmatām upādāya iti śikṣā karaṇīyā 
SA_K01_prmosulu-983	PrMoSū(Mā-L)Śai.44. na pātrasaṃjñī piṇḍapātaṃ pari[bhuṃji]ṣyāmīti śikṣā karaṇīyā /	na pātra saṃjñī piṇḍapātam paribhuṃjiṣyāmi iti śikṣā karaṇīyā 
SA_K01_prmosulu-984	PrMoSū(Mā-L)Śai.45. na agilāno odanaṃ vā sūpaṃ vā vyañjanaṃ vā ātmārthāya kulehi vijñāpetvā vā vijñāpāyetvā vā piṇḍapātaṃ paribhuṃjiṣyāmīti  #	na a gilānaḥ odanam vā sūpam vā vyañjanam vā ātma arthāya kulehi vijñāpetvā vā vijñāpāyetvā vā piṇḍapātam paribhuṃjiṣyāmi iti 
SA_K01_prmosulu-985	śikṣā karaṇīyā /	śikṣā karaṇīyā 
SA_K01_prmosulu-986	PrMoSū(Mā-L)Śai.46. na dinnadinnāni vyaṃjanāni odanena pracchādayiṣyāmi bhūyo āgamanakarmatām upādāyeti śikṣā karaṇīyā /	na dinna dinnāni vyaṃjanāni odanena pracchādayiṣyāmi bhūyas āgamana karma tām upādāya iti śikṣā karaṇīyā 
SA_K01_prmosulu-987	PrMoSū(Mā-L)Śai.47. na sasitthaṃ pātrodakaṃ pṛthivyāṃ niṣiñciṣyāmīti śikṣā karaṇīyā /	na sasittham pātra udakam pṛthivyām niṣiñciṣyāmi iti śikṣā karaṇīyā 
SA_K01_prmosulu-988	PrMoSū(Mā-L)Śai.48. na sasitthena pāṇinā pānīyasthālakaṃ pratigṛhṇiṣyāmīti śikṣā karaṇīyā /	na sa sitthena pāṇinā pānīya sthālakam pratigṛhṇiṣyāmi iti śikṣā karaṇīyā 
SA_K01_prmosulu-989	// uddānam //	uddānam 
SA_K01_prmosulu-990	(35-7) trayo nirlehāḥ (38)	trayaḥ nirlehāḥ 
SA_K01_prmosulu-991	cuccu (39)	cuccu 
SA_K01_prmosulu-992	surusuru (40)	suru suru 
SA_K01_prmosulu-993	na gulugulu (41)	na gulu gulu 
SA_K01_prmosulu-994	na hasta (42)	na hasta 
SA_K01_prmosulu-995	na sittha (43)	na sittha 
SA_K01_prmosulu-996	na odhyāyana (44)	na odhyāyana 
SA_K01_prmosulu-997	na pātrasaṃjñī (45)	na pātra saṃjñī 
SA_K01_prmosulu-998	vijñaptiḥ (46)	vijñaptiḥ 
SA_K01_prmosulu-999	cchādayati (47)	chādayati 
SA_K01_prmosulu-1000	pātrodaka (48)	pātra udaka 
SA_K01_prmosulu-1001	sasitthena //	sa sitthena 
SA_K01_prmosulu-1002	caturtho vargaḥ //	caturthaḥ vargaḥ 
SA_K01_prmosulu-1003	PrMoSū(Mā-L)Śai.49. na sthito niṣaṇṇasya agilānasya dharmaṃ deśayiṣyāmīti śikṣā karaṇīyā /	na sthitaḥ niṣaṇṇasya a gilānasya dharmam deśayiṣyāmi iti śikṣā karaṇīyā 
SA_K01_prmosulu-1004	PrMoSū(Mā-L)Śai.50. na niṣaṇṇo niṣaṇṇasya agilānasya dharmaṃ deśayiṣyāmīti śikṣā karaṇīyā /	na niṣaṇṇaḥ niṣaṇṇasya a gilānasya dharmam deśayiṣyāmi iti śikṣā karaṇīyā 
SA_K01_prmosulu-1005	PrMoSū(Mā-L)Śai.51. na nīcāsane niṣaṇṇo uccāsane niṣaṇṇasya agilānasya dharmaṃ deśayiṣyāmīti śikṣā karaṇīyā /	na nīca āsane niṣaṇṇaḥ ucca āsane niṣaṇṇasya a gilānasya dharmam deśayiṣyāmi iti śikṣā karaṇīyā 
SA_K01_prmosulu-1006	PrMoSū(Mā-L)Śai.52. na upānahārūḍhasya agilānasya dharmaṃ deśayiṣyāmīti śikṣā karaṇīyā /	na upānaha ārūḍhasya a gilānasya dharmam deśayiṣyāmi iti śikṣā karaṇīyā 
SA_K01_prmosulu-1007	PrMoSū(Mā-L)Śai.53. na pādukārūḍhasya agilānasya dharmaṃ deśayiṣyāmīti śikṣā karaṇīyā /	na pādukā ārūḍhasya a gilānasya dharmam deśayiṣyāmi iti śikṣā karaṇīyā 
SA_K01_prmosulu-1008	PrMoSū(Mā-L)Śai.54. na oguṇṭhikākṛtasya agilānasya dharmaṃ deśayiṣyāmīti śikṣā karaṇīyā /	na oguṇṭhikā kṛtasya a gilānasya dharmam deśayiṣyāmi iti śikṣā karaṇīyā 
SA_K01_prmosulu-1009	PrMoSū(Mā-L)Śai.55. na saṃmukhāveṣṭitasya agilānasya dharmaṃ deśayiṣyāmīti śikṣā karaṇīyā /	na saṃmukha āveṣṭitasya a gilānasya dharmam deśayiṣyāmi iti śikṣā karaṇīyā 
SA_K01_prmosulu-1010	PrMoSū(Mā-L)Śai.56. na osaktikāya niṣaṇṇasya agilānasya dharmaṃ deśayiṣyāmīti śikṣā karaṇīyā /	na osaktikāya niṣaṇṇasya a gilānasya dharmam deśayiṣyāmi iti śikṣā karaṇīyā 
SA_K01_prmosulu-1011	PrMoSū(Mā-L)Śai.57. na pallatthikāya niṣaṇṇasya agilānasya dharmaṃ deśayiṣyāmīti śikṣā karaṇīyā /	na pallatthikāya niṣaṇṇasya a gilānasya dharmam deśayiṣyāmi iti śikṣā karaṇīyā 
SA_K01_prmosulu-1012	// uddānam //	uddānam 
SA_K01_prmosulu-1013	(49) na sthito (50) na niṣaṇṇo (51)	na sthitaḥ na niṣaṇṇaḥ 
SA_K01_prmosulu-1014	uccāsana (52)	ucca āsana 
SA_K01_prmosulu-1015	upānaha (53)	upānaha 
SA_K01_prmosulu-1016	pādukā (54)	pādukā 
SA_K01_prmosulu-1017	oguṇṭhikā (55)	oguṇṭhikā 
SA_K01_prmosulu-1018	na saṃmukha (56)	na saṃmukha 
SA_K01_prmosulu-1019	na osaktikā (57)	na osaktikā 
SA_K01_prmosulu-1020	na pallatthikāya //	na pallatthikāya 
SA_K01_prmosulu-1021	pañcamo vargaḥ /	pañcamaḥ vargaḥ 
SA_K01_prmosulu-1022	PrMoSū(Mā-L)Śai.58. na śastrapāṇisya agilānasya dharmaṃ deśayiṣyāmīti śikṣā karaṇīyā /	na śastra pāṇisya a gilānasya dharmam deśayiṣyāmi iti śikṣā karaṇīyā 
SA_K01_prmosulu-1023	PrMoSū(Mā-L)Śai.59. nāyudhapāṇisya agilānasya dharmaṃ deśayiṣyāmīti śikṣā karaṇīyā /	na āyudha pāṇisya a gilānasya dharmam deśayiṣyāmi iti śikṣā karaṇīyā 
SA_K01_prmosulu-1024	PrMoSū(Mā-L)Śai.60. na daṇḍapāṇisya agilānasya dharmaṃ deśayiṣyāmīti śikṣā karaṇīyā /	na daṇḍa pāṇisya a gilānasya dharmam deśayiṣyāmi iti śikṣā karaṇīyā 
SA_K01_prmosulu-1025	PrMoSū(Mā-L)Śai.61. na cchatrapāṇisya agilānasya dharmaṃ deśayiṣyāmīti śikṣā karaṇīyā /	na chatra pāṇisya a gilānasya dharmam deśayiṣyāmi iti śikṣā karaṇīyā 
SA_K01_prmosulu-1026	PrMoSū(Mā-L)Śai.62. na utpathena gacchanto pathena gacchantasya agilānasya dharmaṃ deśayiṣyāmīti śikṣā karaṇīyā /	na utpathena gacchantaḥ u pathena gacchantasya a gilānasya dharmam deśayiṣyāmi iti śikṣā karaṇīyā 
SA_K01_prmosulu-1027	PrMoSū(Mā-L)Śai.63. na pṛṣṭhato gacchanto purato gacchantasya agilānasya dharmaṃ deśayiṣyāmīti śikṣā karaṇīyā /	na pṛṣṭhatas gacchantaḥ puratas gacchantasya a gilānasya dharmam deśayiṣyāmi iti śikṣā karaṇīyā 
SA_K01_prmosulu-1028	PrMoSū(Mā-L)Śai.64. na pādena gacchanto yānena gacchantasya agilānasya dharmaṃ deśayiṣyāmīti śikṣā karaṇīyā /	na pādena gacchantaḥ yānena gacchantasya a gilānasya dharmam deśayiṣyāmi iti śikṣā karaṇīyā 
SA_K01_prmosulu-1029	PrMoSū(Mā-L)Śai.65. na harite tṛṇe uccāraṃ vā prasrāvaṃ vā kheṭaṃ vā siṃhāṇaṃ vā agilāno kariṣyāmīti śikṣā karaṇīyā /	na harite tṛṇe uccāram vā prasrāvam vā kheṭam vā siṃhāṇam vā a gilānaḥ kariṣyāmi iti śikṣā karaṇīyā 
SA_K01_prmosulu-1030	PrMoSū(Mā-L)Śai.66. na udake uccāraṃ vā prasrāvaṃ vā kheṭaṃ vā siṃhāṇakaṃ vā agilāno kariṣyāmīti śikṣā karaṇīyā /	na udake uccāram vā prasrāvam vā kheṭam vā siṃhāṇakam vā a gilānaḥ kariṣyāmi iti śikṣā karaṇīyā 
SA_K01_prmosulu-1031	PrMoSū(Mā-L)Śai.67. na sthito uccāraṃ vā prasrāvaṃ vā agilāno kariṣyāmīti śikṣā karaṇīyā /	na uccāram vā prasrāvam vā a gilānaḥ kariṣyāmi iti śikṣā karaṇīyā 
SA_K01_prmosulu-1032	// uddānam //	uddānam 
SA_K01_prmosulu-1033	(58-59) na śastrāyudha (60)	na śastra āyudha 
SA_K01_prmosulu-1034	daṇḍa (61)	daṇḍa 
SA_K01_prmosulu-1035	cchatra (62)	cchatra 
SA_K01_prmosulu-1036	utpatha (63)	utpatha 
SA_K01_prmosulu-1037	pṛṣṭhato (64)	pṛṣṭhatas 
SA_K01_prmosulu-1038	yānaṃ (65)	yānam 
SA_K01_prmosulu-1039	haritaṃ (66)	haritam 
SA_K01_prmosulu-1040	udaka (67) sthitena /	udaka sthitena 
SA_K01_prmosulu-1041	ṣaṣṭho vargaḥ //	ṣaṣṭhaḥ vargaḥ 
SA_K01_prmosulu-1042	uddiṣṭāḥ kho punar āyuṣmanto sātirekapañcāśac chaikṣā dharmāḥ /	uddiṣṭāḥ khalu punar āyuṣmantaḥ sa atireka pañcāśat śaikṣāḥ dharmāḥ 
SA_K01_prmosulu-1043	tatrāyuṣmanto pṛcchāmi kaccittha pariśuddhāḥ?	tatra āyuṣmantaḥ pṛcchāmi kaccit tha pariśuddhāḥ 
SA_K01_prmosulu-1044	dvitīyaṃ pi āyuṣmanto pṛcchāmi kaccittha pariśuddhāḥ?	dvitīyam pi āyuṣmantaḥ pṛcchāmi kaccit tha pariśuddhāḥ 
SA_K01_prmosulu-1045	tṛtīyaṃ pi āyuṣmanto pṛcchāmi kaccittha pariśuddhāḥ?	tṛtīyam pi āyuṣmantaḥ pṛcchāmi kaccit tha pariśuddhāḥ 
SA_K01_prmosulu-1046	pariśuddhā atrāyuṣmanto yasmāt tūṣṇīm evam etaṃ dhārayāmi /	pariśuddhāḥ atra āyuṣmantaḥ yasmāt tūṣṇīm evam etam dhārayāmi 
SA_K01_prmosulu-1047	[VIII. sapta adhikaraṇaśamathā dharmāḥ]	viii sapta adhikaraṇa śamathāḥ dharmāḥ 
SA_K01_prmosulu-1048	ime kho punar āyuṣmanto sapta adhikaraṇasamathā dharmā anvardhamāsaṃ sūtre prātimokṣe uddeśam āgacchanti ye utpannotpannānām adhikaraṇānāṃ  #	ime khalu punar āyuṣmantaḥ sapta adhikaraṇa samathāḥ dharmāḥ anvardha māsam sūtre prātimokṣe uddeśam āgacchanti ye utpanna utpannānām adhikaraṇānām 
SA_K01_prmosulu-1049	śamathāya vyapaśamathāya saṃvartante /	śamathāya vyapaśamathāya saṃvartante 
SA_K01_prmosulu-1050	sayyathīdaṃ Ō	sayyathī idam ō 
SA_K01_prmosulu-1051	PrMoSū(Mā-L)AŚ.1. saṃmukhavinayo śamatho /	saṃmukha vinayaḥ śamathaḥ 
SA_K01_prmosulu-1052	PrMoSū(Mā-L)AŚ.2. smṛtivinayo śamatho /	smṛti vinayaḥ śamathaḥ 
SA_K01_prmosulu-1053	PrMoSū(Mā-L)AŚ.3. amūḍhavinayo śamatho /	a mūḍha vinayaḥ 
SA_K01_prmosulu-1054	PrMoSū(Mā-L)AŚ.4. pratijñākārako śamatho /	pratijñā kārakaḥ śamathaḥ 
SA_K01_prmosulu-1055	PrMoSū(Mā-L)AŚ.5. tasya pāpeyasiko śamatho /	tasya pāpeyasikaḥ śamathaḥ 
SA_K01_prmosulu-1056	PrMoSū(Mā-L)AŚ.6. yo bhūyasiko śamatho /	yaḥ bhūyasikaḥ śamathaḥ 
SA_K01_prmosulu-1057	PrMoSū(Mā-L)AŚ.7. tṛṇaprastārako ca śamatho saptamo /	tṛṇaprastārakaḥ ca śamathaḥ saptamaḥ 
SA_K01_prmosulu-1058	uddiṣṭāḥ kho punar āyuṣmanto sapta adhikaraṇaśamathā dharmāḥ /	uddiṣṭāḥ kho punar āyuṣmantaḥ sapta adhikaraṇa śamathāḥ dharmāḥ 
SA_K01_prmosulu-1059	tatrāyuḥmanto pṛcchāmi Ō kaccittha pariśuddhāḥ?	pṛcchāmi kaccit tha pariśuddhāḥ 
SA_K01_prmosulu-1060	dvitīyaṃ pi āyuḥmanto pṛcchāmi kaccittha pariśuddhāḥ?	dvitīyam pi pṛcchāmi kaccit tha pariśuddhāḥ 
SA_K01_prmosulu-1061	tṛtīyaṃ pi āyuḥmanto pṛcchāmi kaccittha pariśuddhāḥ?	tṛtīyam pi pṛcchāmi kaccit tha pariśuddhāḥ 
SA_K01_prmosulu-1062	pariśuddhā atrāyuḥmanto yasmāt tūḥṇīm evam etaṃ dhārayāmi /	pariśuddhāḥ atra āyuḥmantaḥ yasmāt tūḥṇīm evam etam dhārayāmi 
SA_K01_prmosulu-1063	[IX. duve dharmāḥ]	ix duve dharmāḥ 
SA_K01_prmosulu-1064	ime kho punar āyuṣmanto duve dharmāḥ Ō dharmo anudharmaś ca anvardhamāsaṃ sūtre prātimokṣe uddeśam āgacchanti /	ime kho punar āyuṣmantaḥ duve dharmāḥ dharmaḥ anudharmaḥ ca anvardha māsam sūtre prātimokṣe uddeśam āgacchanti 
SA_K01_prmosulu-1065	tatra dharmo nāma yam ubhayato vinayo /	tatra dharmaḥ nāma yam 
SA_K01_prmosulu-1066	anudharmo nāma yā atra pratipattiḥ /	anudharmaḥ nāma yā atra pratipattiḥ 
SA_K01_prmosulu-1067	uddiṣṭāḥ kho punar āyuṣmanto duve dharmāḥ dharmo anudharmaś ca /	uddiṣṭāḥ kho punar āyuṣmantaḥ duve dharmāḥ dharmaḥ anudharmaḥ ca 
SA_K01_prmosulu-1068	tatrāyuṣmanto pṛcchāmi Ō kaccittha pariśuddhāḥ?	tatra āyuṣmantaḥ pṛcchāmi kaccit tha pariśuddhāḥ 
SA_K01_prmosulu-1069	dvitīyaṃ pi āyuṣmanto pṛcchāmi kaccittha pariśuddhāḥ?	dvitīyam pi āyuṣmantaḥ pṛcchāmi kaccit tha pariśuddhāḥ 
SA_K01_prmosulu-1070	tṛtīyaṃ pi āyuṣmanto pṛcchāmi kaccittha pariśuddhāḥ?	tṛtīyam pi āyuṣmantaḥ pṛcchāmi kaccit tha pariśuddhāḥ 
SA_K01_prmosulu-1071	pariśuddhā atrāyuṣmanto yasmāt tūṣṇīm evam etaṃ dhārayāmi /	pariśuddhāḥ atra āyuṣmantaḥ yasmāt tūṣṇīm evam etam dhārayāmi 
SA_K01_prmosulu-1072	uddiṣṭaṃ kho punar āyuṣmanto prātimokṣasya vastu /	uddiṣṭam kho punar āyuṣmantaḥ prātimokṣasya vastu 
SA_K01_prmosulu-1073	uddiṣṭaṃ nidānaṃ /	uddiṣṭam nidānam 
SA_K01_prmosulu-1074	uddiṣṭāś catvāraḥ pārājikā dharmāḥ /	uddiṣṭāḥ catvāraḥ pārājikāḥ dharmāḥ 
SA_K01_prmosulu-1075	uddiṣṭāḥ trayodaśa saṃghātiśeṣā dharmāḥ /	uddiṣṭāḥ trayodaśa saṃgha atiśeṣāḥ dharmāḥ 
SA_K01_prmosulu-1076	uddiṣṭāḥ duve aniyatā dharmāḥ /	uddiṣṭāḥ duve aniyatāḥ dharmāḥ 
SA_K01_prmosulu-1077	uddiṣṭāḥ triṃśan nissargikapācattikā dharmāḥ /	uddiṣṭāḥ triṃśat nissargika pācattikāḥ dharmāḥ 
SA_K01_prmosulu-1078	uddiṣṭā dvānavati śuddhapācatti[kā] dharmāḥ /	uddiṣṭāḥ dvānavati śuddha pācattikāḥ dharmāḥ 
SA_K01_prmosulu-1079	uddiṣṭāś catvāraḥ prātideśanikā dharmāḥ /	uddiṣṭāḥ catvāraḥ prātideśanikāḥ dharmāḥ 
SA_K01_prmosulu-1080	uddiṣṭāḥ sātirekapañcāśac chaikṣā dharmāḥ /	uddiṣṭāḥ sa atireka pañcāśat śaikṣāḥ dharmāḥ 
SA_K01_prmosulu-1081	uddiṣṭāḥ saptādhikaraṇaśamathā dharmāḥ /	uddiṣṭāḥ sapta adhikaraṇa śamathāḥ dharmāḥ 
SA_K01_prmosulu-1082	uddiṣṭā duve dharmāḥ,	uddiṣṭāḥ duve dharmāḥ 
SA_K01_prmosulu-1083	dharmo anudharmaś ca /	dharmaḥ anudharmaḥ ca 
SA_K01_prmosulu-1084	etako 'yaṃ punas tasya bhagavato tathāgatasyārhataḥ samyaksaṃbuddhasya dharmavinayo prātimokṣasūtrāgato sūtraparyāpanno /	etakaḥ yam punar tasya bhagavataḥ tathāgatasya arhataḥ samyaksaṃbuddhasya dharma vinayaḥ prātimokṣa sūtra āgataḥ sūtra paryāpannaḥ 
SA_K01_prmosulu-1085	yo vā anyo 'pi kaścid dharmasya anudharmo tatra samagrehi sarvehi sahitehi saṃmodamānehi	yaḥ vai anyaḥ pi kaścid dharmasya tatra samagrehi sarvehi sahitehi saṃmodamānehi 
SA_K01_prmosulu-1086	avivadamānehi ekuddeśehi kṣīrodakībhūtehi śāstuḥ śāsanaṃ dīpayamānehi sukhaṃ ca phāsuṃ	a vivadamānehi ekuddeśehi kṣīrodakībhūtehi śāstuḥ śāsanam dīpayamānehi sukham ca phāsum 
SA_K01_prmosulu-1087	ca viharantehi anadhyācārāya śikṣā karaṇīyā /	ca viharantā ihi anadhyācārāya śikṣā karaṇīyā 
SA_K01_prmosulu-1088	kṣāntiḥ paramaṃ tapo titikṣā nirvāṇaṃ paramaṃ vadanti buddhāḥ /	kṣāntiḥ paramam tapaḥ titikṣā nirvāṇam paramam vadanti buddhāḥ 
SA_K01_prmosulu-1089	na hi pravrajitaḥ paropatāpī śravaṇo bhoti parān viheṭhayānaḥ //	na hi pravrajitaḥ para upatāpī śravaṇaḥ parān viheṭhayānaḥ 
SA_K01_prmosulu-1090	idaṃ tasya bhagavato vipaśyisya tathāgatasyārhataḥ samyaksaṃbuddhasya acirābhisaṃbuddhasya nirarbude bhikṣusaṃghe saṃkṣiptena prātimokṣaṃ subhāṣitaṃ	idam tasya bhagavataḥ vipaśyisya tathāgatasya arhataḥ samyaksaṃbuddhasya acira abhisaṃbuddhasya nirarbude bhikṣu saṃghe saṃkṣiptena prātimokṣam su bhāṣitam 
SA_K01_prmosulu-1091	anopavādī aparopaghātī prātimokṣe ca saṃvaro /	an upavādī apara upaghātī prātimokṣe ca saṃvaraḥ 
SA_K01_prmosulu-1092	mātrajñatā ca bhaktasmiṃ prāntaṃ ca śayanāsanaṃ /	mātra jña tā ca prāntam ca śayana āsanam 
SA_K01_prmosulu-1093	adhicitte cāyogo etaṃ buddhānuśāsanaṃ //	adhicitte ca ayogaḥ etam buddha anuśāsanam 
SA_K01_prmosulu-1094	idaṃ tasya bhagavato śikṣisya tathāgatasyārhataḥ samyaksaṃbuddhasya acirābhisaṃbuddhasya nirarbude bhikṣusaṃghe saṃkṣiptena prātimokṣaṃ subhāṣitaṃ	idam tasya bhagavataḥ śikṣisya tathāgatasya arhataḥ samyaksaṃbuddhasya acira abhisaṃbuddhasya nirarbude bhikṣu saṃghe saṃkṣiptena prātimokṣam su bhāṣitam 
SA_K01_prmosulu-1095	adhicetasi mā pramādyato munino maunapadeṣu śikṣataḥ /	adhicetasi mā pramādyataḥ muninaḥ mauna padeṣu śikṣataḥ 
SA_K01_prmosulu-1096	śokā na bhavanti tāyino upaśāntasya sadā smṛtīmataḥ //	śokāḥ na bhavanti tāyinaḥ upaśāntasya sadā smṛtīmataḥ 
SA_K01_prmosulu-1097	idaṃ tasya bhagavato viśvabhuvasya tathāgatasyārhataḥ samyaksaṃbuddhasya acirābhisaṃbuddhasya nirarbude bhikṣusaṃghe saṃkṣiptena prātimokṣaṃ  #	idam tasya bhagavataḥ viśvabhuvasya tathāgatasya arhataḥ samyaksaṃbuddhasya acira abhisaṃbuddhasya nirarbude bhikṣu saṃghe saṃkṣiptena prātimokṣam 
SA_K01_prmosulu-1098	subhāṣitaṃ //	subhāṣitam 
SA_K01_prmosulu-1099	sarvapāpasyākaraṇaṃ kuśalasyopasaṃpadā /	sarva pāpasya a karaṇam kuśalasya upasaṃpadā 
SA_K01_prmosulu-1100	svacittaparyodapanaṃ etaṃ buddhānuśāsanam //	sva citta paryodapanam etam buddha anuśāsanam 
SA_K01_prmosulu-1101	idaṃ tasya bhagavato krakucchandasya tathāgatasyārhataḥ samyaksaṃbuddhasya acirābhisaṃbuddhasya nirarbude bhikṣusaṃghe saṃkṣiptena prātimokṣaṃ  #	idam tasya bhagavataḥ krakucchandasya tathāgatasya arhataḥ samyaksaṃbuddhasya acira abhisaṃbuddhasya nirarbude bhikṣu saṃghe saṃkṣiptena prātimokṣam 
SA_K01_prmosulu-1102	subhāṣitaṃ //	subhāṣitam 
SA_K01_prmosulu-1103	yathā hi bhramaro puṇyaṃ varṇagandham aheṭhayaṃ /	yathā hi bhramaraḥ puṇyam varṇa gandham aheṭhayam 
SA_K01_prmosulu-1104	paraiti rasam ādāya evaṃ grāme muniś caret //	paraiti rasam ādāya evam grāme muniḥ caret 
SA_K01_prmosulu-1105	na pareṣāṃ vilomāni na pareṣāṃ kṛtākṛtaṃ /	na pareṣām vilomāni na pareṣām kṛta akṛtam 
SA_K01_prmosulu-1106	ātmano tu samīkṣeta kṛtāny akṛtāni ca //	tu samīkṣeta kṛtāni a kṛtāni ca 
SA_K01_prmosulu-1107	idaṃ tasya bhagavato konākamunisya tathāgatasyārhataḥ samyaksaṃbuddhasya acirābhisaṃbuddhasya nirarbude bhikṣusaṃghe saṃkṣiptena prātimokṣaṃ  #	idam tasya bhagavataḥ konāka munisya tathāgatasya arhataḥ samyaksaṃbuddhasya acira abhisaṃbuddhasya nirarbude bhikṣu saṃghe saṃkṣiptena prātimokṣam 
SA_K01_prmosulu-1108	subhāṣitam /	subhāṣitam 
SA_K01_prmosulu-1109	nāsti dhyānam aprajñasya prajñā nāsti adhyāyato /	na asti dhyānam aprajñasya prajñā na asti adhyāyataḥ 
SA_K01_prmosulu-1110	yasya dhyānaṃ ca prajñā ca sa vai nirvāṇasya antike //	yasya dhyānam ca prajñā ca sa vai nirvāṇasya antike 
SA_K01_prmosulu-1111	tatrāyam ādi bhavati ihaprajñasya bhikṣuṇo /	tatra ayam ādi bhavati ihaprajñasya bhikṣuṇaḥ 
SA_K01_prmosulu-1112	indriyai guptiḥ saṃtuṣṭiḥ prātimokṣe ca saṃvaro //	indriyai guptiḥ saṃtuṣṭiḥ prātimokṣe ca saṃvaraḥ 
SA_K01_prmosulu-1113	mitraṃ bhajeta kalyāṇaṃ śuddhājīvīm atandritaṃ /	mitram bhajeta kalyāṇam śuddha ājīvīm atandritam 
SA_K01_prmosulu-1114	pratisaṃstaravartī ca ācārakuśalo siyā /	pratisaṃstara vartī ca ācāra kuśalaḥ siyā 
SA_K01_prmosulu-1115	tataḥ prāmodya bahulo bhikṣu nirvāṇasyaiva antike //	tatas prāmodya bahulaḥ bhikṣu nirvāṇasya eva antike 
SA_K01_prmosulu-1116	idaṃ tasya bhagavataḥ kāśyapasya tathāgatasyārhataḥ samyaksaṃbuddhasya acirābhisaṃbuddhasya nirarbude bhikṣusaṃghe saṃkṣiptena prātimokṣaṃ	idam tasya bhagavataḥ kāśyapasya tathāgatasya arhataḥ samyaksaṃbuddhasya acira abhisaṃbuddhasya nirarbude bhikṣu saṃghe saṃkṣiptena prātimokṣam 
SA_K01_prmosulu-1117	cakṣuṣā saṃvaraḥ sādhuḥ sādhuḥ śrotreṇa saṃvaraḥ /	cakṣuṣā saṃvaraḥ sādhuḥ sādhuḥ śrotreṇa saṃvaraḥ 
SA_K01_prmosulu-1118	ghrāṇena saṃvaraḥ sādhuḥ sādhuḥ jihvāya saṃvaraḥ //	ghrāṇena saṃvaraḥ sādhuḥ sādhuḥ jihvāya saṃvaraḥ 
SA_K01_prmosulu-1119	kāyena saṃvaraḥ sādhuḥ manasā sādhu saṃvaraḥ /	kāyena saṃvaraḥ sādhuḥ manasā sādhu saṃvaraḥ 
SA_K01_prmosulu-1120	sarvatra saṃvṛto bhikṣuḥ sarvaduḥkhāt pramucyate //	sarvatra saṃvṛtaḥ bhikṣuḥ sarva duḥkhāt pramucyate 
SA_K01_prmosulu-1121	idaṃ tasya bhagavataḥ śākyamuneḥ śākyādhirājasya tathāgatasyārhataḥ samyaksambuddhasya acirābhisaṃbuddhasya nirarbude bhikṣusaṃghe saṃkṣiptena  #	idam tasya bhagavataḥ śākyamuneḥ śākyādhirājasya tathāgatasya arhataḥ samyaksambuddhasya acira abhisaṃbuddhasya nirarbude bhikṣu saṃghe saṃkṣiptena 
SA_K01_prmosulu-1122	prātimokṣaṃ subhāṣitam /	prātimokṣam su bhāṣitam 
SA_K01_prmosulu-1123	etāni prātimokṣāṇi saṃbuddhānāṃ śirīmatāṃ /	etāni prātimokṣāṇi saṃbuddhānām śirīmatām 
SA_K01_prmosulu-1124	kīrtitāny aprameyāṇi ........... tiṣṭam a ......... ṇāś ca //	kīrtitāni aprameyāṇi tiṣṭam a 
SA_K01_prmosulu-1125	kṣāntivādī ca bhagavān vipaśyī	kṣānti vādī ca bhagavān vipaśyī 
SA_K01_prmosulu-1126	anopavadyaṃ ca śikhī prakāśayati /	anopavadyam ca śikhī prakāśayati 
SA_K01_prmosulu-1127	adhicittaṃ ca viśvabhūḥ	adhicittam ca viśvabhūḥ 
SA_K01_prmosulu-1128	akaraṇaṃ ca pāpānāṃ krakucchandaḥ /	a karaṇam ca pāpānām kraku chandaḥ 
SA_K01_prmosulu-1129	caryāṃ ca konākamuniḥ	caryām ca konāka muniḥ 
SA_K01_prmosulu-1130	dhyānāni ca kāśyapo prakāśayati /	dhyānāni ca kāśyapaḥ prakāśayati 
SA_K01_prmosulu-1131	saṃvaraṃ śākyamuniḥ //	saṃvaram śākyamuniḥ 
SA_K01_prmosulu-1132	ete sapta daśabalā mahāprajñā amitabuddhī saptānāṃ samyaksaṃbuddhānām abhinnān .... lokākhyādhipatīnāṃ dharmākhyānāni uktāni /	ete sapta daśa balāḥ mahā prajñāḥ amita buddhī saptānām samyaksaṃbuddhānām abhinnān loka ākhya adhipatīnām dharma ākhyānāni uktāni 
SA_K01_prmosulu-1133	uddistaṃ prātimokṣasūtraṃ /	uddistam prātimokṣa sūtram 
SA_K01_prmosulu-1134	kṛtaṃ saṃghena poṣadhaṃ /	kṛtam saṃghena poṣadham 
SA_K01_prmosulu-1135	āryāḥ śikṣāṃ ciraṃ pālayantu /	āryāḥ śikṣām ciram pālayantu 
SA_K01_prmosulu-1136	śāsanaṃ .... santu saṃsthātu /	śāsanam santu saṃsthātu 
SA_K01_prmosulu-1137	samāptaṃ prātimokṣasūtraṃ āryamahāsāṃghikānāṃ lokottaravādināṃ madhyoddeśikānāṃ pāṭha iti //	samāptam prātimokṣa sūtram ārya mahā sāṃghikānām lokottara vādinām madhyoddeśikānām pāṭhaḥ iti 
SA_K01_prmosulu-1138	ye dharmā hetuprabhavā hetuṃ pi teṣāṃ tathāgato hy avadat* /	ye dharmāḥ hetu prabhavāḥ hetum teṣām tathāgataḥ hi avadat 
SA_K01_prmosulu-1139	teṣāṃ ca yo nirodha evaṃvādī mahāśravaṇaḥ /	teṣām ca yaḥ nirodhaḥ evaṃvādī mahā śravaṇaḥ 
SA_K01_prmosulu-1140	yo dharmo 'yaṃ pravaramahāyānayayisya śākyabhikṣuloka śrī[dharasya] /	yaḥ dharmaḥ yam śākya bhikṣu loka śrīdharasya 
SA_K01_prmosulu-1141	śākyabhikṣuśrīvijayabhadralikhitam idam //	śākya bhikṣu śrī vijayabhadra likhitam idam 
