segmentnr	original	analyzed
SA_K14_pamsuavu-0	Pāṃśupradāna-avadāna	pāṃśu pradāna avadāna 
SA_K14_pamsuavu-1	GBM 1508-1513 (= Divy 351.9-353.21)	ro 
SA_K14_pamsuavu-2	GBM 1514-1517 (= Divy 359.28-362.29)	ro 
SA_K14_pamsuavu-3	GBM 1508.1 (cf. Divy 351.9f.) /// + + + + + (bha)vati ( ( \) )	ro-0 ad-1 ad-1 
SA_K14_pamsuavu-4	tac chrutvā gupto gāndhikaś cintayati ayyo ahaṃ tāvad gṛhāvāse pa	tat śrutvā guptaḥ gāndhikaḥ cintayati ayyaḥ aham tāvat gṛha āvāse 
SA_K14_pamsuavu-5	GBM 1508.2 (cf. Divy 351.11f.) /// + + + (bha)[v](i)	divi div SLM
SA_K14_pamsuavu-6	[ṣ]y(a)	ṣya 
SA_K14_pamsuavu-7	ti taṃ vayam āryasya paścācchramaṇaṃ dāsyāmi \ @corrected from dasyāmaḥ@@ sthavira uvāca ( ( \)	ti tam vayam āryasya paścācchramaṇam dāsyāmi corrected from dasyāmaḥ sthaviraḥ uvāca   
SA_K14_pamsuavu-8	) vatsa eva	vatsaḥ eva 
SA_K14_pamsuavu-9	GBM 1508.3 (Divy -) /// + + (rama)[t](e)	divi SLM    ramate ram SPr3In
SA_K14_pamsuavu-10	paricārayati yāva sa bhāryā-d-āpannasatvā saṃjātā ( ( \) )	paricārayati sa bhāryā adāpannasatvā saṃjātā 
SA_K14_pamsuavu-11	sā paripūrṇair navabhi	sā paripūrṇaiḥ navabhiḥ 
SA_K14_pamsuavu-12	GBM 1508.4 (cf. Divy 351.14) /// (prāsā)	cf divi div SLM prāsā prāsā SNF
SA_K14_pamsuavu-13	[di]kaḥ tasya vistareṇa jātimahaṃ kṛtvā aśvagupto nāma kṛta[ḥ] sadhātryā ucchada	dikaḥ tasya vistareṇa jāti maham kṛtvā aśvaguptaḥ nāma kṛtaḥ sa dhātryā ucchada 
SA_K14_pamsuavu-14	GBM 1508.5 (cf. Divy 351.14f.) /// + + ya mahaṃtībhūtaḥ tadānurūpe karmaṇi śikṣaṇāya dattaḥ atha sthaviraśāṇavā	divi div SLM     yaḥ yad SNM mahaṃtībhūtaḥ mahaṃtībhū SNPaM tadā tadā  anurūpe anurūpa SLNe karmaṇi karman SLNe śikṣaṇāya śikṣaṇa SDNe dattaḥ dā SNPaM atha atha  sthavira sthavira Cp śāṇavā śāṇava SNF
SA_K14_pamsuavu-15	GBM 1508.6 (cf. Divy 351.16f.) /// .. putro bhaviṣyati taṃ vayam āryasya paścācchramaṇa[ṃ] dāsyāmi \ @corrected from dasyāmaḥ@@ ayaṃ te putro  #	divi SLM    putraḥ putra SNM bhaviṣyati SFu3In tam tad SAM mad PN āryasya ārya SGM paścācchramaṇam paścācchramaṇa SAM dāsyāmi SFu1In corrected SNPaF from  dasyāmaḥ das PPr1In idam SNM te tvad SG putraḥ putra SNM
SA_K14_pamsuavu-16	jātaḥ anu	jātaḥ anu 
SA_K14_pamsuavu-17	GBM 1508.7 (cf. Divy 351.18f.) /// [k](a)m ekaputrakaḥ anyo yo 'smākaṃ dvitīyaḥ putro bhaviṣyati taṃ vayam āryasya paścācchra	divi div SLM kam kaṃ  eka eka Cp putrakaḥ putraka SNM anyaḥ anya SNM yaḥ yad SNM mama mad PG dvitīyaḥ dvitīya SNM putraḥ putra SNM bhaviṣyati bhū SFu3In tam tad SAM vayam mad PN āryasya ārya SGM paścāt paścāt 
SA_K14_pamsuavu-18	GBM 1508.8 (cf. Divy 351.21f.) /// [p](a)śyati na :	cf divi div SLM paśyati dṛś SPr3In na na 
SA_K14_pamsuavu-19	tata @for loss of visarga cf. AIG I 287b@@ sthavira uvāca evam astv iti \ tasya yāva dvitīyaḥ putro jātaḥ tasyā	tata for loss of visarga cf ai c i  sthaviraḥ uvāca evam astu iti tasya dvitīyaḥ putraḥ jātaḥ tasyāḥ 
SA_K14_pamsuavu-20	GBM 1509.1 (cf. Divy 351.23f.) /// sa(ṃ)vṛttaḥ tadā sthaviraśāṇavāsī guptaṃ gāṃdhikam abhigamyovāca \ tvayā pratijñātaṃ	divi div SLM   saṃvṛttaḥ saṃvṛt SNPaM tadā tadā  sthavira sthavira Cp śāṇa śāṇa Cp vāsī vāsin SNM guptam gup SAPaM gāṃdhikam gāndhika SAM abhigamya abhigam Co uvāca vac SPs3In tvayā tvad SI pratijñātam pratijñā SNPaNe
SA_K14_pamsuavu-21	GBM 1509.2 (cf. Divy 351.26f.) /// (d)āsyāmi \ @corrected from dasyāmaḥ@@ ayaṃ ca te dvitīyaḥ puttra utpannaḥ anujāna pravrājayiṣyāmīti gupto	divi    dāsyāmi dā SFu1In corrected from  dasyāmaḥ dasyāma SNM idam SNM ca  te tvad SG dvitīyaḥ dvitīya SNM putra putra SNM utpannaḥ SNPaM anujāna SPr2Im pravrājayiṣyāmi iti 
SA_K14_pamsuavu-22	GBM 1509.3 (cf. Divy 351.28f.) /// [yo] 'ntargṛhaṃ paripālayiṣyati api tu yo 'smākaṃ tṛtīyaḥ putro bhaviṣyati sa ārya	divi div SLM   yaḥ yad SNM ntargṛham ntargṛha SANe paripālayiṣyati paripālay SFu3In api api  tu tu  yaḥ yad SNM mama mad PG tṛtīyaḥ tṛtīya SNM putraḥ putra SNM bhaviṣyati bhū SFu3In saḥ tad SNM ārya ārya SVM
SA_K14_pamsuavu-23	GBM 1509.4 (cf. Divy 351.30ff.) /// ..[ṃ] sa upaguptaḥ paśyati na :	divi div SLM   ṃ ṃ  saḥ tad SNM upaguptaḥ upagup SNPaM paśyati dṛś SPr3In na na 
SA_K14_pamsuavu-24	tenābhihitam evam astv iti \ yāva( d)	tena abhihitam evam astu iti yāvat 
SA_K14_pamsuavu-25	guptasya tṛtīyaḥ pu	guptasya tṛtīyaḥ pu 
SA_K14_pamsuavu-26	GBM 1509.5 (cf. Divy 352.2f.) /// + + ḥ cchatrākāraśiraḥ vistīrṇalalāṭaḥ atikrānto mānuṣaṃ varṇam asaṃprāptaś ca	cchattra Cp ākāra ākāra Cp śiraḥ śiras SNNe vistīrṇa vistṛ PaCp lalāṭaḥ atikram SNPaM mānuṣam mānuṣa SAM varṇam varṇa SAM a a  saṃprāptaḥ samprāp SNPaM ca ca 
SA_K14_pamsuavu-27	GBM 1509.6 (cf. Divy -) /// + + k[ṣ]īradadhinavanītakṣaudrādibhiḥ saṃvardhitaḥ yatra ca divase jātaḥ tataḥ prabhṛti	divi div SLM     kṣīra kṣīra Cp dadhi dadhi Cp navanīta navanīta Cp kṣaudra kṣaudra Cp ādibhiḥ ādi PIM saṃvardhitaḥ saṃvardhay SNPaM yatra yatra  ca ca  divase divasa SLM jātaḥ jan SNPaM tatas tatas  prabhṛti prabhṛti 
SA_K14_pamsuavu-28	GBM 1509.7 (cf. Divy 352.3f.) /// + + + [n]yaprabhṛtibhi[ś] ca bījajātair abhivardhituṃ pravṛttan* tasya vistareṇa jātima	divi 
SA_K14_pamsuavu-29	GBM 1509.8 (cf. Divy 352.5) /// + + + + [g](a)[ṇa]namu[d]rāyām upanyasto na cireṇa ca pāragaḥ saṃvṛttaḥ tato gāṃ/(dhik).	divi div SLM       gaṇana gaṇana Cp mudrāyām mudrā SLF upanyastaḥ upanyas SNPaM na na  cireṇa cireṇa  ca ca  pāragaḥ pāraga SNM saṃvṛttaḥ saṃvṛt SNPaM tatas tatas  gāṃdhik gāṃdhik SNM
SA_K14_pamsuavu-30	GBM 1510.1 (cf. Divy 352.5f.) /// + + .. .. labhate yāva( t)	divi div SLM
SA_K14_pamsuavu-31	sthaviraśāṇavāsī gupta{s}sakāśam abhigamyovāca \	sthavira śāṇa vāsī guptaḥ sakāśam abhigamya uvāca 
SA_K14_pamsuavu-32	GBM 1510.2 (cf. Divy 352.7f.) /// (āryas)	cf divi 
SA_K14_pamsuavu-33	[y](a)	ya 
SA_K14_pamsuavu-34	pradāsyāmi \ @corrected from dasyāmaḥ@@ paścācchramaṇārtham ayaṃ ca te tṛtīyaḥ puttro jātaḥ anujā	pradāsyāmi corrected from dasyāmaḥ paścāt śramaṇa artham ayam ca te tṛtīyaḥ puttraḥ jātaḥ anujā 
SA_K14_pamsuavu-35	GBM 1510.3 (cf. Divy 352.9f.) /// + + sya lābhe na cch[e]do bhaviṣyati tadā anujñāsyāmi ( ( \) )	divi div SLM lābhe lābha SLM na na  chedaḥ cheda SNM bhaviṣyati bhū SFu3In tadā tadā  anujñāsyāmi anujñā SFu1In
SA_K14_pamsuavu-36	yadā ca tena samayaḥ kṛ	yadā ca tena samayaḥ kṛ 
SA_K14_pamsuavu-37	GBM 1510.4 (Divy -) /// + [n]otpadyatā saddharmmaśīkarai( ḥ)	divi div SLM na na  utpadyatā utpad SIPaPrM saddharma saddharma Cp śīkaraiḥ śīkara PIM
SA_K14_pamsuavu-38	anekajanatā prahlādayitvā {s} sarvabhayātikrā	aneka janatā prahlādayitvā sarva bhaya atikrā 
SA_K14_pamsuavu-39	GBM 1510.5 (Divy -) /// .. [pr](a)vrajitaḥ hante sarvaviṣayaṃ śūnyīkariṣyati \ kim attredānīṃ prāptakālaṃ ta	divi     pravrajitaḥ pravraj SNPaM hante hanta  sarva sarva Cp viṣayam viṣaya SAM śūnyīkariṣyati śūnyīkṛ SFu3In kim kim  attra atra  idānīm idānīm  prāpta prāp PaCp kālam kāla SNNe
SA_K14_pamsuavu-40	GBM 1510.6 (cf. Divy 352.10) /// .. t prāg eva pravrajiṣyati \ tato māreṇa samayaparipūraṇārthaṃ sarvāvantā	divi div SLM    t t  prāk prāk  eva  pravrajiṣyati pravraj SFu3In tatas tatas  māreṇa māra SIM samaya samaya Cp paripūraṇa paripūraṇa Cp artham artha SAM sarvāvantā sarvāvat DuNM
SA_K14_pamsuavu-41	GBM 1510.7 (cf. Divy 352.12) /// + ca dravyāṇi gṛhṇaṃti tan nimittaṃ ca bahulābhaṃ labha{{ṃ}}te yāva( t)	cf divi div SLM ca ca  dravyāṇi dravya PANe gṛhṇanti grah PPr3In tat tad SANe nimittam nimitta SANe ca  bahu bahu Cp lābham lābha SAM labhaṃte labh PPr3In yāvat 
SA_K14_pamsuavu-42	sthaviraḥ śāṇavā	sthaviraḥ śāṇavā 
SA_K14_pamsuavu-43	GBM 1510.8 (cf. Divy 352.14f.) /// [s]th(i)	cf divi div SLM
SA_K14_pamsuavu-44	taḥ gandhāṃś ca vikṛṇāti \ atha sthavireṇa śāṇakavāsinābhihitaḥ vatsa kī	taḥ gandhān ca vikṛṇāti  atha sthavireṇa śāṇaka vāsinā abhihitaḥ vatsa kī 
SA_K14_pamsuavu-45	GBM 1511.1 (Divy -) /// .. iti \ sa kathayati sthavira na kliṣṭā( ( ḥ) )	divi    iti  tat tad SNM kathayati kathay SPr3In sthavira sthavira SVM na  kliṣṭāḥ kliś PNPaM
SA_K14_pamsuavu-46	nākliṣṭāṃ jānāmi caitasikā vā iti \ ajā	na akliṣṭām jānāmi caitasikā vā iti ajā 
SA_K14_pamsuavu-47	GBM 1511.2 (cf. Divy -) /// + dharmā( ( ḥ) )	divi    dharmāḥ 
SA_K14_pamsuavu-48	utpadyaṃte te kuśalāḥ ye kliṣṭacittena sahotpadyaṃte te kliṣṭā {{iti}} yā	utpadyaṃte te kuśalāḥ ye kliṣṭa cittena saha utpadyaṃte te kliṣṭāḥ iti yā 
SA_K14_pamsuavu-49	GBM 1511.3 (cf. Divy 352.15f.) /// + [ga]hyovāca ( ( \) )	ro-0 cc-2    
SA_K14_pamsuavu-50	vatsa kīdṛśā( ḥ)	vatsa kīdṛśāḥ 
SA_K14_pamsuavu-51	te cittacaitasikā dharmāḥ pravarttaṃte kiṃ kliṣṭā athā	te citta caitasikāḥ dharmāḥ pravarttaṃte kim kliṣṭāḥ 
SA_K14_pamsuavu-52	GBM 1511.4 (cf. Divy 352.17ff.) /// + [v](a)tsa yadi cittaṃ parijñātuṃ śakṣyase pratipakṣa( ṃ)	divi div SLM    vatsa vatsa SVM yadi yadi  cittam citta SANe parijñātum parijñā In śakṣyase śak SFu2In
SA_K14_pamsuavu-53	saṃśrayituṃ tena tasya kṛṣṇā pa	saṃśrayitum tena tasya kṛṣṇā pa 
SA_K14_pamsuavu-54	GBM 1511.5 (cf. Divy 352.20f.) /// + [ṣṇā](ṃ)	div SLM    ṣ ṇ Cp nām nām SNM
SA_K14_pamsuavu-55	paṭṭikāṃ sthāpayaḥ ((/ /	paṭṭikām sthāpayaḥ 
SA_K14_pamsuavu-56	)) athākliṣṭam utpadyate paṇḍarikāṃ {{vā}} paṭṭikāṃ sthāpa	atha akliṣṭam utpadyate paṇḍarikām vā paṭṭikām sthāpa 
SA_K14_pamsuavu-57	GBM 1511.6 (cf. Divy 352.22f.) /// + + yasveti /	ad-2 ro-0 iti 
SA_K14_pamsuavu-58	tasya yāvad ārabdhā( ( ḥ) )	tasya yāvat ārabdhā 
SA_K14_pamsuavu-59	akliṣṭacittacaitasikā utpadyituṃ \ sa	akliṣṭa citta caitasikā utpadyitum sa 
SA_K14_pamsuavu-60	GBM 1511.7 (cf. Divy 352.25f.) /// + + [kā]nāṃ sthāpayati ekaṃ kṛṣṇikānāṃ sthāpayati ekaṃ kṛṣṇikānāṃ yāvad a	divi div SLM     sthāpayati sthāpay SPr3In ekam eka SANe kṛṣṇikānām kṛṣṇika PGM sthāpayati sthāpay SPr3In ekam eka SANe kṛṣṇikānām kṛṣṇika PGM yāvat yāvat 
SA_K14_pamsuavu-61	GBM 1511.8 (cf. Divy 352.27f.) /// + + [v](a) paṭṭikā sthāpayati dharmeṇa ca vyavahāraṃ karoti \ mathu( ( ra)	divi  paṭṭikā paṭṭikā SNF sthāpayati sthāpay SPr3In dharmeṇa dharma SIM ca ca  vyavahāram vyavahāra SAM karoti kṛ SPr3In mathu 
SA_K14_pamsuavu-62	)yām vāsava	yām vāsava 
SA_K14_pamsuavu-63	GBM 1512.1 (cf. Divy 352.29) /// + + + .. .. madamattā {{ḥ}} @scribal error for vāsavadattā?	divi div SLM      mada mada Cp mad mad PNPaM for for  vāsavadattā vāsavadattā SNF
SA_K14_pamsuavu-64	@@ tasyā {d} dāsī upagupta{s}sakāśād dine dine gandhāṃ krīṇā	tasyāḥ d dāsī upaguptaḥ sakāśāt dine dine gandhām 
SA_K14_pamsuavu-65	GBM 1512.2 (cf. Divy 353.1f.) /// + + [t](e) dārike muṣyate [g]andhika( ḥ)	divi div SLM     te tvad SG dārike dārikā SVF muṣyate muṣ SPr3InPv gandhikaḥ gandhika SNM
SA_K14_pamsuavu-66	tvayā bahūn gandhān ānayasīti \ dārikovāca \ ā	tvayā bahūn gandhān ānayasi iti dārikā uvāca ā 
SA_K14_pamsuavu-67	GBM 1512.3 (cf. Divy 353.3f.) /// + + + .. ś ca sahadharmeṇa - - - karoti \ śrutvā ca vāsavadatta{{ā}}yā upagupta{s}sa	ca  ca  sahadharmeṇa sahadharma SIM    karoti kṛ SPr3In śrutvā śru Co ca  vāsavadattā vāsavadattā Cp āyāḥ āyā SNM upaguptaḥ upagup SNPaM tad SNM
SA_K14_pamsuavu-68	GBM 1512.4 (cf. Divy 353.5f.) /// + + [kā]śaṃ preṣitā tvatsakāśam āgamiṣyāmi icchāmi tvayā sārdhaṃ ratim anubhavi	divi div SLM     kāśam kāśa SAM preṣitā preṣay SNPaF tvad tvad Cp sakāśam sakāśa SAM āgamiṣyāmi āgam SFu1In icchāmi iṣ SPr1In tvayā tvad SI sārdham  ratim rati SAF
SA_K14_pamsuavu-69	GBM 1512.5 (cf. Divy 353.8f.) /// + + .. savadattā :	divi div SLM savadattā savadattā SNF
SA_K14_pamsuavu-70	paṃcabhiḥ purāṇaśataiḥ paricārayate \ tasyā {d} buddhir utpannā {{ḥ}}	paṃcabhiḥ purāṇa śataiḥ paricārayate tasyāḥ d buddhiḥ utpannā 
SA_K14_pamsuavu-71	GBM 1512.6 (cf. Divy 353.10f.) /// + naḥ preṣikā visarjitā {{ḥ}} na mamāryaputra tvatsakāśā( t)	divi div SLM    naḥ mad PG preṣikā preṣikā SNF visarjitā visarjay SNPaF na na  mama mad SG āryaputra āryaputra SVM tvad tvad Cp sakāśāt sakāśāt 
SA_K14_pamsuavu-72	kenacit prayojanaṃ ke	kenacid prayojanam ke 
SA_K14_pamsuavu-73	GBM 1512.7 (cf. Divy 353.12ff.) /// + ca \ akālas te bhagini maddarśanasyeti \ yāvad anyataraḥ śreṣṭhiputraḥ vāsa	divi div SLM    ca ca  akālaḥ akāla SNM te tvad SG bhagini bhaginī SVF mad mad Cp darśanasya darśana SGNe iti iti  yāvat  anyataraḥ anyatara SNM śreṣṭhi śreṣṭhin Cp putraḥ putra SNM vāsa vāsa SVM
SA_K14_pamsuavu-74	GBM 1512.8 (cf. Divy 353.14ff.) /// [t]t(a)	divi 
SA_K14_pamsuavu-75	rāpathaṃ paṃcaśatam aśvapaṇyaṃ grahāya mathurām anuprāptaḥ tenābhihitaṃ kata	rāpatham paṃcaśatam aśva paṇyam grahāya mathurām anuprāptaḥ tena abhihitam kata 
SA_K14_pamsuavu-76	GBM 1513.1 (cf. Divy 353.17f.) /// .. dāya ( ( \) )	divi   /
SA_K14_pamsuavu-77	bahu ca prābhṛtaṃ vāsavadattāyās sakāśa( ṃ)	bahu ca prābhṛtam vāsavadattāyāḥ sakāśe 
SA_K14_pamsuavu-78	gataḥ tato vāsavadattayā iyam utpa	gataḥ tatas vāsavadattayā iyam utpa 
SA_K14_pamsuavu-79	GBM 1513.2 (Divy -) /// + .. śād gṛhītam ayaṃ cāśvavaṇik paṃca pu( (	divi     gṛhītam grah SNPaNe ayam idam SNM ca  aśva aśva Cp vaṇij vaṇij SNM
SA_K14_pamsuavu-80	rā) )	rā 
SA_K14_pamsuavu-81	ṇaśatāni prabhūtaṃ [v]ottarāpathakaṃ prābhṛtam ādā	ṇa śatāni prabhūtam vā uttarāpathakam prābhṛtam ādā 
SA_K14_pamsuavu-82	GBM 1513.3 (Divy -) /// + + .. gatya yā saha ratim anubhaviṣyatīyantād arthād dhānir bhaviṣyati katham idānīṃ kara	divi SLM      gatya gam Co yā yad SNF saha saha  ratim rati SAF anubhaviṣyati anubhū SFu3In iyantāt iyanta SBM arthāt artha SBM hāniḥ hāni SNF bhaviṣyati bhū SFu3In katham katham  idānīm  kara kṛ SPr2Im
SA_K14_pamsuavu-83	GBM 1513.4 (cf. Divy 353.19) /// + + viṣamaṃ ca madyaṃ pāyayitvā praghātitaḥ tato 'vaskare prakṣipyāśvavaṇik praveśa	divi div SLM      viṣamam viṣama SANe ca ca  madyam madya SANe pāyayitvā pāyay Co praghātitaḥ praghātay SNPaM tatas tatas  vaskare vaskara SLM prakṣipya prakṣip Co aśva aśva Cp vaṇij vaṇij SNM praveśa praviś SPs3In
SA_K14_pamsuavu-84	GBM 1513.5 (Divy -) /// + + + [j]anabaṃdhuvargo apaśyamānās taṃ samaṃtam {a} ārabdhāḥ samanveṣituṃ na ca labhya	divi SLM      jana jana Cp bandhu bandhu Cp vargaḥ varga SNM a  paśyamānāḥ paś PNPaPrMPv tam tad SAM samantam samanta SAM ārabdhāḥ ārabh PNPaM samanveṣitum samanviṣ In na  ca 
SA_K14_pamsuavu-85	GBM 1513.6 (Divy -) /// + + + .. dhāritaḥ tatas tena mātāpitṛbhyāṃ niveditaṃ vāsavadattāgṛhe me praviśa	divi SLM       dhāritaḥ dhāray SNPaM tatas  tena tad SIM mātā mātā Cp pitṛbhyām pitṛ DuIM niveditam niveday SNPaNe vāsavadattā āgṛha SLNe mama mad SG praviśa praviś SPr2Im
SA_K14_pamsuavu-86	GBM 1513.7 (cf. Divy 353.21) /// + + + + [to] mathurāyāṃ mahāsaṃkṣobho jāto rājñā śrutaṃ rājñābhihitaṃ gacchantu bhavaṃto	divi div SLM mathurāyām mathurā SLF mahā mahat Cp saṃkṣobhaḥ saṃkṣobha SNM jātaḥ jan SNPaM rājñā rājan SIM śrutam śru SNPaNe rājñā rājan SIM abhihitam abhidhā SNPaNe gacchantu gam PPr3Im bhavantaḥ bhavat PNM
SA_K14_pamsuavu-87	GBM 1513.8 (Divy -) /// + + + .. [a]tha vāsavadattā pṛyajane nirud( h)	divi div SLM
SA_K14_pamsuavu-88	yamānā madhyasthajanenāśocyamānā	yamānā madhyastha janena aśocyamānā 
SA_K14_pamsuavu-89	GBM 1514.1 (cf. Divy 359.28ff.) /// + + + + [d](a)rśinā \ tvaṃ nāpriyam iha prokta( ḥ)	divi div SLM      darśiṇā darśin SIM tvam tvad SN na na  apriyam apriya SANe iha iha  proktaḥ pravac SNPaM
SA_K14_pamsuavu-90	priyāṇy eva tu laṃbhitā \ nyāyenāne(	priyāṇi eva tu laṃbhitā 
SA_K14_pamsuavu-91	na) bhakti	na bhakti 
SA_K14_pamsuavu-92	GBM 1514.2 (cf. Divy 360.2f.) /// + + + + [tāṃ] nirvāṇaphaladā :	divi div SLM      tām tad SAF nirvāṇa nirvāṇa Cp phala phala Cp dā da SNF
SA_K14_pamsuavu-93	saṃkṣepād yat kṛtaṃ te vrijinam iha muner mohāndhamanasā ( (	saṃkṣepāt yat kṛtam te vrijinam iha muneḥ moha andha manasā 
SA_K14_pamsuavu-94	\)) sarvvaṃ	sarvvam 
SA_K14_pamsuavu-95	GBM 1514.3 (cf. Divy 360.5ff.) /// + + + + d āhṛṣṭa( ḥ)	divi 
SA_K14_pamsuavu-96	sarvvāṃga uvāca \ / /	sarvvāṃgaḥ uvāca 
SA_K14_pamsuavu-97	sthāne mayā bahuvidhaṃ parikhedito 'sau prāk siddhi	sthāne mayā bahuvidham 
SA_K14_pamsuavu-98	GBM 1514.4 (cf. Divy 360.8f.) /// + + + .. [ṇ]. tena putrāparādha iva sānunayena pitrā \ / /	divi div SLM      tena tad SIM putra putra Cp aparādhaḥ aparādha SNM iva iva  sa sa  anunayena anunaya SIM pitrā pitṛ SIM   
SA_K14_pamsuavu-99	saddharmaprasādā{dā}syāyitama	saddharma prasādāt āsyāyitama 
SA_K14_pamsuavu-100	GBM 1514.5 (cf. Divy 360.10f.) /// + + + (v)āca : / /	ro-0 or-1 
SA_K14_pamsuavu-101	anugraho me 'dya paraḥ kṛtas tvayā niveśitaṃ yan mayi buddhagauravaṃ \ idaṃ [c]a kaṇṭha	anugrahaḥ me dya paraḥ kṛtaḥ tvayā niveśitam yat mayi buddha gauravam idam ca kaṇṭha 
SA_K14_pamsuavu-102	GBM 1514.6 (cf. Divy 360.12ff.) /// + + [v]āca \ / /	ro-0 or-1 
SA_K14_pamsuavu-103	samayato mokṣyāmīti \ māra uvāca \ brūhi kas samaya iti \ sthavira uvāca	samayataḥ mokṣyāmi iti māraḥ uvāca brūhi kaḥ samayaḥ iti sthaviraḥ uvāca 
SA_K14_pamsuavu-104	GBM 1514.7 (cf. Divy 360.15f.) /// + .. ṭhayiṣyāmīti \ kim aparam ājñāpayasīti sthavir uvāca / /	divi div SLM     kim ka SANe aparam apara SANe ājñāpayasi ājñāpay SPr2In iti iti  sthaviḥ sthavis SNM uvāca vac SPs3In  /
SA_K14_pamsuavu-105	eṣā tāvac chāsanakāryaṃ	eṣā tāvat śāsana kāryam 
SA_K14_pamsuavu-106	GBM 1514.8 (cf. Divy 360.17ff.) /// .. [vā]ca / /	ro-0 fl-1 fl-2 
SA_K14_pamsuavu-107	prasīda sthavira kim ājñāpayasi \ sthaviro 'bravī( t)	prasīda sthavira kim ājñāpayasi sthaviraḥ bravī t 
SA_K14_pamsuavu-108	svayam eva gacchasi yathāhaṃ varṣaśa(	svayam eva gacchasi yathā aham varṣaśas 
SA_K14_pamsuavu-109	(ta))	ta 
SA_K14_pamsuavu-110	GBM 1515.1 (cf. Divy 360.20f.) /// na dṛṣṭa( ḥ)	divi  na  dṛṣṭaḥ dṛś SNPaM
SA_K14_pamsuavu-111	trailokyanāthasya kāṃcanā{d}drinibhaṃ [t]asya na dṛṣṭo rūpakāyo me \ tad anagham anugra	trailokya nāthasya kāṃcanāt dri nibham tasya na dṛṣṭaḥ rūpa kāyaḥ me tat anagham anugra 
SA_K14_pamsuavu-112	GBM 1515.2 (cf. Divy 360.22ff.) /// + .. sti me daśabalarūpakutūhalo hy ayam* māra uvāca \ tena hi mamāpi samayaḥ śrū	divi      sti as SPr3In mama mad SG daśa daśan Cp bala bala Cp rūpa rūpa Cp kutūhalaḥ kutūhala SNM hi  ayam idam SNM māraḥ māra SNM uvāca vac SPs3In tena tad SIM hi  mama mad SG api api  samayaḥ samaya SNM
SA_K14_pamsuavu-113	GBM 1515.3 (cf. Divy 360.25ff.) /// + .. [y]ā kārya( ḥ)	cf divi 
SA_K14_pamsuavu-114	sarvvajñagurugauravāt* buddhānusmṛtipeśalena manasā pūjām atha tvaṃ mayi	sarvvajña guru gauravāt buddha anusmṛti peśalena manasā pūjām atha tvam mayi 
SA_K14_pamsuavu-115	GBM 1515.4 (cf. Divy 360.28f.) /// + .. kā śaktir mama vītarāgamahitāṃ soḍhuṃ praṇāmakṛyāṃ \ hastanyāsam ivodvahaṃ niva	divi div SLM     kā ka SNF śaktiḥ śakti SNF mama mad SG vīta vī PaCp rāga rāga Cp mahitām mahita SAF soḍhum sah In praṇāma praṇāma Cp kṛyām kṛya SAF hasta hasta Cp nyāsam nyāsa SAM iva iva  udvaham udvah Co
SA_K14_pamsuavu-116	GBM 1515.5 (cf. Divy 360.30ff.) /// + + m[i]ṣyāmīti \ māro 'bravīt tena hi muhūrttam āgamayasva yāvad ahaṃ vanam anupravi	divi      miṣyāmi miṣ SPr1In iti  māraḥ māra SNM bravīt brū S3ImIn tena tena  hi  muhūrtam muhūrta SANe āgamayasva āgamay SPr2Im yāvat  aham mad SN vanam vana SANe
SA_K14_pamsuavu-117	GBM 1515.6 (cf. Divy 361.4f.) /// + + .. .y. buddhivibhavād āsīn mayā yat kṛtaṃ kṛtvā rūpam ahaṃ tad eva nayanaḥ prahlādakaṃ	divi div SLM      y y  buddhi buddhi Cp vibhavāt vibhava SBM āsīt as S3ImIn mayā mad SI yat yad SNNe kṛtam kṛ SNPaNe kṛtvā kṛ Co rūpam rūpa SANe aham mad SN tat tad SANe eva eva  nayanaḥ nayana SNM prahlādakam prahlādaka SNNe
SA_K14_pamsuavu-118	GBM 1515.7 (cf. Divy 361.7f.) /// + + .. tha sthavira evam astv ity uktvā {{ka}} ( (	divi div SLM sthaviraḥ sthavira SNM evam evam  astu as SPr3Im iti  vac Co ka ka SNM
SA_K14_pamsuavu-119	ta) )	ta 
SA_K14_pamsuavu-120	c chvakuṇapam apanīya tathāgatarūpadarśanotsuko	c śva kuṇapam apanīya tathāgata rūpa darśana utsukaḥ 
SA_K14_pamsuavu-121	GBM 1515.8 (cf. Divy 361.9ff.) /// + + + [su]caritanepacchaḥ tasmād vanagahanād ārabdho niṣkramituṃ vakṣyate hi \ tathāgataṃ	divi div SLM     su su  carita car PaCp nepacchaḥ nepaccha SNM tasmāt tad SBNe vana vana Cp gahanāt gahana SBNe ārabdhaḥ ārabh SNPaM niṣkramitum niṣkram In vakṣyate vac SFu3In hi  tathāgatam tathāgata SAM
SA_K14_pamsuavu-122	GBM 1516.1 (cf. Divy 361.13ff.) /// + + .. gam iva cittrapaṭaṃ mahārham udghāṭayan vanam asau tad alaṃcakāra :	divi div SLM      iva iva  cittra cittra Cp paṭam paṭa SAM mahārham mahārha SAM udghāṭayan udghāṭay SNPaPrM vanam vana SANe asau adas SNM tat tad SANe alaṃcakāra alaṃkṛ SPs3In
SA_K14_pamsuavu-123	atha vyā{ṃ}mapra	atha vyāṃmapra 
SA_K14_pamsuavu-124	GBM 1516.2 (cf. Divy 361.16f.) /// + + [d](a)kṣiṇena pārśvena sthaviraśāriputraṃ vāmena pārśvena sthaviramahāmaudgalyāya	divi div SLM     dakṣiṇena dakṣiṇa SIM pārśvena pārśva SIM sthavira sthavira Cp śāriputram śāriputra SAM vāmena vāma SIM pārśvena pārśva SIM sthavira sthavira Cp mahāmaudgalyāya mahāmaudgalya SDM
SA_K14_pamsuavu-125	GBM 1516.3 (cf. Divy 361.18ff.) /// + + + [pā]niruddhasubhūtiprabhṛtīnāṃ ca mahāśrāvakānāṃ rūpāṇy abhinirmīya ardhatrayo	divi div SLM
SA_K14_pamsuavu-126	GBM 1516.4 (cf. Divy 361.21f.) /// + + + m ādarśayitvā sthaviropaguptasyāntikam upajagāma :	divi div SLM      ādarśayitvā ādarśay Co sthavira sthavira Cp upaguptasya upagupta SGM antikam antika SANe upajagāma upagam SPs3In
SA_K14_pamsuavu-127	sthaviropaguptasya ca bha	sthavira upaguptasya ca bha 
SA_K14_pamsuavu-128	GBM 1516.5 (cf. Divy 361.23f.) /// + + [m]anāḥ tvaritam āsanād utthāya nirīkṣamāṇa uvāca \ / /	divi div SLM     manāḥ manas SNM tvaritam tvaritam  āsanāt āsana SBNe utthāya utthā Co nirīkṣamāṇaḥ nirīkṣ SNPaPrM uvāca vac SPs3In   
SA_K14_pamsuavu-129	dhig astu tāṃ niṣkaruṇām a	dhik astu tām niṣkaruṇām a 
SA_K14_pamsuavu-130	GBM 1516.6 (cf. Divy 361.25ff.) /// + + + + ner anityatāṃ prāpya vināśam āgataṃ \ sa buddhālaṃbanayā smṛtyā tathā vyāsakta	divi div SLM      neḥ ni SGM anitya anitya Cp tām tā SAF prāpya prāp Co vināśam vināśa SAM āgatam āgam SNPaNe sa tad SNM buddha buddha Cp ālaṃbanayā ālambana SIF smṛtyā smṛti SIF tathā tathā  vyāsakta vyāsañj SVPaM
SA_K14_pamsuavu-131	GBM 1516.7 (cf. Divy 361.29f.) /// + .. [t]. .. [s](a) padmamukuṭam aṃjaliṃ kṛtvovāca \ aho rūpaśobhā bhagavataḥ kiṃ bahunā \	divi divi SLM     t t SNM sa tad SNM padma padma Cp mukuṭam mukuṭa SAM añjalim añjali SAM kṛtvā kṛ Co uvāca vac SPs3In aho aho  rūpa rūpa Cp śobhā śobhā SNF bhagavataḥ bhagavant SGM kim ka SNNe bahunā bahu SINe
SA_K14_pamsuavu-132	GBM 1516.8 (cf. Divy 362.2ff.) /// (p)uṣpaghanaṃ vanaṃ pṛyatayā candraṃ samāptadyutiṃ {{gīṃ}} ( (	divi div SLM puṣpa puṣpa Cp ghanam ghana SANe vanam vana SANe pṛya pṛ GdCp tayā tā SIF candram candra SAM samāpta samāp PaCp dyutim dyuti SAM gīṃ gīṃ 
SA_K14_pamsuavu-133	gā) )	gāḥ 
SA_K14_pamsuavu-134	bhīryeṇa mahodadhiṃ sthiratayā meruṃ raviṃ	bhīryeṇa mahā udadhim sthira tayā merum ravim 
SA_K14_pamsuavu-135	GBM 1517.1 (cf. Divy 362.6ff.) /// [s](a) bhūyasyā māttrayā saharṣerāpūryamāṇahṛdayo vyāpinā svareṇovāca \ aho	divi div SLM   sa tad SNM bhūyasyā bhūyas SIF māttrayā māttrā SIF saha saha  ṛṣeḥ ṛṣi SGM āpūryamāṇa āp￞ PaPrPvCp hṛdayaḥ hṛdaya SNM vyāpinā vyāpin SIM svareṇa svara SIM uvāca vac SPs3In aho aho 
SA_K14_pamsuavu-136	GBM 1517.2 (cf. Divy 362.9ff.) /// + .. rair.. yadṛcchayā \ yat tat kalpasahasrakoṭinayutair vākkāyacittodbhavaṃ \ dāna	divi div SLM yadṛcchayā yadṛcchā SIF yat yad SNNe tat tad SNNe kalpa kalpa Cp sahasra sahasra Cp koṭi koṭi Cp nayutaiḥ nayuta PINe vāc vāc Cp kāya kāya Cp citta citta Cp udbhavam udbhava SNNe dāna dāna Cp
SA_K14_pamsuavu-137	GBM 1517.3 (cf. Divy 362.12ff.) /// + + + + .. tam amalaṃ rūpaṃ samutthāpitaṃ \ yaṃ dṛṣṭvā ri( pu)	divi div SLM       tam tad SAM amalam amala SNNe rūpam rūpa SNNe samutthāpitam samutthāpay SNPaNe yam yad SAM dṛṣṭvā dṛś Co
SA_K14_pamsuavu-138	r apy abhipramudita( ( ḥ) )	R api abhipramuditaiḥ 
SA_K14_pamsuavu-139	syāt kiṃ punar mma	syāt kim punar mma 
SA_K14_pamsuavu-140	GBM 1517.4 (cf. Divy 362.16f.) /// + + + .. mārasaṃjñā vismṛtya buddhasaṃjñām adhiṣṭhāya mūla( (	divi div SLM
SA_K14_pamsuavu-141	ni) )	ni 
SA_K14_pamsuavu-142	kṛnta iva drumaḥ sarvaśarīre	kṛntaḥ iva drumaḥ sarva śarīre 
SA_K14_pamsuavu-143	GBM 1517.5 (cf. Divy 362.18f.) /// + + va {bhadanta} bhadanta nārhasi samayam atikramituṃ sthavira uvāca \ kas samaya iti \	divi div SLM       bhadanta bhadanta SVM bhadanta bhadanta SVM na na  arhasi arh SPr2In samayam samaya SAM atikramitum atikram In sthaviraḥ sthavira SNM uvāca vac SPs3In kaḥ ka SNM samayaḥ samaya SNM iti iti 
SA_K14_pamsuavu-144	GBM 1517.6 (cf. Divy 362.21ff.) /// + + + [t](a)ta @for loss of visarga cf. AIG I 287b@@ sthaviropaguptaḥ pṛthivītalād utthāya sagadgadakaṃṭho  #	cf divi div SLM      tata tata Cp for loss or visarga cf ai  k k SNM sthavira sthavira Cp upaguptaḥ upagup SNPaM pṛthivī pṛthivī Cp talāt tala SBM utthāya utthā Co sa sa  gadgada gadgada Cp kaṇṭhaḥ kaṇṭha SNM
SA_K14_pamsuavu-145	'bravīt* pāpīmaṃ na kha	bravīt pāpī imam na kha 
SA_K14_pamsuavu-146	GBM 1517.7 (cf. Divy 362.25f.) /// + + + [a]pi tu nayanakāṃtām ākṛtiṃ tasya dṛṣṭvā tam ṛṣim abhinato 'haṃ tvāṃ tu nābhya	divi div SLM       api api  tu  nayana nayana Cp kāntām kānta SAF ākṛtim ākṛti SAF tasya tad SGM dṛṣṭvā dṛś Co tam tad SAM ṛṣim ṛṣi SAM abhinataḥ abhinam SNPaM ham ham  tvām tvad SA tu tu  nābhya nābhya SVM
SA_K14_pamsuavu-147	GBM 1517.8 (cf. Divy 362.28f.) /// + + + praṇamasīti \ sthaviro 'bravīt{i} \ śrūyatāṃ yathā na tvaṃ mayābhyarcito bhavasi \	divi div SLM      praṇamasi praṇam SPr2In iti  sthaviraḥ sthavira SNM bravīti brū SPr3In śrūyatām śru SPr3ImPv yathā yathā  na na  tvam tvad SN mayā mad SI abhyarcitaḥ abhyarcay SNPaM bhavasi bhū SPr2In
