segmentnr	original	analyzed
SA_K14_mavadsuu-0	I. Prologue	i prologue 
SA_K14_mavadsuu-1	evaṃ mayā śrutam ekasmiṃ samaye bhagavāṃ Śrāvastyāṃ viharati Jetavane Anāthapiṇḍadārāme /	evam mayā śrutam ekasmin samaye bhagavām śrāvastyām viharati jetavane anāthapiṇḍada ārāme 
SA_K14_mavadsuu-2	atha saṃbahulānāṃ bhikṣūṇāṃ Karīrikamaṇḍalavāṭe saṃniṣaṇṇānāṃ saṃnipatitānām ayam evaṃrūpo 'bhūd antarākathāsamudāhāraḥ	atha saṃbahulānām bhikṣūṇām karīrika maṇḍalavāṭe saṃniṣaṇṇānām saṃnipatitānām ayam evaṃrūpaḥ bhūt antarākathā samudāhāraḥ 
SA_K14_mavadsuu-3	āścaryam āyuṣmanto yāvac ca bhagavataḥ atīteṣu samyaksaṃbuddheṣu atītāṃśabhāvagateṣu	āścaryam āyuṣmantaḥ yāvat ca bhagavataḥ atīteṣu samyaksaṃbuddheṣu atīta aṃśa bhāva gateṣu 
SA_K14_mavadsuu-4	chinnavartmasu chinnapuṭeṣu niṣprapaṃceṣu prapaṃcātīteṣu parinirvṛteṣu kāruṇikeṣu	chinna vartmasu chinna puṭeṣu niṣprapaṃceṣu prapaṃca atīteṣu parinirvṛteṣu kāruṇikeṣu 
SA_K14_mavadsuu-5	nirāśiṣeṣu evaṃ samyak pratyātmaṃ jñānadarśanaṃ pravartate /	evam samyak pratyātmam jñāna darśanam pravartate 
SA_K14_mavadsuu-6	evaṃśīlā bata te buddhā bhagavaṃto babhūvur ity api evaṃdharmāṇa evaṃprajñā evamabhijñā evaṃvimuktaya evaṃvihāriṇo bata te buddhā bhagavanto  #	evaṃśīlāḥ bata te buddhāḥ bhagavantaḥ babhūvuḥ iti api evam dharmāṇaḥ evaṃprajñāḥ evamabhijñāḥ evam vimuktayaḥ evam vihāriṇaḥ bata te buddhāḥ bhagavantaḥ 
SA_K14_mavadsuu-7	babhūvur ity api /	babhūvuḥ iti api 
SA_K14_mavadsuu-8	kiṃ nu bhagavato dharmadhātuḥ supratividdhaḥ āho svid devatā ārocayaṃti yena tathāgatasyātīteṣu	kim nu bhagavataḥ dharmadhātuḥ su pratividdhaḥ āho svid devatāḥ ārocayaṃti yena tathāgatasya atīteṣu 
SA_K14_mavadsuu-9	samyaksaṃbuddheṣu atītāṃśabhāvagateṣu chinnavartmasu chinnapuṭeṣu niṣprapaṃceṣu prapañcātīteṣu (MAV 32)	samyaksaṃbuddheṣu atīta aṃśa bhāva gateṣu chinna vartmasu chinna puṭeṣu niṣprapaṃceṣu prapañca atīteṣu 
SA_K14_mavadsuu-10	parinirvṛteṣu kāruṇikeṣu nirāśiṣeṣu evaṃ samyak pratyātmaṃ jñānadarśanaṃ pravartate	parinirvṛteṣu kāruṇikeṣu nirāśiṣeṣu evam samyak pratyātmam jñāna darśanam pravartate 
SA_K14_mavadsuu-11	evaṃśīlā bata te buddhā bhagavaṃto babhūvur ity apy evaṃdharmāṇa evaṃprajñā evamabhijñā	evaṃśīlāḥ bata te buddhāḥ bhagavaṃtaḥ babhūvuḥ iti api evam dharmāṇaḥ evaṃprajñāḥ evam abhijñāḥ 
SA_K14_mavadsuu-12	evaṃvimuktaya evaṃvihāriṇo bata te buddhā bhagavaṃto babhūvur ity api /	evam vimuktayaḥ evam vihāriṇaḥ bata te buddhāḥ bhagavaṃtaḥ babhūvuḥ iti api 
SA_K14_mavadsuu-13	iyaṃteṣāṃ saṃbahulānāṃ bhikṣūṇāṃ Karīrikamaṇḍalavāṭe saṃniṣaṇṇānāṃ sannipatitānām antarākathā viprakṛtā /	iyat teṣām saṃbahulānām bhikṣūṇām karīrika maṇḍalavāṭe saṃniṣaṇṇānām sannipatitānām antarākathā viprakṛtā 
SA_K14_mavadsuu-14	aśrauṣīd bhagavāṃ divāvihāropagato divyena śrotreṇa viśuddhenātikrāntamānuṣeṇa śrutvā	aśrauṣīt bhagavām divāvihāra upagataḥ divyena śrotreṇa viśuddhena atikrānta mānuṣeṇa śrutvā 
SA_K14_mavadsuu-15	ca punas tasmāt samādher vyutthāya yena Karīrikamaṇḍalavāṭas tenopajagāma upetya	ca punar tasmāt samādheḥ vyutthāya yena karīrika maṇḍala vāṭaḥ tena upajagāma upetya 
SA_K14_mavadsuu-16	purastād bhikṣusaṃghasya prajñapt';	purastāt bhikṣu saṃghasya prajñapta 
SA_K14_mavadsuu-17	evāsanne nyaṣīdat	eva āsanne nyaṣīdat 
SA_K14_mavadsuu-18	niṣadya bhagavāṃ bhikṣūn āmantrayati kā nu yuṣmākaṃ bhikṣavaḥ saṃbahulānāṃ bhikṣūṇāṃ	niṣadya bhagavām bhikṣūn āmantrayati kā nu yuṣmākam bhikṣavaḥ saṃbahulānām bhikṣūṇām 
SA_K14_mavadsuu-19	Karīrikamaṇḍalavāṭe saṃniṣaṇṇānāṃ saṃnipatitānām antarākathā viprakṛtā kayā cāpi	karīrika maṇḍala vāṭe saṃniṣaṇṇānām saṃnipatitānām antarākathā viprakṛtā kayā ca api 
SA_K14_mavadsuu-20	kathayaitarhi sanniṣaṇṇāḥ saṃnipatitāḥ	kathaya etarhi sanniṣaṇṇāḥ saṃnipatitāḥ 
SA_K14_mavadsuu-21	ihāsmākaṃ bhadanta saṃbahulānāṃ bhikṣūṇāṃ Karīrikamaṇḍalavāṭe saṃniṣaṇṇānāṃ saṃnipatitānām	iha asmākam bhadanta saṃbahulānām bhikṣūṇām karīrika maṇḍalavāṭe saṃniṣaṇṇānām saṃnipatitānām 
SA_K14_mavadsuu-22	ayam evaṃrūpo 'bhūd antarākathāsamudāhāraḥ āścaryam āyuṣmaṃto yāvac ca bhagavataḥ	ayam evaṃrūpaḥ bhūt antarākathā samudāhāraḥ āścaryam āyuṣmaṃtaḥ yāvat ca bhagavataḥ 
SA_K14_mavadsuu-23	atīteṣu samyaksaṃbuddheṣu atītāṃśabhāvagateṣu chinnavartmasu chinnapuṭeṣu niṣprapañceṣu	atīteṣu samyaksaṃbuddheṣu atīta aṃśa bhāva gateṣu chinna vartmasu chinna puṭeṣu niṣprapañceṣu 
SA_K14_mavadsuu-24	prapañcātīteṣu parinirvṛteṣu kāruṇikeṣu nirāśiṣeṣu evaṃ samyak pratyātmaṃ jñānadarśanaṃ	prapañca atīteṣu parinirvṛteṣu kāruṇikeṣu nirāśiṣeṣu evam samyak pratyātmam jñāna darśanam 
SA_K14_mavadsuu-25	pravartate evaṃśīlā bata te buddhā bhagavanto babhūvur ity api evaṃdharmāṇa evaṃprajñā	pravartate evaṃśīlāḥ bata te buddhāḥ bhagavantaḥ babhūvuḥ iti api evam dharmāṇaḥ evaṃprajñā 
SA_K14_mavadsuu-26	evamabhijñā evaṃvimuktaya evaṃvihāriṇo bata te buddhā bhagavanto babhūvur ity api /	evam abhijñāḥ evam vimuktayaḥ evam vihāriṇaḥ bata te buddhāḥ bhagavantaḥ babhūvuḥ iti api 
SA_K14_mavadsuu-27	kiṃ nu bhagavato dharmadhātuḥ supratividdha āho svid devatā ārocayaṃti yena (MAV 34)	kim nu bhagavataḥ dharmadhātuḥ su pratividdhaḥ āho svid devatāḥ ārocayanti yena 
SA_K14_mavadsuu-28	tathāgatasyātīteṣu samyaksaṃbuddheṣu atītāṃśabhāvagateṣu chinnavartmasu chinnapuṭeṣu	tathāgatasya atīteṣu samyaksaṃbuddheṣu atīta aṃśa bhāva gateṣu chinna vartmasu chinna puṭeṣu 
SA_K14_mavadsuu-29	niṣprapañceṣu prapañcātīteṣu parinirvṛteṣu kāruṇikeṣu nirāśiṣeṣu evaṃ samyak pratyātmaṃ	niṣprapañceṣu prapañca atīteṣu parinirvṛteṣu kāruṇikeṣu nirāśiṣeṣu evam samyak pratyātmam 
SA_K14_mavadsuu-30	jñānadarśanaṃ pravartate evaṃśīlā bata te buddhā bhagavanto babhūvur ity api evaṃdharmāṇa	jñāna darśanam pravartate evaṃśīlāḥ bata te buddhāḥ bhagavantaḥ babhūvuḥ iti api evaṃdharmāṇaḥ 
SA_K14_mavadsuu-31	evaṃprajñā evamabhijñā evaṃvimuktaya evaṃvihāriṇo bata te buddhā bhagavaṃto babhūvur ity api /	evaṃprajñāḥ evam abhijñāḥ evam vimuktayaḥ evam vihāriṇaḥ bata te buddhāḥ bhagavaṃtaḥ babhūvuḥ iti api 
SA_K14_mavadsuu-32	iyam asmākaṃ bhadaṃta saṃbahulānāṃ bhiksūṇāṃ Karīrikamaṇḍalavāṭe saṃniṣaṃṇānāṃ saṃnipatitānām	iyam asmākam bhadaṃta saṃbahulānām bhiksūṇām karīrika maṇḍalavāṭe saṃniṣaṃṇānām saṃnipatitānām 
SA_K14_mavadsuu-33	antarākathā viprakṛtā tayā cāpi bhagavan kathayā etarhi saṃniṣaṃṇāḥ saṃnipatitā api	antarākathā viprakṛtā tayā ca api bhagavan kathayā etarhi saṃniṣaṃṇāḥ saṃnipatitāḥ api 
SA_K14_mavadsuu-34	me bhikṣavo dharmadhātuḥ supratividdha api me devatā ārocayanti iyam atra dharmatā	me bhikṣavaḥ dharmadhātuḥ su pratividdha api me devatāḥ ārocayanti iyam atra dharmatā 
SA_K14_mavadsuu-35	tasmād idam ucyate //	tasmāt idam ucyate 
SA_K14_mavadsuu-36	pūrvaṃ kathā dhārmikī arthasaṃhitā	pūrvam kathā dhārmikī artha saṃhitā 
SA_K14_mavadsuu-37	udāhṛtā maṇḍalavāṭabhikṣubhiḥ	udāhṛtāḥ maṇḍala vāṭa bhikṣubhiḥ 
SA_K14_mavadsuu-38	aśrauṣīd divyena hi śrotradhātunā	aśrauṣīt divyena hi śrotra dhātunā 
SA_K14_mavadsuu-39	divāvihāropagato mahāmuniḥ 1	divāvihāra upagataḥ mahā muniḥ 
SA_K14_mavadsuu-40	divyena śrotreṇa niśāmya śāstā	divyena śrotreṇa niśāmya śāstā 
SA_K14_mavadsuu-41	upāgato maṇḍalavāṭabhikṣūn	upāgataḥ maṇḍala vāṭa bhikṣūn 
SA_K14_mavadsuu-42	nyaṣīdat sa hi bhikṣugaṇasya madhye	nyaṣīdat sa hi bhikṣu gaṇasya madhye 
SA_K14_mavadsuu-43	Śakro yathendras tridaśeṣu madhye 2	śakraḥ yathā indraḥ tridaśeṣu madhye 
SA_K14_mavadsuu-44	pratividdho dharmadhātur buddhenādityabandhunā /	pratividdhaḥ dharmadhātuḥ buddhena ādityabandhunā 
SA_K14_mavadsuu-45	yenābhyatītāṃ jānāti saṃbuddhāṃ dvipadottamaḥ 3	yena abhyatītām jānāti saṃbuddhām dvipada uttamaḥ 
SA_K14_mavadsuu-46	evaṃnāmā evaṃjātyā evaṃgotrāś ca te 'bhavan	evaṃnāmāḥ evaṃjātyāḥ evaṃgotrāḥ ca te bhavan 
SA_K14_mavadsuu-47	yathā yathā ca te āsaṃ sarve vyākṛtavāṃ muniḥ 4	yathā yathā ca te āsam sarve vyākṛtavān muniḥ 
SA_K14_mavadsuu-48	nānādīrghāyuṣo devā varṇavanto yaśasvinaḥ	nānā dīrgha āyuṣaḥ devāḥ varṇavantaḥ yaśasvinaḥ 
SA_K14_mavadsuu-49	evam ārocayaṃty arthaṃ saṃbuddhānāṃ yaśasvinām 5 //	evam ārocayaṃti artham saṃbuddhānām yaśasvinām 
SA_K14_mavadsuu-50	II. How was the Dharmadhātu Realized?	ii how was the dharmadhātu realized 
SA_K14_mavadsuu-51	kathaṃ dharmadhātuḥ supratividdhaḥ	katham dharmadhātuḥ su pratividdhaḥ 
SA_K14_mavadsuu-52	A. The Characteristics of the Seven Buddhas	the characteristics of the seven buddhas 
SA_K14_mavadsuu-53	1. Kalpa	kalpa 
SA_K14_mavadsuu-54	itaḥ sa ekanavataḥ kalpo yasmiṃ kalpe Vipaśyī samyaksaṃbuddho loke utpannaḥ itaḥ	itas saḥ ekanavataḥ kalpaḥ yasmin kalpe vipaśyī samyaksaṃbuddhaḥ loke utpannaḥ itas 
SA_K14_mavadsuu-55	sa ekatriṃśattamaḥ kalpo yasmiṃ kalpe Śikhī ca Viśvabhuk ca samyaksaṃbuddhau loka	saḥ ekatriṃśattamaḥ kalpaḥ yasmin kalpe śikhī ca viśvabhuj ca samyaksaṃbuddhau loka 
SA_K14_mavadsuu-56	utpannau asminn eva Bhadrakalpe catvāraḥ samyaksaṃbuddhā loke utpannā Krakasundaḥ	utpannau asmin eva bhadra kalpe catvāraḥ samyaksaṃbuddhāḥ loke utpannā krakasundaḥ 
SA_K14_mavadsuu-57	Kanakamuniḥ Kāśyapo vayaṃ cāpy etarhi Śākyamuniḥ iyam atra dharmatā tasmād idam ucyate //	kanakamuniḥ kāśyapaḥ vayam ca api etarhi śākyamuniḥ iyam atra dharmatā tasmāt idam ucyate 
SA_K14_mavadsuu-58	X kaś ca kalpo ^ ^ _ ^ _ X	kaḥ ca 
SA_K14_mavadsuu-59	yadā Vipaśyī udapādi _ X /	yadā vipaśyī udapādi 
SA_K14_mavadsuu-60	Viśvabhujaṃ _ ^ ^ _ ^ _ X	viśva bhujam 
SA_K14_mavadsuu-61	vināyakāḥ Krakasund ^ _ X /	vināyakāḥ krakasund 
SA_K14_mavadsuu-62	2. Life Span	life span 
SA_K14_mavadsuu-63	Vipaśyinaḥ samyaksaṃbuddhasya aśītir varṣasahasrāṇy āyuṣpramāṇam abhūt Śikhinaḥ samyaksaṃbuddhasya	vipaśyinaḥ samyaksaṃbuddhasya aśītiḥ varṣa sahasrāṇi āyuṣpramāṇam abhūt śikhinaḥ samyaksaṃbuddhasya 
SA_K14_mavadsuu-64	saptatiḥ Viśvabhujaḥ samyaksaṃbuddhasya ṣaṣṭiḥ Krakasundasya samyaksaṃbuddhasya catvāriṅśat	saptatiḥ viśvabhujaḥ samyaksaṃbuddhasya ṣaṣṭiḥ krakasundasya samyaksaṃbuddhasya catvāriṅśat 
SA_K14_mavadsuu-65	Kanakamuneḥ samyaksaṃbuddhasya triṅśat Kāśyapasya samyaksaṃbuddhasya viṃśatiḥ asmākam	kanakamuneḥ samyaksaṃbuddhasya triṅśat kāśyapasya samyaksaṃbuddhasya viṃśatiḥ asmākam 
SA_K14_mavadsuu-66	apy etarhi varṣaśatam āyuṣpramāṇaṃ samyaksukhena paripriyamāṇam iyam atra dharmatā	api etarhi varṣa śatam āyuṣpramāṇam samyak sukhena paripriyamāṇam iyam atra dharmatā 
SA_K14_mavadsuu-67	tasmād idam ucyate //	tasmāt idam ucyate 
SA_K14_mavadsuu-68	X _ ^ _ _ ^ ^ _ sa _ X	ro-0 di-1 xc-1
SA_K14_mavadsuu-69	X _ ^ _ Viśvabhujo jinasya 1	ro   jinasya 
SA_K14_mavadsuu-70	catvāriṃśat Krakasundasya śāstuḥ	catvāriṃśat krakasundasya śāstuḥ 
SA_K14_mavadsuu-71	X _ ^ _ Śākyamuni ^ _ X 2 //	ro-0 co-0 
SA_K14_mavadsuu-72	3. Caste	cas te 
SA_K14_mavadsuu-73	Vipaśyī samyaksaṃbuddhaḥ kṣatriyo jātyābhūt Śikhī samyaksaṃbuddhaḥ kṣatriyo jātyābhūd Viśvabhuk ca /	vipaśyī samyaksaṃbuddhaḥ kṣatriyaḥ jātyā abhūt śikhī samyaksaṃbuddhaḥ kṣatriyaḥ jātyā abhūt viśva bhuj ca 
SA_K14_mavadsuu-74	Krakasundaḥ samyaksaṃbuddho brāhmaṇo jātyābhūt Kanakamuniḥ Kāśyapaś ca /	krakasundaḥ samyaksaṃbuddhaḥ brāhmaṇaḥ jātyā abhūt kanakamuniḥ kāśyapaḥ ca 
SA_K14_mavadsuu-75	asmākam apy etarhi kṣatriyā jātir bhavati iyam atra dharmatā tasmād idam ucyate //	asmākam api etarhi kṣatriyā jātiḥ bhavati iyam atra dharmatā tasmāt idam ucyate 
SA_K14_mavadsuu-76	X _ ^ _ _ ^ babhūva kṣatriyāḥ	       babhūva   
SA_K14_mavadsuu-77	X _ ^ _ Kanakamuniś ca Kāśyapa	ro kanakamuniḥ ca kāśyapa 
SA_K14_mavadsuu-78	et'; ekajāty. ^ ^ _ ^ _ ^ X 1	e t ekajātī 
SA_K14_mavadsuu-79	X yā ^ _ _ ^ ^ _ ^ kalpāṃ	x 
SA_K14_mavadsuu-80	niṣkrāntavāṃ Cchākyakulāc ca kṣatriyāt 2 //	niṣkrāntavān śākya kulāt ca kṣatriyāt 
SA_K14_mavadsuu-81	4. Family Name	family name 
SA_K14_mavadsuu-82	Sanskrit text is completely lost	sanskrit text is completely lost 
SA_K14_mavadsuu-83	5. Bodhi Trees	bodhi trees 
SA_K14_mavadsuu-84	Sanskrit text is completely lost	sanskrit text is completely lost 
SA_K14_mavadsuu-85	6. The Aśembly of Bhikṣus	the aśembly of bhikṣus 
SA_K14_mavadsuu-86	Vipaśyinaḥ samyaksaṃbuddhasya śrāvakāṇāṃ trayo mahāsannipātā babhūvuḥ eko mahāsannipāto dvāṣaṣṭabhikṣuśatasahasrāṇi /	vipaśyinaḥ samyaksaṃbuddhasya śrāvakāṇām trayaḥ mahā sannipātāḥ babhūvuḥ ekaḥ mahā sannipātaḥ dvāṣaṣṭa bhikṣu śata sahasrāṇi 
SA_K14_mavadsuu-87	dvitīyo mahāsannipāto bhikṣuśatasahasram tṛtīyo mahāsannipāto 'śītir bhikṣusahasrāṇi /	dvitīyaḥ mahā sannipātaḥ bhikṣu śata sahasram tṛtīyaḥ mahā sannipātaḥ śītiḥ bhikṣu sahasrāṇi 
SA_K14_mavadsuu-88	Śikhinaḥ samyaksaṃbuddhasya śrāvakāṇāṃ trayo mahāsannipātā babhūvuḥ eko mahāsannipāto bhikṣuśatasahasram dvitīyo mahāsannipāto 'śītir bhikṣusahasrāṇi	śikhinaḥ samyaksaṃbuddhasya śrāvakāṇām trayaḥ mahā sannipātāḥ babhūvuḥ ekaḥ mahā sannipātaḥ bhikṣu śata sahasram dvitīyaḥ mahā sannipātaḥ śītiḥ bhikṣu sahasrāṇi 
SA_K14_mavadsuu-89	tṛtīyo mahāsannipātaḥ saptatir bhikṣusahasrāṇi /	tṛtīyaḥ mahā sannipātaḥ saptatiḥ bhikṣu sahasrāṇi 
SA_K14_mavadsuu-90	Viśvabhujaḥ samyaksaṃbuddhasya śrāvakāṇāṃ dvau mahāsannipātau babhūvatu eko mahāsannipātaḥ saptatir bhikṣusahasrāṇi /	viśvabhujaḥ samyaksaṃbuddhasya śrāvakāṇām dvau mahā sannipātau babhūvatu ekaḥ mahā sannipātaḥ saptatiḥ bhikṣu sahasrāṇi 
SA_K14_mavadsuu-91	dvitīyo mahāsannipāta ṣaṣṭir bhikṣusahasrāṇi /	dvitīyaḥ mahā sannipāta ṣaṣṭiḥ bhikṣu sahasrāṇi 
SA_K14_mavadsuu-92	Krakasundasya samyaksaṃbuddhasya śrāvakānām eko mahāsannipāto babhūva catvāriṃśad bhikṣusahasrāṇi /	krakasundasya samyaksaṃbuddhasya śrāvakānām ekaḥ mahā sannipātaḥ babhūva catvāriṃśat bhikṣu sahasrāṇi 
SA_K14_mavadsuu-93	Kanakamuneḥ samyaksaṃbuddhasya śrāvakānām eko mahāsaṃnipāto babhūva triṃśad bhikṣusahasrāṇi /	kanakamuneḥ samyaksaṃbuddhasya śrāvakānām ekaḥ mahā saṃnipātaḥ babhūva triṃśat bhikṣu sahasrāṇi 
SA_K14_mavadsuu-94	Kāśyapasya samyaksaṃbuddhasya śrāvakānām eko mahāsannipāto babhūva viṅśatir bhikṣusahasrāṇi /	kāśyapasya samyaksaṃbuddhasya śrāvakānām ekaḥ mahā sannipātaḥ babhūva viṅśatiḥ bhikṣu sahasrāṇi 
SA_K14_mavadsuu-95	asmākam apy etarhi (MAV 42)	asmākam api etarhi mau 
SA_K14_mavadsuu-96	śrāvakānām eko mahāsaṃnipāta ardhatrayodaśa bhikṣuśatāni iyam atra dharmatā tasmād idam ucyate //	śrāvakānām ekaḥ mahā saṃnipāta ardha trayodaśa bhikṣu śatāni iyam atra dharmatā tasmāt idam ucyate 
SA_K14_mavadsuu-97	trayo Vipaśyisya trayaḥ Śikhino	trayaḥ vipaśyisya trayaḥ śikhinaḥ 
SA_K14_mavadsuu-98	X _ ^ _ Viśvabhujo jinasya /	ro   jinasya 
SA_K14_mavadsuu-99	caturṇāṃ buddhānām ekaikaśa	caturṇām buddhānām ekaikaśas 
SA_K14_mavadsuu-100	ṛṣisannipātā muninā prakāśitā 1	ṛṣi sannipātā muninā prakāśitā 
SA_K14_mavadsuu-101	te saṃnipātā paramārthadarśinān	te saṃnipātā parama artha darśinān 
SA_K14_mavadsuu-102	nāgeṣu nāge ^ ^ _ ^ _ ^ X /	nāgeṣu nāge 
SA_K14_mavadsuu-103	saṃghādikānām akhilānāṃ tāyināṃ	saṃgha ādikānām akhilānām tāyinām 
SA_K14_mavadsuu-104	pannadhvajānāṃ virajasām ṛjūnām 2 //	panna dhvajānām virajasām ṛjūnām 
SA_K14_mavadsuu-105	7. A Pair of Disciples	a pair of disciples
SA_K14_mavadsuu-106	Vipaśyinaḥ samyaksaṃbuddhasya Khaṇḍaś ca Tiṣyaś ca śrāvakayugam abhūd agrayugaṃ bhadrayugam	vipaśyinaḥ samyaksaṃbuddhasya khaṇḍaḥ ca tiṣyaḥ ca śrāvaka yugam abhūt agra yugam bhadra yugam 
SA_K14_mavadsuu-107	eko 'grya ṛddhimatāṃ dvitīyo 'grya prajñāvatām Śikhinaḥ samyaksaṃbuddhasya Abhibhūḥ	ekaḥ grya ṛddhimatām dvitīyaḥ grya prajñāvatām śikhinaḥ samyaksaṃbuddhasya abhibhūḥ 
SA_K14_mavadsuu-108	Saṃbhavaś ca śrāvakayugam abhūd agrayugaṃ bhadrayugam eko 'grya ṛddhimatāṃ dvitīyo	saṃbhavaḥ ca śrāvaka yugam abhūt agra yugam bhadra yugam ekaḥ gryaḥ ṛddhimatām dvitīyaḥ 
SA_K14_mavadsuu-109	'grya prajñāvatām Viśvabhujaḥ samyaksaṃbuddhasya Śroṇaś ca Uttaraś ca śrāvakayugam	grya prajñāvatām viśvabhujaḥ samyaksaṃbuddhasya śroṇaḥ ca uttaraḥ ca śrāvaka yugam 
SA_K14_mavadsuu-110	abhūd agrayugaṃ bhadrayugam eko 'grya ṛddhimatāṃ dvitīyo 'gryaḥ prajñāvatām Krakasundasya	abhūt agra yugam bhadra yugam ekaḥ gryaḥ ṛddhimatām dvitīyaḥ gryaḥ prajñāvatām krakasundasya 
SA_K14_mavadsuu-111	samyaksaṃbuddhasya Saṃjīvaś ca Viduraś ca śrāvakayugam abhūd agrayugaṃ bhadrayugam	samyaksaṃbuddhasya saṃjīvaḥ ca viduraḥ ca śrāvaka yugam abhūt agra yugam bhadra yugam 
SA_K14_mavadsuu-112	eko 'grya ṛddhimatāṃ dvitīyo 'gryaḥ prajñāvatām Kanakamuneḥ samyaksaṃbuddhasya Bhujiṣyaś	ekaḥ gryaḥ ṛddhimatām dvitīyaḥ gryaḥ prajñāvatām kanakamuneḥ samyaksaṃbuddhasya bhujiṣyaḥ 
SA_K14_mavadsuu-113	ca bhikṣur Uttaraś ca śrāvakayugam abhūd agrayugaṃ bhadrayugam eko 'grya ṛddhimatāṃ	ca bhikṣuḥ uttaraḥ ca śrāvaka yugam abhūt agra yugam bhadra yugam ekaḥ gryaḥ ṛddhimatām 
SA_K14_mavadsuu-114	dvitīyo 'grya prajñāvatām Kāśyapasya samyaksaṃbuddhasya Tiṣyaś ca Bharadvājaś ca	dvitīyaḥ grya prajñāvatām kāśyapasya samyaksaṃbuddhasya tiṣyaḥ ca bharadvājaḥ ca 
SA_K14_mavadsuu-115	śrāvakayugam abhūd agrayugaṃ bhadrayugam eko 'grya ṛddhimatāṃ dvitīyo 'grya prajñāvatām	śrāvaka yugam abhūt agra yugam bhadra yugam ekaḥ grya ṛddhimatām dvitīyaḥ grya prajñāvatām 
SA_K14_mavadsuu-116	asmākam apy etarhi ŚāriputraMaudgalyāyanau bhikṣū agrayugaṃ bhadrayugam eko 'grya	asmākam api etarhi śāriputra maudgalyāyanau bhikṣū agra yugam bhadra yugam ekaḥ grya 
SA_K14_mavadsuu-117	ṛddhimatāṃ dvitīyo 'grya prajñāvatām iyam atra dharmatā tasmād idam ucyate //	ṛddhimatām dvitīyaḥ grya prajñāvatām iyam atra dharmatā tasmāt idam ucyate 
SA_K14_mavadsuu-118	Khaṇḍaś ca Tiṣyaś ca Vipaśyino 'gryau	khaṇḍaḥ ca tiṣyaḥ ca vipaśyinaḥ gryau 
SA_K14_mavadsuu-119	Śikhino buddhasyābhibhūḥ Saṃbhavaś ca /	śikhinaḥ buddhasya abhibhūḥ saṃbhavaḥ ca 
SA_K14_mavadsuu-120	Śroṇottarau Viśvabhujo jinasya	śroṇa uttarau viśva bhujaḥ jinasya 
SA_K14_mavadsuu-121	oghātigau kāmabhaveṣv asaktau 1	ogha atigau kāma bhaveṣu asaktau 
SA_K14_mavadsuu-122	Saṃjīvabhikṣur Viduraś ca paṇḍitaḥ	saṃjīva bhikṣuḥ viduraḥ ca paṇḍitaḥ 
SA_K14_mavadsuu-123	agryāv etau Krakasundasya śāstu /	agryau etau krakasundasya śāstu 
SA_K14_mavadsuu-124	buddhasya ca Kanakamuner ihāgryau	buddhasya ca kanakamuneḥ iha agryau 
SA_K14_mavadsuu-125	Bhujiṣyo bhikṣur athottaraś ca 2	bhujiṣyaḥ bhikṣuḥ atha uttaraḥ ca 
SA_K14_mavadsuu-126	TiṣyaBharadvājayugaṃ maharṣer	tiṣya bharadvāja yugam mahā ṛṣeḥ 
SA_K14_mavadsuu-127	etāv agryau bhagavataḥ Kāśyapasya /	etau agryau bhagavataḥ kāśyapasya 
SA_K14_mavadsuu-128	ŚāriputraMaudgalyāyanau bhikṣū	śāriputra maudgalyāyanau bhikṣū 
SA_K14_mavadsuu-129	tāv etāv Aṅgiraso 'graśrāvakau 3 //	tau etau aṅgirasaḥ graśrāvakau  /
SA_K14_mavadsuu-130	8. Attendants	attendants 
SA_K14_mavadsuu-131	Vipaśyinaḥ samyaksaṃbuddhasya Aśoko nāma bhikṣur upasthāyako 'bhūt Śikhinaḥ samyaksaṃbuddhasya	vipaśyinaḥ samyaksaṃbuddhasya aśokaḥ nāma bhikṣuḥ upasthāyakaḥ bhūt śikhinaḥ samyaksaṃbuddhasya 
SA_K14_mavadsuu-132	Kṣemakāro nāma bhikṣur upasthāyako 'bhūt Viśvabhujaḥ samyaksaṃbuddhasya Upaśānto	kṣemakāraḥ nāma bhikṣuḥ upasthāyakaḥ bhūt viśvabhujaḥ samyaksaṃbuddhasya upaśāntaḥ 
SA_K14_mavadsuu-133	nāma bhikṣur upasthāyako 'bhūt Krakasundasya samyaksaṃbuddhasya Bhadriko nāma bhikṣur	nāma bhikṣuḥ upasthāyakaḥ bhūt krakasundasya samyaksaṃbuddhasya bhadrikaḥ nāma bhikṣuḥ 
SA_K14_mavadsuu-134	upasthāyako 'bhūt Kanakamuneḥ samyaksaṃbuddhasya Svastiko nāma bhikṣur upasthāyako	upasthāyakaḥ bhūt kanakamuneḥ samyaksaṃbuddhasya svastikaḥ nāma bhikṣuḥ upasthāyakaḥ 
SA_K14_mavadsuu-135	'bhūt Kāśyapasya samyaksaṃbuddhasya Sarvamitro nāma bhikṣur upasthāyako 'bhūt asmākam	bhūt kāśyapasya samyaksaṃbuddhasya sarvamitraḥ nāma bhikṣuḥ upasthāyakaḥ bhūt asmākam 
SA_K14_mavadsuu-136	apy etarhi Ānando bhikṣur upasthāyakaḥ iyam atra dharmatā tasmād idam ucyate //	api etarhi ānandaḥ bhikṣuḥ upasthāyakaḥ iyam atra dharmatā tasmāt idam ucyate 
SA_K14_mavadsuu-137	Aśoka Kṣemakāraś ca Upaśāntaś ca Bhadrikaḥ	aśoka kṣemakāraḥ ca upaśāntaḥ ca bhadrikaḥ 
SA_K14_mavadsuu-138	SvastikaḥSarvamitraś ca Ānando bhavati saptamaḥ 1	svastikaḥ sarva mitraḥ ca ānandaḥ bhavati saptamaḥ 
SA_K14_mavadsuu-139	bhikṣava ete mahātmānaḥ śarīrāntimadhāriṇaḥ	bhikṣavaḥ ete mahātmānaḥ śarīra antima dhāriṇaḥ 
SA_K14_mavadsuu-140	vaiyyāpatyakarā āsaṃ cittanimitteṣu kovidā 2	vaiyyāpatya karā āsam citta nimitteṣu kovidā 
SA_K14_mavadsuu-141	sarve kālasya kuśalā nimittaprativedhinaḥ	sarve kālasya kuśalāḥ nimitta prativedhinaḥ 
SA_K14_mavadsuu-142	sarveṣām āsravā kṣīṇā nāsti teṣāṃ punarbhavaḥ 3 //	sarveṣām āsravā kṣīṇā na asti teṣām punarbhavaḥ 
SA_K14_mavadsuu-143	9. Sons	sons 
SA_K14_mavadsuu-144	Vipaśyinaḥ samyaksaṃbuddhasya Susaṃvṛttaskandho nāma putro 'bhūt Śikhinaḥ samyaksaṃbuddhasya	vipaśyinaḥ samyaksaṃbuddhasya susaṃvṛttaskandhaḥ nāma putraḥ bhūt śikhinaḥ samyaksaṃbuddhasya 
SA_K14_mavadsuu-145	Atulo nāma putro 'bhūt Viśvabhujaḥ samyaksaṃbuddhasya Suprabuddho nāma putro 'bhūt	atulaḥ nāma putraḥ bhūt viśvabhujaḥ samyaksaṃbuddhasya suprabuddhaḥ nāma putraḥ bhūt 
SA_K14_mavadsuu-146	Krakasundasya samyaksaṃbuddhasya Pratāpano nāma putro 'bhūt Kanakamuneḥ samyaksaṃbuddhasya	krakasundasya samyaksaṃbuddhasya pratāpanaḥ nāma putraḥ bhūt kanakamuneḥ samyaksaṃbuddhasya 
SA_K14_mavadsuu-147	Sārthavāho nāma putro 'bhūt Kāśyapasya samyaksaṃbuddhasya Vijitaseno nāma putro 'bhūt	sārthavāhaḥ nāma putraḥ bhūt kāśyapasya samyaksaṃbuddhasya vijitasenaḥ nāma putraḥ bhūt 
SA_K14_mavadsuu-148	asmākam apy etarhi Rāhula putra iyam atra dharmatā tasmād idam ucyate //	asmākam api etarhi rāhula putra iyam atra dharmatā tasmāt idam ucyate 
SA_K14_mavadsuu-149	Susaṃvṛttaskandho 'tula Suprabuddha Pratāpanaḥ	su saṃvṛtta skandhaḥ su prabuddha pratāpanaḥ 
SA_K14_mavadsuu-150	Sārthavāho Vijitaseno Rāhulo bhavati saptama 1	sārthavāhaḥ vijita senaḥ rāhulaḥ bhavati saptama 
SA_K14_mavadsuu-151	ete putrā mahātmānaḥ śarīrāntimadhāriṇaḥ	ete putrāḥ mahātmānaḥ śarīra antima dhāriṇaḥ 
SA_K14_mavadsuu-152	sarveṣām āsravā kṣīṇā nāsti teṣāṃ punarbhava 2 //	sarveṣām āsravā kṣīṇā na asti teṣām punarbhava 
SA_K14_mavadsuu-153	10. Mother, Father,	motheḥ fatheḥ 
SA_K14_mavadsuu-154	King and the Capital	king and the capital 
SA_K14_mavadsuu-155	Vipaśyinaḥ samyaksaṃbuddhasya pitābhūd Bandhumo nāma rājā kṣatriyo mūrdhābhiṣikto	vipaśyinaḥ samyaksaṃbuddhasya pitā abhūt bandhumaḥ nāma rājā kṣatriyaḥ mūrdhābhiṣiktaḥ 
SA_K14_mavadsuu-156	mātābhūd Bandhuvatī nāma Bandhumāvatī nāma nagarī rājadhānī babhūva ṛddhā ca sphītā	mātā abhūt bandhuvatī nāma bandhumāvatī nāma nagarī rājadhānī babhūva ṛddhā ca sphītā 
SA_K14_mavadsuu-157	ca kṣemā ca subhikṣā cākīrṇabahujanamanuṣyā ca /	ca kṣemā ca subhikṣā ca ākīrṇa bahu jana manuṣyā ca 
SA_K14_mavadsuu-158	Śikhinaḥ samyaksaṃbuddhasya pitābhūd Aruṇo nāma rājā kṣatriyo mūrdhābhiṣikta mātābhūt Prabhāvatī nāma /	śikhinaḥ samyaksaṃbuddhasya pitā abhūt aruṇaḥ nāma rājā kṣatriyaḥ mūrdhābhiṣikta mātā abhūt prabhāvatī nāma 
SA_K14_mavadsuu-159	Aruṇāvatī nāma nagarī rājadhānī babhūva /	aruṇāvatī nāma nagarī rājadhānī babhūva 
SA_K14_mavadsuu-160	ṛddhā ca pūrvavat Viśvabhujaḥ samyaksaṃbuddhasya pitābhūt Supradīpo nāma rājā kṣatriyo	ṛddhā ca pūrvavat viśvabhujaḥ samyaksaṃbuddhasya pitā abhūt supradīpaḥ nāma rājā kṣatriyaḥ 
SA_K14_mavadsuu-161	mūrdhābhiṣiktaḥ mātābhūd Uttarā nāma Anopamā nāma nagarī rājadhānī babhūva pūrvavat	mūrdhābhiṣiktaḥ mātā abhūt uttarā nāma anopamā nāma nagarī rājadhānī babhūva pūrvavat 
SA_K14_mavadsuu-162	Krakasundasya samyaksaṃbuddhasya pitābhūd Agnidatto nāma brāhmaṇaḥ purohitaḥ mātābhūd	krakasundasya samyaksaṃbuddhasya pitā abhūt agnidattaḥ nāma brāhmaṇaḥ purohitaḥ mātā abhūt 
SA_K14_mavadsuu-163	Dhanavatī nāma tena khalu samayena Kṣemo (MAV 48)	dhanavatī nāma tena khalu samayena 
SA_K14_mavadsuu-164	nāma rājābhūt Kṣemasya khalu rājñaḥ Kṣemāvatī nāma nagarī rājadhānī babhūva pūrvavat	nāma rājā abhūt kṣemasya khalu rājñaḥ kṣemāvatī nāma nagarī rājadhānī babhūva pūrvavat 
SA_K14_mavadsuu-165	Kanakamuneḥ samyaksaṃbuddhasya pitābhūd Yajñadatto nāma brāhmaṇaḥ purohitaḥ mātābhūd	kanakamuneḥ samyaksaṃbuddhasya pitā abhūt yajñadattaḥ nāma brāhmaṇaḥ purohitaḥ mātā abhūt 
SA_K14_mavadsuu-166	Yaśovatī nāma tena khalu samayena Śobho nāma rājābhūc Chobhasya khalu rājñaḥ Śobhavatī	yaśovatī nāma tena khalu samayena śobhaḥ nāma rājā abhūt śobhasya khalu rājñaḥ śobhavatī 
SA_K14_mavadsuu-167	nāma nagarī rājadhānī babhūva pūrvavat Kāśyapasya samyaksaṃbuddhasya pitābhūd Brahmadatto	nāma nagarī rājadhānī babhūva pūrvavat kāśyapasya samyaksaṃbuddhasya pitā abhūt brahmadattaḥ 
SA_K14_mavadsuu-168	nāma brāhmaṇaḥ purohitaḥ mātābhūd Viśākhā nāma tena khalu samayena Kṛkī nāma rājābhūt	nāma brāhmaṇaḥ purohitaḥ mātā abhūt viśākhā nāma tena khalu samayena kṛkī nāma rājā abhūt 
SA_K14_mavadsuu-169	Kṛkiṇaḥ khalu rājño Bārāṇasī nāma nagarī rājadhānī babhūva pūrvavat asmākam apy etarhi	kṛkiṇaḥ khalu rājñaḥ bārāṇasī nāma nagarī rājadhānī babhūva pūrvavat asmākam api etarhi 
SA_K14_mavadsuu-170	pitā Śuddhodano nāma rājā kṣatriyo mūrdhābhiṣiktaḥ mātā Mahāmāyā nāma nagarī Kapilavastur	pitā śuddhodanaḥ nāma rājā kṣatriyaḥ mūrdhābhiṣiktaḥ mātā mahāmāyā nāma nagarī kapilavastuḥ 
SA_K14_mavadsuu-171	nāma rājadhānī ṛddhā ca sphītā ca kṣemā ca subhikṣā ca ākīrṇabahujanamanuṣyā ca Śākyānāṃ	nāma rājadhānī ṛddhā ca sphītā ca kṣemā ca subhikṣā ca ākīrṇa bahu jana manuṣyā ca śākyānām 
SA_K14_mavadsuu-172	gaṇarājyam iyam atra dharmatā tasmād idam ucyate //	gaṇa rājyam iyam atra dharmatā tasmāt idam ucyate 
SA_K14_mavadsuu-173	Vipaśyino buddhavarasya Bandhumā	vipaśyinaḥ buddha varasya bandhumā 
SA_K14_mavadsuu-174	pitābhavad Bandhuvatī ca mātā /	pitā abhavat bandhuvatī ca mātā 
SA_K14_mavadsuu-175	nagarī tathā Bandhumatī suramyā	nagarī tathā bandhumatī su ramyā 
SA_K14_mavadsuu-176	yatra jino dharmam adeśayac chivam 1	yatra jinaḥ dharmam adeśayat śivam 
SA_K14_mavadsuu-177	buddhasya Śikhinaḥ Aruṇaḥ pitābhūt	buddhasya śikhinaḥ aruṇaḥ pitā abhūt 
SA_K14_mavadsuu-178	Prabhāvatī mātā prabhākarasya /	prabhāvatī mātā prabhākarasya 
SA_K14_mavadsuu-179	nagarī tathāruṇavatī suramyā	nagarī tathā aruṇavatī su ramyā 
SA_K14_mavadsuu-180	Aruṇasya rājñaḥ paraśatrumardinaḥ 2	aruṇasya rājñaḥ para śatru mardinaḥ 
SA_K14_mavadsuu-181	yat Supradīpa udapādi kṣatriyaḥ	yat su pradīpaḥ udapādi kṣatriyaḥ 
SA_K14_mavadsuu-182	pitā abhūd Viśvabhujo jinasya /	pitā abhūt viśva bhujaḥ jinasya 
SA_K14_mavadsuu-183	mātā tathaivottara satyanāmā	mātā satyanāmā 
SA_K14_mavadsuu-184	Anopamā nagarī rājadhānī 3	anopamā nagarī rājadhānī 
SA_K14_mavadsuu-185	yad Agnidatta udapādi brāhmaṇaḥ	yat agnidattaḥ udapādi brāhmaṇaḥ 
SA_K14_mavadsuu-186	pitā abhūt Krakasundasya śāstuḥ	pitā abhūt krakasundasya śāstuḥ 
SA_K14_mavadsuu-187	mātāpi ca Dhanavatī satyanāmā	mātā api ca dhanavatī satyanāmā 
SA_K14_mavadsuu-188	Kṣemo rājā Kṣemāvatī rājadhānī 4	kṣemaḥ rājā kṣemāvatī rājadhānī 
SA_K14_mavadsuu-189	yad Yajñadatta udapādi brāhmaṇaḥ	yat yajñadattaḥ udapādi brāhmaṇaḥ 
SA_K14_mavadsuu-190	pitā abhūt Kanakamuner jinasya /	pitā abhūt kanakamuneḥ jinasya 
SA_K14_mavadsuu-191	mātāpi ca Yaśovatī satyanāmā	mātā api ca yaśovatī satyanāmā 
SA_K14_mavadsuu-192	Śobho rājā Śobhāvatī rājadhānī 5	śobhaḥ rājā śobhāvatī rājadhānī 
SA_K14_mavadsuu-193	yad Brahmadatta udapādi brāhmaṇaḥ	yat brahmadattaḥ udapādi brāhmaṇaḥ 
SA_K14_mavadsuu-194	pitā abhūd bhagavataḥ Kāśyapasya /	pitā abhūt bhagavataḥ kāśyapasya 
SA_K14_mavadsuu-195	mātāpi ca Viśākhā satyanāmā	mātā api ca viśākhā satyanāmā 
SA_K14_mavadsuu-196	Kṛkī rājā Bārāṇasī rājadhānī 6	kṛkī rājā bārāṇasī rājadhānī 
SA_K14_mavadsuu-197	Śuddhodano nāma pitā maharṣer	śuddhodanaḥ nāma pitā mahā ṛṣeḥ 
SA_K14_mavadsuu-198	mātā Mahāmāya prabhākarasya /	mātā mahāmāya prabhākarasya 
SA_K14_mavadsuu-199	nagarī tathā ṛddhā sphītā suramyā	nagarī tathā ṛddhā sphītā su ramyā 
SA_K14_mavadsuu-200	Kapilāhvayā yatra jino ^ _ te 7 //	kapila āhvayāḥ yatra te 
SA_K14_mavadsuu-201	11. Mnemonic Keywords of This Chapter	mnemonic keywords of this chapter 
SA_K14_mavadsuu-202	uddānam //	uddānam 
SA_K14_mavadsuu-203	kalpo 'tha āyur jātiś ca gotraṃ vṛkṣāś ca pañcamā /	kalpaḥ thaḥ āyuḥ jātiḥ ca gotram vṛkṣāḥ ca pañcamā 
SA_K14_mavadsuu-204	saṃnipāto yugam upasthāyakā putrā mātā pitā tathā //	saṃnipātaḥ yugam putrāḥ mātā pitā tathā 
SA_K14_mavadsuu-205	B. The Legend of Vipaśyin Buddha	the legend of vipaśyin buddha 
SA_K14_mavadsuu-206	Part One	part one 
SA_K14_mavadsuu-207	[The Bodhisattva's Entrance into His Mother's Womb]	the bodhisattvas entrance into his mothisattvas womb 
SA_K14_mavadsuu-208	1. Descent from Tuṣita Heaven	descent from tuṣita heaven 
SA_K14_mavadsuu-209	dharmatā khalu yasmiṃ samaye Vipaśyī bodhisatvas Tuṣitād devanikāyāc cyavitvā mātuḥ	dharmatā khalu yasmin samaye vipaśyī bodhisatvaḥ tuṣitāt devanikāyāt cyavitvā mātuḥ 
SA_K14_mavadsuu-210	kukṣāv avakrāmati atyarthaṃ tasmiṃ samaye mahāpṛthivīcālaś cābhūt sarvaś cāyaṃ loka	kukṣau avakrāmati atyartham tasmin samaye mahā pṛthivīcālaḥ ca abhūt sarvaḥ ca ayam loka 
SA_K14_mavadsuu-211	udāreṇāvabhāsena sphuṭo 'bhūt yā api tā lokasya lokāntarikā andhastamā andhākāratamisrā	udāreṇa avabhāsena sphuṭaḥ bhūt yāḥ api tāḥ lokasya loka āntarikāḥ andhastamāḥ andha ākāra tamisrā 
SA_K14_mavadsuu-212	yatremau sūryācandramasāv evaṃmahardhikau mahānubhāvau ābhayā ābhāṃ nānubhavataḥ	yatra imau sūryācandramasau evaṃmahardhikau mahā anubhāvau ābhayā ābhām na anubhavataḥ 
SA_K14_mavadsuu-213	tā api tasmiṃ samaye udāreṇāvabhāsena sphuṭā abhūvaṃ tatra ye satvā upapannās te	tāḥ api tasmin samaye udāreṇa avabhāsena sphuṭāḥ abhūvam tatra ye satvāḥ upapannāḥ te 
SA_K14_mavadsuu-214	tayā ābhayā anyonyaṃ satvaṃ saṃjānate anye 'pi bhavaṃtaḥ satvā ihopapannā anye 'pi	tayā ābhayā anyonyam satvam saṃjānate anye pi bhavantaḥ satvāḥ iha upapannāḥ anye pi 
SA_K14_mavadsuu-215	bhavaṃtaḥ satvā ihopapannā iyam atra dharmatā tasmād idam ucyate //	bhavantaḥ satvāḥ iha upapannāḥ iyam atra dharmatā tasmāt idam ucyate 
SA_K14_mavadsuu-216	yathāpi megho vipulaḥ susaṃbhṛto	yathā api meghaḥ vipulaḥ su saṃbhṛtaḥ 
SA_K14_mavadsuu-217	bahūdako mārutavegamūrcchitaḥ	bahu udakaḥ māruta vega mūrcchitaḥ 
SA_K14_mavadsuu-218	tathopamaṃ kukṣim avākramaṃ muniḥ	tathā upamam kukṣim avākramam muniḥ 
SA_K14_mavadsuu-219	śatahradāṃ sūrya ivābhyupāgataḥ 1	śatahradām sūryaḥ iva abhyupāgataḥ 
SA_K14_mavadsuu-220	avabhāsayaṃ hi janatās samantataḥ	avabhāsayam hi janatāḥ samantataḥ 
SA_K14_mavadsuu-221	pṛthūś ca lokāntarikās tamovṛtāḥ	pṛthūḥ ca loka āntarikāḥ tamaḥ vṛtāḥ 
SA_K14_mavadsuu-222	yad utkramet kukṣim asahyasannibhas	yat utkramet kukṣim asahya sannibhaḥ 
SA_K14_mavadsuu-223	tathā tad āsīd iyam atra dharmatā 2 //	tathā tat āsīt iyam atra dharmatā 
SA_K14_mavadsuu-224	[In His Mother's Womb]	in his mothers womb 
SA_K14_mavadsuu-225	2. The Four Devaputras	the four devaputras 
SA_K14_mavadsuu-226	dharmatā khalu yasmiṃ samaye Vipaśyī bodhisatvas Tuṣitād devanikāyāc cyavitvā mātuḥ	dharmatā khalu yasmin samaye vipaśyī bodhisatvaḥ tuṣitāt devanikāyāt cyavitvā mātuḥ 
SA_K14_mavadsuu-227	kukṣāv asthāt tato 'sya Śakreṇa devendreṇa catvāro devaputrā mātur ārakṣakā sthāpitā	kukṣau asthāt tatas sya śakreṇa deva indreṇa catvāraḥ deva putrāḥ mātuḥ ārakṣakā sthāpitā 
SA_K14_mavadsuu-228	mā etāṃ kaścid viheṭhayiṣyati manuṣyo vā amanuṣyo vā iyam atra dharmatā tasmād idam ucyate //	mā etām kaścid viheṭhayiṣyati manuṣyaḥ vā amanuṣyaḥ vā iyam atra dharma tā tasmāt idam ucyate 
SA_K14_mavadsuu-229	te devaputrā sahitāś caturdiśaṃ	te deva putrā sahitāḥ caturdiśam 
SA_K14_mavadsuu-230	mahātmadevānugatā yaśasvinā /	mahātma deva anugatāḥ yaśasvinā 
SA_K14_mavadsuu-231	Śakreṇa proktāḥ paramārthadarśino	śakreṇa proktāḥ parama artha darśinaḥ 
SA_K14_mavadsuu-232	rakṣāṃ kurudhvaṃ sugatasya mātuḥ 1	rakṣām kurudhvam sugatasya mātuḥ 
SA_K14_mavadsuu-233	niṣkṛṣṭaśastrāyudhakhaḍgapāṇayaḥ	niṣkṛṣṭa śastra āyudha khaḍga pāṇayaḥ 
SA_K14_mavadsuu-234	sutīkṣṇarūpāṃ vyavalaṃbya śaktim	su tīkṣṇa rūpām vyavalaṃbya śaktim 
SA_K14_mavadsuu-235	mā tāṃ manuṣyā atha vāpi rākṣasā	mā tām manuṣyāḥ atha vā api rākṣasā 
SA_K14_mavadsuu-236	viheṭhayeyuḥ sugatasya mātaram 2	viheṭhayeyuḥ sugatasya mātaram 
SA_K14_mavadsuu-237	sā devaguptā varabhūtarakṣitā	sā deva guptā vara bhūta rakṣitā 
SA_K14_mavadsuu-238	yaśasvinī devagaṇaiḥ supālitā /	yaśasvinī deva gaṇaiḥ su pālitā 
SA_K14_mavadsuu-239	krīḍaty asāv apsarasa iva Nandane	krīḍati asau apsarasaḥ iva nandane 
SA_K14_mavadsuu-240	tathā tad āsīd iyam atra dharmatā 3 //	tathā tat āsīt iyam atra dharmatā 
SA_K14_mavadsuu-241	3. He is as Pure as a Jewel	he is as pure as a jewel 
SA_K14_mavadsuu-242	dharmatā khalu yasmiṃ samaye Vipaśyī bodhisatvas Tuṣitād devanikāyāc cyavitvā mātuḥ	dharmatā khalu yasmin samaye vipaśyī bodhisatvaḥ tuṣitāt devanikāyāt cyavitvā mātuḥ 
SA_K14_mavadsuu-243	kukṣāv asthāt kośogata evāsthād amrakṣito garbhamalena jubhramalena rudhiramalena	kukṣau asthāt kośogate eva asthāt a mrakṣitaḥ garbha malena jubhra malena rudhira malena 
SA_K14_mavadsuu-244	anyatamānyatamena vā aśuciprākṛtena tadyathā maṇiratnaṃ Kāśikaratne upanikṣiptaṃ	anyatama anyatamena vā aśuci prākṛtena tat yathā maṇi ratnam kāśika ratne upanikṣiptam 
SA_K14_mavadsuu-245	naiva maṇiratnaṃ Kāśikaratnenopalipyate na Kāśikaratnaṃ maṇiratnena iyam atra dharmatā	na eva maṇi ratnam kāśika ratnena upalipyate na kāśika ratnam maṇi ratnena iyam atra dharmatā 
SA_K14_mavadsuu-246	tasmād idam ucyate //	tasmāt idam ucyate 
SA_K14_mavadsuu-247	yathāpi taṃ maṇiratnaṃ prabhāsvaraṃ	yathā api tam maṇi ratnam prabhāsvaram 
SA_K14_mavadsuu-248	na lipyate paramaśucau hi Kāśike /	na lipyate parama śucau hi kāśike 
SA_K14_mavadsuu-249	tathopamaḥ kukṣigato narottamo	tathā upamaḥ kukṣi gataḥ 
SA_K14_mavadsuu-250	na lipyate aśucikṛtena paṇḍitaḥ 1 //	na lipyate aśuci kṛtena paṇḍitaḥ 
SA_K14_mavadsuu-251	4. He is Like an EightFaceted Gem	he is like an eigtfaceted gem 
SA_K14_mavadsuu-252	dharmatā khalu yasmiṃ samaye Vipaśyī bodhisatvas Tuṣitād devanikāyāc cyavitvā mātuḥ kukṣāv asthāt sarvam enaṃ mātā paripūrṇaṃ kukṣigataṃ paśyati  #	dharmatā khalu yasmin samaye vipaśyī bodhisatvaḥ tuṣitāt devanikāyāt cyavitvā mātuḥ kukṣau asthāt sarvam enam mātā paripūrṇam kukṣi gatam paśyati  /
SA_K14_mavadsuu-253	tadyathā maṇir vaiḍūrya aṣṭāṃśo	tat yathā maṇiḥ vaiḍūryaḥ aṣṭa aṃśaḥ 
SA_K14_mavadsuu-254	jātimāṃ śuddho viprasanna anāvilaḥ pañcaraṅgike sūtre arpita syān nīle pīte lohite	śuddhaḥ viprasannaḥ anāvilaḥ pañcaraṅgike sūtre arpita syāt nīle pīte lohite 
SA_K14_mavadsuu-255	avadāte māṃjiṣṭhe taṃ cakṣuṣmāṃ puruṣo dṛṣṭvā jānīyād idaṃ sūtram ayaṃ maṇiḥsūtre	avadāte māṃjiṣṭhe tam cakṣuṣmām puruṣaḥ dṛṣṭvā jānīyāt idam sūtram ayam maṇiḥ sūtre 
SA_K14_mavadsuu-256	maṇir arpita iyam atra dharmatā tasmād idam ucyate //	maṇiḥ arpitaḥ iyam atra dharmatā tasmāt idam ucyate 
SA_K14_mavadsuu-257	yathāpy asau vaiḍūryako mahāmaṇi	yathā api asau vaiḍūryakaḥ mahā maṇi 
SA_K14_mavadsuu-258	prabhāsvaraḥ sūryamarīcisaṃnibhaḥ	prabhāsvaraḥ sūrya marīci saṃnibhaḥ 
SA_K14_mavadsuu-259	tathopamaṃ kukṣigataṃ narottamaṃ	tathā upamam kukṣi gatam nara uttamam 
SA_K14_mavadsuu-260	Vipaśyimātā paripūrṇam īkṣate //	vipaśyi mātā paripūrṇam īkṣate 
SA_K14_mavadsuu-261	5. He Does Not Fatigue His Mother	he does not fatigue his mothr 
SA_K14_mavadsuu-262	dharmatā khalu yasmiṃ samaye Vipaśyī bodhisatvas Tuṣitād devanikāyāc cyavitvā mātuḥ	dharmatā khalu yasmin samaye vipaśyī bodhisatvaḥ tuṣitāt devanikāyāt cyavitvā mātuḥ 
SA_K14_mavadsuu-263	kukṣāv asthān nāsya tasmiṃ samaye mātā śrāntakāyā vābhūt klāntakāyā vā yad uta bodhisatvaṃ	kukṣau asthāt na asya tasmin samaye mātā śrānta kāyā vā abhūt klānta kāyā vā yat uta bodhisatvam 
SA_K14_mavadsuu-264	dhārayaṃtī iyam atra dharmatā tasmād idam ucyate //	dhārayaṃtī iyam atra dharmatā tasmāt idam ucyate 
SA_K14_mavadsuu-265	X _ cāsau kukṣim upe ^ _ ^ X	ca asau kukṣim upe 
SA_K14_mavadsuu-266	X _ cyutaḥ karmav. _ ^ _ ^ X /	cyutaḥ karma 
SA_K14_mavadsuu-267	te dhārayaṃtī iyam atra dharmatā //	te dhārayaṃtī iyam atra dharmatā 
SA_K14_mavadsuu-268	6. His Mother Keeps the Five Precepts	his mothr keeps the five precepts 
SA_K14_mavadsuu-269	dharmatā khalu yasmiṃ samaye Vipaśyī bodhisatvas Tuṣitād devanikāyāc cyavitvā mātuḥ	dharmatā khalu yasmin samaye vipaśyī bodhisatvaḥ tuṣitāt devanikāyāt cyavitvā mātuḥ 
SA_K14_mavadsuu-270	kukṣāv asthāt tato mātrā yāvajjīvaṃ pañca vratapadāni samādattāni yāvajjīvam asya	kukṣau asthāt tatas mātrā yāvajjīvam pañca vrata padāni samādattāni yāvajjīvam asya 
SA_K14_mavadsuu-271	mātā prāṇātipātāt prativiratādattādānād abrahmacaryān mṛṣāvādāt surāmaireyamadyapramādasthānāt	mātā prāṇa atipātāt prativiratā a datta ādānāt a brahmacaryāt mṛṣāvādāt surā maireya madya pramāda sthānāt 
SA_K14_mavadsuu-272	prativiratā iyam atra dharmatā tasmād idam ucyate //	prativiratā iyam atra dharmatā tasmāt idam ucyate 
SA_K14_mavadsuu-273	prāṇān ahaṃtī nādattam ādadau	prāṇān a haṃtī na a dattam ādadau 
SA_K14_mavadsuu-274	mṛṣā na bhāṣen na ca madyapānam	mṛṣā na bhāṣet na ca madya pānam 
SA_K14_mavadsuu-275	abrahmacaryād viratā ca maithunād	a brahmacaryāt viratā ca maithunāt 
SA_K14_mavadsuu-276	Vipaśyimātā iyam atra dharmatā //	vipaśyi mātar iyam atra dharma tā 
SA_K14_mavadsuu-277	7. His Mother Has No Mental Attachment	his mothrī has no mental attachment 
SA_K14_mavadsuu-278	dharmatā khalu yasmiṃ samaye Vipaśyī bodhisatvas Tuṣitād devanikāyāc cyavitvā mātuḥ	dharmatā khalu yasmin samaye vipaśyī bodhisatvaḥ tuṣitāt devanikāyāt cyavitvā mātuḥ 
SA_K14_mavadsuu-279	kukṣāv asthān nāsya mātā tataḥ puruṣeṣu mānasaṃ nibaddhavatī yad uta kāmaguṇopasaṃhitam	kukṣau asthāt na asya mātā tatas puruṣeṣu mānasam nibaddhavatī yat uta kāma guṇa upasaṃhitam 
SA_K14_mavadsuu-280	iyam atra dharmatā tasmād idam ucyate //	iyam atra dharmatā tasmāt idam ucyate 
SA_K14_mavadsuu-281	X _ ^ _ nāpi ca rajyate tadā	na api ca rajyate tadā 
SA_K14_mavadsuu-282	na kāmahetoḥ paridahyate manaḥ	na kāma hetoḥ paridahyate manaḥ 
SA_K14_mavadsuu-283	na cāsya mātuḥ puruṣena mānasaṃ	na ca asya mātuḥ puruṣena mānasam 
SA_K14_mavadsuu-284	nibadhyate kāmaguṇopasaṃhitam //	nibadhyate kāma guṇa upasaṃhitam 
SA_K14_mavadsuu-285	[The Bodhisattva's Birth]	the bodhisattvas birth 
SA_K14_mavadsuu-286	8. Birth	birth 
SA_K14_mavadsuu-287	dharmatā khalu yasmiṃ samaye Vipaśyī bodhisatvo mātuḥ kukṣer niṣkrānto 'tyarthaṃ	dharmatā khalu yasmin samaye vipaśyī bodhisatvaḥ mātuḥ kukṣeḥ niṣkrāntaḥ u tyartham 
SA_K14_mavadsuu-288	tasmiṃ samaye mahāpṛthivīcālaś cābhūt sarvaś cāyaṃ loka udāreṇāvabhāsena sphuṭo 'bhūt	tasmin samaye mahā pṛthivīcālaḥ ca abhūt sarvaḥ ca ayam lokaḥ udāreṇa avabhāsena sphuṭaḥ bhūt 
SA_K14_mavadsuu-289	pūrvavad yāvad anye 'pi bhavantaḥ satvā ihopapannāḥ iyam atra dharmatā tasmād idam ucyate //	pūrvavat yāvat anye pi bhavantaḥ satvāḥ iha upapannāḥ iyam atra dharmatā tasmāt idam ucyate 
SA_K14_mavadsuu-290	utpadyamāne pṛthivī prakampitā	utpadyamāne pṛthivī prakampitā 
SA_K14_mavadsuu-291	pṛthus tathābhā visṛtā ^ _ ^ X /	pṛthuḥ tathā ābhā visṛtā 
SA_K14_mavadsuu-292	X _ ^ _ _ ^ ^ _ ^ śobhate	         śobhate 
SA_K14_mavadsuu-293	tathā tad āsīd iyam atra dharmatā //	tathā tat āsīt iyam atra dharmatā 
SA_K14_mavadsuu-294	9. The Newborn Bodhisattva is Born Without Stain	the newborn bodhisattva is born without stain 
SA_K14_mavadsuu-295	dharmatā khalu yasmiṃ samaye Vipaśyī bodhisatvo mātuḥ kukṣer niṣkrāntas kośogata	dharmatā khalu yasmin samaye vipaśyī bodhisatvaḥ mātuḥ kukṣeḥ niṣkrāntaḥ kośogata 
SA_K14_mavadsuu-296	ivāsir niṣkrānto 'mrakṣito garbhamalena jubhramalena rudhiramalenānyatamānyatamena	iva asiḥ niṣkrāntaḥ mrakṣitaḥ garbha malena jubhra malena rudhira malena anyatama anyatamena 
SA_K14_mavadsuu-297	vāśuciprākṛtena iyam atra dharmatā tasmād idam ucyate //	vā aśuci prākṛtena iyam atra dharma tā tasmāt idam ucyate 
SA_K14_mavadsuu-298	yathāpi taṃ maṇiratanaṃ prabhāsvaraṃ	yathā api tam maṇi ratanam prabhāsvaram 
SA_K14_mavadsuu-299	na lipyate paramaśucau hi Kāśike /	na lipyate parama śucau hi kāśike 
SA_K14_mavadsuu-300	X ciḥ sunirdhāntam ivāṃśukāñcanam //	cis su nirdhāntam iva aṃśu kāñcanam 
SA_K14_mavadsuu-301	10. His Mother Gives Birth in the Standing Position	his mothr gives birth in the standing position 
SA_K14_mavadsuu-302	dharmatā khalu yasmiṃ samaye Vipaśyī bodhisatvo mātuḥ kukṣer niṣkrānto nāsya mātā	dharmatā khalu yasmin samaye vipaśyī bodhisatvaḥ mātuḥ kukṣeḥ niṣkrāntaḥ na asya mātā 
SA_K14_mavadsuu-303	niṣaṇṇā vābhūn nipannā vā sthitaiva sā kṣatriyā kṣatriyaṃ prajātā iyam atra dharmatā	niṣaṇṇā vā abhūt nipannā vā sthitā eva sā kṣatriyā kṣatriyam prajātā iyam atra dharmatā 
SA_K14_mavadsuu-304	tasmād idam ucyate //	tasmāt idam ucyate 
SA_K14_mavadsuu-305	na sā niṣaṃṇā na nipanna kṣatriyā	na sā niṣaṃṇā na nipanna kṣatriyā 
SA_K14_mavadsuu-306	sthitaiva sā .r. pad ^ _ ^ _ ^ X /	sthitā eva sā 
SA_K14_mavadsuu-307	X _ ^ _ _ varasatya vikramo	ro 
SA_K14_mavadsuu-308	jagrāha taṃ surapatideva utsuka //	jagrāha tam surapati devaḥ utsuka 
SA_K14_mavadsuu-309	[After the Bodhisattva's Birth]	after the bodhisattvas birth 
SA_K14_mavadsuu-310	11. He Takes Seven Steps	he takes seven steps 
SA_K14_mavadsuu-311	dharmatā khalu sāṃpratajāto Vipaśyī bodhisatvaḥ sapta padāni prakrāntaḥ parigṛhīto na kasmiṃścic caturdiśañ ca vyavalokayati vācañ ca bhāṣate  #	dharmatā khalu sāṃprata jātaḥ vipaśyī bodhisatvaḥ sapta padāni prakrāntaḥ parigṛhītaḥ na kasmiṃścid caturdiśam ca vyavalokayati vācam ca bhāṣate  /
SA_K14_mavadsuu-312	iyaṃ me bhavet paścimā jātiḥ	iyam me bhavet paścimā jātiḥ 
SA_K14_mavadsuu-313	devāḥ śvetaṃ ca chatraṃ maṇidaṇḍakaṃ ca cāmaraṃ ca dhārayanti iyam atra dharmatā tasmād idam ucyate //	devāḥ śvetam ca chatram maṇi daṇḍakam ca cāmaram ca dhārayanti iyam atra dharmatā tasmāt idam ucyate 
SA_K14_mavadsuu-314	jāto hy eṣa sapta padāni prakramad	jātaḥ hi eṣa sapta padāni prakramat 
SA_K14_mavadsuu-315	di _ ^ _ lokya vācaṃ ca bhāṣate /	vācam ca bhāṣate 
SA_K14_mavadsuu-316	śre _ ^ _ _ ^ ^ _ ^ _ ^ X	ro 
SA_K14_mavadsuu-317	X _ ^ _ _ ^ ^ _ nti deva //	deva 
SA_K14_mavadsuu-318	12. Warm and Cool Streams Fall from Above	    fall from   
SA_K14_mavadsuu-319	dharmatā khalu sāṃpratajātasya Vipaśyino bodhisatvasya dve vāridhāre 'ntarīkṣāt prapatite ekā śītāsyaikoṣṇāsya ye bodhisatvaṃ snāpitavatyau  #	dharmatā khalu sāṃprata jātasya vipaśyinaḥ bodhisatvasya dve vāri dhāre ntarīkṣāt prapatite ekā śīta āsya eka uṣṇa āsya ye bodhisatvam snāpitavatyau 
SA_K14_mavadsuu-320	iyam atra dharmatā tasmād idam ucyate //	iyam atra dharmatā tasmāt idam ucyate 
SA_K14_mavadsuu-321	jāte kumāre sumahābhiṣaṭke	jāte kumāre su mahā abhiṣaṭke 
SA_K14_mavadsuu-322	dve vāridhāre patite antarikṣāt	dve vāri dhāre patite antarikṣāt 
SA_K14_mavadsuu-323	X _ ^ _ _ ṇa ca anāvilā ca	  ca anāvilā ca 
SA_K14_mavadsuu-324	snātaḥ s ^ _ _ dvipadottamo X //	snātaḥ 
SA_K14_mavadsuu-325	13. A Stream Manifests from a Well	a stream manifests from a well 
SA_K14_mavadsuu-326	dharmatā khalu sāṃpratajātasya Vipaśyino bodhisatvasya mātur janayitryāḥ purastāṃ mahad udapānaṃ prādurbhūtaṃ vāri viṣyandi yato 'sya mātā  #	dharmatā khalu sāṃprata jātasya vipaśyinaḥ bodhisatvasya mātuḥ janayitryāḥ purastām mahat udapānam prādurbhūtam vāri viṣyandi yatas u sya mātā  /
SA_K14_mavadsuu-327	udakakāryam akārṣīd iyam atra dharmatā	udaka kāryam akārṣīt iyam atra dharmatā 
SA_K14_mavadsuu-328	tasmād idam ucyate //	tasmāt idam ucyate 
SA_K14_mavadsuu-329	kurvaṃti nāgāsya sadaivapūjāṃ	kurvaṃti nāga asya sa daiva pūjām 
SA_K14_mavadsuu-330	yasmiṃ ^ _ jāyate bodhisatvaḥ	yasmin jāyate bodhisatvaḥ 
SA_K14_mavadsuu-331	te hṛṣṭās tuṣṭā muditā udagrāḥ	te hṛṣṭāḥ tuṣṭāḥ muditāḥ udagrāḥ 
SA_K14_mavadsuu-332	vāriṃ sṛjantīha athodapānam //	vārim sṛjanti iha atha udapānam 
SA_K14_mavadsuu-333	14. The Deities Scatter Flowers and Play Music	the deities scatter flowers and play music 
SA_K14_mavadsuu-334	dharmatā khalu sāṃpratajātasya Vipaśyino bodhisatvasya devatā antarīkṣād divyāny	dharmatā khalu sāṃprata jātasya vipaśyinaḥ bodhisatvasya devatāḥ antarīkṣāt divyāni 
SA_K14_mavadsuu-335	utpalāni padmāni kumudāni puṇḍarīkāṇi agarucūrṇāni tagarucūrṇāni candanacūrṇāni divyāni	utpalāni padmāni kumudāni puṇḍarīkāṇi agaru cūrṇāni tagaru cūrṇāni candana cūrṇāni divyāni 
SA_K14_mavadsuu-336	mandārakāni puṣpāṇi kṣipanti divyāni ca vādyāni saṃpravādayanti cailavikṣepaṃ cākārṣur	mandārakāni puṣpāṇi kṣipanti divyāni ca vādyāni saṃpravādayanti caila vikṣepam ca akārṣuḥ 
SA_K14_mavadsuu-337	iyam atra dharmatā tasmād idam ucyate //	iyam atra dharmatā tasmāt idam ucyate 
SA_K14_mavadsuu-338	jāte kumāre sumahābhiṣaṭke	jāte kumāre su mahā abhiṣaṭke 
SA_K14_mavadsuu-339	d.e _ ^ _ _ ^ ^ _ ^ _ X /	ro-0 
SA_K14_mavadsuu-340	X _ ^ _ _ anubhāvam īkṣya	ro anubhāvam īkṣya 
SA_K14_mavadsuu-341	yāvat sujāto b. ^ _ ^ _ utaḥ	yāvat sujātaḥ 
SA_K14_mavadsuu-342	rāj _ ^ _ _ ^ ^ _ ^ _ X	rāj 
SA_K14_mavadsuu-343	X _ ^ _ āṃ paripūrayiṣyati X	  paripūrayiṣyati 
SA_K14_mavadsuu-344	itīha devā akaniṣṭhavāsina	iti iha devāḥ a kaniṣṭha vāsina 
SA_K14_mavadsuu-345	ā _ ^ _ _ ^ ṣv aghoṣa _ ^ X 3 //	ā  xc 
SA_K14_mavadsuu-346	15. Mnemonic Keywords of This Chapter	mnemonic keywords of this chapter 
SA_K14_mavadsuu-347	uddānam //	uddānam 
SA_K14_mavadsuu-348	utpādakośasthiti saptapadaṃ	utpāda kośa sthiti sapta padam 
SA_K14_mavadsuu-349	dve vāridhāre udapāna devatā //	dve vāridhāre udapāna devatā 
SA_K14_mavadsuu-350	Part Two	part two 
SA_K14_mavadsuu-351	[After the Bodhisattva's Birth: Continued]	after the bodhisattvas birth continued 
SA_K14_mavadsuu-352	1. His Wet Nurse	his wet nurse 
SA_K14_mavadsuu-353	dharmatā khalu sāṃpratajātaṃ Vipaśyinaṃ bodhisatvaṃ mātāpitarau dhātryā anuprayacchataḥ	dharmatā khalu sāṃprata jātam vipaśyinam bodhisatvam mātā pitarau dhātryai anuprayacchataḥ 
SA_K14_mavadsuu-354	ayaṃ tvayā dhātri kumāraḥ kālena kālam udvartayitavyaḥ kālena kālaṃ snāpayitavyaḥ	ayam tvayā dhātri kumāraḥ kālena kālam udvartayitavyaḥ kālena kālam snāpayitavyaḥ 
SA_K14_mavadsuu-355	kālena kālaṃ bhojayitavyaḥ kālena kālaṃ samyak sukhena parihartavyaḥ tam enaṃ dhātry	kālena kālam bhojayitavyaḥ kālena kālam samyak sukhena parihartavyaḥ tam enam dhātri 
SA_K14_mavadsuu-356	ubhābhyāṃ pāṇibhyāṃ pratigṛhītvā kālena kālam udvartayati kālena kālaṃ snāpayati	ubhābhyām pāṇibhyām pratigṛhītvā kālena kālam udvartayati kālena kālam snāpayati 
SA_K14_mavadsuu-357	kālena kālaṃ bhojayati kālena kālaṃ samyak sukhena pariharati /	kālena kālam bhojayati kālena kālam samyak sukhena pariharati 
SA_K14_mavadsuu-358	apīdānīṃ ye gandhā loke manojñarūpās tair vilipya sarvālaṃkārair alaṃkṛtaṃ pitur Bandhumato 'nuprayacchati /	api idānīm ye gandhāḥ loke manojña rūpāḥ taiḥ vilipya sarva alaṃkāraiḥ alaṃkṛtam pituḥ bandhumataḥ nuprayacchati 
SA_K14_mavadsuu-359	enaṃ Bandhumā rājā gṛhītvāṅke niṣādya punaḥ punaḥ prekṣate harṣaṃ janayati iyam atra dharmatā tasmād idam ucyate //	enam bandhumāḥ rājā gṛhītvā aṅke niṣādya punar punar prekṣate harṣam janayati iyam atra dharmatā tasmāt idam ucyate 
SA_K14_mavadsuu-360	X _ ^ _ _ m adadat sa dhātryāḥ	adadat sa dhātryāḥ 
SA_K14_mavadsuu-361	tato 'pi _ _ ^ ^ _ ^ _ X	di 
SA_K14_mavadsuu-362	X _ ^ _ _ ^ ^ _ yati caiva 1	ro-0 ca eva 
SA_K14_mavadsuu-363	ye gandha loke sumanojñarūpāḥ	ye gandha loke su manojña rūpāḥ 
SA_K14_mavadsuu-364	X _ ^ _ _ bhir alaṅkṛ _ X	x     bhiḥ alaṅkṛ 
SA_K14_mavadsuu-365	X bā ^ .ā l. sagataṃ kumāraṃ	sagata kumāram 
SA_K14_mavadsuu-366	punaḥ punaḥ prekṣati harṣajātaḥ	punar punar prekṣati harṣa jātaḥ 
SA_K14_mavadsuu-367	su _ ^ _ _ ^ ^ _ ^ _ X	di-xc-
SA_K14_mavadsuu-368	abhyudyamo _ kula _ ^ .y . nti 3 //	abhyudyamaḥ 
SA_K14_mavadsuu-369	2. The Seer	the seer 
SA_K14_mavadsuu-370	[Two Paths: To Be a Universal Monarch or to Become a Buddha]	two paths to be a univesal monarch or to become a buddha 
SA_K14_mavadsuu-371	dharmatā khalu sāṃpratajātaṃ Vipaśyinaṃ bodhisatvaṃ mātāpitarau brāhmaṇānāṃ naimittānāṃ	dharmatā khalu sāṃprata jātam vipaśyinam bodhisatvam mātā pitarau brāhmaṇānām naimittānām 
SA_K14_mavadsuu-372	vipañcanānāṃ copadarśayataḥ kaścid bhavantaḥ samanvāgataḥ kumāro dvātriṃśadbhir mahāpuruṣalakṣaṇair	vipañcanānām ca upadarśayataḥ kaścid bhavantaḥ samanvāgataḥ kumāraḥ dvātriṃśadbhiḥ mahāpuruṣa lakṣaṇaiḥ 
SA_K14_mavadsuu-373	yaiḥ samanvāgatasya mahāpuruṣasya dve gatī bhavato 'nanyathā saced gṛhy agāram adhyāvasati	yaiḥ samanvāgatasya mahāpuruṣasya dve gatī bhavataḥ na anyathā saced gṛhi agāram adhyāvasati 
SA_K14_mavadsuu-374	rājā bhavati cakravartī cāturantyāṃ vijetā dhārmiko dharmarājā saptaratnasamanvāgataḥ	rājā bhavati cakravartī cāturantyām vijetā dhārmikaḥ dharma rājā sapta ratna samanvāgataḥ 
SA_K14_mavadsuu-375	tasyemāṇy evaṃrūpāṇi sapta ratnāni bhavaṃti tadyathā cakraratnaṃ hastiratnam aśvaratnaṃ	tasya imāṇi evaṃrūpāṇi sapta ratnāni bhavanti tat yathā cakra ratnam hasti ratnam aśva ratnam 
SA_K14_mavadsuu-376	maṇiratnaṃ strīratnaṃ gṛhapatiratnaṃ pariṇāyakaratnam eva saptamaṃ pūrṇaṃ cāsya bhavati	maṇi ratnam strī ratnam gṛhapati ratnam pariṇāyaka ratnam eva saptamam pūrṇam ca asya bhavati 
SA_K14_mavadsuu-377	sahasraṃ putrāṇāṃ śūrāṇāṃ vīrāṇāṃ varāṅgarūpiṇāṃ parasainyapramardakānāṃ sa imām	sahasram putrāṇām śūrāṇām vīrāṇām vara aṅga rūpiṇām para sainya pramardakānām saḥ imām 
SA_K14_mavadsuu-378	eva samudraparyantāṃ mahāpṛthivīm akhilām akaṇṭakām anutpīḍām adaṇḍenāśastreṇa dharmeṇa	eva samudra paryantām mahā pṛthivīm akhilām akaṇṭakām an utpīḍām adaṇḍena aśastreṇa dharmeṇa 
SA_K14_mavadsuu-379	samenābhinirjityādhyāvasati sacet keśaśmaśrūṇy avatārya kāṣāyāṇi vastrāṇy ācchādya	samena abhinirjitya adhyāvasati saced keśa śmaśrūṇi avatārya kāṣāyāṇi vastrāṇi ācchādya 
SA_K14_mavadsuu-380	samyag eva śraddhayāgārād anagārikāṃ pravrajati tathāgato bhavaty arhaṃ samyaksaṃbuddho	samyak eva śraddhayā āgārāt anagārikām pravrajati tathāgataḥ bhavati arham samyaksaṃbuddhaḥ 
SA_K14_mavadsuu-381	vighuṣṭaśabdo loke tathyaṃ deva samanvāgataḥ kumāro dvātriṃśadbhir mahāpuruṣalakṣaṇaiḥ	vighuṣṭa śabdaḥ loke tathyam deva samanvāgataḥ kumāraḥ dvātriṃśadbhiḥ mahāpuruṣa lakṣaṇaiḥ 
SA_K14_mavadsuu-382	pūrvavad yāvat tathāgato bhavaty arhan samyaksaṃbuddho vighuṣṭaśabdo loke iyam atra	pūrvavat yāvat tathāgataḥ bhavati arhan samyaksaṃbuddhaḥ vighuṣṭa śabdaḥ loke iyam atra 
SA_K14_mavadsuu-383	dharmatā tasmād idam ucyate //	dharmatā tasmāt idam ucyate 
SA_K14_mavadsuu-384	jātaṃ kumāraṃ sumahābhiṣaṭkaṃ	jātam kumāram su mahā abhiṣaṭkam 
SA_K14_mavadsuu-385	te bodhisatvam ^ ^ _ ^ _ X /	te bodhisatvam 
SA_K14_mavadsuu-386	X _ ^ _ _ ^ na pravrajito	ro 
SA_K14_mavadsuu-387	rājā bhaviṣyati cakravartī 1	rājā bhaviṣyati cakravartī 
SA_K14_mavadsuu-388	X _ ..ṃ tāṃ _ ^ ^ _ ^ _ X	ro-0 tāṃ 
SA_K14_mavadsuu-389	dharmeṇa kṣemeṇa śivāṃ vasundharām	dharmeṇa kṣemeṇa śivām vasundharām 
SA_K14_mavadsuu-390	yad _ ^ _ _ ^ ^ _ ^ _ bhaṃtam	yat 
SA_K14_mavadsuu-391	X _ ^ _ yaṃ sa k. _ .r. m eva 2	r yam sa k r m eva 
SA_K14_mavadsuu-392	yat sarvasauvarṇa sa ku ^ _ X	yat sarvasauvarṇa sa ku 
SA_K14_mavadsuu-393	X _ ^ _ _ ^ ^ _ ^ nemi /	ro-0 fl-1 fl-2
SA_K14_mavadsuu-394	yad asya pūrve pṛthivīṃ vijeṣyate	yat asya pūrve pṛthivīm vijeṣyate 
SA_K14_mavadsuu-395	tac cakraratnaṃ prathamaṃ niyāsyati 3	tat cakra ratnam prathamam niyāsyati 
SA_K14_mavadsuu-396	sujāta saptāṅgapratiṣṭhitaṃ ṛjum	sujāta sapta aṅga pratiṣṭhitam ṛjum 
SA_K14_mavadsuu-397	avadātam _ ^ ^ _ ^ _ ^ X /	avadātam 
SA_K14_mavadsuu-398	X _ ^ _ _ ^ ^ _ ^ kuñjaraṃ	           
SA_K14_mavadsuu-399	dvitīyaṃ ratnaṃ hi bhṛśaṃ niyāsyati 4	dvitīyam ratnam hi bhṛśam niyāsyati 
SA_K14_mavadsuu-400	yaḥ prātarāśe samayena medinīṃ	yaḥ prātarāśe samayena medinīm 
SA_K14_mavadsuu-401	samaṃtataḥ prāpya punar nirvartate /	samaṃtataḥ prāpya punar nirvartate 
SA_K14_mavadsuu-402	aśvaṃ tṛtīyaṃ ratnaṃ niyāsyati 5	aśvam tṛtīyam ratnam niyāsyati 
SA_K14_mavadsuu-403	maṇiñ ca vaiḍūryam ayaṃ sunirmalaṃ	maṇim ca vaiḍūryam ayam su nirmalam 
SA_K14_mavadsuu-404	samaṃtato yojanam āvabhāsate /	samaṃtataḥ yojanam āvabhāsate 
SA_K14_mavadsuu-405	yathaiva rātrau ^ ^ _ ^ _ ^ X	yathā eva rātrau 
SA_K14_mavadsuu-406	X _ ^ _ _ vimalaṃ niyāsyati 6	ro vimalam niyāsyati 
SA_K14_mavadsuu-407	yā rūpaśabdeṣv atha gandhasparśe	yāḥ rūpa śabdeṣu atha gandha sparśe 
SA_K14_mavadsuu-408	nārī pradhānā pra ^ dottamā ca /	nārī pradhānā pra dā uttamā ca 
SA_K14_mavadsuu-409	yathānta arāḥ sarvataś cāruhāsinī	yathā ante arāḥ sarvatas cāru hāsinī 
SA_K14_mavadsuu-410	tat pañcamaṃ strīratnaṃ niyāsyati 7	tat pañcamam strī ratnam niyāsyati 
SA_K14_mavadsuu-411	X _ ^ _ vaiḍūryaṃ maṇiratnaṃ	      
SA_K14_mavadsuu-412	śilāpravāḍaṃ ca suvarṇarūpam	śilā pravāḍam ca suvarṇa rūpam 
SA_K14_mavadsuu-413	dadāti yaḥ śreṣṭhivaro mahā _ ^ X	dadāti yaḥ śreṣṭhi varaḥ mahā 
SA_K14_mavadsuu-414	gṛhapatiṃ ratnaṃ ṣaṣṭhaṃ niyāsyati 8	gṛhapatim ratnam ṣaṣṭham niyāsyati 
SA_K14_mavadsuu-415	ya _ ^ _ _ ^ ^ _ ^ _ X ṃ	ya 
SA_K14_mavadsuu-416	senāsu sthānaṃ gamanaṃ nivartanam	senāsu sthānam gamanam nivartanam 
SA_K14_mavadsuu-417	yo _ tidakṣaḥ pariṇāyakottamas	tidakṣaḥ pariṇāyaka uttamaḥ 
SA_K14_mavadsuu-418	tat saptamaṃ ratnavaraṃ niyāsyati 9	tat saptamam ratna varam niyāsyati 
SA_K14_mavadsuu-419	jana ^ _ _ ^ ^ _ ^ _ ^ X	ro-0 
SA_K14_mavadsuu-420	X _ ^ _ _ ^ ^ _ .garūpiṇām	        ga rūpiṇām 
SA_K14_mavadsuu-421	sacet punaḥ pravrajat';	saced punar pravrajat 
SA_K14_mavadsuu-422	ānagārikāṃ	ānagārikām 
SA_K14_mavadsuu-423	niḥsaṃśayaṃ buddhavaro bhaviṣyati 10	niḥsaṃśayam buddha varaḥ bhaviṣyati 
SA_K14_mavadsuu-424	evaṃvidha eṣa sutas tavāsti	evaṃvidhaḥ eṣa sutaḥ tava asti 
SA_K14_mavadsuu-425	X anyatarānyatarā gatir dhruvā	anyatara anyatarā gatiḥ dhruvā 
SA_K14_mavadsuu-426	tathā hy etaṃ mantrapadeṣu dṛśyate 11 //	tathā hi etam mantra padeṣu dṛśyate 
SA_K14_mavadsuu-427	[The Thirtytwo Distinguishing Marks of a Great Man]	the thirtytwo distinguishing marks of a great man 
SA_K14_mavadsuu-428	katamāni tāni bhavaṃti kumārasyadvātriṃśan mahāpuruṣalakṣaṇāni yaiḥ samanvāgatasya mahāpuruṣasya dve gatī bhavato (MAV 78)	katamāni tāni bhavanti kumārasya dvātriṃśat mahāpuruṣa lakṣaṇāni yaiḥ samanvāgatasya mahāpuruṣasya dve gatī bhavataḥ 
SA_K14_mavadsuu-429	'nanyathā saced agāram adhyāvasati pūrvavad yāvad vighuṣṭaśabdo loke	na anyathā saced agāram adhyāvasati pūrvavat yāvat vighuṣṭa śabdaḥ loke 
SA_K14_mavadsuu-430	supratiṣṭhitapādo deva kumāra idaṃ mahāpuruṣasya mahāpuruṣalakṣaṇam 1	su pratiṣṭhita pādaḥ deva kumāraḥ idam mahāpuruṣasya mahāpuruṣa lakṣaṇam 
SA_K14_mavadsuu-431	adhas tasya pādayoś cakre jāte sahasrāre sanābhike sanemike sarvākāraparipūrṇe idaṃ mahāpuruṣasya mahāpuruṣalakṣaṇam 2	adhas tasya pādayoḥ cakre jāte sahasrāre sa nābhike sa nemike sarva ākāra paripūrṇe idam mahāpuruṣasya mahāpuruṣa lakṣaṇam 
SA_K14_mavadsuu-432	dīrghāṅgulir deva kumāra idaṃ mahāpuruṣasya mahāpuruṣalakṣaṇam 3 āyatapādapārṣṇir	dīrgha aṅguliḥ deva kumāraḥ idam mahāpuruṣasya mahāpuruṣa lakṣaṇam āyata pāda pārṣṇiḥ 
SA_K14_mavadsuu-433	deva kumāra idaṃ mahāpuruṣasya mahāpuruṣalakṣaṇam 4 mṛdutaruṇapāṇipādo deva kumāra	deva kumāraḥ idam mahāpuruṣasya mahāpuruṣa lakṣaṇam mṛdu taruṇa pāṇi pādaḥ deva kumāra 
SA_K14_mavadsuu-434	mṛdukam asya pāṇipādaṃ tadyathā tūlapicur vā karpāsapicur vā idaṃ mahāpuruṣasya mahāpuruṣalakṣaṇam 5	mṛdukam asya pāṇi pādam tat yathā tūla picuḥ vā karpāsa picuḥ vā idam mahāpuruṣasya mahāpuruṣa lakṣaṇam 
SA_K14_mavadsuu-435	jālinīpāṇipādo deva kumāra jālinī asya pāṇipādeṣu tadyathābhijātasya haṃsarājñaḥ idaṃ mahāpuruṣasya mahāpuruṣalakṣaṇam 6	jālinī pāṇi pādaḥ deva kumāra jālinī asya pāṇi pādeṣu tat yathā abhijātasya haṃsa rājñaḥ idam mahāpuruṣasya mahāpuruṣa lakṣaṇam 
SA_K14_mavadsuu-436	ucchaṅgacaraṇo deva kumāra idaṃ mahāpuruṣasya mahāpuruṣalakṣaṇam 7 aiṇeyajaṅgho deva	ucchaṅgacaraṇaḥ deva kumāraḥ idam mahāpuruṣasya mahāpuruṣa lakṣaṇam aiṇeyajaṅghaḥ deva 
SA_K14_mavadsuu-437	kumāra idaṃ mahāpuruṣasya mahāpuruṣalakṣaṇam 8 anavanatakāyo deva kumāraḥ anavanatena	kumāraḥ idam mahāpuruṣasya mahāpuruṣa lakṣaṇam an avanata kāyaḥ deva kumāraḥ an avanatena 
SA_K14_mavadsuu-438	kāyenobhau jānumaṇḍalāv āmārjati parimārjati idaṃ mahāpuruṣasya mahāpuruṣalakṣaṇam 9	kāyena ubhau jānu maṇḍalau āmārjati parimārjati idam mahāpuruṣasya mahāpuruṣa lakṣaṇam 
SA_K14_mavadsuu-439	kośogatavastiguhyo deva kumāraḥ kośogatam asya vastiguhyaṃ tadyathābhijātasya hastyājāneyasya vāśvasyājāneyasya vā idaṃ mahāpuruṣasya mahāpuruṣalakṣaṇam	kośogata vasti guhyaḥ deva kumāraḥ kośogatam asya vasti guhyam tat yathā abhijātasya hasti ājāneyasya vā aśvasya ājāneyasya vā idam mahāpuruṣasya mahāpuruṣa lakṣaṇam 
SA_K14_mavadsuu-440	nyagrodhaparimaṇḍalo deva kumāro yāvat kāyena tāvad vyāmena yāvad vyāmena tāvat kāyena idaṃ mahāpuruṣasya mahāpuruṣalakṣaṇam 11	nyagrodha parimaṇḍalaḥ deva kumāraḥ yāvat kāyena tāvat vyāmena yāvat vyāmena tāvat kāyena idam mahāpuruṣasya mahāpuruṣa lakṣaṇam 
SA_K14_mavadsuu-441	ūrdhvāṅgaromā deva kumāra idaṃ mahāpuruṣasya mahāpuruṣalakṣaṇam 12 ekaikaromā deva	ūrdhvāṅga romā deva kumāraḥ idam mahāpuruṣasya mahāpuruṣa lakṣaṇam ekaika romā deva 
SA_K14_mavadsuu-442	kumāra ekaikam asya roma kāye jātaṃ nīlaṃ kuṇḍalajātaṃ pradakṣiṇāvartam idaṃ mahāpuruṣasya	kumāraḥ ekaikam asya roma kāye jātam nīlam kuṇḍala jātam pradakṣiṇa āvartam idam mahāpuruṣasya 
SA_K14_mavadsuu-443	mahāpuruṣalakṣaṇam 13	        
SA_K14_mavadsuu-444	suvarṇavarṇo deva kumāraḥ kāñcanasaṃnibhatvacaḥ idaṃ mahāpuruṣasya mahāpuruṣalakṣaṇam 14	suvarṇa varṇaḥ deva kumāraḥ kāñcana saṃnibha tvacaḥ idam mahāpuruṣasya mahāpuruṣa lakṣaṇam 
SA_K14_mavadsuu-445	sūkṣmacchavir deva kumāraḥ (MAV 82)	sūkṣma chaviḥ deva kumāraḥ 
SA_K14_mavadsuu-446	sūkṣmatvāt tvaco rajojalaṃ kāye na saṃtiṣṭhate idaṃ mahāpuruṣasya mahāpuruṣalakṣaṇam 15	sūkṣma tvāt tvacaḥ rajaḥ jalam kāye na saṃtiṣṭhate idam mahāpuruṣasya mahāpuruṣa lakṣaṇam 
SA_K14_mavadsuu-447	saptotsado deva kumāraḥ saptāsyotsadā kāye jātā dvau hastayo dvau pādayo dvāv aṃsayor eko grīvāyām idaṃ mahāpuruṣasya mahāpuruṣalakṣaṇam 16	sapta utsadaḥ deva kumāraḥ sapta asya utsadā kāye jātāḥ dvau hastayaḥ dvau pādayaḥ dvau aṃsayoḥ ekaḥ grīvāyām idam mahāpuruṣasya mahāpuruṣa lakṣaṇam 
SA_K14_mavadsuu-448	citāntarāṃso deva kumāra idaṃ mahāpuruṣasya mahāpuruṣalakṣaṇam 17 siṃhapūrvārdhakāyo	citāntarāṃsaḥ deva kumāraḥ idam mahāpuruṣasya mahāpuruṣa lakṣaṇam siṃha pūrva ardha kāyaḥ 
SA_K14_mavadsuu-449	deva kumāra idaṃ mahāpuruṣasya mahāpuruṣalakṣaṇam 18 bṛhadṛjugātro deva kumāra idaṃ	deva kumāraḥ idam mahāpuruṣasya mahāpuruṣa lakṣaṇam bṛhat ṛju gātraḥ deva kumāraḥ idam 
SA_K14_mavadsuu-450	mahāpuruṣasya mahāpuruṣalakṣaṇam 19 susaṃvṛttaskandho deva kumāra idaṃ mahāpuruṣasya	mahāpuruṣasya mahāpuruṣa lakṣaṇam su saṃvṛtta skandhaḥ deva kumāraḥ idam mahāpuruṣasya 
SA_K14_mavadsuu-451	mahāpuruṣalakṣaṇam 20 catvāriṃśaddanto deva kumāra idaṃ mahāpuruṣasya mahāpuruṣalakṣaṇam	mahāpuruṣa lakṣaṇam catvāriṃśat dantaḥ deva kumāraḥ idam mahāpuruṣasya mahāpuruṣa lakṣaṇam 
SA_K14_mavadsuu-452	21 samadanto deva kumāra idaṃ mahāpuruṣasya mahāpuruṣalakṣaṇam 22 aviraḍadaṃto deva	samadantaḥ deva kumāraḥ idam mahāpuruṣasya mahāpuruṣa lakṣaṇam deva 
SA_K14_mavadsuu-453	kumāra idaṃ mahāpuruṣasya mahāpuruṣalakṣaṇam 23 suśukladaṃṣṭro deva kumāra idaṃ mahāpuruṣasya	kumāraḥ idam mahāpuruṣasya mahāpuruṣa lakṣaṇam su śukla daṃṣṭraḥ deva kumāraḥ idam mahāpuruṣasya 
SA_K14_mavadsuu-454	mahāpuruṣalakṣaṇam 24 siṃhahanur deva kumāra idaṃ mahāpuruṣasya mahāpuruṣalakṣaṇam	mahāpuruṣa lakṣaṇam siṃhahanuḥ deva kumāraḥ idam mahāpuruṣasya mahāpuruṣa lakṣaṇam 
SA_K14_mavadsuu-455	25 rasarasāgraprāpto deva kumāra idaṃ mahāpuruṣasya mahāpuruṣalakṣaṇam 26	rasa rasa agra prāptaḥ deva kumāraḥ idam mahāpuruṣasya mahāpuruṣa lakṣaṇam 
SA_K14_mavadsuu-456	prabhūtatanujihvo deva kumāra prabhūtatvāj jihvayā mukhāj jihvāṃ nirṇāmayitvā sarvaṃ	prabhūta tanu jihvaḥ deva kumāra prabhūta tvāt jihvayā mukhāt jihvām nirṇāmayitvā sarvam 
SA_K14_mavadsuu-457	mukha maṇḍalaṃ praticchādayati yāvat keśaparyantam upādāya idaṃ mahāpuruṣasya mahāpuruṣalakṣaṇam 27	mukha maṇḍalam praticchādayati yāvat keśa paryantam upādāya idam mahāpuruṣasya mahāpuruṣa lakṣaṇam 
SA_K14_mavadsuu-458	brahmasvaro deva kumāraḥ kalaviṅkamanojñabhāṣī dundubhisvaranirghoṣaḥ idaṃ mahāpuruṣasya mahāpuruṣalakṣaṇam 28	brahma svaraḥ deva kumāraḥ kalaviṅka manojña bhāṣī dundubhi svara nirghoṣaḥ idam mahāpuruṣasya mahāpuruṣa lakṣaṇam 
SA_K14_mavadsuu-459	abhinīlanetro deva kumāra idaṃ mahāpuruṣasya mahāpuruṣalakṣaṇam 29 gopakṣmā deva	abhinīla netraḥ deva kumāraḥ idam mahāpuruṣasya mahāpuruṣa lakṣaṇam go pakṣmā deva 
SA_K14_mavadsuu-460	kumāra idaṃ mahāpuruṣasya mahāpuruṣalakṣaṇam 30 uṣṇīṣaśirā deva kumāra idaṃ mahāpuruṣasya	kumāraḥ idam mahāpuruṣasya mahāpuruṣa lakṣaṇam uṣṇīṣa śirāḥ deva kumāraḥ idam mahāpuruṣasya 
SA_K14_mavadsuu-461	mahāpuruṣalakṣaṇam 31 ūrṇā cāsya bhruvor madhye śvetā śaṅkhanibhā pradakṣiṇāvartā	mahāpuruṣa lakṣaṇam  ūrṇā ca asya bhruvoḥ madhye śvetā śaṅkha nibhā pradakṣiṇa āvartā 
SA_K14_mavadsuu-462	idaṃ mahāpuruṣasya mahāpuruṣalakṣaṇam 32	idam mahāpuruṣasya mahāpuruṣa lakṣaṇam 
SA_K14_mavadsuu-463	imāni dvātriṃśan mahāpuruṣalakṣaṇāni yaiḥ samanvāgatasya mahāpuruṣasya dve gatī bhavato 'nanyathā pūrvavad yāvad iyam atra dharmatā tasmād  #	imāni dvātriṃśat mahāpuruṣa lakṣaṇāni yaiḥ samanvāgatasya mahāpuruṣasya dve gatī bhavataḥ na anyathā pūrvavat yāvat iyam atra dharmatā tasmāt 
SA_K14_mavadsuu-464	idam ucyate //	idam ucyate 
SA_K14_mavadsuu-465	hantāhaṃ kīrtayiṣyāmi lakṣaṇāni mahāmuneḥ	hanta aham kīrtayiṣyāmi lakṣaṇāni mahā muneḥ 
SA_K14_mavadsuu-466	kāye'smiṃ bhāvitātmasya śarīrāntimadhāriṇaḥ 1	bhāvitātmasya śarīra antima dhāriṇaḥ 
SA_K14_mavadsuu-467	adhaś ca pādayos tasya cakre jāte susaṃsthite 2	adhas ca pādayoḥ tasya cakre jāte su saṃsthite 
SA_K14_mavadsuu-468	dīrghāṅguliḥ sa bhavati pādapārṣṇī ca āyate /	dīrgha aṅguliḥ sa bhavati pāda pārṣṇī ca āyate 
SA_K14_mavadsuu-469	jālini X ^ _ _ X X X X X ^ _ ^ X 3	ro 
SA_K14_mavadsuu-470	X X X ś cāpi kāyena spṛśate jānumaṇḍalam 4	ca api kāyena spṛśate jānu maṇḍalam 
SA_K14_mavadsuu-471	kośogataṃ vastiguhyaṃ X X X X ^ _ ^ X /	vasti guhyam 
SA_K14_mavadsuu-472	X X X X ^ _ _ X X X X X ^ dakṣiṇam 5	dakṣiṇam 
SA_K14_mavadsuu-473	X X s. ḍ. k. t. ṇ. bhā vy X X X X samaṃtataḥ	samantataḥ 
SA_K14_mavadsuu-474	sūkṣmatvaco 'sau bhavati sapta kāyasya utsadāḥ 6	sūkṣmatvacaḥ sau bhavati sapta kāyasya utsadāḥ 
SA_K14_mavadsuu-475	citāntarāṃso h. _ X siṃhapūrvārdhakāyavān	siṃha pūrva ardha kāyavān 
SA_K14_mavadsuu-476	bṛhadṛjūni gātrāṇi skandhau tasya susaṃskṛtau 7	bṛhat ṛjūni gātrāṇi skandhau tasya su saṃskṛtau 
SA_K14_mavadsuu-477	catuṣkā daśa dantānāṃ paripūrṇā anūnakāḥ	catuṣkāḥ daśa dantānām paripūrṇāḥ anūnakāḥ 
SA_K14_mavadsuu-478	samā aviraḍāś caiva śuklāś caiva susaṃsthitāḥ 8	samāḥ aviraḍāḥ ca eva śuklāḥ ca eva su saṃsthitāḥ 
SA_K14_mavadsuu-479	suśukladaṃṣṭro 'sau h _ X X X rasarasāgratām	rasa rasa agra tām 
SA_K14_mavadsuu-480	prabhūtatanujihvaś ca tathā brahmasvaro mu X 9	prabhūtatanujihvaḥ ca tathā brahmasvaraḥ x
SA_K14_mavadsuu-481	abhinīlanetro gopakṣmā uṣṇīṣaṃ cāsya mūrdhani /	abhinīla netraḥ go pakṣmā uṣṇīṣam ca asya mūrdhani 
SA_K14_mavadsuu-482	ūrṇā cāsya bhruvor madhye śvetā bhavati pradakṣiṇā 10	ūrṇā ca asya bhruvoḥ madhye śvetā bhavati pradakṣiṇā 
SA_K14_mavadsuu-483	dve ca triṃśat tathaitāni lakṣaṇāni mahāmuneḥ	dve ca triṃśat tathā etāni lakṣaṇāni mahā muneḥ 
SA_K14_mavadsuu-484	kāye'smiṃ bhāvitātmasya śarīrāntimadhāriṇaḥ 11	bhāvitātmasya śarīra antima dhāriṇaḥ 
SA_K14_mavadsuu-485	dvātriṃśatiṃ yasya vivardhitāni	dvātriṃśatim yasya vivardhitāni 
SA_K14_mavadsuu-486	bhavaṃti kāye 'smiṃ X _ vidhasya /	bhavanti kāye smin x 
SA_K14_mavadsuu-487	rājā vijitya pṛthivīṃ viśāsti	rājā vijitya pṛthivīm viśāsti 
SA_K14_mavadsuu-488	buddho 'tha vā bhavati hitānukampī 12	buddhaḥ vā bhavati hita anukampī 
SA_K14_mavadsuu-489	smṛtimāṃ bahuputraś ca alpābādhaś ca paṇḍitaḥ	smṛtimān bahu putraḥ ca alpa ābādhaḥ ca paṇḍitaḥ 
SA_K14_mavadsuu-490	lābhī annasya pānasya vastraśayyāsanasya ca 13	lābhī annasya pānasya vastra śayyā āsanasya ca 
SA_K14_mavadsuu-491	abhedyaparivāro 'sau manāpaḥ sarvadehinām	abhedya parivāraḥ sau manāpaḥ sarva dehinām 
SA_K14_mavadsuu-492	anvāvartanti taṃ devā manujāś ca tathāvidham 14	anvāvartanti tam devāḥ manujāḥ ca tathāvidham 
SA_K14_mavadsuu-493	agryo mahādhipatyeṣu bhaven martyas tathāvidhaḥ	agryaḥ mahā ādhipatyeṣu bhavet martyaḥ tathāvidhaḥ 
SA_K14_mavadsuu-494	asamaś cāpratisama atulyaś ca vināyaka 15	asamaḥ ca apratisamaḥ atulyaḥ ca vināyaka 
SA_K14_mavadsuu-495	3. His Mother Passes Away	his mothr passes away 
SA_K14_mavadsuu-496	dharmatā khalu saptāhajātasya Vipaśyino bodhisatvasya mātā janetrī kālagatā samanantarakālagatā tridaśe devanikāye upapannā iyam atra dharmatā  #	dharmatā khalu sapta aha jātasya vipaśyinaḥ bodhisatvasya mātā janetrī kālagatā samanantara kālagatā tridaśe devanikāye upapannā iyam atra dharmatā 
SA_K14_mavadsuu-497	tasmād idam ucyate //	tasmāt idam ucyate 
SA_K14_mavadsuu-498	vidhṛtya māsāṃ hi daśaiva kukṣyā	vidhṛtya māsām hi daśa eva kukṣyā 
SA_K14_mavadsuu-499	Vipaśyimātā asamaṃ prajātā /	vipaśyi mātar asamam prajātā 
SA_K14_mavadsuu-500	kāyasya bhedāt tridaśopapannā	kāyasya bhedāt tridaśā upapannā 
SA_K14_mavadsuu-501	devanikāyā bhagavajjanetrī //	        
SA_K14_mavadsuu-502	4. The Physical Beauty of the Bodhisattva	the physical beauty of the bodhisattva 
SA_K14_mavadsuu-503	dharmatā khalu sāṃpratajāto Vipaśyī bodhisatvo 'bhirūpo darśanīya prāsādiko 'tikrāntaś	dharmatā khalu sāṃprata jātaḥ vipaśyī bodhisatvaḥ abhirūpaḥ darśanīya 
SA_K14_mavadsuu-504	ca mānuṣyakaṃ varṇam asaṃprāptaś ca divyaṃ varṇaṃ nirīkṣamāṇā narāś ca nāryaś ca	ca mānuṣyakam varṇam a saṃprāptaḥ ca divyam varṇam nirīkṣamāṇāḥ narāḥ ca nāryaḥ ca 
SA_K14_mavadsuu-505	tṛptiṃ na gacchaṃti anūnavarṇam tadyathā jāṃbūnadamayī suvarṇaniṣkā dakṣakarmāraputraparimṛṣṭā	tṛptim na gacchanti anūna varṇam tat yathā jāṃbūnada mayī suvarṇa niṣkā dakṣa karmāra putra parimṛṣṭā 
SA_K14_mavadsuu-506	āhate pāṇḍukambale upanikṣiptā atyarthaṃ bhāsate tapate virocate evam eva sāṃpratajāto	āhate pāṇḍu kambale upanikṣiptā atyartham bhāsate tapate virocate evam eva sāṃprata jātaḥ 
SA_K14_mavadsuu-507	Vipaśyī bodhisatvo 'bhirūpo darśanīyo yāvad anūnavarṇam iyam atra dharmatā tasmād idam ucyate //	vipaśyī bodhisatvaḥ bhirūpaḥ darśanīyaḥ yāvat anūna varṇam iyam atra dharmatā tasmāt idam ucyate 
SA_K14_mavadsuu-508	śiśu kumāro manaseva nirmitaḥ	śiśu kumāraḥ manasā iva nirmitaḥ 
SA_K14_mavadsuu-509	yathāpi niṣkā kuśalena niṣṭhitā /	yathā api niṣkā kuśalena niṣṭhitā 
SA_K14_mavadsuu-510	nirīkṣamāṇā hi narāś ca nāryas	nirīkṣamāṇāḥ hi narāḥ ca nāryaḥ 
SA_K14_mavadsuu-511	tṛptiṃ na gacchaṃti anūnavarṇam //	tṛptim na gacchanti anūna varṇam 
SA_K14_mavadsuu-512	5. The Attractiveness of the Bodhisattva	the attractiveness of the bodhisattva 
SA_K14_mavadsuu-513	dharmatā khalu sāṃpratajāto Vipaśyī bodhisatvo mahājanakāyasya priyaś cābhūn manāpaś ca apīdānīṃ mahājanakāyā aṃsenāṃsaṃ (MAV 90)	dharmatā khalu sāṃprata jātaḥ vipaśyī bodhisatvaḥ mahā jana kāyasya priyaḥ ca abhūt manāpaḥ ca api idānīm mahā jana kāyāḥ aṃsena aṃsam 
SA_K14_mavadsuu-514	parivartayaṃti tadyathā śāradakaṃ padmaṃ mahājanakāyasya priyaṃ ca bhavati manāpaṃ	parivartayaṃti tat yathā śāradakam padmam mahā jana kāyasya priyam ca bhavati manāpam 
SA_K14_mavadsuu-515	ca apīdānīṃ mahājanakāyaḥ pāṇinā pāṇiṃ saṃvārayati evam eva sāṃpratajāto Vipaśyī	ca api idānīm mahā jana kāyaḥ pāṇinā pāṇim saṃvārayati evam eva sāṃprata jātaḥ vipaśyī 
SA_K14_mavadsuu-516	bodhisatvo mahājanakāyasya priyaś cābhūn manāpaś ca apīdānīṃ mahājanakāyaḥ aṃsenāṃsaṃ	bodhisatvaḥ mahā jana kāyasya priyaḥ ca abhūt manāpaḥ ca api idānīm mahā jana kāyaḥ aṃsena aṃsam 
SA_K14_mavadsuu-517	parivartayati iyam atra dharmatā tasmād idam ucyate //	parivartayati iyam atra dharmatā tasmāt idam ucyate 
SA_K14_mavadsuu-518	priyo manāpo mahato janasya	priyaḥ manāpaḥ mahataḥ janasya 
SA_K14_mavadsuu-519	tadā Vipaśyī daharas samānaḥ	tadā vipaśyī daharaḥ samānaḥ 
SA_K14_mavadsuu-520	aṃsena cāṃsaṃ parivartayaṃti	aṃsena ca aṃsam parivartayanti 
SA_K14_mavadsuu-521	padmaṃ yathā śāradakaṃ sujātam //	padmam yathā śāradakam su jātam 
SA_K14_mavadsuu-522	[The Bodhisattva's Youth]	the bodhisattvas youth 
SA_K14_mavadsuu-523	6. The Bodhisattva's Eyes Do Not Blink	the bodhisattvas eyes do not blink 
SA_K14_mavadsuu-524	dharmatā khalu Vipaśyī bodhisatvo 'nimiṣo rūpāṇi paśyati na nimiṣati /	dharmatā khalu vipaśyī bodhisatvaḥ nimiṣaḥ rūpāṇi paśyati na nimiṣati 
SA_K14_mavadsuu-525	tadyathā devās tridaśopapannakā iyam atra dharmatā tasmād idam ucyate //	tat yathā devāḥ tridaśa upapannakāḥ iyam atra dharmatā tasmāt idam ucyate 
SA_K14_mavadsuu-526	nāsau kumāro nimiṣaṃ hi paśyati	na asau kumāraḥ nimiṣam hi paśyati 
SA_K14_mavadsuu-527	yathāpi devās tridaśopapannakāḥ	yathā api devāḥ tridaśa upapannakāḥ 
SA_K14_mavadsuu-528	dṛṣṭveha rūpāṇi manoramāṇi	dṛṣṭvā iha rūpāṇi manoramāṇi 
SA_K14_mavadsuu-529	athāpi dṛṣṭvā amanoramāṇi //	atha api dṛṣṭvā amanoramāṇi 
SA_K14_mavadsuu-530	7. His Maturation	his maturation 
SA_K14_mavadsuu-531	dharmatā khalu Vipaśyī bodhisatvaḥ karmavipākajena divyena cakṣuṣā samanvāgato yena sa paśyati divā ca rātrau ca samaṃtayojanam iyam atra dharmatā  #	dharmatā khalu vipaśyī bodhisatvaḥ karma vipāka jena divyena cakṣuṣā samanvāgataḥ yena sa paśyati divā ca rātrau ca samaṃta yojanam iyam atra dharmatā 
SA_K14_mavadsuu-532	tasmād idam ucyate //	tasmāt idam ucyate 
SA_K14_mavadsuu-533	vipākajaṃ tasya babhūva cakṣur	vipāka jam tasya babhūva cakṣuḥ 
SA_K14_mavadsuu-534	divyaṃ viśuddhaṃ vimalaṃ prabhāsvaram	divyam viśuddham vimalam prabhāsvaram 
SA_K14_mavadsuu-535	yenāsau paśyati bodhisatvo	yena asau paśyati bodhisatvaḥ 
SA_K14_mavadsuu-536	divā ca rātrau ca samantayojanam //	divā ca rātrau ca samanta yojanam 
SA_K14_mavadsuu-537	8. The Beauty of His Voice	the beauty of his voice 
SA_K14_mavadsuu-538	dharmatā khalu Vipaśyī bodhisatvo valgusvaraś cābhūn manojñasvaraś ca kalaviṅkamanojñabhāṣī	dharmatā khalu vipaśyī bodhisatvaḥ valgu svaraḥ ca abhūt manojña svaraḥ ca kalaviṅka manojña bhāṣī 
SA_K14_mavadsuu-539	ca dundubhisvaranirghoṣaś ca tadyathā haimavataḥ śakunto valgusvaraś cābhūn manojñasvaraś	ca dundubhi svara nirghoṣaḥ ca tat yathā haimavataḥ śakuntaḥ valgu svaraḥ ca abhūt manojña svaraḥ 
SA_K14_mavadsuu-540	ca kalaviṅkamanojñabhāṣī ca dundubhisvaranirghoṣaś ca evam eva Vipaśyī bodhisatvo	ca kalaviṅka manojña bhāṣī ca dundubhi svara nirghoṣaḥ ca evam eva vipaśyī bodhisatvaḥ 
SA_K14_mavadsuu-541	valgusvaraś cābhūn manojñasvaraś ca kalaviṅkamanojñabhāṣī ca dundubhisvaranirghoṣaś	valgu svaraḥ ca abhūt manojña svaraḥ ca kalaviṅka manojña bhāṣī ca dundubhi svara nirghoṣaḥ 
SA_K14_mavadsuu-542	ca iyam atra dharmatā tasmād idam ucyate //	ca iyam atra dharmatā tasmāt idam ucyate 
SA_K14_mavadsuu-543	yathāpy asau haimavataḥ śakunto	yathā api asau haimavataḥ śakunto 
SA_K14_mavadsuu-544	nikūjate kusumarasena mattaḥ	nikūjate kusuma rasena mattaḥ 
SA_K14_mavadsuu-545	tathaiva valgukalaviṅkabhāṣī	tathā eva valgu kalaviṅka bhāṣī 
SA_K14_mavadsuu-546	sa cāpy abhūd apratikūlabhāṣī //	sa ca api abhūt a pratikūla bhāṣī 
SA_K14_mavadsuu-547	9. Becoming Sagacious	becaming sagacious 
SA_K14_mavadsuu-548	dharmatā khalu Vipaśyī bodhisatvaḥ paṇḍito 'bhūd vyakto medhāvī tantropamikayā mīmāṃsikayā	dharmatā khalu vipaśyī bodhisatvaḥ paṇḍitaḥ bhūt vyaktaḥ medhāvī tantropamikayā mīmāṃsikayā 
SA_K14_mavadsuu-549	prajñayā samanvāgataḥ apīdānīṃ pitur Bandhumato 'rthakaraṇe niṣadya gambhīrān arthān	prajñayā samanvāgataḥ api idānīm pituḥ bandhumataḥ ṛtha karaṇe niṣadya gambhīrān arthān 
SA_K14_mavadsuu-550	nistārayati iyam atra dharmatā tasmād idam ucyate //	nistārayati iyam atra dharmatā tasmāt idam ucyate 
SA_K14_mavadsuu-551	X _ ^ toyāmbudhara iva sāgaraḥ	toya ambudharaḥ iva sāgaraḥ 
SA_K14_mavadsuu-552	anuśiṣṭavān	anuśiṣṭavān 
SA_K14_mavadsuu-553	Bandhumatīnikete	bandhumatī nikete 
SA_K14_mavadsuu-554	naikāṃ janāṃ jānapadāṃś ca kṣatriyān 1	na ekām janām jānapadān ca kṣatriyān 
SA_K14_mavadsuu-555	hitānukampaṃ sam ^ _ ^ _ ^ X	hita anukampam sam 
SA_K14_mavadsuu-556	X _ ^ _ _ ^ ^ _ ^ _ daḥ	xc-3 di-3 ro-0
SA_K14_mavadsuu-557	tataḥ samājñā udapādi bhadrikā	tatas samājñā udapādi bhadrikā 
SA_K14_mavadsuu-558	bhūyo Vipaśyīti samaṃtacakṣuḥ 2 //	bhūyas vipaśyi iti samaṃta cakṣuḥ 
SA_K14_mavadsuu-559	10. The Four Excursions	the four excursions 
SA_K14_mavadsuu-560	[On Seeing an Old Man]	on seeing an old man 
SA_K14_mavadsuu-561	dharmatā khalu Vipaśyī bodhisatva udyānabhūmiṃ niryātukāmaḥ sārathim āmantrayati	dharmatā khalu vipaśyī bodhisatvaḥ udyāna bhūmim niryātu kāmaḥ sārathim āmantrayati 
SA_K14_mavadsuu-562	yojaya sārathe kṣipraṃ bhadraṃ yānam udyānabhūmiṃ niryāsyāmi	yojaya sārathe kṣipram bhadram yānam udyāna bhūmim niryāsyāmi 
SA_K14_mavadsuu-563	evaṃ deveti sārathir Vipaśyino bodhisatvasya pratiśrutya kṣipraṃ bhadraṃ yānaṃ yojayitvā	evam deva iti sārathiḥ vipaśyinaḥ bodhisatvasya pratiśrutya kṣipram bhadram yānam yojayitvā 
SA_K14_mavadsuu-564	yena Vipaśyī bodhisatvas tenopajagāma upetya Vipaśyinaṃ bodhisatvam idam avocat yuktaṃ	yena vipaśyī bodhisatvaḥ tena upajagāma upetya vipaśyinam bodhisatvam idam avocat yuktam 
SA_K14_mavadsuu-565	devasya bhadraṃ yānaṃ yasyedānīṃ devaḥ kālaṃ manyate /	devasya bhadram yānam yasya idānīm devaḥ kālam manyate 
SA_K14_mavadsuu-566	atha Vipaśyī bodhisatvo bhadraṃ yānam abhiruhyodyānabhūmiṃ niryāti adrākṣīd Vipaśyī	atha vipaśyī bodhisatvaḥ bhadram yānam abhiruhya udyāna bhūmim niryāti adrākṣīt vipaśyī 
SA_K14_mavadsuu-567	bodhisatva udyānabhūmiṃ niryāyaṃ puruṣaṃ kubjaṃ gopānasīvaṅgaṃ daṇḍam avaṣṭabhya	bodhisatvaḥ udyāna bhūmim niryāyam puruṣam kubjam gopānasī vaṅgam daṇḍam avaṣṭabhya 
SA_K14_mavadsuu-568	purataḥ pravepamānena kāyena gacchantam dṛṣṭvā ca punaḥ sārathim āmaṃtrayati	puratas pravepamānena kāyena gacchantam dṛṣṭvā ca punar sārathim āmaṃtrayati 
SA_K14_mavadsuu-569	kim eṣa sārathe puruṣaḥ kubjo gopānasīvaṅka daṇḍam avaṣṭabhya purataḥ pravepamānena kāyena gacchati keśāś cāsya vivarṇā na tathānyeṣām	kim eṣa sārathe puruṣaḥ kubjaḥ gopānasī vaṅka daṇḍam avaṣṭabhya puratas pravepamānena kāyena gacchati keśāḥ ca asya vivarṇāḥ na tathā anyeṣām 
SA_K14_mavadsuu-570	eṣa deva puruṣo jīrṇo nāma	eṣa deva puruṣaḥ jīrṇaḥ nāma 
SA_K14_mavadsuu-571	kim eṣa sārathe jīrṇo nāma	kim eṣa sārathe jīrṇaḥ nāma 
SA_K14_mavadsuu-572	anena deva puruṣeṇa na cirāṃ martavyaṃ bhaviṣyati sa eṣa deva jīrṇo nāma	anena deva puruṣeṇa na cirām martavyam bhaviṣyati saḥ eṣa deva jīrṇaḥ nāma 
SA_K14_mavadsuu-573	aham api sārathe jarādharmā jarādharmatāṃ cānatītaḥ	aham api sārathe jarā dharmā jarā dharma tām ca anatītaḥ 
SA_K14_mavadsuu-574	devo 'pi jarādharmā jarādharmatāṃ cānatītaḥ	devaḥ pi jarā dharmā jarā dharma tām ca anatītaḥ 
SA_K14_mavadsuu-575	tenahi sārathe pratinivartaya ratham aṃtaḥpuram eva gaccha yad aham aṃtaḥpuramadhyagata etam evārthaṃ cintayiṣyāmi jarāṃ kilāham avyativṛttaḥ	tena hi sārathe pratinivartaya ratham aṃtaḥpuram eva gaccha yat aham aṃtaḥpura madhya gataḥ etam eva artham cintayiṣyāmi jarām kila aham a vyativṛttaḥ 
SA_K14_mavadsuu-576	pratinivartayati sārathī ratham antaḥpuram eva yāti tatredānīṃ Vipaśyī bodhisatvo 'ntaḥpuramadhyagataḥ	pratinivartayati sārathiḥ ratham antaḥpuram eva yāti tatra idānīm vipaśyī bodhisatvaḥ ntaḥpura madhya gataḥ 
SA_K14_mavadsuu-577	athāpratītaḥ karuṇāni dhyāti jarāṃ kilāham avyativṛtta iyam atra dharmatā tasmād idam ucyate / /	atha apratītaḥ karuṇāni dhyā ati jarām kila aham a vyativṛttaḥ iyam atra dharmatā tasmāt idam ucyate 
SA_K14_mavadsuu-578	puruṣaṃ dṛṣṭveha vyatītayauvanaṃ	puruṣam dṛṣṭvā iha vyatīta yauvanam 
SA_K14_mavadsuu-579	jīrṇāturaṃ palitaṃ daṇḍapāṇim	jīrṇa āturam palitam daṇḍa pāṇim 
SA_K14_mavadsuu-580	athāpratītaḥ karuṇāni dhyāti	atha apratītaḥ karuṇāni dhyāti 
SA_K14_mavadsuu-581	jarāṃ kilāhaṃ nopātivṛttaḥ //	jarām kila aham na upātivṛttaḥ 
SA_K14_mavadsuu-582	[The King's Perturbation 1]	the kings perturbation 
SA_K14_mavadsuu-583	atha Bandhumā rājā sārathim āmantrayati	atha bandhumāḥ rājā sārathim āmantrayati 
SA_K14_mavadsuu-584	kaccit sārathe kumāra āptamanaska udyānabhūmiṃ gataḥ abhirato vā udyāne	kaccit sārathe kumāraḥ āpta manaskaḥ udyāna bhūmim gataḥ abhirataḥ vā udyāne 
SA_K14_mavadsuu-585	no deva / adrākṣīd deva kumāra udyānabhūmiṃ niryāyaṃ puruṣaṃ kubjaṃ gopānasīvaṅkaṃ daṇḍam avaṣṭabhya purataḥ pravepamānena kāyena gacchantaṃ	no deva adrākṣīt deva kumāraḥ udyāna bhūmim niryāyam puruṣam kubjam gopānasī vaṅkam daṇḍam avaṣṭabhya puratas pravepamānena kāyena gacchantam 
SA_K14_mavadsuu-586	dṛṣṭvā ca punar mām āmaṃtrayati kim eṣa sārathe puruṣaḥ kubjo gopānasīvaṅko daṇḍam	dṛṣṭvā ca punar mām āmaṃtrayati kim eṣa sārathe puruṣaḥ kubjaḥ gopānasī vaṅkaḥ daṇḍam 
SA_K14_mavadsuu-587	avaṣṭabhya purataḥ pravepamānena kāyena gacchati keśāś cāsya vivarṇā na tathānyeṣāṃ tam enam (MAV 100)	avaṣṭabhya puratas pravepamānena kāyena gacchati keśāḥ ca asya vivarṇāḥ na tathā anyeṣām tam enam 
SA_K14_mavadsuu-588	evaṃ vadāmi eṣa deva puruṣo jīrṇo nāma sa evam āha kim eṣa sārathe jīrṇo nāma tam	evam vadāmi eṣa deva puruṣaḥ jīrṇaḥ nāma saḥ evam āha kim eṣa sārathe jīrṇaḥ nāma tam 
SA_K14_mavadsuu-589	enam evaṃ vadāmi anena deva puruṣeṇa na cirā martavyaṃ bhaviṣyati sa eṣa deva jīrṇo	enam evam vadāmi anena deva puruṣeṇa na cirā martavyam bhaviṣyati saḥ eṣa deva jīrṇaḥ 
SA_K14_mavadsuu-590	nāma sa evam āha aham api sārathe jarādharmā jarādharmatāṃ cānatītaḥ tam enam evaṃ	nāma saḥ evam āha aham api sārathe jarā dharmā jarā dharma tām ca anatītaḥ tam enam evam 
SA_K14_mavadsuu-591	vadāmi devo 'pi jarādharmā jarādharmatāṃ cānatītaḥ sa evam āha tena hi sārathe pratinivartaya	vadāmi jarā dharmā jarā dharma tām ca anatītaḥ saḥ evam āha tena hi sārathe pratinivartaya 
SA_K14_mavadsuu-592	ratham antaḥpuram eva gaccha yad aham antaḥpuramadhyagata etam evārthaṃ cintayiṣyāmi	ratham antaḥpuram eva gaccha yat aham antaḥpura madhya gataḥ etam eva artham cintayiṣyāmi 
SA_K14_mavadsuu-593	jarāṃ kilāham avyativṛttaḥ sa eṣa deva kumāra antaḥpuramadhyagata athāpratītaḥ karuṇāni	jarām kila aham a vyativṛttaḥ saḥ eṣa deva kumāra antaḥpura madhya gata atha apratītaḥ karuṇāni 
SA_K14_mavadsuu-594	dhyāti jarāṃ kilāham avyativṛttaḥ	dhyā ati jarām kila aham a vyativṛttaḥ 
SA_K14_mavadsuu-595	atha Bandhumato rājña etad abhavan mā haiva brāhmaṇānāṃ naimittānāṃ vivañcanānāṃ	atha bandhumataḥ rājñaḥ etat abhavat mā ha eva brāhmaṇānām naimittānām vivañcanānām 
SA_K14_mavadsuu-596	vacanaṃ bhūtaṃ satyaṃ bhaviṣyati mā haiva kumāraḥ keśaśmaśrūṇy avatārya kāṣāyāṇi	vacanam bhūtam satyam bhaviṣyati mā ha eva kumāraḥ keśa śmaśrūṇi avatārya kāṣāyāṇi 
SA_K14_mavadsuu-597	vastrāṇy ācchādya samyag eva śraddhayā agārād anagārikāṃ pravrajiṣyati yanv aham	vastrāṇi ācchādya samyak eva śraddhayā agārāt anagārikām pravrajiṣyati yanu aham 
SA_K14_mavadsuu-598	asya bhūyasyā mātrayā pañca kāmaguṇān anupradadyām apy eva rato na pravrajeta /	asya bhūyasyā mātrayā pañca kāma guṇān anupradadyām api eva rataḥ na pravrajeta 
SA_K14_mavadsuu-599	atha Bandhumā rājā Vipaśyine bodhisatvāya bhūyasyā mātrayā pañca kāmaguṇān anuprayacchati apy eva rato na pravrajeta iyam atra dharmatā tasmād  #	atha bandhumāḥ rājā vipaśyine bodhisatvāya bhūyasyā mātrayā pañca kāmaguṇān anuprayacchati api eva rataḥ na pravrajeta iyam atra dharmatā tasmāt 
SA_K14_mavadsuu-600	idam ucyate //	idam ucyate 
SA_K14_mavadsuu-601	śrutvā sa saṃgrāhakavākyam evaṃ	śrutvā sa saṃgrāhaka vākyam evam 
SA_K14_mavadsuu-602	pitā Vipaśyisya priyasya Bandhumā /	pitā vipaśyisya priyasya bandhumā 
SA_K14_mavadsuu-603	dadau tataḥ kāmaguṇāṃ hi paṃca	dadau tatas kāma guṇām hi paṃca 
SA_K14_mavadsuu-604	rato hy asau yeṣu na pravrajeta //	rataḥ hi asau yeṣu na pravrajeta 
SA_K14_mavadsuu-605	[On Seeing a Sick Man]	on seeing a sick man 
SA_K14_mavadsuu-606	dharmatā khalu Vipaśyī bodhisatva udyānabhūmiṃ niryātukāmaḥ sārathim āmaṃtrayati pūrvavad yāvad	dharmatā khalu vipaśyī bodhisatvaḥ udyāna bhūmim niryātu kāmaḥ sārathim āmaṃtrayati pūrvavat yāvat 
SA_K14_mavadsuu-607	adrākṣīd Vipaśyī bodhisatva udyānabhūmiṃ niryāyaṃ puruṣam utpāṇḍūtpāṇḍukaṃ kṛśaṃ	adrākṣīt vipaśyī bodhisatvaḥ udyāna bhūmim niryāyam puruṣam utpāṇḍu utpāṇḍukam kṛśam 
SA_K14_mavadsuu-608	rukṣaṃ durvarṇaṃ vyatibhinnendriyaṃ no ca nibandhanīyaṃ bahujanasya cakṣuṣo darśanāya	rukṣam durvarṇam vyatibhinna indriyam no ca nibandhanīyam bahu janasya cakṣuṣaḥ darśanāya 
SA_K14_mavadsuu-609	dṛṣṭvā ca punaḥ sārathim āmantrayati	dṛṣṭvā ca punar sārathim āmantrayati 
SA_K14_mavadsuu-610	kim eṣa sārathe puruṣa utpaṇḍūtpāṇḍukaḥ kṛśa rukṣo durvarṇa vyatibhinnendriya no ca nibandhanīyo bahujanasya cakṣuṣo darśanāya	kim eṣa sārathe puruṣaḥ utpaṇḍu utpāṇḍukaḥ kṛśa rukṣaḥ durvarṇa vyatibhinna indriya no ca nibandhanīyaḥ bahu janasya cakṣuṣaḥ darśanāya 
SA_K14_mavadsuu-611	eṣa deva puruṣo vyādhito nāma	eṣa deva puruṣaḥ vyādhitaḥ nāma 
SA_K14_mavadsuu-612	kim eṣa sārathe vyādhito nāma	kim eṣa sārathe vyādhitaḥ nāma 
SA_K14_mavadsuu-613	anena deva puruṣeṇa sthānam etad vidyate yad anenaivābādhena martavyaṃ bhaviṣyati sa eṣa deva vyādhito nāma	anena deva puruṣeṇa sthānam etat vidyate yat anena eva ābādhena martavyam bhaviṣyati saḥ eṣa deva vyādhitaḥ nāma 
SA_K14_mavadsuu-614	aham api sārathe vyādhidharmā vyādhidharmatāṃ cānatītaḥ	aham api sārathe vyādhi dharmā vyādhi dharma tām ca anatītaḥ 
SA_K14_mavadsuu-615	devo'pi vyādhidharmā vyādhidharmatāṃ cānatītaḥ	devaḥ api vyādhi dharmā vyādhi dharma tām ca anatītaḥ 
SA_K14_mavadsuu-616	tena hi sārathe pratinivartaya ratham antaḥpuram eva gaccha yad aham antaḥpuramadhyagata etam evārthaṃ cintayiṣyāmi vyādhiṃ kilāham avyativṛttaḥ	tena hi sārathe pratinivartaya ratham antaḥpuram eva gaccha yat aham antaḥpura madhya gataḥ etam eva artham cintayiṣyāmi vyādhim kila aham a vyativṛttaḥ 
SA_K14_mavadsuu-617	pratinivartayati sārathī ratham antaḥpuram eva yāti tatredānīṃ Vipaśyī bodhisatva antaḥpuramadhyagata	pratinivartayati sārathiḥ ratham antaḥpuram eva yāti tatra idānīm vipaśyī bodhisatva antaḥpura madhya gata 
SA_K14_mavadsuu-618	athāpratītaḥ karuṇāni dhyāti vyādhiṃ kilāham avyativṛttaḥ iyam atra dharmatā tasmād idam ucyate //	atha apratītaḥ karuṇāni vyādhim kila aham a vyativṛttaḥ iyam atra dharmatā tasmāt idam ucyate 
SA_K14_mavadsuu-619	dṛṣṭveha rogeṇa viṣaktarūpaṃ	dṛṣṭvā iha rogeṇa viṣakta rūpam 
SA_K14_mavadsuu-620	pāṇḍuṃ manuṣyaṃ kṛśam asvatantram	pāṇḍum manuṣyam kṛśam asvatantram 
SA_K14_mavadsuu-621	athāpratītaḥ karuṇāni dhyāti	atha apratītaḥ karuṇāni dhyāti 
SA_K14_mavadsuu-622	vyādhiṃ kilāhaṃ nopātivṛtta //	vyādhim kila aham na upātivṛtta 
SA_K14_mavadsuu-623	[The King's Perturbation 2]	the kings perturbation 
SA_K14_mavadsuu-624	atha Bandhumā rājā sārathim āmaṃtrayati	atha bandhumāḥ rājā sārathim āmaṃtrayati 
SA_K14_mavadsuu-625	kaccit sārathe kumāra āptamanaska udyānabhūmiṃ gata abhirato vā udyāne	kaccit sārathe kumāraḥ āpta manaskaḥ udyāna bhūmim gata abhirataḥ vā udyāne 
SA_K14_mavadsuu-626	no deva adrākṣīd deva kumāra udyānabhūmiṃ niryāyaṃ puruṣam utpāṇḍūtpāṇḍukaṃ kṛśaṃ	na u deva adrākṣīt deva kumāraḥ udyāna bhūmim niryāyam puruṣam utpāṇḍu utpāṇḍukam kṛśam 
SA_K14_mavadsuu-627	rukṣaṃ durvarṇaṃ vyatibhinnendriyaṃ no ca nibandhanīyaṃ bahujanasya cakṣuṣo darśanāya	rukṣam durvarṇam vyatibhinna indriyam no ca nibandhanīyam bahu janasya cakṣuṣaḥ darśanāya 
SA_K14_mavadsuu-628	dṛṣṭvā ca punar mām āmaṃtrayati kim eṣa sārathe puruṣa utpāṇḍūtpāṇḍukaḥ kṛśa rukṣa	dṛṣṭvā ca punar mām āmaṃtrayati kim eṣa sārathe puruṣaḥ utpāṇḍu utpāṇḍukaḥ kṛśa rukṣa 
SA_K14_mavadsuu-629	durvarṇa vyatibhinnendriya no ca nibandhanīya bahujanasya cakṣuṣo darśanāya tam enam	durvarṇa vyatibhinna indriya no ca nibandhanīya bahu janasya cakṣuṣaḥ darśanāya tam enam 
SA_K14_mavadsuu-630	evaṃ vadāmi eṣa deva puruṣo vyādhito nāma sa evam āha kim eṣa sārathe vyādhito nāma	evam vadāmi eṣa deva puruṣaḥ vyādhitaḥ nāma saḥ evam āha kim eṣa sārathe vyādhitaḥ nāma 
SA_K14_mavadsuu-631	tam enam evaṃ vadāmi anena deva puruṣeṇa sthānam etad vidyate yad anenaivābādhena	tam enam evam vadāmi anena deva puruṣeṇa sthānam etat vidyate yat anena eva ābādhena 
SA_K14_mavadsuu-632	martavyaṃ bhaviṣyati sa eṣa deva vyādhito nāma sa evam āha aham api sārathe vyādhidharmā	martavyam bhaviṣyati saḥ eṣa deva vyādhitaḥ nāma saḥ evam āha aham api sārathe vyādhi dharmā 
SA_K14_mavadsuu-633	vyādhidharmatāṃ cānatītaḥ tam enam evaṃ vadāmi devo 'pi vyādhidharmā vyādhidharmatāṃ	vyādhi dharma tām ca anatītaḥ tam enam evam vadāmi vyādhi dharmā vyādhi dharma tām 
SA_K14_mavadsuu-634	cānatītaḥ sa evam āha tena hi sārathe pratinivartaya (MAV 108)	ca anatītaḥ saḥ evam āha tena hi sārathe pratinivartaya 
SA_K14_mavadsuu-635	ratham antaḥpuram eva gaccha yad aham antaḥpuramadhyagata etam evārthaṃ cintayiṣyāmi	ratham antaḥpuram eva gaccha yat aham antaḥpura madhya gataḥ etam eva artham cintayiṣyāmi 
SA_K14_mavadsuu-636	vyādhiṃ kilāham avyativṛttaḥ sa eṣa deva kumāra antaḥpuramadhyagataḥ athāpratītaḥ	vyādhim kila aham a vyativṛttaḥ saḥ eṣa deva kumāra antaḥpura madhya gataḥ atha apratītaḥ 
SA_K14_mavadsuu-637	karuṇāni dhyāti vyādhiṃ kilāham avyativṛttaḥ	karuṇāni dhyā ati vyādhim kila aham a vyativṛttaḥ 
SA_K14_mavadsuu-638	atha Bandhumato rājña etad abhavaṃ mā haiva brāhmaṇānāṃ naimittānāṃ pūrvavat iyam atra dharmatā tasmād idam ucyate //	atha bandhumataḥ rājñaḥ etat abhavam mā ha eva brāhmaṇānām naimittānām pūrvavat iyam atra dharma tā tasmāt idam ucyate 
SA_K14_mavadsuu-639	rūpāṇi śabdāṃś ca tathaiva gandhāṃ	rūpāṇi śabdān ca tathā eva gandhān 
SA_K14_mavadsuu-640	rasān atha sparśaguṇopapannāṃ /	rasān atha sparśa guṇa upapannām 
SA_K14_mavadsuu-641	dadau tataḥ kāmaguṇāṃ hi pañca	dadau tatas kāma guṇām hi pañca 
SA_K14_mavadsuu-642	rato hy asau yeṣu na pravrajeta //	rataḥ hi asau yeṣu na pravrajeta 
SA_K14_mavadsuu-643	[Seeing a Corpse]	seeing a corpse 
SA_K14_mavadsuu-644	dharmatā khalu Vipaśyī bodhisatva udyānabhūmiṃ niryātukāma sārathim āmaṃtrayati pūrvavad	dharmatā khalu vipaśyī bodhisatvaḥ udyāna bhūmim niryātu kāma sārathim āmaṃtrayati pūrvavat 
SA_K14_mavadsuu-645	adrākṣīd Vipaśyī bodhisatva udyānabhūmiṃ niryāyan nānāraṅgair vastraiś cailavitānaṃ	adrākṣīt vipaśyī bodhisatvaḥ udyāna bhūmim niryāyan nānā raṅgaiḥ vastraiḥ caila vitānam 
SA_K14_mavadsuu-646	vitataṃ śivikā ca pragṛhītā ulkā ca purato nīyate mahājanakāyaś ca purato gacchati	vitatam śivikā ca pragṛhītā ulkā ca puratas nīyate mahā jana kāyaḥ ca puratas gacchati 
SA_K14_mavadsuu-647	nāryaś ca prakīrṇakeśyo (MAV 110)	nāryaḥ ca prakīrṇa keśyaḥ mau 
SA_K14_mavadsuu-648	rudantyaḥ pṛṣṭhataḥ pṛṣṭhataḥ samanubaddhā dṛṣṭvā ca punaḥ sārathim āmaṃtrayati	rudantyaḥ pṛṣṭhatas pṛṣṭhatas samanubaddhāḥ dṛṣṭvā ca punar sārathim āmaṃtrayati 
SA_K14_mavadsuu-649	kim etat sārathe nānāraṅgair vastraiś cailavitānaṃ vitataṃ śivikā ca pūrvavat pṛṣṭhataḥ pṛṣṭhataḥ samanubaddhā	kim etat sārathe nānā raṅgaiḥ vastraiḥ caila vitānam vitatam śivikā ca pūrvavat pṛṣṭhatas pṛṣṭhatas samanubaddhā 
SA_K14_mavadsuu-650	eṣa deva puruṣo mṛto nāma	eṣa deva puruṣaḥ mṛtaḥ nāma 
SA_K14_mavadsuu-651	kim eṣa sārathe mṛto nāma	kim eṣa sārathe mṛtaḥ nāma 
SA_K14_mavadsuu-652	eṣa deva puruṣo na bhūyaḥ priyau mātāpitarau drakṣyati priyam api mātāpitarāv etaṃ puruṣaṃ na drakṣyataḥ sa eṣa deva mṛto nāma	eṣa deva puruṣaḥ na bhūyas priyau mātā pitarau drakṣyati priyam api mātā pitarau etam puruṣam na drakṣyataḥ saḥ eṣa deva mṛtaḥ nāma 
SA_K14_mavadsuu-653	aham api sārathe maraṇadharmā maraṇadharmatāñ cānatītaḥ	aham api sārathe maraṇa dharmā maraṇa dharma tām ca anatītaḥ 
SA_K14_mavadsuu-654	devo 'pi maraṇadharmā maraṇadharmatāñ cānatītaḥ	devaḥ pi maraṇa dharmā maraṇa dharma tām ca anatītaḥ 
SA_K14_mavadsuu-655	tenahi sārathe pratinivartaya ratham antaḥpuram eva gaccha yad aham antaḥpuramadhyagata etam evārthaṃ cintayiṣyāmi maraṇaṃ kilāham avyativṛttaḥ	tena hi sārathe pratinivartaya ratham antaḥpuram eva gaccha yat aham antaḥpura madhya gataḥ etam eva artham cintayiṣyāmi maraṇam kila aham a vyativṛttaḥ 
SA_K14_mavadsuu-656	pratinivartayati sārathī ratham antaḥpuram eva yāti tatredānīṃ Vipaśyī bodhisatva antaḥpuramadhyagata	pratinivartayati sārathiḥ ratham antaḥpuram eva yāti tatra idānīm vipaśyī bodhisatva antaḥpura madhya gata 
SA_K14_mavadsuu-657	athāpratītaḥ karuṇāni dhyāti maraṇaṃ kilāham avyativṛtta iyam atra dharmatā tasmād idam ucyate //	atha apratītaḥ karuṇāni dhyā ati maraṇam kila aham a vyativṛttaḥ iyam atra dharmatā tasmāt idam ucyate 
SA_K14_mavadsuu-658	puruṣaṃ dṛṣṭveha vyatītacetasaṃ	puruṣam dṛṣṭvā iha vyatīta cetasam 
SA_K14_mavadsuu-659	mṛtaṃ visaṃjñaṃ kṛtamāyuṣakṣayam	mṛtam visaṃjñam kṛtam āyuṣa kṣayam 
SA_K14_mavadsuu-660	athāpratītaḥ karuṇāni dhyāti	atha apratītaḥ karuṇāni dhyāti 
SA_K14_mavadsuu-661	maraṇaṃ kilāhaṃ nopātivṛtta //	maraṇam kila aham na upātivṛtta 
SA_K14_mavadsuu-662	[The King's Perturbation 3]	the kings perturbation 
SA_K14_mavadsuu-663	atha Bandhumā rājā sārathim āmaṃtrayati	atha bandhumāḥ rājā sārathim āmaṃtrayati 
SA_K14_mavadsuu-664	kaccit sārathe kumāra āptamanaska udyānabhūmiṃ gata abhirato vā udyane	kaccit sārathe kumāraḥ āpta manaskaḥ udyāna bhūmim gata abhirataḥ vā udyane 
SA_K14_mavadsuu-665	no deva adrākṣīd deva kumāra udyānabhūmiṃ niryāyaṃ nānāraṅgair vastraiś cailavitānaṃ	na u deva adrākṣīt deva kumāraḥ udyāna bhūmim niryāyam nānā raṅgaiḥ vastraiḥ caila vitānam 
SA_K14_mavadsuu-666	vitataṃ śivikā ca pūrvavad yāvat pṛṣṭhataḥ pṛṣṭhataḥ samanubaddhāḥ dṛṣṭvā ca punar	vitatam śivikā ca pūrvavat yāvat pṛṣṭhatas pṛṣṭhatas samanubaddhāḥ dṛṣṭvā ca punar 
SA_K14_mavadsuu-667	mām āmaṃtrayati kim etat sārathe nānāraṅgair vastraiś cailavitānaṃ vitataṃ śivikā	mām āmaṃtrayati kim etat sārathe nānā raṅgaiḥ vastraiḥ caila vitānam vitatam śivikā 
SA_K14_mavadsuu-668	ca pūrvavat pṛṣṭhataḥ pṛṣṭhataḥ samanubaddhā tam enam evaṃ vadāmi eṣa deva puruṣo	ca pūrvavat pṛṣṭhatas pṛṣṭhatas samanubaddhā tam enam evam vadāmi eṣa deva puruṣaḥ 
SA_K14_mavadsuu-669	mṛto nāma sa evam āha kim eṣa sārathe mṛto nāma tam enam evaṃ vadāmi eṣa deva puruṣo	mṛtaḥ nāma saḥ evam āha kim eṣa sārathe mṛtaḥ nāma tam enam evam vadāmi eṣa deva puruṣa 
SA_K14_mavadsuu-670	na bhūyaḥ priyau mātāpitarau drakṣyati priyam api mātāpitarau etaṃ puruṣaṃ na drakṣyata	na bhūyas priyau mātā pitarau drakṣyati priyam api mātā pitarau etam puruṣam na drakṣyata 
SA_K14_mavadsuu-671	sa eṣa deva mṛto nāma sa evam āha aham api sārathe maraṇadharmā maraṇadharmatāṃ cānatītaḥ	saḥ eṣa deva mṛtaḥ nāma saḥ evam āha aham api sārathe maraṇa dharmā maraṇa dharma tām ca anatītaḥ 
SA_K14_mavadsuu-672	tam enam evaṃ (MAV 114)	tam enam evam 
SA_K14_mavadsuu-673	vadāmi devo 'pi maraṇadharmā maraṇadharmatāṃ cānatītaḥ sa evam āha tena hi sārathe	vadāmi maraṇa dharmā maraṇa dharma tām ca anatītaḥ saḥ evam āha tena hi sārathe 
SA_K14_mavadsuu-674	pratinivartaya ratham antaḥpuram eva gaccha yad aham antaḥpuramadhyagata etam evārthaṃ	pratinivartaya ratham antaḥpuram eva gaccha yat aham antaḥpura madhya gataḥ etam eva artham 
SA_K14_mavadsuu-675	cintayiṣyāmi maraṇaṃ kilāham avyativṛttaḥ sa eṣa deva kumāra antaḥpuramadhyagata	cintayiṣyāmi maraṇam kila aham a vyativṛttaḥ saḥ eṣa deva kumāra antaḥpura madhya gata 
SA_K14_mavadsuu-676	athāpratītaḥ karuṇāni dhyāti maraṇaṃ kilāham avyativṛttaḥ	atha apratītaḥ karuṇāni dhyā ati maraṇam kila aham a vyativṛttaḥ 
SA_K14_mavadsuu-677	atha Bandhumato rājña etad abhavaṃ mā haiva brāhmaṇānāṃ naimittānāṃ pūrvavad yāvad iyam atra dharmatā tasmād idam ucyate //	atha bandhumataḥ rājñaḥ etat abhavam mā ha eva brāhmaṇānām naimittānām pūrvavat yāvat iyam atra dharmatā tasmāt idam ucyate 
SA_K14_mavadsuu-678	purottame nagaravare suramye	pura uttame nagara vare su ramye 
SA_K14_mavadsuu-679	tadā Vipaśyī daharaḥ samānaḥ	tadā vipaśyī daharaḥ samānaḥ 
SA_K14_mavadsuu-680	āmodate kāmaguṇair hi pañcabhiḥ	āmodate kāma guṇaiḥ hi pañcabhiḥ 
SA_K14_mavadsuu-681	sahasranetra iva Nandane vane //	sahasranetraḥ iva nandane vane 
SA_K14_mavadsuu-682	[Seeing an Ascetic]	seeing an ascetic 
SA_K14_mavadsuu-683	dharmatā khalu Vipaśyī bodhisatva udyānabhūmiṃ niryātukāmaḥ sārathim āmaṃtrayati pūrvavad yāvad	dharmatā khalu vipaśyī bodhisatvaḥ udyāna bhūmim niryātu kāmaḥ sārathim āmaṃtrayati pūrvavat yāvat 
SA_K14_mavadsuu-684	adrākṣīd Vipaśyī bodhisatva udyānabhūmiṃ niryāyaṃ puruṣaṃ muṇḍaṃ kapālapāṇim anuveśmānuveśma kulāny upasaṃkramantaṃ dṛṣṭvā ca punaḥ sārathim	adrākṣīt vipaśyī bodhisatvaḥ udyāna bhūmim niryāyam puruṣam muṇḍam kapāla pāṇim anuveśma anuveśma kulāni upasaṃkramantam dṛṣṭvā ca punar sārathim 
SA_K14_mavadsuu-685	kim eṣa sārathe puruṣa muṇḍaḥ kapālapāṇir anuveśmānuveśma kulāny upasaṃkrāmati vastrāṇi cāsya vivarṇāni na tathānyeṣām	kim eṣa sārathe puruṣa muṇḍaḥ kapāla pāṇiḥ anuveśma anuveśma kulāni upasaṃkrāmati vastrāṇi ca asya vivarṇāni na tathā anyeṣām 
SA_K14_mavadsuu-686	eṣa deva pravrajito nāma	eṣa deva pravrajitaḥ nāma 
SA_K14_mavadsuu-687	kim eṣa sārathe pravrajito nāma	kim eṣa sārathe pravrajitaḥ nāma 
SA_K14_mavadsuu-688	eṣa deva puruṣaḥ sādhu damaḥ sādhu saṃyamaḥ sādhv arthacaryā sādhu dharmacaryā sādhu	eṣa deva puruṣaḥ sādhu damaḥ sādhu saṃyamaḥ sādhu artha caryā sādhu dharma caryā sādhu 
SA_K14_mavadsuu-689	kuśalacaryā sādhu kalyāṇacaryeti keśaśmaśrūṇy avatārya kāṣāyāṇi vastrāṇy āchādya	kuśala caryā sādhu kalyāṇa caryā iti keśa śmaśrūṇi avatārya kāṣāyāṇi vastrāṇi āchādya 
SA_K14_mavadsuu-690	samyag eva śraddhayā agārād anagārikāṃ pravrajitaḥ sa eṣa deva pravrajito nāma /	samyak eva śraddhayā agārāt anagārikām pravrajitaḥ saḥ eṣa deva pravrajitaḥ nāma 
SA_K14_mavadsuu-691	tena hi sārathe yena sa pravrajitas tena rathaṃ preraya	tena hi sārathe yena sa pravrajitaḥ tena ratham preraya 
SA_K14_mavadsuu-692	evaṃ deveti sārathir Vipaśyino bodhisatvasya pratiśrutya yena sa pravrajitas tena rathaṃ prerayati /	evam deva iti sārathiḥ vipaśyinaḥ bodhisatvasya pratiśrutya yena sa pravrajitaḥ tena ratham prerayati 
SA_K14_mavadsuu-693	atha Vipaśyī bodhisatvas taṃ pravrajitam idam avocat	atha vipaśyī bodhisatvaḥ tam pravrajitam idam avocat 
SA_K14_mavadsuu-694	kaḥ punas tvaṃ bhoḥ puruṣa muṇḍaḥ kapālapāṇi anuveśmānuveśma kulāny upasaṃkrāmasi vastrāṇi ca te vivarṇāni na tathānyeṣām	kaḥ punar tvam bhoḥ puruṣa muṇḍaḥ kapāla pāṇi anuveśma anuveśma kulāni upasaṃkrāmasi vastrāṇi ca te vivarṇāni na tathā anyeṣām 
SA_K14_mavadsuu-695	ahaṃ kumāra pravrajito nāma	aham kumāra pravrajitaḥ nāma 
SA_K14_mavadsuu-696	yathā kathaṃ tvaṃ bhoḥ puruṣa pravrajito nāma /	yathā katham tvam bhoḥ puruṣa pravrajitaḥ nāma 
SA_K14_mavadsuu-697	ahaṃ kumāra sādhu damaḥ sādhu saṃyamaḥ sādhv arthacaryā sādhu dharmacaryā sādhu kuśalacaryā sādhu kalyāṇacaryeti keśaśmaśrūṇy (MAV 118)	aham kumāra sādhu damaḥ sādhu saṃyamaḥ sādhu artha caryā sādhu dharma caryā sādhu kuśala caryā sādhu kalyāṇa caryā iti keśa śmaśrūṇi 
SA_K14_mavadsuu-698	avatārya kāṣāyāṇi vastrāṇy āchādya samyag eva śraddhayā agārād anagārikāṃ pravrajitaḥ so 'haṃ pravrajito nāma /	avatārya kāṣāyāṇi vastrāṇi āchādya samyak eva śraddhayā agārāt anagārikām pravrajitaḥ saḥ ham pravrajitaḥ nāma 
SA_K14_mavadsuu-699	sādhu tvaṃ bhoḥ puruṣa arthacaryā dharmacaryā kuśalacaryā kalyāṇacaryeti keśaśmaśrūṇy avatārya kāṣāyāṇi vastrāṇy āchādya samyag eva śraddhayā  #	sādhu tvam bhoḥ puruṣa artha caryā dharma caryā kuśala caryā kalyāṇa caryā iti keśa śmaśrūṇi avatārya kāṣāyāṇi vastrāṇi āchādya samyak eva śraddhayā 
SA_K14_mavadsuu-700	agārād anagārikāṃ pravrajitaḥ	agārāt anagārikām pravrajitaḥ 
SA_K14_mavadsuu-701	tena hi tvaṃ sārathe imaṃ ca ratham imāni cābharaṇāni asmākaṃ jñātibhyo 'nuprayaccha	tena hi tvam sārathe imam ca ratham imāni ca ābharaṇāni asmākam jñātibhyaḥ nuprayaccha 
SA_K14_mavadsuu-702	aham api ca kāmaguṇāṃ prahāya ihaiva pravrajyām abhyupagamiṣyāmi iyam atra dharmatā	aham api ca kāma guṇām prahāya iha eva pravrajyām abhyupagamiṣyāmi iyam atra dharmatā 
SA_K14_mavadsuu-703	tasmād idam ucyate //	tasmāt idam ucyate 
SA_K14_mavadsuu-704	imaṃ rathaṃ cābharaṇāni caiva	imam ratham ca ābharaṇāni ca eva 
SA_K14_mavadsuu-705	anuprayaccha mama jñātikebhyaḥ	anuprayaccha mama jñātikebhyaḥ 
SA_K14_mavadsuu-706	kṣipram ahaṃ kāmaguṇāṃ prahāya	kṣipram aham kāma guṇām prahāya 
SA_K14_mavadsuu-707	ihaiva pravrajyām upāgamiṣye //	iha eva pravrajyām upāgamiṣye 
SA_K14_mavadsuu-708	[Renunciation]	renunciation 
SA_K14_mavadsuu-709	tatredānīṃ Vipaśyī bodhisatvo jīrṇaṃ ca dṛṣṭvā vyādhitaṃ ca dṛṣṭvā mṛtaṃ ca dṛṣṭvā	tatra idānīm vipaśyī bodhisatvaḥ jīrṇam ca dṛṣṭvā vyādhitam ca dṛṣṭvā mṛtam ca dṛṣṭvā 
SA_K14_mavadsuu-710	kāṣāyadhāriṇaṃ pravrajitaṃ ca dṛṣṭvā pravrajyāṃ tatra samupāgato 'sau iyam atra dharmatā	kāṣāya dhāriṇam pravrajitam ca dṛṣṭvā pravrajyām tatra samupāgataḥ sau iyam atra dharmatā 
SA_K14_mavadsuu-711	tasmād idam ucyate //	tasmāt idam ucyate 
SA_K14_mavadsuu-712	jīrṇāñ ca dṛṣṭvā duḥkhitaṃ vyādhitaṃ ca	jīrṇām ca dṛṣṭvā duḥkhitam vyādhitam ca 
SA_K14_mavadsuu-713	mṛtañ ca dṛṣṭvā samatītacetasam	mṛtam ca dṛṣṭvā samatīta cetasam 
SA_K14_mavadsuu-714	kāṣāyakaṇṭhaṃ pravrajita ca vīkṣya	kāṣāya kaṇṭham ca vīkṣya 
SA_K14_mavadsuu-715	tatraiva pravrajyām upāgato 'sau //	tatra eva pravrajyām upāgataḥ sau 
SA_K14_mavadsuu-716	11. Mnemonic Keywords of This Chapter	mnemonic keywords of this chapter 
SA_K14_mavadsuu-717	uddānam //	uddānam 
SA_K14_mavadsuu-718	dhātrī brāhmaṇa mātā ca abhirūpo manāpatā /	dhātrī brāhmaṇa mātā ca abhirūpaḥ manāpatā 
SA_K14_mavadsuu-719	animiṣo vipākadharmaś ca	animiṣaḥ vipāka dharmaḥ ca 
SA_K14_mavadsuu-720	valgusvaraḥ paṇḍitaś ca udyānam //	valgu svaraḥ paṇḍitaḥ ca udyānam 
SA_K14_mavadsuu-721	Part Three	part three 
SA_K14_mavadsuu-722	1. The Eightythousand People of Bandhumatī Renounce the World	the eightythousand people of bandhumatī renounce the world 
SA_K14_mavadsuu-723	aśrauṣur Bandhumatyāṃ rājadhānyām aśītiprāṇasahasrāṇi Vipaśyī bodhisatvaḥ keśaśmaśrūṇy	aśrauṣuḥ bandhumatyām rājadhānyām aśīti prāṇa sahasrāṇi vipaśyī bodhisatvaḥ keśa śmaśrūṇi 
SA_K14_mavadsuu-724	avatārya kāṣāyāṇi vastrāṇy ācchādya samyag eva śraddhayā agārād anagārikāṃ pravrajitaḥ	avatārya kāṣāyāṇi vastrāṇi ācchādya samyak eva śraddhayā agārāt anagārikām pravrajitaḥ 
SA_K14_mavadsuu-725	śrutvā ca punar eṣām etad abhavan na batāvaro dharmo bhaviṣyati nāvaraṃ dharmākhyānaṃ	śrutvā ca punar eṣām etat abhavat na bata avaraḥ dharmaḥ bhaviṣyati na avaram dharma ākhyānam 
SA_K14_mavadsuu-726	yatredānīṃ Vipaśyī bodhisatvas tathā sukumāras tathā sukhaiṣi keśaśmaśrūṇy avatārya	yatrā idānīm vipaśyī bodhisatvaḥ tathā su kumāraḥ tathā sukha eṣi keśa śmaśrūṇi avatārya 
SA_K14_mavadsuu-727	kāṣāyāṇi vastrāṇy āchādya samyag eva śraddhayā agārād anagārikāṃ pravrajitaḥ	kāṣāyāṇi vastrāṇi āchādya samyak eva śraddhayā agārāt anagārikām pravrajitaḥ 
SA_K14_mavadsuu-728	atha ca punas te 'pi keśaśmaśrūṇy avatārya kāṣāyāṇi vastrāṇy āchādya samyag eva śraddhayā agārād anagārikāṃ pravrajitāḥ iyam atra dharmatā  #	atha ca punar te pi keśa śmaśrūṇi avatārya kāṣāyāṇi vastrāṇi āchādya samyak eva śraddhayā agārāt anagārikām pravrajitāḥ iyam atra dharmatā 
SA_K14_mavadsuu-729	tasmād idam ucyate //	tasmāt idam ucyate 
SA_K14_mavadsuu-730	āścaryarūpaṃ pratibhāti me tad	āścarya rūpam pratibhāti me tat 
SA_K14_mavadsuu-731	yāvat susaṃvejakāḥ śuddhasatvā	yāvat su saṃvejakāḥ śuddha satvā 
SA_K14_mavadsuu-732	Vipaśyinaṃ pravrajitaṃ hi śrutvā	vipaśyinam pravrajitam hi śrutvā 
SA_K14_mavadsuu-733	tatraiva pravrajyām anuvrajanti //	tatra eva pravrajyām anuvrajanti 
SA_K14_mavadsuu-734	2. The Eightythousand Disciples Leave on Peregrination	the eightythousand disciples leave on peregrination 
SA_K14_mavadsuu-735	athāśītir bhikṣusahasrāṇi yena Vipaśyī bodhisatvas tenopajagmur upetya Vipaśyino	atha aśītiḥ bhikṣu sahasrāṇi yena vipaśyī bodhisatvaḥ tena upajagmuḥ upetya vipaśyinaḥ 
SA_K14_mavadsuu-736	bodhisatvasya pādau śirasā vanditvā ekānte nyaṣīdaṃn ekāntaniṣaṃṇāny aśītir bhikṣusahasrāṇi	bodhisatvasya pādau śirasā vanditvā ekānte nyaṣīdan ekānta niṣaṃṇāni aśītiḥ bhikṣu sahasrāṇi 
SA_K14_mavadsuu-737	Vipaśyī bodhisatvo dhārmyā kathayā sandarśayati samādāpayati samuttejayati saṃpraharṣayati /	vipaśyī bodhisatvaḥ dhārmyā kathayā sandarśayati samādāpayati samuttejayati saṃpraharṣayati 
SA_K14_mavadsuu-738	atha Vipaśyino bodhisatvasyaitad abhavan na mama pratirūpaṃ syād yad aham ananuprāptasvakārtha	atha vipaśyinaḥ bodhisatvasya etat abhavat na mama pratirūpam syāt yat aham an anuprāpta svaka artha 
SA_K14_mavadsuu-739	eva samāna śrāvakair ākīrṇo vihareyaṃ yanv ahaṃ śrāvakān udyojayeyaṃ carata bhikṣavaś caryāṃ (MAV 124)	eva śrāvakaiḥ ākīrṇaḥ vihareyam yanu aham śrāvakān udyojayeyam carata bhikṣavaḥ caryām 
SA_K14_mavadsuu-740	bahujanahitāya bahujanasukhāya lokānukaṃpāya arthāya hitāya sukhāya devamanuṣyāṇāṃ	bahu jana hitāya bahu jana sukhāya loka anukaṃpāya arthāya hitāya sukhāya deva manuṣyāṇām 
SA_K14_mavadsuu-741	yadā yūyaṃ śṛṇutha Vipaśyī bodhisatva anuttarāṃ samyaksaṃbodhim abhisaṃbuddho deśayati	yadā yūyam śṛṇutha vipaśyī bodhisatva anuttarām samyaksaṃbodhim abhisaṃbuddhaḥ deśayati 
SA_K14_mavadsuu-742	Bandhumatyāṃ rājadhānyāṃ dharmaṃ tadā yūyam āgacchata Bandhumatyāṃ rājadhānīṃ dharmaśravaṇāya	bandhumatyām rājadhānyām dharmam tadā yūyam āgacchata bandhumatyām rājadhānīm dharma śravaṇāya 
SA_K14_mavadsuu-743	atha Vipaśyī bodhisatva śrāvakān udyojayati carata bhikṣavaś caryāṃ pūrvavad yāvad dharmaśravaṇāya /	atha vipaśyī bodhisatva śrāvakān udyojayati carata bhikṣavaḥ caryām pūrvavat yāvat dharma śravaṇāya 
SA_K14_mavadsuu-744	atha Vipaśyino bodhisatvasya śrāvakā Vipaśyinā bodhisatvenodyojitā janapadacaryāṃ prakrāntā iyam atra dharmatā tasmād idam ucyate //	atha vipaśyinaḥ bodhisatvasya śrāvakāḥ vipaśyinā bodhisatvena udyojitāḥ janapada caryām prakrāntāḥ iyam atra dharmatā tasmāt idam ucyate 
SA_K14_mavadsuu-745	anyena te pravrajitā acārṣur	anyena te pravrajitāḥ acārṣuḥ 
SA_K14_mavadsuu-746	ucchena bhikṣācaryeṇa jīvikām	ucchena bhikṣā caryeṇa jīvikām 
SA_K14_mavadsuu-747	anyena śūro dvipadottamas tadā	anyena śūraḥ dvipada uttamaḥ tadā 
SA_K14_mavadsuu-748	eṣaty ādīptaśira iva nirvṛtim //	ādīpta śiraḥ iva nirvṛtim 
SA_K14_mavadsuu-749	3. The Bodhisattva Sits under the Bodhi Tree	the bodhisattva sits under the bodhi tree 
SA_K14_mavadsuu-750	atha Vipaśyī bodhisatvo yāvasikasya puruṣasya sakāśāt tṛṇāny ādāya yena bodhimūlaṃ	atha vipaśyī bodhisatvaḥ yāvasikasya puruṣasya sakāśāt tṛṇāni ādāya yena bodhi mūlam 
SA_K14_mavadsuu-751	tenopajagāma upetya svayam eva tṛṇasaṃstarakaṃ saṃstīrya nyaṣīdat paryaṃgam ābhujya	tena upajagāma upetya svayam eva tṛṇa saṃstarakam saṃstīrya nyaṣīdat paryaṃgam ābhujya 
SA_K14_mavadsuu-752	ṛjuṃ kāyaṃ praṇidhāya pratimukhāṃ smṛtim upasthāpya cittam utpādayati vācaṃ ca bhāṣate	ṛjum kāyam praṇidhāya pratimukhām smṛtim upasthāpya cittam utpādayati vācam ca bhāṣate 
SA_K14_mavadsuu-753	tāvan na bhetsyāmi paryaṃkaṃ yāvad aprāptāsravakṣayaḥ	tāvat na bhetsyāmi paryaṃkam yāvat aprāpta āsrava kṣayaḥ 
SA_K14_mavadsuu-754	sa tāvan na bhinatti paryaṅgaṃ yāvad aprāptāsravakṣaya iyam atra dharmatā tasmād idam ucyate //	sa tāvat na bhinatti paryaṅgam yāvat a prāpta āsrava kṣayaḥ iyam atra dharmatā tasmāt idam ucyate 
SA_K14_mavadsuu-755	paryaṅgam ābhujya tato niṣaṇṇo	paryaṅgam ābhujya tatas niṣaṇṇaḥ 
SA_K14_mavadsuu-756	drumamūle maharṣer bodhimaṇḍe /	druma mūle mahā ṛṣeḥ bodhimaṇḍe 
SA_K14_mavadsuu-757	duḥkhaṃ jarāmaraṇam idaṃ viditvā	duḥkham jarā maraṇam idam viditvā 
SA_K14_mavadsuu-758	nirvāṇaśāntatvam ahaṃ prapadye 1	nirvāṇa śānta tvam aham prapadye 
SA_K14_mavadsuu-759	na bhinadmi paryaṃgam ahaṃ hy alabdhvā	na bhinadmi paryaṃgam aham hi a labdhvā 
SA_K14_mavadsuu-760	anuttarāṃ bodhim anu ^ _ X ḥ	anuttarām bodhim anu 
SA_K14_mavadsuu-761	ity eva _ _ ^ ^ _ Vipaśyī	iti eva    vipaśyī 
SA_K14_mavadsuu-762	na sraṃsayati vīryam alabdhanirvṛtiḥ 2 //	na sraṃsayati vīryam a labdha nirvṛtiḥ 
SA_K14_mavadsuu-763	4. The Realization of Dependent Origination	the realization of dependent origination 
SA_K14_mavadsuu-764	[The Pravṛtti Process]	the pravṛtti process 
SA_K14_mavadsuu-765	atha Vipaśyino bodhisattvasyaikākino rahasigatasya pratisaṃlīnasyaivaṃ cetasi cetaḥparivitarka	atha vipaśyinaḥ bodhisattvasya ekākinaḥ rahasi gatasya pratisaṃlīnasya evam cetasi cetaḥ parivitarka 
SA_K14_mavadsuu-766	udapādi kṛchraṃ batāyaṃ loka āpanno yad uta jāyate 'pi jīryate 'pi mriyate 'pi cyavate	udapādi kṛchram bata ayam lokaḥ āpannaḥ yat uta jāyate pi jīryate pi mriyate pi cyavate 
SA_K14_mavadsuu-767	'py upapadyate 'pi atha ca punar ime satvā jarāmaraṇasyottare niḥsaraṇaṃ yathābhūtaṃ na prajānanti /	upapadyate atha ca punar ime satvāḥ jarā maraṇasya uttare niḥsaraṇam yathābhūtam na prajānanti 
SA_K14_mavadsuu-768	tasyaitad abhavat kasmiṃ nu sati jarāmaraṇaṃ bhavati kiṃpratyayaṃ ca punar jarāmaraṇaṃ tasya yoniśo manasikurvata evaṃ yathābhūtasyābhisamaya  #	tasya etat abhavat kasmin nu sati jarā maraṇam bhavati kiṃpratyayam ca punar jarā maraṇam tasya yoniśas manasikurvataḥ evam yathābhūtasya abhisamaya 
SA_K14_mavadsuu-769	udapādi /	udapādi 
SA_K14_mavadsuu-770	jātyāṃsatyāṃ jarāmaraṇaṃ bhavati jātipratyayaṃ ca punar jarāmaraṇaṃ	jātyām aṃsatyām jarā maraṇam bhavati jāti pratyayam ca punar jarā maraṇam 
SA_K14_mavadsuu-771	tasyaitad abhavat kasmiṃ nu sati jātir bhavati kiṃpratyayā ca punar jāti tasya yoniśo manasikurvata evaṃ yathābhūtasyābhisamaya udapādi /	tasya etat abhavat kasmin nu sati jātiḥ bhavati kiṃpratyayā ca punar jāti tasya yoniśas manasikurvataḥ evam yathābhūtasya abhisamayaḥ udapādi 
SA_K14_mavadsuu-772	bhave sati jātir bhavati bhavapratyayā ca punar jāti	bhave sati jātiḥ bhavati bhava pratyayā ca punar 
SA_K14_mavadsuu-773	tasyaitad abhavat kasmiṃ nu sati bhavo bhavati kiṃpratyayaś ca punar bhavaḥ tasya yoniśo manasikurvata evaṃ yathābhūtasyābhisamaya udapādi	tasya etat abhavat kasmin nu sati bhavaḥ bhavati kiṃpratyayaḥ ca punar bhavaḥ tasya yoniśas manasikurvataḥ evam yathābhūtasya abhisamayaḥ udapādi 
SA_K14_mavadsuu-774	upādāne sati bhavo bhavati upādānapratyayaś ca punar bhavaḥ	upādāne sati bhavaḥ bhavati upādāna pratyayaḥ ca punar bhavaḥ 
SA_K14_mavadsuu-775	tasyaitad abhavat kasmiṃ nu sati upādānaṃ bhavati kiṃpratyayaṃ ca punar upādānaṃ tasya yoniśo manasikurvata evaṃ yathābhūtasyābhisamaya udapādi	tasya etat abhavat kasmin nu sati upādānam bhavati kiṃpratyayam ca punar upādānam tasya yoniśas manasikurvataḥ evam yathābhūtasya abhisamayaḥ udapādi 
SA_K14_mavadsuu-776	tṛṣṇāyāṃ satyām upādānaṃ bhavati tṛṣṇāpratyayaṃ ca punar upādānaṃ	tṛṣṇāyām satyām upādānam bhavati tṛṣṇā pratyayam ca punar upādānam 
SA_K14_mavadsuu-777	tasyaitad abhavat kasmiṃ nu sati tṛṣṇā bhavati kiṃpratyayā ca punas tṛṣṇā tasya yoniśo manasikurvata evaṃ yathābhūtasyābhisamaya udapādi /	tasya etat abhavat kasmin nu sati tṛṣṇā bhavati kiṃpratyayā ca punar tṛṣṇā tasya yoniśas manasikurvataḥ evam yathābhūtasya abhisamayaḥ udapādi 
SA_K14_mavadsuu-778	vedanāyāṃ satyāṃ tṛṣṇā bhavati vedanāpratyayā ca punas tṛṣṇā	vedanāyām satyām tṛṣṇā bhavati vedanā pratyayā ca punar tṛṣṇā 
SA_K14_mavadsuu-779	tasyaitad abhavat kasmiṃ nu sati vedanā bhavati kiṃpratyayā ca punar vedanā tasya yoniśo manasikurvata evaṃ yathābhūtasyābhisamaya udapādi	tasya etat abhavat kasmin nu sati vedanā bhavati kiṃpratyayā ca punar vedanā tasya yoniśas manasikurvataḥ evam yathābhūtasya abhisamayaḥ udapādi 
SA_K14_mavadsuu-780	sparśe sati vedanā bhavati sparśapratyayā ca punar vedanā /	sparśe sati vedanā bhavati sparśa pratyayā ca punar vedanā 
SA_K14_mavadsuu-781	tasyaitad abhavat kasmiṃ nu sati sparśo bhavati kiṃpratyayaś ca puna sparśaḥ tasya yoniśo manasikurvata evaṃ yathābhūtasyābhisamaya udapādi	tasya etat abhavat kasmin nu sati sparśaḥ bhavati kiṃpratyayaḥ ca punar sparśaḥ tasya yoniśas manasikurvataḥ evam yathābhūtasya abhisamayaḥ udapādi 
SA_K14_mavadsuu-782	ṣaḍāyatane sati sparśo bhavati ṣaḍāyatanapratyayaś ca puna sparśaḥ	ṣaṣ āyatane sati sparśaḥ bhavati ṣaṣ āyatana pratyayaḥ ca punar sparśaḥ 
SA_K14_mavadsuu-783	tasyaitad abhavat kasmiṃ nu sati ṣaḍāyatanaṃ bhavati kiṃpratyayaṃ ca punaḥ ṣaḍāyatanaṃ tasya yoniśo manasikurvata evaṃ yathābhūtasyābhisamaya  #	tasya etat abhavat kasmin nu sati ṣaṣ āyatanam bhavati kiṃpratyayam ca punar ṣaṣ āyatanam tasya yoniśas manasikurvataḥ evam yathābhūtasya abhisamaya 
SA_K14_mavadsuu-784	udapādi /	udapādi 
SA_K14_mavadsuu-785	nāmarūpe sati ṣaḍāyatanaṃ bhavati nāmarūpapratyayaṃ ca punaḥ ṣaḍāyatanaṃ	nāma rūpe sati ṣaṣ āyatanam bhavati nāma rūpa pratyayam ca punar ṣaṣ āyatanam 
SA_K14_mavadsuu-786	tasyaitad abhavat kasmiṃ nu sati nāmarūpaṃ bhavati kiṃpratyayaṃ ca punar nāmarūpaṃ tasya yoniśo manasikurvata evaṃ yathābhūtasyābhisamaya udapādi	tasya etat abhavat kasmin nu sati nāma rūpam bhavati kiṃpratyayam ca punar nāma rūpam tasya yoniśas manasikurvataḥ evam yathābhūtasya abhisamayaḥ udapādi 
SA_K14_mavadsuu-787	vijñāne sati nāmarūpaṃ bhavati vijñānapratyayaṃ ca punar nāmarūpaṃ	vijñāne sati nāma rūpam bhavati vijñāna pratyayam ca punar nāma rūpam 
SA_K14_mavadsuu-788	tasyaitad abhavat kasmiṃ nu sati vijñānaṃ bhavati kiṃpratyayaṃ ca punar vijñānam tasya yoniśo manasikurvata evaṃ yathābhūtasyābhisamaya udapādi	tasya etat abhavat kasmin nu sati vijñānam bhavati kiṃpratyayam ca punar vijñānam tasya yoniśas manasikurvataḥ evam yathābhūtasya abhisamayaḥ udapādi 
SA_K14_mavadsuu-789	nāmarūpe sati vijñānaṃ bhavati nāmarūpapratyayañca punar vijñānaṃ	nāma rūpe sati vijñānam bhavati nāma rūpa pratyayam ca punar vijñānam 
SA_K14_mavadsuu-790	tasya vijñānāt pratyudāvartate mānasaṃ nātaḥ parato vyativartate yad uta nāmarūpapratyayaṃ	tasya vijñānāt pratyudāvartate mānasam na atas paratas vyativartate yat uta nāma rūpa pratyayam 
SA_K14_mavadsuu-791	vijñānaṃ vijñānapratyayaṃ nāmarūpaṃ nāmarūpapratyayaṃ ṣaḍāyatanaṃ ṣaḍāyatanapratyayaḥ	vijñānam vijñāna pratyayam nāma rūpam nāma rūpa pratyayam ṣaṣ āyatanam ṣaṣ āyatana pratyayaḥ 
SA_K14_mavadsuu-792	sparśaḥ sparśapratyayā vedanā vedanāpratyayā tṛṣṇā tṛṣṇāpratyayam upādānam upādānapratyayo	sparśaḥ sparśa pratyayā vedanā vedanā pratyayā tṛṣṇā tṛṣṇā pratyayam upādānam upādāna pratyayaḥ 
SA_K14_mavadsuu-793	bhavaḥ bhavapratyayā jāti jātipratyayaṃ jarāmaraṇaṃ śokaparidevaduḥkhadaurmanasyopāyāsā	bhavaḥ bhava pratyayā jāti jāti pratyayam jarā maraṇam śoka parideva duḥkha daurmanasya upāyāsā 
SA_K14_mavadsuu-794	saṃbhavaṃty evam asya kevalasya mahato duḥkhaskandhasya samudayo bhavati /	saṃbhavanti evam asya kevalasya mahataḥ duḥkha skandhasya samudayaḥ bhavati 
SA_K14_mavadsuu-795	[The Nivṛtti Process]	the nivṛtti process 
SA_K14_mavadsuu-796	tasyaitad abhavat kasmiṃ nv asati jarāmaraṇaṃ na bhavati kasya nirodhāj jarāmaraṇanirodhaḥ tasya yoniśo manasikurvata evaṃ yathābhūtasyābhisamaya  #	tasya etat abhavat kasmin nu asati jarā maraṇam na bhavati kasya nirodhāt jarā maraṇa nirodhaḥ tasya yoniśas manasikurvataḥ evam yathā bhūtasya abhisamaya 
SA_K14_mavadsuu-797	udapādi /	udapādi 
SA_K14_mavadsuu-798	jātyām asatyāṃ jarāmaraṇaṃ na bhavati jātinirodhāj jarāmaraṇanirodhaḥ	jātyām asatyām jarā maraṇam na bhavati jāti nirodhāt jarā maraṇa nirodhaḥ 
SA_K14_mavadsuu-799	tasyaitad abhavat kasmiṃ nv asati jātir na bhavati kasya nirodhāj jātinirodhaḥ tasya yoniśo manasikurvata evaṃ yathābhūtasyābhisamaya udapādi	tasya etat abhavat kasmin nu asati jātiḥ na bhavati kasya nirodhāt jāti nirodhaḥ tasya yoniśas manasikurvataḥ evam yathābhūtasya abhisamayaḥ udapādi 
SA_K14_mavadsuu-800	bhave asati jātir na bhavati bhavanirodhāj jātinirodhaḥ	bhave asati jātiḥ na bhavati bhava nirodhāt jāti nirodhaḥ 
SA_K14_mavadsuu-801	tasyaitad abhavat kasmiṃ nv asati bhavo na bhavati kasya nirodhād bhavanirodhaḥ tasya yoniśo manasikurvata evaṃ yathābhūtasyābhisamaya udapādi	tasya etat abhavat kasmin nu asati bhavaḥ na bhavati kasya nirodhāt bhava nirodhaḥ tasya yoniśas manasikurvataḥ evam yathābhūtasya abhisamayaḥ udapādi 
SA_K14_mavadsuu-802	upādāne 'sati bhavo na bhavati upādānanirodhād bhavanirodhaḥ	upādāne sati bhavaḥ na bhavati upādāna nirodhāt bhava nirodhaḥ 
SA_K14_mavadsuu-803	tasyaitadabhavat kasmiṃ nv asati upādānaṃ na bhavati kasya nirodhād upādānanirodhaḥ tasya yoniśo manasikurvata evaṃ yathābhūtasyābhisamaya	tasya etat abhavat kasmin nu asati upādānam na bhavati kasya nirodhāt upādāna nirodhaḥ tasya yoniśas manasikurvataḥ evam yathā bhūtasya abhisamayaḥ 
SA_K14_mavadsuu-804	tṛṣṇāyām asatyām upādānaṃ na bhavati tṛṣṇānirodhād upādānanirodhaḥ	tṛṣṇāyām asatyām upādānam na bhavati tṛṣṇā nirodhāt upādāna nirodhaḥ 
SA_K14_mavadsuu-805	tasyaitad abhavat kasmiṃ nv asati tṛṣṇā na bhavati kasya nirodhāt tṛṣṇānirodhaḥ tasya yoniśo manasikurvata evaṃ yathābhūtasyābhisamaya udapādi	tasya etat abhavat kasmin nu asati tṛṣṇā na bhavati kasya nirodhāt tṛṣṇā nirodhaḥ tasya yoniśas manasikurvataḥ evam yathābhūtasya abhisamayaḥ udapādi 
SA_K14_mavadsuu-806	vedanāyām asatyāṃ tṛṣṇā na bhavati vedanānirodhāt tṛṣṇānirodhaḥ	vedanāyām asatyām tṛṣṇā na bhavati vedanā nirodhāt tṛṣṇā nirodhaḥ 
SA_K14_mavadsuu-807	tasyaitad abhavat kasmiṃ nv asati vedanā na bhavati kasya nirodhād vedanānirodhaḥ tasya yoniśo manasikurvata evaṃ yathābhūtasyābhisamaya udapādi	tasya etat abhavat kasmin nu asati vedanā na bhavati kasya nirodhāt vedanā nirodhaḥ tasya yoniśas manasikurvataḥ evam yathābhūtasya abhisamayaḥ udapādi 
SA_K14_mavadsuu-808	sparśe 'sati vedanā na bhavati sparśanirodhād vedanānirodhaḥ	sparśe sati vedanā na bhavati sparśa nirodhāt vedanā nirodhaḥ 
SA_K14_mavadsuu-809	tasyaitad abhavat kasmiṃ nv asati sparśo na bhavati kasya nirodhāt sparśanirodhaḥ tasya yoniśo manasikurvata evaṃ yathābhūtasyābhisamaya udapādi	tasya etat abhavat kasmin nu asati sparśaḥ na bhavati kasya nirodhāt sparśa nirodhaḥ tasya yoniśas manasikurvataḥ evam yathābhūtasya abhisamayaḥ udapādi 
SA_K14_mavadsuu-810	ṣaḍāyatane 'sati sparśo na bhavati ṣaḍāyatananirodhāt sparśanirodhaḥ	ṣaṣ āyatane sati sparśaḥ na bhavati ṣaṣ āyatana nirodhāt sparśa nirodhaḥ 
SA_K14_mavadsuu-811	tasyaitad abhavat kasmiṃ nv asati ṣaḍāyatanaṃ na bhavati kasya nirodhāt ṣaḍāyatananirodhaḥ tasya yoniśo manasikurvata evaṃ yathābhūtasyābhisamaya  #	tasya etat abhavat kasmin nu asati ṣaṣ āyatanam na bhavati kasya nirodhāt ṣaṣ āyatana nirodhaḥ tasya yoniśas manasikurvataḥ evam yathābhūtasya abhisamaya 
SA_K14_mavadsuu-812	udapādi /	udapādi 
SA_K14_mavadsuu-813	nāmarūpe 'sati ṣaḍāyatanaṃ na bhavati nāmarūpanirodhāt ṣaḍāyatananirodhaḥ	nāma rūpe sati ṣaṣ āyatanam na bhavati nāma rūpa nirodhāt ṣaṣ āyatana nirodhaḥ 
SA_K14_mavadsuu-814	tasyaitad abhavat kasmiṃ nv asati nāmarūpaṃ na bhavati kasya nirodhān nāmarūpanirodhaḥ tasya yoniśo manasikurvata evaṃ yathābhūtasyābhisamaya  #	tasya etat abhavat kasmin nu asati nāma rūpam na bhavati kasya nirodhāt nāma rūpa nirodhaḥ tasya yoniśas manasikurvataḥ evam yathā bhūtasya abhisamaya 
SA_K14_mavadsuu-815	udapādi /	udapādi 
SA_K14_mavadsuu-816	vijñāne 'sati nāmarūpaṃ na bhavati vijñānanirodhān nāmarūpanirodhaḥ	vijñāne sati nāma rūpam na bhavati vijñāna nirodhāt nāma rūpa nirodhaḥ 
SA_K14_mavadsuu-817	tasyaitad abhavat kasmiṃ nv asati vijñānaṃ na bhavati kasya nirodhād vijñānanirodhaḥ tasya yoniśo manasikurvata evaṃ yathābhūtasyābhisamaya  #	tasya etat abhavat kasmin nu asati vijñānam na bhavati kasya nirodhāt vijñāna nirodhaḥ tasya yoniśas manasikurvataḥ evam yathābhūtasya abhisamaya 
SA_K14_mavadsuu-818	udapādi /	udapādi 
SA_K14_mavadsuu-819	saṃskāreṣv asatsu vijñānaṃ na bhavati saṃskāranirodhād vijñānanirodhaḥ	saṃskāreṣu asatsu vijñānam na bhavati saṃskāra nirodhāt vijñāna nirodhaḥ 
SA_K14_mavadsuu-820	tasyaitadabhavat kasmiṃ nv asati saṃskārā na bhavanti kasya nirodhāt saṃskāranirodhaḥ tasya yoniśo manasikurvata evaṃ yathābhūtasyābhisamaya  #	tasya etat abhavat kasmin nu asati saṃskārāḥ na bhavanti kasya nirodhāt saṃskāra nirodhaḥ tasya yoniśas manasikurvataḥ evam yathābhūtasya abhisamaya 
SA_K14_mavadsuu-821	udapādi /	udapādi 
SA_K14_mavadsuu-822	avidyāyām asatyāṃ saṃskārā na bhavaṃti avidyānirodhāt saṃskāranirodhaḥ	avidyāyām asatyām saṃskārāḥ na bhavanti avidyā nirodhāt saṃskāra nirodhaḥ 
SA_K14_mavadsuu-823	iti avidyānirodhāt saṃskāranirodhaḥ saṃskāranirodhād vijñānanirodho:	iti avidyā nirodhāt saṃskāra nirodhaḥ saṃskāra nirodhāt vijñāna nirodhaḥ 
SA_K14_mavadsuu-824	vijñānanirodhān nāmarūpanirodho:	vijñāna nirodhāt nāma rūpa nirodhaḥ 
SA_K14_mavadsuu-825	nāmarūpanirodhāt ṣaḍāyatananirodhaḥ ṣaḍāyatananirodhāt sparśanirodhaḥ sparśanirodhād vedanānirodho:	nāma rūpa nirodhāt ṣaṣ āyatana nirodhaḥ ṣaṣ āyatana nirodhāt sparśa nirodhaḥ sparśa nirodhāt vedanā nirodhaḥ 
SA_K14_mavadsuu-826	vedanānirodhāt tṛṣṇānirodhaḥ (MAV 134)	vedanā nirodhāt tṛṣṇā nirodhaḥ 
SA_K14_mavadsuu-827	tṛṣṇānirodhād upādānanirodhaḥ upādānanirodhād bhavanirodho:	tṛṣṇā nirodhāt upādāna nirodhaḥ upādāna nirodhāt bhava nirodhaḥ 
SA_K14_mavadsuu-828	bhavanirodhāj jātinirodho:	bhava nirodhāt jāti nirodhaḥ 
SA_K14_mavadsuu-829	jātinirodhāj jarāmaraṇanirodhaḥ śokaparidevaduḥkhadaurmanasyopāyāsā nirudhyaṃty evam asya kevalasya mahato duḥkhaskandhasya nirodho bhavati  #	jāti nirodhāt jarā maraṇa nirodhaḥ śoka parideva duḥkha daurmanasya upāyāsāḥ nirudhyanti evam asya kevalasya mahataḥ duḥkha skandhasya nirodhaḥ bhavati  /
SA_K14_mavadsuu-830	iyam atra dharmatā tasmād idam ucyate //	iyam atra dharmatā tasmāt idam ucyate 
SA_K14_mavadsuu-831	imāṃ kathāṃ pariṣadi vartamānāṃ	imām kathām pariṣadi vartamānām 
SA_K14_mavadsuu-832	mahānuśaṃsāṃ vadata śṛṇudhvam	mahā anuśaṃsām vadata śṛṇudhvam 
SA_K14_mavadsuu-833	yā bodhisatvasya babhūva pūrve	yā bodhisatvasya babhūva pūrve 
SA_K14_mavadsuu-834	dharmeṣv avekṣā ananuśruteṣu 1	dharmeṣu avekṣā an anuśruteṣu 
SA_K14_mavadsuu-835	rahogatasya ^ ^ tasya dhyāyato	rahaḥ gatasya tasya dhyāyataḥ 
SA_K14_mavadsuu-836	Vipaśyino 'bhūn manasābhicintitam	vipaśyinaḥ bhūt manasā abhicintitam 
SA_K14_mavadsuu-837	kutonidānaṃ maraṇaṃ jarā ca	kutonidānam maraṇam jarā ca 
SA_K14_mavadsuu-838	saṃbhavati nānāvividhaṃ ca duḥkham 2	saṃbhavati nānā vividham ca duḥkham 
SA_K14_mavadsuu-839	tasyaikam ekāgramanasya dhyāyato	tasya ekam ekāgra manasyaḥ dhyāyataḥ 
SA_K14_mavadsuu-840	X _ ^ _ ry. m udapādi jñānam	udapādi jñānam 
SA_K14_mavadsuu-841	jātinidānaṃ maraṇaṃ jarā ca	jāti nidānam maraṇam jarā ca 
SA_K14_mavadsuu-842	saṃbhavati nānāvividhaṃ ca duḥkham 3	saṃbhavati nānā vividham ca duḥkham 
SA_K14_mavadsuu-843	jātir athaiṣāpi kutonidānā	jātiḥ atha eṣā api kutonidānā 
SA_K14_mavadsuu-844	kiṃpratyayā kaḥ punar asya hetuḥ	kiṃpratyayā kaḥ punar asya hetuḥ 
SA_K14_mavadsuu-845	bhavanidānā bhavamūlikā ca	bhavanidānā bhavamūlikā ca 
SA_K14_mavadsuu-846	jātir bhavapratyayatāṃ pratītya 4	jātiḥ bhava pratyaya tām pratītya 
SA_K14_mavadsuu-847	upādadānaḥ punas tatra tatra	upādadānaḥ punar tatra tatra 
SA_K14_mavadsuu-848	punarbhavaṃ v. ^ ^ _ pratītya /	punarbhavam u    pratītya 
SA_K14_mavadsuu-849	X _ upādānam idaṃ pratītya 5	upādānam idam pratītya 
SA_K14_mavadsuu-850	prabhūtabhakṣasya hi pāvakasya	prabhūta bhakṣasya hi pāvakasya 
SA_K14_mavadsuu-851	samīritaṃ vāyuvaśād yathārci /	samīritam vāyu vaśāt yathā arci 
SA_K14_mavadsuu-852	evam upādānam idaṃ hi bhavati	evam upādānam idam hi bhavati 
SA_K14_mavadsuu-853	tṛṣṇānidānaṃ jvalati yathārciḥ 6	tṛṣṇā nidānam jvalati yathā arciḥ 
SA_K14_mavadsuu-854	tṛṣṇā punar vedayitaṃ pratītya	tṛṣṇā punar vedayitam pratītya 
SA_K14_mavadsuu-855	utpadyate jālinī duḥkhamūlikā /	utpadyate jālinī duḥkha mūlikā 
SA_K14_mavadsuu-856	viṣaktikā saritā sīvanī ca	viṣaktikā saritā sīvanī ca 
SA_K14_mavadsuu-857	sukhena duḥkhena ca saṃprayuktā 7	sukhena duḥkhena ca saṃprayuktā 
SA_K14_mavadsuu-858	sparśas tathaivāyatanaṃ pratītya	sparśaḥ tathā eva āyatanam pratītya 
SA_K14_mavadsuu-859	utpadyate vedayitaṃ narāṇām	utpadyate vedayitam narāṇām 
SA_K14_mavadsuu-860	sātā asātā atha vāpy upekṣā	sātau asātau atha vā api upekṣā 
SA_K14_mavadsuu-861	tisra imā vedanā sparśasaṃbhavā 8	tisraḥ imāḥ vedanāḥ sparśa saṃbhavā 
SA_K14_mavadsuu-862	sparśas tathaivāyatanaṃpratītya	sparśaḥ tathā eva āyatanam pratītya 
SA_K14_mavadsuu-863	utpadyate so 'pi hitasya hetuḥ	utpadyate saḥ u pi hitasya hetuḥ 
SA_K14_mavadsuu-864	cakṣuś ca śrotraṃ ca tathaiva ghrāṇaṃ	cakṣuḥ ca śrotram ca tathā eva ghrāṇam 
SA_K14_mavadsuu-865	jihvā ca kāyaś ca manaś ca ṣaṣṭham 9	jihvā ca kāyaḥ ca manaḥ ca ṣaṣṭham 
SA_K14_mavadsuu-866	idaṃ hi ṣaḍāyatanaṃ sahetukam	idam hi ṣaṣ āyatanam sa hetukam 
SA_K14_mavadsuu-867	utpadyate nāmarūpaṃ pratītya /	utpadyate nāma rūpam pratītya 
SA_K14_mavadsuu-868	riktaṃ ca tucchañ ca asārakañ ca	riktam ca tuccham ca asārakam ca 
SA_K14_mavadsuu-869	anāśvāsikaṃ vipariṇāmadharmam 10	anāśvāsikam vipariṇāma dharmam 
SA_K14_mavadsuu-870	nāma ca rūpaṃ ca kutonidānaṃ	nāma ca rūpam ca kutonidānam 
SA_K14_mavadsuu-871	kiṃpratyayaṃkaḥ punar asya hetuḥ	kiṃpratyayaṃkaḥ punar asya hetuḥ 
SA_K14_mavadsuu-872	ity etam arthaṃ paricintayāno	iti etam artham paricintayānaḥ 
SA_K14_mavadsuu-873	dadarśa vijñānanidānam eva 11	dadarśa vijñāna nidānam eva 
SA_K14_mavadsuu-874	vijñānam etac ca kutonidānaṃ	vijñānam etat ca kutonidānam 
SA_K14_mavadsuu-875	kiṃpratyayaṃ kaḥ punar asya hetuḥ	kiṃpratyayam kaḥ punar asya hetuḥ 
SA_K14_mavadsuu-876	ity etam arthaṃ pravaṇe vicintya	iti etam artham pravaṇe vicintya 
SA_K14_mavadsuu-877	dadarśa saṃskāranidānam eva 12	dadarśa saṃskāra nidānam eva 
SA_K14_mavadsuu-878	kṛtsnaṃ ca saṃskāragataṃ yad etat	kṛtsnam ca saṃskāra gatam yat etat 
SA_K14_mavadsuu-879	kiṃpratyayaṃ kaḥ punar asya hetuḥ	kiṃpratyayam kaḥ punar asya hetuḥ 
SA_K14_mavadsuu-880	ity etam arthaṃ bhagavāṃ Vipaśyī	iti etam artham bhagavān vipaśyī 
SA_K14_mavadsuu-881	dadarśa ajñānanidānam eva 13	dadarśa ajñāna nidānam eva 
SA_K14_mavadsuu-882	evam idaṃ bhavati sahetukaṃ bhṛśaṃ	evam idam bhavati sa hetukam bhṛśam 
SA_K14_mavadsuu-883	sapratyayam asti nidānam asya /	sa pratyayam asti nidānam asya 
SA_K14_mavadsuu-884	tasmād duḥkhe vipariṇāmadharme	tasmāt duḥkhe vipariṇāma dharme 
SA_K14_mavadsuu-885	jñātvā pipāsāṃ vinayanti paṇḍitā 14	jñātvā pipāsām vinayanti 
SA_K14_mavadsuu-886	tad idaṃ hi devair na kṛtaṃ na mānuṣair	tat idam hi devaiḥ na kṛtam na mānuṣaiḥ 
SA_K14_mavadsuu-887	na ceśvarair nirmitaṃ nābhivādyaiḥ	na ca īśvaraiḥ nirmitam na abhivādyaiḥ 
SA_K14_mavadsuu-888	pratyeti vidvāṃ kuśalasmṛtaś ca	pratyeti vidvān kuśala smṛtaḥ ca 
SA_K14_mavadsuu-889	duḥkhasya jñātvā prabhavaṃ śamaṃ ca 15	duḥkhasya jñātvā prabhavam śamam ca 
SA_K14_mavadsuu-890	ajñānam etac ca yadā nirudhyate	ajñānam etat ca yadā nirudhyate 
SA_K14_mavadsuu-891	ime 'pi saṃskāras tadā na santi /	ime pi saṃskāraḥ tadā na santi 
SA_K14_mavadsuu-892	ime 'pi saṃskāra yadā na santi	ime pi saṃskāra yadā na santi 
SA_K14_mavadsuu-893	idaṃ ca vijñānam atho nirudhyate 16	idam ca vijñānam atha u nirudhyate 
SA_K14_mavadsuu-894	vijñānam etac ca yadā nirudhyate	vijñānam etat ca yadā nirudhyate 
SA_K14_mavadsuu-895	nāma ca rūpaṃ ca tato nirudhyate /	nāma ca rūpam ca tatas nirudhyate 
SA_K14_mavadsuu-896	nāma ca rūpaṃ ca yadā aśeṣaṃ	nāma ca rūpam ca yadā aśeṣam 
SA_K14_mavadsuu-897	nirudhyate nāyatanāni santi 17	nirudhyate na āyatanāni santi 
SA_K14_mavadsuu-898	imāni ced āyatanāny aśeṣaṃ	imāni ced āyatanāni aśeṣam 
SA_K14_mavadsuu-899	yadā nirudhyaṃti na santi sparśā /	yadā nirudhyaṃti na santi sparśā 
SA_K14_mavadsuu-900	sparśeṣv asatsu na bhavaṃti vedanā	sparśeṣu asatsu na bhavanti vedanā 
SA_K14_mavadsuu-901	avedayānasya na saṃti tṛṣṇā 18	a vedayānasya na saṃti tṛṣṇā 
SA_K14_mavadsuu-902	tṛṣṇānirodhān nopādadāti	tṛṣṇā nirodhāt na upādadāti 
SA_K14_mavadsuu-903	anupādadānasya bhavā na santi /	an upādadānasya bhavāḥ na santi 
SA_K14_mavadsuu-904	bhavasya cādhyastagamān nirodhāj	bhavasya ca adhyasta gamāt nirodhāt 
SA_K14_mavadsuu-905	jātiḥ kadācin na kathaṃcid asti 19	jātiḥ kadācid na kathaṃcid asti 
SA_K14_mavadsuu-906	jāter nirodhān maraṇaṃ jarā ca	jāteḥ nirodhāt maraṇam jarā ca 
SA_K14_mavadsuu-907	śokaś ca duḥkhaṃ paridevitaṃ ca /	śokaḥ ca duḥkham paridevitam ca 
SA_K14_mavadsuu-908	sarvasya cādhyastagamo nirodhaś	sarvasya ca adhyasta gamaḥ nirodhaḥ 
SA_K14_mavadsuu-909	cakṣuṣmatā evam idaṃ nibuddham 20	cakṣuṣmatā evam idam nibuddham 
SA_K14_mavadsuu-910	gaṃbhīram etaṃ nipuṇaṃ sudurdṛśaṃ	gaṃbhīram etam nipuṇam su durdṛśam 
SA_K14_mavadsuu-911	pratītyasamutpādam avaiti śāstā /	pratītyasamutpādam avaiti śāstā 
SA_K14_mavadsuu-912	asmiṃ satīdaṃ hi sadā pravartate	asmin sati idam hi sadā pravartate 
SA_K14_mavadsuu-913	asati ca tasmiṃ hi sadā na bhavati 21	asati ca tasmin hi sadā na bhavati 
SA_K14_mavadsuu-914	yadā prajānāti yatonidānaṃ	yadā prajānāti yatonidānam 
SA_K14_mavadsuu-915	yāṃ pratyayān āyatanāni santi /	yām pratyayān āyatanāni santi 
SA_K14_mavadsuu-916	na tasya bhūya ito bahirdhā	na tasya bhūyaḥ itas bahirdhā 
SA_K14_mavadsuu-917	paryeṣaṇā bhavati svayaṃ viditvā 22	paryeṣaṇā bhavati svayam viditvā 
SA_K14_mavadsuu-918	yadā ca taṃ paśyaty ātmanaiva	yadā ca tam paśyati ātmanā eva 
SA_K14_mavadsuu-919	na nāma bhavati parivartakaḥ saḥ	na nāma bhavati parivartakaḥ saḥ 
SA_K14_mavadsuu-920	prahāya moham udapādi jñānaṃ	prahāya moham udapādi jñānam 
SA_K14_mavadsuu-921	duḥkhasya jñātvā prabhavaṃ śamaṃ ca 23	duḥkhasya jñātvā prabhavam śamam ca 
SA_K14_mavadsuu-922	cittaṃ yadā caitasikāś ca dharmā	cittam yadā caitasikāḥ ca dharmāḥ 
SA_K14_mavadsuu-923	anityatas suviditā bhavanti /	anityatas su viditāḥ bhavanti 
SA_K14_mavadsuu-924	hīnaṃ praṇītaṃ ca yad asti rūpaṃ	hīnam praṇītam ca yat asti rūpam 
SA_K14_mavadsuu-925	samyagdṛśo vetti pralopadharmam 24	samyak dṛśaḥ vetti pralopa dharmam 
SA_K14_mavadsuu-926	yam āha duḥkhopanayaṃ sukhāvahaṃ	yam āha duḥkha upanayam sukha āvaham 
SA_K14_mavadsuu-927	mārgaṃ śivaṃ yātum ananyaneyam	mārgam śivam yātum an anya neyam 
SA_K14_mavadsuu-928	.ai _ ^ _ _ ^ ^ _ ^ _ X	di-2 di-2 ro-0
SA_K14_mavadsuu-929	yā vā akopyā atulā anaṅgaṇā	yā vai a kopyā atulā an aṅgaṇā 
SA_K14_mavadsuu-930	virā ^ _ _ ^ ^ _ ^ _ ^ X /	ro-0 
SA_K14_mavadsuu-931	X kaḥ sa _ _ ^ ^ _ ^ _ ^ X	kaḥ sa 
SA_K14_mavadsuu-932	X _ ^ _ _ ^ ^ _ kuleṣu /	         
SA_K14_mavadsuu-933	vālam iva tiro vitatakṣureṇa	vālam iva tiras vitata kṣureṇa 
SA_K14_mavadsuu-934	prati ^ _ _ ^ ^ _ ^ _ X 27	ro-0 
SA_K14_mavadsuu-935	X _ ^ _ _ vigatāsya saṃjñā /	ro vigatā asya saṃjñā 
SA_K14_mavadsuu-936	nānān ^ _ _ ^ ^ _ ^ _ ṣe	nānān          ṣe 
SA_K14_mavadsuu-937	sa rāṣṭṛ _ _ ^ ^ _ ^ _ X 28 //	sa rāṣṭṛ 
SA_K14_mavadsuu-938	5. The Four Noble Truths	the four nobel truths 
SA_K14_mavadsuu-939	tatredānīṃ Vipaśyī bodhisatvo jarāmaraṇam adrākṣīj jarāmaraṇasamudayaṃ jarāmaraṇanirodhaṃ	tatra idānīm vipaśyī bodhisatvaḥ jarā maraṇam adrākṣīt jarā maraṇa samudayam jarā maraṇa nirodham 
SA_K14_mavadsuu-940	jarāmaraṇanirodhagāminīṃ pratipadam adrākṣīt evaṃ jātiṃ bhavam upādānaṃ tṛṣṇāṃ vedanāṃ	jarā maraṇa nirodha gāminīm pratipadam adrākṣīt evam jātim bhavam upādānam tṛṣṇām vedanām 
SA_K14_mavadsuu-941	sparśaṃ ṣaḍāyatanaṃ nāmarūpaṃ	sparśam ṣaṣ āyatanam nāma rūpam 
SA_K14_mavadsuu-942	vijñānaṃ saṃskārān adrākṣīt saṃskārasamudayaṃ saṃskāranirodhaṃ saṃskāranirodhagāminīṃ pratipadam adrākṣīt	vijñānam saṃskārān adrākṣīt saṃskāra samudayam saṃskāra nirodham saṃskāra nirodha gāminīm pratipadam adrākṣīt 
SA_K14_mavadsuu-943	rūpam adrākṣīd rūpasamudayaṃ rūpanirodhaṃ rūpanirodhagāminīṃ pratipadam adrākṣīt	rūpam adrākṣīt rūpa samudayam rūpa nirodham rūpa nirodha gāminīm pratipadam adrākṣīt 
SA_K14_mavadsuu-944	vedanāṃ saṃjñāṃ saṃskārāṃ vijñānam adrākṣīt vijñānasamudayaṃ vijñānanirodhaṃ vijñānanirodhagāminīṃ pratipadam adrākṣīt	vedanām saṃjñām saṃskārām vijñānam adrākṣīt vijñāna samudayam vijñāna nirodham vijñāna nirodha gāminīm pratipadam adrākṣīt 
SA_K14_mavadsuu-945	jñānaṃ cāsya darśanaṃ cotpannaṃ saṃbodhapakṣikeṣu dharmeṣu kṣīṇā me jātir uṣitaṃ brahmacaryaṃ kṛtaṃ karaṇīyaṃ nāparam asmād bhavaṃ	jñānam ca asya darśanam ca utpannam saṃbodha pakṣikeṣu dharmeṣu kṣīṇā me jātiḥ uṣitam brahmacaryam kṛtam karaṇīyam na aparam asmāt bhavam 
SA_K14_mavadsuu-946	prajānāmy anuttarāṃ samyaksaṃbodhim abhisaṃbuddho 'smīty adhyajñāsīd iyam atra dharmatā tasmād idam ucyate //	prajānāmi anuttarām samyaksaṃbodhim abhisaṃbuddhaḥ smi iti adhyajñāsīt iyam atra dharmatā tasmāt idam ucyate 
SA_K14_mavadsuu-947	rūpaṃ ca saṃjñāṃ ca tathaiva vedanāṃ	rūpam ca saṃjñām ca tathā eva vedanām 
SA_K14_mavadsuu-948	saṃskāraṃ vijñānam anityam adhya X /	saṃskāram vijñānam anityam x 
SA_K14_mavadsuu-949	na e ^ _ _ ^ ^ _ ^ _ ^ tis	na e di di tis 
SA_K14_mavadsuu-950	tatraiva saṃprāptavan āsravakṣayam 1	tatra eva saṃprāptavan āsrava kṣayam 
SA_K14_mavadsuu-951	picur yathā mārutavegapreritaṃ	picuḥ yathā māruta vega preritam 
SA_K14_mavadsuu-952	diśo diśaṃ gacchati preryamāṇaḥ	diśaḥ diśam gacchati preryamāṇaḥ 
SA_K14_mavadsuu-953	tathaiva mārasya balaṃ su _ ^ X	tathā eva mārasya balam xc
SA_K14_mavadsuu-954	X _ ^ _ s tūlapicu ^ _ X 2 //	ro-0 
SA_K14_mavadsuu-955	6. The Two Questions	the two questions 
SA_K14_mavadsuu-956	acirābhisaṃbuddhasya Vipaśyinaḥ samyaksaṃbuddhasya dvau vitarkau bahulaṃ samudācāriṣṭām naiṣkramyavitarkaś ca pravivekavitarkaś ca iyam atra  #	acira abhisaṃbuddhasya vipaśyinaḥ samyaksaṃbuddhasya dvau vitarkau bahulam samudācāriṣṭām naiṣkramya vitarkaḥ ca praviveka vitarkaḥ ca iyam atra 
SA_K14_mavadsuu-957	dharmatā tasmād idam ucyate //	dharmatā tasmāt idam ucyate 
SA_K14_mavadsuu-958	tathāgatasyāpratituly. _ X	tathāgatasya apratitulī 
SA_K14_mavadsuu-959	X _ ^ _ _ ^ ^ _ ^ _ l. /	ro-0 di-1 ns-1 
SA_K14_mavadsuu-960	babhūva _ _ ^ ^ _ katā ^ X	babhūva      xc
SA_K14_mavadsuu-961	X _ ^ _ _ ^ ^ _ ^ tāyinaḥ 1	           
SA_K14_mavadsuu-962	X _ ^ _ dharmavaśimān aśeṣo	ro 
SA_K14_mavadsuu-963	viśvottaras tṛṣṇākṣayād viraktaḥ	viśva uttaraḥ tṛṣṇā kṣayāt viraktaḥ 
SA_K14_mavadsuu-964	vimuktacitto hy akhilo anāsravo	vimukta cittaḥ hi akhilaḥ anāsravaḥ 
SA_K14_mavadsuu-965	vya _ ^ _ _ ^ ^ _ ^ _ ^ X 2 //	ro-0 di-1 
SA_K14_mavadsuu-966	7. The Resolution to Preach	the resolution to preach 
SA_K14_mavadsuu-967	atha Vipaśyinaḥ samyaksaṃbuddhasyaitad abhavat kasya nv ahaṃ Bandhumatyāṃ rājadhānyāṃ prathamato dharman deśayeyam	atha vipaśyinaḥ samyaksaṃbuddhasya etat abhavat kasya nu aham bandhumatyām rājadhānyām prathamatas dharman deśayeyam 
SA_K14_mavadsuu-968	atha Vipaśyinaḥ samyaksaṃbuddhasyaitad abhavat yanv ahaṃ Khaṇḍasya ca rājakumārasya	atha vipaśyinaḥ samyaksaṃbuddhasya etat abhavat yanu aham khaṇḍasya ca rāja kumārasya 
SA_K14_mavadsuu-969	Tiṣyasya ca purohitaputrasya prathamato dharman deśayeyam iyam atra dharmatā tasmād idam ucyate //	tiṣyasya ca purohita putrasya prathamatas dharman deśayeyam iyam atra dharmatā tasmāt idam ucyate 
SA_K14_mavadsuu-970	śaile yathā parvatamūrdhani sthito	śaile yathā parvata mūrdhani 
SA_K14_mavadsuu-971	yadvāṃ hi paśyej janatāṃ samantāt	yat vām hi paśyet janatām samantāt 
SA_K14_mavadsuu-972	tathā hy asau dharmamayaṃ sumedha	tathā hi asau dharma mayam sumedha 
SA_K14_mavadsuu-973	prāsādam āruhya samantacakṣuḥ	prāsādam āruhya samanta cakṣuḥ 
SA_K14_mavadsuu-974	śokābhibhūtāṃ janatām aśoko	śoka abhibhūtām janatām aśokaḥ 
SA_K14_mavadsuu-975	'drākṣīd imāṃ jātijarābhibhūtām //	drākṣīt imām jāti jarā abhibhūtām 
SA_K14_mavadsuu-976	8. The Buddha Goes to Bandhumatī	the buddha goes to bandhumatī 
SA_K14_mavadsuu-977	atha Vipaśyī samyaksaṃbuddho bodhimūlaṃ yathābhiramyaṃ vihṛtya yena Bandhumatī rājadhānī	atha vipaśyī samyaksaṃbuddhaḥ bodhi mūlam yathā abhiramyam vihṛtya yena bandhumatī rājadhānī 
SA_K14_mavadsuu-978	tena caryāṃ prakrāntaḥ Vipaśyī samyaksaṃbuddho Bandhumatīṃ rājadhānīm anuprāptaḥ	tena caryām prakrāntaḥ vipaśyī samyaksaṃbuddhaḥ bandhumatīm rājadhānīm anuprāptaḥ 
SA_K14_mavadsuu-979	iyam atra dharmatā tasmād idam ucyate //	iyam atra dharmatā tasmāt idam ucyate 
SA_K14_mavadsuu-980	siṃho yathā parvatakuṃjavāsī	siṃhaḥ yathā parvata kuṃja vāsī 
SA_K14_mavadsuu-981	viś _ ^ _ _ ^ ^ _ ^ _ X /	ro-0 di-1 
SA_K14_mavadsuu-982	X _ ^ _ _ ^ ^ mo ^ _ X	xc-xc-xc-
SA_K14_mavadsuu-983	X bandhumatyāṃ ^ ^ _ ^ _ X //	x bandhumatyām 
SA_K14_mavadsuu-984	9. The First Sermon to the Two Principal Disciples	the first sermon to the two principal disciples 
SA_K14_mavadsuu-985	atha Vipaśyī samyaksaṃbuddho dāvapālaṃ puruṣam āmantrayati	atha vipaśyī samyaksaṃbuddhaḥ dāva pālam puruṣam āmantrayati 
SA_K14_mavadsuu-986	ehi tvaṃ bho dāvapāla yena Khaṇḍaś ca rājakumāras Tiṣyaś ca purohitaputras tenopasaṃkrāma	ehi tvam bho dāvapāla yena khaṇḍaḥ ca rāja kumāraḥ tiṣyaḥ ca purohita putraḥ tena upasaṃkrāma 
SA_K14_mavadsuu-987	upetya Khaṇḍañ ca rājakumāraṃ Tiṣyañ ca purohitaputram evaṃ vada Vipaśyī yuvāṃ samyaksaṃbuddho	upetya khaṇḍam ca rāja kumāram tiṣyam ca purohita putram evam vada vipaśyī yuvām samyaksaṃbuddhaḥ 
SA_K14_mavadsuu-988	āgataḥ sa vāṃ draṣṭukāmaḥ	āgataḥ sa vām draṣṭu kāmaḥ 
SA_K14_mavadsuu-989	evaṃ bhadanteti sa dāvapālo puruṣo Vipaśyinaḥ samyaksaṃbudhasya pratiśrutya yena	evam bhadanta iti sa dāvapālo puruṣaḥ vipaśyinaḥ samyaksaṃbudhasya pratiśrutya yena 
SA_K14_mavadsuu-990	Khaṇḍaś ca rājakumāras Tiṣyaś ca purohitaputras tenopajagāma upetya Khaṇḍaṃ ca rājakumāraṃ	khaṇḍaḥ ca rāja kumāraḥ tiṣyaḥ ca purohita putraḥ tena upajagāma upetya khaṇḍam ca rāja kumāram 
SA_K14_mavadsuu-991	Tiṣyañ ca purohitaputram idam avocat	tiṣyam ca purohita putram idam avocat 
SA_K14_mavadsuu-992	Vipaśyī yuvāṃ samyaksaṃbuddho āgataḥ sa vāṃ draṣṭukāmaḥ	vipaśyī yuvām samyaksaṃbuddhaḥ āgataḥ sa vām draṣṭu kāmaḥ 
SA_K14_mavadsuu-993	atha khalu Khaṇḍaś ca rājakumāras Tiṣyaś ca purohitaputras tasya puruṣasya pratiśrutya	atha khalu khaṇḍaḥ ca rāja kumāraḥ tiṣyaḥ ca purohita putraḥ tasya puruṣasya pratiśrutya 
SA_K14_mavadsuu-994	yena Vipaśyī samyaksaṃbuddhas tenopajagmatuḥ upetya Vipaśyinaḥ samyaksaṃbuddhasya	yena vipaśyī samyaksaṃbuddhaḥ tena upajagmatuḥ upetya vipaśyinaḥ samyaksaṃbuddhasya 
SA_K14_mavadsuu-995	pādau śirasā vanditvā ekāṃte nyaṣīdatām (MAV 148)	pādau śirasā vanditvā ekānte nyaṣīdatām 
SA_K14_mavadsuu-996	ekāntaniṣaṇṇau Khaṇḍañ ca rājakumāraṃ Tiṣyaṃ ca purohitaputraṃ Vipaśyī samyaksaṃbuddhas tribhiḥ prātihāryair avavadati ṛddhiprātihāryeṇādeśanāprātihāryeṇa	ekānta niṣaṇṇau khaṇḍam ca rāja kumāram tiṣyam ca purohita putram vipaśyī samyaksaṃbuddhaḥ tribhiḥ prātihāryaiḥ avavadati ṛddhi prātihāryeṇa ādeśanā prātihāryeṇa 
SA_K14_mavadsuu-997	tau tribhiḥ prātihāryaiḥ samyag avavadyamānausamyag anuśiṣyamāṇau tatraiva saṃprāptavantāv āsravakṣayam iyam atra dharmatā tasmād idam ucyate	tau tribhiḥ prātihāryaiḥ samyak avavadyamānau samyak anuśiṣyamāṇau tatra eva saṃprāptavantau āsrava kṣayam iyam atra dharmatā tasmāt idam ucyate 
SA_K14_mavadsuu-998	saṃbodhilabdhas tad upāgamaj jinaḥ	saṃbodhi labdhaḥ tat upāgamat jinaḥ 
SA_K14_mavadsuu-999	X _ ^ _ _ m amṛtaṃ prakāśitaṃ	ro amṛtam prakāśitam 
SA_K14_mavadsuu-1000	pravartitaṃ bhagavatā dharmacakram 1	pravartitam bhagavatā dharmacakram 
SA_K14_mavadsuu-1001	tau KhaṇḍaTiṣyau sugatasya śrāvakau	tau khaṇḍa tiṣyau sugatasya śrāvakau 
SA_K14_mavadsuu-1002	X _ ^ _ _ pratividhyatus tadā	ro     pratividhyatuḥ tadā 
SA_K14_mavadsuu-1003	tatraiva prāptavantāv āsravakṣayam 2 //	tatra eva prāptavantau āsrava kṣayam 
SA_K14_mavadsuu-1004	10. Another Eightythousand People of Bandhumatī Renounce the World	another eightythousand people of bandhumatī renounce the world 
SA_K14_mavadsuu-1005	aśrauṣur Bandhumatyāṃ rājadhānyām aśītiprāṇasahasrāṇi Khaṇḍaś ca rājakumāras Tiṣyaś	aśrauṣuḥ bandhumatyām rājadhānyām aśīti prāṇa sahasrāṇi khaṇḍaḥ ca rāja kumāraḥ tiṣyaḥ 
SA_K14_mavadsuu-1006	ca purohitaputraḥ keśaśmaśrūṇy avatārya kāṣāyāṇi vastrāṇy āchādya samyag eva śraddhayā	ca purohita putraḥ keśa śmaśrūṇi avatārya kāṣāyāṇi vastrāṇi āchādya samyak eva śraddhayā 
SA_K14_mavadsuu-1007	agārād anagārikāṃ pravrajitau	agārāt anagārikām pravrajitau 
SA_K14_mavadsuu-1008	śrutvā ca punar eṣām etad abhavan na batāvaro dharmo bhaviṣyati nāvaraṃ dharmākhyānaṃ	śrutvā ca punar eṣām etat abhavat na bata avaraḥ dharmaḥ bhaviṣyati na avaram dharma ākhyānam 
SA_K14_mavadsuu-1009	yatredānīṃ Khaṇḍaś ca rājakumāras Tiṣyaś ca purohitaputras tathā sukumārau tathā	yatra idānīm khaṇḍaḥ ca rāja kumāraḥ tiṣyaḥ ca purohita putraḥ tathā sukumārau tathā 
SA_K14_mavadsuu-1010	sukhaiṣiṇau keśaśmaśrūṇy avatārya kāṣāyāṇi vastrāṇy āchādya samyag eva śraddhayā	sukha eṣiṇau keśa śmaśrūṇi avatārya kāṣāyāṇi vastrāṇi āchādya samyak eva śraddhayā 
SA_K14_mavadsuu-1011	agārād anagārikāṃ pravrajitau	agārāt anagārikām pravrajitau 
SA_K14_mavadsuu-1012	śrutvā ca punas te 'pi keśaśmaśrūṇy avatārya kāṣāyāṇi vastrāṇy āchādya samyag eva śraddhayāgārād anagārikāṃ pravrajitā iyam atra dharmatā tasmād  #	śrutvā ca punar te pi keśa śmaśrūṇi avatārya kāṣāyāṇi vastrāṇi āchādya samyak eva śraddhayā āgārāt anagārikām pravrajitāḥ iyam atra dharmatā tasmāt 
SA_K14_mavadsuu-1013	idam ucyate //	idam ucyate 
SA_K14_mavadsuu-1014	āścaryarūpaṃ pratibhāti me tad	āścarya rūpam pratibhāti me tat 
SA_K14_mavadsuu-1015	yāvat susaṃvejakāḥ śuddhasatvā /	yāvat su saṃvejakāḥ śuddha satvā 
SA_K14_mavadsuu-1016	śrutvāhi pravrajitau KhaṇḍaTiṣyau	śrutvā hi pravrajitau khaṇḍa tiṣyau 
SA_K14_mavadsuu-1017	pravrajyāṃ tatra samupāgatāś ca //	pravrajyām tatra samupāgatāḥ ca 
SA_K14_mavadsuu-1018	11. The Display of the Three Attainments	the display of the three attainments 
SA_K14_mavadsuu-1019	athāśītir bhikṣusahasrāṇi yena Vipaśyī samyaksaṃbuddhastenopajagmur upetya Vipaśyinaḥ	atha aśītiḥ bhikṣu sahasrāṇi yena vipaśyī samyaksaṃbuddhaḥ tena upajagmuḥ upetya vipaśyinaḥ 
SA_K14_mavadsuu-1020	samyaksaṃbuddhasya pādau śirasā vanditvā ekānte nyaṣīdan ekāntaniṣaṇṇāny aśītir bhikṣusahasrāṇi	samyaksaṃbuddhasya pādau śirasā vanditvā ekānte nyaṣīdan ekānta niṣaṇṇāni aśītiḥ bhikṣu sahasrāṇi 
SA_K14_mavadsuu-1021	Khaṇḍo rājakumāra ṛddhiprātihāryeṇāvavadati Tiṣyaḥ purohitaputra ādeśanāprātihāryeṇāvavadati	khaṇḍaḥ rāja kumāraḥ ṛddhi prātihāryeṇa avavadati tiṣyaḥ purohita putraḥ ādeśanā prātihāryeṇa avavadati 
SA_K14_mavadsuu-1022	Vipaśyī samyaksaṃbuddha ānuśāsanāprātihāryeṇāvavadati	vipaśyī samyaksaṃbuddhaḥ ā anuśāsanā prātihāryeṇa avavadati 
SA_K14_mavadsuu-1023	te tribhiḥ prātihāryaiḥ samyag avavadyamānāḥ samyag anuśiṣyamānās tatraiva saṃprāptavanta āsravakṣayam iyam atra dharmatā tasmād idam ucyate	te tribhiḥ prātihāryaiḥ samyak avavadyamānāḥ samyak anuśiṣyamānāḥ tatra eva saṃprāptavantaḥ āsrava kṣayam iyam atra dharmatā tasmāt idam ucyate 
SA_K14_mavadsuu-1024	Khaṇḍaś ca _ _ ^ ^ _ ^ _ ^ X	khaṇḍaḥ ca 
SA_K14_mavadsuu-1025	12. Return of the First Eightythousand Renunciants of Bandhumatī	return of the first eightythousand renunciants of bandhumatī 
SA_K14_mavadsuu-1026	aśrauṣus tāni pūrvakāṇy aśītir bhikṣusahasrāṇi Vipaśyī samyaksaṃbuddho 'nuttarāṃ samyaksaṃbodhim abhisaṃbuddho deśayati Bandhumatyāṃ rājadhānyāṃ	aśrauṣuḥ tāni pūrvakāṇi aśītiḥ bhikṣu sahasrāṇi vipaśyī samyaksaṃbuddhaḥ nuttarām samyaksaṃbodhim abhisaṃbuddhaḥ deśayati bandhumatyām rājadhānyām 
SA_K14_mavadsuu-1027	śrutvā ca punas te 'pi yena Bandhumatī rājadhānī tena caryāṃ prakrāntā iyam atra dharmatā tasmād idam ucyate //	śrutvā ca punar te yena bandhumatī rājadhānī tena caryām prakrāntāḥ iyam atra dharmatā tasmāt idam ucyate 
SA_K14_mavadsuu-1028	X _ ^ _ _ hi yath. ^ _ ^ X /	ro-0 hi yathā 
SA_K14_mavadsuu-1029	X _ ^ _ _ ^ m asārasaṃjñina	di 
SA_K14_mavadsuu-1030	upāgatā Bandhumatyāṃ ^ _ ^ X //	upāgatāḥ bandhumatyām 
SA_K14_mavadsuu-1031	13. The Display of the Three Attainments to the Eightythousand Renunciants	the display of the three attainments to the eightythousand renunciants 
SA_K14_mavadsuu-1032	athāśītir bhikṣusahasrāṇi yena Vipaśyī samyaksaṃbuddhas tenopajagamuḥ upetya Vipaśyinaḥ	atha aśītiḥ bhikṣu sahasrāṇi yena vipaśyī samyaksaṃbuddhaḥ tena upajagamuḥ upetya vipaśyinaḥ 
SA_K14_mavadsuu-1033	samyaksaṃbuddhasya pādau śirasā vanditvaikānte nyaṣīdan ekāntaniṣaṇṇāny aśītir bhikṣusahasrāṇi	samyaksaṃbuddhasya pādau śirasā vanditvā ekānte nyaṣīdan ekānta niṣaṇṇāni aśītiḥ bhikṣu sahasrāṇi 
SA_K14_mavadsuu-1034	Vipaśyī samyaksaṃbuddhas tribhiḥ prātihāryair avavadati ṛddhiprātihāryeṇādeśanāprātihāryeṇānuśāsanāprātihāryeṇa	vipaśyī samyaksaṃbuddhaḥ tribhiḥ prātihāryaiḥ avavadati ṛddhi prātihāryeṇa ādeśanā prātihāryeṇa anuśāsanā prātihāryeṇa 
SA_K14_mavadsuu-1035	te tribhiḥ prātihāryaiḥ samyag avavadyamānāḥ samyag anuśiṣyamāṇās tatraiva saṃprāptāsravakṣayam iyam atra dharmatā tasmād idam ucyate //	te tribhiḥ prātihāryaiḥ samyak avavadyamānāḥ samyak anuśiṣyamāṇāḥ tatra eva saṃprāpta āsrava kṣayam iyam atra dharmatā tasmāt idam ucyate 
SA_K14_mavadsuu-1036	s X _ ^ _ _ ^ ^ _ ^ _ X	ro-0 di-1 di-1 
SA_K14_mavadsuu-1037	X _ ^ _ _ ^ ^ pākaḥ _ ^ X	xc      pākaḥ 
SA_K14_mavadsuu-1038	X _ ṇa bhavanaśrit. _ ^ _ ^ X //	ṇa bhavana śrit      
SA_K14_mavadsuu-1039	14. Six More Years of Peregrination	six more years of peregrination 
SA_K14_mavadsuu-1040	tena khalu samayena Bandhumatyāṃ rājadhānyāṃ mahān bhikṣusaṃghaḥ prativasati yad uta dvāṣaṣṭabhikṣuśatasahasrāṇi	tena khalu samayena bandhumatyām rājadhānyām mahān bhikṣu saṃghaḥ prativasati yat uta dvāṣaṣṭa bhikṣu śata sahasrāṇi 
SA_K14_mavadsuu-1041	atha Vipaśyinaḥ samyaksaṃbuddhasyaitad abhavad etarhi Bandhumatīṃ rājadhānīṃ niḥśṛtya	atha vipaśyinaḥ samyaksaṃbuddhasya etat abhavat etarhi bandhumatīm rājadhānīm niḥśṛtya 
SA_K14_mavadsuu-1042	mahān bhikṣusaṃghaḥ prativasati yad uta dvāṣaṣṭabhikṣuśatasahasrāṇi yanv ahaṃ śrāvakān	mahān bhikṣu saṃghaḥ prativasati yat uta dvāṣaṣṭa bhikṣu śata sahasrāṇi yanu aham śrāvakān 
SA_K14_mavadsuu-1043	udyojayeyam carata bhikṣavaś caryāṃ bahujanahitāya bahujanasukhāya lokānukampāyārthāya hitāya sukhāya	udyojayeyam carata bhikṣavaḥ caryām bahu jana hitāya bahu jana sukhāya loka anukampāya arthāya hitāya sukhāya 
SA_K14_mavadsuu-1044	devamanuṣyāṇām api tu ṣaṇṇāṃ yūyaṃ varṣāṇām atyayād Bandhumatīṃ rājadhānīm āgacchata prātimokṣasūtroddeśaṃ śrotum	deva manuṣyāṇām api tu ṣaṇṇām yūyam varṣāṇām atyayāt bandhumatīm rājadhānīm āgacchata prātimokṣa sūtra uddeśam śrotum 
SA_K14_mavadsuu-1045	atha devatāḥ Śuddhāvāse sthitās tasya cetasā cittam ājñāya bhagavantam avocan	atha devatāḥ śuddha āvāse sthitāḥ tasya cetasā cittam ājñāya bhagavantam avocan 
SA_K14_mavadsuu-1046	etarhi Bandhumatīṃ rājadhānīn niḥśṛtya mahān bhikṣusaṃghaḥ prativasati yad uta dvāṣaṣṭabhikṣuśatasahasrāṇi	etarhi bandhumatīm rājadhānīt niḥśṛtya mahān bhikṣu saṃghaḥ prativasati yat uta dvāṣaṣṭa bhikṣu śata sahasrāṇi 
SA_K14_mavadsuu-1047	bhagavān śrāvakān udyojayet aham api tathā kariṣyāmi yathā bhikṣavaḥ ṣaṇṇāṃ varṣāṇām	bhagavān śrāvakān udyojayet aham api tathā kariṣyāmi yathā bhikṣavaḥ ṣaṇṇām varṣāṇām 
SA_K14_mavadsuu-1048	atyayād Bandhumatīṃ rājadhānīm āgamiṣyanti prātimokṣasūtroddeśaṃ śrotum	atyayāt bandhumatīm rājadhānīm āgamiṣyanti prātimokṣa sūtra uddeśam śrotum 
SA_K14_mavadsuu-1049	atha Vipaśyī samyaksaṃbuddhaḥ śrāvakān āmaṃtrayati	atha vipaśyī samyaksaṃbuddhaḥ śrāvakān āmaṃtrayati 
SA_K14_mavadsuu-1050	carata bhikṣavaś caryāṃ bahujanahitāya bahujanasukhāya lokānukampāyārthāya hitāya	carata bhikṣavaḥ caryām bahu jana hitāya bahu jana sukhāya loka anukampāya arthāya hitāya 
SA_K14_mavadsuu-1051	sukhāya devamanuṣyāṇām api tu ṣaṇṇāṃ yūyaṃ varṣāṇām atyayād Bandhumatīṃ rājadhānīm	sukhāya deva manuṣyāṇām api tu ṣaṇṇām yūyam varṣāṇām atyayāt bandhumatīm rājadhānīm 
SA_K14_mavadsuu-1052	āgacchata prātimokṣasūtroddeśaṃ śrotum	āgacchata prātimokṣa sūtra uddeśam śrotum 
SA_K14_mavadsuu-1053	evaṃ bhadaṃta iti bhikṣavo Vipaśyinaḥ samyaksaṃbuddhasya pratiśrutya janapadacaryāṃ prakrāntāḥ iyam atra dharmatā tasmād idam ucyate //	evam bhadaṃta iti bhikṣavaḥ vipaśyinaḥ samyaksaṃbuddhasya pratiśrutya janapada caryām prakrāntāḥ iyam atra dharmatā tasmāt idam ucyate 
SA_K14_mavadsuu-1054	yaḥ sārthavāhaḥ sumahāj. _ ^ X	yaḥ sārthavāhaḥ su mahān 
SA_K14_mavadsuu-1055	X reṇa śiṣyāsaṅgāt pramu _ ^ X /	reṇa śiṣya āsaṅgāt 
SA_K14_mavadsuu-1056	X _ ^ _ _ ^ ^ tā diśo diśam 2 //	ro-0 diśaḥ diśam 
SA_K14_mavadsuu-1057	15. The Deities Announce the Years of Peregrination Remaining	the deities annouce the years of peregrination remaining 
SA_K14_mavadsuu-1058	nirgate ekasmin varṣe devatā ārocayaṃti nirgataṃ bhadaṃtāḥ ṣaṇṇāṃ varṣānāṃ ekaṃ varṣam	nirgate ekasmin varṣe devatāḥ ārocayaṃti nirgatam bhadantāḥ ṣaṇṇām varṣānām ekam varṣam 
SA_K14_mavadsuu-1059	pañcanāṃ varṣāṇām atyayād bhavadbhir Bandhumātīṃ rājadhānīṃ gantavyaṃ prātimokṣasūtroddeśaṃ śrotum	pañcanām varṣāṇām atyayāt bhavadbhiḥ bandhumātīm rājadhānīm gantavyam prātimokṣa sūtra uddeśam śrotum 
SA_K14_mavadsuu-1060	nirgatayor dvayor varṣayor devatā ārocayanti nirgate bhadantāś ṣaṇṇāṃ varṣānāṃ dve	nirgatayoḥ dvayoḥ varṣayoḥ devatāḥ ārocayanti nirgate bhadantāḥ ṣaṇṇām varṣānām dve 
SA_K14_mavadsuu-1061	varṣe caturṇāṃ varṣāṇām atyayād bhavadbhir Bandhumatīṃ rājadhānīṃ gaṃtavyaṃ prātimokṣasūtroddeśaṃ śrotum	varṣe caturṇām varṣāṇām atyayāt bhavadbhiḥ bandhumatīm rājadhānīm gaṃtavyam prātimokṣa sūtra uddeśam śrotum 
SA_K14_mavadsuu-1062	nirgateṣu triṣu varṣeṣu yāvan nirgateṣu ṣaṭsu varṣeṣu devatāḥ Śuddhāvāse sthitā bhikṣugaṇaṃ	nirgateṣu triṣu varṣeṣu yāvat nirgateṣu ṣaṭsu varṣeṣu devatāḥ śuddhāvāse sthitāḥ bhikṣu gaṇam 
SA_K14_mavadsuu-1063	vadanti varṣāṇi ṣaṣṭhāni nirgatāni bhavadbhir Bandhumatīṃ rājadhānīṃ gantavyaṃ prātimokṣasūtroddeśaṃ śrotum	vadanti varṣāṇi ṣaṣṭhāni nirgatāni bhavadbhiḥ bandhumatīm rājadhānīm gantavyam prātimokṣa sūtra uddeśam śrotum 
SA_K14_mavadsuu-1064	atha te bhikṣava ekatya svānubhāvena ekatya devatānubhāvena tata eva ājagmur Bandhumatīṃ rājadhānīm iyam atra dharmatā tasmād idam ucyate //	atha te bhikṣavaḥ sva anubhāvena ekatya devatā anubhāvena tatas eva ājagmuḥ bandhumatīm rājadhānīm iyam atra dharmatā tasmāt idam ucyate 
SA_K14_mavadsuu-1065	X _ ^ _ _ ^ ṛṣiṃ praveditām	ro      ṛṣim praveditām 
SA_K14_mavadsuu-1066	śikṣāṃ śrotu _ ^ ta bhikṣavaḥ ^ X	śikṣām śrotu te bhikṣavaḥ x
SA_K14_mavadsuu-1067	nāgā yathā _ ^ tṛṣābhitaptāḥ	nāgāḥ yathā tṛṣā abhitaptāḥ 
SA_K14_mavadsuu-1068	saṃ _ ^ _ _ ^ ^ _ ^ _ X 2 //	ro-0 
SA_K14_mavadsuu-1069	16. The Recitation of the Pratimokṣasūtra	the recitation of the pratimokṣasūtra 
SA_K14_mavadsuu-1070	yadopajagmur dvāṣaṣṭabhikṣuśatasahasrāṇi Bandhumatyāṃ tadā nirmāṇaratīnāṃ devatānām	yadā upajagmuḥ dvāṣaṣṭa bhikṣu śata sahasrāṇi bandhumatyām tadā nirmāṇaratīnām devatānām 
SA_K14_mavadsuu-1071	evam abhavat Vipaśyī samyaksaṃbuddhas tasya dvāṣaṣṭasya bhikṣuśatasahasrāṇāṃ purataḥ	evam abhavat vipaśyī samyaksaṃbuddhaḥ tasya dvāṣaṣṭasya bhikṣu śata sahasrāṇām puratas 
SA_K14_mavadsuu-1072	paryaṃge paryaṃgena niṣīdet niṣadya Vipaśyī samyaksaṃbuddhaḥ prātimokṣasūtroddeśam uddiśet	paryaṃge paryaṃgena niṣīdet niṣadya vipaśyī samyaksaṃbuddhaḥ prātimokṣa sūtra uddeśam uddiśet 
SA_K14_mavadsuu-1073	evam eva Vipaśyī samyaksaṃbuddhas tasya dvāṣaṣṭasya bhikṣuśatasahasrāṇāṃ purataḥ paryaṅke paryaṅkena nyaṣīdan niṣadya Vipaśyī samyaksaṃbuddhaḥ  #	evam eva vipaśyī samyaksaṃbuddhaḥ tasya dvāṣaṣṭasya bhikṣu śata sahasrāṇām puratas paryaṅke paryaṅkena nyaṣīdat niṣadya vipaśyī samyaksaṃbuddhaḥ  /
SA_K14_mavadsuu-1074	prātimokṣasūtroddeśam uddiśati //	prātimokṣa sūtra uddeśam uddiśati 
SA_K14_mavadsuu-1075	kṣāṃtiḥ paramaṃ tapas titīkṣā	kṣāṃtiḥ paramam tapaḥ titīkṣā 
SA_K14_mavadsuu-1076	nirvāṇaṃ paramaṃ vadanti buddhāḥ	nirvāṇam paramam vadanti buddhāḥ 
SA_K14_mavadsuu-1077	na hi pravrajitaḥ paropatāpī	na hi pravrajitaḥ para upatāpī 
SA_K14_mavadsuu-1078	śramaṇo bhavati parāṃ viheṭhayānaḥ //	śramaṇaḥ bhavati parām viheṭhayānaḥ 
SA_K14_mavadsuu-1079	iyam atra dharmatā tasmād idam ucyate //	iyam atra dharmatā tasmāt idam ucyate 
SA_K14_mavadsuu-1080	Vipaśyi śikṣāpadasūtram uktavān	vipaśyi śikṣā pada sūtram uktavān 
SA_K14_mavadsuu-1081	X _ ^ _ _ ^ ^ _ ^ .iddhaḥ //	          iddhaḥ 
SA_K14_mavadsuu-1082	III. How Did the Devatā Preach ?	iii how did the devatā preach 
SA_K14_mavadsuu-1083	kathaṃ devatā ārocayaṃti	katham devatāḥ ārocayanti 
SA_K14_mavadsuu-1084	[Visiting Śuddhāvāsa Heaven]	visiting śuddhāvāsa heaven 
SA_K14_mavadsuu-1085	tasya me etad abhavad a + + + + + + + + + + + + + + + + + + + + + + + + + + + + + + + + + + + + + + + + + na gatapūrvo vā	tasya me etat abhavat na gata pūrvaḥ vā 
SA_K14_mavadsuu-1086	tasya me etad abhavan nāham + + + + + + + + + + ti + + + + + + + + + + + + + + +	tasya me etat abhavat na aham 
SA_K14_mavadsuu-1087	+ + + + + + + + + + + + + + + + + sthāpayitvā + + Śuddhāvāsān devāṃ + + + + + + +	         
SA_K14_mavadsuu-1088	viṣyetāhaṃ lo + + + + + + + + + + + + + + + + + + + + yanv ahaṃ devān Śuddhāvāsān	viṣyeta aham 
SA_K14_mavadsuu-1089	darśanāyopasaṃkrameyam	darśanāya upasaṃkrameyam 
SA_K14_mavadsuu-1090	[Abṛha Heaven]	abṛha heaven 
SA_K14_mavadsuu-1091	so 'haṃ tadyathā balavān puruṣaḥ saṃmiñjitaṃ vā bāhuṃ prasārayet prasāritaṃ vā saṃmiñjayed evam evāhaṃ Jambudvīpe 'ntarhito 'bṛhe devanikāye	saḥ ham tat yathā balavān puruṣaḥ saṃmiñjitam vā bāhum prasārayet prasāritam vā saṃmiñjayet evam eva aham jambudvīpe ntarhitaḥ bṛhe devanikāye 
SA_K14_mavadsuu-1092	adarśann Abṛhakāyikā devatā māṃ dūrata eva dṛṣṭvā ca punar evam āhuḥ ehi bhagavaṃ	adarśan abṛha kāyikāḥ devatāḥ mām dūratas eva dṛṣṭvā ca punar evam āhuḥ ehi bhagavan 
SA_K14_mavadsuu-1093	svāgataṃ bhadanta kuto bhagavāṃś ciracirasya paryāyam akārṣīd ihāgamanāya niṣīdatu	svāgatam bhadanta kutas bhagavān cira cirasya paryāyam akārṣīt iha āgamanāya niṣīdatu 
SA_K14_mavadsuu-1094	bhagavān prajñapta evāsane	bhagavān prajñapte eva āsane 
SA_K14_mavadsuu-1095	nyaṣīdam ahaṃ prajñapta evāsane	nyaṣīdam aham prajñapte eva āsane 
SA_K14_mavadsuu-1096	athābṛhakāyikā devatā mama pādau śirasā vanditvā ekānte nyaṣīdann ekāntaniṣaṇṇā Abṛhakāyikā devatā ahaṃ dhārmyā kathayā saṃdarśayāmi samādāpayāmi  #	atha abṛha kāyikāḥ devatāḥ mama pādau śirasā vanditvā ekānte nyaṣīdan ekānta niṣaṇṇāḥ abṛha kāyikāḥ devatāḥ aham dhārmyā kathayā saṃdarśayāmi samādāpayāmi 
SA_K14_mavadsuu-1097	samuttejayāmi saṃpraharṣayāmi	samuttejayāmi saṃpraharṣayāmi 
SA_K14_mavadsuu-1098	athaikatyā Abṛhakāyikā devatā utthāyāsanād ekāṃsam uttarāsaṅgaṃ kṛtvā yenāhaṃ tenāṃjaliṃ praṇamya mām idam avocan	atha ekatyāḥ a bṛha kāyikāḥ devatāḥ utthāya āsanāt eka aṃsam uttarāsaṅgam kṛtvā yena aham tena aṃjalim praṇamya mām idam avocan 
SA_K14_mavadsuu-1099	vayaṃ bhadanta Vipaśyinaḥ samyaksaṃbuddhasya śrāvakā Vipaśyinaḥ samyaksaṃbuddhasyāntike	vayam bhadanta vipaśyinaḥ samyaksaṃbuddhasya śrāvakāḥ vipaśyinaḥ samyaksaṃbuddhasya antike 
SA_K14_mavadsuu-1100	brahmacaryaṃ caritvehopapannāḥ vayaṃ Śikhinaḥ vayaṃ Viśvabhujaḥ vayaṃ Krakasundasya	brahmacaryam caritvā iha upapannāḥ vayam śikhinaḥ vayam viśvabhujaḥ vayam krakasundasya 
SA_K14_mavadsuu-1101	vayaṃ Kanakamuneḥ vayaṃ Kāśyapasya vayaṃ bhagavataḥ śrāvakā bhagavato 'ntike brahmacaryaṃ caritvehopapannāḥ	vayam kanakamuneḥ vayam kāśyapasya vayam bhagavataḥ śrāvakāḥ bhagavataḥ ntike brahmacaryam caritvā iha upapannāḥ 
SA_K14_mavadsuu-1102	[From Atapa Heaven to Sudarśana Heaven]	from atapa heaven to sudarśana heaven 
SA_K14_mavadsuu-1103	so 'ham Abṛhakāyikā devatādhārmyā kathayā saṃdarśayitvā samādāpayitvā samuttejayitvā	saḥ u ham a bṛha kāyikā devatā dhārmyā kathayā saṃdarśayitvā samādāpayitvā samuttejayitvā 
SA_K14_mavadsuu-1104	saṃpraharṣayitvā tadrūpaṃ samādhiṃ samāpanno yathā samāhite citte Abṛhakāyikābhir	saṃpraharṣayitvā tad rūpam samādhim samāpannaḥ yathā samāhite citte a bṛha kāyikābhiḥ 
SA_K14_mavadsuu-1105	devatābhiḥ sārdham Abṛhe devanikāye 'ntarhito 'tape devanikāye yāvat Sudarśane devanikāye	devatābhiḥ sārdham abṛhe devanikāye tape devanikāye yāvat sudarśane devanikāye 
SA_K14_mavadsuu-1106	pratyasthām pūrvavad yāvad	pratyasthām pūrvavat yāvat 
SA_K14_mavadsuu-1107	[Akaniṣṭha Heaven]	akaniṣṭha heaven 
SA_K14_mavadsuu-1108	yanv ahaṃ devān apy Akaniṣṭhakāyikāṃ darśanāyopasaṃkrameyam	yanu aham devān api a kaniṣṭha kāyikām darśanāya upasaṃkrameyam 
SA_K14_mavadsuu-1109	so 'haṃ tadyathā balavān puruṣaḥ saṃmiñjitaṃ vā bāhuṃ prasārayet prasāritaṃ vā saṃmiñjayed	saḥ ham tat yathā balavān puruṣaḥ saṃmiñjitam vā bāhum prasārayet prasāritam vā saṃmiñjayet 
SA_K14_mavadsuu-1110	evam evāham Abṛhakāyikābhir devatābhiḥ sārdham Atapakāyikābhir devatābhiḥ sārdhaṃ	evam eva aham a bṛha kāyikābhiḥ devatābhiḥ sārdham a tapa kāyikābhiḥ devatābhiḥ sārdham 
SA_K14_mavadsuu-1111	Sudṛśakāyikābhir devatābhiḥ sārdhaṃ Sudarśanakāyikābhir devatābhiḥ sārdhaṃ Sudarśane	sudṛśa kāyikābhiḥ devatābhiḥ sārdham sudarśana kāyikābhiḥ devatābhiḥ sārdham sudarśane 
SA_K14_mavadsuu-1112	devanikāye 'ntarhito 'kaniṣṭhe devanikāye pratyasthām	devanikāye ntarhitaḥ kaniṣṭhe devanikāye pratyasthām 
SA_K14_mavadsuu-1113	adarśann Akaniṣṭhakāyikā devatā māṃ dūrata eva dṛṣṭvā ca punar evam āhuḥ ehi bhagavaṃ	adarśan akaniṣṭha kāyikāḥ devatāḥ mām dūratas eva dṛṣṭvā ca punar evam āhuḥ ehi bhagavan 
SA_K14_mavadsuu-1114	svāgataṃ bhadanta kuto bhagavāṃ ciracirasya paryāyam akārṣīd ihāgamanāya niṣīdatu	svāgatam bhadanta kutas bhagavām cira cirasya paryāyam akārṣīt iha āgamanāya niṣīdatu 
SA_K14_mavadsuu-1115	bhagavāṃ prajñapta evāsane	bhagavān prajñapte eva āsane 
SA_K14_mavadsuu-1116	nyaṣīdam ahaṃ prajñapta evāsane	nyaṣīdam aham prajñapte eva āsane 
SA_K14_mavadsuu-1117	athākaniṣṭhakāyikā devatā mama pādau śirasā vanditvā ekāṃte nyaṣīdann (MAV 162)	atha akaniṣṭha kāyikāḥ devatāḥ mama pādau śirasā vanditvā ekāṃte nyaṣīdan 
SA_K14_mavadsuu-1118	ekāṃtaniṣaṇṇā Akaniṣṭhakāyikā devatā ahaṃ dhārmyā kathayā saṃdarśayāmi samādāpayāmi samuttejayāmi saṃpraharṣayāmi	ekānta niṣaṇṇāḥ akaniṣṭha kāyikāḥ devatāḥ aham dhārmyā kathayā saṃdarśayāmi samādāpayāmi samuttejayāmi saṃpraharṣayāmi 
SA_K14_mavadsuu-1119	athaikatyā Akaniṣṭhakāyikā devatā utthāyāsanād ekāṃsam uttarāsaṅgaṃ kṛtvā yenāhaṃ tenāṃjaliṃ praṇamya mām idam avocan	atha ekatyāḥ akaniṣṭha kāyikāḥ devatāḥ utthāya āsanāt eka aṃsam uttarāsaṅgam kṛtvā yena aham tena aṃjalim praṇamya mām idam avocan 
SA_K14_mavadsuu-1120	vayaṃ bhadanta Vipaśyinaḥ samyaksaṃbuddhasya śrāvakā Vipaśyinaḥ samyaksaṃbuddhasyāntike	vayam bhadanta vipaśyinaḥ samyaksaṃbuddhasya śrāvakāḥ vipaśyinaḥ samyaksaṃbuddhasya antike 
SA_K14_mavadsuu-1121	brahmacaryaṃ caritvā ihopapannāḥ vayaṃ Śikhinaḥ vayaṃ Viśvabhujaḥ vayaṃ Krakasundasya	brahmacaryam caritvā iha upapannāḥ vayam śikhinaḥ vayam viśvabhujaḥ vayam krakasundasya 
SA_K14_mavadsuu-1122	vayaṃ Kanakamuneḥ vayaṃ Kāśyapasya vayaṃ bhagavataḥ śrāvakā bhagavato 'ntike brahmacaryaṃ caritvehopapannāḥ	vayam kanakamuneḥ vayam kāśyapasya vayam bhagavataḥ śrāvakāḥ bhagavataḥ ntike brahmacaryam caritvā iha upapannāḥ 
SA_K14_mavadsuu-1123	[Return to Jambudvīpa]	return taḥ jambudvīpa 
SA_K14_mavadsuu-1124	so 'ham Akaniṣṭhakāyikā devatā dhārmyā kathayā saṃdarśayitvā samādāpayitvā samuttejayitvā	sā u ham akaniṣṭha kāyikā devatā dhārmyā kathayā saṃdarśayitvā samādāpayitvā samuttejayitvā 
SA_K14_mavadsuu-1125	saṃpraharṣayitvā tadrūpaṃ samādhiṃ samāpanno yathā samāhite citte Akaniṣṭhe devanikāye	saṃpraharṣayitvā tad rūpam samādhim samāpannaḥ yathā samāhite citte akaniṣṭhe devanikāye 
SA_K14_mavadsuu-1126	aṃtarhito Jambudvīpe pratyasthām	aṃtarhitaḥ jambudvīpe pratyasthām 
SA_K14_mavadsuu-1127	evaṃ devatā ārocayaṃti iyam atra dharmatā tasmād idam ucyate //	evam devatāḥ ārocayanti iyam atra dharmatā tasmāt idam ucyate 
SA_K14_mavadsuu-1128	balavān yathā naro ^ _ ^ _ X	balavān yathā naraḥ 
SA_K14_mavadsuu-1129	prasāritaṃ vā parisaṃhareta /	prasāritam vā parisaṃhareta 
SA_K14_mavadsuu-1130	tathaiva śūro dvipadottamo munir	tathā eva śūraḥ dvipada uttamaḥ muniḥ 
SA_K14_mavadsuu-1131	Abṛhāṃs tadā devagaṇān upāgamat 1	abṛhān tadā deva gaṇān upāgamat 
SA_K14_mavadsuu-1132	yā _ ^ _ _ ^ ^ _ ^ _ X	diś 
SA_K14_mavadsuu-1133	Atapāṃs tadā devagaṇān upāgamat 2	atapān tadā deva gaṇān upāgamat 
SA_K14_mavadsuu-1134	vārī yathā _ ^ ^ _ ^ _ sthitaṃ	vārī yathā 
SA_K14_mavadsuu-1135	vivartate na ^ ca tena lipyate /	vivartate na ca tena lipyate 
SA_K14_mavadsuu-1136	tathaiva śūro dvipadottamo muniḥ	tathā eva śūraḥ dvipada uttamaḥ muniḥ 
SA_K14_mavadsuu-1137	Sudṛśāṃs tadā devagaṇān upāgamat 3	sudṛśān tadā deva gaṇān upāgamat 
SA_K14_mavadsuu-1138	Abṛhaiś ca sārdham Atapaiś ca sārdhaṃ	abṛhaiḥ ca sārdham atapaiḥ ca sārdham 
SA_K14_mavadsuu-1139	parivāritaḥ Sudṛśadevatābhiḥ	parivāritaḥ sudṛśa devatābhiḥ 
SA_K14_mavadsuu-1140	anaṃtavarṇo hi śriyā jvalaṃtaṃ	anaṃta varṇaḥ hi śriyā jvalaṃtam 
SA_K14_mavadsuu-1141	Sudarśanān devagaṇān upāgamat 4	sudarśanān deva gaṇān upāgamat 
SA_K14_mavadsuu-1142	Śuddhādhivāsair anugamyamānaḥ	śuddha adhivāsaiḥ anugamyamānaḥ 
SA_K14_mavadsuu-1143	parivārito devatānāṃ sahasraiḥ	parivāritaḥ devatānām sahasraiḥ 
SA_K14_mavadsuu-1144	anaṃtavarṇaḥ śatapuṇyalakṣaṇaḥ	ananta varṇaḥ śata puṇya lakṣaṇaḥ 
SA_K14_mavadsuu-1145	Akaniṣṭhabhūmiṃ samupāgato jinaḥ 5	akaniṣṭha bhūmim samupāgataḥ jinaḥ 
SA_K14_mavadsuu-1146	dharmadṛśo dharmaniyāmakovidā	           
SA_K14_mavadsuu-1147	Vipaśyino buddhavarasya śrāvakāḥ	vipaśyinaḥ buddha varasya śrāvakāḥ 
SA_K14_mavadsuu-1148	tathāgataṃ prāṃjalayo 'bhyupāgatā	tathāgatam prāṃjalayaḥ bhyupāgatā 
SA_K14_mavadsuu-1149	vyabhre dine yathaiva sūryam udgatam 6	vyabhre dine yathā eva sūryam udgatam 
SA_K14_mavadsuu-1150	buddhasya Śikhinaḥ sametya śrāvakā	buddhasya śikhinaḥ sametya śrāvakā 
SA_K14_mavadsuu-1151	ājñātadharmāḥ svayam āgatāḥ phale /	ājñāta dharmāḥ svayam āgatāḥ phale 
SA_K14_mavadsuu-1152	tathāgataṃ prāṃjalayo 'bhyupāgatās	tathāgatam prāṃjalayaḥ bhyupāgatāḥ 
SA_K14_mavadsuu-1153	tripañcarātrābhyuditam iva candram 7	tri pañca rātra abhyuditam iva candram 
SA_K14_mavadsuu-1154	te Viśvabhuj _ ^ ^ masya śrāvakāḥ	te viśvabhuj     masya śrāvakāḥ 
SA_K14_mavadsuu-1155	prahāya pañcāvaraṇāni cetasaḥ	prahāya pañca āvaraṇāni cetasaḥ 
SA_K14_mavadsuu-1156	tathāgataṃ prāṃjalayo 'bhyupāgatā	tathāgatam prāṃjalayaḥ bhyupāgatā 
SA_K14_mavadsuu-1157	niśi jvalaṃtaṃ pravana iva pāvakam 8	niśi jvalaṃtam pravane iva pāvakam 
SA_K14_mavadsuu-1158	te vītarāgāḥ Krakasundaśrāvakāḥ	te vīta rāgāḥ krakasunda śrāvakāḥ 
SA_K14_mavadsuu-1159	kāmeṣu cchandaṃ pratighaṃ vinodya /	kāmeṣu chandam pratigham vinodya 
SA_K14_mavadsuu-1160	tathāgataṃ prāṃjalayo 'bhyupāgatāḥ	tathāgatam prāṃjalayaḥ bhyupāgatāḥ 
SA_K14_mavadsuu-1161	Śaṃkaraṃ bhūtapatim iva devatāḥ 9	śaṃkaram bhūtapatim iva devatāḥ 
SA_K14_mavadsuu-1162	jinasya te Kanakamunes tu śrāvakā	jinasya te kanakamuneḥ tu śrāvakā 
SA_K14_mavadsuu-1163	bhāvyeha mārgam amṛtopalabdhaye /	bhāvyā iha mārgam amṛta upalabdhaye 
SA_K14_mavadsuu-1164	tathāgataṃ prāṃjalayo 'bhyupāgatā	tathāgatam prāṃjalayaḥ bhyupāgatā 
SA_K14_mavadsuu-1165	yaśasvinaṃ vaiśravaṇam i _ ^ X 10	yaśasvinam vaiśravaṇam i 
SA_K14_mavadsuu-1166	an _ ^ _ _ ^ bahuhetucintakāḥ	ad bahu hetu cintakāḥ 
SA_K14_mavadsuu-1167	tathāgataṃ prāṃjalayo 'bhyupāgatāḥ	tathāgatam prāṃjalayaḥ bhyupāgatāḥ 
SA_K14_mavadsuu-1168	X _ ^ _ _ ^ ^ _ ^ _ X m 11	ro-0 di-1 ns-1 
SA_K14_mavadsuu-1169	tathāgato vyupaśa ^ _ ^ _ ^ do	tathāgataḥ 
SA_K14_mavadsuu-1170	devāṃ gato varavipulardhiyuktaḥ	gataḥ vara vipula ṛdhi yuktaḥ 
SA_K14_mavadsuu-1171	athāgatā dṛḍhasthirabandhan _ X	atha āgatāḥ dṛḍha sthira bandhan 
SA_K14_mavadsuu-1172	X _ ^ _ _ ^ ^ śrāvakā vayam 12	ro       śrāvakāḥ vayam 
SA_K14_mavadsuu-1173	āvāsaśreṣṭhā khalu pañca ete	āvāsa śreṣṭhā khalu pañca ete 
SA_K14_mavadsuu-1174	śuddhair ihādhyuṣitās tatvadarśibhiḥ	śuddhaiḥ iha adhyuṣitāḥ tatva darśibhiḥ 
SA_K14_mavadsuu-1175	viśuddhaśīlaṃ sama _ upāgatā	viśuddha śīlam samaḥ upāgatā 
SA_K14_mavadsuu-1176	jinam ana _ ^ ^ _ ^ _ vayam 13	jinam ana        mayam 
SA_K14_mavadsuu-1177	eṣo hi saptānyatamo vināyakaḥ	eṣaḥ hi sapta anyatamaḥ vināyakaḥ 
SA_K14_mavadsuu-1178	oghaṃjahaḥ kāmabhaveṣv asaktaḥ	oghaṃjahaḥ kāma bhaveṣu asaktaḥ 
SA_K14_mavadsuu-1179	evaṃ hi devā Akaniṣṭhakāyikāḥ	evam hi devāḥ akaniṣṭha kāyikāḥ 
SA_K14_mavadsuu-1180	aratiratisaho hi bhikṣur evam	a rati rati sahaḥ hi bhikṣuḥ evam 
SA_K14_mavadsuu-1181	XX _ _ śayanāsanaṃ bhajeta /	śayana āsanam bhajeta 
SA_K14_mavadsuu-1182	tatra ca vihared ihāpramatto	tatra ca viharet iha apramattaḥ 
SA_K14_mavadsuu-1183	bhava _ _ ^ ^ _ ^ _ ^ _ _ 15 //	ro-0 
