segmentnr	original	analyzed
SA_MB_kakacandesvarimataHK-0	Muktabodha E-text in UTF-8	muktabodha etext in utf
SA_MB_kakacandesvarimataHK-1	###########################################################################MUKTABODHA INDOLOGICAL RESEARCH INSTITUTEwww.muktabodha.org©2011 Muktabodha Indological Research Institute  All Rights Reserved.E-texts may be viewed only online or downloaded for private study.E-texts may not, under any circumstances, be copied, republished,reproduced, distributed or sold, either in original or altered form, withoutthe express permission of Muktabodha Indological Research Institute in writing.Data-entered by the staff of Muktabodha under the direction of Mark S. G. Dyczkowski.Catalog number : M00287	muktabodha indological research muktabodha indological research institute all rights reserved texts may be viewed only online or downloaded for private studye texts may not under any circumstances be copied republished reproduced distributed or sold either in original or altered form withoutthe express permission of muktabodha indological research institute in writing data entered by the staff of muktabodha under the direction of mark s g dyczkowskicatalog number  /
SA_MB_kakacandesvarimataHK-2	Uniform title: kākacaṇḍeśvarīmata	uniform title 
SA_MB_kakacandesvarimataHK-3	Manuscript : NGMCP 3 - 118 reel number: A 211/8	ro ad ad  
SA_MB_kakacandesvarimataHK-4	Description: Kākacaṇḍeśvarīmata (the Teaching for the Fierce Crow Goddess). The text is framed as a dialogue between Kākacaṇḍeśvarī (also called Kākacāmuṇḍā) who is equated with Kaṃkālī (the Skeleton) and Kālarātrī (Dark Night), both forms of Kālī. She is the consort (Umādevī) of the five headed Bhairava, who is probably with Svacchandabhairava, who is in some of his aspects a medicine god. They are seated on mount Kailāsa. After imploring him for the knowledge that leads to liberation, the god promising to do so, teaches the preparation of herbs for healing and magic most especially he focuses on the magical preparation of alchemical mercury making this an important unpublished work on Indian alchemy.	description kākacaṇḍeśvarīmata the teaching for the fierce crow goddess the text is framed as a dialogue between kākacaṇḍeśvarī also called kākacāmuṇḍā who is equated with kaṃkālī the skeleton and kālarātrī dark night both forms of kālī she is the consort umā devī of the five headed bhairava who is probably with svacchandabhairava and is in some of his aspects a medicine god they are seated on mount kailāsa after imploring him for the knowledge that leads to liberation the
SA_MB_kakacandesvarimataHK-5	Notes: Revision 0: December 17, 2013	notes revision december 
SA_MB_kakacandesvarimataHK-6	Publication country : India	publication country india 
SA_MB_kakacandesvarimataHK-7	śrīgaṇeśāya namaḥ ||	śrī gaṇeśāya namaḥ 
SA_MB_kakacandesvarimataHK-8	bhṛgvādi devadeveśaṃ ahaṃ pṛcchāmiśaṃkaraṃ |	bhṛgu ādi devadeveśam aham pṛcchāmi śaṃkaram 
SA_MB_kakacandesvarimataHK-9	skaṃdādyāśca mahāmāyā bhṛṃgā caiva vinā ekaiḥ ||	skaṃda ādyāḥ ca mahāmāyāḥ bhṛṃgā ca eva vinā ekaiḥ 
SA_MB_kakacandesvarimataHK-10	śrīvakratuṃḍāya namaḥ ||	śrī vakratuṃḍāya namaḥ 
SA_MB_kakacandesvarimataHK-11	kailāsaśikharāsīne umāsārdhaṃ gajatguruḥ |	kailāsa śikhara āsīne umā sārdham gajatguruḥ 
SA_MB_kakacandesvarimataHK-12	yoginyaṣṭakataṃtre ca guhyādguhyataraṃparaṃ ||	yoginī aṣṭaka taṃtre ca guhyāt guhyataram param 
SA_MB_kakacandesvarimataHK-13	sarvajñāna prakāśāya sarvajñāsarvakacchrayaḥ |	sarvajñāna prakāśāya 
SA_MB_kakacandesvarimataHK-14	etaikāryaṃ kathaṃ devetvayā sarvaṃmamopari ||	katham deve tvayā sarvam mama upari 
SA_MB_kakacandesvarimataHK-15	śrī īśvara uvāca ||	śrī īśvaraḥ uvāca 
SA_MB_kakacandesvarimataHK-16	kaṃkālī kālarātrī ca kākacaṃḍā vacāṃvikā |	          
SA_MB_kakacandesvarimataHK-17	kaṃkālī kālarātrī ca kākacaṃḍeśvarīmatā ||	             
SA_MB_kakacandesvarimataHK-18	evamardya tathākānyau yoginīgaṇanāyakaiḥ |	evam ardya yoginī gaṇa nāyakaiḥ 
SA_MB_kakacandesvarimataHK-19	nṛtyavādyavacobhedaisānaṃdaiḥ hṛṣṭhacetasāṃ ||	nṛtya vādya vacaḥ bhedaiḥ ānaṃdaiḥ hṛṣṭha cetasām 
SA_MB_kakacandesvarimataHK-20	tatastaṃ bhairavaṃ devaṃ yogiṇīgaṇaveṣṭhitaṃ |	tatas tam bhairavam devam yogiṇī gaṇa veṣṭhitam 
SA_MB_kakacandesvarimataHK-21	kecit stuvaṃti saṃhṛṣṭāḥ kecit stuvaṃti guhyakāḥ ||	kecid stuvaṃti saṃhṛṣṭāḥ kecid stuvaṃti guhyakāḥ 
SA_MB_kakacandesvarimataHK-22	kecit nṛtyaṃti tasyāgre keciddhāsya ca kurvataṃ |	kecid nṛtyaṃti tasya agre kecid ha asya ca 
SA_MB_kakacandesvarimataHK-23	etaistu jñānabhaktaistu arcitastatra bhairavaḥ ||	etaiḥ tu jñāna bhaktaiḥ tu arcitaḥ tatra bhairavaḥ 
SA_MB_kakacandesvarimataHK-24	śrīdevyuvāca ||	śrī devī uvāca 
SA_MB_kakacandesvarimataHK-25	dṛṣṭvā tu bhairavaṃ devaṃ paṃcavaktraṃ trilocanaṃ |	dṛṣṭvā tu bhairavam devam paṃcavaktram trilocanam 
SA_MB_kakacandesvarimataHK-26	1a)	a 
SA_MB_kakacandesvarimataHK-27	sānaṃdaṃ tridiśeṣaṃ ca vadhvāñcatirabhāṣitaḥ ||	sa ānaṃdam ca 
SA_MB_kakacandesvarimataHK-28	etaistu jñānabhaktaistu arcitaistatra bhairava |	etaiḥ tu jñāna bhaktaiḥ tu arcitaiḥ tatra bhairava 
SA_MB_kakacandesvarimataHK-29	kākacaṃḍeśvarī devī umādevī ca bhairavī ||	kākacaṃḍeśvarī devī umādevī ca bhairavī 
SA_MB_kakacandesvarimataHK-30	śrībhairavovāca |	śrī bhairavā uvāca 
SA_MB_kakacandesvarimataHK-31	sāsvataṃ yathā devi mahājñānaṃ ca nirbhayaṃ |	sāsvatam yathā devi mahājñānam ca nirbhayam 
SA_MB_kakacandesvarimataHK-32	jñānavādā tu yat pūrvaṃ mānavaiśvālyasiddhidaḥ ||	tu yat pūrvam māna vaiśvālya siddhi daḥ 
SA_MB_kakacandesvarimataHK-33	na paśyati idaṃ jñānaṃ pratyayādeśagāmināṃ |	na paśyati idam jñānam pratyaya ādeśa gāminām 
SA_MB_kakacandesvarimataHK-34	vedānāṃ ca vayorthenaḥ na siddhistena vidyate ||	vedānām ca na siddhiḥ tena vidyate 
SA_MB_kakacandesvarimataHK-35	athavāsaṃ varārohe kākacaṃḍeśvarīmate |	athavā āsam varārohe kākacaṃḍeśvarīmate 
SA_MB_kakacandesvarimataHK-36	muktārthaṃ nikhilaṃ devi sarvopādhivivarjitāṃ ||	mukta artham nikhilam devi sarva upādhi vivarjitām 
SA_MB_kakacandesvarimataHK-37	śrīkākacaṃḍeśvaryauvāca ||	śrī kākacaṃḍeśvaryā uvāca 
SA_MB_kakacandesvarimataHK-38	kathaṃ kāye sthito jīvakosau jīva prakīrtitaḥ |	katham kāye sthitaḥ jīvakaḥ asau jīva prakīrtitaḥ 
SA_MB_kakacandesvarimataHK-39	kasmāt sa kurute karmasthitaṃ saṃsārapaṃjare ||	kasmāt sa kurute karma sthitam saṃsāra paṃjare 
SA_MB_kakacandesvarimataHK-40	jarāvyā&dhi daridreṇagrasta saṃsāravadhano |	saṃsāra vadhanaḥ 
SA_MB_kakacandesvarimataHK-41	ekekumaṃtijaṃghaṃtve ekaskaṃdhavahena tu ||	eka ikumaṃti jaṃghaṃtve eka skaṃdha vahena tu 
SA_MB_kakacandesvarimataHK-42	jayaśaṣṭaṃ ca māṃgalyaṃ ekasthāneka jaṃtavaḥ |	ca māṃgalyam jaṃtavaḥ 
SA_MB_kakacandesvarimataHK-43	kiṃ kurvaṇamakurvaṃti tasmātvaṃbrūhi śaṃkaraḥ ||	kim kurvaṇam akurvanti tasmāt tvam brūhi śaṃkaraḥ 
SA_MB_kakacandesvarimataHK-44	śrī īśvarovāca |	śrī īśvarā uvāca 
SA_MB_kakacandesvarimataHK-45	śṛṇutvaṃ kākacāmuṃḍe sādhakānāṃ hitaṃ priye |	śṛṇutvam kāka cāmuṃḍe sādhakānām hitam priye 
SA_MB_kakacandesvarimataHK-46	1b)	b 
SA_MB_kakacandesvarimataHK-47	guhyādguhyataraṃ vākyaṃ tvayā pṛṣṭo varānane ||	guhyāt guhyataram vākyam tvayā pṛṣṭaḥ varānane 
SA_MB_kakacandesvarimataHK-48	kathayāmi samāsena kākacaṃḍeśvari śṛṇu |	kathayāmi samāsena kākacaṃḍeśvari śṛṇu 
SA_MB_kakacandesvarimataHK-49	yo sau ātmāparonityaṃ anādinidhaneśvaraḥ ||	sau ātmā aparaḥ nityam an ādi nidhana īśvaraḥ 
SA_MB_kakacandesvarimataHK-50	svarūpaṃ nirguṇaṃ vāpi sarvavyādhi nirāmayaḥ |	sva rūpam nirguṇam vā api sarva vyādhi nirāmayaḥ 
SA_MB_kakacandesvarimataHK-51	anādikarma saṃvandhaḥ kāyastho bhavate sadā ||	anādi karma saṃvandhaḥ kāyasthaḥ bhavate sadā 
SA_MB_kakacandesvarimataHK-52	jīvopādhīmayaṃ karma ajñāne saṃpravatṛte |	jīva upādhī mayam karma ajñāne 
SA_MB_kakacandesvarimataHK-53	tasmāt karma prayatnena saṃsāre sevite tu sau ||	tasmāt karma prayatnena saṃsāre sevite tu sau 
SA_MB_kakacandesvarimataHK-54	karoti vividhaṃ karma saṃsāre kāmamohitaḥ |	karoti vividham karma saṃsāre kāma mohitaḥ 
SA_MB_kakacandesvarimataHK-55	dravyopāyaṃ na jānāti kāmabhogena hetunā ||	dravya upāyam na jānāti kāma bhogena hetunā 
SA_MB_kakacandesvarimataHK-56	kṛṣivāṇijyasevā ca svāmivikriyakārakaṃ |	kṛṣi vāṇijya sevā ca svāmi vikriya kārakam 
SA_MB_kakacandesvarimataHK-57	vahate kāṣṭabhāraṃ ca tṛṇabhārānanekadhā ||	vahate kāṣṭa bhāram ca tṛṇa bhārān anekadhā 
SA_MB_kakacandesvarimataHK-58	kāyakleśena kāmāna dravyopāyaṃ karoti saḥ |	kāya kleśena dravya upāyam karoti saḥ 
SA_MB_kakacandesvarimataHK-59	kāyekleśonaraḥ śrīmānkurukarmānyanekadhā ||	śrīmān kuru karmāni anekadhā 
SA_MB_kakacandesvarimataHK-60	bhrāmyamāṇanarāye ca kāmārthāṃkāmaciṃtakāḥ |	ca 
SA_MB_kakacandesvarimataHK-61	jāyaṃte martuloke tu dāridrohatacetasaḥ ||	jāyaṃte martu loke tu dāridra hata cetasaḥ 
SA_MB_kakacandesvarimataHK-62	jāyaṃte vadhirāsteṃdhāḥ paṃgukubjāśca khaṃjakāḥ |	jāyaṃte vadhirāḥ teṃdhāḥ paṃgu kubjāḥ ca khaṃjakāḥ 
SA_MB_kakacandesvarimataHK-63	2a)	a 
SA_MB_kakacandesvarimataHK-64	mahāsaṃsāre vaṃdhena tu guṇena tu saṃyutā ||	mahāsaṃsāre vaṃdhena tu guṇena tu saṃyutā 
SA_MB_kakacandesvarimataHK-65	karoti karmasadyastu ajñānājñānavarjitaḥ |	karoti karma sadyaḥ tu ajñāna ajñāna varjitaḥ 
SA_MB_kakacandesvarimataHK-66	nāsau muṃcati saṃsāraṃ kāyastho kāyavarjitaḥ ||	na asau muṃcati saṃsāram kāya varjitaḥ 
SA_MB_kakacandesvarimataHK-67	aṭate ghorasaṃsāre aṃtaśca ghaṭikādravaḥ |	aṭate ghora saṃsāre antar ca ghaṭikā dravaḥ 
SA_MB_kakacandesvarimataHK-68	ekatuḥ kathitaṃ bhadreyatvayā paripṛcchatāṃ ||	kathitam bhadreya tvayā paripṛcchatām 
SA_MB_kakacandesvarimataHK-69	kimanyaṃ pṛcchate bhadre tathānyaṃ kathayāmyahaṃ |	kim anyam pṛcchate bhadre tathā anyam kathayāmi aham 
SA_MB_kakacandesvarimataHK-70	kākacaṃḍeśvarī śāstraṃ kathitaṃ niścayāmyahaṃ ||	kākacaṃḍeśvarī śāstram kathitam niścayāmi aham 
SA_MB_kakacandesvarimataHK-71	iti kākacaṃḍeśvarimate ||	iti kākacaṃḍeśvarimate 
SA_MB_kakacandesvarimataHK-72	kākacaṃḍeśvaryuvāca ||	kākacaṃḍeśvarī uvāca 
SA_MB_kakacandesvarimataHK-73	kathayāmi mahādeva kāmabhogaprasādhanaṃ |	kathayāmi mahādeva kāma bhoga prasādhanam 
SA_MB_kakacandesvarimataHK-74	arthasaṃpadyate yena akleśāt parameśvaraḥ ||	artha saṃpadyate yena akleśāt parameśvaraḥ 
SA_MB_kakacandesvarimataHK-75	tadahaṃ śrotumicchāmi kathayasva prasādataḥ |	tat aham śrotum icchāmi kathayasva prasādataḥ 
SA_MB_kakacandesvarimataHK-76	pādukāpalayo paṃcadivyaṃ strīkāmasādhanaṃ ||	paṃca divyam strī kāma sādhanam 
SA_MB_kakacandesvarimataHK-77	aṃjanaṃ īdṛśaṃ caiva guṭikā caiva khecarī |	aṃjanam īdṛśam ca eva guṭikā ca eva khecarī 
SA_MB_kakacandesvarimataHK-78	sādhakānāṃ hitaṃ devabhūcarakāśagāminī ||	sādhakānām hitam deva bhū cara kāśa gāminī 
SA_MB_kakacandesvarimataHK-79	jalukāvaṃdhamityāha dhātuvādaraṃsāyanaṃ |	jalukāvaṃdham iti āha dhātuvāda raṃsāyanam 
SA_MB_kakacandesvarimataHK-80	jāraṇaṃ māraṇāṃ caiva abhrakasya ca drāvaṇaṃ ||	jāraṇam māraṇām ca eva abhrakasya ca drāvaṇam 
SA_MB_kakacandesvarimataHK-81	2b)	b 
SA_MB_kakacandesvarimataHK-82	arthopāyaṃ ca deveśabrūhime tripurāṃtakaḥ |	artha upāyam ca deveśa brūhi me tripurāṃtakaḥ 
SA_MB_kakacandesvarimataHK-83	rasakarma yathā deva sārabhūtaṃ vadasvame ||	rasakarma yathā deva sāra bhūtam vadasva ame 
SA_MB_kakacandesvarimataHK-84	śrīmahādevauvāca ||	śrī mahādevaḥ uvāca 
SA_MB_kakacandesvarimataHK-85	śṛṇutvaṃ kākacāmuṃḍe sādhakānāṃ hitaṃ priye |	śṛṇutvam kāka cāmuṃḍe sādhakānām hitam priye 
SA_MB_kakacandesvarimataHK-86	kathayāmi samāsena pratyaṃ yatsiddhisādhanaṃ ||	kathayāmi samāsena yat siddhi sādhanam 
SA_MB_kakacandesvarimataHK-87	na dravyenavināsiddhirnabhogaṃ kāmameva ca |	na dravyena vinā siddhiḥ na bhogam kāmam eva ca 
SA_MB_kakacandesvarimataHK-88	dravyahīnānarāmartya pretarūpena saṃsthitāḥ ||	dravya hīna anara amartya preta rūpena saṃsthitāḥ 
SA_MB_kakacandesvarimataHK-89	aṭate martyaloke ca paropadravakārakāḥ |	aṭate martya loke ca para upadrava kārakāḥ 
SA_MB_kakacandesvarimataHK-90	svānapakṣiparoteṣāṃ jīvaṃ tasya mṛtasya ca ||	svāna pakṣi paroteṣām jīvam tasya mṛtasya ca 
SA_MB_kakacandesvarimataHK-91	kālasaṃbhogarūpeṇa pāṃḍitya jñānasaṃsthitaḥ |	kāla saṃbhoga rūpeṇa pāṃḍitya jñāna saṃsthitaḥ 
SA_MB_kakacandesvarimataHK-92	dravyaṃhīnā na sobhaṃte prāṇahīnaṃ yathā tanuḥ ||	dravyaṃ hīnāḥ na sobhaṃte prāṇa hīnam yathā tanuḥ 
SA_MB_kakacandesvarimataHK-93	kuṣṭino prāṇahīnāstumukāṃdhāvadhirastathāḥ |	prāṇa hīnāḥ tumuka aṃdha avadhiraḥ tathāḥ 
SA_MB_kakacandesvarimataHK-94	na yasyaṃti martyalokesmin dravyārthaṃ makaradhvajaḥ ||	na martya loke ismin dravya artham makaradhvajaḥ 
SA_MB_kakacandesvarimataHK-95	tasmāt sādhayadeveśiraseṃdraṃ sādhakeśvaraḥ |	tasmāt sādhaya deveśiḥ aseṃdram sādhaka īśvaraḥ 
SA_MB_kakacandesvarimataHK-96	taṃdevi kathayāmyasya sādhakānāṃ hitaṃ priye ||	tam devi kathayāmi asya sādhakānām hitam priye 
SA_MB_kakacandesvarimataHK-97	jāraṇaṃ māraṇādini dravyasādhanamuttamaṃ |	jāraṇam māraṇa ādini dravya sādhanam uttamam 
SA_MB_kakacandesvarimataHK-98	rasānāṃ jāyate siddhikāmārthaṃ bhogasādhanaṃ ||	rasānām jāyate siddhi kāma artham bhoga sādhanam 
SA_MB_kakacandesvarimataHK-99	vajradaṃḍaṃ sudaṃḍaṃ ca lohadaṃḍaṃ tathaiva ca |	vajradaṃḍam sudaṃḍam ca lohadaṃḍam tathā eva ca 
SA_MB_kakacandesvarimataHK-100	3a)	a 
SA_MB_kakacandesvarimataHK-101	evaṃ ca oṣadhī trīṇi rasasya māraṇe hitaṃ ||	evam ca oṣadhī trīṇi rasasya māraṇe hitam 
SA_MB_kakacandesvarimataHK-102	vajradaṃḍotha vajrāśca lohadaṃḍovaṭasya ca |	vajradaṃḍā utha vajrāḥ ca lohadaṃḍā uvaṭasya ca 
SA_MB_kakacandesvarimataHK-103	sudaṃḍo brahmadaṃḍasya samāsat kīrtitāṃ priyo ||	sudaṃḍaḥ brahmadaṃḍasya samāsat kīrti tām 
SA_MB_kakacandesvarimataHK-104	grāhayetaṃ samāsena sādhako hṛṣṭacetasaḥ |	grāhayetam samāsena sādhakaḥ hṛṣṭa cetasaḥ 
SA_MB_kakacandesvarimataHK-105	tad sarasayuktaṃ ekīkṛtya vimardayet ||	tat sa rasa yuktam ekīkṛtya vimardayet 
SA_MB_kakacandesvarimataHK-106	aṃdhamuṣāṃ kṛtaṃ dhyātaṃ rasaṃ ca mṛyate kṣaṇāt |	aṃdha muṣām kṛtam dhyātam rasam ca mṛyate kṣaṇāt 
SA_MB_kakacandesvarimataHK-107	sahasravedhī kariṣyāmi yadā siddho mahārasaḥ ||	sahasravedhī kariṣyāmi yadā siddhaḥ mahārasaḥ 
SA_MB_kakacandesvarimataHK-108	muṣāvālepayettena purāgṛhyamahauṣadhīṃ |	muṣau ālepayet tena purā gṛhya mahauṣadhīm 
SA_MB_kakacandesvarimataHK-109	aṃdhamukhāṃdhamedyastu rasavaṃdha ayaṃvidhiḥ ||	andhamukha andhamet yaḥ tu rasavaṃdha ayam vidhiḥ 
SA_MB_kakacandesvarimataHK-110	paścātpalasahasreṣu śulvaṃ saṃgrāhayedbudhaḥ |	paścāt pala sahasreṣu śulvam saṃgrāhayet budhaḥ 
SA_MB_kakacandesvarimataHK-111	amlaṃ vargahataṃ kṛtvā kṣāravargāhataṃ kuru ||	amlam varga hatam kṛtvā kṣāra varga āhatam kuru 
SA_MB_kakacandesvarimataHK-112	vajrakṣīrārkakṣīraiścamardayet saptadhānaraḥ |	vajra kṣīra arka kṣīraiḥ ca mardayet saptadhā anaraḥ 
SA_MB_kakacandesvarimataHK-113	puṭaṃ kṛtvā samāsena kālikārahitā bhavet ||	puṭam kṛtvā samāsena kālikā rahitā bhavet 
SA_MB_kakacandesvarimataHK-114	mūrkhagarbhodarekṣiptadhāmayet svadirānale |	mūrkha garbha udara īkṣipta dhāmayet svadira anale 
SA_MB_kakacandesvarimataHK-115	raseṃdraṃ kṣepayetatra tāraṃ bhavaṃti śobhanaṃ ||	raseṃdram kṣepayet atra tāram bhavanti śobhanam 
SA_MB_kakacandesvarimataHK-116	iti kākacaṃḍeśvarīmate prathamapaṭalaḥ ||	iti kākacaṃḍeśvarīmate prathama paṭalaḥ 
SA_MB_kakacandesvarimataHK-117	3b)	b 
SA_MB_kakacandesvarimataHK-118	athānyaṃ saṃpravakṣyāmimuṣāvaṃdha yathā vidhāṃ |	atha anyam yathā 
SA_MB_kakacandesvarimataHK-119	mṛttikāṃ grāhayet prājñatṛṇa pāṣāṇa varjitāṃ || 1 ||	mṛttikām grāhayet prājña tṛṇa pāṣāṇa varjitām 
SA_MB_kakacandesvarimataHK-120	tu ṣaṃbhāgadvayaṃ grāhyaṃ mṛttikāsaṃtṛtīyakaṃ |	tu ṣaṃ bhāga dvayam grāhyam 
SA_MB_kakacandesvarimataHK-121	ekīkṛtya tu saṃmardyamuṣātāṃ kārat priye ||	ekīkṛtya tu priye 
SA_MB_kakacandesvarimataHK-122	gostanā kārasaṃgrāhyaṃ atha vā vartulāṃ priyeṃ | mukhāvaṃdhīmatikhyātaṃ	atha vā vartulām mukhāvaṃdhīm atikhyātam 
SA_MB_kakacandesvarimataHK-123	sādhakānāṃ hitaṃ priye ||	sādhakānām hitam priye 
SA_MB_kakacandesvarimataHK-124	athāsvagajamalaṃ devi gṛhītvā sādhakaḥ priye |	atha asva gaja malam devi gṛhītvā sādhakaḥ priye 
SA_MB_kakacandesvarimataHK-125	dāhayetaṃ varārohe yāvadahyatāṃ vrajet ||	dāhayetam varārohe yāvat dahyatām vrajet 
SA_MB_kakacandesvarimataHK-126	vāsakasya tu patrāṇi valmīka mṛttikāsahaḥ |	vāsakasya tu patrāṇi valmīka mṛttikāsahaḥ 
SA_MB_kakacandesvarimataHK-127	peṣayajjaladaṃḍena ye vāpi valakāṃkṣaṇaḥ ||	peṣayat jala daṃḍena ye vā api vala kāṃkṣaṇaḥ 
SA_MB_kakacandesvarimataHK-128	asvagajamalaṃ datvāyāṃ śubhiśratumardayet |	a sva gaja malam śubhiśratum ardayet 
SA_MB_kakacandesvarimataHK-129	kartavyaṃ ca ayaṃ koṣṭhaṃ cakratālaṃ ca mūṣakaṃ ||	kartavyam ca ayam koṣṭham cakratālam ca mūṣakam 
SA_MB_kakacandesvarimataHK-130	vajravadbhavate sopi mūṣāvaṃdha prakīrtitaṃ |	vajra vat bhavate saḥ upi mūṣāvaṃdha prakīrtitam 
SA_MB_kakacandesvarimataHK-131	teṣāṃ ca prathamaṃ kṛtvā paścāt karma samārabhavet ||	teṣām ca prathamam kṛtvā paścāt karma 
SA_MB_kakacandesvarimataHK-132	iti mūṣāvedhā athānya saṃpravakṣyāmi rasasyamāraṇaṃ vidhiḥ ||	iti mūṣā vedhāḥ saṃpravakṣyāmi vidhiḥ 
SA_MB_kakacandesvarimataHK-133	pūrvaṃ ca oṣadhaṃ triṇi grāhayedevasādhakaḥ |	pūrvam ca oṣadham triṇi grāhayet evasādhakaḥ 
SA_MB_kakacandesvarimataHK-134	mūṣā saṃlepayettena dhānyakarma samārabhet ||	mūṣā saṃlepayet tena dhānya karma samārabhet 
SA_MB_kakacandesvarimataHK-135	rasyaṃdraṃ mṛyate kṣipraṃ kurukarma yathecchayā |	rasyaṃdram mṛyate kṣipram kuru karma yathā icchayā 
SA_MB_kakacandesvarimataHK-136	tārakartā bhavetyeha hemakartā śṛṇu priye ||	tāra kartā bhava iti eha hema kartā śṛṇu priye 
SA_MB_kakacandesvarimataHK-137	4a)	a 
SA_MB_kakacandesvarimataHK-138	kṛtvā lohamayaṃ pātraṃ tasyordhaṃ kāṃtajaṃ śubhaṃ |	kṛtvā loha mayam pātram tasya ūrdham kānta jam śubham 
SA_MB_kakacandesvarimataHK-139	anyonyaṃ pucchalagnaṃ tu kārayet sādhakottamaḥ ||	anyonyam puccha lagnam tu kārayet sādhaka uttamaḥ 
SA_MB_kakacandesvarimataHK-140	adhoyaṃtreṇa saṃdhāsya āyasaṃ tatra jārayet |	adhas yaṃtreṇa saṃdhāsye āyasam tatra jārayet 
SA_MB_kakacandesvarimataHK-141	taptakhalvadare datvā jāyate mātrasaṃśayaḥ ||	taptakhalva dare da tvā jāyate mātra saṃśayaḥ 
SA_MB_kakacandesvarimataHK-142	ṣaḍguṇaṃ āyasaṃ tatra hemaṃ **? guṇaṃ vaibhet |	ṣaḍguṇam āyasam tatra hemam guṇam 
SA_MB_kakacandesvarimataHK-143	kṣīravṛkṣā tathā jārī khaṃjarī udaravigrahaṃ ||	kṣīravṛkṣā tathā jārī khaṃjarī udara vigraham 
SA_MB_kakacandesvarimataHK-144	grāheya ca rasaṃ teṣāṃ āyasaṃ tatra jārayet |	grāheya ca rasam teṣām āyasam tatra jārayet 
SA_MB_kakacandesvarimataHK-145	jārayettātra saṃdeho dvayaṃ dṛṣṭvā yathā strīyaḥ ||	jārayet tā atra saṃdehaḥ dvayam dṛṣṭvā yathā strīyaḥ 
SA_MB_kakacandesvarimataHK-146	tato grahvā rasaṃ jāri sarvasaṃvedhayettataḥ |	tatas grahvā rasam jāri sarva saṃvedhayet tatas 
SA_MB_kakacandesvarimataHK-147	hemaṃ ca jāyate tatra dharmakāmārtha sādhanaṃ ||	hemam ca jāyate tatra dharma kāma artha sādhanam 
SA_MB_kakacandesvarimataHK-148	hemantu ṣaḍguṇaṃ deyaḥ purā oṣadhamāraṇaṃ |	ṣaḍguṇam deyaḥ purā oṣadha māraṇam 
SA_MB_kakacandesvarimataHK-149	kimanyaṃ evasebhadre samāsāt kathitaṃ mayā ||	kim anyam evasebhadre samāsāt kathitam mayā 
SA_MB_kakacandesvarimataHK-150	atha caturthapaṭalaḥ ||	atha caturtha paṭalaḥ 
SA_MB_kakacandesvarimataHK-151	athānyaṃ saṃpravakṣyāmi guṭikāvaṃdha yathāvidhiḥ |	atha anyam saṃpravakṣyāmi guṭikā vaṃdha yathā vidhiḥ 
SA_MB_kakacandesvarimataHK-152	amaratvaṃ khecaratvaṃ hīdṛśīkaraṇabhūcarī ||	amara tvam khecara tvam hi īdṛśīkaraṇa bhū carī 
SA_MB_kakacandesvarimataHK-153	4b)	b 
SA_MB_kakacandesvarimataHK-154	sādhayatsādhako bhadreraseṃdrasya prabhāvataḥ |	sādhayat sādhakaḥ bhadreḥ raseṃdrasya prabhāvataḥ 
SA_MB_kakacandesvarimataHK-155	raseṃdraṃ jārayet prājñādaṃḍatraya sumarditaṃ ||	          
SA_MB_kakacandesvarimataHK-156	hematāro tathā bhraṃcavajrakāmti tathāyasaṃ |	tathā tathā āyasam 
SA_MB_kakacandesvarimataHK-157	ekīkṛtvā rasaṃ vāpi jāyate pūrvavadvidhiḥ ||	ekīkṛtvā rasam vā api jāyate pūrvavat vidhiḥ 
SA_MB_kakacandesvarimataHK-158	loha evahilehāṃśca jārayettatparasparaṃ |	lohe eva hi lehān ca jārayet tat parasparam 
SA_MB_kakacandesvarimataHK-159	vajraṃmeva hi vajrāśca drāvayaṃti parasparaṃ ||	vajram eva hi vajrāḥ ca drāvayaṃti parasparam 
SA_MB_kakacandesvarimataHK-160	rasopirasalohāni jārayettatsamaṃyadi |	rasopi rasa lohāni jārayet tat samam yadi 
SA_MB_kakacandesvarimataHK-161	jāritemāritaṃ dadyāt guṭikāṃ kārayet yathā ||	dadyāt guṭikām kārayet yathā 
SA_MB_kakacandesvarimataHK-162	mūṣā garbhodarekṣipya dhārayetvadiṃganale |	mūṣā garbha udare kṣipya dhārayet tvad iṃga nale 
SA_MB_kakacandesvarimataHK-163	guṭikā jāyate tena mahābhogya pradāyanī ||	guṭikā jāyate tena mahā bhogya pradāyanī 
SA_MB_kakacandesvarimataHK-164	saubhāgya jananī sāttukāṃti puṣṭi vivardhanī |	saubhāgya jananī sāttukāṃti puṣṭi vivardhanī 
SA_MB_kakacandesvarimataHK-165	amaratvakarisā tu sādhakānāṃ na saṃśayaḥ ||	tu sādhakānām na saṃśayaḥ 
SA_MB_kakacandesvarimataHK-166	kṣobhayedarśanāt nārīṃ sādhakāṃśca tathā priya |	kṣobhayet arśanāt nārīm sādhakān ca tathā priya 
SA_MB_kakacandesvarimataHK-167	yasya vaktragatāsāṃ tu ṣaṇmāsaṃ sādhakeśvaraḥ ||	yasya vaktra gatā āsām tu ṣaṣ māsam sādhaka īśvaraḥ 
SA_MB_kakacandesvarimataHK-168	kriyate yastu jīve deveśi drāyuyutaṃ tathā |	kriyate yaḥ tu jīve deveśi drāyu yutam tathā 
SA_MB_kakacandesvarimataHK-169	aṣṭamekaṃ sthitā vaktre guṭikāhyamarasundarī ||	aṣṭam ekam sthitā vaktre guṭikā hi amarasundarī 
SA_MB_kakacandesvarimataHK-170	5a)	a 
SA_MB_kakacandesvarimataHK-171	ayutadvaya saṃjīvejasavyādhi vivarjitaḥ |	       
SA_MB_kakacandesvarimataHK-172	vṛdvaya kramenaiva ayuta catvāri jīvitaṃ ||	kramena eva ayuta catvāri jīvitam 
SA_MB_kakacandesvarimataHK-173	na bhiṃdyate ca śastrāṇi cakravajrādimudgaraiḥ |	na bhiṃdyate ca śastrāṇi cakra vajra ādi mudgaraiḥ 
SA_MB_kakacandesvarimataHK-174	puṣpalagnaṃ yathā bhāvaṃ jāyate sādhakeśvari ||	puṣpa lagnam yathā bhāvam jāyate sādhaka īśvari 
SA_MB_kakacandesvarimataHK-175	vajradaṃḍādighātaiśca taḍito vahubhiryadiḥ |	vajradaṃḍa ādi ghātaiḥ ca taḍitaḥ vahubhiḥ yadiḥ 
SA_MB_kakacandesvarimataHK-176	na bhidyate tadā saupi mahākāyo mahāvalaḥ ||	na bhidyate tadā saupi mahā kāyaḥ mahā valaḥ 
SA_MB_kakacandesvarimataHK-177	jāyate nātrasaṃdeho guṭikāyāṃ prasādataḥ |	jāyate na atra saṃdehaḥ guṭikāyām prasādataḥ 
SA_MB_kakacandesvarimataHK-178	sādhayatsādhanāddevi kākacaṃḍeśvarīmate ||	sādhayat sādhanāt devi kākacaṃḍeśvarīmate 
SA_MB_kakacandesvarimataHK-179	iti amarasundarīguṭikā ||	iti amarasundarī guṭikā 
SA_MB_kakacandesvarimataHK-180	athānyaṃ saṃpravakṣyāmi guṭikā trailokya sundarī |	athā anyam saṃpravakṣyāmi guṭikā trailokya sundarī 
SA_MB_kakacandesvarimataHK-181	yāvadvaktra sthitā devi kṣobhitā madavihvalā ||	sthitā devi kṣobhitā mada vihvalā 
SA_MB_kakacandesvarimataHK-182	trailokyaṃ bhavate yena gaṇagaṃdharvayoṣitāṃ |	trailokyam bhavate yena gaṇa gaṃdharva yoṣitām 
SA_MB_kakacandesvarimataHK-183	darśanāt kṣobhayetnārī sādhakasya varānane ||	darśanāt kṣobhayet nārī sādhakasya varānane 
SA_MB_kakacandesvarimataHK-184	kathayāmi samāsena guṭikā trailokya sundarīṃ |	kathayāmi samāsena guṭikā trailokya sundarīm 
SA_MB_kakacandesvarimataHK-185	asyārthaṃ kāṃtimādāya vajra vai krāṃti vaiṣṇavā ||	asya artham kāṃtim ādāya vajra vai krāṃti vaiṣṇavā 
SA_MB_kakacandesvarimataHK-186	gaganamadanārisaṃyuktaṃ trilohaṃ ca mahārasaṃ |	               
SA_MB_kakacandesvarimataHK-187	5b)	b 
SA_MB_kakacandesvarimataHK-188	tridaṃḍaṃ mardayitvā tu kṣāravargāhataṃ kuruḥ ||	             
SA_MB_kakacandesvarimataHK-189	jāyete tu dvayaṃ bhūyo taptakhalvodare kṣipet |	jāyete tu dvayam taptakhalva udare kṣipet 
SA_MB_kakacandesvarimataHK-190	jāritaṃ samabhāgena golakaṃ kārayet priye ||	       kārayet   
SA_MB_kakacandesvarimataHK-191	vajramuṣākṛtaṃ dhyātaṃ guṭikāṃ kārayettathā |	vajramuṣā kṛtam dhyātam guṭikām kārayet tathā 
SA_MB_kakacandesvarimataHK-192	trailokyasundarī nāmnā kāmadeva samo bhavet ||	trailokyasundarī nāmnā kāmadeva samaḥ bhavet 
SA_MB_kakacandesvarimataHK-193	iti kākacaṃḍeśvarīmate trailokyasundarī guṭikā ||	iti kākacaṃḍeśvarīmate trailokyasundarī guṭikā 
SA_MB_kakacandesvarimataHK-194	athanyaṃ saṃpravakṣyāmi guṭikāṃ trailokyamohanī ||	atha anyam saṃpravakṣyāmi guṭikām trailokya mohanī 
SA_MB_kakacandesvarimataHK-195	yathā tu mohitā loke bhavate vajrasaṃsthitā |	yathā tu mohitā loke bhavate vajra saṃsthitā 
SA_MB_kakacandesvarimataHK-196	yasya vaktre tu aṣṭvaikaṃ sa jīvedvarṣalakṣakaṃ ||	yasya vaktre tu aṣṭvā ekam sa jīvet varṣa lakṣakam 
SA_MB_kakacandesvarimataHK-197	aṣṭadvayapramāṇaṃ tu vajrakāyo mahāvalaḥ |	aṣṭa dvaya pramāṇam tu vajra kāyaḥ mahā valaḥ 
SA_MB_kakacandesvarimataHK-198	jāyate nātrasaṃdeho mahāmadanasaṃbhavaḥ ||	jāyate na atra saṃdehaḥ mahā madana saṃbhavaḥ 
SA_MB_kakacandesvarimataHK-199	vihvalā mohitānāryonaruṇyo nātra saṃśayaḥ |	vihvalāḥ mohitāḥ anāryaḥ naruṇyaḥ na atra saṃśayaḥ 
SA_MB_kakacandesvarimataHK-200	mukhāvaddhaṃ ca bhūmadhye svecchācārīva sādhakaḥ ||	ca bhū madhye svecchā cārī iva sādhakaḥ 
SA_MB_kakacandesvarimataHK-201	athātaḥ saṃpravakṣyāmi guṭikā jāyate yathā |	atha atas saṃpravakṣyāmi guṭikā jāyate yathā 
SA_MB_kakacandesvarimataHK-202	mātaṃgī kākacaṃḍā tu gajamadahārīṇa tu ||	mātaṃgī kākacaṃḍā tu tu 
SA_MB_kakacandesvarimataHK-203	6a)	a 
SA_MB_kakacandesvarimataHK-204	kākakokilakaṃbhāsa vajravajrā trikālikā |	vajravajrā trikālikā 
SA_MB_kakacandesvarimataHK-205	hayanaramadanāsyātu kākatuṃḍā tathā priye ||	kākatuṃḍā tathā priye 
SA_MB_kakacandesvarimataHK-206	śukacaṃcuka nārīṇāmākulaṃkarapuṭṭakaiḥ |	nārīṇām ākulaṃkara puṭṭakaiḥ 
SA_MB_kakacandesvarimataHK-207	mātaṃgīmātaṃgaḥ puṣpaṃ kākamiti kākajaṃghikā ||	            
SA_MB_kakacandesvarimataHK-208	caṃḍāmiti cāṃḍālī gajamiti gajakuṃbhkā |	caṃḍām iti cāṃḍālī gajam iti gaja kuṃbhkā 
SA_MB_kakacandesvarimataHK-209	pippilīkātu vā pāṭhakāketi kaikokoravayoḥ ||	vā pāṭhakākā iti ka ekokoravayoḥ 
SA_MB_kakacandesvarimataHK-210	kāmeti agnijaṃ devi vajretimihuṃḍike |	kāma iti agni jam devi 
SA_MB_kakacandesvarimataHK-211	vadyatikāmitirikāḥ hayanaradanamarīsyā ||	vadyatikā mitirikāḥ 
SA_MB_kakacandesvarimataHK-212	iti caṃḍālīkāmitā ||	iti caṃḍālīkāmitā 
SA_MB_kakacandesvarimataHK-213	kākatuṃḍeti kākāḍīśakreti śukacaṃcukā |	kākatuṃḍā iti kākāḍī śakrā iti śukacaṃcukā 
SA_MB_kakacandesvarimataHK-214	umatiśālmalīkākāmabhiḥ kācamācikā ||	          
SA_MB_kakacandesvarimataHK-215	vimeti citrakaṃ caiva nāḍī nameti nāḍikā |	vimā iti citrakam ca eva nāḍī namā iti nāḍikā 
SA_MB_kakacandesvarimataHK-216	madanāṃtakarīdevi haridrāmiti procyate ||	            
SA_MB_kakacandesvarimataHK-217	kāmitikachihalpātuhamiti hastakarṇikā |	hasta karṇikā 
SA_MB_kakacandesvarimataHK-218	aṃjulayaṭhīkarūjuyāllohidaṃḍalohitāṃ śukaṃ ||	śukam 
SA_MB_kakacandesvarimataHK-219	brahmadaṃḍīti adhopuṣpaṃ vidhīyate devī sahadevikā ||	brahmadaṃḍī iti adhopuṣpam vidhīyate devī sahadevikā 
SA_MB_kakacandesvarimataHK-220	6b)	b 
SA_MB_kakacandesvarimataHK-221	kṛtivakṣagavāṃchikā ||	       
SA_MB_kakacandesvarimataHK-222	iśvarī eśvaryaṃ madanā iti madanaphalaṃ |	iśvarī eśvaryam madanāḥ iti madana phalam 
SA_MB_kakacandesvarimataHK-223	rapareti rasaivauva samāsāt kathito mayāḥ ||	raparā iti samāsāt kathitaḥ mayāḥ 
SA_MB_kakacandesvarimataHK-224	mahoṣadhīgaṇaṃ devimātaṃgī puṣpasaṃyutaṃ |	mahā oṣadhī gaṇam devi mātaṃgī puṣpa saṃyutam 
SA_MB_kakacandesvarimataHK-225	mardayet sūtakaṃ devi saptāhaṃ sādhakottamaḥ ||	mardayet sūtakam devi sapta aham sādhaka uttamaḥ 
SA_MB_kakacandesvarimataHK-226	tatsāmyena hemaṃ syāt vajrā abhraṃ rasasamaṃ kṛtvā mardayet sādhakeśvaraḥ	    syāt                                                                                
SA_MB_kakacandesvarimataHK-227	guṭikā jāyate tatra mohanī bhuvana traye |	guṭikā jāyate tatra mohanī bhuvana traye 
SA_MB_kakacandesvarimataHK-228	devāsura manuṣyānāṃ nāgagaṃdharvakinnarauḥ ||	deva asura manuṣyānām nāga gaṃdharva kinnarauḥ 
SA_MB_kakacandesvarimataHK-229	kāmarūpi bhavetsopi viṃcaredbhuvanatrayaṃ |	kāmarūpi bhavet saḥ api viṃcaret bhuvanatrayam 
SA_MB_kakacandesvarimataHK-230	sarvavyādhi vinirmukto dviṣaṣṭi varaṣā kṛti ||	vinirmuktaḥ 
SA_MB_kakacandesvarimataHK-231	vallarbhaḥ sarvanārīṇāṃ saubhāgyaṃ matulaṃ labhet |	vallarbhaḥ sarva nārīṇām saubhāgyam labhet 
SA_MB_kakacandesvarimataHK-232	ajayo sarvadevānāṃ vajrakāyo mahāvalaḥ ||	sarva devānām vajra kāyaḥ mahā valaḥ 
SA_MB_kakacandesvarimataHK-233	jāyate nātra saṃdeho kākacaṃḍeśvarīmate |	jāyate na atra kākacaṃḍeśvarīmate 
SA_MB_kakacandesvarimataHK-234	athātaḥ saṃpravakṣyāmi guṭikā vijaya sundari ||	atha atas saṃpravakṣyāmi guṭikāḥ vijaya sundari 
SA_MB_kakacandesvarimataHK-235	yasya vaktra sthitā bhadre vajrakāyo bhavennaraḥ |	yasya sthitā bhadre vajra kāyaḥ bhavet naraḥ 
SA_MB_kakacandesvarimataHK-236	vajrābhrakaṃ triloha ca kāṃtaprāyasameva ca ||	vajrābhrakam triloha ca kānta prāyasam eva ca 
SA_MB_kakacandesvarimataHK-237	7a)	a 
SA_MB_kakacandesvarimataHK-238	cuṃvakaṃ bhrāmakaṃ tīkṣṇaṃ rasendraṃ jārayettataḥ |	       jārayet tatas 
SA_MB_kakacandesvarimataHK-239	purā tu oṣadhaṃ triṇītena kalkenamardayet ||	purā tu oṣadham triṇītena kalkena mardayet 
SA_MB_kakacandesvarimataHK-240	jāritemārite dadyāt guṭikākārayet priye |	dadyāt guṭikā kārayet priye 
SA_MB_kakacandesvarimataHK-241	purā tu oṣadhaṃ triṇīmuṣātalena lepayet ||	purā tu oṣadham triṇīmuṣā talena lepayet 
SA_MB_kakacandesvarimataHK-242	guṭikātena vadhvā tu dhāmyakarma samārabhet |	guṭi kātena vadhvā tu dhāmya karma samārabhet 
SA_MB_kakacandesvarimataHK-243	dravībhūtaṃ tato vodaṃ divyakoṭi samaprabhaṃ ||	dravībhūtam tatas sama prabham 
SA_MB_kakacandesvarimataHK-244	pūjāṃ kṛtvā mukhedhāryā vajrakāyo mahāvalaḥ |	pūjām kṛtvā mukhedhāryā vajra kāyaḥ mahā valaḥ 
SA_MB_kakacandesvarimataHK-245	abhedya sarvasastreṣu khaḍgacakrādimudgaraiḥ ||	a bhedya sarva sastreṣu khaḍga cakra ādi mudgaraiḥ 
SA_MB_kakacandesvarimataHK-246	triśulaphalakaṃ caiva bhidyamāno na bhidyate |	tri śula phalakam ca eva bhidyamānaḥ na bhidyate 
SA_MB_kakacandesvarimataHK-247	vajradeho mahāvīryavākṣayohyamarastathā ||	vajra dehaḥ mahā vīryavān akṣayaḥ hi amaraḥ tathā 
SA_MB_kakacandesvarimataHK-248	jarāroga vinimukto bhavedvai sādhakeśvaraḥ |	jarā roga vinimuktaḥ bhavet vai sādhaka īśvaraḥ 
SA_MB_kakacandesvarimataHK-249	dulabhaḥ sarvanārīṇāṃ kāmarūpadharo bhavet ||	dulabhaḥ sarva nārīṇām kāma rūpa dharaḥ bhavet 
SA_MB_kakacandesvarimataHK-250	asūrāṇāṃ jayo bhadre abhedhyo devadānavaiḥ |	asūrāṇām jayaḥ bhadre abhedhyaḥ deva dānavaiḥ 
SA_MB_kakacandesvarimataHK-251	iti śāstraprabhāvaṃ hi sidhyate sādhakeśvari ||	iti śāstra prabhāvam hi sidhyate sādhaka īśvari 
SA_MB_kakacandesvarimataHK-252	tvayāhaṃ pṛcchatārthaṃ hi kākacaṃḍeśvarī mate |	tvayā aham pṛcchatā artham hi kākacaṃḍeśvarī mate 
SA_MB_kakacandesvarimataHK-253	athānyaṃ saṃpravakṣyāmi guṭikā kāmabhoginī||	athā anyam saṃpravakṣyāmi guṭikā kāmabhoginī 
SA_MB_kakacandesvarimataHK-254	7b)	b 
SA_MB_kakacandesvarimataHK-255	khecarīnāmavikhyātā devagaṃdharvapūjitā |	                
SA_MB_kakacandesvarimataHK-256	aṭaṃti devatā sarve nirālamve mahāpure ||	aṭanti devatā sarve nirālambe mahā pure 
SA_MB_kakacandesvarimataHK-257	guṭikāyā prabhāvena khecaratvamupāgatā |	guṭikāyāḥ prabhāvena khecara tvam upāgatā 
SA_MB_kakacandesvarimataHK-258	khecarī tena sā proktā samāsena prakīrtitāḥ ||	khecarī tena sā proktā samāsena prakīrtitāḥ 
SA_MB_kakacandesvarimataHK-259	grāhaye sūtakaṃ prājñastritohairveṣṭitaṃ kuru |	grāhaye sūtakam prājñaḥ tri tohaiḥ veṣṭitam kuru 
SA_MB_kakacandesvarimataHK-260	varuṇavṛkṣasyakāṣṭaṃ tu kṣipet susamāhitaḥ ||	tu kṣipet su samāhitaḥ 
SA_MB_kakacandesvarimataHK-261	punaḥ śītodake sādhyarasavaṃdhamayaṃ vidhiḥ |	punar śīta udake sādhya rasa vaṃdham ayam vidhiḥ 
SA_MB_kakacandesvarimataHK-262	muṣekṣiptaṃ ayaṃ śīghraṃ utpannonāttasaṃśayaḥ ||	ayam śīghram utpanna ūna ātta saṃśayaḥ 
SA_MB_kakacandesvarimataHK-263	kāmarūpī bhaveddevi trailokya maṭate naraḥ |	kāmarūpī bhavet devi trailokya maṭate naraḥ 
SA_MB_kakacandesvarimataHK-264	vallabhaḥ sarvanārīṇāṃmaragaṃdharvakinnaraiḥ ||	vallabhaḥ sarva nārīṇām mara gaṃdharva kinnaraiḥ 
SA_MB_kakacandesvarimataHK-265	sidhyate nātra saṃdehaḥ kākacaṃḍeśvarī mate ||	sidhyate na atra saṃdehaḥ kākacaṃḍeśvarī mate 
SA_MB_kakacandesvarimataHK-266	athānyaṃ saṃpravakṣyāmi khecarā'kāśagāminī |	atha anyam saṃpravakṣyāmi khecara ākāśa gāminī 
SA_MB_kakacandesvarimataHK-267	dullabha sarvanārīṇāṃ kiṃ punamānuṣāya ca ||	dullabha sarva nārīṇām kim puna mānuṣāya ca 
SA_MB_kakacandesvarimataHK-268	anyeśāstrapyupāyena muktiḥ sthānaṃ prakalpayet |	muktiḥ sthānam prakalpayet 
SA_MB_kakacandesvarimataHK-269	sapiṃḍamuktamityāhu kākacaṃḍeśvarīmate ||	sapiṃḍam uktam iti āhuḥ kākacaṃḍeśvarīmate 
SA_MB_kakacandesvarimataHK-270	sādhakānāṃ hitārthāya pṛcchatehaṃ tvayā priye |	sādhakānām hita arthāya pṛcchata iham tvayā priye 
SA_MB_kakacandesvarimataHK-271	8a)	a 
SA_MB_kakacandesvarimataHK-272	ākāśagamanaṃ bhadre bhavate sādhakeśvaraḥ ||	ākāśagamanam bhadre bhavate sādhaka īśvaraḥ 
SA_MB_kakacandesvarimataHK-273	hayamāri kālarātrī naramārī gajamārikā |	         
SA_MB_kakacandesvarimataHK-274	mamārī viśvamārī ca vārāhī aśvamārikā ||	mamārī viśvamārī ca vārāhī aśvamārikā 
SA_MB_kakacandesvarimataHK-275	māhiṣaṃ viśvaṃmārī ca jalamārī vajā bhavet |	māhiṣam viśvaṃmārī ca jalamārī vajā bhavet 
SA_MB_kakacandesvarimataHK-276	nāmānyetāni guhyāni oṣadhīnāṃ samāsataḥ ||	nāmāni etāni guhyāni oṣadhīnām samāsatas 
SA_MB_kakacandesvarimataHK-277	hayeti hayacaṃḍālī kāketi mṛgacaṃḍikā |	haya iti hayacaṃḍālī kāka iti mṛgacaṃḍikā 
SA_MB_kakacandesvarimataHK-278	gajeti gajacāṃḍālībhaṃmārī āditya bhaktikā ||	gaja iti gajacāṃḍālī bhaṃmārī āditya bhaktikā 
SA_MB_kakacandesvarimataHK-279	naramārī caṃḍikāsyāgirikarṇikāmapi priye |	naramārī caṃḍikā āsyā girikarṇikām api priye 
SA_MB_kakacandesvarimataHK-280	viśvamārī rudrajadyā jalamārī dugdharūdyuhaḥ ||	        
SA_MB_kakacandesvarimataHK-281	vārāhamārīśnuhīvajrimahiṣamāriṇīti caṃḍetikāḥ |	caṃḍetikāḥ 
SA_MB_kakacandesvarimataHK-282	karkoṭikā tu vijñeyā viṣṇumārī ca kākatiktā ||	         
SA_MB_kakacandesvarimataHK-283	jalamārī agniproktā oṣadhīnāṃ rasaṃ haret |	          haret 
SA_MB_kakacandesvarimataHK-284	taptakhalvodaremardasaptāhaṃ sūtakaṃ sahaḥ ||	taptakhalva udaremarda sapta aham sūtakam sahaḥ 
SA_MB_kakacandesvarimataHK-285	mūsvagarbhodarekṣipyadhamyakarma samārabhet |	mū sva garbha udara īkṣipya dhamya karma samārabhet 
SA_MB_kakacandesvarimataHK-286	mṛyate nātrasaṃdeho rasendra statkṣaṇāddhruvaṃ ||	mṛyate na atra saṃdehaḥ rasendraḥ tad kṣaṇāt dhruvam 
SA_MB_kakacandesvarimataHK-287	mukhe kṣiptvā tu śīpraṃ tu ākāśa kramate kṣaṇāt |	mukhe kṣiptvā tu śīpram tu ākāśa kramate kṣaṇāt 
SA_MB_kakacandesvarimataHK-288	8b)	b 
SA_MB_kakacandesvarimataHK-289	tarilokyamaṭate devi jarāmṛtyu vivarjitaḥ ||	tari lokyam aṭate devi jarā mṛtyu vivarjitaḥ 
SA_MB_kakacandesvarimataHK-290	sidhyate nātra saṃdeho kākacaṃḍeśvarīmate ||	sidhyate na atra kākacaṃḍeśvarīmate 
SA_MB_kakacandesvarimataHK-291	ākāśagāminīguṭikā ||	ākāśagāminī guṭikā 
SA_MB_kakacandesvarimataHK-292	athānyaṃ saṃpravakṣyāmi idṛśī nāmakhecarī |	atha anyam saṃpravakṣyāmi idṛśī nāmakhecarī 
SA_MB_kakacandesvarimataHK-293	guṭikā siddhidā proktā rasendraṃ pūrvavad bhavet ||	guṭikā siddhi dā proktā rasendram pūrvavat bhavet 
SA_MB_kakacandesvarimataHK-294	marditaṃ guṭikāṃ kṛtvā mātaṃgī puṣpakai sahaḥ |	marditam guṭikām kṛtvā mātaṃgī puṣpakaiḥ sahaḥ 
SA_MB_kakacandesvarimataHK-295	kāmarūpī ca saṃmohet garupregna parākramaḥ ||	kāmarūpī ca saṃmohet garupregna parākramaḥ 
SA_MB_kakacandesvarimataHK-296	brāhmī kanyodbhavaṃ caiva veṣṭitaṃ golakaṃ kuruḥ |	brāhmī kanyā udbhavam ca eva veṣṭitam golakam kuruḥ 
SA_MB_kakacandesvarimataHK-297	punaḥ strilohe ca veṣṭhitaṃ pūjāṃ kṛtvā vidhānataḥ ||	punar strilohe ca veṣṭhitam pūjām kṛtvā vidhānataḥ 
SA_MB_kakacandesvarimataHK-298	kṛṣṇacaturdaśī rātrau mahāpūjāṃ ca kārayet |	kṛṣṇa caturdaśī rātrau mahā pūjām ca kārayet 
SA_MB_kakacandesvarimataHK-299	mahāphalaiśca saṃyuktaṃ mahāmāṃsaṃ valiṃ haret ||	mahāphalaiḥ ca saṃyuktam mahāmāṃsam valim haret 
SA_MB_kakacandesvarimataHK-300	kumārī yoginī vṛndaṃtvācāryaṃtoṣayadyadā |	kumārī yoginī vṛndam tu ācāryam toṣayat yadā 
SA_MB_kakacandesvarimataHK-301	bhairavaṃ vahukaṃ nāthaṃ vācayet sādhakottamaḥ ||	bhairavam vahukam nātham vācayet sādhaka uttamaḥ 
SA_MB_kakacandesvarimataHK-302	gaṃdhapuṣpākṣetairdhūpairvastrālaṃkāraṇādibhiḥ |	gaṃdha puṣpa akṣetaiḥ dhūpaiḥ vastra alaṃkāraṇa ādibhiḥ 
SA_MB_kakacandesvarimataHK-303	namaskṛtyārcitātsarvāntoṣayitvā prayatnataḥ ||	namaskṛtya arcitāt sarvān toṣayitvā prayatnataḥ 
SA_MB_kakacandesvarimataHK-304	mukhetyaṃkṣipyaguṭikāṃ adṛśyo bhavate naraḥ |	adṛśyaḥ bhavate naraḥ 
SA_MB_kakacandesvarimataHK-305	kriḍate guhyake sārdhaṃ bhūtavetālaśākinī ||	kriḍate guhyake sārdham bhūta vetāla śākinī 
SA_MB_kakacandesvarimataHK-306	9a)	a 
SA_MB_kakacandesvarimataHK-307	brahmarākṣasaguptāstu kuṣmāṃḍai sahakrīḍate |	brahmarākṣasa guptāḥ tu kuṣmāṃḍaiḥ saha krīḍate 
SA_MB_kakacandesvarimataHK-308	mahāvalaṃjayaṃ sarvaṃ avadhyo yogiṇī gaṇaiḥ ||	mahāvalaṃjayam sarvam avadhyaḥ gaṇaiḥ 
SA_MB_kakacandesvarimataHK-309	aṭate sarvadīpāṃśca svacchaṃdagatigāminī |	aṭate sarva dīpān ca svacchaṃda gati gāminī 
SA_MB_kakacandesvarimataHK-310	bhuṃjate vivudhaṃbhogaṃ kāmarūpī strīyāsahaḥ ||	bhuṃjate kāmarūpī 
SA_MB_kakacandesvarimataHK-311	tathā sausādhako bhadre kāmarūpī mahāvalaḥ |	tathā sausādhakaḥ bhadre kāmarūpī mahā valaḥ 
SA_MB_kakacandesvarimataHK-312	taṣṭhacchāyaṃ tato bhūtvā kṛḍate sādhakottamaḥ ||	taṣṭhat chāyam tatas bhūtvā kṛḍate sādhaka uttamaḥ 
SA_MB_kakacandesvarimataHK-313	tathā tu bhairavī deve krīḍate guhyakai sahaḥ |	tathā tu bhairavī deve krīḍate guhyakai sahaḥ 
SA_MB_kakacandesvarimataHK-314	iti kākacaṃḍeśvarīmate ||	iti kākacaṃḍeśvarīmate 
SA_MB_kakacandesvarimataHK-315	śrīkākacaṃḍeśvaryuvāca ||	śrī kākacaṃḍeśvarī uvāca 
SA_MB_kakacandesvarimataHK-316	ahaṃ pṛcchāmi deveśa sādhakānāṃ hitāyavaiḥ |	aham pṛcchāmi deveśa sādhakānām hita āyavaiḥ 
SA_MB_kakacandesvarimataHK-317	akleśāt sādhanārthāya divyasiddhikaraṃ paraṃ ||	akleśāt sādhana arthāya divya siddhi karam param 
SA_MB_kakacandesvarimataHK-318	saṃskārarahitaṃ karma yathā saukurute naraḥ |	saṃskāra rahitam karma yathā naraḥ 
SA_MB_kakacandesvarimataHK-319	tatsarvaṃ vrūhi deveśa yadādyāhaṃ tu vallabhāḥ ||	tat sarvam vrūhi deveśa yadā adya aham tu vallabhāḥ 
SA_MB_kakacandesvarimataHK-320	śrīsarvajñauvāca ||	śrī sarvajñā uvāca 
SA_MB_kakacandesvarimataHK-321	śṛṇutvaṃ kākacāmuṃḍe sādhakānāṃ hitāvahaḥ |	śṛṇu tvam kāka cāmuṃḍe sādhakānām hita āvahaḥ 
SA_MB_kakacandesvarimataHK-322	kathayāmi samāsena raseṃdramāraṇapriye ||	kathayāmi samāsena raseṃdra māraṇa priye 
SA_MB_kakacandesvarimataHK-323	aṣṭauṣavīryathāpūrvavāmaye tu rasai saha |	aṣṭa oṣavīḥ yathāpūrva vāmaye tu rasaiḥ saha 
SA_MB_kakacandesvarimataHK-324	9b)	b 
SA_MB_kakacandesvarimataHK-325	kāmuki vajrakaṃdā ca kaṭukaṃvī tu rājitā ||	          
SA_MB_kakacandesvarimataHK-326	karkoṭī gṛdhaparṇā ca kākāṃḍī vyāghrapādikā |	           
SA_MB_kakacandesvarimataHK-327	etaistu mardayet sutaṃ tapta khalvodare pumān ||	etaiḥ tu mardayet sutam tapta khalva udare pumān 
SA_MB_kakacandesvarimataHK-328	saptāhamamlavargeśca mardayet sūdṛḍhaṃ priye |	sapta aham amlavargeḥ ca mardayet sū dṛḍham priye 
SA_MB_kakacandesvarimataHK-329	jāritaṃ māritaṃ tatra mūrdhva garbhokṣipeduśāṃ ||	jāritam māritam tatra 
SA_MB_kakacandesvarimataHK-330	dhānyamānaṃ mṛtaṃ bhūtvā saṃskāraṃrahitaṃ bhavet |	dhānya mānam mṛtam bhūtvā saṃskāraṃ rahitam bhavet 
SA_MB_kakacandesvarimataHK-331	sahasravedha karoti siddhyate tu mahārasaḥ ||	karoti tu mahārasaḥ 
SA_MB_kakacandesvarimataHK-332	tārakartā idaṃ devi hemakartā śṛṇu priye |	tāra kartā idam devi hema kartā śṛṇu priye 
SA_MB_kakacandesvarimataHK-333	kṛṣṇābhrakaṃ ekapātraṃ tu amlakṣipyadinaṃ trayaṃ ||	            
SA_MB_kakacandesvarimataHK-334	abhrakatya hitapāradamāraṇaṃ ||	hita pārada māraṇam 
SA_MB_kakacandesvarimataHK-335	nṛhatyārasa saṃyuktaṃ mardaya tu yathāvidhiḥ |	nṛhatyā rasa saṃyuktam mardaya tu yathā vidhiḥ 
SA_MB_kakacandesvarimataHK-336	saptāhaṃ sādhako hṛṣṭomardayet sūtakaṃ tathā ||	sapta aham sādhakaḥ hṛṣṭaḥ mardayet sūtakam tathā 
SA_MB_kakacandesvarimataHK-337	navanī sadṛśākāraṃ abhrakaṃ yava dṛśyate |	sadṛśa ākāram abhrakam dṛśyate 
SA_MB_kakacandesvarimataHK-338	taptakhalvodarekṣiptvā tena madhye rasaṃ kṣipet ||	taptakhalva udare kṣiptvā tena madhye rasam kṣipet 
SA_MB_kakacandesvarimataHK-339	rasābhukaṃ marditaṃ kṣiptvā adhohastaṃ pradāpayet |	            
SA_MB_kakacandesvarimataHK-340	āsāyāsahataṃ sūtaṃ jāyate nātra saṃśayaḥ ||	āsa āyāsa hatam sūtam jāyate na atra saṃśayaḥ 
SA_MB_kakacandesvarimataHK-341	ṣaḍguṇaṃcāyasaṃdatvā hemaṃ cāṣṭaṃguṇaṃ bhavet |	ṣaḍguṇam ca āyasam datvā hemam ca aṣṭaṃguṇam bhavet 
SA_MB_kakacandesvarimataHK-342	mūṣāgarbhaṃ ca saṃlepya dhāmyaka māsamāharebhet ||	mūṣā garbham ca saṃlepya māsam āharebhet 
SA_MB_kakacandesvarimataHK-343	10a)	Ro
SA_MB_kakacandesvarimataHK-344	lāṃgalī citraka caiva vajrīkaṃthārikā sahaḥ |	         
SA_MB_kakacandesvarimataHK-345	kṣīrakaṃvuka saṃyuktaṃ mūṣālepaṃ tu kārayet ||	kṣīra kaṃvuka saṃyuktam mūṣā lepam tu kārayet 
SA_MB_kakacandesvarimataHK-346	mṛyate tat rasaṃ kṣipta sahasravedhī ca jāyate |	mṛyate tat rasam kṣipta sahasravedhī ca jāyate 
SA_MB_kakacandesvarimataHK-347	tādamahevidhaṃ caiva akleśat kathito rasaṃ ||	ca eva kathitaḥ rasam 
SA_MB_kakacandesvarimataHK-348	athānya saṃpravakṣyāmi abhrakasya yathā vidhiḥ |	abhrakasya yathā vidhiḥ 
SA_MB_kakacandesvarimataHK-349	kṛṣṇābhrakaṃ ca pītaṃ ca grāhayet sādhakottamaḥ ||	kṛṣṇa abhrakam ca pītam ca grāhayet sādhaka uttamaḥ 
SA_MB_kakacandesvarimataHK-350	bṛhatpārasa saṃyuktaṃ mardayetaṃ prayatnataḥ |	          
SA_MB_kakacandesvarimataHK-351	vaṃgamādāya yatnena āranāle niṣecayet ||	vaṃgam ādāya yatnena āranāle niṣecayet 
SA_MB_kakacandesvarimataHK-352	abhrakaṃtetayormadhyamardayet sādhakottamaḥ |	abhrakam tā etayoḥ madhyam ardayet sādhaka uttamaḥ 
SA_MB_kakacandesvarimataHK-353	grāhayattakṣaṇaddevi grāsa evaṃ ca sūtakaṃ ||	grāhayat takṣaṇat devi grāsaḥ evam ca sūtakam 
SA_MB_kakacandesvarimataHK-354	raṃjate nātrasaṃdeho karmakuryādyathecchayā |	raṃjate karma kuryāt yathā icchayā 
SA_MB_kakacandesvarimataHK-355	lakṣavedhī tu litvā tu prakāśā sādhakeśvari ||	lakṣa vedhī tu tu prakāśā sādhakeśvari 
SA_MB_kakacandesvarimataHK-356	abhrakasya tu pāpunyodrāvakaṃ cābhrakasya ca |	abhrakasya tu pāpunyā udrāvakam ca abhrakasya ca 
SA_MB_kakacandesvarimataHK-357	samāsena tu dhāmyetepataṃte vimalādūsaḥ ||	samāsena tu 
SA_MB_kakacandesvarimataHK-358	kṣīrakaṃcukiyācūrṇaṃ śuddharasena bhāvayet |	           
SA_MB_kakacandesvarimataHK-359	nidagdhā vajradaṃḍena tadrasaṃbhāvitaṃ kuruḥ ||	nidagdhā vajra daṃḍena kuruḥ 
SA_MB_kakacandesvarimataHK-360	ekaika saptavāraṃ tu bhāvayet saptarātrakeḥ |	     tu bhāvayet 
SA_MB_kakacandesvarimataHK-361	10b)	Ro
SA_MB_kakacandesvarimataHK-362	rasābhrakaṃ kṣipet punaḥ ||	        
SA_MB_kakacandesvarimataHK-363	kṣīrakaṃdarikalkaṃ hi lepayadamlamabhrakaṃ |	          
SA_MB_kakacandesvarimataHK-364	kāṃsapātre kṣipetaṃ ca vistaresādhakottamaḥ ||	kāṃsa pātre kṣipetam ca 
SA_MB_kakacandesvarimataHK-365	sūryaṣarbhevataṃdhāpya sadāhasādhakottamaḥ |	sa dāha sādhaka uttamaḥ 
SA_MB_kakacandesvarimataHK-366	drāvaye nātrasaṃdeho priyaṃ dṛṣṭvā yathā strīyaḥ ||	drāvaye priyam dṛṣṭvā yathā strīyaḥ 
SA_MB_kakacandesvarimataHK-367	rasasobhāgakekai tu iti bhāgadvayaṃ priye |	tu iti bhāga dvayam priye 
SA_MB_kakacandesvarimataHK-368	anale dhāmyatāṃ kṛtvā mṛyate nātra saṃśayaḥ ||	anale dhāmyatām kṛtvā mṛyate na atra saṃśayaḥ 
SA_MB_kakacandesvarimataHK-369	lakṣavedhī bhavetsopi jāyate rasabhairavaḥ ||	lakṣa vedhī bhavet saḥ api jāyate rasabhairavaḥ 
SA_MB_kakacandesvarimataHK-370	rasaṭaṃka 1 ṭa gaṃdhakaṭaṃka 1 ṭa navasādaraṭaṃka 1 ṭa ekatra karipīhanāpuṭa	rasa ṭaṃka gaṃdhaka ṭaṃka navasādara ṭaṃka ekatra 
SA_MB_kakacandesvarimataHK-371	65 dina 21 ka ca harada tathā se gataraikāpu 63 | hemardana karanā rasagaṃdhaka	ca harada tathā se hemardana karanā rasa gandhaka 
SA_MB_kakacandesvarimataHK-372	navasādarajalajaṃtrapakāvanā mudrākījai mainamudrāmainasera 2 tela alasīkā sera	mudrā kījai tela alasīkā 
SA_MB_kakacandesvarimataHK-373	2 ca rūlo haikai ca lāvanāpāni bharanā hiṃsāptodhīṣālirāṣanā punaḥ |	ca ca bharanā punar 
SA_MB_kakacandesvarimataHK-374	mainapāvanāpāche alasīkātelapāvanāha agnideṇīpālidyaḍe 100 avaṭāvanāpāni	agnideṇī pālidyaḍe 
SA_MB_kakacandesvarimataHK-375	tatāvanācarūvicepācchaimonaṣarovilīce	tatāvana acarū vicepāt śaimaḥ ūna ṣaraḥ vilīce 
SA_MB_kakacandesvarimataHK-376	11a)	Ro
SA_MB_kakacandesvarimataHK-377	ehameva vaṭakedudhamā hicchrāṇīyepācche tāte pāni māhigolāvāhīyai prahara	eham eva tāte māhigolāvāhīyai prahara 
SA_MB_kakacandesvarimataHK-378	12 uparāṃti gālā āpapāsirāṣaṇā || iti maiva mudrā ||	iti mā eva mudrā 
SA_MB_kakacandesvarimataHK-379	tāṃvāśrādhārūpāśrādhā ekatragāliye patrakija ikaraṃ karatī 1 lepiye	ekatragāliye lepiye 
SA_MB_kakacandesvarimataHK-380	agāramadhye bhāvanā hemu alaṃguhoi || iti mudrā ||	agāra madhye bhāvanā iti mudrā 
SA_MB_kakacandesvarimataHK-381	athānyaṃ saṃpravakṣyāmi yathā druti saṃjāyate |	atha anyam saṃpravakṣyāmi yathā druti saṃjāyate 
SA_MB_kakacandesvarimataHK-382	grāhayedabhrakaṃ prājñaśvetaṃ vā kṛṣṇameva vā ||	grāhayet abhrakam prājña śvetam vā kṛṣṇam eva vā 
SA_MB_kakacandesvarimataHK-383	purā saṃskāra saṃyuktaṃ kartavyaṃ sādhakeśvaraḥ |	purā saṃskāra saṃyuktam kartavyam sādhaka īśvaraḥ 
SA_MB_kakacandesvarimataHK-384	yavā javā saṃcicaṇīkaṃdhārīkaṃ vurkavajradaṃḍayoḥ ||	yavā javā vurka vajradaṃḍayoḥ 
SA_MB_kakacandesvarimataHK-385	vajrakaṃdārkattīreṇa bhallātaṃkasaṭaṃkaṇaṃ |	        
SA_MB_kakacandesvarimataHK-386	kṣāratraya samāyuktaṃ lavaṇapaṃcasamanvitaṃ ||	kṣāratraya samāyuktam lavaṇa paṃca samanvitam 
SA_MB_kakacandesvarimataHK-387	ekīkṛtvā tu taṃkalkaṃ abhrapatrāṇi lepayet |	ekīkṛtvā tu tam kalkam abhra patrāṇi lepayet 
SA_MB_kakacandesvarimataHK-388	mukhagarbhodarekṣipyadhāmayet vadirānale ||	mukha garbha udara īkṣipya dhāmayet vadira anale 
SA_MB_kakacandesvarimataHK-389	dravate nātra saṃdeho kāmaśaktiryathāstriyaḥ |	dravate na atra saṃdeho kāma śaktiḥ yathā striyaḥ 
SA_MB_kakacandesvarimataHK-390	lakṣavedhakaro sohi bhavate nātra saṃśayaḥ ||	lakṣa vedha karaḥ bhavate na atra saṃśayaḥ 
SA_MB_kakacandesvarimataHK-391	iti kākacaṃḍeśvarīmate nikhilasāraṃ ||	iti kākacaṃḍeśvarīmate nikhila sāram 
SA_MB_kakacandesvarimataHK-392	11b)	Ro
SA_MB_kakacandesvarimataHK-393	athānyaṃ saṃpravakṣyāmi sulvāsya kālikāyahaṃ |	atha anyam saṃpravakṣyāmi sulva asya 
SA_MB_kakacandesvarimataHK-394	śulvamadhye sthitaṃ hema na jānāti hi sādhako ||	śulva madhye sthitam hema na jānāti hi 
SA_MB_kakacandesvarimataHK-395	amlavargāhataṃ śulvaṃkṣāravarṇahataṃ kuruḥ |	amlavarga āhatam śulvaṃkṣāra varṇa hatam kuruḥ 
SA_MB_kakacandesvarimataHK-396	saiṃdhavai raktadugdhaiśca mardayecchulvapatrakaṃ ||	saiṃdhavaiḥ rakta dugdhaiḥ ca mardayet śulva patrakam 
SA_MB_kakacandesvarimataHK-397	āraṇyamutpalaṃ grāhyaṃ puṭaṃ dadyāttrisādhakaḥ |	āraṇyam utpalam grāhyam puṭam dadyāt tri sādhakaḥ 
SA_MB_kakacandesvarimataHK-398	kālikā rahitaṃ tena saptavārāṇi bhairavi ||	kālikā rahitam tena sapta vārāṇi bhairavi 
SA_MB_kakacandesvarimataHK-399	taṃ śulvaṃ tārake datvā nirdahet priyahemayo |	tam śulvam tārake da tvā nirdahet 
SA_MB_kakacandesvarimataHK-400	bhavate tena sarvāṇi sarvadoṣa vivarjitaḥ ||	bhavate tena sarvāṇi sarva doṣa vivarjitaḥ 
SA_MB_kakacandesvarimataHK-401	athātaḥ saṃpravakṣyāmi śulvasya kālikāyahaṃ |	atha atas saṃpravakṣyāmi śulvasya 
SA_MB_kakacandesvarimataHK-402	śulvamadhye tu yaddhemaṃ ākarṣayati sādhakaḥ ||	śulva madhye tu yat hemam ākarṣayati sādhakaḥ 
SA_MB_kakacandesvarimataHK-403	gaṃdhakena hataṃ kṛtvā nāgena śodhanaṃ tataḥ |	gaṃdhakena hatam kṛtvā nāgena śodhanam tatas 
SA_MB_kakacandesvarimataHK-404	saptavāraṃ hataṃ kṛtvā saptavāraṃ ca śodhayet ||	sapta vāram hatam kṛtvā sapta vāram ca śodhayet 
SA_MB_kakacandesvarimataHK-405	atasī puṣpasaṃkāsaṃ jāyate nātra saṃśayaḥ |	atasī puṣpa saṃkāsam jāyate na atra saṃśayaḥ 
SA_MB_kakacandesvarimataHK-406	samabhāgaṃ samaṃ sūtaṃ kārayet sādhakāstathā ||	sama bhāgam samam sūtam kārayet sādhakāḥ tathā 
SA_MB_kakacandesvarimataHK-407	dhāmamānahibhityukta sayate rājabhairavaḥ |	rāja bhairavaḥ 
SA_MB_kakacandesvarimataHK-408	caṃdrārkajāva bhāgaṃ tu hemaṃ ca jāyate dhruvaṃ ||	bhāgam tu hemam ca jāyate dhruvam 
SA_MB_kakacandesvarimataHK-409	iti kākacaṃdeśvarī mate ||	iti kākacaṃdeśvarī mate 
SA_MB_kakacandesvarimataHK-410	12a)	Ro
SA_MB_kakacandesvarimataHK-411	athānya saṃpravakṣyāmi tārakartārameva hi |	atha anya saṃpravakṣyāmi tāra kartāram eva hi 
SA_MB_kakacandesvarimataHK-412	kāryaṃ ca jāyate puṃsāṃ karmakāryārthasādhakaṃ ||	kāryam ca jāyate puṃsām karma kārya artha sādhakam 
SA_MB_kakacandesvarimataHK-413	aṃkoṭakasya vījāni grāhayatsādhakottamaḥ |	aṃkoṭakasya vījāni grāhayat sādhaka uttamaḥ 
SA_MB_kakacandesvarimataHK-414	tailasagrāhayettasmāt paṃcatālakasaṃyutaṃ ||	tailasa grāhayet tasmāt paṃcatālaka saṃyutam 
SA_MB_kakacandesvarimataHK-415	higulasya kṛtaṃ kṣāraṃ mṛtavaṃgaṃ niṣevayet |	            
SA_MB_kakacandesvarimataHK-416	mṛyate nātrasaṃdeho saptāhā kṣīrasaṃyutaḥ ||	mṛyate sapta ahā kṣīra saṃyutaḥ 
SA_MB_kakacandesvarimataHK-417	mṛtaṃvaṃgaṃ tato gṛhyatāraṃ saptaguṇaṃ bhavet |	tatas gṛhya tāram saptaguṇam bhavet 
SA_MB_kakacandesvarimataHK-418	praṣṭaṃ ca kārayettena caturthāṃśena golakṃ ||	ca kārayet tena caturtha aṃśena golakam 
SA_MB_kakacandesvarimataHK-419	staṃbhaya vajrakaṃ dena pṛṣṭikāmuttamā bhavet |	staṃbhaya vajrakam pṛṣṭikām uttamā bhavet 
SA_MB_kakacandesvarimataHK-420	śatavedhaṃ pravarteta jāyate tāramuttamaṃ ||	śata vedham pravarteta jāyate tāram uttamam 
SA_MB_kakacandesvarimataHK-421	sādhayeddharmakāmārthaṃ alpasarvāthasādhanaṃ |	sādhayet dharma kāma artham alpa sarva atha sādhanam 
SA_MB_kakacandesvarimataHK-422	dravyahīnopi siddhyeta caṃḍikā vadamuttamaṃ ||	dravya hīnaḥ api siddhyeta caṃḍikā vadam uttamam 
SA_MB_kakacandesvarimataHK-423	tālakasya ca satvaṃ ca mṛtavaṃgaṃ tathā bhavet |	tālakasya ca satvam ca mṛta vaṃgam tathā bhavet 
SA_MB_kakacandesvarimataHK-424	mṛtasye parisatvaṃ ca yathā ṣoḍaśa saṃskṛte ||	parisatvam ca yathā ṣoḍaśa saṃskṛte 
SA_MB_kakacandesvarimataHK-425	taṃvaṃgaṃ rasasamaṃjārjyaśulvavedhaśatāṃsake |	taṃ vaṃgam rasa samaṃja arjya śulva vedha śata aṃsake 
SA_MB_kakacandesvarimataHK-426	tārakartā bhavatyaha hemakartā śṛṇu priye ||	tāra kartā bhavati aha hema kartā śṛṇu priye 
SA_MB_kakacandesvarimataHK-427	arjunasyatva vā grāhyapaṃcāṃgaṃ vāsakasya ca |	vā grāhya paṃcāṃgam vāsakasya ca 
SA_MB_kakacandesvarimataHK-428	dahyate kriyate bhasmagajoṣṭamūtrakaṃ kṣipet ||	dahyate kriyate bhasma gaja uṣṭa mūtrakam kṣipet 
SA_MB_kakacandesvarimataHK-429	12b)	Ro
SA_MB_kakacandesvarimataHK-430	nāgaṃ nidhāyate tatra saptāhaṃ sādhakottamaḥ |	nāgam nidhāyate tatra sapta aham sādhaka uttamaḥ 
SA_MB_kakacandesvarimataHK-431	saptavāraṃ puṭaṃ taṃtu jāyate vajrasaṃnibhaṃ ||	sapta vāram puṭam taṃtu jāyate vajra saṃnibham 
SA_MB_kakacandesvarimataHK-432	nāgarūpyavidhi ||	    
SA_MB_kakacandesvarimataHK-433	athānyaṃ saṃpravakṣyāmi nāgānāṃ raṃjanaṃ tathā |	atha anyam saṃpravakṣyāmi nāgānām raṃjanam tathā 
SA_MB_kakacandesvarimataHK-434	hemakasadṛśaṃ nāgaṃ bhavate nātrasaṃśayaḥ ||	hemaka sadṛśam nāgam bhavate na atra saṃśayaḥ 
SA_MB_kakacandesvarimataHK-435	rasaṃ cakaṃ guṇaṃ caiva śākaṃ kūpalikaṃ tathā |	rasam guṇam ca eva śākam kūpalikam tathā 
SA_MB_kakacandesvarimataHK-436	brahmavṛkṣa rasaṃgrāhyaṃ nāga tatu niṣecayet ||	niṣecayet 
SA_MB_kakacandesvarimataHK-437	śatāṃ saṃvedhasaddhemaṃ mātṛkā ca samaṃ paraṃ |	mātṛkā ca samam param 
SA_MB_kakacandesvarimataHK-438	mārayataṃ punaḥ nāgaṃ śākaṃ kopalikāsahaḥ ||	mārayatam punar nāgam śākam kopalikā sahaḥ 
SA_MB_kakacandesvarimataHK-439	hemaṃ tu jāyate tana sarvadoṣaharaṃ paraṃ |	hemam tu jāyate sarva doṣa haram param 
SA_MB_kakacandesvarimataHK-440	nāgasparaṃ tataṃ khyātavaṃgasya māraṇaṃ tathā ||	nāga sparam tatam khyāta vaṃgasya māraṇam tathā 
SA_MB_kakacandesvarimataHK-441	yadātve pṛcchate bhadre tathānyakathayāmyahaṃ |	yadātve pṛcchate bhadre tathā anya kathayāmi aham 
SA_MB_kakacandesvarimataHK-442	jāyate sūkṣmamokṣaṃ tu kurukarmānyanekadhā ||	jāyate sūkṣma mokṣam tu kuru karmāni anekadhā 
SA_MB_kakacandesvarimataHK-443	tapta khalvodare kṣiptvā rasa tatra nidhāpayet |	tapta khalva udare kṣiptvā rasa tatra nidhāpayet 
SA_MB_kakacandesvarimataHK-444	adho yaṃtragato vahniḥ dhāmayamadhurānale ||	adhas yaṃtra gataḥ vahniḥ dhāmaya madhura anale 
SA_MB_kakacandesvarimataHK-445	mahākāṃti tato jāḍyasasūtaṃ sādhakattamaḥ |	          
SA_MB_kakacandesvarimataHK-446	tadardhaṃ jāyateddhemaṃ ṣaṇmāsaṃ tatkrameṇa tu ||	tad ardham jāyate iddhemam ṣaṣ māsam tad krameṇa tu 
SA_MB_kakacandesvarimataHK-447	purāccodha saṃyuktastatasaṃmardhayotpriye |	saṃyuktaḥ tata saṃmardhaya ud priye 
SA_MB_kakacandesvarimataHK-448	garbhastaṃ jāyate tatra ṣaṇmāsādayasaṃpriye ||	garbhaḥ tam jāyate tatra ṣaṣ māsāt ayasaṃpriye 
SA_MB_kakacandesvarimataHK-449	13a)	Ro
SA_MB_kakacandesvarimataHK-450	grāhayataṃ samāsena rasendraṃ sādhakeśvari |	grāhayatam samāsena rasendram sādhaka īśvari 
SA_MB_kakacandesvarimataHK-451	mūṣāyā garbhalepaṃ tu purādaṃḍatrayaṇa tu ||	mūṣāyāḥ garbha lepam tu tu 
SA_MB_kakacandesvarimataHK-452	aṃdhamūṣākṛta dhyātaṃ mṛyatesai mahārasaḥ |	dhyātam mṛyate sai mahārasaḥ 
SA_MB_kakacandesvarimataHK-453	lakṣavedhī bhavetsohi dharmakāmārthasādhanaṃ ||	lakṣa vedhī bhavet saḥ hi dharma kāma artha sādhanam 
SA_MB_kakacandesvarimataHK-454	aiśvaśvaryaṃguṇasaṃpannaṃ bhavaṃte sādhakeśvari |	aiśvaśvaryaṃ guṇa saṃpannam sādhaka īśvari 
SA_MB_kakacandesvarimataHK-455	iti śrīkākacaṃḍeśvarīmate jāraṇapaṭalaḥ ||	iti śrī kākacaṃḍeśvarīmate jāraṇa paṭalaḥ 
SA_MB_kakacandesvarimataHK-456	deharakṣaṇavidhīvāraḥ ||	      
SA_MB_kakacandesvarimataHK-457	athānyaṃ śṛṇudeveśi amaratva yathā bhavet |	atha anyam yathā bhavet 
SA_MB_kakacandesvarimataHK-458	lakṣakoṭi guṇaisvaryaṃ rājabhoga sukhāni ca ||	guṇa aisvaryam ca 
SA_MB_kakacandesvarimataHK-459	nirarthāṃ piṃḍapātena jāyate takṣaṇā dhruvaṃ |	nirarthām piṃḍapātena jāyate takṣaṇā dhruvam 
SA_MB_kakacandesvarimataHK-460	kathayāmita vā devi piṃḍasya lakṣaṇāni ca ||	vā devi piṃḍasya lakṣaṇāni ca 
SA_MB_kakacandesvarimataHK-461	rasendra grāhayadrājño daṃḍa trayasumarditaṃ |	rasendra grāhayat rājñaḥ daṃḍa traya su marditam 
SA_MB_kakacandesvarimataHK-462	śālmalī udarevāryaṃ aṣṭamekaṃ hi suṃdari ||	aṣṭam ekam hi suṃdari 
SA_MB_kakacandesvarimataHK-463	yadāsau bhajate kṛṣṇaṃ grāhattaṃ mahārasaṃ |	yadā asau bhajate kṛṣṇam grāhat tam mahārasam 
SA_MB_kakacandesvarimataHK-464	ṣaṇmāsaṃ bhuṃjito tena vajrakāyo bhavennaraḥ ||	tena vajra kāyaḥ bhavet naraḥ 
SA_MB_kakacandesvarimataHK-465	aṣṭamekaṃ prayogaṃ tu ayutaikaṃ sa jīvati |	aṣṭam ekam prayogam tu ayuta ekam sa jīvati 
SA_MB_kakacandesvarimataHK-466	aṣṭavaya prayogena bhakṣayataṃ mahārasaṃ ||	bhakṣayatam mahārasam 
SA_MB_kakacandesvarimataHK-467	ayutadvaya saṃjīveni rūpadravadehinaḥ |	rūpadrava dehinaḥ 
SA_MB_kakacandesvarimataHK-468	13b)	Ro
SA_MB_kakacandesvarimataHK-469	rasendraṃ bhakṣayedyātakṣīrāśī kāmavarjitaḥ ||	  bhakṣayet           
SA_MB_kakacandesvarimataHK-470	akṣayo rajaraścaivavalīpalitavarjitaḥ |	akṣayaḥ rajaraḥ ca eva valī palita varjitaḥ 
SA_MB_kakacandesvarimataHK-471	sabhavennātra saṃdeho kākacaṃḍeśvarīmate ||	kākacaṃḍeśvarīmate 
SA_MB_kakacandesvarimataHK-472	punaḥ raṇyaṃ pravakṣyāmi amaraṃ sādhakeśvari |	punar raṇyam pravakṣyāmi amaram sādhakeśvari 
SA_MB_kakacandesvarimataHK-473	abhrakaṃ kāṃtilohaścaraseṃdrogaṃdhakaḥ stathā ||	abhrakam kāntilohaḥ ca raseṃdraḥ gaṃdhakaḥ 
SA_MB_kakacandesvarimataHK-474	tridaṃḍaṃ mardayet pūrvaṃ māsamekaṃ hi sundari |	tridaṃḍam mardayet pūrvam māsam ekam hi sundari 
SA_MB_kakacandesvarimataHK-475	rasendraṃ gaṃdhakaṃ kṣipya aṣṭamekaṃ tu bhakṣayet ||	                  
SA_MB_kakacandesvarimataHK-476	yadā vṛkṣa bhajet kṛṣṇa grāhayetaṃ mahārasaṃ |	yadā vṛkṣa bhajet kṛṣṇa grāhayetam mahārasam 
SA_MB_kakacandesvarimataHK-477	pūjāṃ kṛtvā samāsena bhakṣayettaṃ mahārasa ||	pūjām kṛtvā samāsena bhakṣayet tam mahārasa 
SA_MB_kakacandesvarimataHK-478	ṣaṇmāsasya prayogena jīvettu ayutaṃ trayaṃ |	ṣaṣ māsasya prayogena jīvet tu ayutam trayam 
SA_MB_kakacandesvarimataHK-479	jarāroga vinirmukto vajrakāyo mahāvalaḥ ||	jarā roga vinirmuktaḥ vajra kāyaḥ mahā valaḥ 
SA_MB_kakacandesvarimataHK-480	iti śālmalīkalpaḥ ||	iti śālmalī kalpaḥ 
SA_MB_kakacandesvarimataHK-481	ataḥ paraṃ pravakṣyāmi amaratvaṃ bhavennaraḥ |	atas param pravakṣyāmi amara tvam bhavet naraḥ 
SA_MB_kakacandesvarimataHK-482	mahākāṃti samoyāti abhrakaṃ bhajate sahaḥ ||	         
SA_MB_kakacandesvarimataHK-483	marditaṃ kalkate naiva tridaṃḍaṃ pūrvavadvidhiḥ |	marditam kalkate nā eva tridaṃḍam pūrvavat vidhiḥ 
SA_MB_kakacandesvarimataHK-484	brahmadaṃḍodaredhāryaṃ aṣṭameka hi sundari ||	hi sundari 
SA_MB_kakacandesvarimataHK-485	aṣṭāṃkṣāṃte bhavate brahmavrata daṃḍaḥ susādhakaḥ |	aṣṭāṃkṣa aṃte bhavate brahmavrata daṃḍaḥ susādhakaḥ 
SA_MB_kakacandesvarimataHK-486	saṃgrāhyaṃ ca prayatnena bhajetaṃ pūrvavadvidhiḥ ||	saṃgrāhyam ca prayatnena bhajetam pūrvavat vidhiḥ 
SA_MB_kakacandesvarimataHK-487	ṣaṇmāsaṃ bhajayadyastu svargāsyābhyāṃtaraṃ sthitaḥ |	ṣaṣ māsam bhajayat yaḥ tu svarga āsyābhyām antaram sthitaḥ 
SA_MB_kakacandesvarimataHK-488	14a)	Ro
SA_MB_kakacandesvarimataHK-489	kṣīrāhāro sadā brahmalakṣavedhī sajīvati ||	kṣīra āhāraḥ sadā brahma lakṣa vedhī sa jīvati 
SA_MB_kakacandesvarimataHK-490	mahākāyo mahāvīryo brahmatulyo parākramaḥ |	mahā kāyaḥ mahā vīryaḥ parākramaḥ 
SA_MB_kakacandesvarimataHK-491	jāyte nātra saṃdeho dviṣaṣṭi vārṣikākṛtiḥ ||	jāyte na atra saṃdehaḥ dvi ṣaṣṭi vārṣika ākṛtiḥ 
SA_MB_kakacandesvarimataHK-492	iti palāsabrahmavṛkṣaṃ ||	iti palāsa brahmavṛkṣam 
SA_MB_kakacandesvarimataHK-493	punarasyottaraṃ karma jāyate brahmaviṃdatiḥ |	punar asya uttaram karma jāyate brahma viṃdatiḥ 
SA_MB_kakacandesvarimataHK-494	amaratvaṃ sādhakānāṃ lakṣavarṣāṇi suṃdariḥ ||	amara tvam sādhakānām lakṣa varṣāṇi suṃdariḥ 
SA_MB_kakacandesvarimataHK-495	gaṃdhakaṃ brahmavījantu kaṭutuṃvī supāradaṃ |	         
SA_MB_kakacandesvarimataHK-496	mardayetaṃ śnuhīto ye āyasaṃ tu samāhitaḥ ||	mardayetam śnuhītaḥ ye āyasam tu samāhitaḥ 
SA_MB_kakacandesvarimataHK-497	aṣṭete kṛṣṇadaṃ hi bhavate sādhakeśvari |	aṣṭa ite kṛṣṇa dam hi bhavate sādhaka īśvari 
SA_MB_kakacandesvarimataHK-498	pūjāṃ kṛtvā tu saṃgrāhyaṃ varṣamekaṃ tu bhakṣayet ||	pūjām kṛtvā tu saṃgrāhyam varṣam ekam tu bhakṣayet 
SA_MB_kakacandesvarimataHK-499	kāmavarjita kṣīrāśī vajrakāyokṣayo bhavet ||	kṣīra āśī bhavet 
SA_MB_kakacandesvarimataHK-500	iti brahmadaṃḍaḥ saṃpradāyaḥ ||	iti brahmadaṃḍaḥ saṃpradāyaḥ 
SA_MB_kakacandesvarimataHK-501	athānyaṃ saṃpravakṣyāmiḥ yathā siddhyaṃti sādhakā |	atha anyam saṃpravakṣyāmiḥ yathā siddhyaṃti sādhakāḥ 
SA_MB_kakacandesvarimataHK-502	bhogaṃ ca bhajate devi martyulokeṣu sādhakaḥ ||	bhogam ca bhajate devi martyu lokeṣu sādhakaḥ 
SA_MB_kakacandesvarimataHK-503	atha sūtābhrasāraravidhiḥ ||	atha sūta abhra sārara vidhiḥ 
SA_MB_kakacandesvarimataHK-504	abhrakaṃ kāṃtilohaśca sūtakaṃ ca vimardayet |	abhrakam kāntilohaḥ ca sūtakam ca vimardayet 
SA_MB_kakacandesvarimataHK-505	vajrato yena saṃmardya tapta khalvodare priye ||	vajrataḥ yena saṃmardya tapta khalva udare priye 
SA_MB_kakacandesvarimataHK-506	14b)	Ro
SA_MB_kakacandesvarimataHK-507	dhānyarāsi sthitaṃ madhye varṣatekaṃ ca dhārayet |	dhānya rāsi sthitam madhye ca dhārayet 
SA_MB_kakacandesvarimataHK-508	aṣṭāṃte jāyate sūto bhasmī bhūto na saṃśayaḥ ||	aṣṭāṃte jāyate sūtaḥ bhasmī bhūtaḥ na saṃśayaḥ 
SA_MB_kakacandesvarimataHK-509	bhāgaṃ tu raktikāyāsustu bhakṣayataṃ mahārasaṃ |	bhāgam tu bhakṣayatam mahārasam 
SA_MB_kakacandesvarimataHK-510	aṣṭamekaṃ prayogena dviṣaṣṭivārṣikākṛtiḥ ||	aṣṭam ekam prayogena dvi ṣaṣṭi vārṣika ākṛtiḥ 
SA_MB_kakacandesvarimataHK-511	akṣayaśca jayaściava kāmarūpīhā valaḥ |	akṣayaḥ ca jayaḥ ciava kāmarūpī hā valaḥ 
SA_MB_kakacandesvarimataHK-512	svacchaṃdagamano sohi jāyate nātra saṃśayaḥ ||	saḥ hi jāyate na atra saṃśayaḥ 
SA_MB_kakacandesvarimataHK-513	anyaṃ ca sa tu vakṣyāmi sādhakasya hitāvahaḥ |	anyam ca sa tu vakṣyāmi sādhakasya hita āvahaḥ 
SA_MB_kakacandesvarimataHK-514	piṃḍapātenajebhītāye cānye bhaya ca kramāt ||	ca anye ca kramāt 
SA_MB_kakacandesvarimataHK-515	teṣaṣṭaṃti mahāvīryaṃ kākacaṃḍeśvarī mate |	mahā vīryam kākacaṃḍeśvarī mate 
SA_MB_kakacandesvarimataHK-516	karkoṭi tailamādāyaniṃvūrapiṃ ca pāradaṃ ||	karkoṭi tailam ādāya niṃvūrapim ca pāradam 
SA_MB_kakacandesvarimataHK-517	pāradaṃ mardayet tatra saptāhaṃ sādhakeśvari |	             
SA_MB_kakacandesvarimataHK-518	mṛyate tadrasaṃkṣipraṃ nasyapāne niyojayet ||	mṛyate tat rasam kṣipram nasya pāne niyojayet 
SA_MB_kakacandesvarimataHK-519	abhyaṃgaṃ pāṭhakārayattena ṣaṇmāsātra varānane |	abhyaṃgam pāṭha kārayat tena ṣaṣ māsāḥ atra varānane 
SA_MB_kakacandesvarimataHK-520	akṣayo ajaraḥścaiva jarāroga vivarjitaḥ ||	akṣayaḥ ajaraḥ ca eva jarā roga vivarjitaḥ 
SA_MB_kakacandesvarimataHK-521	mahākāyo mahāvīryadviraṣṭivārṣikākṛtiḥ |	             
SA_MB_kakacandesvarimataHK-522	iti karkoṭīkalpaḥ ||	iti karkoṭī kalpaḥ 
SA_MB_kakacandesvarimataHK-523	athānyaṃ saṃpravakṣyāmi bhakṣayadyastu sādhakaḥ |	atha anyam saṃpravakṣyāmi bhakṣayat yaḥ tu sādhakaḥ 
SA_MB_kakacandesvarimataHK-524	kṣīrāhyamadhusaṃyuktaṃ kakoṭī vījapurayo ||	kṣīra āhya madhu saṃyuktam 
SA_MB_kakacandesvarimataHK-525	15a)	Ro
SA_MB_kakacandesvarimataHK-526	bhakṣayet sa tu ṣaṇmāsaṃ kṣīrāśī kāmavarjitaḥ |	bhakṣayet sa tu ṣaṣ māsam kṣīra āśī kāma varjitaḥ 
SA_MB_kakacandesvarimataHK-527	valīpalita nirmukto aṣṭamekaṃ dviraṣṭayoḥ ||	nirmuktaḥ aṣṭam ekam dvis aṣṭayoḥ 
SA_MB_kakacandesvarimataHK-528	karkoṭī vījamādāya sūkṣmacūrṇaṃ tu kārayet |	             
SA_MB_kakacandesvarimataHK-529	bhakṣayet madhusaṃyuktaṃ kṣīrāśīvarjitendriyaḥ ||	bhakṣayet madhu saṃyuktam kṣīra āśī varjita indriyaḥ 
SA_MB_kakacandesvarimataHK-530	aṣṭamekasya yogena mahākāyo mahāvalaḥ |	aṣṭam ekasya yogena mahā kāyaḥ mahā valaḥ 
SA_MB_kakacandesvarimataHK-531	aṭhate sarvadīpāni kākāyurbhavate naraḥ ||	aṭhate sarva dīpāni kāka āyuḥ bhavate naraḥ 
SA_MB_kakacandesvarimataHK-532	athavā tasya vījāni bhakṣayet ghṛta saṃyutaṃ |	athavā tasya vījāni bhakṣayet ghṛta saṃyutam 
SA_MB_kakacandesvarimataHK-533	aṣṭadvayaprayogena kākadvayaṃ sa jīvati ||	aṣṭa dvaya prayogena kāka dvayam sa jīvati 
SA_MB_kakacandesvarimataHK-534	tasya vījaṃ rasaṃ gaṃdhaṃ bhṛṃgarājena mardayet |	tasya vījam rasam gaṃdham bhṛṃgarājena mardayet 
SA_MB_kakacandesvarimataHK-535	jīvakasyodare sthāpya aṣṭamekaṃ samāhitaḥ ||	jīvakasya udare sthāpya aṣṭam ekam samāhitaḥ 
SA_MB_kakacandesvarimataHK-536	aṣṭate gṛhyayennena ekāṃte vidhivatsthitaṃ |	ekānte vidhivat sthitam 
SA_MB_kakacandesvarimataHK-537	śitatāpa vinirmukto varṣamekaṃ vasedyadi ||	śita tāpa vinirmuktaḥ varṣam ekam vaset yadi 
SA_MB_kakacandesvarimataHK-538	mākṣikena samaṃ yuktaṃ kṣīrāśīvajitendriyaḥ |	             
SA_MB_kakacandesvarimataHK-539	sajīvet kākacatvāri caṃḍavātā hito pivā ||	sa jīvet kāka catvāri 
SA_MB_kakacandesvarimataHK-540	aṭate sarvadīpāṃśca kāmarūpī mahāvalaḥ |	aṭate sarva dīpān ca kāmarūpī mahā valaḥ 
SA_MB_kakacandesvarimataHK-541	ajayo sarvabhūtānāṃ vajrakāyo mahāvalaḥ ||	sarva bhūtānām vajra kāyaḥ mahā valaḥ 
SA_MB_kakacandesvarimataHK-542	asate kākajaṃghāścamākāṃḍī ca mahauṣadhī |	kākajaṃghāḥ camākāṃḍī ca mahauṣadhī 
SA_MB_kakacandesvarimataHK-543	15b)	Ro
SA_MB_kakacandesvarimataHK-544	tasyāṃte ca kṣayaṃ kālo jīvate kākapakṣiṇāṃ ||	tasya aṃte ca kṣayam kālaḥ jīvate kāka pakṣiṇām 
SA_MB_kakacandesvarimataHK-545	kākāḍīkākasaṃkāśakākaśākākalocanā |	kākāḍī kāka saṃkāśa kākaśākāka locanā 
SA_MB_kakacandesvarimataHK-546	bhakṣayedyastu mānavyo kākāyurbhavate tu saḥ ||	bhakṣayet yaḥ tu kāka āyuḥ bhavate tu saḥ 
SA_MB_kakacandesvarimataHK-547	iti kākajaṃghākalpaḥ ||	iti kākajaṃghā kalpaḥ 
SA_MB_kakacandesvarimataHK-548	ata paraṃ pravakṣyāmi guhyānāṃ ca mahauṣadhī |	atas param pravakṣyāmi guhyānām ca mahauṣadhī 
SA_MB_kakacandesvarimataHK-549	yathā tu labhate devi sādhakānāṃ hitā vahaḥ ||	yathā tu labhate devi sādhakānām hitā vahaḥ 
SA_MB_kakacandesvarimataHK-550	kāmikākāṃkāḍī tu kāmundikākamācikā |	         
SA_MB_kakacandesvarimataHK-551	gaṃḍīmiti gaṃḍiśī ca kāmitikācamānayo ||	gaṃḍīm iti gaṃḍiśī ca 
SA_MB_kakacandesvarimataHK-552	kāmiti karkoṭā ca samitisaṃmarī bhavet |	kāmiti karkoṭā ca bhavet 
SA_MB_kakacandesvarimataHK-553	kāmitilyā ca kāmiti pippalī bhavā ||	kāmitilyā ca kāmiti pippalī bhavā 
SA_MB_kakacandesvarimataHK-554	kāmitikaṃ śulye ca kāmiti bhṛṃgarājakāṃ |	kāmitikam śulye ca kāmiti bhṛṃgarājakām 
SA_MB_kakacandesvarimataHK-555	kāmitikalujā ca kāmitikaṭutuṃvinī ||	kāmitikalujā ca kāmitikaṭutuṃvinī 
SA_MB_kakacandesvarimataHK-556	kālomiti lohitvaṃ ca vidhitistaṃ vinirmalā |	ca vidhitiḥ tam vinirmalā 
SA_MB_kakacandesvarimataHK-557	nāmitāye ca proktā ca mitikāmitikātathā ||	ca proktā ca 
SA_MB_kakacandesvarimataHK-558	iti saṃketavakṣyāmi sādhakānāṃ hitāvahaṃ ||	iti saṃketa vakṣyāmi sādhakānām hita āvaham 
SA_MB_kakacandesvarimataHK-559	kathayāmi samāsena sādhakā siddhidāyakaṃ |	kathayāmi samāsena siddhi dāyakam 
SA_MB_kakacandesvarimataHK-560	16a)	Ro
SA_MB_kakacandesvarimataHK-561	etaistu mardayet sūtaṃ gaṃdhakena samanvitaṃ ||	etaiḥ tu mardayet sūtam gaṃdhakena samanvitam 
SA_MB_kakacandesvarimataHK-562	bhakṣayedājña saṃyuktaṃ ṣaṇmāsātsādhakottamaḥ |	bhakṣayet ājña saṃyuktam ṣaṣ māsāt sādhaka uttamaḥ 
SA_MB_kakacandesvarimataHK-563	jitendriyopikṣīrāsītvaṃ ayutaikaṃ sajīvati ||	ayuta ekam sa jīvati 
SA_MB_kakacandesvarimataHK-564	kaṃguṇītailena pāradabhakṣaṇavidhiḥ |	            
SA_MB_kakacandesvarimataHK-565	gaṃdhakaṃ rasasaṃyuktaṃ kaṃguṇī tailasaṃyutaṃ ||	            
SA_MB_kakacandesvarimataHK-566	māsameka prayogena aṣṭamekaṃ tu bhakṣayet |	māsam eka prayogena aṣṭam ekam tu bhakṣayet 
SA_MB_kakacandesvarimataHK-567	kṣīrāśī brahmacārī ca lakṣāyutvaṃ bhaviṣyati ||	kṣīra āśī brahmacārī ca lakṣa āyu tvam bhaviṣyati 
SA_MB_kakacandesvarimataHK-568	bhavate sādhakebhadre vajrakāyo na saṃśayaḥ |	bhavate sādhakebhadre vajra kāyaḥ na saṃśayaḥ 
SA_MB_kakacandesvarimataHK-569	svacchaṃdagatimānaṃdī raseṃdrasya prabhāvataḥ ||	raseṃdrasya prabhāvataḥ 
SA_MB_kakacandesvarimataHK-570	kākacaṃḍeśvarī sāstre sādhakaiṃ siddhidāyakaiṃ |	            
SA_MB_kakacandesvarimataHK-571	iti rasakaṃgaṃdhakakaṃguṇītailaḥ ||	iti rasakam gaṃdhaka kaṃguṇī tailaḥ 
SA_MB_kakacandesvarimataHK-572	athātaḥ saṃpravakṣyāmi amaratvaṃ sādhako bhavet |	atha atas saṃpravakṣyāmi amara tvam sādhakaḥ bhavet 
SA_MB_kakacandesvarimataHK-573	rasagaṃdhakasāmekaṃkaṃguṇītailemardayet ||	rasa gaṃdhaka sāma ekaṃ kaṃguṇī taile mardayet 
SA_MB_kakacandesvarimataHK-574	vījaṣṭakṣodaresthāpya aṣṭamekaṃ prayatnataḥ |	aṣṭam ekam prayatnataḥ 
SA_MB_kakacandesvarimataHK-575	pūjāṃ kṛvā tato bhakṣemākṣīkai rasasaṃyutaṃ ||	pūjām tatas 
SA_MB_kakacandesvarimataHK-576	aṣṭānavarṣamekaṃ tu kṣīrāśī kāmavarjitaḥ |	aṣṭān avarṣam ekam tu kṣīra āśī kāma varjitaḥ 
SA_MB_kakacandesvarimataHK-577	dviraṣṭavārṣikā jīvet kāmarūpī mahāvalaḥ ||	dvis aṣṭa vārṣikāḥ jīvet kāmarūpī mahā valaḥ 
SA_MB_kakacandesvarimataHK-578	16b)	Ro
SA_MB_kakacandesvarimataHK-579	anaṃtaraṃ prayogāni guhyādguhyataraṃ bhavet |	anaṃtaram prayogāni guhyāt guhyataram bhavet 
SA_MB_kakacandesvarimataHK-580	haritakī brahmakalpaṃ mahākāṃti sa pāradaṃ ||	          
SA_MB_kakacandesvarimataHK-581	ekatraiḥ mardanaṃ kṛtvā kaṃguṇī sahamardayet |	ekatraiḥ mardanam kṛtvā kaṃguṇī sahamardayet 
SA_MB_kakacandesvarimataHK-582	vajratoyana saṃmardya taptakhalvodare priye ||	saṃmardya taptakhalva udare priye 
SA_MB_kakacandesvarimataHK-583	dhānyarāsaṃdhu madhyaṃ tu varṣameko hi dhārayet |	dhānyarāsaṃdhu madhyam tu varṣam ekaḥ hi dhārayet 
SA_MB_kakacandesvarimataHK-584	aṣṭāte jāyate sūto bhasmabhūto hi jāyate ||	jāyate sūtaḥ bhasma bhūtaḥ hi jāyate 
SA_MB_kakacandesvarimataHK-585	bhāgaikaṃ raktīkāyā syāt bhakṣaya tu mahārasaṃ |	bhāga ekam raktīkāyāḥ syāt bhakṣaya tu mahārasam 
SA_MB_kakacandesvarimataHK-586	aṣṭameka prayogena dviriṣṭi vārṣikā kṛtiḥ ||	prayogena dvis iṣṭi vārṣikā kṛtiḥ 
SA_MB_kakacandesvarimataHK-587	akṣayoḥ ajayaṃścaiva kāmarūpī mahāvalaḥ |	akṣayoḥ ajayan ca eva kāmarūpī mahā valaḥ 
SA_MB_kakacandesvarimataHK-588	svacchandagamano sohi jāyate nātra saṃśayaḥ ||	svacchanda gamanaḥ saḥ hi jāyate na atra saṃśayaḥ 
SA_MB_kakacandesvarimataHK-589	iti haritakī brahmakalpaḥ ||	iti haritakī brahma kalpaḥ 
SA_MB_kakacandesvarimataHK-590	athānyaṃ ca prayogāni rasasyamāraṇaṃ prathā |	atha anyam ca prayogāni rasasya māraṇam prathā 
SA_MB_kakacandesvarimataHK-591	sādhakānāṃ hitārthāya yathā sarvajñabhāṣitaṃ ||	sādhakānām hita arthāya yathā sarvajña bhāṣitam 
SA_MB_kakacandesvarimataHK-592	grāhayeta raseṃdro hi poṭalī sūtraveṣṭhitaṃ |	grāhayeta raseṃdraḥ hi poṭalī sūtra veṣṭhitam 
SA_MB_kakacandesvarimataHK-593	svanārīkaṃdarecchipya dīrghaḍole prayojitaṃ ||	sva nārī kaṃdara icchipya dīrghaḍole prayojitam 
SA_MB_kakacandesvarimataHK-594	snānaṃ ca kārayennāvat tāvadbhiṃghādati saurasaḥ |	snānam ca kārayet nāvat tāvat bhiṃghāt ati saurasaḥ 
SA_MB_kakacandesvarimataHK-595	śaṃkhapuṣpātulepātusidyenaketrivārake ||	śaṃkhapuṣpā tulepā tusidyenake trivārake 
SA_MB_kakacandesvarimataHK-596	17a)	Ro
SA_MB_kakacandesvarimataHK-597	mṛtikāṃ punaḥ lepayet ||	mṛtikām punar lepayet 
SA_MB_kakacandesvarimataHK-598	dhāmyakarma samāyogaṃ mṛdusūtaṃ ducyate |	dhāmya karma samāyogam mṛdu sūtam ducyate 
SA_MB_kakacandesvarimataHK-599	śatāṃ śaṃvedhayadbhadredhamakāmārthasiddhidaṃ ||	śatām 
SA_MB_kakacandesvarimataHK-600	puraśroṣadha saṃyogāt taptakhalvekṣiped rasaṃ |	saṃyogāt taptakhalve kṣipet rasam 
SA_MB_kakacandesvarimataHK-601	kṛṣṇābhaṃ jāyate tatra āsāpāśahataṃ kuruḥ ||	kṛṣṇa ābham jāyate tatra āsā pāśa hatam kuruḥ 
SA_MB_kakacandesvarimataHK-602	jāyate māsamekaṃ tu kurukarmāyadhyacchayā |	jāyate māsam ekam tu 
SA_MB_kakacandesvarimataHK-603	sahasravedhakaṃ sopi jāyate nātra saṃśayaḥ ||	sahasra vedhakam saḥ api jāyate na atra saṃśayaḥ 
SA_MB_kakacandesvarimataHK-604	iti poṭalīpākarasendraḥ || atha jalukāvidhiḥ ||	iti poṭalīpākarasendraḥ atha jalukā vidhiḥ 
SA_MB_kakacandesvarimataHK-605	ataḥ paraṃ sādhakārthāya kāmasiddhiryathā bhavet |	atas param sādhaka arthāya kāma siddhiḥ yathā bhavet 
SA_MB_kakacandesvarimataHK-606	jalukājāyate bhadre durlabha bhuvanatrayo ||	bhadre 
SA_MB_kakacandesvarimataHK-607	aśvacāṃḍālikākaṃdaṃrasaṃte naiva mardayet |	na eva mardayet 
SA_MB_kakacandesvarimataHK-608	svanārī kaṃdarasekṣipyadhāmyakarmatathā kuruḥ ||	sva nārī kaṃda rasa īkṣipya dhāmya karma tathā kuruḥ 
SA_MB_kakacandesvarimataHK-609	punantumardanaṃ kṛtvā śleṣmāṃtakarasena tu |	           
SA_MB_kakacandesvarimataHK-610	taptakhalvodarekṣipyamāsamekaṃ samāhitaḥ ||	taptakhalva udara īkṣipya māsam ekam samāhitaḥ 
SA_MB_kakacandesvarimataHK-611	jalukā jāyate tena mahābhadrāyadāpiṇī |	jalukā jāyate tena 
SA_MB_kakacandesvarimataHK-612	kṣobhaya sarvanārīṇāṃ mahāsaubhāgyavardhanī ||	kṣobhaya sarva nārīṇām mahā saubhāgya vardhanī 
SA_MB_kakacandesvarimataHK-613	17b)	Ro
SA_MB_kakacandesvarimataHK-614	kāmārthī sādhakośca kṣobhayastri sahasrakaṃ |	kāma arthī sādhakoḥ ca kṣobhayaḥ tri sahasrakam 
SA_MB_kakacandesvarimataHK-615	mahāmadaneśvarī nāmnā kṣobhayet bhuvana trayaṃ ||	mahāmadaneśvarī nāmnā kṣobhayet bhuvana trayam 
SA_MB_kakacandesvarimataHK-616	vidārīkādamādāyaverakaṃdara saṃyutaṃ |	        
SA_MB_kakacandesvarimataHK-617	mardayet sūtakaṃ tena māsamekaṃ vicakṣaṇaḥ ||	mardayet sūtakam tena māsam ekam vicakṣaṇaḥ 
SA_MB_kakacandesvarimataHK-618	śveta vyālodarekṣipya jalukādrāvanaṃ tathā |	śveta vyāla udara īkṣipya jalukā drāvanam tathā 
SA_MB_kakacandesvarimataHK-619	kāmabhoga mahāyuktaṃ drāvaṇaṃ bhuvanaṃ trayaṃ ||	           
SA_MB_kakacandesvarimataHK-620	atha vā jalukānāṃ tu saṃkṣapāt sādhakasya prabho |	atha vā jalukānām tu saṃkṣapāt sādhakasya prabho 
SA_MB_kakacandesvarimataHK-621	hayamārīkaṃdamādāya sūtakaṃ mardayettataḥ ||	            
SA_MB_kakacandesvarimataHK-622	gonasarpodarekṣipyajalukāvaṃdha jāyate |	jāyate 
SA_MB_kakacandesvarimataHK-623	mahākāmeśvarī nāmnā sarvakāma prasādhinī ||	mahākāmeśvarī nāmnā sarvakāma prasādhinī 
SA_MB_kakacandesvarimataHK-624	athānyā tu jalukā tu sādhayet sādhakeśvari |	athā anyā tu jalukā tu sādhayet sādhakeśvari 
SA_MB_kakacandesvarimataHK-625	jagacāṃḍālikā daṃḍesūtaṃ saṃmardyasuṃdari ||	           
SA_MB_kakacandesvarimataHK-626	spatāhena mahādevi sādhayet kāmahetunā |	spatāhena mahādevi sādhayet kāma hetunā 
SA_MB_kakacandesvarimataHK-627	athānyā tu jalukā hi rasānu samabhidyate ||	atha anyā tu jalukā hi rasa anu samabhidyate 
SA_MB_kakacandesvarimataHK-628	trailokyamohinī nāmnā sādhayet kāmahetūnā |	trailokyamohinī nāmnā sādhayet 
SA_MB_kakacandesvarimataHK-629	kāmeśvarī nāmavidyātā sādhakānāṃ hitā vahā ||	          
SA_MB_kakacandesvarimataHK-630	kākāḍīkaṃdamādāyāśvamārīkaṃdasaṃyutaṃ |	kākāḍī kaṃdam ādāya aśvamārī kaṃda saṃyutam 
SA_MB_kakacandesvarimataHK-631	18a)	Ro
SA_MB_kakacandesvarimataHK-632	bhṛgamārīkaṃda sahitā sūtakaṃ mardanaṃ kuruḥ ||	           
SA_MB_kakacandesvarimataHK-633	citravyālodarekṣipyakāmārthaṃ jāyate rasaḥ |	                
SA_MB_kakacandesvarimataHK-634	kāmeśvarī triyaṃyeśca kṣobhayatsādhakottamaḥ ||	kāmeśvarī triyaṃyeḥ ca kṣobhayat sādhaka uttamaḥ 
SA_MB_kakacandesvarimataHK-635	athānyā procyate bhadre jalukāmadadrāvinī |	athā anyā procyate bhadre jalukā mada drāvinī 
SA_MB_kakacandesvarimataHK-636	yathā tu drāvayennārī sādhakaṃ sauṣyadāyanī ||	yathā tu drāvayet nārī sādhakam sauṣyadāyanī 
SA_MB_kakacandesvarimataHK-637	grāhayet karavīraṃ ca narakaṃdīhayamārikā |	grāhayet karavīram ca narakaṃdī hayamārikā 
SA_MB_kakacandesvarimataHK-638	sramārī rasasaṃmardyasaptaikaṃ tu na saṃśaya ||	         tu na   
SA_MB_kakacandesvarimataHK-639	japāṃtavyālodarekṣipya jalukā kāmabhoginī |	jalukā kāmabhoginī 
SA_MB_kakacandesvarimataHK-640	suṣahaṃto asādhakānāṃ saṃkṣepāt kathitaṃ mayā ||	asādhakānām saṃkṣepāt kathitam mayā 
SA_MB_kakacandesvarimataHK-641	iti kākacaṃḍeśvarīmate jalukākalpaḥ ||	iti kākacaṃḍeśvarīmate jalukā kalpaḥ 
SA_MB_kakacandesvarimataHK-642	athānyāṃ saṃpravakṣyāmi sādhakānāṃ hitāvahaṃ |	atha anyām saṃpravakṣyāmi sādhakānām hita āvaham 
SA_MB_kakacandesvarimataHK-643	śṛṇutvaṃ devadeveśi sādhakosiddhidāyakaṃ ||	śṛṇu tvam devadeveśi 
SA_MB_kakacandesvarimataHK-644	bhramate bhūtaladevivicaredevakanyakā |	bhramate bhū tala devi vicaret deva kanyakā 
SA_MB_kakacandesvarimataHK-645	dadāti sādhakaṃ siddhiṃ yadvīrāvīravaṃdite ||	dadāti sādhakam siddhim yat vīrā vīra vaṃdite 
SA_MB_kakacandesvarimataHK-646	āṣāḍhakṛṣṇa aṣṭamyāṃ guruvāro yadā bhavet |	āṣāḍha kṛṣṇa aṣṭamyām guruvāraḥ yadā bhavet 
SA_MB_kakacandesvarimataHK-647	svāti nakṣatra yogena devakanyābhi gacchati ||	svāti nakṣatra yogena devakanyā abhi gacchati 
SA_MB_kakacandesvarimataHK-648	sarvavicareyadyasti sādhakaṃ siddhidāyakā |	sarva vicarā iyadī asti sādhakam siddhi dāyakā 
SA_MB_kakacandesvarimataHK-649	18b)	Ro
SA_MB_kakacandesvarimataHK-650	śrāvaṇemāsi deveśi kṛṣṇāyā ca caturdaśī ||	śrāvaṇemāsi deveśi kṛṣṇāyāḥ ca caturdaśī 
SA_MB_kakacandesvarimataHK-651	guruvāro puṣpayoge kanyā nirgacchate tadā |	kanyā nirgacchate tadā 
SA_MB_kakacandesvarimataHK-652	yathāsti ca marai sarvai krīḍaṃti sarvadāyakaiḥ ||	yathā asti ca krīḍanti sarva dāyakaiḥ 
SA_MB_kakacandesvarimataHK-653	bhādrapadeśa yogānāṃ kṛṣṇapakṣe caturdaśī |	yogānām kṛṣṇa pakṣe caturdaśī 
SA_MB_kakacandesvarimataHK-654	bṛhaspati bhavedvāredvayaphālguṇarikṣayo ||	bṛhaspati 
SA_MB_kakacandesvarimataHK-655	saṃyogā bhavate yastu kanyāvivaranigatā |	saṃyogā bhavate yaḥ tu kanyā vivara nigatā 
SA_MB_kakacandesvarimataHK-656	āśvunemāsiyogena kṛṣṇā cāpi caturdaśī ||	āśvunā imāsi yogena kṛṣṇā ca api caturdaśī 
SA_MB_kakacandesvarimataHK-657	puṣpanakṣatrasaṃyutā guruvāro vidhīyate |	puṣpa nakṣatra saṃyutā guruvāraḥ vidhīyate 
SA_MB_kakacandesvarimataHK-658	vivareṣu ca yā kanyā sarvasthāneṣu pūjitā ||	vivareṣu ca yā kanyā sarva sthāneṣu pūjitā 
SA_MB_kakacandesvarimataHK-659	kārtike tu amāvāsyā guruvāreṇa saṃyutā |	kārtike tu amāvāsyā guruvāreṇa saṃyutā 
SA_MB_kakacandesvarimataHK-660	svātau ṛkṣya samāyāti vicareṣu ca sarvasu ||	svātau ṛkṣya samāyāti vicareṣu ca sarvasu 
SA_MB_kakacandesvarimataHK-661	nirgatā siddhiyogena mārgaśirasi pūrṇāyāṃ vṛhaspati suṣumeva ca |	nirgatā siddhi yogena mārgaśirasi pūrṇāyām vṛhaspati suṣuma iva ca 
SA_MB_kakacandesvarimataHK-662	mṛgaśiraśvayogena dvāre vivaramanāyikā |	dvāre vivaram anāyikā 
SA_MB_kakacandesvarimataHK-663	rahasya carate varṣā sādhakaṃ siddhisādhayoḥ ||	rahasya carate varṣā sādhakam siddhi sādhayoḥ 
SA_MB_kakacandesvarimataHK-664	pauṣamāseśuklapakṣe pratipadguruvāsare |	             
SA_MB_kakacandesvarimataHK-665	19a)	Ro
SA_MB_kakacandesvarimataHK-666	mūlanakṣatra saṃyoge devakanyā ca dṛśyate ||	mūla nakṣatra saṃyoge deva kanyā ca dṛśyate 
SA_MB_kakacandesvarimataHK-667	māghe śuklacaturdaśyāṃ guruvāreṇa saṃyutāḥ |	māghe śukla caturdaśyām guruvāreṇa saṃyutāḥ 
SA_MB_kakacandesvarimataHK-668	mūlanakṣatrasahitaṃ sarvakanyā vinirgatā ||	mūla nakṣatra sahitam sarva kanyā vinirgatā 
SA_MB_kakacandesvarimataHK-669	phālguṇe kṛṣṇapakṣe tu tithituṣṇā caturdaśī |	phālguṇe kṛṣṇa pakṣe tu tithi tuṣṇā caturdaśī 
SA_MB_kakacandesvarimataHK-670	bṛhaspati tathā vāre puṣpanakṣatra saṃyutā ||	bṛhaspati tathā vāre puṣpa nakṣatra saṃyutā 
SA_MB_kakacandesvarimataHK-671	kanyā ca krīḍate tatra vivareṣu ca saṃsthitā |	kanyā ca krīḍate tatra vivareṣu ca saṃsthitā 
SA_MB_kakacandesvarimataHK-672	caitramāse śuklapakṣe caturdaśyāṃ bṛhaspatau ||	caitra māse śukla pakṣe caturdaśyām bṛhaspatau 
SA_MB_kakacandesvarimataHK-673	mūlanakṣatra saṃyoge sarvavivarodvaṃdate |	mūla nakṣatra saṃyoge 
SA_MB_kakacandesvarimataHK-674	evaṃ tu siddhiyogāni vivareṣu pratiṣṭhati ||	evam tu siddhi yogāni vivareṣu pratiṣṭhati 
SA_MB_kakacandesvarimataHK-675	krīḍate devakanyāśca sādhakaiḥ siddhidā ekaiḥ |	krīḍate deva kanyāḥ ca sādhakaiḥ siddhi dāḥ ekaiḥ 
SA_MB_kakacandesvarimataHK-676	iti kākacaṃḍeśvaramate vivarapaṭalaṃ ||	iti kākacaṃḍeśvara mate vivara paṭalam 
SA_MB_kakacandesvarimataHK-677	athānyaṃ saṃpravakṣyāmi śailodakavidhiryathā |	atha anyam saṃpravakṣyāmi śailodaka vidhiḥ yathā 
SA_MB_kakacandesvarimataHK-678	durlabhaṃ sādhakānāṃ ca siddhiyogaṃ ca durlabhaṃ ||	durlabham sādhakānām ca siddhi yogam ca durlabham 
SA_MB_kakacandesvarimataHK-679	19b)	Ro
SA_MB_kakacandesvarimataHK-680	udakaṃ vahuvijñeyaṃ divyasiddhikaraṃ paraṃ |	udakam vahu vijñeyam divya siddhi karam param 
SA_MB_kakacandesvarimataHK-681	kṣaṇavedhī ahorātraṃ saptāhaṃ pakṣavedhakaṃ ||	            
SA_MB_kakacandesvarimataHK-682	māsaṃ ca ṣaṇmāsaṃ ca saṃvatsaravedhakaṃ |	māsam ca ṣaṣ māsam ca saṃvatsara vedhakam 
SA_MB_kakacandesvarimataHK-683	etāni śailodakāni sarvā tu samatulyatā ||	etāni śailodakāni sarvā tu sama tulya tā 
SA_MB_kakacandesvarimataHK-684	tasyāyaṃtu guṇā vakṣeyena yenāti sādhakaḥ |	tasya ayam tu yena ati sādhakaḥ 
SA_MB_kakacandesvarimataHK-685	veṣṭakaṃ ca parityaktā vedhakāṃstupayo japet ||	veṣṭakam ca parityaktā vedhakān tupayaḥ japet 
SA_MB_kakacandesvarimataHK-686	hiṃgulaṃ haritālaṃ ca gaṃdhakaṃ ca manaḥ śilāṃ |	hiṃgulam haritālam ca gaṃdhakam ca manaḥ śilām 
SA_MB_kakacandesvarimataHK-687	eteṣāṃ gaṃdhamāhāro prakaroti ca vedhikaṃ ||	eteṣām prakaroti ca vedhikam 
SA_MB_kakacandesvarimataHK-688	śailodakaṃ kathyate bhadre kṣīre cāṣṭaguṇena tu |	śailodakam kathyate bhadre kṣīre ca aṣṭaguṇena tu 
SA_MB_kakacandesvarimataHK-689	tattukṣīraṃ viśeṣaṃ tu pivate sādhakeśvariḥ ||	tat tu kṣīram viśeṣam tu pivate sādhaka īśvariḥ 
SA_MB_kakacandesvarimataHK-690	ekaviṃśati rātreṇa kṣaṇena vahusādhakaḥ |	ekaviṃśati rātreṇa kṣaṇena vahu sādhakaḥ 
SA_MB_kakacandesvarimataHK-691	surādviriṣṭavarṣaikā kāmarūpīna saṃbhavaḥ ||	saṃbhavaḥ 
SA_MB_kakacandesvarimataHK-692	śailodakaṃ gṛhītvā tu kulatthena sahaḥ kvāthayet |	śailodakam gṛhītvā tu kulatthena sahaḥ kvāthayet 
SA_MB_kakacandesvarimataHK-693	tena kvāthepacedannedatvā cāṣṭaguṇaṃ tathā ||	tena kvāthe pacet anna idam tvā ca aṣṭaguṇam tathā 
SA_MB_kakacandesvarimataHK-694	guḍagaṃḍamadhusahaiḥ yathā hāraṃ ca svecchayā |	guḍa gaṃḍa madhu sahaiḥ yathā hāram ca sva icchayā 
SA_MB_kakacandesvarimataHK-695	20a)	Ro
SA_MB_kakacandesvarimataHK-696	sannāyuka bhaviṣyaṃti nātrakāryā vicāraṇā ||	bhaviṣyanti na atrakāryā vicāraṇā 
SA_MB_kakacandesvarimataHK-697	śailodaka gṛhītvā tu triphalā sahabhakṣayet |	gṛhītvā tu triphalā saha bhakṣayet 
SA_MB_kakacandesvarimataHK-698	ṣoḍaśa bhāgaviśeṣaṃ tu tailaṃ ca sahapācayet ||	ṣoḍaśa bhāga viśeṣam tu tailam ca saha pācayet 
SA_MB_kakacandesvarimataHK-699	guḍatailenābhyaṃgaṃ kuryāttaṃ bhakṣaṇāttataḥ |	guḍa tailena abhyaṃgam kuryāt tam bhakṣaṇāt tatas 
SA_MB_kakacandesvarimataHK-700	tataḥ valīpalita naśyaṃti sarvakuṣṭa vivarjitaḥ ||	tatas valīpalita naśyaṃti sarva kuṣṭa vivarjitaḥ 
SA_MB_kakacandesvarimataHK-701	divyadeho yathā devo jāyate sādhakasya ca |	divya dehaḥ yathā devaḥ jāyate sādhakasya ca 
SA_MB_kakacandesvarimataHK-702	iti śilodakapārada bhakṣaṇaṃ ||	iti śilodaka pārada bhakṣaṇam 
SA_MB_kakacandesvarimataHK-703	māṣaikaṃ māṣasūtaṃ ca hastena śatumardayet |	māṣa ekam māṣa sūtam ca hastena śatum ardayet 
SA_MB_kakacandesvarimataHK-704	naṣṭapiṣṭo bhavejjīvai punaḥ jīvapyatadrasaṃ ||	naṣṭapiṣṭaḥ punar 
SA_MB_kakacandesvarimataHK-705	taprasayo māsamekaṃ jarāmṛtyu vivarjitaḥ |	tapra sayaḥ māsam ekam jarā mṛtyu vivarjitaḥ 
SA_MB_kakacandesvarimataHK-706	nāśanaṃ ||	na aśanam 
SA_MB_kakacandesvarimataHK-707	athavā tadrasaṃmāṣakarṣeṇa māṣahemakaṃ ||	athavā tad rasam māṣa karṣeṇa māṣa hemakam 
SA_MB_kakacandesvarimataHK-708	guṭikā kārayettena mukhekṣiptvādṛśī bhavet |	guṭikā kārayet tena bhavet 
SA_MB_kakacandesvarimataHK-709	ṣaḍbhāgaṃ ca haredravyaṃ jīveccaṃdrārkatārakaṃ ||	ṣaṣ bhāgam ca haret ravyam jīvet caṃdra arka tārakam 
SA_MB_kakacandesvarimataHK-710	athavā rasakarṣaikaṃ tatkṣaṇena tu mardayet |	athavā rasa karṣa ekam tad kṣaṇena tu mardayet 
SA_MB_kakacandesvarimataHK-711	iṃguḍīphala madhya tu śailodaka madhyasaṃkurū ||	iṃguḍīphala madhya tu śailodaka madhya saṃkurū 
SA_MB_kakacandesvarimataHK-712	kālena triguṇaṃ caiva kaṭhinyaṃ tasya jāyate |	kālena triguṇam ca eva kaṭhinyam tasya jāyate 
SA_MB_kakacandesvarimataHK-713	20b)	Ro
SA_MB_kakacandesvarimataHK-714	ṣaṇmāsena mukhaṃ dhārya vajrakāyo bhavennaraḥ ||	ṣaṣ māsena mukham dhārya vajra kāyaḥ bhavet naraḥ 
SA_MB_kakacandesvarimataHK-715	vasanāgayute prāṇe hi divyasahasramodate |	vasa nāga yute prāṇe hi divya sahasram odate 
SA_MB_kakacandesvarimataHK-716	tatodakepi vedyāmatakṣīrārdhena pāyasaṃ ||	tata udake api vedyām atakṣīra ardhena pāyasam 
SA_MB_kakacandesvarimataHK-717	māśaikaṃ tu prayogena sahasrāyurbhavennaraḥ |	māśa ekam tu prayogena sahasra āyūḥ bhavet naraḥ 
SA_MB_kakacandesvarimataHK-718	tatodakaṃ gṛhītvā tu harītakī sahakvāthayet ||	tata udakam gṛhītvā tu harītakī saha kvāthayet 
SA_MB_kakacandesvarimataHK-719	ghṛtena madhunālehyaṃ snigdhabhāṃḍena sthāpayet |	ghṛtena madhunā ālehyam snigdha bhāṃḍena sthāpayet 
SA_MB_kakacandesvarimataHK-720	saptaikaṃ bhūmimadhyasthaṃ ekaikaṃ bhakṣayetpunaḥ ||	sapta ekam bhūmi madhya stham ekaikam bhakṣayet punar 
SA_MB_kakacandesvarimataHK-721	valīpalitanirmukto jīvedvarṣa śatadvayaṃ |	valī palita nirmuktaḥ jīvet varṣa śata dvayam 
SA_MB_kakacandesvarimataHK-722	tenodakena mardena abhrakaṃ kvāthakārayet ||	tena udakena mardena abhrakam kvātha kārayet 
SA_MB_kakacandesvarimataHK-723	saptarātraṃ puṭaṃ pākaṃ bharitaṃ jāyate rasaṃ |	sapta rātram puṭam pākam bharitam jāyate rasam 
SA_MB_kakacandesvarimataHK-724	kurute māsameko hi valīpalita hataṃ bhavet ||	kurute māsam ekaḥ hi valīpalita hatam bhavet 
SA_MB_kakacandesvarimataHK-725	atha śailodakaṃ mardyaṃ ghṛtena sahalehayet |	atha śailodakam mardyam ghṛtena saha lehayet 
SA_MB_kakacandesvarimataHK-726	māsakena prayogena jarāmṛtyu vinaśyati ||	māsakena prayogena jarā mṛtyu vinaśyati 
SA_MB_kakacandesvarimataHK-727	śailodakaṃ kulatthena kvāthaṃ kṛtvā punaḥ kṣayet |	śailodakam kulatthena kvātham kṛtvā punar 
SA_MB_kakacandesvarimataHK-728	ghṛtaṃ ca madhunā sahitaṃ lehyaṃ ca pivete sadā ||	ghṛtam ca madhunā sahitam lehyam ca pivete sadā 
SA_MB_kakacandesvarimataHK-729	māsaikaṃ ca prayogena valīpalita varjitaṃ |	māsa ekam ca prayogena 
SA_MB_kakacandesvarimataHK-730	mahākāyo mahāvīrya sahasrāyu sa jīvitaṃ ||	mahā kāyaḥ mahā vīrya sahasra āyu sa jīvitam 
SA_MB_kakacandesvarimataHK-731	21a)	Ro
SA_MB_kakacandesvarimataHK-732	athavā kiṃ vahunoktena vidhānaṃ nyāyayojibhiḥ |	athavā kim vahunā uktena vidhānam nyāya yojibhiḥ 
SA_MB_kakacandesvarimataHK-733	divyadehadharoścaiva āyuvardhayate sadā ||	divya deha dharoḥ ca eva āyu vardhayate sadā 
SA_MB_kakacandesvarimataHK-734	kūṣmāṃḍāni ca madyāni phalāniyānikāni ca |	kūṣmāṃḍāni ca madyāni phalāniyānikāni ca 
SA_MB_kakacandesvarimataHK-735	lohānikṣipya śailaiśca prabhūtaṃ bhakṣameva ca ||	lohān ikṣipya śailaiḥ ca prabhūtam bhakṣam eva ca 
SA_MB_kakacandesvarimataHK-736	kṣīrabhojyaṃ ca jīrṇete vajrakāyo bhavennaraḥ |	kṣīra bhojyam ca jīrṇa ete vajra kāyaḥ bhavet naraḥ 
SA_MB_kakacandesvarimataHK-737	sarvato divyadehaśca ayutāyurbhaviṣyati ||	sarvatas divya dehaḥ ca ayuta āyuḥ bhaviṣyati 
SA_MB_kakacandesvarimataHK-738	bhakṣeyeśāli ṣaṣṭhaiśca triṣācareyataḥ |	ṣaṣṭhaiḥ ca 
SA_MB_kakacandesvarimataHK-739	parihāraṃ praṣomayoḥ varṣeṇa kalpāyuśca bhavate bhavate sādhakeśvaraḥ ||	parihāram praṣomayoḥ varṣeṇa kalpa āyuḥ ca bhavate bhavate sādhaka īśvaraḥ 
SA_MB_kakacandesvarimataHK-740	iṃguḍīna tu vījāni śailaṃ bhūtaṃ jale sthitaṃ |	tu vījāni śailam bhūtam jale sthitam 
SA_MB_kakacandesvarimataHK-741	tenaiva pratipāyena vaṃgasthaṃbhaṃ karoti ca ||	tena eva pratipāyena vaṃga sthaṃbham karoti ca 
SA_MB_kakacandesvarimataHK-742	pāradena saṃyuktaṃ pānīya viṣanāśanaṃ |	pāradena saṃyuktam pānīya viṣa nāśanam 
SA_MB_kakacandesvarimataHK-743	rasopari sa sahitaṃ sajaremena veṣṭitaṃ ||	rasa upari sa jaremena veṣṭitam 
SA_MB_kakacandesvarimataHK-744	kuṃḍamadhye prakṣipetajāvaṃ tu kathinaṃ bhavet |	kuṃḍa madhye tu kathinam bhavet 
SA_MB_kakacandesvarimataHK-745	sahasrāṃśe ca lohānivedhaṃ tu kanakaṃ bhavet ||	sahasra aṃśe ca tu kanakam bhavet 
SA_MB_kakacandesvarimataHK-746	guḍasya tu palaṃ grāhyaṃkarṣaṃ caiva rasasya ca |	guḍasya tu palam ca eva rasasya ca 
SA_MB_kakacandesvarimataHK-747	21b)	Ro
SA_MB_kakacandesvarimataHK-748	tenodakena mardyaṃti kāṃsyapātre nidhāpayet ||	tena udakena kāṃsya pātre nidhāpayet 
SA_MB_kakacandesvarimataHK-749	tasmiṃ tu kuṃḍe nikṣiptaṃ kaṭhinaṃ tu yadā bhavet |	tasmin tu kuṃḍe nikṣiptam kaṭhinam tu yadā bhavet 
SA_MB_kakacandesvarimataHK-750	taṃ mukhena ca dhārtavyaṃ sarvarogāpahārakaṃ ||	tam mukhena ca dhārtavyam sarva roga apahārakam 
SA_MB_kakacandesvarimataHK-751	daśanāgayutā prāṇe vajrakāyastu yojayet |	daśa nāga yutā prāṇe vajra kāyaḥ tu yojayet 
SA_MB_kakacandesvarimataHK-752	udare tu ciraṃkāle śubhe sārdhena saṃśayaḥ ||	udare tu ciraṃkāle śubhe sārdhena saṃśayaḥ 
SA_MB_kakacandesvarimataHK-753	atha saṃlohakaṃ grāhyaṃ meṣaśṛṃgenidhāpayet |	atha saṃlohakam grāhyam 
SA_MB_kakacandesvarimataHK-754	aparaṃsneparaṃtaṃ tu cūrṇaṃ bhavati śobhanaṃ ||	tu cūrṇam bhavati śobhanam 
SA_MB_kakacandesvarimataHK-755	tena nāgaśatāṃśena nirvījaṃ kanakaṃ bhavet |	tena nāga śata aṃśena nirvījam kanakam bhavet 
SA_MB_kakacandesvarimataHK-756	vuṣmunārādhitā pṛthvī arkātodarate purā ||	pṛthvī purā 
SA_MB_kakacandesvarimataHK-757	bhākārejñā kuṃdate yastu vedaṃ yasya nivartanaṃ |	yaḥ tu vedam yasya 
SA_MB_kakacandesvarimataHK-758	śailodakaṃmiti jñeyaṃ viṣṇukhedaṃ tathā bhavet ||	śailodakam iti jñeyam viṣṇukhedam tathā bhavet 
SA_MB_kakacandesvarimataHK-759	ghṛtaṃ bhaktaṃ śarīrastu nityavyāyāma tatparaḥ |	ghṛtam bhaktam śarīraḥ tu nitya vyāyāma tatparaḥ 
SA_MB_kakacandesvarimataHK-760	mardanaṃ ca prakartavyaṃ śailodaka rasāyaṇe ||	mardanam ca prakartavyam śailodaka rasāyaṇe 
SA_MB_kakacandesvarimataHK-761	amaro ajaraścaiva vajrakāyo mahāvalaḥ |	amaraḥ ajaraḥ ca eva vajra kāyaḥ mahā valaḥ 
SA_MB_kakacandesvarimataHK-762	iti kākacaṃḍeśvarīmate śailodakaḥ paṭalaḥ ||	iti kākacaṃḍeśvarīmate śailodakaḥ paṭalaḥ 
SA_MB_kakacandesvarimataHK-763	22a)	Ro
SA_MB_kakacandesvarimataHK-764	śrīdevyuvāca ||	śrī devī uvāca 
SA_MB_kakacandesvarimataHK-765	kailāśaśikhareramye devadevaṃ jagadguruṃ |	kailāśa śikhare ramye devadevam jagadgurum 
SA_MB_kakacandesvarimataHK-766	pṛcchāmi ca mahādeva kalpaṃ vaitālakasya ca ||	pṛcchāmi ca mahādeva kalpam vaitālakasya ca 
SA_MB_kakacandesvarimataHK-767	sādhakānāṃ hitārthāya mṛtyudāridranāśanaṃ |	sādhakānām hita arthāya mṛtyu dāridra nāśanam 
SA_MB_kakacandesvarimataHK-768	śrī īśvarovāca ||	śrī īśvarā uvāca 
SA_MB_kakacandesvarimataHK-769	sādhusādhumahābhāge yatvayā paripṛcchatāṃ |	sādhu sādhu mahābhāge yat tvayā paripṛcchatām 
SA_MB_kakacandesvarimataHK-770	sādhakānāṃ hitārthāya durlabhaṃ kathyate mayā ||	sādhakānām hita arthāya durlabham kathyate mayā 
SA_MB_kakacandesvarimataHK-771	kṣālitaṃdulatoyanatālakaṃ ca varānane |	kṣālitaṃdula toyana tālakam ca varānane 
SA_MB_kakacandesvarimataHK-772	tatapaścādvarārohepeṣayettaṃdulai saha ||	tata paścāt varārohe peṣayet taṃdulaiḥ saha 
SA_MB_kakacandesvarimataHK-773	ṣaṣṭikā pṛṣṭhasahitaṃ golakaṃ kārayet punaḥ |	ṣaṣṭikā pṛṣṭha sahitam golakam kārayet punar 
SA_MB_kakacandesvarimataHK-774	prakṣipyodaka madhyena tatasamaśītaṃ jāyate ||	prakṣipya udaka madhyena jāyate 
SA_MB_kakacandesvarimataHK-775	śoṣitaṃ sūryatāyena pūjāṃ kṛtvā vicūr.itaṃ |	śoṣitam sūrya tāyena pūjām kṛtvā vicūritam 
SA_MB_kakacandesvarimataHK-776	bhakṣitaṃ madhusarpibhyāṃ saptarātraṃ samāhitaḥ ||	bhakṣitam madhu sarpibhyām sapta rātram samāhitaḥ 
SA_MB_kakacandesvarimataHK-777	udayāditya varṇābhaḥ svarūpo priyadarśanaḥ |	udaya āditya varṇa ābhaḥ priya darśanaḥ 
SA_MB_kakacandesvarimataHK-778	khecaratvamavāpnoti mahāvala parākramaḥ ||	khecara tvam avāpnoti mahā vala parākramaḥ 
SA_MB_kakacandesvarimataHK-779	dvitīye saptake devipataṃti śaśimūrdhvajāḥ |	dvitīye saptake śaśim ūrdhvajāḥ 
SA_MB_kakacandesvarimataHK-780	22b)	Ro
SA_MB_kakacandesvarimataHK-781	tvacādaṃtāni sarvaṃ tena khāścaiva na saṃśayaḥ ||	tvacā daṃtāni sarvam tena khāḥ ca eva na saṃśayaḥ 
SA_MB_kakacandesvarimataHK-782	tṛtīya saptakedevikeśaṃ bhramarasaṃnibhaṃ |	tṛtīya saptake devikeśam bhramara saṃnibham 
SA_MB_kakacandesvarimataHK-783	taptakāṃcana varṇābhaḥ dviraṣṭa varṣakākṛtiḥ ||	tapta kāṃcana varṇa ābhaḥ dvis aṣṭa varṣaka ākṛtiḥ 
SA_MB_kakacandesvarimataHK-784	śaṃkhakuṃdeṃdu puṣpaiśca na khāṃgacchali saṃnibhā |	śaṃkha kuṃda indu puṣpaiḥ ca na khāṃga chali saṃnibhā 
SA_MB_kakacandesvarimataHK-785	navanāgavalo bhūtvā jīveccaṃdrārkatārakaṃ ||	nava nāga valaḥ bhūtvā jīvet caṃdra arka tārakam 
SA_MB_kakacandesvarimataHK-786	punaranyaṃ pravakṣyāmi tālakasya śubhāvidhi |	punar anyam pravakṣyāmi tālakasya śubhāvidhi 
SA_MB_kakacandesvarimataHK-787	tālakaṃ gṛhyate devi mardayettena sūtakaṃ ||	tālakam gṛhyate devi mardayet tena sūtakam 
SA_MB_kakacandesvarimataHK-788	bhakṣayet pratyahadevimāṣaikaṃ ca dine dine |	bhakṣayet pratyaha devi māṣa ekam ca dine dine 
SA_MB_kakacandesvarimataHK-789	yāvatkarṣa pramānaṃ tu dinānāmekaviṃśati ||	yāvat karṣa pramānam tu dinānām ekaviṃśati 
SA_MB_kakacandesvarimataHK-790	aṣṭādaśaikakuṣṭāni utpaṃnāni ca nāśayet |	aṣṭādaśa ekakuṣṭāni utpaṃnāni ca nāśayet 
SA_MB_kakacandesvarimataHK-791	udayādityasaṃkāśaṃ jāyate siddhikeśvari ||	udaya āditya saṃkāśam jāyate siddhikeśvari 
SA_MB_kakacandesvarimataHK-792	prāpyate siddhiyogeṃdraṃ labhate siddhimuttamaṃ |	prāpyate siddhi yoga iṃdram labhate siddhim uttamam 
SA_MB_kakacandesvarimataHK-793	valīpalita nirmukto dviriṣṭavarṣakāhutiḥ ||	             
SA_MB_kakacandesvarimataHK-794	navanāgavalobhūtvājīve caṃdrārkatārakaṃ |	caṃdra arka tārakam 
SA_MB_kakacandesvarimataHK-795	jalakāṣṭaṃ ca saṃgṛhya kṛtvā cāpi samudbhukaṃ ||	jala kāṣṭam ca saṃgṛhya kṛtvā ca api samudbhukam 
SA_MB_kakacandesvarimataHK-796	tena ghṛtena saṃsodhyatālakaṃ niṣanena tu |	tena ghṛtena tu 
SA_MB_kakacandesvarimataHK-797	śaṣāḍhamāsayo paṃcayāvatkārtikapūrṇimā ||	śa ṣāḍha māsayoḥ paṃca yāvat kārtika pūrṇimā 
SA_MB_kakacandesvarimataHK-798	23a)	Ro
SA_MB_kakacandesvarimataHK-799	puṣkarāṃte sthite madhye uddharetaṃ śubhedine |	puṣkara aṃte sthite madhye uddharetam śubhedine 
SA_MB_kakacandesvarimataHK-800	mardayettena sūtaṃ ca māṣaikaṃ bhakṣayetna tu ||	mardayet tena sūtam ca māṣa ekam bhakṣayet na tu 
SA_MB_kakacandesvarimataHK-801	prātarūtthāyaṃ medhāvī śaptāhaṃ ca dine dine |	medhāvī śapta aham ca dine dine 
SA_MB_kakacandesvarimataHK-802	dvitīye saptake caiva keśābhramarasaṃnibhā ||	dvitīye saptake ca eva keśa abhramara saṃnibhā 
SA_MB_kakacandesvarimataHK-803	saubhāgyārogya śrīcanārīhṛdayanaṃdanaḥ |	        
SA_MB_kakacandesvarimataHK-804	māsameka prayogena apsaraiḥ saha krīḍati ||	māsam eka prayogena apsaraiḥ saha krīḍati 
SA_MB_kakacandesvarimataHK-805	brahmavṛkṣasya kāṣṭhena evaṃ kṛtvā prayatnataḥ |	brahmavṛkṣasya kāṣṭhena evam kṛtvā prayatnataḥ 
SA_MB_kakacandesvarimataHK-806	tālakaṃ rasasaṃyuktaṃ dhātrī saha niyojayet ||	tālakam rasa saṃyuktam dhātrī saha niyojayet 
SA_MB_kakacandesvarimataHK-807	mahiṣīpurīṣavedyaṃ tat svacchayāna ca bhidyate |	mahiṣī purīṣa vedyam tat ca bhidyate 
SA_MB_kakacandesvarimataHK-808	dinānāmekaviṃśaṃ ca śoṣitaṃ yāvajāyate ||	dinānām ekaviṃśam ca śoṣitam yāvat jāyate 
SA_MB_kakacandesvarimataHK-809	bhakṣataṃ rasaṃ siddhaṃ vṛhasyati samo bhavet |	rasam siddham vṛhasyati samaḥ bhavet 
SA_MB_kakacandesvarimataHK-810	nānāśāstrārtha saṃvādī avadhyo sarvabhūtale ||	nānā śāstra artha saṃvādī avadhyaḥ sarva bhū tale 
SA_MB_kakacandesvarimataHK-811	tālakaṃ pārade caiva ekīkṛtvā tu mardayet |	tālakam pārade ca eva ekīkṛtvā tu mardayet 
SA_MB_kakacandesvarimataHK-812	tālamūlīrasaṃ caiva mardayedrasasaṃyutaṃ ||	tālamūlī rasam ca eva mardayet rasa saṃyutam 
SA_MB_kakacandesvarimataHK-813	jaṃvīrakāṣṭhaiḥ saṃmardyaḥ lohasyabhājanaṃ kuruḥ |	jaṃvīra kāṣṭhaiḥ saṃmardyaḥ lohasya bhājanam kuruḥ 
SA_MB_kakacandesvarimataHK-814	taṃtālakaṃ gṛhītvā tu kṣipejjaṃvīrapūrakaiḥ ||	taṃtālakam gṛhītvā tu kṣipet jaṃvīra pūrakaiḥ 
SA_MB_kakacandesvarimataHK-815	23b)	Ro
SA_MB_kakacandesvarimataHK-816	mahiṣīsthāne ca veṣṭhayaṃ pacinirgaṃdhatāṃ vrajet |	mahiṣī sthāne ca veṣṭhayam paci nirgaṃdha tām vrajet 
SA_MB_kakacandesvarimataHK-817	punaḥ pāradasaṃyuktomātu liṃge na pācayet ||	punar liṃge na pācayet 
SA_MB_kakacandesvarimataHK-818	tāṃvūlapatrasahitaṃ māṣaikaṃ caiva bhakṣayet |	tāṃvūla patra sahitam māṣa ekam ca eva bhakṣayet 
SA_MB_kakacandesvarimataHK-819	māsameka prayogena iṣṭasiddhirbhaviṣyati ||	māsam eka prayogena iṣṭa siddhiḥ bhaviṣyati 
SA_MB_kakacandesvarimataHK-820	raṃjate sarvalohāni puṭayāṃkena kāṃcanaṃ |	raṃjate sarva lohāni puṭaya aṃkena kāṃcanam 
SA_MB_kakacandesvarimataHK-821	iti kākacaṃḍeśvarīmate tālakakalpaṃ samāptam ||	iti kākacaṃḍeśvarīmate tālaka kalpam samāptam 
SA_MB_kakacandesvarimataHK-822	haritāla satvapātanaḥ ||	       
SA_MB_kakacandesvarimataHK-823	rasaṃ ca tālakaṃ caiva lohapātreṇa mardayet |	rasam ca tālakam ca eva loha pātreṇa mardayet 
SA_MB_kakacandesvarimataHK-824	vījapūraka madhya tu mahiṣī gomayenacchādayet ||	vījapūraka madhya tu mahiṣī gomayena chādayet 
SA_MB_kakacandesvarimataHK-825	tāṃvūlapatra madhye tu māṣamekaṃ tu nakṣayet |	tāṃvūla patra madhye tu māṣam ekam tu nakṣayet 
SA_MB_kakacandesvarimataHK-826	māsameka prayogaṃ ca jīveccaṃdrārkatārakaṃ ||	māsam eka prayogam ca jīvet candra arka tārakam 
SA_MB_kakacandesvarimataHK-827	24a)	Ro
SA_MB_kakacandesvarimataHK-828	kāṃtacecābhrakaṃ caiva rasaṃgaṃdhakameva ca |	ca eva rasam gaṃdhakam eva ca 
SA_MB_kakacandesvarimataHK-829	mardayecca tridaṃḍena yāvadbhavati golakaṃ ||	mardayet ca tridaṃḍena yāvat bhavati golakam 
SA_MB_kakacandesvarimataHK-830	niṃvakalpaḥ ||	niṃva kalpaḥ 
SA_MB_kakacandesvarimataHK-831	picumuṃdodaresthāpya varṣamekartu sādhakaḥ |	picumunda udare sthāpya varṣam eka ṛtu sādhakaḥ 
SA_MB_kakacandesvarimataHK-832	ṣaṇmāsaṃ bhakṣayedyastu jīveccandrārkatārakaṃ ||	ṣaṣ māsam bhakṣayet yaḥ tu jīvet candra arka tārakam 
SA_MB_kakacandesvarimataHK-833	tridaṃḍamarditaṃ sūtaṃ śālmalī vṛkṣe sthāpayet |	tridaṃḍa marditam sūtam śālmalī vṛkṣe sthāpayet 
SA_MB_kakacandesvarimataHK-834	varṣameka pramāṇenataṃ bhakṣayet punaḥ punaḥ ||	bhakṣayet punar punar 
SA_MB_kakacandesvarimataHK-835	ṣaṇmāsaṃ ca prayogena jīveccaṃdrārkatārakaṃ |	ṣaṣ māsam ca prayogena jīvet caṃdra arka tārakam 
SA_MB_kakacandesvarimataHK-836	punaranya pravakṣyāmi bhasmasūtavidhiṃ **? ||	punar anya pravakṣyāmi bhasma sūta vidhim 
SA_MB_kakacandesvarimataHK-837	devadālīrasaṃmardya rasaṃgaṃdhakameva ca |	devadālī rasaṃ mardya rasam gaṃdhakam eva ca 
SA_MB_kakacandesvarimataHK-838	pācayet puṭayākanabhasmabhavati sūtakaṃ ||	pācayet sūtakam 
SA_MB_kakacandesvarimataHK-839	bhakṣayettāṃvūlapatreṇa māṣikaṃ māsameva ca |	bhakṣayet tāṃvūla patreṇa māṣikam māsam eva ca 
SA_MB_kakacandesvarimataHK-840	24b)	Ro
SA_MB_kakacandesvarimataHK-841	paṃkṣameka pramāṇena kukṣikuṣṭhādi sādhake ||	paṃkṣameka pramāṇena kukṣi kuṣṭha ādi sādhake 
SA_MB_kakacandesvarimataHK-842	evaṃ prayogena bhakṣayet bhakṣayet palaṃdaśa |	evam prayogena bhakṣayet bhakṣayet palam daśa 
SA_MB_kakacandesvarimataHK-843	valīpalita nirmukto mahāvalaparākramaḥ ||	valī palita nirmuktaḥ mahā vala parākramaḥ 
SA_MB_kakacandesvarimataHK-844	suvarṇadṛṣṭirmedhāvī jīvedvarṣa śatadvayaṃ |	suvarṇa dṛṣṭiḥ medhāvī jīvet varṣa śata dvayam 
SA_MB_kakacandesvarimataHK-845	triguṇaṃ bhakṣayet prājño bhasmasūtavidhau saha ||	  bhakṣayet          
SA_MB_kakacandesvarimataHK-846	paṃcavarṣaśatānyevajīvecca sādhakeśvari |	paṃca varṣa śatāni eva jīvet ca sādhakeśvari 
SA_MB_kakacandesvarimataHK-847	iti laghusūtakaṃ ||	iti laghusūtakam 
SA_MB_kakacandesvarimataHK-848	oṃ saḥ saḥ srāvaya 2 amṛtaṃ srāvaya oṃ mahau haṃ hasaḥ svāhā kuru kuru	om saḥ saḥ srāvaya amṛtam srāvaya om mahau haṃ hasaḥ svāhā kuru kuru 
SA_MB_kakacandesvarimataHK-849	somaṃ ca sarasaḥ || śālmalī chedanamaṃtraḥ ||	somam ca sarasaḥ śālmalī chedana maṃtraḥ 
SA_MB_kakacandesvarimataHK-850	punaranyaṃ pravakṣyāmi mahālehyaṃ yathāvidhi |	punar anyam pravakṣyāmi mahālehyam yathāvidhi 
SA_MB_kakacandesvarimataHK-851	niśācara hataṃ sūtaṃ dhātrī phalahataṃ tīkṣṇaṃ ||	niśācara hatam sūtam dhātrī phala hatam tīkṣṇam 
SA_MB_kakacandesvarimataHK-852	triphalāmadhusarpirbhyāṃyolihetsojarāmaraḥ |	triphalā madhu sarpirbhyām yaḥ lihet saḥ jarā amaraḥ 
SA_MB_kakacandesvarimataHK-853	25a)	Ro
SA_MB_kakacandesvarimataHK-854	gaṃdhakaṃ pāradaṃ caiva tīkṣṇaṃ ca kāṃtimeva ca ||	gaṃdhakam pāradam ca eva tīkṣṇam ca kāntim eva ca 
SA_MB_kakacandesvarimataHK-855	samadhātau samaṃrdhyārtapalāśavījamātrayoḥ |	sama dhātau 
SA_MB_kakacandesvarimataHK-856	tripauṣadhādvayaṃjātī śilājitatriphalāsaha ||	tripauṣadhā dvayam jātī śilā jita triphalā saha 
SA_MB_kakacandesvarimataHK-857	etāni samabhāgāni arkadhātrī ca mardayet |	etāni sama bhāgāni arka dhātrī ca mardayet 
SA_MB_kakacandesvarimataHK-858	taṃḍulīyarasaṃtaptvā triphalāṃ sahamardayet ||	taṃḍulīya rasam taptvā triphalām sahamardayet 
SA_MB_kakacandesvarimataHK-859	khadirakvāthasaṃyuktāṃ śikhipitta samanvitam |	khadira kvātha saṃyuktām śikhi pitta samanvitam 
SA_MB_kakacandesvarimataHK-860	mardayettu vidhānena arkasya tu rasaiḥ saha ||	mardayet tu vidhānena arkasya tu rasaiḥ saha 
SA_MB_kakacandesvarimataHK-861	triphalārasakrātaṃ ca kāṃtisayuktasthāpayet |	triphalā rasa krātam ca kānti sayukta sthāpayet 
SA_MB_kakacandesvarimataHK-862	gojihvātriphalāyāśca vāhyalepāni kārayet ||	gojihvā triphalāyāḥ ca vāhya lepāni kārayet 
SA_MB_kakacandesvarimataHK-863	taṃvāhyamṛttikālepaṃ mṛnmayabhāṃḍesthāpayet |	tam vāhya mṛttikā lepam mṛd maya bhāṃḍe sthāpayet 
SA_MB_kakacandesvarimataHK-864	puṭayogena bhūmau tu nikhanejjānumātrake ||	puṭa yogena bhūmau tu nikhanet jānu mātrake 
SA_MB_kakacandesvarimataHK-865	25b)	Ro
SA_MB_kakacandesvarimataHK-866	adhorddhaṣāta dātavyaṃ mṛttikālepagomayaṃ |	dātavyam mṛttikā lepa gomayam 
SA_MB_kakacandesvarimataHK-867	nityānigaṃdhadhūpānisaṃvatsaraikameva ca ||	nityāni gaṃdha dhūpāni saṃvatsara ekam eva ca 
SA_MB_kakacandesvarimataHK-868	pūjāṃ kṛtvā tu uddhṛtya pūjayeddeva brāhmaṇān |	pūjām kṛtvā tu uddhṛtya pūjayet deva brāhmaṇān 
SA_MB_kakacandesvarimataHK-869	madhusarpiḥ samāyuktaṃ bhakṣayetta mahārasaṃ ||	madhu sarpiḥ samāyuktam mahārasam 
SA_MB_kakacandesvarimataHK-870	śubhedinesu nakṣatre śubhacandre varāvale |	śubhedinesu nakṣatre śubha candre vara āvale 
SA_MB_kakacandesvarimataHK-871	prathame saptame caiva kuṣṭhakṣayavināśanaṃ ||	prathame saptame ca eva kuṣṭha kṣaya vināśanam 
SA_MB_kakacandesvarimataHK-872	sarvavyādhi vinirmukto kaṃkumātraṃ mahārasaṃ |	kaṃku mātram mahārasam 
SA_MB_kakacandesvarimataHK-873	saptake saptame caiva khecarī bhavatāvyayā ||	saptake saptame ca eva khecarī bhavata avyayā 
SA_MB_kakacandesvarimataHK-874	nālyapuṇyena siddhyaṃti idaṃ caiva rasāyaṇaṃ |	idam ca eva rasāyaṇam 
SA_MB_kakacandesvarimataHK-875	na kāṃtena vināsūtaṃ na sūtaṃ kāṃtivarjitaṃ ||	na kāṃtena vinā a sūtam na sūtam kānti varjitam 
SA_MB_kakacandesvarimataHK-876	na saṃkramati deha na gṛhapiṃḍamivāṃbhasi |	na saṃkramati deha na gṛha piṃḍam iva aṃbhasi 
SA_MB_kakacandesvarimataHK-877	iti mahārasāyaṇavidhiḥ samāptaḥ ||	iti mahārasāyaṇa vidhiḥ samāptaḥ 
SA_MB_kakacandesvarimataHK-878	26a)	Ro
SA_MB_kakacandesvarimataHK-879	oṃ namo rasendrāya ||	om namaḥ rasendrāya 
SA_MB_kakacandesvarimataHK-880	dharmaṃ kīrtiṃ samāśritya kathyate rasasaṃgrahaḥ |	dharmam kīrtim samāśritya kathyate rasa saṃgrahaḥ 
SA_MB_kakacandesvarimataHK-881	vinādravyaṃ na siddhyaṃti tasmāddravyanirūpaṇaṃ ||	vinā dravyam na tasmāt dravya nirūpaṇam 
SA_MB_kakacandesvarimataHK-882	jayati rasavarendraḥ kuṣṭhapuṣpādiroganut |	                
SA_MB_kakacandesvarimataHK-883	praharati samastāyeya yadasti narāṇāṃ ca valīpalitaṃ vinaśyati ||	praharati yat asti narāṇām ca valī palitam vinaśyati 
SA_MB_kakacandesvarimataHK-884	dīrghāyurdadāti ca rasavadhyaṃdaviṣyaṃti khecaratvaṃ dadāti ca ||	dīrgha āyuḥ dadāti ca rasa vadhyam daviṣyaṃti khecara tvam dadāti ca 
SA_MB_kakacandesvarimataHK-885	yadā aṣṭādaśaṃ karmarasaṃ yena vaśīkṛtaṃ |	yadā aṣṭādaśam karma rasam yena vaśīkṛtam 
SA_MB_kakacandesvarimataHK-886	hanyāttasya jarāmṛtyu dāridryaṃ mṛtyumeva ca ||	hanyāt tasya jarā mṛtyu dāridryam mṛtyum eva ca 
SA_MB_kakacandesvarimataHK-887	svedanāddarśanā mūrchāmutthāpyapānarodhanam |	svedanāt darśanāḥ mūrchām utthāpya apāna rodhanam 
SA_MB_kakacandesvarimataHK-888	niyamādīpanaścaiva gaganagrāsapramāṇataḥ ||	niyama ādīpanaḥ ca eva gagana grāsa pramāṇataḥ 
SA_MB_kakacandesvarimataHK-889	mathanācāraṇavidhānaṃ drāvaṇaṃ ca tathā paraṃ |	mathana ācāraṇa vidhānam drāvaṇam ca tathā param 
SA_MB_kakacandesvarimataHK-890	26b)	Ro
SA_MB_kakacandesvarimataHK-891	garbhadūtakaṣārātajāraṇaṃ raṃjanasya tu |	          
SA_MB_kakacandesvarimataHK-892	māraṇaṃ kramaṇa caiva eva maṣṭādaśa kramāt ||	kramāt 
SA_MB_kakacandesvarimataHK-893	na svedatonāgni siddhirasavyaṃ caiva bhāvitaṃ |	na siddhiḥ asavyam ca eva bhāvitam 
SA_MB_kakacandesvarimataHK-894	muktibheda eva svedo aṣṭakarma pravakṣyate ||	mukti bhedaḥ eva svedaḥ aṣṭakarma pravakṣyate 
SA_MB_kakacandesvarimataHK-895	svedācaraṇavidhānaṃ jāraṇaṃ māraṇanthā |	sveda ācaraṇa vidhānam jāraṇam 
SA_MB_kakacandesvarimataHK-896	jāraṇaṃ caiva vijñeyā aṣṭakarma ca ||	jāraṇam ca eva vijñeyāḥ aṣṭakarma ca 
SA_MB_kakacandesvarimataHK-897	na svedāntī vratāṃ yāti narakto raṃjayet paraṃ |	na sveda antī vratām yāti na raktaḥ raṃjayet param 
SA_MB_kakacandesvarimataHK-898	na jārito bhavedvāpī na yogaṃ kramatepi ca ||	na jāritaḥ bhavet vāpī na yogam kramate api ca 
SA_MB_kakacandesvarimataHK-899	ebhiḥ karmānusāraiśca samīkāsuvaśī kṛtam |	ebhiḥ karma anusāraiḥ ca samīkā su vaśī kṛtam 
SA_MB_kakacandesvarimataHK-900	hanyāttasya jarāmṛtyudāridryaṃ duḥkhanāśanam ||	hanyāt tasya jarā mṛtyu dāridryam duḥkha nāśanam 
SA_MB_kakacandesvarimataHK-901	sādhayenmaṃtrayaṃtrābhyāṃ saghoṣaṇa krameṇa ca |	sādhayet maṃtra yaṃtrābhyām sa ghoṣaṇa krameṇa ca 
SA_MB_kakacandesvarimataHK-902	saṃsvedanāśayogena tatkṣaṇaṃ vadhnāti sūtakaṃ ||	saṃsveda nāśa yogena tad kṣaṇam vadhnāti sūtakam 
SA_MB_kakacandesvarimataHK-903	27a)	Ro
SA_MB_kakacandesvarimataHK-904	dhūmresuniṣṭhite caiva maṃdūkalūta eva ca |	ca eva maṃdūka lūte eva ca 
SA_MB_kakacandesvarimataHK-905	kaṃpaṃnikuṃbhakaṃ caiva rasasya paṃcadhāgatiḥ ||	kaṃpam nikuṃbhakam ca eva rasasya paṃcadhā gatiḥ 
SA_MB_kakacandesvarimataHK-906	svedanaṃ vakṣyate yatra śṛṇusaṃkarasiddhidaṃ |	svedanam vakṣyate yatra śṛṇu saṃkara siddhi dam 
SA_MB_kakacandesvarimataHK-907	pāṭhāpunarnnavācaivalāṃgalīyaviciṃcakā ||	pāṭhā punarnnavā caiva lāṃgalīya viciṃcakā 
SA_MB_kakacandesvarimataHK-908	devadālpātakāpaṃca oṣadhī ityathocitā |	oṣadhī iti atha ucitā 
SA_MB_kakacandesvarimataHK-909	sigrusiṃdhaṃ trikaṭukaṃ sthālyāṃdolāgnināpacet ||	sigru siṃdham trikaṭukam sthālyā āṃdolā agninā pacet 
SA_MB_kakacandesvarimataHK-910	punaḥ puṭetu mṛtatvaṃ jāraṇābhukamucyate |	punar puṭetu mṛta tvam jāraṇābhukam ucyate 
SA_MB_kakacandesvarimataHK-911	nahiṣī dugdhapālaṃ ca kāraṇaṃ vījapūrakaṃ ||	         
SA_MB_kakacandesvarimataHK-912	jaṃvīrāmlaṃvetasatyavṛhatyayavaciṃcakā |	jaṃvīra amlaṃvetasatya vṛhatya yavaciṃcakā 
SA_MB_kakacandesvarimataHK-913	sigrusaidhavatulyasya patrāṇi pakvayāni ca ||	sigru saidhava tulyasya patrāṇi pakvayāni ca 
SA_MB_kakacandesvarimataHK-914	saurāṣṭrahayakāsīsasiṃdhayo āranālayoḥ |	saurāṣṭra haya kāsīsa siṃdhayoḥ āranālayoḥ 
SA_MB_kakacandesvarimataHK-915	dinadvādaśamityāhurmadirāra sa ucyate ||	dina dvādaśam iti āhuḥ madirāra saḥ ucyate 
SA_MB_kakacandesvarimataHK-916	27b)	Ro
SA_MB_kakacandesvarimataHK-917	abhrakacūrṇabhāvanāṃ vahuvāraṃ punaḥ punaḥ |	abhraka cūrṇa bhāvanām vahu vāram punar punar 
SA_MB_kakacandesvarimataHK-918	sutaptalohakhalve tu siṃdhunāsahitaṃdhunaḥ ||	su tapta loha khalve tu 
SA_MB_kakacandesvarimataHK-919	sūtakacābhrakaṃ madhyeyāvadbhavati golakaṃ |	sūta kaca abhrakam madhye yāvat bhavati golakam 
SA_MB_kakacandesvarimataHK-920	hemakriyā su hemāni tārakriyā sutādayaḥ ||	hema kriyā su hemāni tāra kriyā suta ādayaḥ 
SA_MB_kakacandesvarimataHK-921	mūṣāṃ kṛtvā ca dhāmayedabhrakayādāṃsamardayet |	mūṣām kṛtvā ca dhāmayet abhrakayā dāṃsam ardayet 
SA_MB_kakacandesvarimataHK-922	kāṃsya dviguṇatriguṇeṣu yathā saṃketacāraṇaṃ ||	dviguṇa triguṇeṣu yathā saṃketa cāraṇam 
SA_MB_kakacandesvarimataHK-923	jāraṇañca pravakṣyāmi rasagrāsasya caritaṃ |	jāraṇam ca pravakṣyāmi rasa grāsasya caritam 
SA_MB_kakacandesvarimataHK-924	siṃdhuvidrānvittamebhirjāraṇaṃ ceti kārayet ||	siṃdhu vidrā anvittam ebhiḥ jāraṇam ca iti kārayet 
SA_MB_kakacandesvarimataHK-925	svedaṃdadyāttu saṃyogekṣaṇaṃ vadhnāti sūtakaṃ |	svedam dadyāt tu saṃyoga īkṣaṇam vadhnāti sūtakam 
SA_MB_kakacandesvarimataHK-926	pariṇāmyati ||	pariṇāmyati 
SA_MB_kakacandesvarimataHK-927	athānyaṃ vyākhyāsyāmaḥ ||	atha anyam vyākhyāsyāmaḥ 
SA_MB_kakacandesvarimataHK-928	rasābhragolakaṃyattugostanākāramūṣake |	rasa abhra golakam yat tu gostana ākāra mūṣake 
SA_MB_kakacandesvarimataHK-929	adhorddhavihidatvena hāṃyāsiktātapūrayet ||	adhorddha vihida tvena 
SA_MB_kakacandesvarimataHK-930	28a)	Ro
SA_MB_kakacandesvarimataHK-931	adho mṛdvagninājārayet ||	adhas mṛdu agninā ājārayet 
SA_MB_kakacandesvarimataHK-932	rasoparistokamṣtokacapurāmlasiṃdhu dāpayet |	rasa upari stokam stoka capura amla siṃdhu dāpayet 
SA_MB_kakacandesvarimataHK-933	evaṃ tu tridine jīrṇe grāsate jāraṇādikaṃ ||	evam tu tri dine jīrṇe grāsate jāraṇa ādikam 
SA_MB_kakacandesvarimataHK-934	jīrṇasya lakṣaṇatrīṇi caturthaṃ mṛtpiṃḍabhūtakaṃ |	jīrṇasya lakṣaṇa trīṇi caturtham mṛd piṃḍa bhūtakam 
SA_MB_kakacandesvarimataHK-935	atha vajravaikrāṃtavidhiḥ ||	atha vajra vaikrāṃta vidhiḥ 
SA_MB_kakacandesvarimataHK-936	ṭaṃkaṇaṃ ṭai hatasyā tu divyauṣadha yogena saṃsparśābhavate mukhaṃ |	tu divyauṣadha yogena mukham 
SA_MB_kakacandesvarimataHK-937	tatkṣaṇaṃ vadhyate rasaṃ evaṃ abhrakarasaṃ caiva pūrvokteṣu ca karmasu ||	tad kṣaṇam vadhyate rasam evam abhraka rasam ca eva pūrva ukteṣu ca karmasu 
SA_MB_kakacandesvarimataHK-938	iti jāraṇaṃ ||	iti jāraṇam 
SA_MB_kakacandesvarimataHK-939	atha drāvaṇam ||	atha drāvaṇam 
SA_MB_kakacandesvarimataHK-940	hiṃgvāṣṭaṭaṃkaṇaṃ savyaṃ tribhiḥ saṃyuktameva ca |	hiṃgvā aṣṭa ṭaṃkaṇam savyam tribhiḥ saṃyuktam eva ca 
SA_MB_kakacandesvarimataHK-941	vidrañca jāraṇaṃ śreṣṭhaṃ rasā aṣṭau sadāpriye ||	vidran ca jāraṇam śreṣṭham rasāḥ aṣṭau sadāpriye 
SA_MB_kakacandesvarimataHK-942	atha vyākhyā syāmaḥ ||	atha vyākhyā syāmaḥ 
SA_MB_kakacandesvarimataHK-943	28b)	Ro
SA_MB_kakacandesvarimataHK-944	arkakṣīreṇa śaṃkhaṃ ca cūrṇapuṭitasaṃmataṃ |	arka kṣīreṇa śaṃkham ca cūrṇa puṭita saṃmatam 
SA_MB_kakacandesvarimataHK-945	idamekaṃ viḍaśreṣṭaṃ rasajāraṇamuttamaṃ ||	idam ekam viḍa śreṣṭam rasa jāraṇam uttamam 
SA_MB_kakacandesvarimataHK-946	guḍanāmeti bhasmasya gālitaṃgojalena tu |	guḍa nāma iti bhasmasya gālitam go jalena tu 
SA_MB_kakacandesvarimataHK-947	pītagaṃdhakabhāvāttu yadvāraṃ sādhitaṃ bhavet ||	pīta gaṃdhaka bhāvāt tu yat vāram sādhitam bhavet 
SA_MB_kakacandesvarimataHK-948	atha vyākhyāsyāmaḥ ||	atha vyākhyāsyāmaḥ 
SA_MB_kakacandesvarimataHK-949	mūlakandapuṭaṃ dagdhaṃ bhasmagomūtragālitaṃ |	            
SA_MB_kakacandesvarimataHK-950	gaṃdhakaṃ tena bhāvyetaśataikaṃta punaḥ punaḥ ||	gaṃdhakam tena punar punar 
SA_MB_kakacandesvarimataHK-951	itthamuktaṃ viḍaśreṣṭhaṃ gaṃdhakasya muṣaraṃsaḥ |	ittham uktam viḍa śreṣṭham gaṃdhakasya 
SA_MB_kakacandesvarimataHK-952	athavā citrodaka bhasmagālitaṃ ca gomūtrake ||	athavā citra udaka bhasma gālitam ca go mūtrake 
SA_MB_kakacandesvarimataHK-953	bhāvanāneka yuktā tu iti paramavidu ucyate |	bhāvanā aneka yuktā tu iti parama vidu ucyate 
SA_MB_kakacandesvarimataHK-954	lakṣaṇakṣāroparasairmūtrāgomūtragālitam ||	lakṣaṇa kṣāra uparasaiḥ mūtrā go mūtra gālitam 
SA_MB_kakacandesvarimataHK-955	uktāmrajāriṇīmebhiḥ kuruktaṃsānupācayet |	ukta āmra jāriṇīm ebhiḥ kurukṣuktaṃsa anupācayet 
SA_MB_kakacandesvarimataHK-956	29a)	Ro
SA_MB_kakacandesvarimataHK-957	samudrasaiṃdhavānāṃ ca viduromāti sauvarcalaṃ ||	samudra saiṃdhavānām ca vidura umā ati sauvarcalam 
SA_MB_kakacandesvarimataHK-958	javakṣārasauvarjakānāṃ ca ṭaṃkaṇe ca sahasaṃyutau |	javakṣāra sauvarjakānām ca ṭaṃkaṇe ca saha saṃyutau 
SA_MB_kakacandesvarimataHK-959	mekṣakapālāsakṣāraiśca tilakṣāre apāmārgayoḥ ||	mekṣaka pālāsa kṣāraiḥ ca tila kṣāre apāmārgayoḥ 
SA_MB_kakacandesvarimataHK-960	asvacchaṃ vajrakākṣāsva arkakṣāra eraṇḍayoḥ |	asvaccham arka kṣāre eraṇḍayoḥ 
SA_MB_kakacandesvarimataHK-961	unmattaṃścakūṣmāṇḍaśca gomūtreṇa tu gālayet ||	unmattan ca kūṣmāṇḍaḥ ca go mūtreṇa tu gālayet 
SA_MB_kakacandesvarimataHK-962	idamevaviduṃśreṣṭhaṃ sarvalohānidrāvayet |	sarva lohāni drāvayet 
SA_MB_kakacandesvarimataHK-963	dvauharidrāṇimajiṣṭāpataṃgeraktacaṃdanaṃ ||	dvau haridrāṇi majiṣṭā pataṃge raktacaṃdanam 
SA_MB_kakacandesvarimataHK-964	kusubhaṃ kuṃkumaṃ caiva haṃsapādaṃ tathā samaṃ |	kusubham kuṃkumam ca eva haṃsapādam tathā samam 
SA_MB_kakacandesvarimataHK-965	ṭaṃkaṇaṃ caiva mākṣīkaṃ śaṃkhacaṃ śvetakācayoḥ ||	ṭaṃkaṇam ca eva mākṣīkam śaṃkhacam śveta kācayoḥ 
SA_MB_kakacandesvarimataHK-966	tālakaṃ prativāyena deyatiṃvyūṭajīvayoḥ |	tālakam prativāyena deya tiṃvyūṭa jīvayoḥ 
SA_MB_kakacandesvarimataHK-967	nirmalaṃ bhavate tāraṃ yaśodhana manuttamam ||	nirmalam bhavate tāram yaśaḥ dhana manuttamam 
SA_MB_kakacandesvarimataHK-968	nivyūṭavaṃgābhramasya saptamekarṣa ṣoḍaśaṃ |	nivyūṭa vaṃga abhramasya saptama ekarṣa ṣoḍaśam 
SA_MB_kakacandesvarimataHK-969	29b)	Ro
SA_MB_kakacandesvarimataHK-970	guṇaṃ ca devi kuṣitameva kūṭādhikaśatavedhakam ||	guṇam ca devi kuṣitam eva kūṭa adhika śata vedhakam 
SA_MB_kakacandesvarimataHK-971	nivaheti tārasya ca mṛtavaṃgasyameva ca |	nivaha iti tārasya ca mṛta vaṃgasyam eva ca 
SA_MB_kakacandesvarimataHK-972	śvetobhrakosamaṃ satvaṃ gṛhṇīyāttaṃ nivāhayet ||	satvam gṛhṇīyāt tam nivāhayet 
SA_MB_kakacandesvarimataHK-973	yāvattārāvaśeṣaṃ tu evaṃ tu saptavārake |	yāvat tāra avaśeṣam tu evam tu sapta vārake 
SA_MB_kakacandesvarimataHK-974	ṣoḍaśāttubhinnamasyātpādāṃśena ca jāritaṃ ||	ṣoḍaśāt tu bhinnam asyāt pāda aṃśena ca jāritam 
SA_MB_kakacandesvarimataHK-975	śatavedhaṃ pūrvavatsyāt jñātvā tu vījamelanaṃ || iti ||	śata vedham pūrvavat syāt jñātvā tu vīja melanam iti 
SA_MB_kakacandesvarimataHK-976	raṃjakaṃ tu pravakṣyāmi śvetapītagvidhiryathā |	raṃjakam tu pravakṣyāmi 
SA_MB_kakacandesvarimataHK-977	sāraṇaṃ kāraṇaṃ vakṣyegomahiṣājya saṃpure ||	sāraṇam kāraṇam vakṣye go mahiṣa ajya saṃpure 
SA_MB_kakacandesvarimataHK-978	godhāśaśakāvasājāti yathā lābhe raktapītagaṇāni ca |	godhā śaśaka avasā jāti yathā lābhe rakta pīta gaṇāni ca 
SA_MB_kakacandesvarimataHK-979	niryāsaṃsamatailena paripakvaṃ bhavettu sā ||	niryāsam sama tailena paripakvam bhavet tu sā 
SA_MB_kakacandesvarimataHK-980	sāraṇārtha prayogaṃ ca sādhayedrasakarmaṇi |	sāraṇā artha prayogam ca sādhayet rasakarmaṇi 
SA_MB_kakacandesvarimataHK-981	30a)	Ro
SA_MB_kakacandesvarimataHK-982	haradaṃtī vījasamaṃ tailāhaṃ agnisādhitaṃ ||	            
SA_MB_kakacandesvarimataHK-983	evaṃ pratisārastu bhavati sāraṇakarmaṇi |	evam pratisāraḥ tu bhavati sāraṇa karmaṇi 
SA_MB_kakacandesvarimataHK-984	haraṃ ca pāradaṃ daṃtī samaṃkasya ca vījāni ||	haram ca pāradam daṃtī samaṃkasya ca vījāni 
SA_MB_kakacandesvarimataHK-985	vījeti harivījāni tāravījānimeva hi |	vīja iti hari vījāni tāra vījānim eva hi 
SA_MB_kakacandesvarimataHK-986	sameti samabhāgāni tārabhāgaikaṃ nāgabhāgaikaṃ ||	samā iti sama bhāgāni tāra bhāga ekam nāga bhāga ekam 
SA_MB_kakacandesvarimataHK-987	adho agniṃ pradadyāt tailena sārdhaṃ ca kuru |	adhas agnim pradadyāt tailena sārdham ca kuru 
SA_MB_kakacandesvarimataHK-988	kasya puṣpāṇi sadaśaḥ daśamūṣā sthāpayet ||	kasya puṣpāṇi sadaśaḥ daśamūṣā sthāpayet 
SA_MB_kakacandesvarimataHK-989	hemavījantu bhāgaikaṃ āvartopi niṣevayet |	hema vījantu bhāga ekam niṣevayet 
SA_MB_kakacandesvarimataHK-990	samarasāṃbhūtakāyā evaṃvidhaṃ ca mardayet ||	evaṃvidham ca mardayet 
SA_MB_kakacandesvarimataHK-991	satvapātanaṃ vakṣyate ||	satva pātanam vakṣyate 
SA_MB_kakacandesvarimataHK-992	gugalaṃśalipiṣṭaṃ tu kṛṣṇā tu mṛttikā saha |	tu kṛṣṇā tu mṛttikā saha 
SA_MB_kakacandesvarimataHK-993	kavalaṃ samacūrṇantu gṛhītvā kṣīrakvāthitāṃ ||	gṛhītvā kṣīra kvāthitām 
SA_MB_kakacandesvarimataHK-994	30b)	Ro
SA_MB_kakacandesvarimataHK-995	pākakāle cābhrakaṃ datvā cālitaṃ miśritaṃ kuru |	pāka kāle ca abhrakam da tvā cālitam miśritam kuru 
SA_MB_kakacandesvarimataHK-996	piṃḍī vadhvā kṛtā tena saptāhe niṣitādhayet ||	piṃḍī vadhvā kṛtā tena sapta ahe 
SA_MB_kakacandesvarimataHK-997	khadirāṃgāra agnau ca abhrasatvaṃ tu patitaṃ |	khadira aṃgāra agnau ca abhra satvam tu patitam 
SA_MB_kakacandesvarimataHK-998	aparayogaṃ ||	apara yogam 
SA_MB_kakacandesvarimataHK-999	saptāhaṃ ca daśāhaṃ vā abhracūrṇaṃ tu melayet |	sapta aham ca daśa aham vā abhra cūrṇam tu melayet 
SA_MB_kakacandesvarimataHK-1000	ca calva ca sapiṃḍa madhyāttu dināptaṃ dhāmitaṃ kuru ||	ca calva ca sapiṃḍa madhyāt tu dina āptam dhāmitam kuru 
SA_MB_kakacandesvarimataHK-1001	mṛduśīśakasatvaṃ ca satataṃ patiti cābhrakaṃ |	mṛdu śīśaka satvam ca satatam patiti ca abhrakam 
SA_MB_kakacandesvarimataHK-1002	mākṣikasatvaṃ ||	       
SA_MB_kakacandesvarimataHK-1003	kṣaudraṃ gaṃdharva tailena saghṛtaṃttumabhinavāṃge |	kṣaudram gaṃdharva tailena abhinava aṃge 
SA_MB_kakacandesvarimataHK-1004	āmāvādadyāttu bhūṣo vārtā bhāvitaṃ vaṭī tathā ||	āmau ādadyāt tu bhūṣaḥ vārtā bhāvitam vaṭī tathā 
SA_MB_kakacandesvarimataHK-1005	kadalī rasasaṃyuktaṃ bhāvanā mākṣikasya ca |	               
SA_MB_kakacandesvarimataHK-1006	kuryānmūṣāprataptāyāṃ kṣipettu mākṣikaṃ tathā ||	kuryāt mūṣā prataptāyām kṣipet tu mākṣikam tathā 
SA_MB_kakacandesvarimataHK-1007	31a)	Ro
SA_MB_kakacandesvarimataHK-1008	satyaṃ nāgeṃdratulyaṃ ca gatanti mṛdayaṃ tathā |	satyam nāga iṃdra tulyam ca mṛdayam tathā 
SA_MB_kakacandesvarimataHK-1009	sa ca vaiśvānarābhā tu mākṣika satvameva hi ||	sa ca vaiśvānara ābhā tu mākṣika sattvam eva hi 
SA_MB_kakacandesvarimataHK-1010	drājau *? dreti vikhyātaṃ gaṃdharvati erāvayoḥ |	drājau dreti vikhyātam gaṃdharvati erāvayoḥ 
SA_MB_kakacandesvarimataHK-1011	vātavatī lakṣmaṇājñeyāvadeti kumārīgaṃdhakaṃ ca ||	vātavatī kumārī gaṃdhakam ca 
SA_MB_kakacandesvarimataHK-1012	vārāhakāṃtāṃ tāṃvūlapatrakāṃsyā ca lepayet |	vārāha kāntām tāṃvūla patra kāṃsyā ca lepayet 
SA_MB_kakacandesvarimataHK-1013	anenaiva prayogena trisaṃdhyo taiva yogavat ||	anena eva prayogena trisaṃdhyā u tā eva yogavat 
SA_MB_kakacandesvarimataHK-1014	ṣaṭparisātu satvaṃ ca pataṃti sāramekavat |	satvam ca patanti sāram ekavat 
SA_MB_kakacandesvarimataHK-1015	athāparayogaḥ ||	atha apara yogaḥ 
SA_MB_kakacandesvarimataHK-1016	kaṃkuṣṭa ṭaṃkaṇābhyāṃ ca strī dugdhena tu mardayet |	kaṃkuṣṭa ṭaṃkaṇābhyām ca strī dugdhena tu mardayet 
SA_MB_kakacandesvarimataHK-1017	kṣiptaṃ patati mūṣāśca prataptā parivātakaṃ ||	kṣiptam patati mūṣāḥ ca prataptā parivātakam 
SA_MB_kakacandesvarimataHK-1018	sakaṭatvasyasyātu mahiṣī karṇamalasya ca |	mahiṣī karṇa malasya ca 
SA_MB_kakacandesvarimataHK-1019	kaṭāṣyakarṇa tu malaṃ guṃjasaptapīṣayet ||	tu malam guṃja sapta pīṣayet 
SA_MB_kakacandesvarimataHK-1020	31b)	Ro
SA_MB_kakacandesvarimataHK-1021	pralepittaṃ mūṣāyāṃ tu taptasya pratikṣipyate |	pralepittam mūṣāyām tu taptasya pratikṣipyate 
SA_MB_kakacandesvarimataHK-1022	kaṃkuṣṭaṭaṃkaṇaṃ stanyaṃ vā mitraṃ dhāmyadrāvaṇaṃ ||	kaṃkuṣṭa ṭaṃkaṇam stanyam vā mitram dhāmya drāvaṇam 
SA_MB_kakacandesvarimataHK-1023	strīrapi vajrīkṣīreṇa bhāvitameraṃḍa tailakaṃ |	strīḥ api vajrī kṣīreṇa bhāvitam eraṃḍa tailakam 
SA_MB_kakacandesvarimataHK-1024	keśasahitaṃ dhumettaṃ patatitāpyasatvayoḥ ||	keśa sahitam dhumet tam patati tāpya satvayoḥ 
SA_MB_kakacandesvarimataHK-1025	tāpyacūrṇaṃ rasasya ca manacaṃcala svabhāvataḥ |	tāpya cūrṇam rasasya ca svabhāvataḥ 
SA_MB_kakacandesvarimataHK-1026	rasaṃ vaṃdho kiṃśapīti bhūtale ||	rasam bhū tale 
SA_MB_kakacandesvarimataHK-1027	pāṭhāṃtare ||	pāṭha aṃtare 
SA_MB_kakacandesvarimataHK-1028	āranālena lohaṃ kaḍukṣākena tu khedanaṃ |	āranālena loham kaḍukṣākena tu khedanam 
SA_MB_kakacandesvarimataHK-1029	ghṛtamadhunā sahamardyaṃ pācitaṃ syāt strīravivajrakaṃ ||	             
SA_MB_kakacandesvarimataHK-1030	kṣārayobhāvitaṃ kṛtvā ghṛtasya madhunā saha |	kṣāra yaḥ bhāvitam kṛtvā ghṛtasya madhunā saha 
SA_MB_kakacandesvarimataHK-1031	gṛhadhūmakaṃ datvā ca dhamettutasya satvaṃ ca ||	gṛhadhūmakam da tvā ca dhamet tutasya satvam ca 
SA_MB_kakacandesvarimataHK-1032	patitaṃ bhavati hemakamekī kṛtvā tu meva hi |	patitam bhavati hemakam ekī kṛtvā tu mā iva hi 
SA_MB_kakacandesvarimataHK-1033	32a)	Ro
SA_MB_kakacandesvarimataHK-1034	aṣṭāṃśena dharitvā tu satvasya melakaṃ kuru ||	aṣṭa aṃśena dharitvā tu satvasya melakam kuru 
SA_MB_kakacandesvarimataHK-1035	sūtamititāpyarāsīka satvapāttanaṃ vidhiḥ |	vidhiḥ 
SA_MB_kakacandesvarimataHK-1036	tālakasatvaṃvidhiḥ ||	tālaka sattvam vidhiḥ 
SA_MB_kakacandesvarimataHK-1037	rasatālaṃ samaṃ kṛtvā kūṣmāṃḍa caiva mardayet |	rasa tālam samam kṛtvā kūṣmāṃḍa ca eva mardayet 
SA_MB_kakacandesvarimataHK-1038	haṃḍikātthāpayettatra tāmrapātre chādayet ||	haṃḍikā tthāpayet tatra tāmra pātre chādayet 
SA_MB_kakacandesvarimataHK-1039	śaktikāpūryāsvedāṃ ca praharadvayaṃmeva hi |	śaktikā āpūrya āsvedām ca prahara dvayam eva hi 
SA_MB_kakacandesvarimataHK-1040	paścāntu śītalaṃ kṛtvā tālasatvaṃ vidhīyate ||	śītalam kṛtvā tāla satvam vidhīyate 
SA_MB_kakacandesvarimataHK-1041	evaṃ tu vidhiyogāntukaṃ kuṣṭarasasatvayoḥ |	evam tu kuṣṭa rasa satvayoḥ 
SA_MB_kakacandesvarimataHK-1042	gaṃdhakarlohapātreṇa satvapātanakaṃ bhavet ||	sattva pātanakam bhavet 
SA_MB_kakacandesvarimataHK-1043	haritāla satvavidhiḥ ||	        
SA_MB_kakacandesvarimataHK-1044	iti śrīrasasārottaraṃ caṃḍī maheśvarasaṃvāde rasapātanavidhiḥ ||	iti śrī rasasāra uttaram caṃḍī maheśvara saṃvāde rasa pātana vidhiḥ 
SA_MB_kakacandesvarimataHK-1045	lohānāṃ māraṇaṃ vakṣye arivargaṃ yathā kramāt |	lohānām māraṇam vakṣye arivargam yathā kramāt 
SA_MB_kakacandesvarimataHK-1046	32b)	Ro
SA_MB_kakacandesvarimataHK-1047	tālenavaṃgaṃdaradena tīkṣṇaṃ nāgenaniṣkaṃśilayā ca nāgaṃ |	tālena vaṃgaṃdaradena tīkṣṇam nāgena niṣkam śilayā ca nāgam 
SA_MB_kakacandesvarimataHK-1048	gaṃdhena kāṃsyaṃ tenaiva śulvaṃ tāraṃ ca mākṣīkarasena hanyāt ||	gaṃdhena kāṃsyam tena eva śulvam tāram ca mākṣīka rasena hanyāt 
SA_MB_kakacandesvarimataHK-1049	iti māraṇa arivargaḥ ||	iti māraṇa arivargaḥ 
SA_MB_kakacandesvarimataHK-1050	harapaṃgarūḍo samarasī kṛtaṃ sṛṣṭaṃ pariplutaṃ pītagaṃdhasyaiva	samarasī kṛtam sṛṣṭam pariplutam pītagaṃdhasya eva 
SA_MB_kakacandesvarimataHK-1051	ṣaḍguṇaṃ | evaṃ trimāritaṃ jāritameva bhavati caṃdrārkavedhī mahārasaḥ || ṭīkā	ṣaḍguṇam evam tri māritam jāritam eva bhavati candrārka vedhī mahārasaḥ ṭīkā 
SA_MB_kakacandesvarimataHK-1052	|| hareti pāradaṃ pannageti nāgaṃ garuḍeti hemavījaṃ sameti samabhāgāni gṛhya	hara iti pāradam pannaga iti nāgam garuḍa iti hema vījam sama iti sama bhāgāni gṛhya 
SA_MB_kakacandesvarimataHK-1053	samarasī kriyate | tailāśāyāṃ mṛdāgninā | sārakāṃsyapātreṇa ca tailena hi	sama rasī kriyate taila āśāyām mṛdā agninā sāra kāṃsya pātreṇa ca tailena hi 
SA_MB_kakacandesvarimataHK-1054	dhāryatāṃ | cārayati yāvat sāvaśiṣṭhaṃtriṇam jārayet ||	cārayati yāvat sa avaśiṣṭhaṃtriṇam jārayet 
SA_MB_kakacandesvarimataHK-1055	33a)	Ro
SA_MB_kakacandesvarimataHK-1056	pūrvoktamāraṇavidhiḥ || caṃdrārkavedhī mahārasaḥ ||	               
SA_MB_kakacandesvarimataHK-1057	trinetrogaruḍārūḍho mṛdukāṃtarakasveta |	        
SA_MB_kakacandesvarimataHK-1058	gaṃdhakasamāsakharāṃcayonyāṃlakṣaṃ ca gamyate ||	ca gamyate 
SA_MB_kakacandesvarimataHK-1059	ṭīkā ||	ṭīkā 
SA_MB_kakacandesvarimataHK-1060	trinetretirasaṃgarūḍeti hemavījaṃ mṛdukāṃtaṃ mṛdukāṃtaṃ	trinetrā iti rasaṃgarūḍā iti hema vījam mṛdukāṃtam mṛdukāṃtam 
SA_MB_kakacandesvarimataHK-1061	mṛduḥsīsakaṃ | kāṃākāṃtipatreṇa etānvitau kariṣaṣaṣāgni svedopari	mṛduḥ sīsakam etad anvitau sveda upari 
SA_MB_kakacandesvarimataHK-1062	strīpuṣpebhāvitagaṃdhakamākṣikayāścūrṇaṃ | pratīvāpadeyaṃ dhārayet |	strī puṣpe bhāvita gaṃdhaka mākṣikayāḥ cūrṇam pratīvāpa deyam dhārayet 
SA_MB_kakacandesvarimataHK-1063	yāvadaśāvaśiṣṭaṃ triguṇaṃ jārayet pūrvoktamāraṇavidhiḥ ||	yāvat aśa avaśiṣṭam triguṇam jārayet pūrva ukta māraṇa vidhiḥ 
SA_MB_kakacandesvarimataHK-1064	taṃmārayettrivāraṃ tu śulvavidhikaraṃdhātuśodhanaṃ vakṣye gaṃdhakakaraṃ	tam mārayet tri vāram tu śulva vidhi karam dhātu śodhanam vakṣye gaṃdhaka karam 
SA_MB_kakacandesvarimataHK-1065	ca | eraṃḍa araṇītailena drāvayitvā mṛdāpitāṃ ||	ca eraṃḍa araṇī tailena drāvayitvā mṛdāpitām 
SA_MB_kakacandesvarimataHK-1066	33b)	Ro
SA_MB_kakacandesvarimataHK-1067	dhattūrakaraseniṣaktāyāṃ tataśchāgakṣīreṇa dinamekaṃ | mṛdusvedaṃ tataḥ	dhattūraka rase niṣaktāyām tatas chāga kṣīreṇa dinam ekam mṛdu svedam tatas 
SA_MB_kakacandesvarimataHK-1068	kuryāt | abhayāṃ | rāśnāsa tu madhyā tu miśreṇa saptavāraṃ bhāvayet || iti	kuryāt abhayām tu miśreṇa sapta vāram bhāvayet iti 
SA_MB_kakacandesvarimataHK-1069	gaṃdhakaśuddhiḥ || daradaṃgopittena pakvatailaṃ mahiṣītakreṇadolā |	gaṃdhaka śuddhiḥ daradaṃgo pittena pakva tailam mahiṣī takreṇa dolā 
SA_MB_kakacandesvarimataHK-1070	svedodinatrayaṃ tataḥ | poṭalikāyāṃ vījapūrake nikṣipya maṃdāgnināpacet |	                                                           
SA_MB_kakacandesvarimataHK-1071	vāratrayaṃ ca pañcāt śikhipittena palāśarasena ca || iti daraśuddhiḥ || śilāyā	vāra trayam ca pañcāt śikhi pittena palāśa rasena ca iti dara śuddhiḥ śilāyāḥ 
SA_MB_kakacandesvarimataHK-1072	gopittena vījapūraka pakvacaṃvahuśaḥ | vibhītakaraseṇāpi miśreṇa tāpayitvā | iti	go pittena vibhītaka raseṇa api miśreṇa tāpayitvā iti 
SA_MB_kakacandesvarimataHK-1073	manaḥśilāśuddhiḥ ||	       
SA_MB_kakacandesvarimataHK-1074	34a)	Ro
SA_MB_kakacandesvarimataHK-1075	haritālaṃdhātrī rasena pariplutaṃ arkapatraṃ mṛduliptaṃ puṭatrayaṃ	              
SA_MB_kakacandesvarimataHK-1076	puṭayākatrayaṃ kuryāt | bhūyobhūyośuṣkabhāvanāṃ kṛtvā vatsamūtreṇa |	puṭayāka trayam kuryāt bhūyas bhūyas śuṣka bhāvanām kṛtvā vatsa mūtreṇa 
SA_MB_kakacandesvarimataHK-1077	peṣayitvā ca tāṃvūlapatra rasabhāvanāpunaḥ puṭapākaṃ ca tadvat | kūṣmāṃḍa	peṣayitvā ca tāṃvūla patra rasa bhāvanā punar puṭapākam ca tadvat kūṣmāṃḍa 
SA_MB_kakacandesvarimataHK-1078	rasenāpidolikāyāṃ ca vaddhvā taṇḍulabhedaṃ kṛtvā pacedvahuśaḥ | iti tālaḥ |	rasena apidolikāyām ca vaddhvā taṇḍulabhedam kṛtvā pacet vahuśas iti tālaḥ 
SA_MB_kakacandesvarimataHK-1079	mākṣikaṃ āranālena gavāṃ mūtreṇa ajāsūtreṇa tu punaḥ | kramaśaḥ kvāthayet |	mākṣikam āranālena gavām mūtreṇa ajā sūtreṇa tu punar kramaśas kvāthayet 
SA_MB_kakacandesvarimataHK-1080	kulatthena āranāṃledvau ca kasauṃjīrasabhāvayitvā rājakośātakī rasena	kulatthena ca kasauṃjī rasa bhāvayitvā rājakośātakī rasena 
SA_MB_kakacandesvarimataHK-1081	kūṣmāṃḍagaṇayārirasena yācayet || iti kāṃsya śuddhiḥ || taṃḍulatoyaṃ kṛtvā	kūṣmāṃḍa gaṇayāri rasena yācayet iti kāṃsya śuddhiḥ taṃḍula toyam kṛtvā 
SA_MB_kakacandesvarimataHK-1082	ca eraṃḍatailena pācayet ||	ca eraṃḍa tailena pācayet 
SA_MB_kakacandesvarimataHK-1083	34b)	Ro
SA_MB_kakacandesvarimataHK-1084	gairikaśuddhiḥ ||	gairika śuddhiḥ 
SA_MB_kakacandesvarimataHK-1085	iti kākacaṃḍeśvarīmate sarva ||	iti kākacaṃḍeśvarīmate sarva 
SA_MB_kakacandesvarimataHK-1086	varṇoktaraṣādīnāṃ ca vakṣyeyā ca hitāgamaḥ |	varṇa ukta raṣa ādīnām ca vakṣyeyā ca hita āgamaḥ 
SA_MB_kakacandesvarimataHK-1087	vṛddhānāṃ puṭakvaṃcakanīyasañca triguṇakaṃ ||	vṛddhānām puṭa kvaṃcakanīyasam ca triguṇakam 
SA_MB_kakacandesvarimataHK-1088	kalkamādāyatāraṃtāramādāyakāṃcanaṃ |	kalkam ādāya tāram tāram ādāya kāñcanam 
SA_MB_kakacandesvarimataHK-1089	ṭīkā ||	ṭīkā 
SA_MB_kakacandesvarimataHK-1090	yāmitipāradaṃhimiti hiṃgulaṃ tāmititāthaṃ |	yām iti pāradam him iti hiṃgulam tām iti tātham 
SA_MB_kakacandesvarimataHK-1091	mākṣīkāṃgamiti gaṃdhakaṃ | ma iti manaḥ śilākramavṛddhyā tu gṛhyaṃte	mākṣīka aṃgam iti gaṃdhakam maḥ iti manaḥ śilā krama vṛddhyā tu gṛhyaṃte 
SA_MB_kakacandesvarimataHK-1092	vṛddhiriti vījapūrakarasena madyanavet | jaṃvīrakarasena vā kanīyasetu	vṛddhiḥ iti vījapūraka rasena jaṃvīraka rasena vā 
SA_MB_kakacandesvarimataHK-1093	śuddharāḥ dusaktapatrakṛtvā kalkenalepya puṭena cūrṇaṃ syāt tataḥ |	śuddha rāḥ kalkena lepya puṭena cūrṇam syāt tatas 
SA_MB_kakacandesvarimataHK-1094	mṛducūrṇa samaragoghṛtenamodakaṃ tārasya triguṇaṃ nivahet tāramādāya	mṛdu cūrṇa samarago ghṛtena modakam tārasya triguṇam nivahet tāram ādāya 
SA_MB_kakacandesvarimataHK-1095	kāṃcanam ||	kāṃcanam 
SA_MB_kakacandesvarimataHK-1096	35a)	Ro
SA_MB_kakacandesvarimataHK-1097	nirvāhiṇa kālena tāradaśāṃśena hemavījaṃ dātavyaṃ jñātvā melakaṃ |	nirvāhiṇa kālena tāra daśa aṃśena hema vījam dātavyam jñātvā melakam 
SA_MB_kakacandesvarimataHK-1098	śulvamapi pakvaṃ tena samaṃ samaṃ nivihetu | śulvacūrṇaṃ goghṛtena	śulvam api pakvam tena samam samam śulva cūrṇam go ghṛtena 
SA_MB_kakacandesvarimataHK-1099	moditaṃdukarṣa catuṣṭhāyāṃ tārasametinirūḍhaṃ bhavati | tadardhena	catuṣṭhāyām bhavati tad ardhena 
SA_MB_kakacandesvarimataHK-1100	kalyāṇakaṃ śulvamiti pūrvoktakalkaṃ na puṭitaṃ bhavati |	kalyāṇakam śulvam iti pūrva ukta kalkam na puṭitam bhavati 
SA_MB_kakacandesvarimataHK-1101	śulvacūrṇeṅgoghṛtena moditaṃ taccūrṇaṃ hemena dadyāt | triṃpalaṃ	              dadyāt   
SA_MB_kakacandesvarimataHK-1102	triphalaṣadyalaṃ vā kaṭi pramāṇaṃ vāhayet | varṇotkarṣa catuṣṭayaṃ bhavati |	vā kaṭi pramāṇam vāhayet varṇa utkarṣa catuṣṭayam bhavati 
SA_MB_kakacandesvarimataHK-1103	athavā triguṇanirvāhayet tadeva mṛtāśulva pūrvokta cūrṇīkṛtaṃ daradaṃ na	athavā triguṇa nirvāhayet tat eva cūrṇīkṛtam daradam na 
SA_MB_kakacandesvarimataHK-1104	35b)	Ro
SA_MB_kakacandesvarimataHK-1105	samaṃ goghṛtena moditaṃ tadardhena kalyāṇakaṃ | ṭīkā || rasabhāga 1	samam go ghṛtena moditam tad ardhena kalyāṇakam ṭīkā rasabhāga 
SA_MB_kakacandesvarimataHK-1106	tālakabhāga 1 ekatramarditapeṭhakairasasāṭhidina 3 paścāttugolakaṃ kṛtvā	tālaka bhāgaḥ kṛtvā 
SA_MB_kakacandesvarimataHK-1107	haṃḍikā madhye sthāpya upari avajre vadupiṃḍa datvā punaḥ | sarāvayitvā	haṃḍikā madhye sthāpya upari avajre punar 
SA_MB_kakacandesvarimataHK-1108	vālukāyābharitavyā upari adhomukhaṃlipta urdhvadvāreṇa nīraṃ datvā punaḥ	upari urdhva dvāreṇa nīram da tvā punar 
SA_MB_kakacandesvarimataHK-1109	sarāvamudrikā adho agniṃ prajvālayet | prahara 3 svāṃgaśītalaṃ grāhyaṃ	sarāva mudrikā adhas agnim prajvālayet prahara svāṃgaśītalam grāhyam 
SA_MB_kakacandesvarimataHK-1110	uparāṃti kāṃsyapātraṃ tataḥ | kṛtva tatarasaṃdoṣasthāne dātavyaṃ ratā 4 || iti	kāṃsya pātram tatas dātavyam iti 
SA_MB_kakacandesvarimataHK-1111	rasasārottare dalādhikāraḥ || pārābhāga 1 hiṃgulabhāga 2	           
SA_MB_kakacandesvarimataHK-1112	36a)	Ro
SA_MB_kakacandesvarimataHK-1113	svarṇamāṣī bhāga 3 gaṃdhakabhāga 4 manaḥ śilabhāga 5 dhattūrakarasemardayet	                             
SA_MB_kakacandesvarimataHK-1114	lākṣārasena kadutora īrasena yāvaddi tatrayaṃ śulvaśuddhabhāga 15	lākṣā rasena kaduta uraḥ ī rasena 
SA_MB_kakacandesvarimataHK-1115	kaṃṭakavedhīpatra kuryāttena lepayat | punaḥ kiṃcidgaṃdhakaṃ datvā mardayet |	kuryāt tena lepayat punar kiṃcid gaṃdhakam da tvā mardayet 
SA_MB_kakacandesvarimataHK-1116	pādāṃśena nīlakāṃ ca deyaṃ | ṭaṃkaṇaṃ deyaṃ śuddhaśulvabhāga 3	pāda aṃśena nīlakām ca deyam ṭaṃkaṇam deyam śuddha śulva bhāga 
SA_MB_kakacandesvarimataHK-1117	śuddhatārabhāga 1 taṃcūrṇadhāryemūsiphirā vai khāgaśītalaṃ paśyat | evaṃ	vai khāga śītalam paśyat evam 
SA_MB_kakacandesvarimataHK-1118	vidhi trivāraṃ samanirvāhayet | prakāśamūṣāyāṃ yāvatārāvaśiṣṭāni vā harini	                      
SA_MB_kakacandesvarimataHK-1119	kālaitāradaśāṃśena ādivījaṃ dātavyaṃ tāraṃ tārakaraṇavidhiḥ ||	                    
SA_MB_kakacandesvarimataHK-1120	36b)	Ro
SA_MB_kakacandesvarimataHK-1121	rajoṣṭha karṇikā syāt śuddhaśulva samanvitam | sarvadhātu māraṇam | vyūḍhaṃ	rajoṣṭha karṇikā syāt śuddhaśulva samanvitam sarvadhātu māraṇam vyūḍham 
SA_MB_kakacandesvarimataHK-1122	pādāṃśena nimitaṃ daśavarṇikāsyāt | hematāraṃ kūṣmāṃḍarasena	pāda aṃśena nimitam daśa varṇikā asyāt hematāram kūṣmāṃḍa rasena 
SA_MB_kakacandesvarimataHK-1123	arkakṣīreṇapeṣayet | lepayedvaṃgapatrāṇi puṭena mriyate | acaṃmuṃḍī bhedarasaṃ	arka kṣīreṇa peṣayet lepayet vaṃga patrāṇi puṭena mriyate acaṃmuṃḍī bheda rasam 
SA_MB_kakacandesvarimataHK-1124	caiva śilāyāṃ peṣayena tu |	ca eva śilāyām tu 
SA_MB_kakacandesvarimataHK-1125	lepayennāgapatrāṇi puṭaṃ āyasanniyeta |	lepayet nāga patrāṇi puṭam 
SA_MB_kakacandesvarimataHK-1126	tāpyakaṃgaṃdhakaṃ caiva ajākṣīreṇa peṣayet ||	tāpyakam gaṃdhakam ca eva ajā kṣīreṇa peṣayet 
SA_MB_kakacandesvarimataHK-1127	lepayet śulvapatrāṇi mriyate tāmramuttamaṃ |	lepayet śulva patrāṇi mriyate tāmram uttamam 
SA_MB_kakacandesvarimataHK-1128	tāthaṃ gaṃdhakadaradaṃ arkakṣīreṇa pīṣayet ||	gaṃdhaka daradam arka kṣīreṇa pīṣayet 
SA_MB_kakacandesvarimataHK-1129	lepayettārapatrāṇipuṭaṃ jāyate valaṃ |	lepayet tāra patrāṇi puṭam jāyate 
SA_MB_kakacandesvarimataHK-1130	tāpyavalaṃvasādaraṃ kāṃcanī kvāthamardayet ||	            
SA_MB_kakacandesvarimataHK-1131	37a)	Ro
SA_MB_kakacandesvarimataHK-1132	lepayeddhemapatrāṇipuṭaṃ mriyate kṣaṇāt |	lepayet hema patra āṇi puṭam mriyate kṣaṇāt 
SA_MB_kakacandesvarimataHK-1133	caṃdraṃ caṃdrakalāpetaṃ ravibhāgaṃ raviryathā ||	caṃdram caṃdra kalā apetam ravi bhāgam raviḥ yathā 
SA_MB_kakacandesvarimataHK-1134	kanakasyadvayaṃbhāgaṃ caṃdrārka hematārayoḥ |	kanakasya dvayam bhāgam caṃdrārka hema tārayoḥ 
SA_MB_kakacandesvarimataHK-1135	daradaṃgaṃdhakaṃtāpyaṃ śilāyārasasaṃyutaṃ ||	daradam gaṃdhakam tāpyam śilāyāḥ rasa saṃyutam 
SA_MB_kakacandesvarimataHK-1136	rasakasya dvayobhāgā khalve kṛtvā tu mardayet |	rasakasya khalve kṛtvā tu mardayet 
SA_MB_kakacandesvarimataHK-1137	tridinaṃkā ca madhyā tu raviśaśilepitaṃ dalaṃ ||	tri dinaṃkā ca madhyā tu ravi śaśi lepitam dalam 
SA_MB_kakacandesvarimataHK-1138	maṃdānalena pakvaṃ tu ślvena kalkaṃ bhavet |	maṃda analena pakvam tu ślvena kalkam bhavet 
SA_MB_kakacandesvarimataHK-1139	bhojanaṃ vartikānāṃ tu ye vāpi na tadutthitāḥ ||	bhojanam vartikānām tu ye vā api na tad utthitāḥ 
SA_MB_kakacandesvarimataHK-1140	prathamaṃ vittaye bhakti grāsamukti rasāyaṇaṃ |	prathamam vittaye bhakti grāsa mukti rasāyaṇam 
SA_MB_kakacandesvarimataHK-1141	bhuktimukti na jānāti pāpiṣṭhāmohitā tanau ||	bhukti mukti na jānāti pāpiṣṭhā mohitā tanau 
SA_MB_kakacandesvarimataHK-1142	lohānāṃ śodhanaṃ vakṣye sarvadoṣa vināśanaṃ |	lohānām śodhanam vakṣye sarva doṣa vināśanam 
SA_MB_kakacandesvarimataHK-1143	yena śodhita mātreṇa nirmalatvaṃ prajāyate ||	yena śodhita mātreṇa nirmala tvam prajāyate 
SA_MB_kakacandesvarimataHK-1144	37b)	Ro
SA_MB_kakacandesvarimataHK-1145	gāḍhīchatrāṃpataṃgīgrāsīḍha ca durmelakaḥ |	ca durmelakaḥ 
SA_MB_kakacandesvarimataHK-1146	aśuddhe sarvalohāni ṣaḍbhirdoṣaiḥ praṇaśyati ||	aśuddhe sarva lohāni ṣaḍbhiḥ doṣaiḥ praṇaśyati 
SA_MB_kakacandesvarimataHK-1147	athā ca śuddhaṃ bhūmikṣetraṃ dhānyaṃ caiva pradohati |	athā ca śuddham bhūmi kṣetram dhānyam ca eva pradohati 
SA_MB_kakacandesvarimataHK-1148	tathā ca śuddhalohaṃ ca dravyañcaiva prakāśayet ||	tathā ca śuddha loham ca dravyam ca eva prakāśayet 
SA_MB_kakacandesvarimataHK-1149	prathamaṃ lohaśuddhaṃ kṣetraṃ caiva dvitīyakaṃ |	prathamam loha śuddham kṣetram ca eva dvitīyakam 
SA_MB_kakacandesvarimataHK-1150	tṛtīyaṃ rasavedhaṃ ca dravyaśuddhaṃ caturthakaṃ ||	tṛtīyam rasa vedham ca dravya śuddham caturthakam 
SA_MB_kakacandesvarimataHK-1151	ādivījottaraṃ kuryāt madhye ca rasavedhakaṃ |	ādi vīja uttaram kuryāt madhye ca rasa vedhakam 
SA_MB_kakacandesvarimataHK-1152	acarasavedhakaṃ ||	        
SA_MB_kakacandesvarimataHK-1153	aṃte melāpakaṃcaṃvayojānāti sarvartikaḥ |	aṃte melāpakam caṃvayaḥ jānāti sarvartikaḥ 
SA_MB_kakacandesvarimataHK-1154	haragaurī melāpaṃca dṛṣṭvā pāpaṃ praṇaśyati ||	haragaurī melāpam ca dṛṣṭvā pāpam praṇaśyati 
SA_MB_kakacandesvarimataHK-1155	puṇyahīnā na paśyaṃti iti pāradamelanaṃ ||	puṇya hīnāḥ na paśyaṃti iti pārada melanam 
SA_MB_kakacandesvarimataHK-1156	kiṃgajaisturagaiḥ strībhiḥ pṛthivyā dhanasaṃcayaiḥ |	kiṃgajaiḥ turagaiḥ strībhiḥ pṛthivyāḥ dhana saṃcayaiḥ 
SA_MB_kakacandesvarimataHK-1157	38a)	Ro
SA_MB_kakacandesvarimataHK-1158	tadāpi bhogamicchaṃti satśarīramavasyati ||	tadā api bhogam icchanti sat śarīram avasyati 
SA_MB_kakacandesvarimataHK-1159	mānuṣaṃ janma saṃprāpya sarvajaṃtuṣudurlabhaṃ |	mānuṣam janma saṃprāpya sarva jaṃtuṣu durlabham 
SA_MB_kakacandesvarimataHK-1160	ātmānaṃ mokṣitaṃte ca yena sādhyaṃ tu pāradaṃ ||	ātmānam mokṣitam te ca yena sādhyam tu pāradam 
SA_MB_kakacandesvarimataHK-1161	guruṃ devarasaṃ caiva dūṣayaṃti durātmanā |	gurum deva rasam ca eva dūṣayanti durātmanā 
SA_MB_kakacandesvarimataHK-1162	patitā narake ghore na teṣāṃ punarāgamaḥ ||	patitāḥ narake ghore na teṣām punarāgamaḥ 
SA_MB_kakacandesvarimataHK-1163	gagane rāśisaṃkhyā tu śatapaṃca tathā bhavet |	gagane rāśi saṃkhyā tu śata paṃca tathā bhavet 
SA_MB_kakacandesvarimataHK-1164	abhraka parīkṣā ||	abhraka parīkṣā 
SA_MB_kakacandesvarimataHK-1165	śvetaṃ pītaṃ tathāraktaṃ kṛṣṇābhraṃ ca tathā paraṃ |	śvetam pītam tathā āraktam kṛṣṇa abhram ca tathā param 
SA_MB_kakacandesvarimataHK-1166	ekaikasya tu rāgasya dviguṇaṃ caiva kalpayet ||	ekaikasya tu rāgasya dviguṇam ca eva kalpayet 
SA_MB_kakacandesvarimataHK-1167	jānāti sādhakānāṃ tu abhrakaṃ tu caturvidham |	jānāti sādhakānām tu abhrakam tu caturvidham 
SA_MB_kakacandesvarimataHK-1168	śvetā ca brāhmaṇā jñeyā raktavarṇāśca kṣatriyāḥ ||	śvetā ca brāhmaṇāḥ jñeyāḥ rakta varṇāḥ ca kṣatriyāḥ 
SA_MB_kakacandesvarimataHK-1169	pītā vaiśyāḥ samākhyātāḥ kṛṣṇaṃ śūdramudāhṛtaṃ |	pītāḥ vaiśyāḥ samākhyātāḥ kṛṣṇam śūdram udāhṛtam 
SA_MB_kakacandesvarimataHK-1170	38b)	Ro
SA_MB_kakacandesvarimataHK-1171	ekaikasya ca varṇasya jātiścaiva caturvidhā ||	ekaikasya ca varṇasya jātiḥ ca eva caturvidhā 
SA_MB_kakacandesvarimataHK-1172	pinākīdardurī vajrīrasendraṃ ca caturthakaṃ |	             
SA_MB_kakacandesvarimataHK-1173	parīkṣāyāṃ prakurvīta tadākarma samārabhet ||	parīkṣāyām prakurvīta tadā karma samārabhet 
SA_MB_kakacandesvarimataHK-1174	kṣīramadhye tu saṃsthāpya pacayenmṛduvahninā |	kṣīra madhye tu saṃsthāpya pacayet mṛdu vahninā 
SA_MB_kakacandesvarimataHK-1175	tāvacca pācayet prājño yāvat kṣīraṃ pramucyate ||	tāvat ca pācayet prājñaḥ yāvat kṣīram pramucyate 
SA_MB_kakacandesvarimataHK-1176	aṃdhamūṣā tataḥ sthāpya dhāmayeta punaḥ punaḥ |	aṃdhamūṣā tatas sthāpya dhāmayeta punar punar 
SA_MB_kakacandesvarimataHK-1177	mūṣāyāṃ sāṃdulegrāhyaṃ kṣīramadhye tu cāṃbhasi ||	mūṣāyām sāṃdule grāhyam kṣīra madhye tu ca aṃbhasi 
SA_MB_kakacandesvarimataHK-1178	parīkṣāṃ kārayettatra abhrakasya mahātmanaḥ |	parīkṣām kārayet tatra abhrakasya mahātmanaḥ 
SA_MB_kakacandesvarimataHK-1179	sphuṭayettaṭaṭāśabdaṃ tvacāsarvatra jāyate ||	sphuṭayet taṭaṭā śabdam tvacā sarvatra jāyate 
SA_MB_kakacandesvarimataHK-1180	raseṃdrī ca vijānīyādra sa karmaṇi cottamaṃ |	raseṃdrī ca karmaṇi ca uttamam 
SA_MB_kakacandesvarimataHK-1181	saṃkodhavardhate cāpi pinākīmiti vidyate ||	ca api pinākīm iti vidyate 
SA_MB_kakacandesvarimataHK-1182	39a)	Ro
SA_MB_kakacandesvarimataHK-1183	taptaṃ dardurabhedyaṃte dardurīti nigadyate |	taptam dardura bhedyaṃte dardurī iti nigadyate 
SA_MB_kakacandesvarimataHK-1184	vajraṃvajra samākāraṃ vajrī ca iti mucyate ||	vajram vajra sama ākāram vajrī ca iti mucyate 
SA_MB_kakacandesvarimataHK-1185	hrasvoti dīrghamāyāti pinākīpyaṃkakarmaṇi |	dīrgham āyāti 
SA_MB_kakacandesvarimataHK-1186	dardraṣṭo sthūlamāyāti dardurī samabhidyate ||	dardraṣṭaḥ sthūlam āyāti dardurī samabhidyate 
SA_MB_kakacandesvarimataHK-1187	vajrīvajrakṛtā devi vajradehastu jāyate |	vajrī vajra kṛtā devi vajra dehaḥ tu jāyate 
SA_MB_kakacandesvarimataHK-1188	yathābhraṃca tathā khyātaṃ caturvidhaṃ vyavasthitaṃ ||	yathā abhram ca tathā khyātam caturvidham vyavasthitam 
SA_MB_kakacandesvarimataHK-1189	īśvara uvāca ||	īśvaraḥ uvāca 
SA_MB_kakacandesvarimataHK-1190	ācāryeṇa prasaṃgaṃ na yathā bhakti dṛḍhistathā |	ācāryeṇa prasaṃgam na yathā dṛḍhiḥ tathā 
SA_MB_kakacandesvarimataHK-1191	vaṃcayeddārūṇaṃ kālaṃ gurupāda prasādataḥ ||	vaṃcayet dārūṇam kālam guru pāda prasādataḥ 
SA_MB_kakacandesvarimataHK-1192	mukhena udakaṃ kṣipyaśītollaṃ tatra lakṣaṇaṃ |	mukhena udakam kṣipya śīta ullam tatra lakṣaṇam 
SA_MB_kakacandesvarimataHK-1193	ullena jīvatāṃ devi śītena maraṇamādiśet ||	ullena jīvatām devi śītena maraṇam ādiśet 
SA_MB_kakacandesvarimataHK-1194	yathā śītagataṃvāri ṣaṇmāsā mṛti jāyate |	yathā śīta gatam vāri ṣaṣ māsāḥ jāyate 
SA_MB_kakacandesvarimataHK-1195	39b)	Ro
SA_MB_kakacandesvarimataHK-1196	pranāśaḥ sarvalokeṣu śṛṇukarma varānane ||	pranāśaḥ sarva lokeṣu varānane 
SA_MB_kakacandesvarimataHK-1197	udyānaṃ calite yena ūrdhvaṃ vāuḥ pravartate |	udyānam calite yena ūrdhvam vāuḥ pravartate 
SA_MB_kakacandesvarimataHK-1198	eko mṛtyupathaṃde gṛhṇāti maraṇāṃ tathāṃ ||	ekaḥ gṛhṇāti 
SA_MB_kakacandesvarimataHK-1199	evaṃ cihne samutpanne kālaṃ ca bhavati dhruvam |	evam cihne samutpanne kālam ca bhavati dhruvam 
SA_MB_kakacandesvarimataHK-1200	nagnaṃ kṛvā varārohe yena mṛtyuvaśaṃgatāḥ ||	nagnam varārohe yena mṛtyu vaśaṃgatāḥ 
SA_MB_kakacandesvarimataHK-1201	idaṃ kṛtvā tu deveśi mānuṣāḥ kālapīḍitāḥ |	idam kṛtvā tu deveśi mānuṣāḥ kāla pīḍitāḥ 
SA_MB_kakacandesvarimataHK-1202	kadalīpatra saṃsthāpyaniṣkaṃ tatra nidhāpayet ||	           
SA_MB_kakacandesvarimataHK-1203	retaṃ patati deveśa kadalī patracopari |	retam patati deveśa kadalī 
SA_MB_kakacandesvarimataHK-1204	taṃreta madhunāmiśraṃ gavyasūrpisamanvitam ||	madhunā amiśram gavya sūrpi samanvitam 
SA_MB_kakacandesvarimataHK-1205	nasyaṃ dadyādvarārohe yena mṛtyuvaśaṃgatāḥ |	nasyam dadyāt varārohe yena mṛtyu vaśaṃgatāḥ 
SA_MB_kakacandesvarimataHK-1206	phūkayitvā varārohe ghaṭikādvayagocare ||	phūkayitvā varārohe ghaṭikā dvaya gocare 
SA_MB_kakacandesvarimataHK-1207	40a)	Ro
SA_MB_kakacandesvarimataHK-1208	punarjīveta deveśa yogato yamaṃ maṃdire |	punar jīveta deveśa yogataḥ yamam maṃdire 
SA_MB_kakacandesvarimataHK-1209	yatra deśegatā vāyuḥ saṃpuṭenasya dāpayet ||	yatra deśe gatā vāyuḥ saṃpuṭena asya dāpayet 
SA_MB_kakacandesvarimataHK-1210	mṛtyu saṃjīvano nāmalabhedvari prasādataḥ |	mṛtyu saṃjīvanaḥ nāma labhet vari prasādataḥ 
SA_MB_kakacandesvarimataHK-1211	brahmaviṣṇu hareścaiva mṛtyuṃ saṃjīvanī kṛtā ||	brahma viṣṇu hareḥ ca eva mṛtyum saṃjīvanī kṛtā 
SA_MB_kakacandesvarimataHK-1212	eṣabhedavibhedenavayetkālamāgataṃ |	eṣa bheda vibhedena vayet kālam āgatam 
SA_MB_kakacandesvarimataHK-1213	parābhiṣṭhe ca lobhiṣṭhe pāpākarmaṇi dūṣite ||	parābhiṣṭhe ca lobhiṣṭhe pāpa akarmaṇi dūṣite 
SA_MB_kakacandesvarimataHK-1214	vittamātmya prasṛṣṭebhyāṃ akathyaṃ vīravaṃdite |	vittamātmya prasṛṣṭebhyām akathyam vīra vaṃdite 
SA_MB_kakacandesvarimataHK-1215	karoti bhakti saṃyuktaḥ adhvātaṃ śuddhabhāṣitaṃ ||	karoti bhakti saṃyuktaḥ adhvātam śuddhabhāṣitam 
SA_MB_kakacandesvarimataHK-1216	dadyātu cottamāvidyāśiṣ.yaimāyā vivarjitaḥ |	dadyātu ca uttamā vidyā śiṣyaiḥ aimāyāḥ vivarjitaḥ 
SA_MB_kakacandesvarimataHK-1217	sāmānyaṃ sarvalokasya grāsaṃ chādanameva ca ||	sāmānyam sarva lokasya grāsam chādanam eva ca 
SA_MB_kakacandesvarimataHK-1218	acareṇa labhetsiddhi brahmavidyādikaṃ kramāt |	acareṇa labhet siddhi brahma vidyā ādikam kramāt 
SA_MB_kakacandesvarimataHK-1219	40b)	Ro
SA_MB_kakacandesvarimataHK-1220	ācārye pūjite devi atha vittānusāraṇaṃ ||	ācārye pūjite devi atha vitta anusāraṇam 
SA_MB_kakacandesvarimataHK-1221	kathayāmi varārohe kalpaṃ amarasuṃdarī |	kathayāmi varārohe kalpam amarasuṃdarī 
SA_MB_kakacandesvarimataHK-1222	yena amaramāyāti yoginaśca varānane ||	yena amaram āyāti yoginaḥ ca varānane 
SA_MB_kakacandesvarimataHK-1223	vījasya paṃcabhāgāni ghṛtabhāgatrayaṃ bhavet |	        bhavet 
SA_MB_kakacandesvarimataHK-1224	madhu dviguṇabhāgena ālodyo viṣṇunā saha ||	madhu dviguṇa bhāgena ālodyaḥ viṣṇunā saha 
SA_MB_kakacandesvarimataHK-1225	nasyaṃ dadyādvarārohe vāmena surasundari |	nasyam dadyāt varārohe vāmena surasundari 
SA_MB_kakacandesvarimataHK-1226	yo gṛhṇāti uṣākāle māsamekaṃ tu nasyakaṃ ||	yaḥ gṛhṇāti uṣā kāle māsam ekam tu nasyakam 
SA_MB_kakacandesvarimataHK-1227	vāme siddhirbhavettasya kalpena surasundari |	vāme siddhiḥ bhavet tasya kalpena surasundari 
SA_MB_kakacandesvarimataHK-1228	māsadvayaṃ varārohaṃ nasyaṃ dadyāntu yoginaḥ ||	        dadyāntu   
SA_MB_kakacandesvarimataHK-1229	udgārayati śāstrāṇi svayameva kavirbhavet |	udgārayati śāstrāṇi svayam eva kaviḥ bhavet 
SA_MB_kakacandesvarimataHK-1230	haṃtirogamaśeṣeṇa yogaviṃsvasureśvari ||	haṃti rogam aśeṣeṇa 
SA_MB_kakacandesvarimataHK-1231	41a)	Ro
SA_MB_kakacandesvarimataHK-1232	saptamāsasya saṃprāptenasyaṃ caiva tu yogināṃ |	sapta māsasya ca eva tu yoginām 
SA_MB_kakacandesvarimataHK-1233	adṛṣṭha yoginaścaiva tena sāhāṃ pravartate ||	adṛṣṭha yoginaḥ ca eva tena sāhām pravartate 
SA_MB_kakacandesvarimataHK-1234	dharāmāyā prayogena cāmaratvamavāpnuyāt |	dharāmāyā prayogena ca amara tvam avāpnuyāt 
SA_MB_kakacandesvarimataHK-1235	kuṃḍagolaka saṃyuktaṃ śaktimeva varānane ||	kuṃḍa golaka saṃyuktam śaktim eva varānane 
SA_MB_kakacandesvarimataHK-1236	tena saṃmardayedyatnānnasyaṃ dadyādvarānane |	tena saṃmardayet yatnāt nasyam dadyāt varānane 
SA_MB_kakacandesvarimataHK-1237	saptarātra prayogena amaratvaṃ jāyate dhruvaṃ ||	saptarātra prayogena amara tvam jāyate dhruvam 
SA_MB_kakacandesvarimataHK-1238	oṃ namo gaṇapataye ||	om namaḥ gaṇapataye 
SA_MB_kakacandesvarimataHK-1239	athātaḥ saṃpravakṣyāmi karpūrakaraṇottamaṃ |	atha atas saṃpravakṣyāmi karpūra karaṇa uttamam 
SA_MB_kakacandesvarimataHK-1240	raṃbhāyā puṣpasaṃgrāhya cāgrabhāgaṃ tu chedayet ||	raṃbhāyāḥ ca agra bhāgam tu chedayet 
SA_MB_kakacandesvarimataHK-1241	raṃbhā puṣparasaṃ grāhyaṃ daṃḍamātraṃ tu dhārayet |	raṃbhā puṣpa rasam grāhyam daṃḍa mātram tu dhārayet 
SA_MB_kakacandesvarimataHK-1242	tasyāmpravodevi viṣṇupāṇikamuttamam ||	viṣṇu pāṇikam uttamam 
SA_MB_kakacandesvarimataHK-1243	sūtreṇa veṣṭitaṃ kṛtvā dṛḍhaṃ vaṃdhena yaṃtritaṃ |	sūtreṇa veṣṭitam kṛtvā dṛḍham vaṃdhena yaṃtritam 
SA_MB_kakacandesvarimataHK-1244	41b)	Ro
SA_MB_kakacandesvarimataHK-1245	etatkarma samāsena karpūrakaraṇottamaṃ ||	etat karma samāsena karpūra karaṇa uttamam 
SA_MB_kakacandesvarimataHK-1246	caitrādyā tu prakurvīta yāvadācāḍhagocaraṃ |	caitra ādyā tu prakurvīta yāvat ācāḍha gocaram 
SA_MB_kakacandesvarimataHK-1247	nīrasaṃyuta yadā vṛkṣaṃ uttāryaṃ pāṇikapriye ||	yadā vṛkṣam uttāryam 
SA_MB_kakacandesvarimataHK-1248	khādyakuryāṃ yadā icchā karpūraṇottamaṃ |	khādya kuryām yadā icchā karpūraṇa uttamam 
SA_MB_kakacandesvarimataHK-1249	ajākṣīreṇa prakṣālya punaḥ svasthenadhāritaṃ ||	ajā kṣīreṇa prakṣālya punar svasthena dhāritam 
SA_MB_kakacandesvarimataHK-1250	chāyā śuṣkaṃ tataḥ kuryāddhārayet karpūrabhāṃḍake |	chāyā śuṣkam tatas kuryāt dhārayet karpūra bhāṃḍake 
SA_MB_kakacandesvarimataHK-1251	karpūraṃ kuru deveśi trailokye tattu durlabham ||	karpūram kuru deveśi trailokye tat tu durlabham 
SA_MB_kakacandesvarimataHK-1252	iti karpūrakaraṇam ||	iti karpūra karaṇam 
SA_MB_kakacandesvarimataHK-1253	paraṅkutūhalaṃ devi karpūra tailamuttamam |	param kutūhalam devi karpūra tailam uttamam 
SA_MB_kakacandesvarimataHK-1254	jātipatrikāgrāhyasarjarasena peṣayet ||	            
SA_MB_kakacandesvarimataHK-1255	tilataileti deveśi kakarāgaṃ tu kārayet |	tila taila iti deveśi kakarāgam tu kārayet 
SA_MB_kakacandesvarimataHK-1256	lohadaṃḍena deveśi pācayettu vicakṣaṇaḥ ||	lohadaṃḍena deveśi pācayet tu vicakṣaṇaḥ 
SA_MB_kakacandesvarimataHK-1257	42a)	Ro
SA_MB_kakacandesvarimataHK-1258	paripakvagataṃ tailaṃ karpūraṃ tatra niḥkṣipet |	paripakva gatam tailam karpūram tatra niḥkṣipet 
SA_MB_kakacandesvarimataHK-1259	karpūra tailabhāgena karpūrabhāṃḍenidhāpayet ||	karpūra taila bhāgena karpūra bhāṃḍenidhāpayet 
SA_MB_kakacandesvarimataHK-1260	tattailaṃ devatā yogyaṃ gaṃdharvāṇāṃ ca mardayet |	tat tailam devatā yogyam gaṃdharvāṇām ca mardayet 
SA_MB_kakacandesvarimataHK-1261	aḍikāceṣṭayebhāgāmibharidharitvā praharaṇāṃ ||	praharaṇām 
SA_MB_kakacandesvarimataHK-1262	evaṃ tu aṃḍīkomābhavatitvacāḍaceḍayettailacāṭakī ekatasya madhye tvacāṃ	evam tu madhye tvacām 
SA_MB_kakacandesvarimataHK-1263	prakṣipya punaḥ haṇḍikā ardhapāṇī bharitvārohi sa pūrayetuthaṃ dvāre karpaṭūṃ	prakṣipya punar haṇḍikāḥ ardha pāṇī sa dvāre karpaṭūm 
SA_MB_kakacandesvarimataHK-1264	deyaṃ || athavādakījaliścā tasyo parivādukī alagaṃdhārayet || vāṭukī	deyam 
SA_MB_kakacandesvarimataHK-1265	uparidhṛtvā tena karpaṭena ācchādya punaḥ upariḍhakaṇī deyāḍhakaṇī	upari dhṛtvā tena karpaṭena ācchādya punar upari ḍhakaṇī deyā āḍhakaṇī 
SA_MB_kakacandesvarimataHK-1266	uparibhāṣitam || iti karpūratailaṃ ||	upari bhāṣitam iti karpūra tailam 
SA_MB_kakacandesvarimataHK-1267	42b)	Ro
SA_MB_kakacandesvarimataHK-1268	karpūraṃ śīlayeśilāyāpānīpeṣaṃtukapaḍaicchāṇīye tasya cūrṇaṃ	karpūram tasya cūrṇam 
SA_MB_kakacandesvarimataHK-1269	gṛhṇīyāttu alevāṃbhasivagenāli bharitvādyāre kadalīpatraṃ deyaṃ || kelepatra	gṛhṇīyāt tu bharitvā adya āre kadalī patram deyam 
SA_MB_kakacandesvarimataHK-1270	veṣṭayet || punaḥ kapaḍoṭī veṣṭayet lepigosāmadhyedhamet || taccūrṇā	veṣṭayet punar kapaḍoṭī veṣṭayet lepi gosā madhye dhamet tat cūrṇā 
SA_MB_kakacandesvarimataHK-1271	gṛhīyāttasya madhye karpūrapānīyaṃ dāpayet vīṇakaṃ bhavati śobhaṇaṃ |	gṛhīyāt tasya madhye karpūra pānīyam dāpayet vīṇakam bhavati śobhaṇam 
SA_MB_kakacandesvarimataHK-1272	pātālake tu kītvacāsāpainnakapaḍādeyaṃ chādayet vāra 7 aśoṣita talehatamāgni	pātālake tu chādayet 
SA_MB_kakacandesvarimataHK-1273	praharārdhamiti punaḥ | udghāṭitaṃ hṛtvā iti pahati | sa ca dutiṣiladhāritvā punaḥ	prahara ardham iti punar udghāṭitam hṛtvā iti pahati sa ca punar 
SA_MB_kakacandesvarimataHK-1274	43a)	Ro
SA_MB_kakacandesvarimataHK-1275	aṃḍīṭaṃkaṇacīrīsiṣāḍhaṭaṃkaṇadeyā pṛthak pṛthak dhārayet | evaṃ	aṃḍī ṭaṃkaṇa cīrī siṣāḍha ṭaṃkaṇa deyā pṛthak pṛthak dhārayet evam 
SA_MB_kakacandesvarimataHK-1276	palamadhye palatrayaṃ 3 rāla madanaphala 2 aṃḍīcūlai upari ca ṭāpyate taila ca	pala madhye pala trayam upari ca ca 
SA_MB_kakacandesvarimataHK-1277	uthāī aparakṣipet | naṣamūtalo 3 hāḍī madhye nikṣipet | avaṭāvayet | kūvuḍalī	uthāī aparakṣipet naṣamūtalo hāḍī madhye nikṣipet avaṭāvayet kūvuḍalī 
SA_MB_kakacandesvarimataHK-1278	aparaṃ kāryā madhye nikṣipya evaṃ madanaphalaṃ rāla ekatra uvālai yāvat	aparam kāryāḥ madhye nikṣipya evam madana phalam rāle ekatra yāvat 
SA_MB_kakacandesvarimataHK-1279	uttāritaṃ tasya svāṃgśītalaṃ grāhya na svabhūtalī kāṭipīsai punaḥ usī madhye	uttāritam tasya svāṃgśītalam grāhya na madhye 
SA_MB_kakacandesvarimataHK-1280	kṣipet | kūvuḍalī 2 pīsi kṣipet | aṃḍītvacāvaṣidhāryāṭaṃka 3 ilā 3 cīṭakaṃ 3	kṣipet kūvuḍalī pīsi kṣipet ilā 
SA_MB_kakacandesvarimataHK-1281	logaṭaṃkatīnajā 3 phala ekatra peṣayet |	phale ekatra peṣayet 
SA_MB_kakacandesvarimataHK-1282	43b)	Ro
SA_MB_kakacandesvarimataHK-1283	sūkṣmacūrṇaṃ kṛtvā karpūramāse 2 evastupīsikṣipet haṃḍikā madhye	sūkṣma cūrṇam kṛtvā karpūra māse haṃḍikā madhye 
SA_MB_kakacandesvarimataHK-1284	sugaṃdhavastu ekalapatraṇavāsitvā jñātavyā vicakṣaṇaḥ | duti utta agile	jñātavyā vicakṣaṇaḥ 
SA_MB_kakacandesvarimataHK-1285	puṣpasevatīṭaṃka eka athavā sugaṃdhavastu yadidalitaṃ utparedhārayet prahara 4	athavā sugandha vastu prahara 
SA_MB_kakacandesvarimataHK-1286	mititini punaḥ te puṣpa utārīye aparaṃ dātavyaṃ evaṃ vāra 2 nityakartavyaṃ	punar te aparam dātavyam evam 
SA_MB_kakacandesvarimataHK-1287	puṣpedhāritavyaṃ utāridina 7 siddhaṃ bhavati dalaṃ miśrogaṃdhakarma	siddham bhavati dalam 
SA_MB_kakacandesvarimataHK-1288	maṃḍayitvā sūkṣmena sarvaṃ kṛtvā tena madhye prathamaṃdalaṃdhāryaṃ	maṃḍayitvā sūkṣmena sarvam kṛtvā tena madhye prathamam dalam dhāryam 
SA_MB_kakacandesvarimataHK-1289	uttaredutidhāryāta sugaṃdhapuṣpadātavyāḥ maṃdaṃ deyāḥ prahara 4 punaḥ	su gaṃdha puṣpa dātavyāḥ maṃdam deyāḥ prahara punar 
SA_MB_kakacandesvarimataHK-1290	anyāṃ | dadyādevaṃ vidhidina 3 pīcche kūpikāṃ dhārayet ||	anyām kūpikām dhārayet 
SA_MB_kakacandesvarimataHK-1291	44a)	Ro
SA_MB_kakacandesvarimataHK-1292	navādi siddhyati nānyathā | iti yavādikaraṇaṃ || atha kasturīkaraṇaṃ | kṛṣṇā	nava ādi siddhi ati na anyathā iti yava ādi karaṇam atha kasturīkaraṇam kṛṣṇā 
SA_MB_kakacandesvarimataHK-1293	gurūjātīphalaṃ kuṃkumaṃ kesaraṃ samabhāgaṃ kṛtvā peṣayet ||	          kṛtvā peṣayet 
SA_MB_kakacandesvarimataHK-1294	śigusūlarasena sūkṣmavartayitvā ketakī patramālepayet | kṣaṇamekaṃ kasturikā	śigu sūla rasena ketakī patram ālepayet kṣaṇam ekam kasturikā 
SA_MB_kakacandesvarimataHK-1295	bhavati aṃcakī guṭhalīcūrṇaṃ pakvaṃ aṃvarasena bhāvanā vahuśaḥ punaḥ	bhavati guṭhalī cūrṇam pakvam aṃva rasena bhāvanā vahuśas punar 
SA_MB_kakacandesvarimataHK-1296	puṭitaṃ kṛtvā paścāt ilā-icī 1 chaḍa 2 taja 3 jāvatrī 4 kuṭu 5 jāiphala 6	puṭitam kṛtvā paścāt 
SA_MB_kakacandesvarimataHK-1297	sasaṃbhāga sūkṣmacūrṇitaṃ puna 2 aṃvarasena mardanaṃ karpūrodaka	sūkṣma cūrṇitam 
SA_MB_kakacandesvarimataHK-1298	bhāvanādeyaṃ kastūrikā bhavati || dalārdhaṃ śubhraṃ sarvatra gaṃdhaṃ	bhāvanā deyam kastūrikā bhavati dala ardham śubhram sarvatra gaṃdham 
SA_MB_kakacandesvarimataHK-1299	44b)	Ro
SA_MB_kakacandesvarimataHK-1300	gṛhītvā dravyena samabhāgamelanaṃ kṛtvā guṃṭhalīdagdhaṃ sa eva melitaṃ |	gṛhītvā dravyena sama bhāga melanam kṛtvā guṃṭhalī dagdham saḥ eva melitam 
SA_MB_kakacandesvarimataHK-1301	dravyaṃ samaṃ tataḥ | punaḥ ekatra kṛtvā poyasatailena mardayet | kastūrikā	dravyam samam tatas punar ekatra kṛtvā poyasa tailena mardayet kastūrikā 
SA_MB_kakacandesvarimataHK-1302	bhavati | evaṃ snigdhasugaṃdhikā bhavati | anyaṃ | śrīphala purātana	bhavati evam snigdha sugaṃdhikā bhavati anyam śrīphala purātana 
SA_MB_kakacandesvarimataHK-1303	bharamagrāhyaṃ | tasya bhāvanā sugaṃdhaśāli udakabhāvanā 3 vokamūtre idaṃ	tasya bhāvanā su gaṃdha śāli udaka bhāvanā idam 
SA_MB_kakacandesvarimataHK-1304	prahara 4 bhāvanā 3 vanacara mūtra gṛhakā udakaṃdenikṣipya tasyodake bhāvanā	prahara bhāvanā tasya udake bhāvanā 
SA_MB_kakacandesvarimataHK-1305	3 vālā udakena bhāvanā 3 sarvakāṣṭha sugaṃdha udakena bhāvanā | atha	vālā udakena bhāvanā sarvakāṣṭha sugaṃdha udakena bhāvanā atha 
SA_MB_kakacandesvarimataHK-1306	dutipātane bhāvanā deyā | kuṭukacūratajāpatraja udakena bhāvanā pṛthak	duti pātane bhāvanā deyā udakena bhāvanā pṛthak 
SA_MB_kakacandesvarimataHK-1307	pṛtha	pṛtha 
SA_MB_kakacandesvarimataHK-1308	45a)	Ro
SA_MB_kakacandesvarimataHK-1309	suramāsyi ugaṃṭhivaṃdhayitvā | ilāicī jāiphala piṃḍe datvā karpūra	ilāicī jāiphala piṃḍe datvā 
SA_MB_kakacandesvarimataHK-1310	kuṃkumabhāvanā sugaṃdha tailoyaṃ saṃpacet | paścāt piṃḍe datvā ketakī puṣpa	saṃpacet paścāt piṃḍe 
SA_MB_kakacandesvarimataHK-1311	suhaṃjaṇā jaladeyaṃ kṛtvā gharmedhāryā dutirbhavati | chāyā madhye tasya	suhaṃjaṇā jala deyam kṛtvā gharmedhāryā dutiḥ bhavati chāyā madhye tasya 
SA_MB_kakacandesvarimataHK-1312	bhāvanācāri kastūrikā bhavati || nakhapala 5 tailena talīye dhūmravarṇaṃ kṛtvā	bhāvanā cāri kastūrikā bhavati nakha pala tailena talīye dhūmra varṇam kṛtvā 
SA_MB_kakacandesvarimataHK-1313	paścāt śilāṃ pīṣayitvā kelimūlaṃ ānayet uttamaprakṣyālya sarāvī 9 pāṇī	paścāt śilām pīṣayitvā keli mūlam ānayet pāṇī 
SA_MB_kakacandesvarimataHK-1314	avaṭāiyai aṣṭā viśeṣalījīye uttama prakṣālaye nakhaṃ sa tu pānīya	nakhaṃ sa tu 
SA_MB_kakacandesvarimataHK-1315	vudavudesārayet | ilāicīṭaṃka 5 tajaṭaṃka 5 nāgakeśaraṭaṃka 5	ilāicī ṭaṃka taja ṭaṃka nāgakeśara ṭaṃka 
SA_MB_kakacandesvarimataHK-1316	45b)	Ro
SA_MB_kakacandesvarimataHK-1317	jāiphalaṭaṃ 5 vāḍivaṃ dhaṇāṭaṃka 5 tena udakena saha ekaeka pṛthak pṛthak	tena udakena saha ekaeka pṛthak pṛthak 
SA_MB_kakacandesvarimataHK-1318	kapaḍaicchāni bhāvanā 7 deyaṃ siddhidālaṃ bhavati || aṃḍī 5 āṇiromadīpāgninā	bhāvanā deyam siddhi dālam bhavati āṇi roma dīpa agninā 
SA_MB_kakacandesvarimataHK-1319	dāpayet || atha roma utpāṭayet | vaḍīptohitahathārakaṃdeyāpānīya kṣipet || tata	dāpayet atha roma utpāṭayet kṣipet 
SA_MB_kakacandesvarimataHK-1320	utpareṣorakaṃdhāryataṃ | tata utpare aṃḍikā 5 salākācobhidhāryāvāri ca	tatas utpare aṃḍikā ca 
SA_MB_kakacandesvarimataHK-1321	paṇīdeyaḥ sūkṣma agniṃ jvālayet | tatrāṃḍī sataṃ kaṭorakeyatati sarvā satataṃ	paṇīdeyaḥ sūkṣma agnim jvālayet sarvā satatam 
SA_MB_kakacandesvarimataHK-1322	syadalamadhye mardayet | punaḥ aṃḍī sūkṣma ek pṛthak pṛthak karpaṭena	                 
SA_MB_kakacandesvarimataHK-1323	chāṇitaṃ bhāvanā ca deyā siddhidalaṃ bhavati ||	chāṇitam bhāvanā ca deyā siddhidalam bhavati 
SA_MB_kakacandesvarimataHK-1324	46a)	Ro
SA_MB_kakacandesvarimataHK-1325	aṃḍīyāṃ 5 ānayeromaṃdīyāgni nādahvayet | atha romatatpāṭayet tāvaḍī sohi	atha roma tat pāṭayet 
SA_MB_kakacandesvarimataHK-1326	satharakaṃdeyāḥ pānīyaṃ kṣipet || tata utpareṣorakaṃ dhāryate tatrotpare aṃḍikā 5	pānīyam kṣipet tatas utpareṣu urakam dhāryate tatra utpare aṃḍikā 
SA_MB_kakacandesvarimataHK-1327	salākācobhidhāryāṣāriḍhakaṇīdeyā agnisūkṣmaṃ jālayet | tatrāṃḍī sataṃ	agni sūkṣmam jālayet 
SA_MB_kakacandesvarimataHK-1328	kaṭorakepatati sarvāsataṃ tasya dalamadhye mardayet || tataḥ aṃḍīsūkṣmapīṣayet |	sarvāsatam tasya dala madhye mardayet tatas 
SA_MB_kakacandesvarimataHK-1329	tatra madhye dātavyaṃvaṃ kṛṣṇavīṇī bharitāṃ vījaṃ dadyāt | sugaṃdhi uttamā	tatra madhye kṛṣṇa vīṇī bharitām vījam dadyāt sugaṃdhi uttamā 
SA_MB_kakacandesvarimataHK-1330	bhavati | iti śreṣṭha kastūrikā ||	bhavati iti śreṣṭha kastūrikā 
SA_MB_kakacandesvarimataHK-1331	dadhivastreṇaniḥpīḍya chāyā śuṣkaṃ tu kārayet |	dadhi vastreṇa niḥpīḍya chāyā śuṣkam tu kārayet 
SA_MB_kakacandesvarimataHK-1332	punaḥ kastūra rasena bhāvitavyaṃ kṛtvā tu vārala punaḥ ||	punar kastūra rasena bhāvitavyam kṛtvā tu vārala punar 
SA_MB_kakacandesvarimataHK-1333	46b)	Ro
SA_MB_kakacandesvarimataHK-1334	alatārasena bhāvanā ca aṣṭādaśena kuṃkumaṃ datvā kaṭutailabhāvanā 7	alatā rasena bhāvanā ca aṣṭādaśena kuṃkumam da tvā kaṭutaila bhāvanā 
SA_MB_kakacandesvarimataHK-1335	bhavyaṃ bhavati kuṃkumaṃ | muramāṃsa 5 patraja 5 kaṭutaila 5 ṣahapīṣayet	        
SA_MB_kakacandesvarimataHK-1336	chāyā śuṣkaṃ tu kārayet | ketakī druti puṭakemaṃḍatikābhāvanā datvā |	chāyā śuṣkam tu kārayet 
SA_MB_kakacandesvarimataHK-1337	ekaikaṃ vījaṃ datvā kuṃkumaṃ bhavati | kasūbhovīlugiri dugdhena	ekaikam vījam da tvā kuṃkumam bhavati dugdhena 
SA_MB_kakacandesvarimataHK-1338	pīṣpālākṣābhāvanātha tribhāge vījaṃ datvā kuṃkumaṃ bhavati | trivarṣaṃ	tri bhāge vījam da tvā kuṃkumam bhavati tri varṣam 
SA_MB_kakacandesvarimataHK-1339	haridrākṣālayekinopāyena hori puṣpasigrujaḍatvacā āmlakāṃtika	puṣpa sigru jaḍa tvacā āmla kāntika 
SA_MB_kakacandesvarimataHK-1340	madhyejajegadhaṃ mṛyate | punaḥ dugdhena pīṣya alaṭābhāvanā ca tribhāge	mṛyate punar dugdhena pīṣya alaṭā bhāvanā ca tri bhāge 
SA_MB_kakacandesvarimataHK-1341	vījaṃ datvā kuṃkumaṃ bhavati ||	vījam da tvā kuṃkumam bhavati 
SA_MB_kakacandesvarimataHK-1342	47a)	Ro
SA_MB_kakacandesvarimataHK-1343	yā abhinava haridrātāṃ gṛhītvā cāḍacoḍayet | sugaṃdhi tailasthāpya | atha	gṛhītvā cāḍacoḍayet sugaṃdhi taila sthāpya atha 
SA_MB_kakacandesvarimataHK-1344	utyaregaṃdha mriyate | alpaṃ pacetpunaḥ grāhyaṃ sūkṣmaṃ pīṣparaṃgalākṣa |	mriyate alpam pacet punar grāhyam sūkṣmam 
SA_MB_kakacandesvarimataHK-1345	sugaṃdhapānī madhye nikṣipya punaḥ sajjīṭaṃkaṇa nimiṣamātraṃ lākṣā	sugaṃdha pānī madhye nikṣipya punar sajjī ṭaṃkaṇa nimiṣa mātram lākṣā 
SA_MB_kakacandesvarimataHK-1346	rasamadhye prakṣipya sugaṃdha dravyaṃ puṣpāḍhi vāsayet | kuṃkumaṃ bhavati |	rasa madhye prakṣipya su gandha dravyam puṣpa āḍhi vāsayet kuṃkumam bhavati 
SA_MB_kakacandesvarimataHK-1347	tavākṣīra bhāga 2 kasūṃmābhāga 1 ubhayorapi pīṣayet evaṃ ṭaṃka 20 nisā 1	ubhayoḥ api pīṣayet evam 
SA_MB_kakacandesvarimataHK-1348	mahiṣa dadhi madhu varada amlena pisimarditaṃ kṛtvā athavā ahorātraṃ	mahiṣa dadhi madhu vara da amlena pisimarditam kṛtvā athavā ahorātram 
SA_MB_kakacandesvarimataHK-1349	punarvaṭī deyaṃ chāyā śuṣkaṃ tu kārayet | punaḥ pīṣayet | āmalī rasena pīṣayet	punar vaṭī deyam chāyā śuṣkam tu kārayet punar pīṣayet āmalī rasena pīṣayet 
SA_MB_kakacandesvarimataHK-1350	47b)	Ro
SA_MB_kakacandesvarimataHK-1351	punaḥ śuṣkāṃtha punaḥ cākīpīṣayet || tatra madhye guggulu | tailā | atha kaḍutaila |	punar śuṣkāṃtha punar tatra madhye guggulu tailā atha kaḍutaila 
SA_MB_kakacandesvarimataHK-1352	chalīrākvāthaṃ kaṭutailaṃ samaṃkṣipya dhārayet pṛthivī madhye tena	chalīrā kvātham kaṭutailam samaṃkṣipya dhārayet pṛthivī madhye tena 
SA_MB_kakacandesvarimataHK-1353	tailabhāvanā | bhavyaṃ bhavati kuṃkumaṃ | hiṃgulaviṃśabhāgena datvā	taila bhāvanā bhavyam bhavati kuṃkumam hiṃgula viṃśa bhāgena 
SA_MB_kakacandesvarimataHK-1354	pūrvamathodakena pīṣyaṃ melayet punaḥ śuṣkāpya punaḥ tailena sahapīṣayet |	pūrvam atha udakena pīṣyam melayet punar punar tailena saha pīṣayet 
SA_MB_kakacandesvarimataHK-1355	bhavyaṃ mardayet | dalaṃ ālodyakupikāṃtaraṃbharet dharmedhārayet tailaṃ	bhavyam mardayet dalam ālodya kupikā antaram bharet dharme dhārayet tailam 
SA_MB_kakacandesvarimataHK-1356	utparedhārayet | raktaśrīvaṃtamahāsiddhaṃ śobhitaṃ | iti uttaradiśāṃ	rakta śrīvanta mahā siddham śobhitam iti uttara diśām 
SA_MB_kakacandesvarimataHK-1357	tribhāgekesaraṃ pradhānaṃ vāyavetaṃ bhavati | kuṃkumaḥ | kauṃtubhaṃ	tri bhāge kesaram pradhānam vāyavetam bhavati kuṃkumaḥ kauṃtubham 
SA_MB_kakacandesvarimataHK-1358	tavākṣīraṃkacūrṇaṃ kṛtvāye ca sahita ekabhāgamālatī rasaṃ deyaṃ |	ca sahite eka bhāga mālatī rasam deyam 
SA_MB_kakacandesvarimataHK-1359	48a)	Ro
SA_MB_kakacandesvarimataHK-1360	amlena bhāvanāṃ dadyāt vaṭikāṃ kṛtvā | chāyāśoṣitaṃ punaḥ	    dadyāt              
SA_MB_kakacandesvarimataHK-1361	sūkṣmacūrṇitaṃ kṛtvā varada tailena pīṣya paṃcacatvāriṃ śataśobhāgaḥ	sūkṣma cūrṇitam kṛtvā vara da tailena pīṣya śataśas bhāgaḥ 
SA_MB_kakacandesvarimataHK-1362	atisūkṣmaṃ tu kārayet | vīryaṃ dvādaśamobhāgatriphalā sahapīṣayet |	ati sūkṣmam tu kārayet vīryam dvādaśa mobhāga triphalā sahapīṣayet 
SA_MB_kakacandesvarimataHK-1363	catvāriṃśādhitā śatapaṃcamaṇāṃ tatra pramāṇataḥ kuṃpikāṃbharayat tatra	catvāriṃśa ādhitā śata paṃca maṇām tatra pramāṇataḥ kuṃpikām bharayat tatra 
SA_MB_kakacandesvarimataHK-1364	viṃśaditaṃdharmedhārayet | kuṃkumaṃ bhavati śobhanaṃ paṃcamai	viṃśaditam dharme dhārayet kuṃkumam bhavati śobhanam 
SA_MB_kakacandesvarimataHK-1365	calapramāṇaṃ | pārāṭaṃka 10 suhāgāṭaṃka 10 hiṃgulaṭaṃkaṃ 15 phūlamaṇa	cala pramāṇam pārā ṭaṃka suhāgā ṭaṃka hiṃgula ṭaṃkam 
SA_MB_kakacandesvarimataHK-1366	ekatailaṃ tulamātraṃ karcūrasahakvāthayet | tailaṃ kaṭukarāvaṃ |	                
SA_MB_kakacandesvarimataHK-1367	kuṃkumakaraṇaṃ |	kuṃkuma karaṇam 
SA_MB_kakacandesvarimataHK-1368	48b)	Ro
SA_MB_kakacandesvarimataHK-1369	garuḍaikecāvalavahuḍidhoiyavālitaṃ suṣkāvayet | yāvacca śuṣkaṃ bhavati tadā	suṣkāvayet yāvat ca śuṣkam bhavati tadā 
SA_MB_kakacandesvarimataHK-1370	śilāpīṣayet | kesūrasabhāva āṭhadeyaṃpīṣitaṃ kṛtvāyuḥ alatāra	śilā pīṣayet 
SA_MB_kakacandesvarimataHK-1371	sabhāvanādeyaṃ malaimadhye aṃḍikāṃ romavarjitaṃ kṛtvā śilāpīṣayet |	sa bhāvanā deyam aṃḍikām roma varjitam kṛtvā śilā pīṣayet 
SA_MB_kakacandesvarimataHK-1372	kṛtvā malaṇamadhye nicoḍayemardayet | vāraṭaṃkaṇādeṇā kaṭutaila madhye	kṛtvā malaṇa madhye 
SA_MB_kakacandesvarimataHK-1373	nikṣipya dina 9 sūryapākaṃ kārayettena tailena sarvadalaṃ mardayet | maṇapratisera	nikṣipya sūrya pākam kārayet tena tailena sarva dalam mardayet 
SA_MB_kakacandesvarimataHK-1374	1 vījakuṃkumaṃ bhavati śobhanaṃ | sa bhālu puṣpaviṃdugrāhyaṃ ṣaḍeṣīṇ layet |	vīja kuṃkumam bhavati śobhanam puṣpa viṃdu grāhyam 
SA_MB_kakacandesvarimataHK-1375	evaṃ bhāga 3 alatānaṣubhāga 3 rāvaṃtrakau	evam 
SA_MB_kakacandesvarimataHK-1376	49a)	Ro
SA_MB_kakacandesvarimataHK-1377	bhauga 3 grāhyacūrṇaṃ kṛtvā melayet | lāṣapānīmardayet | vāsaṃ deyaṃ	                    
SA_MB_kakacandesvarimataHK-1378	sugaṃdhavastu kuṃkumaṃ bhavati | iti sugaṃdhādivastu ||	su gaṃdha vastu kuṃkumam bhavati iti su gaṃdha ādi vastu 
SA_MB_kakacandesvarimataHK-1379	ṣadyalaṃ vilvamadhyasthaṃ māṣīṃ cūrṇayalāṣṭakaṃ |	              
SA_MB_kakacandesvarimataHK-1380	catvāropicumaṃdasya dverasasya tu kārayet ||	tu kārayet 
SA_MB_kakacandesvarimataHK-1381	guḍaguggulaśuṃṭhīnāṃ palamekaika dāpayet |	guḍa guggula śuṃṭhīnām dāpayet 
SA_MB_kakacandesvarimataHK-1382	śvetaguṃjā tu cūrṇantu gaṃdharvavījacūrṇitam ||	śveta guṃjā tu cūrṇam tu gaṃdharva vīja cūrṇitam 
SA_MB_kakacandesvarimataHK-1383	māṣapiṣṭhīipothasatvaṃ cūrṇaṃ kṛtvā tu yatnataḥ |	               
SA_MB_kakacandesvarimataHK-1384	picumaṃdaṃvījacūrṇamekaṃ kṛtvā tu mardayet ||	               
SA_MB_kakacandesvarimataHK-1385	hiṃguḍā pradhānaṃ | ajāpaya madhye māsamekaṃ ca dhārayet | pradhānaṃ	hiṃguḍā pradhānam madhye māsam ekam ca dhārayet pradhānam 
SA_MB_kakacandesvarimataHK-1386	bhavati murahaṃ | tavāṣīrabhāga	bhavati tava aṣīrabhāga 
SA_MB_kakacandesvarimataHK-1387	49b)	Ro
SA_MB_kakacandesvarimataHK-1388	3 aṣoḍagarībhāga 3 dūdhabhāga 1 ugrahiṃgu pradhānabhāga 1 kaḍukarāīpāṇī	             
SA_MB_kakacandesvarimataHK-1389	bhāvanādeyā tena mardayet | gugalamalitā abhramadhye mardayet |	             
SA_MB_kakacandesvarimataHK-1390	sarīrasaṃpannavāpi rasenālasanaṃradhayet | hiṃgudalaṃ deyaṃ nirgadhaṃ bhavatiḥ	hiṃgu dalam deyam nirgadham bhavatiḥ 
SA_MB_kakacandesvarimataHK-1391	| lasunaṃ | prathamaṃ divase mahiṣī dugdhaṃ grāhyaṃ pala 9 mahāgaṃdhataila pala	prathamam divase mahiṣī dugdham grāhyam 
SA_MB_kakacandesvarimataHK-1392	1 māṣacūrṇapala 1 evamahisākasurabhītavāṣīrapala 4 guggulapala 6 gūṃdapala 6	māṣa cūrṇa pala guggula pala 
SA_MB_kakacandesvarimataHK-1393	rājikāpala 4 kacūrapala 2 vījaṃ kṣayet | taila duraṃdayaṃtaṃ tāraye	vījam kṣayet tāraye 
SA_MB_kakacandesvarimataHK-1394	udakairaṃdhaye prathamaṃ guggulena sahāpaṃcamaṃśena vījaṃ phūṃṭaḍī	udakaiḥ aṃdhaye prathamam guggulena saha ā paṃcama aṃśena vījam phūṃṭaḍī 
SA_MB_kakacandesvarimataHK-1395	bharitaṃ gopyasthānena dhāritaṃ ṣadiragūṃdapakṣaḍā bhavati |	bharitam gopya sthānena dhāritam bhavati 
SA_MB_kakacandesvarimataHK-1396	50a)	Ro
SA_MB_kakacandesvarimataHK-1397	cāvalasera ekavadugādivīsadhārayet ca uthālīniyatu | dugdhena pīṣayet | gugulavīsaṃ	ekavat ugādi vīsa dhārayet ca dugdhena pīṣayet 
SA_MB_kakacandesvarimataHK-1398	| telatalīyenirgaṃdhalasunaparenivolī pala 2 sarvaṃ cūrṇaṃ kṛtvā	sarvam cūrṇam kṛtvā 
SA_MB_kakacandesvarimataHK-1399	gugulatatmardayet | soyaṃ mardikāṃ kṛtvā mukhyāyāpunaḥ cūrṇaṃ	gugula tat mardayet sā uyam mardikām kṛtvā cūrṇam 
SA_MB_kakacandesvarimataHK-1400	sahagaṃdhahoinibhrāmā | gaṃdhakaṃ ciulaṃ mātraṃ tu poṭalī vadhvāsvedayet |	                         
SA_MB_kakacandesvarimataHK-1401	ḍolāyaṃtraṃ dinamekaṃ tu ahorātra dhūnalāmadhye pānīye saha evaṃ	dolāyaṃtram dinam ekam tu ahorātra pānīye saha evam 
SA_MB_kakacandesvarimataHK-1402	gaṃdhakaṃdhārya utparegalegalipaḍati | dugdha sadhye śuddhirbhavati | uttamā	dugdha sadhye śuddhiḥ bhavati uttamā 
SA_MB_kakacandesvarimataHK-1403	evaṃ śuddhagaṃdhaka rasakā eṇakārayet |	evam 
SA_MB_kakacandesvarimataHK-1404	50b)	Ro
SA_MB_kakacandesvarimataHK-1405	tāmraṭaṃka 5 suhajaṇā rasamadhyetāvījaṇepatraṃvāra 7 cūnā aṣṭāvāra 8 palāsa	cūnā aṣṭāvāra 
SA_MB_kakacandesvarimataHK-1406	aṃtaracchāli vāra 7 āvilīniṃvūkārasavīja madhye patra ukālīye punaḥ udakena	antaracchāli vāra āvilī niṃvūkā rasavīja madhye patra ukālīye punar udakena 
SA_MB_kakacandesvarimataHK-1407	prakṣālayet punaḥ gokṣīra madhye utkālyate prahara 1 punaḥ prakṣālayet | tāmra	prakṣālayet punar gokṣīra madhye utkālyate prahara punar prakṣālayet tāmra 
SA_MB_kakacandesvarimataHK-1408	samaṃ gaṃdhakaṃ datvā dhārayet cūrṇaṃ kṛtvā | āṃdrakarasa mahāvalacūrṇa	samam gaṃdhakam da tvā dhārayet cūrṇam kṛtvā āṃdraka rasa mahāvala cūrṇa 
SA_MB_kakacandesvarimataHK-1409	deyāḥ vartayeśleṣmānāśayati | tasya cūrṇaṃ valaghanavākaragadyāṇa ca	deyāḥ tasya cūrṇam ca 
SA_MB_kakacandesvarimataHK-1410	ḍarohaṃgadyāṇaṃ 1 prabhāte bhakṣayet pramehaṃ nāśayati | sāheti punaḥ	prabhāte bhakṣayet prameham nāśayati sāhā iti punar 
SA_MB_kakacandesvarimataHK-1411	sahavalena vāta sakaragadyāṇa 1 vaḍarohagaṃdhajaḍagaghāṇa 1 prabhāte	prabhāte 
SA_MB_kakacandesvarimataHK-1412	bhakṣayet |	bhakṣayet 
SA_MB_kakacandesvarimataHK-1413	51a)	Ro
SA_MB_kakacandesvarimataHK-1414	dīrgha kṣayarogaṃ nāśayati | punastasya cūrṇavalaṃvṛdha | śilājitugaḍaṇā	kṣaya rogam nāśayati punar tasya 
SA_MB_kakacandesvarimataHK-1415	hiṃgu valavata evaṃ kṣayet | śūlaṃ nāśayati | punastasya cūrṇaṃ vala 4 śilājit	hiṃgu valavataḥ evam kṣayet śūlam nāśayati punar tasya cūrṇam vala śilājit 
SA_MB_kakacandesvarimataHK-1416	13 vacchanāgabhaṃgaratī 1 pratibhakṣayet kuṣṭhaṃ nāśayati | iti	prati bhakṣayet kuṣṭham nāśayati iti 
SA_MB_kakacandesvarimataHK-1417	tāmrabhairavarasaḥ | nautanahaṃḍikā madhye rasapalamekaṃ kṣipet | punaḥ pratyare	                                                                              
SA_MB_kakacandesvarimataHK-1418	gaṃdhakaṃ kṣipet | palamekaṃ tu cūrṇaṃ yet | palaṃ śuddhavādukī upariṭaṃkayet	gaṃdhakam kṣipet palam ekam tu cūrṇam palam śuddha vādukī upari ṭaṃkayet 
SA_MB_kakacandesvarimataHK-1419	| uparikapaṃṭamṛttikāṃ lepyāpalakaṃ datvā tena mardayet |	upari kapaṃṭa mṛttikām lepya āpalakam tena mardayet 
SA_MB_kakacandesvarimataHK-1420	cuhlakātparecadyapyaśanaiḥ śanaiḥ dīpāgniṃ jvālayet |	cuhlakāt parecadi api aśanais śanais dīpa agnim jvālayet 
SA_MB_kakacandesvarimataHK-1421	51b)	Ro
SA_MB_kakacandesvarimataHK-1422	yāvat cuhlakaṃ śītalaṃ bhavati tāvadvahnina utāryate svāṃgaśītalaṃ kṛtvā tato	yāvat cuhlakam śītalam bhavati tāvat vahninaḥ svāṃgaśītalam kṛtvā 
SA_MB_kakacandesvarimataHK-1423	vaṭukī parigrāhayet | sūkṣmacūrṇaṃ kṛtvā upavāsa dvayaṃ	vaṭukī parigrāhayet sūkṣma cūrṇam kṛtvā upavāsa dvayam 
SA_MB_kakacandesvarimataHK-1424	trayamanaṃtaraṃgyātarogeṇaratī 4 deyaṃ vātapitta śleṣmajvarenāśayati |	deyam vāta pitta śleṣma jvarena āśayati 
SA_MB_kakacandesvarimataHK-1425	rasabhāga 1 gaṃdhakabhāga 2 śulvabhāga 3 mari ca bhāga 7 viṣabhāga 1 ciramaṭhī	rasa bhāga gaṃdhaka bhāga śulva bhāga mari ca bhāga viṣa bhāga 
SA_MB_kakacandesvarimataHK-1426	bhāga 1 rohūkāpittābhāga 1 arkadugdhenamardayet | canakamātravaṭikākāryā |	bhāga arka dugdhena mardayet canaka mātra vaṭikā kāryā 
SA_MB_kakacandesvarimataHK-1427	ekaikavaṭikādeyāsannipātajvaraṃ nāśayati | tridoṣa jvaraṃ nāśayati | oṃ	ekaika vaṭikā deya asannipāta jvaram nāśayati tridoṣa jvaram nāśayati oṃ 
SA_MB_kakacandesvarimataHK-1428	kācapāpa ṛṣikasyayaṛṣikasya ṛṣikāpūta	kācapāpa 
SA_MB_kakacandesvarimataHK-1429	52a)	Ro
SA_MB_kakacandesvarimataHK-1430	sūryadevatā śrīsūryodevatākāputrarājāśrīsugrīvarājāsugrīvakā ājñākārike	ājñā kārike 
SA_MB_kakacandesvarimataHK-1431	putrajalavāle ākāśavārai bhūtavalaipiśācacālaichalacālaichidracānaivittacālai	putra jala vāle ākāśa vārai bhūta valai piśāca cālai chala cālai chidra cānai vitta cālai 
SA_MB_kakacandesvarimataHK-1432	ca kārūvālaiḍākinī vālaiśākinī vālaisatīsītāke vāhana agraraha	ca vāhana 
SA_MB_kakacandesvarimataHK-1433	padmavānaracālaivahattarikoṭhirīkṣacalehāvegavaṃta hoicālu rājā sugrīvakī	rājā sugrīvakī 
SA_MB_kakacandesvarimataHK-1434	āgyāphuraijaina calahito ardhabrahmādi phaṭimarahi oṃ phaṭ svāhā |	ardha brahma ādi om phaṭ svāhā 
SA_MB_kakacandesvarimataHK-1435	ādityavāridīvodharaṇo kanyākaihācāvalamudrāsupārī naivedyadharaṇākorādī vā	naivedya dharaṇa a kora ādī vā 
SA_MB_kakacandesvarimataHK-1436	vāra 7	vāra 
SA_MB_kakacandesvarimataHK-1437	52b)	Ro
SA_MB_kakacandesvarimataHK-1438	maṃtrapaṭhaṇāpīta akṣata atha vā śveta sarpapādīpamāhī pratiṣṭhaṇī	atha vā śveta sarpapādī pamāhī 
SA_MB_kakacandesvarimataHK-1439	kaṃtyādeṣaijopūṃchaisokahaiḥ || oṃ śrīṃ klīṃ hrīṃ vadavada vāgvādinī namaḥ	om śrīṃ klīṃ hrīṃ vadavada vāgvādinī namaḥ 
SA_MB_kakacandesvarimataHK-1440	svāhā | giguḍuvīḍo ese 21 ṣirahaṭī rasenakāṃ ca kākaṭorākapaḍoṭīkaṭoraideve	svāhā giguḍuvīḍo ese rasenakām ca kāka ṭorā kapaḍoṭī kaṭoraideve 
SA_MB_kakacandesvarimataHK-1441	uparipuṭavajramiṭīkādījai manaśilaṭaṃka 3 pīsanīni kaṃkaṭoraikā ca	ca 
SA_MB_kakacandesvarimataHK-1442	keviciviṭoghaṇukaraṇīgaḍo ehacchopahinī kaikapaḍaighāti āṇicyārilakaḍīṭhokai	ehaccha upahinī 
SA_MB_kakacandesvarimataHK-1443	ahicāraiṣalovadahigiḍo esera 1 ṣirahaṭī kasera 1 kalarūserū	esera ṣira haṭī kasera kalarū serū 
SA_MB_kakacandesvarimataHK-1444	ādhuvicikapaḍaidharīyaiyajjadhūpadharīyahi prahara 2 atha ca 3 rasanikalaito	prahara atha ca 
SA_MB_kakacandesvarimataHK-1445	kāmakījai |	kāmakījai 
SA_MB_kakacandesvarimataHK-1446	53a)	Ro
SA_MB_kakacandesvarimataHK-1447	tailasera 5 ghṛtasera aṭā 3 ekatrasera sātatela madhyemethī	tailasera ghṛtasera aṭā ekatrasera sātatela madhyemethī 
SA_MB_kakacandesvarimataHK-1448	kīṭikaḍīkaripāvaṇībhalīkaripakāuṇī uparāṃtisera 1 vocedeṇesuṣāvaṇā	uparāṃtisera 
SA_MB_kakacandesvarimataHK-1449	uparāṃtidahīsera aṭāśyakāvaṇāghṛtahoi | iti ghṛtakaraṇam ||	iti ghṛta karaṇam 
SA_MB_kakacandesvarimataHK-1450	savākuṃkaṃguṇimaṇa 1 cāvaladūdhabhāvaṇepīsaṇeghṛtasera	cāvala dūdha bhāvaṇe pīsaṇe ghṛtasera 
SA_MB_kakacandesvarimataHK-1451	aṭāiyāduralāimardanīṣāṃḍahoi | iti ṣāṃḍakaraṇaṃ | nivolīsera 10 lasunasera 10	iti ṣāṃḍa karaṇam 
SA_MB_kakacandesvarimataHK-1452	araḍolīsera 10 dūdhamāhisadhaṇī gūḍadūdhasera 5 hiṃgasera 5 ekatrakaripāsaṇe	araḍolīsera 
SA_MB_kakacandesvarimataHK-1453	hiṃgahoi | iti hiṃgukaraṇaṃ |	iti hiṃgukaraṇam 
SA_MB_kakacandesvarimataHK-1454	53b)	Ro
SA_MB_kakacandesvarimataHK-1455	majjāsera 5 rālase 2 | ekatrakarigālīyetelasera 1 bhevaṇīpāṇī uvālaṇāni	rālase   bhevaṇī pāṇī 
SA_MB_kakacandesvarimataHK-1456	coḍisajjaivācipāvaṇe | mādhyosera | leṇāvicipāvaṇābhāḍaibhā idhijāvaṇāmeṇa	coḍi sajja evā cipāvaṇe   
SA_MB_kakacandesvarimataHK-1457	hoi | meṇavidhi | supārī 7 siṃdūrakarinīkīkaripīsaṇīthohari dūdhakāpuṭa 2	supārī 
SA_MB_kakacandesvarimataHK-1458	dhattūraikerasapuṭa 1 arkadugdhapuṭa 1 kaṭhorekaisekaideṇepuṭāsera 2	arka dugdha puṭa 
SA_MB_kakacandesvarimataHK-1459	dūdhūbhivāvaṇījitupāṇīna hoikorīhāḍī ca drāvaṇī	ca drāvaṇī 
SA_MB_kakacandesvarimataHK-1460	jāgalaigolīkilāśkahośtolīvāṃdhaṇīṣirolī	jāgalaigolī kilās kahośtolī vāṃdhaṇī sirolī 
SA_MB_kakacandesvarimataHK-1461	54a)	Ro
SA_MB_kakacandesvarimataHK-1462	pramāṇa ekadinadeṣaṇī ekarāgniṣāisovaitrījīmuṣivījaśa | caraṣīsera |	cara ṣī sera 
SA_MB_kakacandesvarimataHK-1463	maiṇaṭhaṃka 7 rālaṭaṃka 4 ekatra karigālanetuṇisera 7 sevaṇī samarasa	rālaṭaṃka ekatra sevaṇī samarasa 
SA_MB_kakacandesvarimataHK-1464	hoiyāvaṇīni coivālāralāvaṇāmaiṇahoi || haritālaṭaṃ 1 pārāṭaṃ 1 dhoharikai	hoiyāvaṇīni haritālaṭam pārāṭam 
SA_MB_kakacandesvarimataHK-1465	dūdhamāhimardananādina 7 uparāṃti golīkaraṇī || sera ādhapīpalīkā āṭāṭaṃka 10	golīkaraṇī 
SA_MB_kakacandesvarimataHK-1466	jīrāviurāgolī karaṇīka uḍaitailamardanakaṇāṃ punaḥ hṛḍīkorī	punar hṛḍīkorī 
SA_MB_kakacandesvarimataHK-1467	vītripīpalikācūnādeṇāheṭhi uparipālivīcirasudeṇā punaḥ upariḍhakaṇīdeṇīleṣu	upari pāli vīci rasu deṇā punar upariḍha kaṇī deṇī leṣu 
SA_MB_kakacandesvarimataHK-1468	karaṇāji unanilaśghadro 2 agnijalāvaṇībhātapramāṇakalaṃkuhoi ||	agni jala avaṇī bhāta pramāṇa kalaṃku hoi 
SA_MB_kakacandesvarimataHK-1469	54b)	Ro
SA_MB_kakacandesvarimataHK-1470	tāvāsuhāgā rasadegalāvaṇā | tāvātolā 1 rasamāsā 1 degālaṇā punaḥ	rasa dega lāvaṇā tāvātolāḥ rasa māsāḥ degālaṇā punar 
SA_MB_kakacandesvarimataHK-1471	bhāgahoitā vā bhāga ekarūpā suhāgādegālaṇātāraṃ bhavati | siṃgaraphaṭaṃ 3	bhāga hoitā vā bhāgaḥ eka rūpā bhavati siṃgara phaṭam 
SA_MB_kakacandesvarimataHK-1472	tāvāṭaṃka 3 lohāṭaṃdaṃvaidekaimagajanāliduhuṃ	tāva āṭaṃka 
SA_MB_kakacandesvarimataHK-1473	pralepasiṃgaraphadeṇāsukāvaṇāpeṣayet | tatra madhye dātavyaṃ | evaṃ	tatra madhye dātavyam evam 
SA_MB_kakacandesvarimataHK-1474	kṛṣṇavīṇī bharitaṃ vījaṃthā tu | sugaṃdha uttamā bhavati | iti kasturīkaraṇaṃ |	kṛṣṇavīṇī bharitam tu sugaṃdhaḥ uttamā bhavati iti kasturīkaraṇam 
SA_MB_kakacandesvarimataHK-1475	maiṇa pradhāna tailamadhye gālayet pāṇī madhye ḍālayet | tepāpaḍī bhavati |	maiṇa pradhāna taila madhye gālayet pāṇī madhye ḍālayet tepāpaḍī bhavati 
SA_MB_kakacandesvarimataHK-1476	punaḥ aparabhāṃḍe ca drāpitaṃ tṛtīyāṃsena karaṇā tailaṃ	punar apara bhāṃḍe ca drāpitam tṛtīya aṃsena karaṇā tailam 
SA_MB_kakacandesvarimataHK-1477	55a)	Ro
SA_MB_kakacandesvarimataHK-1478	deyaṃ caturthośena suhajaṇā jaḍadeyaṃ punaḥ piyaṃ saṃdeyaṃ evaṃ dala aḍikā	deyam caturtha uśena suha jaṇā jaḍa deyam punar piyam saṃdeyam evam 
SA_MB_kakacandesvarimataHK-1479	sahamardayitvā punadhapayerālakṣā |	saha mardayitvā 
SA_MB_kakacandesvarimataHK-1480	kṣīrakaṃdā kṣīramūle kṣīramūle punarnavā |	          
SA_MB_kakacandesvarimataHK-1481	aprasūtaṃgavāṃ mūtraṃ sūtavaṃdhasya lakṣaṇaṃ ||	aprasūtaṃgavām mūtram sūta vaṃdhasya lakṣaṇam 
SA_MB_kakacandesvarimataHK-1482	aṃdhamūṣākaraṇī tu haiyakāvaṇī prahara 4	aṃdhamūṣā karaṇī tu haiyakāvaṇī prahara 
SA_MB_kakacandesvarimataHK-1483	mūsataikāṭigardabhakaimūtravīcipakāvaṇādolāyaṃtrigaṃdhakakāteluṭaṃka 64	               
SA_MB_kakacandesvarimataHK-1484	hāḍīretasetī bharaṇī lohaikī kaṭorīvicidharaṇī vivirūpāpāvaṇā |	bharaṇī lohaikī kaṭorī vicidharaṇī 
SA_MB_kakacandesvarimataHK-1485	togaṃdhakakātelucarāvaṇavaśdākātelaṭaṃka 9 cāraṇā phaṭ	cāraṇā phaṭ 
SA_MB_kakacandesvarimataHK-1486	kaḍīpāṇījaluvahūtanikalaśvaidaikā |	kaḍī pāṇī jalu vahūta nikala śvaida ekā 
SA_MB_kakacandesvarimataHK-1487	55b)	Ro
SA_MB_kakacandesvarimataHK-1488	gaṃdhakakātelunosārededekāṭaṇāna usādaraṭaṃka 4 gaṃdhakasera 2 tailaṃ	tailam 
SA_MB_kakacandesvarimataHK-1489	vidhijyi unikala itpidukāḍhaṇā punaḥ rohūkāpitāvicipāikariḍolāyaṃtra	vidhi jyi uni kalaḥ it pidu kā ḍhaṇā punar 
SA_MB_kakacandesvarimataHK-1490	dūdhucakarīkāsera 10 caḍāvaṇāpacāvaṇāsiddhaṃ bhavati | gaṃdhakata	caḍāvaṇā pacāvaṇā siddham bhavati 
SA_MB_kakacandesvarimataHK-1491	usādaradeṇāṭaṃ 4 kaṭāikārasasera 10 caḍāvaṇāverasera ekase uṇe punaḥ kunālī	kaṭāikārasasera ekase uṇe punar kunālī 
SA_MB_kakacandesvarimataHK-1492	pāvaṇesera madhyeṭakaṃ 9 miracapīsakaridalacī aḍaṃkaṇa karaṇevetatatekunālī	madhyeṭakam 
SA_MB_kakacandesvarimataHK-1493	pāśyakāvaṇe majāpāvaṇīmisvahoi || hemābhragaṃdha kaṭakaṃṇatāpyatutthaṃ	hema abhra gaṃdha kaṭakaṃṇa tāpya tuttham 
SA_MB_kakacandesvarimataHK-1494	caṃdrāṣṭhavāṇarasa yugmaguṇādhimānaṃ |	yugma guṇa adhimānam 
SA_MB_kakacandesvarimataHK-1495	56a)	Ro
SA_MB_kakacandesvarimataHK-1496	jaṃvīrarājaphala satvapuṭena siddhacūrṇīkṛtaṃ sa viṣamauktikavallajaṃrasaṃ |	satva puṭena siddhacūrṇīkṛtam 
SA_MB_kakacandesvarimataHK-1497	siddhorasaḥ hasitāvalīḍhamānaṃ sarvāṃgasuṃdaraṃ iti kathitogadāriḥ |	siddhorasaḥ hasita avalīḍha mānam sarva aṃga suṃdaram iti kathita ugadāriḥ 
SA_MB_kakacandesvarimataHK-1498	jīrṇajvarāruci valakṣayamehakāśapāṃdhāṃmabhūmagudodaradoṣahaṃtā | iti	iti 
SA_MB_kakacandesvarimataHK-1499	sarvāṃga suṃdararasaḥ | kṛṣṇā sāramṛgaśṛṃgakaṃ yathā	                 
SA_MB_kakacandesvarimataHK-1500	sūkṣmacūrṇakṛta haṃḍikāsthitaṃ | bhāvayetsrahilamocikārase uddhṛtaṃ	                     
SA_MB_kakacandesvarimataHK-1501	samṛdduvahnidāhitaṃ | caṃḍeśvarākhyaṃ pavadaṃti saṃtaḥ | datvā jale naiva	caṃḍeśvara ākhyam saṃtaḥ da tvā jale na eva 
SA_MB_kakacandesvarimataHK-1502	savyoṣakararaṃprabhātakālehyaruṇodayevā bhūtaṃ jvaraṃ śāṃti mupaiti cokraḥ |	bhūtam jvaram śāṃti m upaiti ca ukraḥ 
SA_MB_kakacandesvarimataHK-1503	57a)	Ro
SA_MB_kakacandesvarimataHK-1504	kuṣṭhaṃ gaṃdhakaviṣado triphalāpādaḥ samaḥ | bhṛgvāṃvumarditāhyete	kuṣṭham triphalā pādaḥ samaḥ 
SA_MB_kakacandesvarimataHK-1505	mudgamāṣavaṭī kṛtvāḥ | jvaraṃ haṃtyaṣṭabhiḥ yāmehyaṣṭa praharakāni vā |	mudga māṣa vaṭī kṛtvāḥ jvaram haṃti aṣṭabhiḥ yāmehi aṣṭa praharakāni vā 
SA_MB_kakacandesvarimataHK-1506	iti śrīkākacaṇḍeśvarīmataṃ samāptam ||	iti śrī kākacaṇḍeśvarīmatam samāptam 
SA_MB_kakacandesvarimataHK-1507	śubhamastu sadā || śubhaṃ ||	śubham astu sadā śubham 
SA_MB_kakacandesvarimataHK-1508	MUKTABODHA INDOLOGICAL RESEARCH INSTITUTE©2011 Muktabodha Indological Research Institute  All Rights Reserved.E-texts may be viewed only online or downloaded for private study.E-texts may not, under any circumstances, be copied, republished,reproduced, distributed or sold, either in original or altered form, withoutthe express permission of Muktabodha Indological Research Institute in writing.Data-entered by the staff of Muktabodha under the direction of Mark S. G. Dyczkowski.	muktabodha indological research muktabodha indological research institute all rights reserved texts may be viewed only online or downloaded for private studye texts may not under any circumstances be copied republished reproduced distributed or sold either in original or altered form withoutthe express permission of muktabodha indological research institute in writing data entered by the staff of muktabodha under the direction of mark s g dyczkowski 
