segmentnr	original	analyzed
SA_MBP_araatrisikaavivrttiHK-0	Muktabodha E-text in UTF-8	muktabodha etext in utf
SA_MBP_araatrisikaavivrttiHK-1	###########################################################################MUKTABODHA INDOLOGICAL RESEARCH INSTITUTEwww.muktabodha.org©2011 Muktabodha Indological Research Institute  All Rights Reserved.E-texts may be viewed only online or downloaded for private study.E-texts may not, under any circumstances, be copied, republished,reproduced, distributed or sold, either in original or altered form, withoutthe express permission of Muktabodha Indological Research Institute in writing.Data-entered by the staff of Muktabodha under the direction of Mark S. G. Dyczkowski.Catalog number : M00044	muktabodha indological research muktabodha indological research institute all rights reserved texts may be viewed only online or downloaded for private studye texts may not under any circumstances be copied republished reproduced distributed or sold either in original or altered form withoutthe express permission of muktabodha indological research institute in writing data entered by the staff of muktabodha under the direction of mark s g dyczkowskicatalog number  /
SA_MBP_araatrisikaavivrttiHK-2	Uniform title: parātriśikāvivṛti	uniform title parā triśikā vivṛti 
SA_MBP_araatrisikaavivrttiHK-3	Secondary title: parātriśikā	secondary title parā triśikā 
SA_MBP_araatrisikaavivrttiHK-4	Author : rājānakalakṣmirāma	authoḥ rāja ānaka lakṣmi rāma 
SA_MBP_araatrisikaavivrttiHK-5	Alternate name : lakṣmirāma	alternate name lakṣmirāma 
SA_MBP_araatrisikaavivrttiHK-6	Editor : Zadoo J D	e t itoḥ j d 
SA_MBP_araatrisikaavivrttiHK-7	Description: These two texts have been transcribed from vol. 69 of the Kashmir Series of Texts and Studies.	description these two texts have been transcribed from vol of the kashmir series of texts and studies 
SA_MBP_araatrisikaavivrttiHK-8	Notes: The texts have been transcribed by the staff of Muktabodha under the direction of Mark S. G. Dyczkowski .  Revision 0 Jan 28, 2007	notes the texts have been transcribed by the staff of muktabodha under the direction of mark s g dyczkowski   revision  jan 
SA_MBP_araatrisikaavivrttiHK-9	Publisher : Research Department Jammu and Kashmir State	publisher research depatment jammu and kashmir state 
SA_MBP_araatrisikaavivrttiHK-10	Publication year : 1947	publication year 
SA_MBP_araatrisikaavivrttiHK-11	Publication city : Srinagar	publication citi srinagar 
SA_MBP_araatrisikaavivrttiHK-12	Publication country : India	publication country india 
SA_MBP_araatrisikaavivrttiHK-13	todvārā niṇeṃtumudyuktāḥ pātañjalahaṭhayogipūrvamīmāṃsakādayaḥ |	pātañjala haṭha yogi pūrva mīmāṃsaka ādayaḥ 
SA_MBP_araatrisikaavivrttiHK-14	bhairavabhaṭṭārakastu bhaktajanamanugrahītuṃ spandātmakena	bhairava bhaṭṭārakaḥ tu bhakta janam anugrahītum spanda ātmakena 
SA_MBP_araatrisikaavivrttiHK-15	parāpaśyantyādivākcatuṣṭayalakṣaṇena srotasā rājayogaśabdavācyena	parāpaśyantī ādi vāc catuṣṭaya lakṣaṇena srotasā rājayoga śabda vācyena 
SA_MBP_araatrisikaavivrttiHK-16	jñānakriyāśaktisaṃghaṭṭātmakena	jñāna kriyā śakti saṃghaṭṭa ātmakena 
SA_MBP_araatrisikaavivrttiHK-17	akārādihakārāntavarṇavikāsatmakamadhijigamiṣatā anuttarākhyaṃ	akāra ādi hakāra anta varṇa vikāsa tmakam adhijigamiṣatā anuttara ākhyam 
SA_MBP_araatrisikaavivrttiHK-18	jñānakriyātmakamadhvānamupadidikṣati bhairavīpraśnaprastāvanayā | tathā ca	jñāna kriyā ātmakam adhvānam upadidikṣati bhairavī praśna prastāvanayā tathā ca 
SA_MBP_araatrisikaavivrttiHK-19	śrutiḥ  catvāri vākparimitā padāni tāni vidurbrāhmaṇā ye  manīṣiṇaḥ | guhā	śrutiḥ catvāri vāc parimitā padāni tāni viduḥ brāhmaṇāḥ ye manīṣiṇaḥ guhā 
SA_MBP_araatrisikaavivrttiHK-20	trīṇi nihitā neṅgayanti turīyaṃ vāco manuṣyā vadanti || iti	trīṇi nihitā na iṅgayanti turīyam vācaḥ manuṣyāḥ vadanti iti 
SA_MBP_araatrisikaavivrttiHK-21	śrībhairavī	śrī bhairavī 
SA_MBP_araatrisikaavivrttiHK-22	anuttaraṃ kathaṃ deva sadyaḥ kaulikasiddhidam |	anuttaram katham deva sadyas kaulika siddhi dam 
SA_MBP_araatrisikaavivrttiHK-23	yena vijñātamātreṇa khecarīsamatāṃ brajet || 1 ||	yena vijñāta mātreṇa khecarī sama tām brajet 
SA_MBP_araatrisikaavivrttiHK-24	bhoḥ deva anuttaraṃ na vidyate prakṛṣṭamuttaraṃ yatastadanuttaraṃ ciddhanaṃ	bhoḥ deva anuttaram na vidyate prakṛṣṭam uttaram yatas tat anuttaram ciddhanam 
SA_MBP_araatrisikaavivrttiHK-25	vastu kaulikasiddhidaṃ kule dehe bhavā kaulikī siddhiścidaikātmyaṃ tāṃ	vastu kaulika siddhi dam kule dehe bhavā kaulikī siddhiḥ cit aikātmyam tām 
SA_MBP_araatrisikaavivrttiHK-26	dadātīti tādṛśam kaulikīsiddhirjaḍasyāpi	dadāti iti tādṛśam kaulikī siddhiḥ jaḍasya api 
SA_MBP_araatrisikaavivrttiHK-27	dehādeścidaikātmyapratipattidārḍhyaṃ jīvanmuktiḥ |	deha ādeḥ cit aikātmya pratipatti dārḍhyam jīvanmuktiḥ 
SA_MBP_araatrisikaavivrttiHK-28	uktaṃ ca  	uktam ca 
SA_MBP_araatrisikaavivrttiHK-29	dehādiṣu cetyamāneṣvapi cidaikātmyapratipattidārḍhyaṃ jīvanmuktiḥ	deha ādiṣu cetyamāneṣu api cit aikātmya pratipatti dārḍhyam jīvanmuktiḥ 
SA_MBP_araatrisikaavivrttiHK-30	(śaktisū0 16)	śakti sū 
SA_MBP_araatrisikaavivrttiHK-31	kathaṃ kena prakāreṇa bhavet sadya iti parijñānakṣaṇa eva | tamupāyaṃ vada	katham kena prakāreṇa bhavet sadyas iti parijñāna kṣaṇe eva tam upāyam vada 
SA_MBP_araatrisikaavivrttiHK-32	ityarthaḥ | yena upāyana anubhūtamātreṇa ayaṃ naraḥ khecarīsamatāṃ	iti arthaḥ yena upāyana anubhūta mātreṇa ayam naraḥ khecarī sama tām 
SA_MBP_araatrisikaavivrttiHK-33	khecarīṇāṃ tava cidekarūpasya śaktīnāṃ sāmyaṃ svātantryarūpamāpnoti	khecarīṇām tava cit eka rūpasya śaktīnām sāmyam svātantrya rūpam āpnoti 
SA_MBP_araatrisikaavivrttiHK-34	mukto bhavatītyarthaḥ || 1 ||	muktaḥ bhavati iti arthaḥ 
SA_MBP_araatrisikaavivrttiHK-35	etadguhyaṃ mahāguhyaṃ kathayasva mama prabho |	etat guhyam mahā guhyam kathayasva mama prabho 
SA_MBP_araatrisikaavivrttiHK-36	hṛdayasthā tu yā śaktiḥ kaulikī kulanāyikā || 2 ||	hṛdaya sthā tu yā śaktiḥ kaulikī kula nāyikā 
SA_MBP_araatrisikaavivrttiHK-37	tāṃ me kathaya deveśa yena tṛptiṃ labhāmyaham |	tām me kathaya deveśa yena tṛptim labhāmi aham 
SA_MBP_araatrisikaavivrttiHK-38	yadyapyetat guhyaṃ gopyaṃ tato'pi mahāguhyaṃ guhyataraṃ he prabho	yadi api etat guhyam gopyam tatas upi mahā guhyam guhyataram he prabho 
SA_MBP_araatrisikaavivrttiHK-39	prabhavanaśīla! tadapi mama tvadabhinnāyāḥ kathayasva vaikharīvācā bodhaya	prabhavana śīla tat api mama tvad abhinnāyāḥ kathayasva vaikharī vācā bodhaya 
SA_MBP_araatrisikaavivrttiHK-40	bhaktānugrahārtham | vaikharīlakṣaṇaṃ tu vākyapadīye	          tu   
SA_MBP_araatrisikaavivrttiHK-41	sthāneṣu vivṛte vāyau kṛtavarṇaparigrahā |	sthāneṣu vivṛte vāyau kṛta varṇa parigrahā 
SA_MBP_araatrisikaavivrttiHK-42	vaikharīvākprayoktṛṇāṃ prāṇavṛttinibandhanā ||	              
SA_MBP_araatrisikaavivrttiHK-43	iti | tathā yā cicchaktirhṛdayasthā hṛdaye sthitā kaulikī dehādivyāptrī	iti tathā yā cicchaktiḥ hṛdaya sthā hṛdaye sthitā kaulikī deha ādi vyāptrī 
SA_MBP_araatrisikaavivrttiHK-44	kulanāyikā kulasya dehasya nāyikā cidaikātmyopapādikā tāṃ śaktiṃ ca	kula nāyikā kulasya dehasya nāyikā cit aikātmya upapādikā tām śaktim ca 
SA_MBP_araatrisikaavivrttiHK-45	svarūpato me kathaya, he deva yena śrutena tṛptiṃ nirākāṅkṣatāṃ labhe'ham ||	svarūpataḥ me kathaya he deva yena śrutena tṛptim nirākāṅkṣa tām labhe ham 
SA_MBP_araatrisikaavivrttiHK-46	śrībhairavaḥ	           
SA_MBP_araatrisikaavivrttiHK-47	śṛṇu devi mahābhāge uttarasyāpyanuttaram || 3 ||	śṛṇu devi mahābhāge uttarasya api anuttaram 
SA_MBP_araatrisikaavivrttiHK-48	kauliko'yaṃ vidhirdevi mama hṛdvyomnyavasthitaḥ |	kaulikaḥ ayam vidhiḥ devi mama hṛd vyomni avasthitaḥ 
SA_MBP_araatrisikaavivrttiHK-49	kathayāmi sureśāni sadyaḥ kaulikasiddhidam || 4 ||	kathayāmi sureśāni sadyas kaulika siddhi dam 
SA_MBP_araatrisikaavivrttiHK-50	he devi! uttarasya citprakāśasya api yadanuttaramutkṛṣṭaṃ vimarśātmakaṃ	he devi uttarasya cit prakāśasya api yat anuttaram utkṛṣṭam vimarśa ātmakam 
SA_MBP_araatrisikaavivrttiHK-51	svarūpaṃ tat śṛṇu | ayaṃ vidhirupāyaḥ kauliko jaḍasya	svarūpam tat śṛṇu ayam vidhiḥ upāyaḥ kaulikaḥ jaḍasya 
SA_MBP_araatrisikaavivrttiHK-52	dehādeścidekarūpatāsaṃpādakaḥ, agniriva āyasapiṇḍasya agnitopapādakaḥ |	deha ādeḥ cit eka rūpa tā saṃpādakaḥ agniḥ iva āyasa piṇḍasya agni tā upapādakaḥ 
SA_MBP_araatrisikaavivrttiHK-53	kintu adyāvadhi kenāpi na pṛṣṭo'yaṃ vidhiḥ, ato mama hṛdvyomni eva avasthito	kintu adya avadhi kena api na pṛṣṭaḥ yam vidhiḥ atas mama hṛd vyomni eva 
SA_MBP_araatrisikaavivrttiHK-54	na vahiḥ prakāśitaḥ, sadyaḥ kaulikasiddhidaṃ	na vahis prakāśitaḥ sadyas kaulika siddhi dam 
SA_MBP_araatrisikaavivrttiHK-55	dehādeścidaikātmyopapādakamupāyaṃ kathayāmi vravīmi || 4 ||	deha ādeḥ cit aikātmya upapādakam upāyam kathayāmi vravīmi 
SA_MBP_araatrisikaavivrttiHK-56	tadeva vaktumupakramate 	tat eva vaktum upakramate 
SA_MBP_araatrisikaavivrttiHK-57	athādyāstithayaḥ sarve svarā bindvavasānagāḥ |	atha ādyāḥ tithayaḥ sarve svarāḥ bindu avasāna gāḥ 
SA_MBP_araatrisikaavivrttiHK-58	tadantaḥ kālayogena somasūryau prakīrtitau || 5 ||	tad antaḥ kāla yogena soma sūryau prakīrtitau 
SA_MBP_araatrisikaavivrttiHK-59	atha ityupakrame ādyā akārādyā bindvavasānagā aṃkāraparyantāstithayaḥ	atha iti upakrame ādyāḥ akāra ādyāḥ bindu avasāna gāḥ aṃkāra paryantāḥ tithayaḥ 
SA_MBP_araatrisikaavivrttiHK-60	pañcadaśa varṇāḥ svarāstatsaṃśakāḥ tadantaḥ teṣāṃ varṇānāṃ	pañcadaśa varṇāḥ svarāḥ tad saṃśakāḥ tad antaḥ teṣām varṇānām 
SA_MBP_araatrisikaavivrttiHK-61	uccāramadhye kālayogena  kālaḥ kalanā sūkṣmakriyāśaktistasya yogena	uccāra madhye kāla yogena kālaḥ kalanā sūkṣma kriyāśaktiḥ tasya yogena 
SA_MBP_araatrisikaavivrttiHK-62	sambandhena	sambandhena 
SA_MBP_araatrisikaavivrttiHK-63	prāk saṃvit prāṇe pariṇatā	prāk saṃvid prāṇe pariṇatā 
SA_MBP_araatrisikaavivrttiHK-64	ityukteḥ, somasūryau prāṇāpānau prakīrtitau pravṛttihetū proktau | athaca	iti ukteḥ soma sūryau prāṇa apānau prakīrtitau pravṛtti hetū proktau atha ca 
SA_MBP_araatrisikaavivrttiHK-65	tithayaḥ pratipadādyāḥ sūryācandramasoḥ sannikarṣavikarṣābhyāṃ	tithayaḥ pratipad ādyāḥ sūryācandramasoḥ sannikarṣa vikarṣābhyām 
SA_MBP_araatrisikaavivrttiHK-66	kālayogena ca pravartante iti bāhyo'rthaḥ śliṣṭaḥ sugamaḥ || 5 ||	kāla yogena ca pravartante iti bāhyaḥ arthaḥ śliṣṭaḥ sugamaḥ   
SA_MBP_araatrisikaavivrttiHK-67	atha varṇānāṃ vācyavācakatayā sarvātmakatvaṃ vaktuṃ prakramate 	atha varṇānām vācya vācaka tayā sarva ātmaka tvam vaktum prakramate 
SA_MBP_araatrisikaavivrttiHK-68	pṛthivyādīni tattvāni puruṣāntāni pañcasu |	pṛthivī ādīni tattvāni puruṣa antāni pañcasu 
SA_MBP_araatrisikaavivrttiHK-69	kramāt kādiṣu varṇeṣu makārānteṣu suvrate || 6 ||	kramāt kādiṣu varṇeṣu makāra anteṣu suvrate 
SA_MBP_araatrisikaavivrttiHK-70	akārādivisargāntaṃ śivatattvaṃ kādiṅāntaṃ dharādinabhontaṃ	akāra ādi visarga antam śiva tattvam kādi ṅā antam dharā ādi nabhaḥ ntam 
SA_MBP_araatrisikaavivrttiHK-71	bhūtapañcakaṃ, cādiñāntaṃ gandhādiśabdāntaṃ tanmātrapañcakam,	bhūta pañcakam ca ādi ñā antam gandha ādi śabda antam tanmātra pañcakam 
SA_MBP_araatrisikaavivrttiHK-72	ṭādiṇāntaṃ pādādivāgantaṃ karmākṣapañcakam, tādināntaṃ ghrāṇādi	ṭādi ṇa antam pāda ādi vāc antam karma akṣa pañcakam tādi na antam ghrāṇa ādi 
SA_MBP_araatrisikaavivrttiHK-73	śrotrāntaṃ dhīndriyapañcakam, pādimāntaṃ	śrotra antam dhīndriya pañcakam 
SA_MBP_araatrisikaavivrttiHK-74	mano'haṅkārabuddhiprakṛtipuruṣākhyapañcakam || 6 ||	manaḥ haṅkāra buddhi prakṛti puruṣa ākhya pañcakam 
SA_MBP_araatrisikaavivrttiHK-75	vāyvāgnisalilendrāṇāṃ dhāraṇānāṃ catuṣṭayam |	vāyu āgni salila indrāṇām dhāraṇānām catuṣṭayam 
SA_MBP_araatrisikaavivrttiHK-76	tadūrdhvaṃ śādi vikhyātaṃ purastādbrahmapañcakam || 7 ||	tad ūrdhvam śādi vikhyātam purastāt brahmapañcakam 
SA_MBP_araatrisikaavivrttiHK-77	vāyavī- āgneyī  vāruṇī- aindrī  (pārthivī) dhāraṇāstāsāṃ	vāyavī āgneyī vāruṇī aindrī pārthivī dhāraṇāḥ tāsām 
SA_MBP_araatrisikaavivrttiHK-78	sthānavācakaṃ yādi catuṣṭayaṃ, tadūrdhvaṃ śādīnāṃ pañcānāṃ	sthāna vācakam ya ādi catuṣṭayam tad ūrdhvam śa ādīnām pañcānām 
SA_MBP_araatrisikaavivrttiHK-79	brahmapañcakaṃ īśānatatpuruṣāghoravāmadevasadyojātākhyaṃ vikhyātaṃ	brahmapañcakam īśāna tatpuruṣa aghora vāmadeva sadyojāta ākhyam vikhyātam 
SA_MBP_araatrisikaavivrttiHK-80	vācyaṃ | paśyantyātmakasattvānuvṛttyā ya sparśaḥ, i rūpaṃ, la rasaḥ, va	vācyam sparśaḥ rūpam la rasaḥ 
SA_MBP_araatrisikaavivrttiHK-81	gandhaḥ, dehavyāpakasūryarūpapraṇavacintanaṃ pārthivīdhāraṇā,	                                     
SA_MBP_araatrisikaavivrttiHK-82	dakṣiṇapādāṅguṣṭhotthitakālāgnijvālābhirvāhyāntaradehasya	dakṣiṇa pāda aṅguṣṭha utthita kālāgni jvālābhiḥ vāhya antara dehasya 
SA_MBP_araatrisikaavivrttiHK-83	bhasmībhūtatvabhāvanāḥ āgneyī, caṇḍavāyunā śārīrabhasmano	bhasmībhūta tva bhāvanāḥ āgneyī caṇḍa vāyunā śārīra bhasmanaḥ 
SA_MBP_araatrisikaavivrttiHK-84	daśadiggatatvabhāvanaṃ vāyavī, dvādaśāntapatitena śāktāmṛtena	daśa diś gata tva bhāvanam vāyavī dvādaśānta patitena śākta amṛtena 
SA_MBP_araatrisikaavivrttiHK-85	tatsthānasya kṣālitattvabhāvanaṃ, tato jīvasya kuṇḍalinyā sahavyomasthitasya	tad sthānasya kṣāli tattva bhāvanam tatas jīvasya kuṇḍalinyā saha vyoma sthitasya 
SA_MBP_araatrisikaavivrttiHK-86	prāṇapratiṣṭhayā amṛtena hṛdyavatāraṇaṃ vāruṇīdhāraṇā || 7 ||	prāṇa pratiṣṭhayā amṛtena hṛdi avatāraṇam vāruṇī dhāraṇā 
SA_MBP_araatrisikaavivrttiHK-87	amūlā tatkramājjñeyā kṣāntā sṛṣṭirudāhṛtā |	amūlā tad kramāt jñeyā kṣā antā sṛṣṭiḥ udāhṛtā 
SA_MBP_araatrisikaavivrttiHK-88	akārādikṣakārāntā varṇasṛṣṭirvarṇakrameṇa amūlā akāramūlā	akāra ādi kṣakāra antā varṇa sṛṣṭiḥ varṇa krameṇa amūlā akāra mūlā 
SA_MBP_araatrisikaavivrttiHK-89	akārasamavāyikāraṇakā kathitā jñeyā | akārasya sarvavarṇātmakatvaṃ	akāra samavāyi kāraṇakā kathitā jñeyā akārasya sarva varṇa ātmaka tvam 
SA_MBP_araatrisikaavivrttiHK-90	śrutirāha 	śrutiḥ āha 
SA_MBP_araatrisikaavivrttiHK-91	akāro vai sarvā vāk saiṣā sparśoṣmabhirvyajyamānā bahnīrnānārūpā	akāraḥ vai sarvā vāc sā eṣā sparśa ūṣmabhiḥ vyajyamānā bahnīḥ nānā rūpā 
SA_MBP_araatrisikaavivrttiHK-92	bhavati |	bhavati 
SA_MBP_araatrisikaavivrttiHK-93	iti | gītāsvapi 	iti gītāsu api 
SA_MBP_araatrisikaavivrttiHK-94	akṣarāṇāmakāro'smi --------------------------------------- | (10|33)	akṣarāṇām akāraḥ asmi 
SA_MBP_araatrisikaavivrttiHK-95	iti tathāhi- parameśvarasya svātmavimarśaḥ a iti, tatraiva ānandaśaktiḥ, ā iti,	iti tathā hi parameśvarasya sva ātma vimarśaḥ a iti tatra eva ānanda śaktiḥ iti 
SA_MBP_araatrisikaavivrttiHK-96	pūrṇecchā i iti, icchājñānonmukheśanaṃ ī iti, bhāvonmeṣonmukhaṃ	pūrṇa icchā iti icchā jñāna unmukha īśanam iti bhāva unmeṣa unmukham 
SA_MBP_araatrisikaavivrttiHK-97	jñānaṃ u iti, anuttarasaṃvitsaṃkocādūnībhūtā ū iti, saiva	jñānam u iti anuttara saṃvid saṃkocāt ūnībhūtā iti sā eva 
SA_MBP_araatrisikaavivrttiHK-98	svarūpavismaraṇena sūnyībhūteva bahirmukhā ṝṛ iti, niścalaśunyatāptyā ḷ ḹ	sva rūpa vismaraṇena sūnyībhūtā iva bahirmukhā iti niścala śunya tā āptyā 
SA_MBP_araatrisikaavivrttiHK-99	iti, etaccatuṣkaṃ śūnyatvāptyā dagdhabījamiva ṣaṇṭharūpaṃ bhāṣyate, natu	iti etat catuṣkam śūnya tva āptyā dagdha bījam iva ṣaṇṭha rūpam bhāṣyate na tu 
SA_MBP_araatrisikaavivrttiHK-100	sarvathā bījatvavyapagamaḥ | anuttarānandayoriccheśanayośca mithaḥ saṃyoge e	sarvathā bīja tva vyapagamaḥ anuttara ānandayoḥ icchā īśanayoḥ ca mithas saṃyoge e 
SA_MBP_araatrisikaavivrttiHK-101	iti, uktaṃ ca 	iti uktam ca 
SA_MBP_araatrisikaavivrttiHK-102	avarṇa-ivarṇe e iti (kā0 vṛtti 1|2|2)	avarṇa aivarṇe e iti kā 
SA_MBP_araatrisikaavivrttiHK-103	(p. 6) tadevaṃ rūpamanuvasat ai iti, a ā u ū o iti, a ā o iti, au iti, unmeṣe'pi	tat evam rūpam anuvasat iti a ā u ū o iti a ā o iti au iti unmeṣe pi 
SA_MBP_araatrisikaavivrttiHK-104	vācyam | evamicchājñāne anuttarapadalīne bindumātraśeṣatayā aṃ iti, sa eva	vācyam evam icchā jñāne anuttara pada līne bindu mātra śeṣa tayā aṃ iti saḥ eva 
SA_MBP_araatrisikaavivrttiHK-105	parameśvaraḥ śāktavisargapradhānatayā aḥ iti | dharādiśaktyantaṃ	                                
SA_MBP_araatrisikaavivrttiHK-106	kādikṣāntavimarśaśaktiḥ ṣoḍaśī kalā iti gīyate |	           iti gīyate 
SA_MBP_araatrisikaavivrttiHK-107	uktaṃ ca tantrāloke	uktam ca tantrāloke 
SA_MBP_araatrisikaavivrttiHK-108	puruṣe ṣoḍaśakale tāmāhuḥ paramāṃ kalām |	puruṣe ṣoḍaśa kale tām āhuḥ paramām kalām 
SA_MBP_araatrisikaavivrttiHK-109	iti | akārasya ghanatvaṃ kavargaḥ kaṇṭhyatvāt, evaṃ ikārasya	iti akārasya ghana tvam kavargaḥ kaṇṭhya tvāt evam ikārasya 
SA_MBP_araatrisikaavivrttiHK-110	cavargastālavyatvāt, ukārasya pavarga auṣṭhyatvāt, ṛkārasya ṭavargo	cavargaḥ tālavya tvāt ukārasya pavargaḥ auṣṭhya tvāt ṛkārasya ṭavargaḥ 
SA_MBP_araatrisikaavivrttiHK-111	mūrdhanyatvāt, ḷkārasya tavargo dantyatvāt, yaśau cavargasyāntaḥ raṣau	mūrdhanya tvāt ḷkārasya tavargaḥ dantya tvāt ya śau cavargasya antaḥ ra ṣau 
SA_MBP_araatrisikaavivrttiHK-112	ṭavargasya lasau tavargasya, vakāro'pi tapavargayārdhanatā | evamamūrtasyāpi	ṭavargasya la sau tavargasya evam amūrtasya api 
SA_MBP_araatrisikaavivrttiHK-113	ciddhanasya kriyāśaktirūpataiva, svarāḥ śivabījātmakāḥ śāktarūpaṃ kusu	ciddhanasya kriyāśakti rūpa tā eva svarāḥ śiva bīja ātmakāḥ śākta rūpam kusu 
SA_MBP_araatrisikaavivrttiHK-114	matayā tiṣṭhantaḥ kādayaḥ kṣāntā yonirityabhidhīyate, evaṃ varṇānāṃ	matayā tiṣṭhantaḥ ka ādayaḥ kṣāntāḥ yoniḥ iti abhidhīyate evam varṇānām 
SA_MBP_araatrisikaavivrttiHK-115	ghanībhāvo'parāvākvapuṣi tiṣṭhan vaikharīrūpaṃ sphuṭī bhavati || 8 ||	tiṣṭhan vaikharī rūpam sphuṭī bhavati 
SA_MBP_araatrisikaavivrttiHK-116	sarveṣāmeva mantrāṇāṃ vidyānāṃ ca yaśasvini || 8 ||	sarveṣām eva mantrāṇām vidyānām ca yaśasvini 
SA_MBP_araatrisikaavivrttiHK-117	iyaṃ yoni samākhyātā sarvatantreṣu sarvathā |	iyam samākhyātā sarva tantreṣu sarvathā 
SA_MBP_araatrisikaavivrttiHK-118	iyaṃ varṇasṛṣṭirādiḥ kṣāntā, yonirutpattikāraṇam | uktaṃ ca	iyam varṇa sṛṣṭiḥ ādiḥ kṣā antā yoniḥ utpatti kāraṇam uktam ca 
SA_MBP_araatrisikaavivrttiHK-119	mahārthamañjaryām	mahārthamañjaryām 
SA_MBP_araatrisikaavivrttiHK-120	mananamaye nijavibhave	            
SA_MBP_araatrisikaavivrttiHK-121	nijasaṅkocabhaye trāṇamayī |	nija saṅkoca bhaye trāṇa mayī 
SA_MBP_araatrisikaavivrttiHK-122	kavalitaviśvavikalpā	kavalita viśva vikalpā 
SA_MBP_araatrisikaavivrttiHK-123	anubhūtiḥ kāpi mantraśabdārthaḥ ||	anubhūtiḥ kā api mantra śabda arthaḥ 
SA_MBP_araatrisikaavivrttiHK-124	iti || 8 ||	iti 
SA_MBP_araatrisikaavivrttiHK-125	(p. 7) atha mahāmantrasyoddhāramāha 	atha mahāmantrasya uddhāram āha 
SA_MBP_araatrisikaavivrttiHK-126	caturdaśayutaṃ bhadre tithīśāntasamanvitam || 9 ||	caturdaśa yutam bhadre tithi īśa anta samanvitam 
SA_MBP_araatrisikaavivrttiHK-127	tṛtīyaṃ brahma suśroṇi hṛdayaṃ bhairavātmanaḥ |	tṛtīyam brahma suśroṇi hṛdayam bhairava ātmanaḥ 
SA_MBP_araatrisikaavivrttiHK-128	aghora iti tryakṣaraṃ svareṣu vartamānaṃ, tṛtīyaṃ brahma aghorākhyaṃ	aghoraḥ iti tri akṣaram svareṣu vartamānam tṛtīyam brahma aghora ākhyam 
SA_MBP_araatrisikaavivrttiHK-129	yat caturdaśasvareṣu yutaṃ saṃbaddhaṃ sa akāraḥ tithiḥ pañcadaśaḥ svaraḥ	yat caturdaśa svareṣu yutam saṃbaddham sa akāraḥ tithiḥ pañcadaśaḥ svaraḥ 
SA_MBP_araatrisikaavivrttiHK-130	aṃkāraḥ tena yutaścāsau śāntaḥ śavargānto dvaḥ tena ahamiti yo vimarśaḥ	aṃkāraḥ tena yutaḥ ca asau śāntaḥ śavarga antaḥ dvaḥ tena aham iti yaḥ vimarśaḥ 
SA_MBP_araatrisikaavivrttiHK-131	paśyantīvāgrūpaḥ	paśyantī vāc rūpaḥ 
SA_MBP_araatrisikaavivrttiHK-132	vākyapadīye 	vākyapadīye 
SA_MBP_araatrisikaavivrttiHK-133	avibhāgā tu paśyantī sarvataḥ saṃhṛtakramaḥ |	avibhāgā tu paśyantī sarvatas saṃhṛta kramaḥ 
SA_MBP_araatrisikaavivrttiHK-134	svarūpajyotirevāntaḥ sūkṣmā vāganapāyinī ||	sva rūpa jyotiḥ eva antar sūkṣmā vāc anapāyinī 
SA_MBP_araatrisikaavivrttiHK-135	ityevaṃ lakṣitaḥ tat	iti evam lakṣitaḥ tat 
SA_MBP_araatrisikaavivrttiHK-136	parā brahmaiva kevalā |	parā brahma eva kevalā 
SA_MBP_araatrisikaavivrttiHK-137	ityukteḥ parāvāgrūpasya bhairavātmanaḥ sarvavyāpakasya citprakāśasya	iti ukteḥ parā vāc rūpasya bhairava ātmanaḥ sarva vyāpakasya cit prakāśasya 
SA_MBP_araatrisikaavivrttiHK-138	hṛdayaṃ sārabhūto mahāmantraḥ | tithī kṛdikārādaktinaḥ (ga0 pā0 50 sū0) iti	hṛdayam sāra bhūtaḥ mahā mantraḥ tithī ga pā      
SA_MBP_araatrisikaavivrttiHK-139	vāḍīp || yathā rajanī iti | uktaṃ ca 	vāḍīp yathā rajanī iti uktam ca 
SA_MBP_araatrisikaavivrttiHK-140	prakāśasyātmaviśrāntirahaṃbhāvo hi kīrtitaḥ | (a0 pra0 si0 22)	prakāśasya ātma viśrāntiḥ ahaṃbhāvaḥ hi kīrtitaḥ a pra si 
SA_MBP_araatrisikaavivrttiHK-141	iti | tathā 	iti tathā 
SA_MBP_araatrisikaavivrttiHK-142	sā sphurattā mahāsattā -------------------------- |	sā sphurat tā mahā sattā 
SA_MBP_araatrisikaavivrttiHK-143	iti	iti 
SA_MBP_araatrisikaavivrttiHK-144	--------------------------- hṛdayaṃ parameṣṭhinaḥ | (ī0 pra0 1|5|14)	hṛdayam parameṣṭhinaḥ ī pra 
SA_MBP_araatrisikaavivrttiHK-145	iti ca | tathā 	iti ca tathā 
SA_MBP_araatrisikaavivrttiHK-146	svabhāvamavabhāsasya vimarśaṃ viduranyathā |	svabhāvam avabhāsasya vimarśam viduḥ anyathā 
SA_MBP_araatrisikaavivrttiHK-147	(p. 8) prakāśo'rthoparakto'pi sphuṭikādijaḍopamaḥ || (ī0 pra0 1 | 5 | 11 )	prakāśa ūrtha uparaktaḥ api sphuṭika ādi jaḍa upamaḥ 
SA_MBP_araatrisikaavivrttiHK-148	iti | athaca tṛtīyaṃ brahma aghoramantraḥ citparāmarśayuto bhairavātmanaḥ	iti atha ca tṛtīyam brahma aghora mantraḥ cit parāmarśa yutaḥ bhairava ātmanaḥ 
SA_MBP_araatrisikaavivrttiHK-149	svacchandabhairavasya hṛdayaṃ sārabhūto mahāmantraḥ || 9 ||	svacchanda bhairavasya hṛdayam sāra bhūtaḥ mahā mantraḥ 
SA_MBP_araatrisikaavivrttiHK-150	etannāyoginījāto nārudro labhate sphuṭam || 10 ||	etat na a yoginī jātaḥ na a rudraḥ labhate sphuṭam 
SA_MBP_araatrisikaavivrttiHK-151	hṛdayaṃ devadevasya sadyo yogavimokṣadam |	hṛdayam devadevasya sadyas yoga vimokṣa dam 
SA_MBP_araatrisikaavivrttiHK-152	etadahantāparāmarśātmakaṃ sarvavedyaṃ kimapi paramaṃ hṛdayaṃ	etat ahantā parāmarśa ātmakam sarva vedyam kim api paramam hṛdayam 
SA_MBP_araatrisikaavivrttiHK-153	rahasyabhūtaṃ devadevasya cidātmano nārudro yoginīvyatiriktajāto na sphuṭaṃ	rahasya bhūtam devadevasya cit ātmanaḥ na arudraḥ yoginī vyatirikta jātaḥ na sphuṭam 
SA_MBP_araatrisikaavivrttiHK-154	labhate nopalabhate | yaśca rudrāṃśo bhāvibhairavībhāvo na syāt sa ca	labhate na upalabhate yaḥ ca rudra aṃśaḥ bhāvi bhairavībhāvaḥ na syāt sa ca 
SA_MBP_araatrisikaavivrttiHK-155	nopalabhate | sphuṭamiti dehāhaṃbhāvanyakkāreṇa citpradhānyena yaccopalabhate	na upalabhate sphuṭam iti deha ahaṃbhāva nyakkāreṇa cit pradhānyena yat ca upalabhate 
SA_MBP_araatrisikaavivrttiHK-156	sa yoginījāto rudrāṃśaśca pratyāsannabhairavībhāvaḥ sadyo lābhakṣaṇa eva	sa yoginī jātaḥ rudra aṃśaḥ ca pratyāsanna bhairavībhāvaḥ sadyas lābha kṣaṇe eva 
SA_MBP_araatrisikaavivrttiHK-157	yogavimokṣadaṃ yogaścidātmasamāpattirvimokṣaścidekamayatā tadddātīti || 10	yoga vimokṣa dam yogaḥ cit ātma samāpattiḥ vimokṣaḥ cit eka maya tā tat ddāti iti 
SA_MBP_araatrisikaavivrttiHK-158	paśyantīvācoccāre kṛte'sya mahimānamāha 	paśyantī vācā uccāre kṛta isya mahimānam āha 
SA_MBP_araatrisikaavivrttiHK-159	asyoccāre kṛte samyaṅmantramudrāgaṇo mahān || 11 ||	asya uccāre kṛte samyak mantra mudrā gaṇaḥ mahān 
SA_MBP_araatrisikaavivrttiHK-160	sadyastanmukhatāmeti svadehāveśalakṣaṇam |	sadyas tad mukha tām eti sva deha āveśa lakṣaṇam 
SA_MBP_araatrisikaavivrttiHK-161	asya mahāmantrasya ahamityevaṃlakṣaṇasya aghoramantrasya ca uccāre avirataṃ	asya mahāmantrasya aham iti evaṃlakṣaṇasya aghora mantrasya ca uccāre aviratam 
SA_MBP_araatrisikaavivrttiHK-162	tattaddevatānusaṃdhānena parāmarśe samyāgiti	tad tad devatā anusaṃdhānena parāmarśe samyāk iti 
SA_MBP_araatrisikaavivrttiHK-163	dehāhaṃbhāvavismaraṇapūrvaṃ citpradhānyena kṛte sati mantramudrāgaṇo	deha ahaṃbhāva vismaraṇa pūrvam cit pradhānyena kṛte sati 
SA_MBP_araatrisikaavivrttiHK-164	mahān mantramudrādevatāsamūhaḥ sadyo vimarśakṣaṇa eva tanmukhatāṃ	mahān mantra mudrā devatā samūhaḥ sadyas vimarśa kṣaṇaḥ eva tad mukha tām 
SA_MBP_araatrisikaavivrttiHK-165	tasya yoginaḥ saṃmukhatvameti, kathaṃ svadehāveśa lakṣaṇaṃ svadehe yogidehe	tasya yoginaḥ saṃmukha tvam eti katham sva deha āveśa lakṣaṇam sva dehe yogi dehe 
SA_MBP_araatrisikaavivrttiHK-166	āveśo devānāṃ lakṣaṇaṃ lakṣma yatra saṃmukhatvaprāptau || 11 ||	āveśaḥ devānām lakṣaṇam lakṣma yatra saṃmukha tva prāptau 
SA_MBP_araatrisikaavivrttiHK-167	(p. 9) atha samādheḥ samayogena prabhāvamāha 	atha samādheḥ sama yogena prabhāvam āha 
SA_MBP_araatrisikaavivrttiHK-168	muhūrta smarate yastu cummakenābhimudritaḥ || 12 ||	muhūrta smarate yaḥ tu cummakena abhimudritaḥ 
SA_MBP_araatrisikaavivrttiHK-169	saṃbadhnāti tadā sarvaṃ mantramudrāgaṇaṃ naraḥ |	saṃbadhnāti tadā sarvam mantra mudrā gaṇam naraḥ 
SA_MBP_araatrisikaavivrttiHK-170	atītānāgatānarthān pṛṣṭo'sau kathayatyapi || 13 ||	atīta anāgatān arthān pṛṣṭā asau kathayati api 
SA_MBP_araatrisikaavivrttiHK-171	yo yogī cumbakena śāktasparśena abhimudritaḥ saṃbaddho muhūrtaṃ	yaḥ yogī cumbakena śākta sparśena abhimudritaḥ saṃbaddhaḥ muhūrtam 
SA_MBP_araatrisikaavivrttiHK-172	ghaṭikāyugmaṃ cidātmānaṃ smarate nirantaraṃ ahamityevaṃ parāmṛśati, sa	ghaṭikā yugmam cit ātmānam smarate nirantaram aham iti evam parāmṛśati sa 
SA_MBP_araatrisikaavivrttiHK-173	eva naro mantramudrāgaṇaṃ mantrāṇāṃ mudrāṇāṃ ca devagaṇaṃ, tadā	eva naraḥ mantra mudrā gaṇam mantrāṇām mudrāṇām ca deva gaṇam tadā 
SA_MBP_araatrisikaavivrttiHK-174	svasvāmibhāvena saṃbadhnāti pratyakṣīkurute, sa eva vyutthāne kenacita	sva svāmi bhāvena saṃbadhnāti pratyakṣīkurute saḥ eva vyutthāne 
SA_MBP_araatrisikaavivrttiHK-175	śubhāśubhaṃ svasya jagato vā pṛṣṭaḥ san atītānāgatān	śubha aśubham svasya jagataḥ vā pṛṣṭaḥ san atīta anāgatān 
SA_MBP_araatrisikaavivrttiHK-176	bhūtabhaviṣyatkālena vyavahitān arthān prayojanāni kathayati tasya vāṇī na	bhūta bhaviṣyat kālena vyavahitān arthān prayojanāni kathayati tasya vāṇī na 
SA_MBP_araatrisikaavivrttiHK-177	vyabhicaratītyarthaḥ || 13 ||	vyabhicarati iti arthaḥ 
SA_MBP_araatrisikaavivrttiHK-178	praharādyadabhipretaṃ devatārūpamuccaran |	praharāt yat abhipretam devatā rūpam uccaran 
SA_MBP_araatrisikaavivrttiHK-179	sākṣātpaśyatyasaṃdigdhamākṛṣṭaṃ rudraśaktibhiḥ || 14 ||	sākṣāt paśyati asaṃdigdham ākṛṣṭam rudra śaktibhiḥ 
SA_MBP_araatrisikaavivrttiHK-180	praharāditi lyablope pañcamī, praharamātraṃ devatārūpaṃ	praharāt iti lyap lope pañcamī prahara mātram devatā rūpam 
SA_MBP_araatrisikaavivrttiHK-181	cidātmānamadhiṣṭhāya samuccaran parāmṛśan samādhistho yogī	cit ātmānam adhiṣṭhāya samuccaran parāmṛśan samādhi sthaḥ yogī 
SA_MBP_araatrisikaavivrttiHK-182	yadyadabhipretamabhimatamindrādidevatārūpaṃ syāt tattaddevatārūpa	yat yat abhipretam abhimatam indra ādi devatā rūpam syāt tat tad devatā rūpa 
SA_MBP_araatrisikaavivrttiHK-183	masaṃdigdhaṃ sākṣāt paśyati rudraśaktibhiḥ	sākṣāt paśyati rudra śaktibhiḥ 
SA_MBP_araatrisikaavivrttiHK-184	parameśaśaktiṃbhirvrāhmyādibhirākṛṣṭaṃ noditam || 14 ||	parameśa śaktiṃbhiḥ vrāhmī ādibhiḥ ākṛṣṭam na uditam 
SA_MBP_araatrisikaavivrttiHK-185	praharadvayamātreṇa vyomastho jāyate smaran |	prahara dvaya mātreṇa vyoma sthaḥ jāyate smaran 
SA_MBP_araatrisikaavivrttiHK-186	trayeṇa mātaraḥ sarvā yogeśvaryo mahābalāḥ || 15 ||	trayeṇa mātaraḥ sarvāḥ yoga īśvaryaḥ mahā balāḥ 
SA_MBP_araatrisikaavivrttiHK-187	vīrā vīreśvarāḥ siddhā balavāñcchākinīgaṇaḥ |	vīrāḥ vīra īśvarāḥ siddhāḥ balavān śākinī gaṇaḥ 
SA_MBP_araatrisikaavivrttiHK-188	āgatya samayaṃ labdhvā bhairaveṇa pracoditāḥ || 16 ||	āgatya samayam labdhvā bhairaveṇa pracoditāḥ 
SA_MBP_araatrisikaavivrttiHK-189	yacchanti paramāṃ siddhiṃ phalaṃ yadvā samīhitam |	yacchanti paramām siddhim phalam yat vā samīhitam 
SA_MBP_araatrisikaavivrttiHK-190	praharadvayaṃ cet smaran samādhau viśrānto yogī vyomastho jāyate khagatiṃ	prahara dvayam ced smaran samādhau viśrāntaḥ yogī vyoma sthaḥ jāyate khagatim 
SA_MBP_araatrisikaavivrttiHK-191	prāpnoti samādhiviśrāntatvāt, praharatrayaṃ cet samādhiviśrāntastadā	prāpnoti samādhi viśrānta tvāt prahara trayam ced samādhi viśrāntaḥ tadā 
SA_MBP_araatrisikaavivrttiHK-192	bhairavanāthādājñāmādāya tena preritā mātaro brāhmyādyāḥ	bhairava nāthāt ājñām ādāya tena preritāḥ mātaraḥ brāhmī ādyāḥ 
SA_MBP_araatrisikaavivrttiHK-193	pañcavidhakṛtakāriṇyaḥ vīrā yogino vīreśvarā yogīndrāḥ siddhāḥ	pañcavidha kṛta kāriṇyaḥ vīrāḥ yoginaḥ vīreśvarāḥ yogi indrāḥ siddhāḥ 
SA_MBP_araatrisikaavivrttiHK-194	kapilādayaḥ śaktinīgaṇo yoginīsamūhaḥ tasmai praharatrayaṃ samādhisthāya	kapila ādayaḥ śaktinī gaṇaḥ yoginī samūhaḥ tasmai prahara trayam samādhi sthāya 
SA_MBP_araatrisikaavivrttiHK-195	yogine samīpamāgatya paramāṃ pūrṇāṃ siddhiṃ svasyāḥ	yogine samīpam āgatya paramām pūrṇām siddhim svasyāḥ 
SA_MBP_araatrisikaavivrttiHK-196	prakṛteryatheṣṭaviniyoktṛtvalakṣaṇaṃ svātantryaṃ, tathā yadanyat kāṅkṣitaṃ	prakṛteḥ yathā iṣṭa viniyoktṛ tva lakṣaṇam svātantryam tathā yat anyat kāṅkṣitam 
SA_MBP_araatrisikaavivrttiHK-197	phalaṃ tad dāsyanti || 16 ||	phalam tat dāsyanti  /
SA_MBP_araatrisikaavivrttiHK-198	anena siddhāḥ setsyanti sādhayanti ca mantriṇaḥ || 17 ||	anena siddhāḥ setsyanti sādhayanti ca mantriṇaḥ 
SA_MBP_araatrisikaavivrttiHK-199	yat kiñcidbhairavetantre sarvamasmāt prasidhyati |	yat kiñcid bhairavetantre sarvam asmāt prasidhyati 
SA_MBP_araatrisikaavivrttiHK-200	anenaivāhamiti   cidānandaviśrāntilakṣaṇena samādhinā aghoramantreṇa ca	anena eva aham iti cit ānanda viśrānti lakṣaṇena samādhinā aghora mantreṇa ca 
SA_MBP_araatrisikaavivrttiHK-201	siddhā yogino janmamokṣānyataraparigrahe svatantrāḥ saṃpadyante sādhayanti	siddhāḥ yoginaḥ janma mokṣa anyatara parigrahe svatantrāḥ saṃpadyante sādhayanti 
SA_MBP_araatrisikaavivrttiHK-202	anyānapi siddhān saṃpādayiṣyanti | tathā asyaiva mahāmantropāsakasya yat	anyān api siddhān saṃpādayiṣyanti tathā asya eva mahā mantra upāsakasya yat 
SA_MBP_araatrisikaavivrttiHK-203	kiñcid bhairavetantre phalamuktaṃ tat sarvamasmāt mahāmantropāsanarūpāt	kiñcid bhairavetantre phalam uktam tat sarvam asmāt mahā mantra upāsana rūpāt 
SA_MBP_araatrisikaavivrttiHK-204	samādheraghoramantrataśca siddhyati || 17 ||	samādheḥ aghora mantrataḥ ca siddhi ati 
SA_MBP_araatrisikaavivrttiHK-205	adṛṣṭamaṇḍalo'pyevaṃ yaḥ kiñcidvetti tattvataḥ || 18 ||	adṛṣṭa maṇḍalaḥ api evam yaḥ kiñcid vetti tattvataḥ 
SA_MBP_araatrisikaavivrttiHK-206	sa siddhibhāg bhavennityaṃ sa yogī sa ca dīkṣitaḥ |	sa siddhi bhāj bhavet nityam sa yogī sa ca dīkṣitaḥ 
SA_MBP_araatrisikaavivrttiHK-207	yaḥ kiściditi varṇāśramavibhāgādhikāravyatiriktastattvato	yaḥ kiścid iti varṇa āśrama vibhāga adhikāra vyatiriktaḥ tattvataḥ 
SA_MBP_araatrisikaavivrttiHK-208	dehāhaṃbhāvanyakkāreṇa evaṃ uktaprakāreṇa mahāmantraṃ vetti,	deha ahaṃbhāva nyakkāreṇa evam ukta prakāreṇa mahāmantram vetti 
SA_MBP_araatrisikaavivrttiHK-209	so'dṛṣṭamaṇḍalo'pi dīkṣāvidhāne yat prayuktaṃ maṇḍalaṃ	dīkṣā vidhāne yat prayuktam maṇḍalam 
SA_MBP_araatrisikaavivrttiHK-210	kalaśayāgādidevatācakraṃ tat tenādṛṣṭamapi, evamīdṛśaḥ sannapi siddhibhāk	kalaśa yāga ādi devatā cakram tat tena adṛṣṭam api evam īdṛśaḥ san api siddhi bhāj 
SA_MBP_araatrisikaavivrttiHK-211	nityayogī dīkṣitaśca bhavati | uktaṃ ca 	nitya yogī dīkṣitaḥ ca bhavati uktam ca 
SA_MBP_araatrisikaavivrttiHK-212	svasvarūpaparijhānaṃ mantro'yaṃ pāramārthikaḥ |	sva svarūpa parijhānam mantraḥ yaḥ pāramārthikaḥ 
SA_MBP_araatrisikaavivrttiHK-213	p. 11) dīkṣeyameṣa yogaśca kriyāyā apyanuttaraḥ ||	dīkṣā iyam eṣa yogaḥ ca kriyāyāḥ api anuttaraḥ 
SA_MBP_araatrisikaavivrttiHK-214	iti | yogo navanābhasaṃjñaḥ, kalaśamaṇḍalājhisādhana  carusādhana 	iti yogaḥ navanābha saṃjñaḥ kalaśa maṇḍala ajhi sādhana caru sādhana 
SA_MBP_araatrisikaavivrttiHK-215	śiṣyasaṃskāra  nyāsavidhāna  pāśasūtrasaṃskāra  svapnaparīkṣā 	śiṣya saṃskāra nyāsa vidhāna pāśa sūtra saṃskāra svapna parīkṣā 
SA_MBP_araatrisikaavivrttiHK-216	yāgavidhāna  rudrāṃśāpādana  kalāpañcakaśodhana 	              
SA_MBP_araatrisikaavivrttiHK-217	yojanikopadeśābhiṣeka  pavitrārohaṇa  visarjanāntāyāḥ kriyāyāḥ	yojanikā upadeśa abhiṣeka pavitra ārohaṇa visarjana antāyāḥ kriyāyāḥ 
SA_MBP_araatrisikaavivrttiHK-218	karmānuṣṭhānādapi anuttaro'tyutkṛṣṭaḥ || 18 ||	karma anuṣṭhānāt api 
SA_MBP_araatrisikaavivrttiHK-219	anena jñātamatreṇa jñāyate sarvaśaktibhiḥ || 19 ||	anena jñāta matreṇa jñāyate sarva śaktibhiḥ 
SA_MBP_araatrisikaavivrttiHK-220	śākinīkulasāmānyo bhavedyogaṃ vināpi hi |	śākinī kula sāmānyaḥ bhavet yogam vinā api hi 
SA_MBP_araatrisikaavivrttiHK-221	avidhijño vidhānajño jāyate yajanaṃ prati || 20 ||	a vidhi jñaḥ vidhāna jñaḥ jāyate yajanam prati 
SA_MBP_araatrisikaavivrttiHK-222	anena mahāmantreṇa bhairaveśvarasya sarvābhiḥ śaktibhirjñāyate	anena mahāmantreṇa bhairava īśvarasya sarvābhiḥ śaktibhiḥ jñāyate 
SA_MBP_araatrisikaavivrttiHK-223	svakīyatve saḥ, tathā yogaṃ vināpi vyutthāne vartamānaḥ	svakīya tve saḥ tathā yogam vinā api vyutthāne vartamānaḥ 
SA_MBP_araatrisikaavivrttiHK-224	śākinīkulasāmānyaḥ śākinīkulasya yoginīgaṇasya sāmānyaḥ sādhāraṇaḥ	śākinī kula sāmānyaḥ śākinī kulasya yoginī gaṇasya sāmānyaḥ sādhāraṇaḥ 
SA_MBP_araatrisikaavivrttiHK-225	krīḍanako bhavet | pūrvamavidhijño'pi anenaiva mahāmantreṇa jñātena	krīḍanakaḥ bhavet pūrvam avidhi jñaḥ api anena eva mahāmantreṇa jñātena 
SA_MBP_araatrisikaavivrttiHK-226	dīkṣāyā yajanaṃ prati vidhānajño jāyate || 20 ||	dīkṣāyāḥ yajanam prati vidhāna jñaḥ jāyate 
SA_MBP_araatrisikaavivrttiHK-227	kālāgnimāditaḥ kṛtvā māyāntaṃ brahmadehagam |	kālāgnim āditas kṛtvā māyā antam brahma deha gam 
SA_MBP_araatrisikaavivrttiHK-228	śivo viśvādyanantāntaḥ paraṃ śaktitrayaṃ matam || 21 ||	śivaḥ viśva ādi ananta antar param śakti trayam matam 
SA_MBP_araatrisikaavivrttiHK-229	nivṛttikalāyāḥ pādāgrādgulphāntaṃ vyāptiḥ tatraiva bhūtattvasthitiḥ	                                               
SA_MBP_araatrisikaavivrttiHK-230	brahmaṇo'dhikṛtiḥ | pratiṣṭhāyā gulphānnābhyantaṃ vyāptiḥ tatra	brahmaṇā adhikṛtiḥ pratiṣṭhāyāḥ gulphāt nābhi antam vyāptiḥ tatra 
SA_MBP_araatrisikaavivrttiHK-231	jalatattvamārabhya prakṛtitattvāntaṃ caturviṃśatitattvasthitiḥ tatra	jala tattvam ārabhya prakṛti tattva antam caturviṃśati tattva sthitiḥ tatra 
SA_MBP_araatrisikaavivrttiHK-232	viṣṇoradhikṛtiḥ | vidyāyā nābhestālvantaṃ vyāptiḥ, tatra puruṣatattvamārabhya	viṣṇoḥ adhikṛtiḥ vidyāyāḥ nābheḥ tālu antam vyāptiḥ tatra puruṣa tattvam ārabhya 
SA_MBP_araatrisikaavivrttiHK-233	māyātattvāntaṃ saptatattvasthitiḥ, tatra rudrasyādhikṛtiḥ |	                         
SA_MBP_araatrisikaavivrttiHK-234	śāntākalāyāstāluno bindvantaṃ vyāptiḥ tatra śuddhavidyāditattvatrayasthitiḥ,	                                        
SA_MBP_araatrisikaavivrttiHK-235	tatra īśvarasyādhikṛtiḥ |	tatra īśvarasya adhikṛtiḥ 
SA_MBP_araatrisikaavivrttiHK-236	puruṣaniyatikālarāgavidyākalāmāyātattvāni sapta,	puruṣa niyati kāla rāga vidyā kalā māyā tattvāni sapta 
SA_MBP_araatrisikaavivrttiHK-237	śuddhavidyātattveśvaratattvasadāśivākhyāni trīṇi tattvāni, bhūtāni pañca,	śuddhavidyā tattva īśvara tattva sadāśiva ākhyāni trīṇi tattvāni bhūtāni pañca 
SA_MBP_araatrisikaavivrttiHK-238	ghīndriyāni pañca, karmendriyāni pañca, viṣayāḥ pañca, antaḥkaraṇāni trīṇi,	ghīndriyāni pañca karmendriyāni pañca viṣayāḥ pañca antaḥkaraṇāni trīṇi 
SA_MBP_araatrisikaavivrttiHK-239	prakṛtirekā, nivṛttāvaṣṭottaraśataṃ bhuvanāni, pratiṣṭhāyāṃ ṣaṭpañcāśat,	prakṛtiḥ ekā nivṛttau aṣṭottaraśatam bhuvanāni pratiṣṭhāyām ṣaṭpañcāśat 
SA_MBP_araatrisikaavivrttiHK-240	vidyāyāṃ saptaviṃśatiḥ, śāntāyāṃ saptadaśa, śāntyatītāyāṃ ṣoḍaśa,	vidyāyām saptaviṃśatiḥ śāntāyām saptadaśa śānti atītāyām ṣoḍaśa 
SA_MBP_araatrisikaavivrttiHK-241	evaṃ sarvāṇi bhuvanāni caturviṃśatyadhikaṃ dviśatam | śāntyatītāyā bindoḥ	evam sarvāṇi bhuvanāni caturviṃśati adhikam dviśatam śānti atītāyāḥ bindoḥ 
SA_MBP_araatrisikaavivrttiHK-242	karandhrāntaṃ vyāptiḥ, tatra anantavyāptaśivatattvasthitiḥ tatra	              
SA_MBP_araatrisikaavivrttiHK-243	anāśritaśivasyādhikṛtiḥ | atra tu saṃkṣepeṇaiva etatkramaḥ | kālāgniṃ	anāśrita śivasya adhikṛtiḥ atra tu saṃkṣepeṇa eva etad kramaḥ 
SA_MBP_araatrisikaavivrttiHK-244	kālāgnisthānaṃ pādāgraṃ āditaḥ kṛtvā tadārabhya māyāntaṃ	kālāgni sthānam pāda agram āditas kṛtvā tat ārabhya māyā antam 
SA_MBP_araatrisikaavivrttiHK-245	māyātattvāntaṃ brahmotyupalakṣaṇaṃ tena brahmaviṣṇudehagamiti tālvantaṃ	māyā tattva antam brahma uti upalakṣaṇam tena brahma viṣṇu deha gam iti tālu antam 
SA_MBP_araatrisikaavivrttiHK-246	sthitau, brahma iti napuṃsako nirdeśa eśaḥ pāṭhaḥ | śivo māyordhve	sthitau brahma iti napuṃsakaḥ nirdeśaḥ eśaḥ pāṭhaḥ śivaḥ māyā ūrdhve 
SA_MBP_araatrisikaavivrttiHK-247	viśvādyanantānto viśvabhuvanācchuddhavidyāderārabhya anantānto	viśva ādi ananta antaḥ viśva bhuvanāt śuddhavidyā ādeḥ ārabhya ananta antaḥ 
SA_MBP_araatrisikaavivrttiHK-248	anantabhuvanāvadhi adhiṣṭhātā sthitaḥ, ataḥ paraṃ śaktitrayaṃ vidyā  	ananta bhuvana avadhi adhiṣṭhātā sthitaḥ atas param śakti trayam vidyā 
SA_MBP_araatrisikaavivrttiHK-249	śāntā  śāntyatītāditrayaṃ  sūkṣmamutkṛṣṭaṃ ca matam || 21 ||	                    
SA_MBP_araatrisikaavivrttiHK-250	kuta ityāha 	kutas iti āha 
SA_MBP_araatrisikaavivrttiHK-251	tadantarvarti yatkiñcit śuddhamārge vyavasthitam |	tad antar varti yat kiñcid śuddha mārge vyavasthitam 
SA_MBP_araatrisikaavivrttiHK-252	aṇurviśuddhamacirādaiśvaraṃ jñānamaśnute || 22 ||	aṇuḥ viśuddham acirāt aiśvaram jñānam aśnute 
SA_MBP_araatrisikaavivrttiHK-253	tasya śaktitrayasya antarvarti yadadhvarūpaṃ	tasya śakti trayasya antarvarti yat adhva rūpam 
SA_MBP_araatrisikaavivrttiHK-254	tattvabhuvanāvasthādimadhyasthitaṃ tat śuddhamārge vyavasthitaṃ	tattva bhuvana avasthā ādi madhya sthitam tat śuddha mārge vyavasthitam 
SA_MBP_araatrisikaavivrttiHK-255	māyākāluṣyatānavatāratamyādaṇurjīvo yogamabhyasyan śuddhādhvani	māyā kāluṣya tānava tāratamyāt aṇuḥ jīvaḥ yogam abhyasyan śuddhādhvani 
SA_MBP_araatrisikaavivrttiHK-256	pratiṣṭhito'cirād aiśvaraṃ jñānaṃ viśuddhaṃ bhedaprathārahitaṃ prāpnoti |	pratiṣṭhita ucirāt aiśvaram jñānam viśuddham bheda prathā rahitam prāpnoti 
SA_MBP_araatrisikaavivrttiHK-257	ṣaḍadhvānaḥ varṇapadamantrabhuvanatattvakalātmānaḥ, trayo vācakāstrayo	ṣaṣ adhvānaḥ varṇa pada mantra bhuvana tattva kalā ātmānaḥ trayaḥ vācakāḥ trayaḥ 
SA_MBP_araatrisikaavivrttiHK-258	vācyāḥ || 22 ||	vācyāḥ 
SA_MBP_araatrisikaavivrttiHK-259	taccodakaḥ śivo jñeyaḥ sarvajñaḥ parameśvaraḥ |	tad codakaḥ śivaḥ jñeyaḥ sarvajñaḥ parameśvaraḥ 
SA_MBP_araatrisikaavivrttiHK-260	sarvago nirmalaḥ svacchastṛptaḥ svāyatanaḥ śuciḥ || 23 ||	sarvagaḥ nirmalaḥ svacchaḥ tṛptaḥ sva āyatanaḥ śuciḥ 
SA_MBP_araatrisikaavivrttiHK-261	taccodakaḥ tasya īśvarajñānasya codako'nugrahabhājanaṃ kañcideva	tad codakaḥ tasya īśvara jñānasya codakaḥ unugraha bhājanam kañcid eva 
SA_MBP_araatrisikaavivrttiHK-262	yogivaryaṃ prati prayojakaḥ śivakalādhiṣṭhātajñeyaḥ, yataḥ sa eva sarvajñaḥ |	yogi varyam prati prayojakaḥ śiva kalā adhiṣṭhāta jñeyaḥ yatas saḥ eva sarvajñaḥ 
SA_MBP_araatrisikaavivrttiHK-263	yaduktam 	yat uktam 
SA_MBP_araatrisikaavivrttiHK-264	eko bhāvastattvato yena dṛṣṭaḥ sarve bhāvāstattvatastena dṛṣṭāḥ | iti	ekaḥ bhāvaḥ tattvataḥ yena dṛṣṭaḥ sarve bhāvāḥ tattvataḥ tena dṛṣṭāḥ iti 
SA_MBP_araatrisikaavivrttiHK-265	parameśvaro'deyamapi dātuṃ samarthaḥ | sarvago vyāpakaḥ | sarvago	parameśvara udeyam api dātum samarthaḥ sarvagaḥ vyāpakaḥ sarvagaḥ 
SA_MBP_araatrisikaavivrttiHK-266	māyīyamalarahitaḥ | svacchaḥ āṇavamalarahitaḥ | tṛptaḥ kārmamalarahitatvāt	māyīya mala rahitaḥ svacchaḥ āṇava mala rahitaḥ tṛptaḥ kārma mala rahita tvāt 
SA_MBP_araatrisikaavivrttiHK-267	nirākāṅghaḥ | svāyatanaścidātmani pratiṣṭhitaḥ | śucirnivāsanaḥ | ītādṛganyo	nirākāṅghaḥ sva āyatanaḥ cit ātmani pratiṣṭhitaḥ śuciḥ nivāsanaḥ 
SA_MBP_araatrisikaavivrttiHK-268	devaḥ ko'pi nāsti | malatrayalakṣaṇaṃ śrīpratyabhijñāyām 	devaḥ kaḥ api na asti mala traya lakṣaṇam śrī pratyabhijñāyām 
SA_MBP_araatrisikaavivrttiHK-269	svātantryahānirbodhasya svātantryasyāpyabodhatā |	svātantrya hāniḥ bodhasya svātantryasya api abodha tā 
SA_MBP_araatrisikaavivrttiHK-270	dvidhāṇavaṃ malamidaṃ svasvarūpāpahānitaḥ ||	dvidhā āṇavam malam idam sva svarūpa apahānitaḥ 
SA_MBP_araatrisikaavivrttiHK-271	bhinnavedyaprathātraiva māyākhyaṃ janmabhogadam |	bhinna vedya prathā atrā eva māyā ākhyam janma bhoga dam 
SA_MBP_araatrisikaavivrttiHK-272	kartaryabodhe kārmaṃ tu māyāśaktyaiva tattrayam || (ī0 pra0 3 | 2 | 4 |)	kartari abodhe kārmam tu māyā śaktyā eva tat trayam 
SA_MBP_araatrisikaavivrttiHK-273	iti || 23 ||	iti 
SA_MBP_araatrisikaavivrttiHK-274	nanu aṇorjīvasya saṅkucitasya pūrṇavyāpakeśvarajñānaṃ	nanu aṇoḥ jīvasya saṅkucitasya pūrṇa vyāpaka īśvara jñānam 
SA_MBP_araatrisikaavivrttiHK-275	durghaṭamanumīyate jalabindorivārṇavatvaprāptirityato dṛṣṭāntanidarśanena	durghaṭam anumīyate jala bindoḥ iva arṇava tva prāptiḥ iti atas dṛṣṭānta nidarśanena 
SA_MBP_araatrisikaavivrttiHK-276	samyagbodhayati 	samyak bodhayati 
SA_MBP_araatrisikaavivrttiHK-277	yathānyagrodhabījasthaḥ śaktirūpo mahādrumaḥ |	yathā nyagrodha bīja sthaḥ śakti rūpaḥ mahā drumaḥ 
SA_MBP_araatrisikaavivrttiHK-278	tathā hṛdayabījasthaṃ jagadetaccarācaram || 24 ||	tathā hṛdaya bīja stham jagat etat carācaram 
SA_MBP_araatrisikaavivrttiHK-279	(p. 14) nyagrodhabīje vaṭavṛkṣabīje śaktirūpo hṛdayabījaṃ	nyagrodha bīje vaṭa vṛkṣa bīje śakti rūpaḥ hṛdaya bījam 
SA_MBP_araatrisikaavivrttiHK-280	śuddhacitparāmarśātmaparārūpaṃ tatra sthitaṃ carācarātmakaṃ	śuddha cit parāmarśa ātma parā rūpam tatra sthitam carācara ātmakam 
SA_MBP_araatrisikaavivrttiHK-281	jagadvistīrṇaṃ hṛdayabījasthaṃ sūkṣmarūpeṇa sthitamato na	jagat vistīrṇam hṛdaya bīja stham sūkṣma rūpeṇa sthitam atas na 
SA_MBP_araatrisikaavivrttiHK-282	kiñcidasamañjasam || 24 ||	kiñcid asamañjasam  /
SA_MBP_araatrisikaavivrttiHK-283	evaṃ yo vetti tattvena tasya nirvāṇagāminī |	evam yaḥ vetti tattvena tasya nirvāṇa gāminī 
SA_MBP_araatrisikaavivrttiHK-284	dīkṣā bhavatyasaṃdigdhā tilājyāhutivarjitā || 25 ||	dīkṣā bhavati asaṃdigdhā tila ājya āhuti varjitā 
SA_MBP_araatrisikaavivrttiHK-285	tattvena dehāhaṃbhāvatiraskāreṇa cidātmapratiṣṭhayā yo vetti	tattvena deha ahaṃbhāva tiraskāreṇa cit ātma pratiṣṭhayā yaḥ vetti 
SA_MBP_araatrisikaavivrttiHK-286	saṃvedayate | dīkṣeti 	saṃvedayate dīkṣā iti 
SA_MBP_araatrisikaavivrttiHK-287	dadāti jñānasadbhāvaṃ kṣapayatyakhilaṃ malam |	dadāti jñāna sadbhāvam kṣapayati akhilam malam 
SA_MBP_araatrisikaavivrttiHK-288	bodhānuvedhād dīkṣoktā dānakṣapaṇadharmiṇī ||	bodha anuvedhāt dīkṣā uktā dāna kṣapaṇa dharmiṇī 
SA_MBP_araatrisikaavivrttiHK-289	ityādinā lakṣitā mokṣāvahā, tilājyā, iti bāhyopaka	ityādinā lakṣitā mokṣa āvahā tila ājyāḥ iti 
SA_MBP_araatrisikaavivrttiHK-290	raṇamanapekṣamāṇā, nātra saṃśayaḥ || 25 ||	raṇam an apekṣamāṇāḥ na atra saṃśayaḥ 
SA_MBP_araatrisikaavivrttiHK-291	evamāntarīṃ sūkṣmāṃ pūjāmabhidhāya bāhyapūjopalakṣaṇamāḥ	evam āntarīm sūkṣmām pūjām abhidhāya bāhya pūjā upalakṣaṇam āḥ 
SA_MBP_araatrisikaavivrttiHK-292	tramapyāha 	tram api āha 
SA_MBP_araatrisikaavivrttiHK-293	mūrdhni vaktre ca hṛdaye guhye mūrtau tathaiva ca |	mūrdhni vaktre ca hṛdaye guhye mūrtau tathā eva ca 
SA_MBP_araatrisikaavivrttiHK-294	nyāsaṃ kṛtvā śikhāṃ baddhvā saptaviṃśatimantritām || 26 ||	nyāsam kṛtvā śikhām baddhvā saptaviṃśati mantritām 
SA_MBP_araatrisikaavivrttiHK-295	īśānamūrdhne namaḥ, tatpuruṣavaktrāya namaḥ, aghorahṛdayāya namaḥ,	īśāna mūrdhne namaḥ tatpuruṣa vaktrāya namaḥ aghora hṛdayāya namaḥ 
SA_MBP_araatrisikaavivrttiHK-296	vāmadevaguhyāya namaḥ, sadyojātamūrtaye namaḥ, iti mantreṇa nyāsaṃ kṛtvā	vāmadeva guhyāya namaḥ sadyojāta mūrtaye namaḥ iti mantreṇa nyāsam kṛtvā 
SA_MBP_araatrisikaavivrttiHK-297	aghoramantreṇa ca saptaviṃśativāramaṣṭottaraśatākṣamālāpādena mantritāṃ	aghora mantreṇa ca saptaviṃśati vāram aṣṭottaraśata akṣa mālā pādena mantritām 
SA_MBP_araatrisikaavivrttiHK-298	śikhāṃ baddhvā || 26 ||	śikhām baddhvā 
SA_MBP_araatrisikaavivrttiHK-299	ekaikaṃ tu diśāṃ bandhaṃ daśānāmapi yojayet |	ekaikam tu diśām bandham daśānām api yojayet 
SA_MBP_araatrisikaavivrttiHK-300	tālatrayaṃ purā datvā saśabdaṃ vighnaśāntaye || 27 ||	tāla trayam purā da tvā sa śabdam vighna śāntaye 
SA_MBP_araatrisikaavivrttiHK-301	choṭikābhirdaśabhiḥ,	choṭikābhiḥ daśabhiḥ 
SA_MBP_araatrisikaavivrttiHK-302	bhūtāḥ pretāḥ piśācāśca rākṣasāśca sarīsṛpāḥ |	bhūtāḥ pretāḥ piśācāḥ ca rākṣasāḥ ca sarīsṛpāḥ 
SA_MBP_araatrisikaavivrttiHK-303	(p. 15) apasarpantu te sarve divyāstreṇa tāḍitāḥ ||	apasarpantu te sarve divya astreṇa tāḍitāḥ 
SA_MBP_araatrisikaavivrttiHK-304	iti mantreṇa digbandhaṃ prayojayet,	iti mantreṇa digbandham prayojayet 
SA_MBP_araatrisikaavivrttiHK-305	apasarpantu te bhūtā ye bhūtā bhuvi saṃsthitāḥ |	apasarpantu te bhūtāḥ ye bhūtāḥ bhuvi saṃsthitāḥ 
SA_MBP_araatrisikaavivrttiHK-306	ye bhūtā vighnakartāraste naśyantu śivājñayā ||	ye bhūtāḥ vighna kartāraḥ te naśyantu śiva ājñayā 
SA_MBP_araatrisikaavivrttiHK-307	iti mantreṇa pūrvaṃ pārṣṇyāghātatrayaṃ kṛtvā,	iti mantreṇa pūrvam pārṣṇi āghāta trayam kṛtvā 
SA_MBP_araatrisikaavivrttiHK-308	pāṣāṇḍakāriṇo bhūtā bhūtā bhūmyantarikṣagāḥ |	pāṣāṇḍa kāriṇaḥ bhūtāḥ bhūtāḥ bhūmi antarikṣa gāḥ 
SA_MBP_araatrisikaavivrttiHK-309	divi loke sthitā ye ca te naśyantu śivājñayā ||	divi loke sthitāḥ ye ca te naśyantu śiva ājñayā 
SA_MBP_araatrisikaavivrttiHK-310	iti | saśabdaṃ tālatrayaṃ dattvā pratyūhopaśamanāya || 27 ||	iti sa śabdam tāla trayam dattvā pratyūha upaśamanāya 
SA_MBP_araatrisikaavivrttiHK-311	śikhāsaṃkhyātijaptena toyenābhyukṣayettataḥ |	śikhā saṃkhyā ati japtena toyena abhyukṣayet tatas 
SA_MBP_araatrisikaavivrttiHK-312	puṣpādikaṃ kramāt sarvaṃ liṅge vā sthaṇḍile'thavā || 28 ||	puṣpa ādikam kramāt sarvam liṅge vā sthaṇḍile ithavā 
SA_MBP_araatrisikaavivrttiHK-313	caturdaśābhijaptena puṣpeṇāsanakalpanā |	caturdaśa abhijaptena puṣpeṇa āsana kalpanā 
SA_MBP_araatrisikaavivrttiHK-314	nairṛte'strārghapātre saptaviṃśativāramaghoramantreṇa mantritaṃ toyaṃ	nairṛta istra arghapātre saptaviṃśati vāram aghora mantreṇa mantritam toyam 
SA_MBP_araatrisikaavivrttiHK-315	vidhāya jñānasvaṅgena puṣpagandhākṣatādikaṃ pūjopakaraṇamabhyukṣayet	vidhāya jñāna su aṅgena puṣpa gandha akṣata ādikam pūjā upakaraṇam abhyukṣayet 
SA_MBP_araatrisikaavivrttiHK-316	śodhanārthaṃ siñcet | tato mṛnmayādiliṅge sthaṇḍile vā yāgabhūmau	śodhana artham siñcet tatas mṛd maya ādi liṅge sthaṇḍile vā yāga bhūmau 
SA_MBP_araatrisikaavivrttiHK-317	vihitāṣṭadalakamalādike vā darpaṇapratibimbite caturdaśavāramaghorābhijaptena	vihita aṣṭadala kamala ādike vā darpaṇa pratibimbite caturdaśa vāram aghora abhijaptena 
SA_MBP_araatrisikaavivrttiHK-318	puṣpeṇa iti puṣpāsanādikāṃ pūjāṃ kuryāt || 18 ||	puṣpeṇa iti puṣpa āsana ādikām pūjām kuryāt 
SA_MBP_araatrisikaavivrttiHK-319	tataḥ sṛṣṭiṃ yajedvīraḥ punarevāsanaṃ tataḥ || 29 ||	tatas sṛṣṭim yajet vīraḥ punar eva āsanam tatas 
SA_MBP_araatrisikaavivrttiHK-320	sṛṣṭiṃ tu saṃpuṭīkṛtya punaryajanamārabhet |	sṛṣṭim tu saṃpuṭīkṛtya punar yajanam ārabhet 
SA_MBP_araatrisikaavivrttiHK-321	tato vāhyapūjānantaramakārādihakārāntāṃ varṇasṛṣṭiṃ yajet	tatas vāhya pūjā anantaram makāra ādi hakāra antām varṇa sṛṣṭim yajet 
SA_MBP_araatrisikaavivrttiHK-322	liṅgādau ca pūjayet aṃ namaḥ ityevam, punareva vīro yogīndro	liṅga ādau ca pūjayet aṃ namaḥ iti evam punar eva vīraḥ yogi indraḥ 
SA_MBP_araatrisikaavivrttiHK-323	dhyānayogāsanaṃ vidhāya akārādihakārāntāṃ sṛṣṭiṃ saṃpuṭīkṛtya	dhyāna yoga āsanam vidhāya akāra ādi hakāra antām sṛṣṭim saṃpuṭīkṛtya 
SA_MBP_araatrisikaavivrttiHK-324	pratyāhṛtya ahamiti cittattve pratiṣṭhito bhūtvā punaryajanamāntarīṃ	pratyāhṛtya aham iti cit tattve pratiṣṭhitaḥ bhūtvā punar yajanam āntarīm 
SA_MBP_araatrisikaavivrttiHK-325	pūjāmārabhet | ātmāmarśanamevābhyantarī pūjā || 29 ||	pūjām ārabhet ātma āmarśanam eva ābhyantarī pūjā 
SA_MBP_araatrisikaavivrttiHK-326	(p. 16) tato bhāvanayā pūjā 	tatas bhāvanayā pūjā 
SA_MBP_araatrisikaavivrttiHK-327	sarvatattvasusaṃpūrṇā sarvābharaṇabhūṣitām || 30 ||	sarva tattva su saṃpūrṇā sarva ābharaṇa bhūṣitām 
SA_MBP_araatrisikaavivrttiHK-328	yajeddevīṃ maheśānīṃ saptaviśatimantritām |	yajet devīm maheśānīm saptaviśati mantritām 
SA_MBP_araatrisikaavivrttiHK-329	tataḥ sugandhipuṣpaistu yathāśaktyā samarcayet || 31 ||	tatas sugandhi puṣpaiḥ tu yathāśaktyā samarcayet 
SA_MBP_araatrisikaavivrttiHK-330	pūjayet parayā bhaktyā ātmānaṃ ca nivedayet |	pūjayet parayā bhaktyā ātmānam ca nivedayet 
SA_MBP_araatrisikaavivrttiHK-331	sarvatattvaiḥ ṣaṭtriṃśat tattvaiḥ susaṃpūrṇāṃ nirbharāṃ	sarva tattvaiḥ ṣaṭtriṃśat tattvaiḥ su saṃpūrṇām nirbharām 
SA_MBP_araatrisikaavivrttiHK-332	sarvābharaṇabhūṣitāṃ maheśvarīṃ parāṃ devīmaghoramantreṇa parayā	sarva ābharaṇa bhūṣitām maheśvarīm parām devīm aghora mantreṇa parayā 
SA_MBP_araatrisikaavivrttiHK-333	bhaktyā atyādareṇa pūjayet gandhapuṣpādibhirātmānaṃ ca nivedayet	bhaktyā atyādareṇa pūjayet gandha puṣpa ādibhiḥ ātmānam ca nivedayet 
SA_MBP_araatrisikaavivrttiHK-334	samarpayet || 31 ||	samarpayet 
SA_MBP_araatrisikaavivrttiHK-335	evaṃ yajanamākhyātamagnikārye'pyayaṃ vidhiḥ || 32 ||	evam yajanam ākhyātam agni kārye pi ayam vidhiḥ 
SA_MBP_araatrisikaavivrttiHK-336	kṛtapūjāvidhiḥ samyak smaran bījaṃ prasidhyati |	kṛta pūjā vidhiḥ samyak smaran bījam prasidhyati 
SA_MBP_araatrisikaavivrttiHK-337	evaṃ dviprakāraṃ yajanaṃ pūjanamuktaṃ agnikārye homādāvapi ayaṃ	evam dvi prakāram yajanam pūjanam uktam agni kārye homa ādau api ayam 
SA_MBP_araatrisikaavivrttiHK-338	vidhiḥ, eṣa eva prakāro dvividhaḥ evamuktavidhayā kṛtapūjāvidhiryogī samyag	vidhiḥ eṣaḥ eva prakāraḥ dvividhaḥ evam ukta vidhayā kṛta pūjā vidhiḥ yogī samyak 
SA_MBP_araatrisikaavivrttiHK-339	dehāhantāṃ vismārya jagato varṇānāṃ ca bījaṃ mūlakāraṇaṃ cittattvaṃ	deha ahaṃtām vismārya jagataḥ varṇānām ca bījam mūla kāraṇam cit tattvam 
SA_MBP_araatrisikaavivrttiHK-340	nityamanavarataṃ vyutthāne'pi smaran pratyavamṛśan prasidhyati anuttarāṃ	nityam anavaratam vyutthāne api smaran pratyavamṛśan prasidhyati anuttarām 
SA_MBP_araatrisikaavivrttiHK-341	jñānadhārāmadhirohati || 32 ||	jñāna dhārām adhirohati 
SA_MBP_araatrisikaavivrttiHK-342	atha dhyānayoganiṣṭhasya yoginaḥ saprakāraṃ smaraṇe	atha dhyāna yoga niṣṭhasya yoginaḥ sa prakāram smaraṇe 
SA_MBP_araatrisikaavivrttiHK-343	rahasyopadeśamāha 	rahasya upadeśam āha 
SA_MBP_araatrisikaavivrttiHK-344	ādyantarahitaṃ bījaṃ vikasattithimadhyagam || 33 ||	ādi anta rahitam bījam vikasat tithi madhya gam 
SA_MBP_araatrisikaavivrttiHK-345	hṛtpadmāntargataṃ dhyāyet somāṃśaṃ nityamabhyaset |	hṛd padma antargatam dhyāyet soma aṃśam nityam abhyaset 
SA_MBP_araatrisikaavivrttiHK-346	jagato varṇānāṃ vā bījaṃ parārūpaṃ cidātmakaṃ tattvaṃ bījaṃ	jagataḥ varṇānām vā bījam parā rūpam cit ātmakam tattvam bījam 
SA_MBP_araatrisikaavivrttiHK-347	māṃ sarvabhūtānāṃ ----------------------------- |	mām sarva bhūtānām 
SA_MBP_araatrisikaavivrttiHK-348	(p. 17) iti gītāsūktam | vikasaditi vikasanto akārādihakārāntaṃ prasaranto	iti gītāsu uktam vikasat iti vikasantaḥ akāra ādi hakāra antam prasarantaḥ 
SA_MBP_araatrisikaavivrttiHK-349	amūlā tat kramāt jñeyā ------------ | (8 ślo0 )	amūlā tad kramāt jñeyā    
SA_MBP_araatrisikaavivrttiHK-350	ityatra jñātamātreṇa vyañjanarūpeṇa pariṇamanto vaikharyāṃ vāci	iti atra jñāta mātreṇa vyañjana rūpeṇa pariṇamantaḥ vaikharyām vāci 
SA_MBP_araatrisikaavivrttiHK-351	spaṣṭatāṃ gacchataśca te tithayaḥ pañcadaśa svarāsteṣāṃ madhyagaṃ	spaṣṭa tām gacchataḥ ca te tithayaḥ pañcadaśa svarāḥ teṣām madhya gam 
SA_MBP_araatrisikaavivrttiHK-352	tadantarvarti ahamityevaṃ svābhedena natu dhyeyatvena hṛtpadmāntargataṃ	tad antarvarti aham iti evam sva abhedena na tu dhyeya tvena hṛd padma antargatam 
SA_MBP_araatrisikaavivrttiHK-353	dhyāyet rājayogavit gurupadeśena anuśīlayet gururupāyaḥ || (śi0 sū0 2 | 9 )	dhyāyet rājayoga vid guru upadeśena anuśīlayet guruḥ upāyaḥ     
SA_MBP_araatrisikaavivrttiHK-354	ityuktam | tathā ca  śrutiḥ 	iti uktam tathā ca śrutiḥ 
SA_MBP_araatrisikaavivrttiHK-355	tadvijñānārthaṃ sa gurumevābhigacchet samitpāṇiḥ śrotriyaṃ brahmaniṣṭham	tad vijñāna artham sa gurum eva abhigacchet samidh pāṇiḥ śrotriyam brahmaniṣṭham 
SA_MBP_araatrisikaavivrttiHK-356	iti | kathaṃ dhyāyedityāha  ādyantarahitaṃ ādihāntavarṇarahitaṃ varṇānāṃ	iti katham dhyāyet iti āha ādi anta rahitam ādi ha anta varṇa rahitam varṇānām 
SA_MBP_araatrisikaavivrttiHK-357	vikalparūpatvāt | spande'pi 	vikalpa rūpa tvāt spande api 
SA_MBP_araatrisikaavivrttiHK-358	śabdarāśisamutthasya ------------------------------- | (spa0 kā0 4 | 15 )	śabdarāśi samutthasya spa kā  /
SA_MBP_araatrisikaavivrttiHK-359	ityuktam | avikalpaṃ yathā syāttathā dhyāyet |	iti uktam avikalpam yathā syāt tathā dhyāyet 
SA_MBP_araatrisikaavivrttiHK-360	kevalaṃ buddhyupādānakramarūpānupātinī |	kevalam buddhi upādāna krama rūpa anupātinī 
SA_MBP_araatrisikaavivrttiHK-361	prāṇavṛttimatikramya madhyamā vākpravartate ||	prāṇa vṛttim atikramya madhyamā vāc pravartate 
SA_MBP_araatrisikaavivrttiHK-362	ityevaṃlakṣaṇāṃ madhyamāṃ vācaṃ pratinivartya sattvena vimṛśet |	iti evaṃlakṣaṇām madhyamām vācam pratinivartya sattvena vimṛśet 
SA_MBP_araatrisikaavivrttiHK-363	yaduktaṃ śrīpūrve 	yat uktam śrī pūrve 
SA_MBP_araatrisikaavivrttiHK-364	tadetadahamityevaṃ visargānuttarātmakam |	tat etat aham iti evam visarga anuttara ātmakam 
SA_MBP_araatrisikaavivrttiHK-365	nābhikuṇḍalahṛdvyomno yogino'hamupāsate ||	nābhi kuṇḍala hṛt vyomnaḥ yoginaḥ uham upāsate 
SA_MBP_araatrisikaavivrttiHK-366	iti | nirvikalpadhyānasya etadeva lakṣaṇam | dhyānayogabalena	iti nirvikalpa dhyānasya etat eva lakṣaṇam dhyāna yoga balena 
SA_MBP_araatrisikaavivrttiHK-367	ṣaṭcakrabhedanapūrvaṃ suṣumnāyāṃ prāṇāpānalayena pādāgrādārabhya	ṣaṭcakra bhedana pūrvam suṣumnāyām prāṇa apāna layena pāda agrāt ārabhya 
SA_MBP_araatrisikaavivrttiHK-368	karandhrāntaṃ vidyudvat sahasotthite cidānandapūre yadeva nimajjanaṃ tadeva	                 eva        eva 
SA_MBP_araatrisikaavivrttiHK-369	dhyānaṃ anyathā dambhacaryeti | atra vyutthāne smaraṇopayoginīṃ yuktimāha 	dhyānam anyathā dambha caryā iti  atra vyutthāne smaraṇa upayoginīm yuktim āha 
SA_MBP_araatrisikaavivrttiHK-370	somāṃśaṃmiti, somāṃśaṃ prāṇasya avasāne apānasya pravivikṣāyāṃ	soma aṃśam iti soma aṃśam prāṇasya avasāne apānasya pravivikṣāyām 
SA_MBP_araatrisikaavivrttiHK-371	nityaṃ anavarataṃ abhyasyet cittattvaṃ vimṛśet |	            
SA_MBP_araatrisikaavivrttiHK-372	na sā jīvakalā kācit santānadvayavartinī |	na sā jīva kalā kācid santāna dvaya vartinī 
SA_MBP_araatrisikaavivrttiHK-373	vyātrī śivakalā yasyāmadhiṣṭhātrī na vidyate ||	vyātrī śiva kalā yasyām adhiṣṭhātrī na vidyate 
SA_MBP_araatrisikaavivrttiHK-374	ityukteḥ | taduktaṃ vāsiṣṭhe 	iti ukteḥ tat uktam vāsiṣṭhe 
SA_MBP_araatrisikaavivrttiHK-375	astaṅgatavati prāṇe tvapāne'bhyudayonmukhe |	astaṅgatavati prāṇe tu apāna ibhi udaya unmukhe 
SA_MBP_araatrisikaavivrttiHK-376	bahiḥ kumbhakamālaṃbya ciraṃ bhūyo na śocyate || (vā0 6 pra0)	bahis kumbhakam ālaṃbya ciram bhūyas na śocyate vā 
SA_MBP_araatrisikaavivrttiHK-377	tathā 	tathā 
SA_MBP_araatrisikaavivrttiHK-378	prāṇakṣayapadāntasthamapānakṣayakoṭigam |	prāṇa kṣaya pada anta stham apāna kṣaya koṭi gam 
SA_MBP_araatrisikaavivrttiHK-379	apānaprāṇayormadhyaṃ cidātmānamupāsmahe ||	apāna prāṇayoḥ madhyam cit ātmānam upāsmahe 
SA_MBP_araatrisikaavivrttiHK-380	iti | tantrāloke'pi 	iti tantrāloke pi 
SA_MBP_araatrisikaavivrttiHK-381	tapaḥ prabhṛtayo yeca niyamastattadāsanam |	tapaḥ prabhṛtayaḥ ye ca niyamaḥ tat tat āsanam 
SA_MBP_araatrisikaavivrttiHK-382	prāṇāyāmāśca tatsarvametad bāhyavijṛmbhitam ||	prāṇāyāmāḥ ca tat sarvam etat bāhya vijṛmbhitam 
SA_MBP_araatrisikaavivrttiHK-383	śrīmadvīrāvalau proktaṃ bodhamātre śivātmake |	śrīmat vīrāvalau proktam bodha mātre śiva ātmake 
SA_MBP_araatrisikaavivrttiHK-384	cittapralayabandhena pralīne śaśibhāskare ||	citta pralaya bandhena pralīne śaśi bhāskare 
SA_MBP_araatrisikaavivrttiHK-385	prāpte ca dvādaśe bhāge jīvāditye subodhake |	prāpte ca dvādaśe bhāge jīvāditye subodhake 
SA_MBP_araatrisikaavivrttiHK-386	mokṣaḥ sa eva kathitaḥ prāṇāyāmo nirarthakaḥ ||	mokṣaḥ saḥ eva kathitaḥ prāṇāyāmaḥ nirarthakaḥ 
SA_MBP_araatrisikaavivrttiHK-387	prāṇāyāmo na kartavyaḥ śarīraṃ yena pīḍyate | (taṃ0 4 ā0 )	prāṇāyāmaḥ na kartavyaḥ śarīram yena pīḍyate tam 
SA_MBP_araatrisikaavivrttiHK-388	iti | prabhṛtigrahaṇena tapaḥsvādhyāyeśvarapraṇidhānāni kriyāyogaḥ |	iti prabhṛti grahaṇena tapaḥ svādhyāya īśvara praṇidhānāni kriyā yogaḥ 
SA_MBP_araatrisikaavivrttiHK-389	yamaniyamāsanaprāṇāyāmapratyāhāradhāraṇādhyānasamādhayo'ṣṭāvaṅ	yama niyama āsana prāṇāyāma pratyāhāra dhāraṇā dhyāna samādhayaḥ uṣṭau aṅ 
SA_MBP_araatrisikaavivrttiHK-390	gāni yogasya ityādayo yogaśāstroktāḥ iti || 33 ||	gāni yogasya ityādayaḥ yoga śāstra uktāḥ iti 
SA_MBP_araatrisikaavivrttiHK-391	yānyān kāmayate kāmāṃstāṃstāṃ śīghramavāpnuyāt || 34 ||	yān yān kāmayate kāmān tān tām śīghram avāpnuyāt 
SA_MBP_araatrisikaavivrttiHK-392	asmāt pratyakṣatāmeti sarvajñatvaṃ na saṃśayaḥ |	asmāt pratyakṣa tām eti sarvajña tvam na saṃśayaḥ 
SA_MBP_araatrisikaavivrttiHK-393	(p. 19) kāmānabhilāṣān asmādeva paratattvābhyāsāt pratyakṣatāmeti	kāmān abhilāṣān asmāt eva para tattva abhyāsāt pratyakṣa tām eti 
SA_MBP_araatrisikaavivrttiHK-394	prādurbhavati || 34 ||	prādurbhavati 
SA_MBP_araatrisikaavivrttiHK-395	evaṃ mantraphalāvāptirityetadrudrayāmalam || 35 ||	evam mantra phala avāptiḥ iti etat rudrayāmalam 
SA_MBP_araatrisikaavivrttiHK-396	etadbhyāsataḥ siddhiḥ sarvajñatvamavāpyate |	etad bhyāsataḥ siddhiḥ sarvajña tvam avāpyate 
SA_MBP_araatrisikaavivrttiHK-397	evaṃ dviprakārapūjanena, rudraśca rudrāṇī ca rudrau tayoḥ	evam dvi prakāra pūjanena rudraḥ ca rudrāṇī ca rudrau tayoḥ 
SA_MBP_araatrisikaavivrttiHK-398	śivaśaktyoryāmalamubhayasaṃghaṭṭātmakaṃ rūpam | siddhirbāhyābhyantarī	śiva śaktyoḥ yāmalam ubhaya saṃghaṭṭa ātmakam rūpam siddhiḥ bāhya ābhyantarī 
SA_MBP_araatrisikaavivrttiHK-399	ca | taduktam 	ca tat uktam 
SA_MBP_araatrisikaavivrttiHK-400	dharmādharmāntare cittaṃ ruddhaṃ yena tadā tu saḥ |	dharma adharma antare cittam ruddham yena tadā tu saḥ 
SA_MBP_araatrisikaavivrttiHK-401	yadvakti sa bhavenmantraḥ kiṃ punarmāntrikotthitaḥ ||	yat vakti sa bhavet mantraḥ kim punar māntrika utthitaḥ 
SA_MBP_araatrisikaavivrttiHK-402	iti | tathāca śrutiḥ 	iti tathā ca śrutiḥ 
SA_MBP_araatrisikaavivrttiHK-403	yā vāguditā yā cānuditā śivā na śantamā bhava |	yā vāc uditā yā ca an uditā śivā na śantamā bhava 
SA_MBP_araatrisikaavivrttiHK-404	sumṛlīkā sarasvati mā te vyoma sandṛśe ||	su mṛlīkā sarasvati mā te vyoma sandṛśe 
SA_MBP_araatrisikaavivrttiHK-405	he sarasvati parabrahmaṇo'vinābhāvini parāmarśātmikaśakte yā tvaṃ	he sarasvati para brahmaṇaḥ vinābhāvini parāmarśa ātmika śakte yā tvam 
SA_MBP_araatrisikaavivrttiHK-406	vāgrūpā citparāmarśātmikā uditā vaikharyātmanā āvirbhūtā yā ca	vāc rūpā cit parāmarśa ātmikā uditā vaikharī ātmanā āvirbhūtā yā ca 
SA_MBP_araatrisikaavivrttiHK-407	tvamanuditā madhyamārūpeṇa satīparairasaṃvedyā, yā ca tvaṃ śivā	tvam anuditā madhyamā rūpeṇa satī paraiḥ asaṃvedyā yā ca tvam śivā 
SA_MBP_araatrisikaavivrttiHK-408	cidātmaparāmarśaparatayā duḥkhasaṃparkaśūnyā paśyantī rūpā, yā ca	cit ātma parāmarśa para tayā duḥkha saṃparka śūnyā paśyantī rūpā yā ca 
SA_MBP_araatrisikaavivrttiHK-409	tvaṃ śantamā cidānandaghanatvena parārūpā, sā tvaṃ no'smākaṃ	tvam śantamā cit ānanda ghana tvena parārūpā sā tvam na usmākam 
SA_MBP_araatrisikaavivrttiHK-410	sumṛlīkā vibhāvitālaukikacidānandā bhava ityāśaṃsā | tathā te tava	su mṛlīkā vibhāvita alaukika cit ānandā bhava iti āśaṃsā tathā te tava 
SA_MBP_araatrisikaavivrttiHK-411	svarūpasya vyoma cidātmaparāmarśavismaraṇalakṣaṇaṃ chidraṃ ca tusṛṣvapi	svarūpasya vyoma cit ātma parāmarśa vismaraṇa lakṣaṇam chidram ca tusṛṣu api 
SA_MBP_araatrisikaavivrttiHK-412	vākṣu mā saṃdṛśe mādrākṣam | tvatsvarūpasākṣātkārānnityamapracyuto	vākṣu mā saṃdṛśe mā adrākṣam tvad sva rūpa sākṣātkārāt nityam apracyutaḥ 
SA_MBP_araatrisikaavivrttiHK-413	bhūyāmamityāśāsmahe || 35 ||	bhūyāmam iti āśāsmahe 
SA_MBP_araatrisikaavivrttiHK-414	ekaṃ yaḥ svamukhaṃ pidhāya jagatāṃ sṛṣṭiṃ vidhate svayaṃ	ekam yaḥ sva mukham pidhāya jagatām sṛṣṭim vidhate svayam 
SA_MBP_araatrisikaavivrttiHK-415	yaścācchādya nijāncaturdaśabhujānrakṣāvidhāne paṭuḥ |	yaḥ ca ācchādya nijān caturdaśa bhujān rakṣā vidhāne paṭuḥ 
SA_MBP_araatrisikaavivrttiHK-416	svāni dvādaśalocanāni ca tirodhāya kṣiṇoti kṣaṇādyastaṃ kāraṇakāraṇaṃ	svāni dvādaśa locanāni ca tirodhāya kṣiṇoti kṣaṇāt yaḥ tam kāraṇa kāraṇam 
SA_MBP_araatrisikaavivrttiHK-417	hitarataṃ svacchandanāthaṃ stumaḥ ||	hita ratam svacchanda nātham stumaḥ 
SA_MBP_araatrisikaavivrttiHK-418	dṛṣṭvā durghaṭanāṃ śāstre guptapādairvinirmite |	dṛṣṭvā durghaṭanām śāstre gupta pādaiḥ vinirmite 
SA_MBP_araatrisikaavivrttiHK-419	rājānalasakenaiṣā trīśikāvivṛtiḥ kṛtā ||	rājānalasakena eṣā trīśikā vivṛtiḥ kṛtā 
SA_MBP_araatrisikaavivrttiHK-420	iti śam ||	iti śam 
SA_MBP_araatrisikaavivrttiHK-421	iti śrīrājānakalakṣmīrāmakṛtā parātrīśikālaghuvivṛtiḥ samāptā ||	iti śrī rājānaka lakṣmīrāma kṛtā parātrīśikā laghu vivṛtiḥ samāptā 
SA_MBP_araatrisikaavivrttiHK-422	pāṭhakalekhakayoḥ śreyaskarī bhūyāditi ||	pāṭhaka lekhakayoḥ śreyaskarī bhūyāt iti 
SA_MBP_araatrisikaavivrttiHK-423	MUKTABODHA INDOLOGICAL RESEARCH INSTITUTE©2011 Muktabodha Indological Research Institute  All Rights Reserved.E-texts may be viewed only online or downloaded for private study.E-texts may not, under any circumstances, be copied, republished,reproduced, distributed or sold, either in original or altered form, withoutthe express permission of Muktabodha Indological Research Institute in writing.Data-entered by the staff of Muktabodha under the direction of Mark S. G. Dyczkowski.	muktabodha indological research muktabodha indological research institute all rights reserved texts may be viewed only online or downloaded for private studye texts may not under any circumstances be copied republished reproduced distributed or sold either in original or altered form withoutthe express permission of muktabodha indological research institute in writing data entered by the staff of muktabodha under the direction of mark s g dyczkowski 
