segmentnr	original	analyzed
SA_MB_ugracandapujapaddhatiHK-0	Muktabodha E-text in UTF-8	muktabodha etext in utf
SA_MB_ugracandapujapaddhatiHK-1	###########################################################################MUKTABODHA INDOLOGICAL RESEARCH INSTITUTEwww.muktabodha.org©2011 Muktabodha Indological Research Institute  All Rights Reserved.E-texts may be viewed only online or downloaded for private study.E-texts may not, under any circumstances, be copied, republished,reproduced, distributed or sold, either in original or altered form, withoutthe express permission of Muktabodha Indological Research Institute in writing.Data-entered by the staff of Muktabodha under the direction of Mark S. G. Dyczkowski.Catalog number : M00420	muktabodha indological research muktabodha indological research institute all rights reserved texts may be viewed only online or downloaded for private studye texts may not under any circumstances be copied republished reproduced distributed or sold either in original or altered form withoutthe express permission of muktabodha indological research institute in writing data entered by the staff of muktabodha under the direction of mark s g dyczkowskicatalog number  /
SA_MB_ugracandapujapaddhatiHK-2	Uniform title: ugracaṇḍapūjāpaddhati	uniform title ugracaṇḍa pūjā paddhati 
SA_MB_ugracandapujapaddhatiHK-3	Manuscript : NGMCP manuscript 1696/979 reel no: B 177/22	manuscript manuscript 
SA_MB_ugracandapujapaddhatiHK-4	Notes: Data entered by the staff of Muktabodha under the direction of Mark S. G. Dyczkowski.	notes data entered by the staff muktabodha under the direction of mark s g dyczkowski 
SA_MB_ugracandapujapaddhatiHK-5	Revision 0: April 28, 2017	revision april 
SA_MB_ugracandapujapaddhatiHK-6	Publication country : India	publication country india 
SA_MB_ugracandapujapaddhatiHK-7	ugracaṇḍāpūjāpaddhati	ugracaṇḍā pūjā paddhati 
SA_MB_ugracandapujapaddhatiHK-8	1a) mathanī astrāya phaṭ || ai& 5 oṃ hū& vajapañjale svāhā ||	a mathanī astrāya phaṭ ai om hū vajapañjale svāhā 
SA_MB_ugracandapujapaddhatiHK-9	ai& 5 calamakulekulamacale hrī& hū& phaṭ svāhā ||	ai calamakulekulamacale hrī hū phaṭ svāhā 
SA_MB_ugracandapujapaddhatiHK-10	ai& 5 khphre& sakalaśatruprathamanī astrāya phaṭ || karasodhanaṃ ||	ai khphre sakala śatru prathamanī astrāya phaṭ kara sodhanam 
SA_MB_ugracandapujapaddhatiHK-11	ai& 5 khphre& paramahaṃsanī aṅguṣṭhāyanaḥ ||	ai khphre paramahaṃsanī aṅguṣṭhāyanaḥ 
SA_MB_ugracandapujapaddhatiHK-12	ai& 5 khphre& nirvānamārgadetarjanyāye svāhā ||	ai khphre nirvāna mārgade tarja nyāye svāhā 
SA_MB_ugracandapujapaddhatiHK-13	ai& 5 khphre& vikhamopallavaprasamanī madhyemāye voṣaṭ ||	ai khphre madhyemāye voṣaṭ 
SA_MB_ugracandapujapaddhatiHK-14	ai& 5 khphre& sakaladuritā riṣṭakleśadalani anāmikāya hū& ||	ai khphre sakala duritā riṣṭa kleśa dalani anāmikāya hū 
SA_MB_ugracandapujapaddhatiHK-15	ai& 5 khphre& sarvāṃ padāmbhodhitalanī kaniṣṭhakāye varṣaṭ ||	ai khphre sarvām kaniṣṭha kāye varṣaṭ 
SA_MB_ugracandapujapaddhatiHK-16	ai& 5 khphre& sakalasatruṃ pramathanī astrāya phaṭ || thvatakaraṃ nyāsa ||	ai khphre sakala satrum pramathanī astrāya phaṭ thvatakaram nyāsa 
SA_MB_ugracandapujapaddhatiHK-17	ai& 5 khphre& namaḥ sarvasiddhiyoginībhyo urddhavaktranātha pādukāṃ ||	ai khphre namaḥ sarva siddhi yoginībhyaḥ urddha vaktra nātha pādukām 
SA_MB_ugracandapujapaddhatiHK-18	ai& 5 khphre& namaḥ sarvasiddhimātṛbhyo pūrvavaktranātha pādukāṃ 5 ||	ai khphre namaḥ sarva siddhi mātṛbhyaḥ pūrva vaktra nātha pādukām 
SA_MB_ugracandapujapaddhatiHK-19	ai& 5 khphre& namonityoditānandanaṇḍitāyai dakṣiṇa vaktranāthapādukāṃ ||	ai khphre namaḥ nitya udita ānanda naṇḍitāyai dakṣiṇa vaktra nātha pādukām 
SA_MB_ugracandapujapaddhatiHK-20	1b) ai& 5 khphre& sakalakulacakre nāyikāyai uttaravaktranāthapāukāṃ ||	b ai sakala kula cakre nāyikāyai uttara vaktra nātha pāukām 
SA_MB_ugracandapujapaddhatiHK-21	ai& 5 khphre& bhagavatyai caṇḍakāpālinai paścimavaktranātha pādukāṃ 5 ||	ai khphre bhagavatyai caṇḍa kāpālinai paścima vaktra nātha pādukām 
SA_MB_ugracandapujapaddhatiHK-22	ai& 5 khphre& namaḥ sarvasiddhi yoginībhyo parāparavaktranātha pādukāṃ 5 ||	ai khphre namaḥ sarva siddhi yoginībhyaḥ parāpara vaktra nātha pādukām 
SA_MB_ugracandapujapaddhatiHK-23	iti vaktraṃ nyāsa ||	iti vaktram nyāsa 
SA_MB_ugracandapujapaddhatiHK-24	ai& 5 khphre& paramahaṃśini hṛdayāya namaḥ ||	ai khphre paramahaṃśini hṛdayāya namaḥ 
SA_MB_ugracandapujapaddhatiHK-25	ai& 5 khphre& nirvānamārgadaśirase svāhā 5 ||	ai khphre nirvāna mārgada śirase svāhā 
SA_MB_ugracandapujapaddhatiHK-26	ai& 5 khphre& vikhamopaplavapramathanī śikhāya vauṣaṭ ||	ai khphre vikhamā upaplava pramathanī śikhāya vauṣaṭ 
SA_MB_ugracandapujapaddhatiHK-27	ai& 5 khphre& sakaladulitāriṣṭakeśadalani kavacāye hū& 5 ||	ai khphre sakala dulita ariṣṭa keśa dalani kavacāye hū 
SA_MB_ugracandapujapaddhatiHK-28	ai& 5 khphre& sarvāṃ padāmbhodhitelaninetratrayāye vaṣaṭ ||	ai khphre sarvām vaṣaṭ 
SA_MB_ugracandapujapaddhatiHK-29	ai& 5 khphre& sakalaśatrupramathanī astrāya phaṭ || thvate aṃganyāsa ||	ai khphre sakala śatru pramathanī astrāya phaṭ thvate aṃganyāsa 
SA_MB_ugracandapujapaddhatiHK-30	2a) ai& 5 jalapātrāsanāya pādukāṃ ||	a ai jala pātra āsanāya pādukām 
SA_MB_ugracandapujapaddhatiHK-31	ai& 5 oṃ hrī& hū& hā& phre& kṣo& kro& namaḥ jalapātrabhaṭṭārikāye pādukāṃ 5 ||	ai om hrī hū hā phre     namaḥ jala pātra bhaṭṭārikāye pādukām 
SA_MB_ugracandapujapaddhatiHK-32	ṣaḍaṃgenasaṃpūjya || āvāhanādi dhenumudrādarśayet ||	ṣaḍaṃgena saṃpūjya āvāhana ādi dhenu mudrā darśayet 
SA_MB_ugracandapujapaddhatiHK-33	ai& 5 śrīsiddhilakṣmī vidmahe navatyāya dhīmahe tanno lakṣmī pracodayāt ||	ai śrī siddhi lakṣmī vidmahe navatyāya dhīmahe tat naḥ lakṣmī pracodayāt 
SA_MB_ugracandapujapaddhatiHK-34	arghapātrāsanāya pādukāṃ 5 ||	arghapātra āsanāya pādukām 
SA_MB_ugracandapujapaddhatiHK-35	ai& 5 hskṣmlvryū& ānandabhairavāye vaṣaṭ ||	ai ānandabhairavāya vaṣaṭ 
SA_MB_ugracandapujapaddhatiHK-36	ai& 5 svā& sa sa sa saparādevī amṛtaṃ vama 2 svāhā ||	ai svā sa sa sa sa parā devī amṛtam vama svāhā 
SA_MB_ugracandapujapaddhatiHK-37	oṃ hrī& hū& hrā& phre& kṣo& kro& namaḥ arghapātrabhaṭṭārikāyai pādukāṃ 5 ||	om hrī hū hrā phre    namaḥ arghapātra bhaṭṭārikāyai pādukām 
SA_MB_ugracandapujapaddhatiHK-38	ṣaḍaṃgena saṃpūjya || āvāhanādi yonimudrāṃ darśayet || bhūtaśūddhiḥ ||	ṣaḍaṃgena saṃpūjya āvāhana ādi yonimudrām darśayet 
SA_MB_ugracandapujapaddhatiHK-39	mūlamantrena ātmapūjā || āvāhana ||	mūlamantrena ātma pūjā āvāhana 
SA_MB_ugracandapujapaddhatiHK-40	ai& 5 jā& sā parāparāsūkṣmī khagasthā khagarūpiṇai ||	ai jā sā parāparā sūkṣmī khaga sthā khaga rūpiṇā 
SA_MB_ugracandapujapaddhatiHK-41	śuralokagatā devī māyā ihamaṇḍale ||	śura loka gatā devī māyā iha maṇḍale 
SA_MB_ugracandapujapaddhatiHK-42	2b) kṣetravaṭukagaṇa || vali || mudrā || ai& 5 ādhāraśaktetyādi || 8 ||	kṣetra vaṭuka gaṇa vali mudrā ai ādhāra śakta ityādi 
SA_MB_ugracandapujapaddhatiHK-43	mahiṣāsnāya 2 || siṃhāsnāya 2 || śuṃbhāsnāya || niśuṃbhāsnāya 2 ||	mahiṣāsnāya siṃhāsnāya śuṃbhāsnāya niśuṃbhāsnāya 
SA_MB_ugracandapujapaddhatiHK-44	namaḥ śrī& hrī& caṇḍacogrāyai namaḥ śrī& hrī& namaḥ || rudracaṇḍādi || 8 ||	namaḥ śrī hrī caṇḍa ca ugrāyai namaḥ śrī hrī namaḥ rudra caṇḍa ādi 
SA_MB_ugracandapujapaddhatiHK-45	ai& 5 hskhphre& siddhicāmuṇḍeśvarī namaḥ ||	ai hskhphre siddhicāmuṇḍā īśvarā namaḥ 
SA_MB_ugracandapujapaddhatiHK-46	oṃ hrī& rājaprade hsphre& ugracaṇḍeripumardanī hū& phre& sadārakṣa 2 tvā& mā& ju&	om hrī rāja prade ugracaṇḍā ripu mardanī hū phre sadā rakṣa tvā mā 
SA_MB_ugracandapujapaddhatiHK-47	saḥ mṛtyuhare pādukāṃ ||	saḥ mṛtyu hare pādukām 
SA_MB_ugracandapujapaddhatiHK-48	oṃ hrī& rājaprade śphre& ugracaṇḍīripumardanī hū& phre& sadārakṣa 2 tvā& mā&	om hrī rāja prade śphre ugracaṇḍī ripu mardanī hū phre sadā rakṣa tvā mā 
SA_MB_ugracandapujapaddhatiHK-49	ju& saḥ mṛtyuhare pādukāṃ ||	ju saḥ mṛtyu hare pādukām 
SA_MB_ugracandapujapaddhatiHK-50	ai& 5 khphre& hrī& śrī& la& oḍḍiyāṇapiṭhāye pādukāṃ 5 ||	ai khphre hrī śrī la pādukām 
SA_MB_ugracandapujapaddhatiHK-51	ai& 5 khphre& hrī& śrī& va& jālaṃdharapīthāye pādukāṃ  5 ||	ai pādukām 
SA_MB_ugracandapujapaddhatiHK-52	ai& 5 khphre& śrī& ra& pūrṇagiripīṭhāya pādukāṃ 5 ||	ai khphre śrī ra pūrṇagiri pīṭhāya pādukām 
SA_MB_ugracandapujapaddhatiHK-53	3a) ai& 5 khphre& hrī& śrī& ya& kāmarūpapīṭhāye pādukāṃ 5 ||	a ai hrī śrī pādukām 
SA_MB_ugracandapujapaddhatiHK-54	ai& 5 khphre& mahāpretāsanāya pādukāṃ 5 || dhyāna ||	ai khphre mahāpreta āsanāya pādukām 
SA_MB_ugracandapujapaddhatiHK-55	mahā tejo mapi lakṣmī rasmikobhyāyutaprabhā |	mahā lakṣmī 
SA_MB_ugracandapujapaddhatiHK-56	pañcavaktrā daśabhujā tripañcanayanaiyutā ||	pañca vaktrā daśa bhujā tri pañca nayanaiḥ yutā 
SA_MB_ugracandapujapaddhatiHK-57	svetavarṇā mahādevī mahāpretā paristhitā |	svetavarṇā mahādevī mahāpretā paristhitā 
SA_MB_ugracandapujapaddhatiHK-58	mātṛkāṣṭakamadhye tu siddhiyogiṇi pūjitā ||	mātṛkā aṣṭaka madhye tu siddhiyogiṇi pūjitā 
SA_MB_ugracandapujapaddhatiHK-59	dālitāsyā lelihānāṃ jvālāpnāṣṭakṛtaṃ jagat |	dālita āsyā lelihānām jvālā apnāṣṭa kṛtam jagat 
SA_MB_ugracandapujapaddhatiHK-60	udhvāsocchusayogeṇacālayet kulaparvatā ||	kula parvatā 
SA_MB_ugracandapujapaddhatiHK-61	kvacidveśe kvacit kuṭya kvacit saṃharate calāt ||	kvacid veśe kvacid kvacid saṃharate calāt 
SA_MB_ugracandapujapaddhatiHK-62	kvacitsṛje kvacillyālyaiḥ svatatrācchā pravartate ||	kvacid sṛje kvacid lyālyaiḥ svatatra acchā pravartate 
SA_MB_ugracandapujapaddhatiHK-63	śeṣāśobharaṇairyuktā mulagendravibhūkṣitā |	śeṣā śobharaṇaiḥ yuktā mulaga indra vibhūkṣitā 
SA_MB_ugracandapujapaddhatiHK-64	pāśāṅkusadharādevī varadābhayapāṇinī ||	              
SA_MB_ugracandapujapaddhatiHK-65	3b) vāmahaste dhṛtakhaḍgaṃ trailokyakṣaubhakārake |	vāma haste dhṛta khaḍgam trailokya kṣaubha kārake 
SA_MB_ugracandapujapaddhatiHK-66	vāme khaṭvāṅgamatyugra dakṣiṇeśūlamuttamaṃ ||	vāme khaṭvāṅgam ati ugra dakṣiṇe śūlam uttamam 
SA_MB_ugracandapujapaddhatiHK-67	aparekaṇḍaraṃ raudraṃ kṣatajāsa ca pūjitaṃ |	raudram ca pūjitam 
SA_MB_ugracandapujapaddhatiHK-68	savyahaste sa deśāvai muṇḍasonitasādrakaṃ ||	savya haste sa 
SA_MB_ugracandapujapaddhatiHK-69	vāme tu kalaśaṃ divyaṃ mahāratnaprapūrite |	vāme tu kalaśam divyam mahā ratna prapūrite 
SA_MB_ugracandapujapaddhatiHK-70	eṣā pratyaṃgirā devī utmanma vyomadehigā ||	eṣā pratyaṃgirā devī vyoma dehi gā 
SA_MB_ugracandapujapaddhatiHK-71	ekāśāneka bhedena viśvaṃvyāpya vyavasthitā ||	ekāśā aneka bhedena viśvam vyāpya vyavasthitā 
SA_MB_ugracandapujapaddhatiHK-72	pratyaṃgirā mahādevī siddhilakṣmīṃ jayapradā ||	pratyaṃgirāḥ mahādevī siddhi lakṣmīm jaya pradā 
SA_MB_ugracandapujapaddhatiHK-73	iti dhyāna puṣpa namaḥ ||	iti dhyāna puṣpa namaḥ 
SA_MB_ugracandapujapaddhatiHK-74	ai& 5 śrīsiddhilakṣmī vidmahe navatyāyadhīmahe tanno lakṣmī pracodayāt ||	ai śrī siddhi lakṣmī vidmahe navatyāya dhīmahe tat naḥ lakṣmī pracodayāt 
SA_MB_ugracandapujapaddhatiHK-75	ai& 5 oṃ nama sarvasiddhi yogiṇībhyāṃ namaḥ sarvasiddhi mātṛbhyo namo	ai om nama sarva siddhi yogiṇībhyām namaḥ sarva siddhi mātṛbhyaḥ namo 
SA_MB_ugracandapujapaddhatiHK-76	nityoditānandanaṇḍitāyai sakarakulacakranāyikāyai bhagavatyai	nitya udita ānanda naṇḍitāyai sakara kula cakra nāyikāyai bhagavatyai 
SA_MB_ugracandapujapaddhatiHK-77	caṇḍakāpālinyai tadyathā oṃ hrī& hū& hrā& phre& kṣo& kro& namaḥ ||	caṇḍakāpālinyai tat yathā om hrī hū hrā phre    namaḥ 
SA_MB_ugracandapujapaddhatiHK-78	4a) paramahaṃśinī nirvānamārgadevi samopaplavaprasamanī sakaladuritā	parama haṃśinī nirvāna mārga devi sama upaplava prasamanī sakala duritā 
SA_MB_ugracandapujapaddhatiHK-79	riṣṭakleśadalanī sarvā padāmbhodhitalanī śakalaśatru prathamanī devī āgaccha	riṣṭa kleśa dalanī sarvā pada ambhodhi talanī devī āgaccha 
SA_MB_ugracandapujapaddhatiHK-80	2 hasa 2 valla 2 nararudhirātra vasākṣanī samasvaśatru marda 2 khāhi 2 triśūlena	hasa valla nara rudhira atra vasa akṣanī sama sva śatru marda khāhi triśūlena 
SA_MB_ugracandapujapaddhatiHK-81	bhiṇḍi 2 cchindi 2 khaḍgena tāḍaya 2 cedaya 2 tāvadyāvat	bhindi chindi khaḍgena tāḍaya cedaya tāvat yāvat 
SA_MB_ugracandapujapaddhatiHK-82	mamaśakalamanārathā na sādhaya 2 paramakārunike bhagavatī	mama śakalam anārathā na sādhaya parama kārunike bhagavatī 
SA_MB_ugracandapujapaddhatiHK-83	mahābhairavarūpadhāriṇī tridaśaraśamite sakalamantramātaḥ pralatajalavatsale	                                   
SA_MB_ugracandapujapaddhatiHK-84	devī mahākālikālanāśanī oṃ hū& 3 prasīdamadanāturā hrī& kuru 2	devī mahākāli kālanāśanī om   prasīda madana āturā hrī kuru 
SA_MB_ugracandapujapaddhatiHK-85	surāsurakarṇikā hrī& śrī& hū& phaṭ svāhā || vali ||	sura asura karṇikā hrī śrī hū phaṭ svāhā vali 
SA_MB_ugracandapujapaddhatiHK-86	ai& 5 oṃ hrī& hū& hā& phre& kṣo& kro& namaḥ || triyāñjali || 2 ||	ai om hrī hū hā phre     namaḥ triyā añjali 
SA_MB_ugracandapujapaddhatiHK-87	khphre& karmagaṇapatinātha pādukāṃ ||	khphre karma gaṇapati nātha pādukām 
SA_MB_ugracandapujapaddhatiHK-88	khphre& karmagaṇapatināthavallabhāmvā pādukāṃ ||	karma gaṇapati nātha vallabhā vā pādukām 
SA_MB_ugracandapujapaddhatiHK-89	khphre& karmavaṭukanātha pādukāṃ ||	karma vaṭuka nātha pādukām 
SA_MB_ugracandapujapaddhatiHK-90	khphre& karmavaṭukanāthavallalamvā pādukāṃ ||	karma vaṭuka nātha valla lamvā pādukām 
SA_MB_ugracandapujapaddhatiHK-91	khphre& oṃkārapīṭhanātha pādukāṃ ||	oṃkāra pīṭha nātha pādukām 
SA_MB_ugracandapujapaddhatiHK-92	khphre& vṛkṣaśakaṭanātha pādukāṃ ||	vṛkṣa śakaṭa nātha pādukām 
SA_MB_ugracandapujapaddhatiHK-93	khphre& hū& grahākalavīla śmaśānanātha pādukāṃ ||	khphre hū grahākalavīla śmaśānanātha pādukām 
SA_MB_ugracandapujapaddhatiHK-94	khphre& sarva śaṃhāriṇī āmvā pādukāṃ ||	sarva śaṃhāriṇī āmvā pādukām 
SA_MB_ugracandapujapaddhatiHK-95	khphre& sarvasaṃhāriṇī valātkaṭa kṣetrapālanāthavallabhāmvā pādukāṃ ||	sarva saṃhāriṇī pādukām 
SA_MB_ugracandapujapaddhatiHK-96	ai& 5 haṃsāsanāya pādukāṃ || ai& 5 vṛṣāsanāya pādukāṃ ||	ai haṃsa āsanāya pādukām ai vṛṣa āsanāya pādukām 
SA_MB_ugracandapujapaddhatiHK-97	5a) ai& 5 mayūrāsanāya pādukāṃ || ai& 5 garuḍāsanāya pādukāṃ ||	a ai mayūrāsanāya pādukām ai garuḍāsanāya pādukām 
SA_MB_ugracandapujapaddhatiHK-98	ai& 5 mahiṣāsanāya pādukāṃ || ai& 5 gajāsanāya pādukāṃ ||	ai mahiṣa āsanāya pādukām ai gaja āsanāya pādukām 
SA_MB_ugracandapujapaddhatiHK-99	ai& 5 pretāsanāya pādukāṃ || ai& 5 narāsanāya pādukāṃ ||	ai preta āsanāya pādukām ai narāsanāya pādukām 
SA_MB_ugracandapujapaddhatiHK-100	ai& 5 vrahmāṇī aśitāṅgabhairavanāthasahita pādukāṃ ||	ai vrahmāṇī aśita aṅga bhairava nātha sahita pādukām 
SA_MB_ugracandapujapaddhatiHK-101	ai& 5 ka& māneśvarī rurubhairavanāthasahita pādukāṃ ||	ai ka māneśvarī ruru bhairava nātha sahita pādukām 
SA_MB_ugracandapujapaddhatiHK-102	ai& 5 ca& kaumārīcaṇḍabhairavanāthasahita pādukāṃ ||	ai ca kaumārī caṇḍa bhairava nātha sahita pādukām 
SA_MB_ugracandapujapaddhatiHK-103	ai& 5 ṭa& vaiṣṇavīkrodhabhairavanāthasahita pādukāṃ ||	ai ṭa vaiṣṇavī krodhabhairava nātha sahita pādukām 
SA_MB_ugracandapujapaddhatiHK-104	ai& 5 ta& vārāhī unmaṃta bhairavanāthasahita pādukāṃ ||	ai te vārāhī unmanta bhairava nātha sahita pādukām 
SA_MB_ugracandapujapaddhatiHK-105	ai& 5 pa& indrānī kalālīsa bhairavanāthasahita pādukāṃ ||	ai indrānī kalālīsa bhairava nātha sahita pādukām 
SA_MB_ugracandapujapaddhatiHK-106	ai& 5 ya& cāmuṇḍābhīkhala bhairavanāthasahita pādukāṃ ||	ai cāmuṇḍa abhīkhala bhairava nātha sahita pādukām 
SA_MB_ugracandapujapaddhatiHK-107	5b) ai& 5 sa& mahālakṣmī saṃhāra bhairavanāthasahita pādukāṃ || thvatesaṃvali	                    
SA_MB_ugracandapujapaddhatiHK-108	|| iti mātṛkāṃ || khphre& śivādevī amvāpādukāṃ 5 ||	iti mātṛkām 
SA_MB_ugracandapujapaddhatiHK-109	khphre& bhagavati devī amvāpādukāṃ 5 ||	bhagavati devī 
SA_MB_ugracandapujapaddhatiHK-110	khphre& māyādevī amvā pādukāṃ 5 ||	māyādevī amvā pādukām 
SA_MB_ugracandapujapaddhatiHK-111	ai& 5 khphre& bhadrā devī amvā pādukāṃ 5 ||	ai khphre bhadrā devī amvā pādukām 
SA_MB_ugracandapujapaddhatiHK-112	khphre& kiniradevī amvā pādukāṃ 5 ||	khphre kiniradevī amvā pādukām 
SA_MB_ugracandapujapaddhatiHK-113	khphre& vilāli devī amvā pādukāṃ 5 ||	vilāli devī amvā pādukām 
SA_MB_ugracandapujapaddhatiHK-114	khphre& yamajihvā devī amvāpādukāṃ 5 ||	yamajihvā devī 
SA_MB_ugracandapujapaddhatiHK-115	khphre& tvakṣakarṣanī devī amvā pādukāṃ 5 ||	tvakṣa karṣanī devī amvā pādukām 
SA_MB_ugracandapujapaddhatiHK-116	khphre& ghaṃṭodarī amvā pādukāṃ 5 ||	ghaṃṭodarī pādukām 
SA_MB_ugracandapujapaddhatiHK-117	khphre& coramātarīdevī amvā pādukāṃ 5 ||	coramātarīdevī amvā pādukām 
SA_MB_ugracandapujapaddhatiHK-118	khphre& kiṃkinidevī amvā pādukāṃ 5 ||	kiṃkinidevī amvā pādukām 
SA_MB_ugracandapujapaddhatiHK-119	khphre& kākinī devī amvā pādukāṃ 5 || thvata saṃnnali ||	kākinī devī amvā pādukām 
SA_MB_ugracandapujapaddhatiHK-120	khphre& ḍā& ḍākinī pādukāṃ 5 || khphre& ra& rākiṇī pādukāṃ 5 ||	ḍā ḍākinī pādukām   khphre ra rākiṇī pādukām 
SA_MB_ugracandapujapaddhatiHK-121	6a) khphre& lā& lākiṇī pādukāṃ 5 || khphre& kā& kākiṇī pādukāṃ 5 ||	a khphre lā lākiṇī pādukām   khphre kā kākiṇī pādukām 
SA_MB_ugracandapujapaddhatiHK-122	khphre& sā& sākiṇī pādukāṃ 5 || khphre& hā& hākiṇī pādukāṃ 5 ||	sā sākiṇī pādukām   khphre hā hākiṇī pādukām 
SA_MB_ugracandapujapaddhatiHK-123	khphre& yā& yākiṇī pādukāṃ 5 || thvate saṃvali || triyāñjali ||	pādukām      
SA_MB_ugracandapujapaddhatiHK-124	ai& 5 pretāsanāya pādukāṃ 5 || ai& 5 hrī& hū& hā& phe& kṣo& kro& namaḥ	ai preta āsanāya pādukām ai hrī hū hā phe     namaḥ 
SA_MB_ugracandapujapaddhatiHK-125	śrīsiddhilakṣmī devyāyai pādukāṃ 5 || āvali || ai& 5 śivāsanāya pādukāṃ 5 ||	śrī siddhilakṣmī devyāyai pādukāṃ   /
SA_MB_ugracandapujapaddhatiHK-126	ai& 5 oṃ phre& siddhikalāli  hrī& cchrī& hū& strī& phre& nama svāhā || 3 ||	ai om phre siddhikalā ali hrī cchrī hū strī phre nama svāhā 
SA_MB_ugracandapujapaddhatiHK-127	triyāñjali || vali || nirvānacchāya || tvākamahāvaliviya || dhuve || dīpa || jāpa ||	vali dhuve dīpa jāpa 
SA_MB_ugracandapujapaddhatiHK-128	trideva || hsphre& svāhā || śphre& svāhā || oṃ hrī& hū& hā& phre& kṣo& kro& nama	trideva hsphre svāhā śphre svāhā om hrī hū hā phre kṣo kro nama 
SA_MB_ugracandapujapaddhatiHK-129	svāhā ||	svāhā 
SA_MB_ugracandapujapaddhatiHK-130	oṃ phre& siddhikarāli hrī& cchrī& hū& strī& phre& nama svāhā || 108 ||	om phre siddhikarāli hrī cchrī hū strī phre nama svāhā 
SA_MB_ugracandapujapaddhatiHK-131	6b) stotra || śrīsamvartā || mārkadevo || jādevī || utphalāṃ || yāsaṃntakāgni ||	mārkadevaḥ jādevī 
SA_MB_ugracandapujapaddhatiHK-132	yathā vāna || atra gandhādi || tarpana || samayacchāya || ekāneka || amvapūrva ||	yathā vāna atra gandha ādi tarpana samaya chāya eka aneka 
SA_MB_ugracandapujapaddhatiHK-133	valivisarjana || iti ugracaṇḍā ugracaṇḍī siddhilakṣmī guhyakāli devārcanavidhi	vali visarjane iti ugracaṇḍā ugracaṇḍī siddhilakṣmī guhyakāli deva arcana vidhi 
SA_MB_ugracandapujapaddhatiHK-134	samāpta ||	samāpta 
SA_MB_ugracandapujapaddhatiHK-135	atha pūrvāmnāya devārcana || gurunamaskāra || arghapātrāsanāya pādukāṃ ||	atha pūrva āmnāya deva arcana guru namaskāra arghapātra āsanāya pādukām 
SA_MB_ugracandapujapaddhatiHK-136	kūrmāsanāya pādukāṃ || ānmāsanāya pādukāṃ ||	kūrma āsanāya pādukām 
SA_MB_ugracandapujapaddhatiHK-137	kini 2 vicce koṅkaṇāmvā antaśakti astrāya phaṭ || 2 ||	            
SA_MB_ugracandapujapaddhatiHK-138	oṃ hū& vajrapañjale svāhā || oṃ hū& calamakulekulamacale hrā& hrī& hrū& phaṭ	om hū vajrapañjale svāhā om hū calamakulekulamacale hrā hrī hrū phaṭ 
SA_MB_ugracandapujapaddhatiHK-139	svāhā || antakāyai phaṭ || ai& 5 kaniṣṭakāyai namaḥ || hrā& anāmikāyai svāhā ||	svāhā antakāyai phaṭ ai kaniṣṭakāyai namaḥ hrā anāmikāyai svāhā 
SA_MB_ugracandapujapaddhatiHK-140	7a) śrīmadhyemāyai voṣaṭ || khphre& tarjanyāyai hū& ||	a śrī madhya imāyai voṣaṭ khphre tarjanyāyai hū 
SA_MB_ugracandapujapaddhatiHK-141	hsau& aṃguṣṭhāyai vaṣaṭ || antakāyai phaṭ || ai& ūddhavaktrāyai namaḥ ||	hsau aṃguṣṭhāyai vaṣaṭ antakāyai phaṭ ai ūddhavaktrāyai namaḥ 
SA_MB_ugracandapujapaddhatiHK-142	hrī& pūrvavaktrāyai namaḥ || śrī& dakṣiṇavaktrāyai namaḥ ||	hrī pūrva vaktrāyai namaḥ śrī dakṣiṇa vaktrāyai namaḥ 
SA_MB_ugracandapujapaddhatiHK-143	khphre& uttaravaktrāyai namaḥ || hsau& paścimavaktrāyai namaḥ ||	uttara vaktrāyai namaḥ hsau paścima vaktrāyai namaḥ 
SA_MB_ugracandapujapaddhatiHK-144	antarakāye parāparavaktrāye namaḥ || ai& hṛdayāya namaḥ ||	antarakāye parāparavaktrāye namaḥ ai hṛdayāya namaḥ 
SA_MB_ugracandapujapaddhatiHK-145	hrī& sirase svāhā || śrīśikhāye vaṣaṭ || khphre& kavacāya hū& ||	hrī sirase svāhā śrī śikhāye vaṣaṭ khphre kavacāya hū 
SA_MB_ugracandapujapaddhatiHK-146	hsau& netratrayāya vaṣaṭ || antarakāya phaṭ || iti karavaktraṃ aṅgaṃ nyāsa ||	hsau netratrayāya vaṣaṭ antarakāya phaṭ iti kara vaktram aṅgam nyāsa 
SA_MB_ugracandapujapaddhatiHK-147	mūlaṃ nyāsa || kiṇi 2 vicce koṅkaṇāmvā anantaśakti astrāya phaṭ ||	               
SA_MB_ugracandapujapaddhatiHK-148	karasodhanaṃ || bhagavati amve hskhphū& hṛtkamalāyai aṅguṣṭhāyai namaḥ ||	kara sodhanam bhagavati amve hskhphū hṛd kamalāyai aṅguṣṭhāyai namaḥ 
SA_MB_ugracandapujapaddhatiHK-149	śkhphrī& kuvjikekuladīpāyai tarjanyāyai svāhā ||	śkhphrī kuvjikekuladīpāyai tarjanyāyai svāhā 
SA_MB_ugracandapujapaddhatiHK-150	7b) śrā& śrī& śū& varvaraśikhāyai madhyemāyai vaṣaṭ ||	b śrā śrī śū varvaraśikhāyai madhyemāyai vaṣaṭ 
SA_MB_ugracandapujapaddhatiHK-151	calamakura aghorāmukhī anāmikāyai hū& ||	cala makura aghorā mukhī anāmikāyai hū 
SA_MB_ugracandapujapaddhatiHK-152	chā& cchī& mahaṃtārikāyai kaniṣṭhikāyai vaṣaṭ ||	chā cchī mahaṃtārikāyai kaniṣṭhikāyai vaṣaṭ 
SA_MB_ugracandapujapaddhatiHK-153	kiṇi 2 vicce koṅkaṇamvā hra& astāye phaṭ || karaṃ nyāsa || atha vaktraṃ nyāsa ||	kiṇi vicce koṅkaṇamvā hra phaṭ karam nyāsa atha vaktram nyāsa 
SA_MB_ugracandapujapaddhatiHK-154	bhagavati amve hskhphrū& hṛtkamalāyai urddhavaktrāya pādukāṃ ||	bhagavati amve hskhphrū hṛd kamalāyai urddha vaktrāya pādukām 
SA_MB_ugracandapujapaddhatiHK-155	śkhphrī& kuvjikāyai kuladīpāyai vūrvavaktrāya pādukāṃ ||	śkhphrī kuvjikāyai kuladīpāyai vūrva vaktrāya pādukām 
SA_MB_ugracandapujapaddhatiHK-156	śrā& śrī& śū& varvaraśikhāyai dakṣiṇavaktrāyai pādukāṃ ||	śrā śrī śū varvara śikhāyai dakṣiṇa vaktrāyai pādukām 
SA_MB_ugracandapujapaddhatiHK-157	calamakule aghorāmukhī uttaravaktrāyai pādukāṃ ||	cala makule aghorā mukhī uttara vaktrāyai pādukām 
SA_MB_ugracandapujapaddhatiHK-158	cchā& cchī& mahantārikāyai paścimavaktrāyai pādukāṃ ||	cchā cchī mahantārikāyai paścima vaktrāyai pādukām 
SA_MB_ugracandapujapaddhatiHK-159	kini 2 vicce komaṇāmvāparāparaṃ vaktrāyai pādukāṃ || vaktranyāsaṃ ||	kini vicce vaktrāyai pādukām vaktra nyāsam 
SA_MB_ugracandapujapaddhatiHK-160	punaḥ aṅgaṃ nyāsa || bhagavati amve hskhphre& hṛtkamalāyai hṛdayāya namaḥ ||	punar aṅgam nyāsa bhagavati amve hskhphre hṛd kamalāyai hṛdayāya namaḥ 
SA_MB_ugracandapujapaddhatiHK-161	8a) śkhphrī& kuvjikāyai kuladīpāyai śirase svāhā ||	a śkhphrī kuvjikāyai kuladīpāyai śirase svāhā 
SA_MB_ugracandapujapaddhatiHK-162	śrā& śrī& śū& varvaraśikheśikhāyai vauṣaṭ ||	śrā śrī śū varvara śikheśikhāyai vauṣaṭ 
SA_MB_ugracandapujapaddhatiHK-163	calamakule aghorāmukhī kavacāya hū& ||	cala makule aghorā mukhī kavacāya hū 
SA_MB_ugracandapujapaddhatiHK-164	chā& cchī& mahantārikāyai netratrayāya vaṣaṭ ||	chā cchī mahantārikāyai netratrayāya vaṣaṭ 
SA_MB_ugracandapujapaddhatiHK-165	kiṇi 2 vicce koṅkaṇāmvā anantaśakti astrāya phaṭ || ṣaḍaṃga nyāsa ||	kiṇi vicce anantaśakti astrāya phaṭ ṣaḍaṃga nyāsa 
SA_MB_ugracandapujapaddhatiHK-166	jalapātrāsanāya pādukāṃ ||	jala pātra āsanāya pādukām 
SA_MB_ugracandapujapaddhatiHK-167	ai& 5 bhagavati amve hskhphrū& śkhphrī& kuvjike śrā& śrī& śū& calamakule	ai bhagavati amve hskhphrū śkhphrī kuvjike śrā śrī śū calamakule 
SA_MB_ugracandapujapaddhatiHK-168	aghorāmukhī cchā& cchī& kiṇi 2 vicce 5 jalapātrabhaṭṭārikāye pādukāṃ ||	aghorāmukhī pādukām 
SA_MB_ugracandapujapaddhatiHK-169	ṣaḍaṅga || āvāhanādi dhenumudrāṃ darśayet || gāyatri ||	ṣaṣ aṅge āvāhana ādi dhenu mudrām darśayet gāyatri 
SA_MB_ugracandapujapaddhatiHK-170	ai& 5 mitrināthāya vidmahe kulakolinidhimahe tanno kuvji pracodayāt ||	ai mitri nāthāya vidmahe tat naḥ kuvji pracodayāt 
SA_MB_ugracandapujapaddhatiHK-171	sarvadarvrathākṣaṇādi ātmasiṃcayet || arghapātrāsanāya pādukāṃ ||	sarva darvratha akṣaṇa ādi ātma siṃcayet arghapātra āsanāya pādukām 
SA_MB_ugracandapujapaddhatiHK-172	8b) hrī& hrī& glū& hrī& hrī& slū& hrī& hrī& plū& hrī& hrī& nlū& ||	hrī hrī glū hrī hrī slū hrī hrī plū hrī hrī nlū 
SA_MB_ugracandapujapaddhatiHK-173	glū& slū& plū& mlū& nlū& paramāmṛta arghapātrāye namaḥ ||	glū slū plū mlū nlū parama amṛta arghapātrāye namaḥ 
SA_MB_ugracandapujapaddhatiHK-174	ai& 5 bhagavati amve hskhphrū& śkhphrī& kuvjike śrā& śrī& śrū& calamakule	ai bhagavati amve hskhphrū śkhphrī kuvjike śrā śrī śrū calamakule 
SA_MB_ugracandapujapaddhatiHK-175	aghorāmukhī cchā& cchī& kiṇi 2 vicce 5 śrīarghapātrabhaṭṭārikāye pādukāṃ ||	aghorā mukhī cchā cchī kiṇi vicce śrī arghapātra bhaṭṭārikāye pādukām 
SA_MB_ugracandapujapaddhatiHK-176	ṣaḍaṃga || āvāhanādi yoni mudrāṃ darśayat ||	ṣaṣ aṅge āvāhana ādi yoni mudrām darśayat 
SA_MB_ugracandapujapaddhatiHK-177	ai& hrī& śrī& khphre& hskau& hsau& khphre& śrī& hrī& ai& || thvatenabhūtaśuddhi ||	ai hrī śrī khphre hskau hsau khphre śrī hrī ai 
SA_MB_ugracandapujapaddhatiHK-178	ātmapūjā || āvāhana || samvartāna || musāsanāya pādukāṃ ||	ātma pūjā āvāhana samvartāna musā āsanāya pādukām 
SA_MB_ugracandapujapaddhatiHK-179	nurāsanāya pādukāṃ || narāsanāya pādukāṃ || ai& 5 gā& gī& gū& gaḥ glau&	nurāsanāya pādukām narāsanāya pādukām  ai gāḥ gī gū gaḥ glau 
SA_MB_ugracandapujapaddhatiHK-180	śrīkulagaṇeśvarāya pādukāṃ ||	śrī kula gaṇa īśvarāya pādukām 
SA_MB_ugracandapujapaddhatiHK-181	ai& 5 śrī& hrī& kulaputravaṭukanāthāya pādukāṃ ||	ai śrī hrī kula putra vaṭuka nāthāya pādukām 
SA_MB_ugracandapujapaddhatiHK-182	ai& 5 thro& kaṭādīpadambhakī devī dhvāṃkṣetrapālāya pādukāṃ ||	ai thro kaṭā dīpa dambhakī devī dhvāṃ kṣetrapālāya pādukām 
SA_MB_ugracandapujapaddhatiHK-183	9a) thvatenavali || āvāhanādi || gajadaṇḍatarjanī mudrāṃ darśayet ||	āvāhana ādi gaja daṇḍa tarjanī mudrām darśayet 
SA_MB_ugracandapujapaddhatiHK-184	ai& 5 haṃsāsanāya pādukāṃ || ai& 5 vṛṣāsanāya pādukāṃ ||	ai haṃsa āsanāya pādukām ai vṛṣa āsanāya pādukām 
SA_MB_ugracandapujapaddhatiHK-185	ai& 5 mayurāsanāya pādukāṃ || ai& 5 garuḍāsanāya pādukāṃ ||	ai mayurāsanāya pādukām ai garuḍāsanāya pādukām 
SA_MB_ugracandapujapaddhatiHK-186	ai& 5 mahiṣāsanāya pādukāṃ || ai& 5 gajāsanāya pādukāṃ ||	ai mahiṣa āsanāya pādukām ai gaja āsanāya pādukām 
SA_MB_ugracandapujapaddhatiHK-187	ai& 5 pretāsanāya pādukāṃ || ai& 5 jarāsanāya pādukāṃ ||	ai pretāsanāya pādukām ai jarāsanāya pādukām 
SA_MB_ugracandapujapaddhatiHK-188	ai& 5 avrahmāyaṇī devī aśitāṅgabhairavāya pādukāṃ ||	ai avrahmāyaṇī devī aśita aṅga bhairavāya pādukām 
SA_MB_ugracandapujapaddhatiHK-189	ai& 5 ka& māheśvarī devī rurubhairavāya pādukāṃ ||	ai ka māheśvarī devī rurubhairavāya pādukām 
SA_MB_ugracandapujapaddhatiHK-190	ai& 5 ca& komāridevī caṇḍabhairavāya pādukāṃ ||	ai ca komārī devī caṇḍabhairavāya pādukām 
SA_MB_ugracandapujapaddhatiHK-191	ai& 5 ta& vaiṣṇavī devī krodhabhairavāya pādukāṃ ||	ai te vaiṣṇavī devī krodhabhairavāya pādukām 
SA_MB_ugracandapujapaddhatiHK-192	ai& 5 ta& vārāhi devī unmattabhairavāya pādukāṃ ||	ai vārāhi devī unmattabhairavāya pādukām 
SA_MB_ugracandapujapaddhatiHK-193	9b) ai& 5 pa& indrāṇī devī kapālīśa bhairavāya pādukāṃ ||	indrāṇī devī kapālī īśa bhairavāya pādukām 
SA_MB_ugracandapujapaddhatiHK-194	ai& 5 ya& cāmuṇḍā devī bhīṣaṇabhairavāya pādukāṃ ||	cāmuṇḍā devī bhīṣaṇa bhairavāya pādukām 
SA_MB_ugracandapujapaddhatiHK-195	ai& 5 sa& mahālakṣmī devī sa& hālabhairavāya pādukāṃ ||	ai sa mahālakṣmī devī sa hālabhairavāya pādukām 
SA_MB_ugracandapujapaddhatiHK-196	thvataṃ saṃvali || ai& 5 śavāsanāya pādukāṃ ||	ai śavāsanāya pādukām 
SA_MB_ugracandapujapaddhatiHK-197	hskhphre& siddhicāmuṇḍāyai pādukāṃ || vali || bhagavati pūjā ||	siddhicāmuṇḍāyai pādukām bhagavati pūjā 
SA_MB_ugracandapujapaddhatiHK-198	ai& 5 ādhāraśaktaye pādukāṃ || ai& 5 phre& antāsanāya pādukāṃ ||	ai ādhāra śaktaye pādukām ai phre anta āsanāya pādukām 
SA_MB_ugracandapujapaddhatiHK-199	ai& 5 kaṇḍāsanāya pādukāṃ || ai& 5 nārāsanāya pādukāṃ ||	ai kaṇḍāsanāya pādukām ai nārāsanāya pādukām 
SA_MB_ugracandapujapaddhatiHK-200	ai& 5 patrāsanāya pādukāṃ || ai& 5 keśarāsanāya pādukāṃ ||	ai patrāsanāya pādukām ai keśarāsanāya pādukām 
SA_MB_ugracandapujapaddhatiHK-201	ai& 5 karṇīkāsanāya pādukāṃ || ai& 5 padmāsanāya pādukāṃ ||	ai karṇīkā āsanāya pādukām  ai padmāsanāya pādukām 
SA_MB_ugracandapujapaddhatiHK-202	ai& 5 mahiṣāsanāya pādukāṃ || ai& 5 siṃhāsanāya pādukāṃ ||	ai mahiṣa āsanāya pādukām ai siṃhāsanāya pādukām 
SA_MB_ugracandapujapaddhatiHK-203	ai& 5 śumbhasanāye pādukāṃ ||	ai pādukām 
SA_MB_ugracandapujapaddhatiHK-204	10a) ai& 5 niśumbhāsanāya pādukāṃ ||	ai niśumbha āsanāya pādukām 
SA_MB_ugracandapujapaddhatiHK-205	ai& 5 namaḥ śrī& hrī& candracogrāye namaḥ śrī& hrī& pādukāṃ ||	ai namaḥ śrī hrī namaḥ śrī hrī pādukām 
SA_MB_ugracandapujapaddhatiHK-206	ai& 5 śrīrudracaṇḍāyai pādukāṃ || ai& 5 śrīpracaṇḍāyai pādukāṃ ||	ai śrī rudracaṇḍāyai pādukām  ai śrī pracaṇḍāyai pādukām 
SA_MB_ugracandapujapaddhatiHK-207	ai& 5 śrīcaṇḍacagrāyai pādukāṃ || ai& 5 śrīcaṇḍanāyakāyai pādukāṃ ||	ai śrī caṇḍacagrāyai pādukām  ai śrī caṇḍanāyakāyai pādukām 
SA_MB_ugracandapujapaddhatiHK-208	ai& 5 śrīcaṇḍāyai pādukāṃ || ai& 5 śrīcaṇḍavatyai pādukāṃ ||	ai śrī caṇḍāyai pādukām  ai śrī caṇḍavatyai pādukām 
SA_MB_ugracandapujapaddhatiHK-209	ai& 5 śrīcaṇḍarūpāyai pādukāṃ || ai& 5 śrīaticaṇḍikāyai pādukāṃ ||	ai śrī caṇḍa rūpāyai pādukām  ai śrī aticaṇḍikāyai pādukām 
SA_MB_ugracandapujapaddhatiHK-210	ai& 5 oṃ hrī& rājaprade hsphre& ugracaṇḍaripumardanī hū& phre& sadārakṣa 2 tvā&	ai om hrī rāja prade ugracaṇḍa ripu mardanī hū phre sadā ārakṣa tvā 
SA_MB_ugracandapujapaddhatiHK-211	mā& ju& saḥ mṛtyuhare pādukāṃ || triyāñjali || vali ||	mā ju saḥ mṛtyu hare pādukām 
SA_MB_ugracandapujapaddhatiHK-212	āvahanādi mudrā daśayet || tato navātmā pūjā || ai& 5 ādināthāmnāya	āvahana ādi mudrāḥ daśayet tatas nava ātmā pūjā 
SA_MB_ugracandapujapaddhatiHK-213	pādukāṃ ||	pādukām 
SA_MB_ugracandapujapaddhatiHK-214	10b) ai& 5 hrī& bhairavanāthāsnāye pādukāṃ ||	ai hrī bhairava nāthā snāye pādukām 
SA_MB_ugracandapujapaddhatiHK-215	ai& 5 śrīsomanāthāsnāye pādukāṃ ||	ai śrī somanāthā snāye pādukām 
SA_MB_ugracandapujapaddhatiHK-216	ai& 5 khphre& āvartakanāthāsnāya pādukāṃ 5 ||	ai pādukām 
SA_MB_ugracandapujapaddhatiHK-217	ai& 5 hsau& mahāpretiśanāthāsnāya pādukāṃ 5 || thvate āsa ||	ai hsau pādukām 
SA_MB_ugracandapujapaddhatiHK-218	ai& 5 sa& bhṛgīśānandanātha pādukāṃ 5 ||	ai sa bhṛgīśa ānandanātha pādukām 
SA_MB_ugracandapujapaddhatiHK-219	ai& 5 ha& lakulīśānandanātha pādukāṃ 5 ||	ai ha lakulīśa ānandanātha pādukām 
SA_MB_ugracandapujapaddhatiHK-220	ai& 5 kṣa& saṃvartānandanātha pādukāṃ 5 ||	ai kṣa saṃvartānandanātha pādukām 
SA_MB_ugracandapujapaddhatiHK-221	ai& 5 ma& mahākālānandanātha pādukāṃ 5 ||	ai ma mahākāla ānandanātha pādukām 
SA_MB_ugracandapujapaddhatiHK-222	ai& 5 la& pināṃkīnandanātha pādukāṃ 5 ||	ai la pināṃkīnandanātha pādukām 
SA_MB_ugracandapujapaddhatiHK-223	ai& 5 va& khaḍgīśānandanātha pādukāṃ 5 ||	ai khaḍgīśa ānandanātha pādukām 
SA_MB_ugracandapujapaddhatiHK-224	ai& 5 ra& bhujaṅgīśānandanātha pādukāṃ 5 ||	ai ra bhujaṅgīśa ānandanātha pādukām 
SA_MB_ugracandapujapaddhatiHK-225	ai& 5 ya& vālīśānandanātha pādukāṃ 5 ||	ai vāli īśa ānandanātha pādukām 
SA_MB_ugracandapujapaddhatiHK-226	ai& 5 ū& arghīśānandanātha pādukāṃ 5 ||	ai ū arghīśa ānandanātha pādukām 
SA_MB_ugracandapujapaddhatiHK-227	ai& 5 śkṣmlvryū& śrīnavātmānandanātha pādukāṃ ||	ai śrī nava ātma ānandanātha pādukām 
SA_MB_ugracandapujapaddhatiHK-228	11a) triyāñjali || 3 || vali || iti navātmā pūjā || tato karmapūjā ||	          
SA_MB_ugracandapujapaddhatiHK-229	ai& 5 hā& hī& hū& hai& hau& haḥ kuleśvarī amvā pādukāṃ ||	ai hā hī hū hai hau haḥ kuleśvarī pādukām 
SA_MB_ugracandapujapaddhatiHK-230	ai& 5 sā& sī& sū& sai& sau& saḥ siddheśvarī amvā pādukāṃ ||	ai sā sī sū sai sau saḥ siddheśvarī amvā pādukām 
SA_MB_ugracandapujapaddhatiHK-231	ai& 5 yā& yī& yū& yai& yau& yaḥ ratnaśvarī amvā pādukāṃ ||	ai yā yī yū yai yau yaḥ pādukām 
SA_MB_ugracandapujapaddhatiHK-232	ai& 5 kṣā& kṣī& kṣū& kṣai& kṣau& kṣaḥ vidyaśvarī amvā pādukāṃ ||	ai kṣā kṣī kṣū kṣai kṣau kṣaḥ vidyaśvarī amvā pādukām 
SA_MB_ugracandapujapaddhatiHK-233	khambhādi catuskā ||	khambha ādi catuskā 
SA_MB_ugracandapujapaddhatiHK-234	ai& 5 śrīoḍiyānapīṭhe sukṣmīnāthasukṣmāmvā pādukāṃ ||	ai pādukām 
SA_MB_ugracandapujapaddhatiHK-235	ai& 5 śrījālandharapīṭhe susūkṣmanātha susūkṣmāmvā pādukāṃ ||	ai śrī jālandhara pīṭhe su sūkṣmanātha su sūkṣma amvā pādukām 
SA_MB_ugracandapujapaddhatiHK-236	ai& 5 śrīpūrṇagiripīṭhe antimanātha antimvā pādukāṃ ||	śrī pūrṇagiri pīṭhe pādukām 
SA_MB_ugracandapujapaddhatiHK-237	ai& 5 śrīkāmarūpapīṭhe amṛtatītamanātha amṛtātī amvā pādukāṃ ||	śrī kāmarūpa pīṭhe pādukām 
SA_MB_ugracandapujapaddhatiHK-238	11b) vali || tato dhyāna || ai& 5 bhuvanāṃ kulasaṃyuktaṃ padapatravibhūṣita |	tatas dhyāna kula saṃyuktam pada pattra vibhūṣita 
SA_MB_ugracandapujapaddhatiHK-239	varṇakaṇṭhakasaṭkīrṇaṃ mantracchidrasamanvitaṃ ||	varṇa kaṇṭhaka saṭkīrṇam mantra chidra samanvitam 
SA_MB_ugracandapujapaddhatiHK-240	kalāśubhrācitadivyaṃ tatva ganthyaparisthitaṃ ||	kalā śubhra ācita divyam ganthya paristhitam 
SA_MB_ugracandapujapaddhatiHK-241	kṣetrāpakṣetra saṃdohaiścaturvidaśa lāmvitaṃ ||	kṣetra apakṣetra saṃdohaiḥ caturvidaśa 
SA_MB_ugracandapujapaddhatiHK-242	kādibhāntā caturviṃśavarṇastrairūpasobhitaṃ ||	ka ādi bha antā caturviṃśa varṇaḥ trairūpa sobhitam 
SA_MB_ugracandapujapaddhatiHK-243	tatra madhya sthitādevī samitrā śrīkuvjikāyikā ||	tatra madhya sthitā devī sa mitrā śrī kuvjikāyikā 
SA_MB_ugracandapujapaddhatiHK-244	vedamuṇḍakṛtā mālāyātiścakṣutrayāñjari ||	              
SA_MB_ugracandapujapaddhatiHK-245	śivaśiddhāntaśāstrādyaiḥ sarvā bharaṇabhūṣitā ||	śiva śiddhānta śāstra ādyaiḥ sarvā bharaṇa bhūṣitā 
SA_MB_ugracandapujapaddhatiHK-246	ugrīranti mahoghena tatvajālasadoditaṃ ||	mahā oghena 
SA_MB_ugracandapujapaddhatiHK-247	dvibhujā saumyavadanā arupādā sūtriṇī ||	dvi bhujā saumya vadanā aru pādā sūtriṇī 
SA_MB_ugracandapujapaddhatiHK-248	mitrātsaṅgagatā devī anyānyarati lālasā ||	mitrāt saṅga gatā devī lālasā 
SA_MB_ugracandapujapaddhatiHK-249	phalāndālairanakaiśca atyānandasadāditau || pīṭhapīṭhādhipaijanikāva ||	phala āndālaiḥ anakaiḥ ca atyānanda sada āditau 
SA_MB_ugracandapujapaddhatiHK-250	12a) vākyavālāhā aghamāsanakṣatra || asyat kāya vāmano vāgjanitāse	vākya vāla ahā agha māsa nakṣatra asyat kāya vāmanaḥ vāc janitāse 
SA_MB_ugracandapujapaddhatiHK-251	sapāpaprasamenapūrakatāmraghaṭita suvarṇalikachatraṃ matānāṃ śirodaivata	suvarṇa lika chatram matānām 
SA_MB_ugracandapujapaddhatiHK-252	aśvamedhajajña anyephalasamaprāptikāmaḥ śrīimukadevyai jālasthatelanoparu	anyephala sama prāpti kāmaḥ śrī imuka devyai 
SA_MB_ugracandapujapaddhatiHK-253	cchatradānastubhyaṃ mahaṃdadaṃ || 4919	chatra dānaḥ tubhyam mahaṃdadam 
SA_MB_ugracandapujapaddhatiHK-254	13) yanāya aghoramṛtyuṃjayāyatantanetra śivārcana vidhetat sarvaṃ	aghora mṛtyuṃjaya śiva arcana sarvam 
SA_MB_ugracandapujapaddhatiHK-255	paripūrṇamastu ||	paripūrṇam astu 
SA_MB_ugracandapujapaddhatiHK-256	14a) oṃ namaḥ ai& pūrvāṅgaṃ cetgurusevikāramagnaṃ |	om namaḥ ai pūrva aṅgam ced guru sevi kāra magnam 
SA_MB_ugracandapujapaddhatiHK-257	tānyaṃ jñānalakṣmībhiḥ kṛtamugharayena saumisūyyabhāskara ||	jñāna lakṣmībhiḥ kṛta mugha rayena saumisūyya bhāskara 
SA_MB_ugracandapujapaddhatiHK-258	yāso ārāgvamadhye svayetijalanidhauna nāgavaṭukasya jñāsasyādi	nāga vaṭukasya 
SA_MB_ugracandapujapaddhatiHK-259	pharāgrakṣalatiphaṇisānavidyatasyā savāt |	savāt 
SA_MB_ugracandapujapaddhatiHK-260	vrahamaṇyaistuyamāne tridaśanutigaṇai ṛgvajuṃ śamamantraviṣṇu	tridaśa nuti gaṇaiḥ ṛk vajum śama mantra viṣṇu 
SA_MB_ugracandapujapaddhatiHK-261	trailokyanāthaṃ kaluṣalukaharaṃ pātumāṃ padmanābha.	trailokya nātham kaluṣaluka haram pātu mām padmanābha 
SA_MB_ugracandapujapaddhatiHK-262	marukāñcanadatvā nāṃgavāṃkoṭi satirapiḥ ||	satirapiḥ 
SA_MB_ugracandapujapaddhatiHK-263	pañcakoṭituragānāṃ tatphalaṃ śivadaśanāṃ ||	pañca koṭi turagānām tat phalam 
SA_MB_ugracandapujapaddhatiHK-264	14b) śūrddhaśāntaṃ śivaṃ prasādaparamaṃ sarvajñaśakteśvaraṃ	                
SA_MB_ugracandapujapaddhatiHK-265	sānandaśvaraṃ vāyakasyabhagavān sampūrṇakāmāprada.	sa ānanda śvaram 
SA_MB_ugracandapujapaddhatiHK-266	vāgīśvaravastuvāgbhavaḥ padaṃ vāmādiśakteśvaraṃ	vāc īśvara vastu vāc bhavaḥ padam vāma ādi śakti īśvaram 
SA_MB_ugracandapujapaddhatiHK-267	vyāṣṭiśaukavināśakuṣṭhabhayahāṃ mṛtyuṃjayaḥ trāhimāṃ || pūjā ||	mṛtyuṃjayaḥ pūjā 
SA_MB_ugracandapujapaddhatiHK-268	pāpohaṃ pāpakarmānā pāpāt sthāpasaṃbhava vyātrāhimāṃ	pāpa ūham pāpa karmāṇā pāpāt 
SA_MB_ugracandapujapaddhatiHK-269	pūrṇarīkākṣaṃ sarvapāpāharoharaḥ ||	           
SA_MB_ugracandapujapaddhatiHK-270	antat śaranaṃ nāstisvamevaśaraḥ paṃcamaḥ |	antat śaranam paṃcamaḥ 
SA_MB_ugracandapujapaddhatiHK-271	tasmāt kāru.yabhāvane rakṣavakṣaparameśvaraḥ ||	tasmāt kāruya bhāvane rakṣavakṣa parama īśvaraḥ 
SA_MB_ugracandapujapaddhatiHK-272	śrīsūryāyanārāyaṇāya |	śrī sūryāya nārāyaṇāya 
SA_MB_ugracandapujapaddhatiHK-273	15a) oṃ namaḥ śrīsūryāya || tatrorrigācanavidhi || ai& 5 akhaṇḍamaṇḍalābhyādi ||	om namaḥ śrī sūryāya tatra ūrri gācana vidhi ai akhaṇḍa maṇḍala abhyādi 
SA_MB_ugracandapujapaddhatiHK-274	oṃ śrīśrīśrīpālametā śrīgurupalamācāje śrīādidevapādukāṃ ||	om śrī śrī śrīpāla metā śrī ādideva pādukām 
SA_MB_ugracandapujapaddhatiHK-275	parmāsnāya pādukāṃ arghapātrāsnāyapādukāṃ || kūrmāsnāyaka	parma āsnāya pādukām arghapātra āsnāya pādukām 
SA_MB_ugracandapujapaddhatiHK-276	pādukāṃ || ātmāmlāya pādukāṃ || karaṃ nyāsa || ra& aṃstāya phaṭ ||	pādukām ātma amlāya pādukām karam nyāsa phaṭ 
SA_MB_ugracandapujapaddhatiHK-277	oṃ hṛdayāya namaḥ || arkāyaśirase svāhā || bhurbhuvaḥ svajāniśikhāye vauṣaṭ ||	om hṛdayāya namaḥ arka āya śirase svāhā bhuḥ bhuvaḥ vauṣaṭ 
SA_MB_ugracandapujapaddhatiHK-278	hū& kavacāya hū& || bhānetetrayavauṣaṭ || oṃ raṃ astrāye phaṭ ||	hū kavacāya hū om raṃ astrāya phaṭ 
SA_MB_ugracandapujapaddhatiHK-279	iti karaṃ nyāsa || ai& aṅganyāsa || arghapātrapūjā || oṃ hrī& hṛdayāya namaḥ ||	iti oṃ hrī hṛdayāya namaḥ 
SA_MB_ugracandapujapaddhatiHK-280	ityādi || āvānathāyanadanāṣitapurṣya namaḥ || ātmane śiñcaye ||	ityādi namaḥ ātmane śiñcaye 
SA_MB_ugracandapujapaddhatiHK-281	ātmane caṇḍanaṃ nama || ātmaśipurye nama ||	ātmane caṇḍanam namaḥ nama 
SA_MB_ugracandapujapaddhatiHK-282	15b) ātmasnāya nama || ātmamūrtaya nama || oṃ aśvāsnāyanaḥ ||	namaḥ ātma mūrtaye namaḥ om aśvāsnāyanaḥ 
SA_MB_ugracandapujapaddhatiHK-283	oṃ hrā& hrī& sapuryāye nama || oṃ ha& kha& kālikasuryamuta namaḥ ||	om hrā hrī sa puryāye nama om namaḥ 
SA_MB_ugracandapujapaddhatiHK-284	oṃ prakāśasaktiśahitāya namaḥ || sahaśrakilanāyavilamahe kṛtāṃtāyadhīmahe	om namaḥ kṛtāṃtāya dhīmahe 
SA_MB_ugracandapujapaddhatiHK-285	ta& nnaṃ ca suryapracodayā || āvāhanādi || jāpa || oṃ hrā& svāhā ||	ca surya pracodayā āvāhana ādi jāpa om hrā svāhā 
SA_MB_ugracandapujapaddhatiHK-286	tato viṣṇupūjā || nyāsa || oṃ sthaṃnamonārāyaṇāya astāya phaṭ ||	tatas viṣṇu pūjā nyāsa om sthaṃ namaḥ nārāyaṇāya astāya phaṭ 
SA_MB_ugracandapujapaddhatiHK-287	oṃ ccha& namonārāyanāyahṛdayāya nama ||	om ccha namaḥ nārāyanāya hṛdayāya nama 
SA_MB_ugracandapujapaddhatiHK-288	oṃ ccha& namonārāyanāya śirase svāhā ||	om ccha namaḥ nārāyanāya śirase svāhā 
SA_MB_ugracandapujapaddhatiHK-289	oṃ ccha& namonārāyanāyasikhāya vauṣaṭ ||	om ccha namaḥ nārāyanāyasikhāya vauṣaṭ 
SA_MB_ugracandapujapaddhatiHK-290	oṃ ccha& namonārāyanāya kavacapadaṃ ||	om ccha namaḥ nārāyanāya kavaca padam 
SA_MB_ugracandapujapaddhatiHK-291	oṃ ccha& namonārāyanāyapayaṃ taṃtrāya vauṣaṭ ||	om ccha namaḥ nārāya nāya payam taṃtrāya vauṣaṭ 
SA_MB_ugracandapujapaddhatiHK-292	oṃ garudāsnāya nama || oṃ hrī&sanamānāraya nama || hṛdayāyanyivyadyai ||	om garudāsnāya nama  om nama 
SA_MB_ugracandapujapaddhatiHK-293	16a) oṃ hrā& salakṣmī saktisahitāye nama || nārāyanāya	om hrā sa lakṣmī nama nārāyanāya 
SA_MB_ugracandapujapaddhatiHK-294	vilamahervaṃṣṇavāyadhimahe natavyaṃ acut pacodayā ||	natavyam a cut 
SA_MB_ugracandapujapaddhatiHK-295	oṃ hrī& lakṣmī nārāyanāya nama || oṃ hrī& lakṣmīnārāyanāyapatimāya namaḥ ||	om hrī lakṣmī nārāyanāya nama om hrī lakṣmī nārāyanāya patimāya namaḥ 
SA_MB_ugracandapujapaddhatiHK-296	oṃ hrī& anantanārāyanāya nama || anantanārāyanāyapatimāya nama ||	om hrī ananta nārāyanāya nama nama 
SA_MB_ugracandapujapaddhatiHK-297	oṃ ūmāmaheśvarāya nama || oṃ mādhavāya nama || āvānaṣṭā jāpa oṃ hrī&	om ūmā maheśvarāya nama om mādhavāya nama jāpa om hrī 
SA_MB_ugracandapujapaddhatiHK-298	svāhā || aghoraṃ yanyāsa ||	svāhā aghoram yanyā āsa 
SA_MB_ugracandapujapaddhatiHK-299	oṃ hrā& namasterudrarupyahra māhāpāśupatāstā  atāya hū& phaṭ ||	om hrā namaḥ te rudra rupya hra māhāpāśupatāḥ tāḥ atāya hū phaṭ 
SA_MB_ugracandapujapaddhatiHK-300	oṃ hrā& aghorehrī& kaniṣṭakāya nama || oṃ hrā& thaghore hrī& anāmikāya svāhā ||	om hrā aghore hrī kaniṣṭakāya nama om hrā thaghore hrī anāmikāya svāhā 
SA_MB_ugracandapujapaddhatiHK-301	oṃ hrā& ghoreghoraṃtare hū& madhonāya voṣaṭ ||	om hrā hū voṣaṭ 
SA_MB_ugracandapujapaddhatiHK-302	oṃ hrā& sarvatasarvaṃ sarvehre tarjanyāya nama ||	om hrā sarvatasarvam sarvehre tarjanyāya nama 
SA_MB_ugracandapujapaddhatiHK-303	oṃ hrā& ju& saḥ jyotirupātmane aṅguṣṭhāya namaḥ ||	om hrā ju saḥ jyotiḥ upātmane aṅguṣṭhāya namaḥ 
SA_MB_ugracandapujapaddhatiHK-304	16b) oṃ hrā& namasterudrarūpe hraḥ mahāpāśupatāstāya astāya phaṭ ||	om                     
SA_MB_ugracandapujapaddhatiHK-305	iti karaṃ nyāsa ||	iti karam nyāsa 
SA_MB_ugracandapujapaddhatiHK-306	oṃ hrā& aghore hrā& sarvātmane hṛdayāya namaḥ ||	om hrā aghore hrā sarvātmane hṛdayāya namaḥ 
SA_MB_ugracandapujapaddhatiHK-307	ityādi aṅganyāsa || vaktaṃ nyāsa ||	ityādi 
SA_MB_ugracandapujapaddhatiHK-308	oṃ hrā& kṣa& iśānāya ūrddhavaktrāya namaḥ || ityādi || āsana ||	om hrā kṣa iśānāya ūrddha vaktrāya namaḥ ityādi āsana 
SA_MB_ugracandapujapaddhatiHK-309	oṃ hrā& vṛkhāsnāya namaḥ || oṃ hrā& aghore hrā& ghoreghoraṃtare hū& phu& sarvata	om hrā vṛkhāsnāya namaḥ om hrā aghore hrā hū phu 
SA_MB_ugracandapujapaddhatiHK-310	svaraṃ sarve hṛdaya ju& sa hru& rudrarūpe hraḥ śrīśiṣāśucchanda	svaram sarve hṛdaya sa hru rudra rūpe hraḥ śrī śiṣā āśucchanda 
SA_MB_ugracandapujapaddhatiHK-311	māhābheravāya sadāśivāya nama || oṃ aghoreśvarāśakti sahitāya namaḥ ||	māhābheravāya sadāśivāya nama om aghora īśvara aśakti sahitāya namaḥ 
SA_MB_ugracandapujapaddhatiHK-312	śiṣānāthāya vilamahe svacchandāya dhīmahe tanno rudrapracodayāt ||	śiṣā nāthāya vilamahe svacchandāya dhīmahe tat naḥ rudra pracodayāt 
SA_MB_ugracandapujapaddhatiHK-313	lu& indrāyavajrahastāya surāṣike namaḥ || lu& aganesāḥ hri& hastāya tejādhipate	lu indrāya vajrahastāya surāṣike namaḥ lu aganesāḥ hri hastāya teja adhipate 
SA_MB_ugracandapujapaddhatiHK-314	namaḥ ||	namaḥ 
SA_MB_ugracandapujapaddhatiHK-315	17a) paṃcavaktrapūjā ||	       
SA_MB_ugracandapujapaddhatiHK-316	oṃ hrā& kṣa& iśānāya ūrddhavaktrāya namaḥ ||	om hrā kṣa iśānāya ūrddha vaktrāya namaḥ 
SA_MB_ugracandapujapaddhatiHK-317	oṃ hrā& yaṃtapuruśārvavaktrāya namaḥ ||	om   yaṃta puru śārva vaktrāya namaḥ 
SA_MB_ugracandapujapaddhatiHK-318	oṃ hrā& ra& aghorāyadakhinavaktrāya namaḥ ||	om   ra aghorāya dakhi navaktrāya namaḥ 
SA_MB_ugracandapujapaddhatiHK-319	oṃ hrā& carvāmadevāya ūgravaktrā namaḥ ||	om hrā car vāmadevāya namaḥ 
SA_MB_ugracandapujapaddhatiHK-320	oṃ hrā& raṃsadevajātāyā paścimavaktrāya namaḥ ||	om   paścima vaktrāya namaḥ 
SA_MB_ugracandapujapaddhatiHK-321	oṃ hrā& kṣa& īśānāya ūrddhavaktrāya namaḥ ||	om hrā   īśānāya ūrddha vaktrāya namaḥ 
SA_MB_ugracandapujapaddhatiHK-322	oṃ viśvanāthāya namaḥ || oṃ anantāya namaḥ || thvanaṃ nyaivyadyai ||	om viśvanāthāya namaḥ om anantāya namaḥ thvanaṃ 
SA_MB_ugracandapujapaddhatiHK-323	āvāhanādi || jāpa || oṃ hrā& svāhā || 10 || atha mṛtyuṃjaye pūjanaṃ ||	āvāhana ādi jāpa om hrā svāhā    atha mṛtyuṃjaye pūjanam 
SA_MB_ugracandapujapaddhatiHK-324	oṃ ju& saḥ anantaśakti astrāya phaṭ || oṃ ju& saḥ kaniṣṭhakāya namaḥ ||	om ju saḥ ananta śakti astrāya phaṭ om ju saḥ kaniṣṭhakāya namaḥ 
SA_MB_ugracandapujapaddhatiHK-325	oṃ ju& saḥ anāmikāya svāhā || oṃ ju& saḥ madhyemāya vauṣaṭ ||	om ju saḥ anāmikāya svāhā om ju saḥ madhyemāya vauṣaṭ 
SA_MB_ugracandapujapaddhatiHK-326	oṃ ju& saḥ tarjanyāya hū& || oṃ ju& saḥ aṅguṣṭhāya voṣaṭ ||	om ju saḥ tarjanyāya hū  om ju saḥ aṅguṣṭhāya voṣaṭ 
SA_MB_ugracandapujapaddhatiHK-327	17b) oṃ ju& saḥ anantaśakti astrāya phaṭ || thvatekaraṃnyāsaḥ ||	om ju saḥ ananta śakti astrāya phaṭ 
SA_MB_ugracandapujapaddhatiHK-328	tato aṅgaṃ nyāsa || oṃ ju& saḥ sarvajñātvāya hṛdayāya nama ||	tatas aṅgam nyāsa om saḥ sarva jñātvāya hṛdayāya nama 
SA_MB_ugracandapujapaddhatiHK-329	oṃ ju& saḥ amṛtatejomārinindaptiśirase svāhā ||	om ju saḥ amṛta tejaḥ māri nindapti śirase svāhā 
SA_MB_ugracandapujapaddhatiHK-330	oṃ ju& saḥ anādivodhaśikhāyai voṣaṭ ||	om ju saḥ anādi vodha śikhāyai voṣaṭ 
SA_MB_ugracandapujapaddhatiHK-331	oṃ ju& saḥ svatantrakavacāya hū& || oṃ ju& saḥ aruptaśaktaye netratrayāya vaṣaṭ ||	om ju saḥ svatantra kavacāya hū om ju saḥ arupta śaktaye netratrayāya vaṣaṭ 
SA_MB_ugracandapujapaddhatiHK-332	oṃ ju& saḥ anantaśakti astrāya phaṭ || iti aṃgaṃ nyāsa ||	om ju saḥ ananta śakti astrāya phaṭ iti aṃgam 
SA_MB_ugracandapujapaddhatiHK-333	oṃ ju& saḥ vṛṣāsanāya namaḥ ||	om ju saḥ vṛṣāsanāya namaḥ 
SA_MB_ugracandapujapaddhatiHK-334	oṃ ju& saḥ mṛtyuñjayāya amṛtāśvarāya mahābhairavāya namaḥ ||	om ju saḥ mṛtyuñjayāya amṛtāśvarāya mahābhairavāya namaḥ 
SA_MB_ugracandapujapaddhatiHK-335	naivedyaṃ namaḥ || oṃ ju& saḥ amṛtalakṣmīśvarī śaktisahitāya namaḥ ||	naivedyam namaḥ om ju saḥ amṛta lakṣmī īśvarā śakti sahitāya namaḥ 
SA_MB_ugracandapujapaddhatiHK-336	naivedyaṃ namaḥ || oṃ ju& saḥ mṛtyuñjayāya vidmahe amṛtīśvarāya dhīmahe	naivedyam namaḥ om ju saḥ mṛtyuñjayāya vidmahe amṛtīśvarāya dhīmahe 
SA_MB_ugracandapujapaddhatiHK-337	tanno netrapacopayāt ||	tat naḥ netra pacā upayāt 
SA_MB_ugracandapujapaddhatiHK-338	18a) thvamṛtyuñjayavahmaṃ thvatenaṃ pūjāyāya || āvāhanādi ||	thva mṛtyuñjaya vahmam āvāhana ādi 
SA_MB_ugracandapujapaddhatiHK-339	mudrādarśayet || dhūpa || dīpa || jāpa || mantra || mohaṃ dakābhyādi ||	mudrā darśayet dhūpa dīpa jāpa mantra moham daka abhyādi 
SA_MB_ugracandapujapaddhatiHK-340	jānātyādi || merukācatyādi || śuddhaśāntatyādi || pāpohaṃ tyādi ||	jānātyādi meru kāca tyādi śuddha śānta tyādi 
SA_MB_ugracandapujapaddhatiHK-341	śrīsūrtyāyamārāyanāya aghoramṛtyuṃjayāya tantanetraśivārcanavidhe tat	śrī sūrtyāya mārāyanāya aghora mṛtyuṃjayāya tanta netra śiva arcana vidhe tat 
SA_MB_ugracandapujapaddhatiHK-342	sarvaṃ paripūrṇamastu || kevo || stotrāṃ || devatvāpāsaṃtaya || nyāsalikāya ||	sarvam paripūrṇam astu stotrām deva tva apāsaṃtaye 
SA_MB_ugracandapujapaddhatiHK-343	aghoranaṃ || oṃ hrā& hṛdayāya nama || ātmane namaḥ || oṃ hraḥ astrāya phaṭ ||	om hrā hṛdayāya nama ātmane namaḥ om hraḥ astrāya phaṭ 
SA_MB_ugracandapujapaddhatiHK-344	aghapātravisajanaṃ || iti liṃgārcanavidhi samāpta ||	iti liṃga arcana vidhi samāpta 
SA_MB_ugracandapujapaddhatiHK-345	tato pādukādevārcanaṃ kārayet || oṃ hrī& śrī& hsphre& hsau& ||	pādukā deva arcanam kārayet om hrī śrī hsphre hsau 
SA_MB_ugracandapujapaddhatiHK-346	akhaṇḍamaṇḍalātyādi ||	akhaṇḍa maṇḍala atyādi 
SA_MB_ugracandapujapaddhatiHK-347	18b) guruvrahmātyādi || śrīparamagurupādukāṃ || śrīparameṣṭhiguru	                     
SA_MB_ugracandapujapaddhatiHK-348	pādukāṃ || śrīparamācāryaguru pādukāṃ || śrīādidevapādukāṃ ||	pādukām śrī parama ācārya guru pādukām śrī ādideva pādukām 
SA_MB_ugracandapujapaddhatiHK-349	padmāsanāya pādukāṃ || arghapātrāsanāya pādukāṃ ||	padma āsanāya pādukām arghapātra āsanāya pādukām 
SA_MB_ugracandapujapaddhatiHK-350	5 kurmāsanāya pādukāṃ || 5 ātmāsanāya pādukāṃ ||	kurma āsanāya pādukām   ātma āsanāya pādukām 
SA_MB_ugracandapujapaddhatiHK-351	ai& 5 antakoya phaṭ || karasodhanaṃ || ai& kaniṣṭhakāyai namaḥ ||	ai phaṭ ai kaniṣṭhakāyai namaḥ 
SA_MB_ugracandapujapaddhatiHK-352	ai& 5 hrī& anānikāyai svāhā || ai& 5 śrīmadhyemāyai voṣaṭ ||	ai hrī anānikāyai svāhā ai śrī madhyemāyai voṣaṭ 
SA_MB_ugracandapujapaddhatiHK-353	ai& 5 khphre& tarjanyāyai hū& || ai& 5 hsau& aṅguṣṭhāyai vaṣaṭ ||	ai khphre tarjanyāyai hū ai hsau aṅguṣṭhāyai vaṣaṭ 
SA_MB_ugracandapujapaddhatiHK-354	ai& 5 antrayāye phaṭ || thvatekaraṃnyāsa || punavaktraṃ nyāsa || ai& 5	ai phaṭ thvatekaram nyāsa punavaktram nyāsa 
SA_MB_ugracandapujapaddhatiHK-355	ūrddhavaktrāya namaḥ || ai& 5 hrī& pūrvavaktrāye namaḥ ||	ūrddha vaktrāya namaḥ ai hrī pūrva vaktrāya namaḥ 
SA_MB_ugracandapujapaddhatiHK-356	ai& 5 śrī& dakṣiṇavaktrāya namaḥ || ai& 5 khphre& uttaravaktrāya namaḥ ||	ai śrī dakṣiṇa vaktrāya namaḥ ai khphre uttara vaktrāya namaḥ 
SA_MB_ugracandapujapaddhatiHK-357	19a) ai& 5 hsau& paścchimavaktrāya namaḥ ||	ai hsau paścchima vaktrāya namaḥ 
SA_MB_ugracandapujapaddhatiHK-358	ai& 5 a& ūrddhaparāparavaktrāya namaḥ || thvatevaktraṃ nyāsa || atha	ai a ūrddha para apara vaktrāya namaḥ atha 
SA_MB_ugracandapujapaddhatiHK-359	aṃgaṃnyāsa || ai& 5 hṛdayāya namaḥ || ai& 5 hrī& śirase svāhā ||	aṃgaṃnyāsa ai hṛdayāya namaḥ ai hrī śirase svāhā 
SA_MB_ugracandapujapaddhatiHK-360	ai& 5 śrī& śikhāya voṣaṭ || ai& 5 khphre& kavacāya hū& ||	ai śrī śikhāya voṣaṭ ai khphre kavacāya hū 
SA_MB_ugracandapujapaddhatiHK-361	ai& 5 hsau& netratrayāya vaṣaṭ || ai& 5 ai& antrakāya phaṭ ||	ai hsau netratrayāya vaṣaṭ ai ai antrakāya phaṭ 
SA_MB_ugracandapujapaddhatiHK-362	iti aṃgaṃ nyāsa || jalapātrapūjā || mūlamantrana || arghapātrapūjā ||	iti 
SA_MB_ugracandapujapaddhatiHK-363	ai& 5 arghapātrāsanāya pādukāṃ ||	ai arghapātra āsanāya pādukām 
SA_MB_ugracandapujapaddhatiHK-364	ai& 5 glu& slu& plu& mlu& nlu& paramāmṛta arghapātrāsanāya namaḥ ||	ai glu slu plu mlu nlu parama amṛta arghapātra āsanāya namaḥ 
SA_MB_ugracandapujapaddhatiHK-365	mūlamantrana || ṣaḍaṃgena || āvāhanādi || yonimudrā ||	ṣaḍaṃgena āvāhana ādi yonimudrā 
SA_MB_ugracandapujapaddhatiHK-366	bhūtaśuddhi || ātmapūjā || taṃhālaghopūjā || gaṃgādinā ||	ātma pūjā gaṃgā ādinā 
SA_MB_ugracandapujapaddhatiHK-367	āvāhanādi || dhyenumudrā || vākya || sanānayācake || caṇḍana ||	āvāhana ādi dhyenumudrā vākya 
SA_MB_ugracandapujapaddhatiHK-368	puṣpaṃ ca || punagurunamaskāra ||	puṣpam ca 
SA_MB_ugracandapujapaddhatiHK-369	19b) nyāsādi purvavat || āvāhana samvartāna || trideva || kṣatra || vaṭuka ||	nyāsa ādi purvavat āvāhana samvartāna trideva kṣatra vaṭuka 
SA_MB_ugracandapujapaddhatiHK-370	gaṇa || āvāhanādi || svasvamudrā || aṣṭapatrapūjā || aṣṭamātṛkāna ||	                
SA_MB_ugracandapujapaddhatiHK-371	ai& 5 ha&sāsanāya pādukāṃ || vṛṣāsanāya pādukāṃ ||	ai hasa āsanāya pādukām vṛṣa āsanāya pādukām 
SA_MB_ugracandapujapaddhatiHK-372	mayurāsanāya pādukāṃ || garuḍāsanāya pādukāṃ || mahiṣāsanāya	mayuḥ āsanāya pādukām garuḍa āsanāya pādukām mahiṣa āsanāya 
SA_MB_ugracandapujapaddhatiHK-373	pādukāṃ || gajāsanāya pādukāṃ || pretāsanāya pādukāṃ ||	pādukām gajāsanāya pādukām preta āsanāya pādukām 
SA_MB_ugracandapujapaddhatiHK-374	narāsanāya pādukāṃ || thvata āsana || ai& 5 avrahmāni asitāṅgabhailavāya	narāsanāya pādukām āsana ai avrahmāni asitāṅga bhailavāya 
SA_MB_ugracandapujapaddhatiHK-375	pādukāṃ || ai& 5 ka& māheśvarī rurubhairavāya pādukāṃ ||	pādukām ai ka māheśvarī rurubhairavāya pādukām 
SA_MB_ugracandapujapaddhatiHK-376	ai& 5 ca& kaumārī caṇḍabhairavāya pādukāṃ ||	ai ca kaumārī caṇḍabhairavāya pādukām 
SA_MB_ugracandapujapaddhatiHK-377	ai& 5 ta& vaiṣṇavī krodhabhairavāya pādukāṃ ||	ai te vaiṣṇavī krodhabhairavāya pādukām 
SA_MB_ugracandapujapaddhatiHK-378	ai& 5 ta& vārāhi umartabhairavāya pādukāṃ ||	ai te vārāhi umarta bhairavāya pādukām 
SA_MB_ugracandapujapaddhatiHK-379	ai& 5 ya& endrānāṃ kapālī bhairavāya pādukāṃ ||	ai kapālī bhairavāya pādukām 
SA_MB_ugracandapujapaddhatiHK-380	ai& 5 ya& cāmuṇḍābhīṣanabhairavāya pādukāṃ ||	ai cāmuṇḍā abhīṣana bhairavāya pādukām 
SA_MB_ugracandapujapaddhatiHK-381	20a) ai& 5 sa& mahālakṣmī saṃhārabhairavāya pādukāṃ ||	ai sa mahā lakṣmī saṃhārabhairavāya pādukām 
SA_MB_ugracandapujapaddhatiHK-382	thvatenaṃ vali || ete mātṛkā pūjā || punamadhyemitrādi pañcaka pūjā ||	ete mātṛkā pūjā 
SA_MB_ugracandapujapaddhatiHK-383	ai& 5 mītrīśānandanātha pādukāṃ || ai& 5 oḍiśānandanātha pādukāṃ ||	ai mītrīśa ānandanātha pādukām  ai oḍiśa ānandanātha pādukām 
SA_MB_ugracandapujapaddhatiHK-384	ai& 5 ṣaṣṭhīśānandanātha pādukāṃ || ai& 5 caccīśānandanātha pādukāṃ ||	ai ṣaṣṭhīśa ānandanātha pādukām  ai caccīśa ānandanātha pādukām 
SA_MB_ugracandapujapaddhatiHK-385	ai& 5 tuṣṇīśānandanātha pādukāṃ || thvatenītrādi pañcaka ||	ai tuṣṇīśa ānandanātha pādukām 
SA_MB_ugracandapujapaddhatiHK-386	mūlamantrana trayāñjali || ai& 5 padmāsanāya pādukāṃ ||	padmāsanāya pādukām 
SA_MB_ugracandapujapaddhatiHK-387	ai& 5 hylū& śuklamahāvidyāpīṭha śuklapuṣpaśukla mahāmaṇḍalāpīṭha	ai hylū śukla mahāvidyā pīṭha śukla puṣpa śukla mahā maṇḍalā pīṭha 
SA_MB_ugracandapujapaddhatiHK-388	śuklacarū śuklamahāmantrapīṭha śukladīpaśuklamahāmudrāpīṭha śuklamatī	śukla carū śukla mahāmantra pīṭha śukla dīpa śukla mahā mudrā pīṭha śukla matī 
SA_MB_ugracandapujapaddhatiHK-389	śuklamahāprakāśā nanda nāthapādukāṃ pūjayāmi 5 ||	śukla mahā prakāśā nanda nātha pādukām pūjayāmi 
SA_MB_ugracandapujapaddhatiHK-390	ai& 5 ślū& raktamahāvidyāpīṭha raktapuṣparaktamahāmandalāpīṭha	ai ślū rakta mahāvidyā pīṭha rakta puṣpa rakta mahāmandalā pīṭha 
SA_MB_ugracandapujapaddhatiHK-391	raktacaruraktamahāmantrapīṭha raktadīpa raktamudrā mudrāpīṭharaktamatīrakta	rakta caru rakta mahā mantra pīṭha rakta dīpa rakta mudrā mudrā pīṭha rakta mati rakta 
SA_MB_ugracandapujapaddhatiHK-392	mahāprakāśānandanātha pādukāṃ || thvate mūlantraṇatriyāṃjali || vali ||	mahāprakāśa ānandanātha pādukām 
SA_MB_ugracandapujapaddhatiHK-393	ai& 5 hrī& sarva pīṭhajā kṣatrajā mantrajā yogajā kulajā sahajā saṃdohajāye	ai hrī sarva pīṭha jā kṣatra jā mantra jā yoga jā kula jā saha jā saṃdoha jāye 
SA_MB_ugracandapujapaddhatiHK-394	keścit yogīṇīnāṃ khecarī bhūcarī gocarī ekākṣarī dvikṣarī trīkṣarī	keścid yogīṇīnām khecarī bhūcarī gocarī ekākṣarī dvikṣarī trīkṣarī 
SA_MB_ugracandapujapaddhatiHK-395	catuspañca ṣaṭ saptastanavākṣarīnāṃ trijagāminīnāṃ yathopamaṃ nā idaṃ	catur pañca ṣaṣ tri ja gāminīnām yathā upamam naḥ idam 
SA_MB_ugracandapujapaddhatiHK-396	valiṃ japagaṇita gṛhna 2 mamasiddhi kuru 2 hu& phaṭ svāhā ||	valim japa gaṇita gṛhna mama siddhi kuru hu phaṭ svāhā 
SA_MB_ugracandapujapaddhatiHK-397	mahāvalinadhunake || āvāhanādi yonimudrā darśayet ||	āvāhana ādi yonimudrāḥ darśayet 
SA_MB_ugracandapujapaddhatiHK-398	21a) dhūpa || dīpa || naivedya || jāpa || trideva || 3 || hslū& ślū& 108 || śrīsamvartā ||	dhūpa dīpa naivedya jāpa trideva             
SA_MB_ugracandapujapaddhatiHK-399	vrahmāṇī ||śaśadharaśadṛśaṃ saloke devākṣayānake caraṇau ||	vrahmāṇī sa loke deva akṣayānake caraṇau 
SA_MB_ugracandapujapaddhatiHK-400	śitarajambhāsvaravimalau sambhonityaṃ pātu janārṇi || vākya || tarpaṇa ||	sambho nityam pātu janārṇi vākya tarpaṇa 
SA_MB_ugracandapujapaddhatiHK-401	deva āśirvāda || ekāne || ātmaśirvā || amvapūrva || astrenavali visarjana ||	deva āśirvāda ekāne ātmaśirvā  visarjana 
SA_MB_ugracandapujapaddhatiHK-402	hṛdayamantrena ātmalīna || iti pādukādevārcana vihdi samāptaḥ ||	hṛdayamantrena ātma līnaḥ iti pādukā deva arcana samāptaḥ 
SA_MB_ugracandapujapaddhatiHK-403	tato paścimadevārcana kālayet || gurunamaskāraṃ || ai& 5 padmāsanāya	paścima deva arcana kālayet guru namaskāram padma āsanāya 
SA_MB_ugracandapujapaddhatiHK-404	pādukāṃ || ai& 5 arghapātrāsanāya pādukāṃ ||	pādukām ai arghapātra āsanāya pādukām 
SA_MB_ugracandapujapaddhatiHK-405	ai& 5 kūrmāsanāya pādukāṃ || ānmāsanāya pādukāṃ ||	ai kūrmāsanāya pādukām 
SA_MB_ugracandapujapaddhatiHK-406	ai& 5 kini 2 vicce koṅkanāyai hraḥ astrāya phaṭ ||	ai kini vicce koṅkanāyai hraḥ astrāya phaṭ 
SA_MB_ugracandapujapaddhatiHK-407	puṣpenakarasodhanaṃ || ai& 5 hrū& pha& phaṭ vajrapañjale svāhā ||	ai hrū pha phaṭ vajra pañjale svāhā 
SA_MB_ugracandapujapaddhatiHK-408	21b) ai& 5 calamakulekulamacale hrī& hrū& phaṭ ||	ai calamakulekulamacale hrī hrū phaṭ 
SA_MB_ugracandapujapaddhatiHK-409	ai& 5 kini 2 vicce koṅkanāyai hraḥ astrāya phaṭ || karasodhanaṃ ||	ai kini vicce koṅkanāyai hraḥ astrāya phaṭ karasodhanam 
SA_MB_ugracandapujapaddhatiHK-410	ai& 5 namo bhagavati hṛtkamalāyai hrā& śrī& aṃguṣṭhāyai pādukāṃ ||	ai namaḥ bhagavati hṛd kamalāyai hrā śrī aṃguṣṭhāyai pādukām 
SA_MB_ugracandapujapaddhatiHK-411	ai& 5 hsphre& kuvjikāyai kuladipāyai hrī& śrītarjanyāye pādukāṃ ||	ai hsphre kuvjikāyai kuladipāyai hrī śrī tarjanyāye pādukām 
SA_MB_ugracandapujapaddhatiHK-412	ai& 5 hrā& hrī& hrū& varvalaśikhemadhyemāye voṣaṭ ||	ai hrā hrī hrū varvala śikhe madhye māye voṣaṭ 
SA_MB_ugracandapujapaddhatiHK-413	ai& 5 ghore aghore aghorāmukhī ca hrū& rupāyai anāmikāya pādukāṃ ||	ai ghore aghore aghorāmukhī ca hrū rupāyai anāmikāya pādukām 
SA_MB_ugracandapujapaddhatiHK-414	ai& 5 cchā& mahantārikāyai hrau& kaniṣṭikāya voṣaṭ ||	ai cchā mahantārikāyai hrau kaniṣṭikāya voṣaṭ 
SA_MB_ugracandapujapaddhatiHK-415	ai& 5 kini 2 vicce koṅkanāyai hraḥ astrāya phaṭ || karaṃ nyāsa ||	ai kini vicce koṅkanāyai hraḥ astrāya phaṭ karam nyāsa 
SA_MB_ugracandapujapaddhatiHK-416	ai& 5 namobhagavati hṛtkamalāyai hrā& śrī& ūrddhavaktrāyai pādupākāṃ ||	ai namaḥ bhagavati hṛd kamalāyai hrā śrī ūrddha vaktrāyai pādupākāṃ 
SA_MB_ugracandapujapaddhatiHK-417	ai& 5 hsphre& kuvjikāyai kuladīpāyai hrī& śrī& pūrvavaktrāyai pādukāṃ ||	ai hsphre kuvjikāyai kuladīpāyai hrī śrī pūrva vaktrāyai pādukām 
SA_MB_ugracandapujapaddhatiHK-418	22a) ai& 5 hrā& hrī& hrū& varvaraśikhe hrū& śrīdakṣiṇavaktrāyai pādukāṃ ||	ai hrā hrī hrū varvaraśikhe hrū śrī dakṣiṇa vaktrāyai pādukām 
SA_MB_ugracandapujapaddhatiHK-419	ai& 5 ghore aghore aghorāmukhī vahurūpāyai hrai& śrīuttaravaktrāye pādukāṃ ||	ai ghore aghore aghorā mukhī vahurūpāyai   śrī uttara vaktra aye pādukām 
SA_MB_ugracandapujapaddhatiHK-420	ai& 5 chā& chī& mahantārikāyai hrau& śrīpaścimavaktrāye pādukāṃ ||	ai chā chī mahantārikāyai pādukām 
SA_MB_ugracandapujapaddhatiHK-421	ai& 5 kini 2 vicce koṅkanāyai parāparavaktrāyai pādukāṃ ||	ai kini vicce koṅkanāyai parāparavaktrāyai pādukām 
SA_MB_ugracandapujapaddhatiHK-422	thvatevaktraṃ nyāsa ||	nyāsa 
SA_MB_ugracandapujapaddhatiHK-423	ai& 5 namo bhagavati hṛtkamalāyai drā& śrīhṛdayāya pādukāṃ ||	ai namaḥ bhagavati hṛd kamalāyai drā śrī hṛdayāya pādukām 
SA_MB_ugracandapujapaddhatiHK-424	ai& 5 hsphre& kuvjikāyai kuladīpāyai hrī& śirase svāhā ||	ai hsphre kuvjikāyai kuladīpāyai hrī śirase svāhā 
SA_MB_ugracandapujapaddhatiHK-425	ai& 5 hrā& hrī& hu& varvaraśikhe hū& śikhāya voṣaṭ ||	ai hrā hrī hu varvaraśikhe hū śikhāya voṣaṭ 
SA_MB_ugracandapujapaddhatiHK-426	ai& 5 ghore aghore aghorāmukhī vahurūpāyai hrai& śrīkavacāya hū& ||	ai ghore aghore aghorā mukhī vahurūpāyai hrai śrī kavacāya hū 
SA_MB_ugracandapujapaddhatiHK-427	ai& 5 cchā& cchī& mahantārikāyai hrau& śrīnetratrayāya voṣaṭ ||	ai cchā cchī mahantārikāyai   śrīnetratrayāya voṣaṭ 
SA_MB_ugracandapujapaddhatiHK-428	ai& 5 kiṇi 2 vicce koṅkanāyai hraḥ astāya phaṭ || aṅganyāsa || jalapātra pūjā ||	ai kiṇi vicce koṅkanāyai hraḥ astāya phaṭ aṅganyāsa jalapātra pūjā 
SA_MB_ugracandapujapaddhatiHK-429	jalapātrāsanāya pādukāṃ ||	jala pātra āsanāya pādukām 
SA_MB_ugracandapujapaddhatiHK-430	ai& 5 hskṣmlvryū& āndaśaktibhairavānandavīrādhipataye śkṣmlvryī&	ai ānda śakti bhairava ānanda vīra adhipataye śkṣml vryī 
SA_MB_ugracandapujapaddhatiHK-431	śrījarapātrabhaṭṭārikāyai pādukāṃ || ṣaḍaṃgeṇa saṃpūjya ||	śrī jarapātra bhaṭṭārikāyai pādukām ṣaḍaṃgeṇa saṃpūjya 
SA_MB_ugracandapujapaddhatiHK-432	āvāhanādi dhenumudrā dararśayet ||	āvāhana ādi dhenu mudrāḥ 
SA_MB_ugracandapujapaddhatiHK-433	ai& 5 kuvjikāyai vidmahe kuladīpāyadhīmahe tannokuvji pracodayāt ||	ai kuvjikāyai vidmahe kula dīpāya dhīmahe tat naḥ kuvji pracodayāt 
SA_MB_ugracandapujapaddhatiHK-434	tenamantrena ātmādi sarva devyāni prokṣaṇaṃ ||	tena mantrena ātma ādi sarva devyāni prokṣaṇam 
SA_MB_ugracandapujapaddhatiHK-435	ai& 5 arghapātrāsanāya pādukāṃ || ai& 5 hrā& hrī& hrū& hraḥ prasphura 2 ghora 2	ai arghapātra āsanāya pādukām ai hrā hrī hrū hraḥ prasphura ghora 
SA_MB_ugracandapujapaddhatiHK-436	tara 2 tanu 2 rūpacata 2 kaha 2 vama 2 ghātaya 2 vighāya 2 vighni 2 hū& 3 phaṭ 2	tara tanu rūpa cata kaha vama ghātaya vighāya vighni hū phaṭ 
SA_MB_ugracandapujapaddhatiHK-437	kro& śrīmahākāmāraṇāvi ca pādukāṃ ||	śrī mahā kāmāraṇāvi ca pādukām 
SA_MB_ugracandapujapaddhatiHK-438	23) ai& 5 śkṣmlvryī& ānandaśaktibhairavānanda śrīmahāvidyārājeśvarī	ānanda śakti bhairava ānanda śrī mahāvidyā rāja īśvarā 
SA_MB_ugracandapujapaddhatiHK-439	hskṣmlvryū& vyaṃpātrabhaṭṭārikāyai pādukāṃ ||	pādukām 
SA_MB_ugracandapujapaddhatiHK-440	ṣaḍakhyāna pūjyā || āvāhanādi || yonimudrādarśayet ||	āvāhana ādi yonimudrā darśayet 
SA_MB_ugracandapujapaddhatiHK-441	ai& hrā& hrī& śrī& hskau& hsau& hsphre& śrī& hrī& phre& || bhūtaśuddhi ||	ai hrā hrī śrī hskau hsau hsphre śrī hrī phre  bhūtaśuddhi 
SA_MB_ugracandapujapaddhatiHK-442	iti arghapātrapūjā || ātmapūjā || ai& vilepana pādukāṃ || ai& 5 hrī& hskṣmlvryū&	iti arghapātra pūjā ātma pūjā ai vilepana pādukāṃ ai hrī 
SA_MB_ugracandapujapaddhatiHK-443	tritatva hrū& kṣetra pādukāṃ || ai& 5 śrī&	tritatva hrū kṣetra pādukāṃ ai śrī 
SA_MB_ugracandapujapaddhatiHK-444	MUKTABODHA INDOLOGICAL RESEARCH INSTITUTE©2011 Muktabodha Indological Research Institute  All Rights Reserved.E-texts may be viewed only online or downloaded for private study.E-texts may not, under any circumstances, be copied, republished,reproduced, distributed or sold, either in original or altered form, withoutthe express permission of Muktabodha Indological Research Institute in writing.Data-entered by the staff of Muktabodha under the direction of Mark S. G. Dyczkowski.	muktabodha indological research muktabodha indological research institute all rights reserved texts may be viewed only online or downloaded for private studye texts may not under any circumstances be copied republished reproduced distributed or sold either in original or altered form withoutthe express permission of muktabodha indological research institute in writing data entered by the staff of muktabodha under the direction of mark s g dyczkowski 
