segmentnr	original	analyzed
SA_MB_mahaaguhyakaaliividhaanamHK-0	Muktabodha E-text in UTF-8	muktabodha etext in utf
SA_MB_mahaaguhyakaaliividhaanamHK-1	###########################################################################MUKTABODHA INDOLOGICAL RESEARCH INSTITUTEwww.muktabodha.org©2011 Muktabodha Indological Research Institute  All Rights Reserved.E-texts may be viewed only online or downloaded for private study.E-texts may not, under any circumstances, be copied, republished,reproduced, distributed or sold, either in original or altered form, withoutthe express permission of Muktabodha Indological Research Institute in writing.Data-entered by the staff of Muktabodha under the direction of Mark S. G. Dyczkowski.Catalog number : M04003	muktabodha indological research muktabodha indological research institute all rights reserved texts may be viewed only online or downloaded for private studye texts may not under any circumstances be copied republished reproduced distributed or sold either in original or altered form withoutthe express permission of muktabodha indological research institute in writing data entered by the staff of muktabodha under the direction of mark s g dyczkowskicatalog number  /
SA_MB_mahaaguhyakaaliividhaanamHK-2	Uniform title: mahāguhyakālīvidhānam	uniform title mahāguhyakālī vidhānam 
SA_MB_mahaaguhyakaaliividhaanamHK-3	Manuscript : NGMCP manuscript no: 2048 reel No. B 139/2	manuscript no  reel no  b 
SA_MB_mahaaguhyakaaliividhaanamHK-4	Notes: Data entered by the staff of Muktabodha under the direction of Mark S. G. Dyczkowski.	notes data entered by the staff muktabodha under the direction of mark s g dyczkowski 
SA_MB_mahaaguhyakaaliividhaanamHK-5	Publication country : India	publication country india 
SA_MB_mahaaguhyakaaliividhaanamHK-6	p. 1a) oṃ namaḥ kālikāyai ||	a om namaḥ kālikāyai 
SA_MB_mahaaguhyakaaliividhaanamHK-7	asya śrīmahāguhye kālisvalpaṣoḍhānyāsavidyā ānandabhairava ṛṣirūṣnicchandaḥ	asya śrī mahāguhye kāli su alpa ṣoḍhā nyāsa vidyā ānandabhairavaḥ ṛṣiḥ ūṣni chandaḥ 
SA_MB_mahaaguhyakaaliividhaanamHK-8	śrīmanmahāguhye kālīkādeśinī siddhidā śaktiḥ śrīmahāprakaṭakālikādevatā devatā hū&	śrīmat mahāguhye kālīkā deśinī siddhi dā śaktiḥ śrī mahā prakaṭa kālikā devatāḥ devatā hū 
SA_MB_mahaaguhyakaaliividhaanamHK-9	vījaṃ saḥ śaktiḥ śeṣaṃ kilākaṃ mama śarīraśuddhiḥ pūrvakadṛḍhatvaprāptaye viniyogaḥ ||	vījam saḥ śaktiḥ śeṣam kilākam mama śarīra śuddhiḥ pūrvaka dṛḍha tva prāptaye viniyogaḥ 
SA_MB_mahaaguhyakaaliividhaanamHK-10	vaddhāṃjaliḥ ||	vaddha aṃjaliḥ 
SA_MB_mahaaguhyakaaliividhaanamHK-11	hā& hī& hū& hai& hau& haḥ || karāṃganyāsaḥ | dhyānaṃ ||	hā hī hū hai hau haḥ kara aṃganyāsaḥ dhyānam 
SA_MB_mahaaguhyakaaliividhaanamHK-12	prakaṭāṃ śūlataṃkādhaḥ pānapātraṃ śivānvitāṃ |	prakaṭām śūla taṃkā adhas pāna pātram śiva anvitām 
SA_MB_mahaaguhyakaaliividhaanamHK-13	p. 1b) varābhayakarāṃ bhīmāṃ pūrvavat sarvaṃ saṃyutāṃ ||	vara abhaya karām bhīmām pūrvavat sarvam saṃyutām 
SA_MB_mahaaguhyakaaliividhaanamHK-14	evaṃ dhyātvā mānasopacāraiḥ saṃpūjya |	evam dhyātvā mānasa upacāraiḥ saṃpūjya 
SA_MB_mahaaguhyakaaliividhaanamHK-15	daśadhā japaṃ vaddhāṃjaliḥ	daśadhā japam vaddha aṃjaliḥ 
SA_MB_mahaaguhyakaaliividhaanamHK-16	prakaṭe kālike devi mantrasiddhipradāyinī	prakaṭe kālike devi mantra siddhi pradāyinī 
SA_MB_mahaaguhyakaaliividhaanamHK-17	silpaṣoḍhāṃ kariṣyāmi dṛḍhīkuru vapurmama ||	silpa ṣoḍhām kariṣyāmi dṛḍhīkuru vapuḥ mama 
SA_MB_mahaaguhyakaaliividhaanamHK-18	atha nyāsaḥ phre& hrī& chī& strī& hū& hū& saḥ svāhā prakaṭakālikāyai namaḥ svāhā ||	atha nyāsaḥ phre hrī chī strī hū hū saḥ svāhā prakaṭakālikāyai namaḥ svāhā 
SA_MB_mahaaguhyakaaliividhaanamHK-19	ādhāre oṃ ghorakālikāyai namaḥ svāhā || liṃge ||	ādhāre om ghorakālikāyai namaḥ svāhā liṃge 
SA_MB_mahaaguhyakaaliividhaanamHK-20	oṃ draṃṣṭrinī kālikāyai namaḥ svāhā || p. 2a) nābhau ||	om draṃṣṭrinī kālikāyai namaḥ svāhā p a nābhau 
SA_MB_mahaaguhyakaaliividhaanamHK-21	oṃ ghorakālikāyai namaḥ svāhā || hṛdaye	om ghorakālikāyai namaḥ svāhā hṛdaye 
SA_MB_mahaaguhyakaaliividhaanamHK-22	oṃ aṭṭāṭṭahāsakālikāyai namaḥ svāhā || kaṇṭhe ||	om aṭṭāṭṭahāsakālikāyai namaḥ svāhā kaṇṭhe 
SA_MB_mahaaguhyakaaliividhaanamHK-23	oṃ śiromālinīkālikāyai namaḥ svāhā || bhrūmadhye ||	om śiraḥ mālinī kālikāyai namaḥ svāhā bhrū madhye 
SA_MB_mahaaguhyakaaliividhaanamHK-24	meghaprabhākālikāyai namaḥ svāhā | vrahamraṃdhye ||	meghaprabhākālikāyai namaḥ svāhā 
SA_MB_mahaaguhyakaaliividhaanamHK-25	oṃ kharvakālikāyai namaḥ svāhā || lālāṭe ||	om kharvakālikāyai namaḥ svāhā lālāṭe 
SA_MB_mahaaguhyakaaliividhaanamHK-26	oṃ jayapradākālikāyai namaḥ svāhā || mūkhe ||	om jaya pradā kālikāyai namaḥ svāhā mūkhe 
SA_MB_mahaaguhyakaaliividhaanamHK-27	oṃ sṛṣṭikālikāyai namaḥ svāhā || mūlādivāmahastāntaṃ ||	om sṛṣṭikālikāyai namaḥ svāhā mūla ādi vāma hasta antam 
SA_MB_mahaaguhyakaaliividhaanamHK-28	p. 2b) oṃ sthitikālikāyai namaḥ svāhā || mūlādidakṣahastāntaṃ ||	om sthiti kālikāyai namaḥ svāhā mūla ādi dakṣa hasta antam 
SA_MB_mahaaguhyakaaliividhaanamHK-29	oṃ saṃhārakālikāyai namaḥ svāhā || vrahmaraṃdhodīkaṇṭhāntaṃ ||	om saṃhārakālikāyai namaḥ svāhā 
SA_MB_mahaaguhyakaaliividhaanamHK-30	oṃ bhāsākālikāyai namaḥ svāhā || kaṇṭhādihṛdayāntaṃ ||	om bhāsākālikāyai namaḥ svāhā kaṇṭha ādi hṛdaya antam 
SA_MB_mahaaguhyakaaliividhaanamHK-31	oṃ nākṣākālikāyai namaḥ svāhā || hṛdayānābhyantaṃ ||	om nākṣākālikāyai namaḥ svāhā 
SA_MB_mahaaguhyakaaliividhaanamHK-32	āmnāyasārakālikāyai namaḥ svāhā || nābhyādivāmapākāntaṃ ||	āmnāya sāra kālikāyai namaḥ svāhā nābhi ādi vāma pāka antam 
SA_MB_mahaaguhyakaaliividhaanamHK-33	oṃ kaurasākālikāyai namaḥ svāhā || nābhyāṃdidakṣa pādāntaṃ ||	om kaurasākālikāyai namaḥ svāhā 
SA_MB_mahaaguhyakaaliividhaanamHK-34	p. 3a) oṃ rahasyasārakālikāyai namaḥ svāhā || vrahmaraṃdhodiguhyānta pṛṣṭataḥ ||	a om rahasyasārakālikāyai namaḥ svāhā 
SA_MB_mahaaguhyakaaliividhaanamHK-35	oṃ yoginīsārakālikāyai namaḥ svāhā || guḍadigulphāntaṃ pṛṣṭataḥ ||	om yoginī sārakālikāyai namaḥ svāhā guḍa diś ulpha antam pṛṣṭatas 
SA_MB_mahaaguhyakaaliividhaanamHK-36	sarvaśaktisārakālikāyai namaḥ svāhā ||	sarva śakti sāra kālikāyai namaḥ svāhā 
SA_MB_mahaaguhyakaaliividhaanamHK-37	śrīmanmahāprakaṭakālikāyai hūṃ phaṭ namaḥ svāhā ||	śrīmat mahā prakaṭa kālikāyai   phaṭ namaḥ svāhā 
SA_MB_mahaaguhyakaaliividhaanamHK-38	śirādipādāntatridhā vyāpakaṃ hū& lelihānāmudrāṃ darśayen praṇamet || vaddhāṃjaliḥ ||	śira ādi pāda anta tridhā          darśayet praṇamet   
SA_MB_mahaaguhyakaaliividhaanamHK-39	sarvaśuddhiprade devi prakaṭe vrahmarūpiṇi ||	sarva śuddhi prade devi prakaṭe vrahma rūpiṇi 
SA_MB_mahaaguhyakaaliividhaanamHK-40	p. 3b) dehaśuddhiṃ prayachādya kālikāmarcayāmyahaṃ ||	deha śuddhim prayaccha adya kālikām arcayāmi aham 
SA_MB_mahaaguhyakaaliividhaanamHK-41	iti svalpaṣoḍhānyāsaḥ ||	iti svalpa ṣoḍhānyāsaḥ 
SA_MB_mahaaguhyakaaliividhaanamHK-42	namaḥ śrīkālikāyai || bhairavyuvāca ||	namaḥ śrī kālikāyai  bhairavī uvāca 
SA_MB_mahaaguhyakaaliividhaanamHK-43	bhagavan śrotumichāmi mānavekena hetunā ||	bhagavan śrotum icchāmi mānava ekena hetunā 
SA_MB_mahaaguhyakaaliividhaanamHK-44	mantrāḥ parāṅmukhāyānti koṭijaptā api prabho ||	mantrāḥ parāṅmukhāyānti koṭi japtāḥ api prabho 
SA_MB_mahaaguhyakaaliividhaanamHK-45	śrībhairava uvāca ||	śrī bhairavaḥ uvāca 
SA_MB_mahaaguhyakaaliividhaanamHK-46	etadrahasyaṃ kathayāmi tvayi priye ||	etat rahasyam kathayāmi tvayi priye 
SA_MB_mahaaguhyakaaliividhaanamHK-47	śopitavyaṃ prayatnena svayonimiva vallabhe ||	śopitavyam prayatnena sva yonim iva vallabhe 
SA_MB_mahaaguhyakaaliividhaanamHK-48	kavacena vināyastu kālīmantrajapodyataḥ ||	kavacena vināyaḥ tu kālī mantra japa udyataḥ 
SA_MB_mahaaguhyakaaliividhaanamHK-49	sanasiddhimavāpnoti koṭikalpaśatairapi ||	sana siddhim avāpnoti koṭi kalpa śataiḥ api 
SA_MB_mahaaguhyakaaliividhaanamHK-50	p. 4a) kavacaṃ paṃcakaṃ jñeyaṃ prathamaṃ deharakṣakaṃ |	kavacam paṃcakam jñeyam prathamam deharakṣakam 
SA_MB_mahaaguhyakaaliividhaanamHK-51	dvitīyaṃ nāma saṃśuptaṃ tṛtīyaṃ śastabhūṣitaṃ ||	dvitīyam nāma saṃśuptam tṛtīyam śasta bhūṣitam 
SA_MB_mahaaguhyakaaliividhaanamHK-52	caturthaṃ vījaśaktyādi bhūṣitaṃ paṃcamaṃ śṛṇū |	caturtham vīja śakti ādi bhūṣitam paṃcamam 
SA_MB_mahaaguhyakaaliividhaanamHK-53	mantrabhūtaṃ varārohe bhuvi sarvārthasādhanaṃ ||	mantra bhūtam varārohe bhuvi sarva artha sādhanam 
SA_MB_mahaaguhyakaaliividhaanamHK-54	asya deharakṣakaṃ kavacasya kālāgnirudra ṛṣiranuṣṭup cchandaḥ śrīmahāguhyakālī devatā	asya deha rakṣakam kavacasya kālāgni rudraḥ ṛṣiḥ anuṣṭubh chandaḥ śrī mahāguhyakālī devatā 
SA_MB_mahaaguhyakaaliividhaanamHK-55	phraṃ vījaṃ svāhā śaktiḥ śeṣakīlakaṃ mama deharakṣaṇe viniyogaḥ || iti vaddhāṃjalidevīṃ	phraṃ vījam svāhā śaktiḥ śeṣa kīlakam mama deha rakṣaṇe viniyogaḥ iti vaddhāṃjali devīm 
SA_MB_mahaaguhyakaaliividhaanamHK-56	manasādhyātvā paṭhed ||	manasā dhyātvā paṭhet 
SA_MB_mahaaguhyakaaliividhaanamHK-57	p. 4b) phe& śiro me kālikā pātu bhālaṃ guhye svarūpiṇī ||	śiraḥ me kālikā pātu bhālam guhye svarūpiṇī 
SA_MB_mahaaguhyakaaliividhaanamHK-58	prakaṭākhyā dṛśyai pātu vikaṭākhyā mama śruti ||	prakaṭā ākhyā dṛśyai pātu vikaṭā ākhyā mama śruti 
SA_MB_mahaaguhyakaaliividhaanamHK-59	draṃṣṭinī nāśike pāyāntu khaṃme ghora rūpiṇī ||	draṃṣṭinī nāśike pāyāntu khaṃme ghora rūpiṇī 
SA_MB_mahaaguhyakaaliividhaanamHK-60	aṭṭāṭṭahāso rasanaṃ kaṇṭhaṃ me muṇḍamālinī ||	aṭṭāṭṭahāsaḥ rasanam kaṇṭham me muṇḍamālinī 
SA_MB_mahaaguhyakaaliividhaanamHK-61	skaṃdhau meghaprabhā pātu bhujau me kharvakālikā ||	skaṃdhau meghaprabhā pātu bhujau me kharvakālikā 
SA_MB_mahaaguhyakaaliividhaanamHK-62	jayapradā karau pātu hṛdayaṃ caṇḍaghaṇṭikā ||	jaya pradā karau pātu hṛdayam caṇḍaghaṇṭikā 
SA_MB_mahaaguhyakaaliividhaanamHK-63	vakṣaḥ kuleśvarī pātu hastaṃśakti priyā mama ||	vakṣaḥ kuleśvarī pātu hastaṃśakti priyā mama 
SA_MB_mahaaguhyakaaliividhaanamHK-64	pārśvau me jaṭinī pāyād yoginī cakracāriṇī ||	pārśvau me jaṭinī pāyāt yoginī cakra cāriṇī 
SA_MB_mahaaguhyakaaliividhaanamHK-65	p. 5a) lalajjihvā pātu kukṣiṃ madhyaṃ dānavaghāṭinī ||	a lalat jihvā pātu kukṣim madhyam dānava ghāṭinī 
SA_MB_mahaaguhyakaaliividhaanamHK-66	nābhiṃ ghoramukhī pāyāt nacarmadhāriṇī jaṭī ||	nābhim ghora mukhī pāyāt na carma dhāriṇī jaṭī 
SA_MB_mahaaguhyakaaliividhaanamHK-67	māṃsabhakṣyā śaktinī meḍaruśoṇitabhojinī ||	           
SA_MB_mahaaguhyakaaliividhaanamHK-68	khecarī jānunī pātu jaṃgha kharparadhāriṇī ||	khecarī jānunī pātu jaṃgha kharpara dhāriṇī 
SA_MB_mahaaguhyakaaliividhaanamHK-69	pādau sarvatra gopāyāt sarvāṅgaṃ kālikā svāhā ||	pādau sarvatra gopāyāt sarva aṅgam kālikā svāhā 
SA_MB_mahaaguhyakaaliividhaanamHK-70	iti te kathitaṃ devi kavacaṃ deharakṣakaṃ ||	iti te kathitam devi kavacam deha rakṣakam 
SA_MB_mahaaguhyakaaliividhaanamHK-71	vinānena siddhiḥ syāt kalpakoṭiśatairapi ||	vinā anena siddhiḥ syāt kalpa koṭi śataiḥ api 
SA_MB_mahaaguhyakaaliividhaanamHK-72	gurubhaktimate deyaṃ na deyaṃ yasya kasyacit ||	guru bhaktimate deyam na deyam yasya kasyacid 
SA_MB_mahaaguhyakaaliividhaanamHK-73	p. 5b) śāntāya śuddhacintāya devībhaktāya cāriṇe |	śāntāya śuddha cintāya devī bhaktāya cāriṇe 
SA_MB_mahaaguhyakaaliividhaanamHK-74	paṭhitvā kavacaṃ devī japenmantraṃ samāhitaḥ ||	paṭhitvā kavacam devī japet mantram samāhitaḥ 
SA_MB_mahaaguhyakaaliividhaanamHK-75	urjaṭe parvate vāpi śmaśāne vā yathā ruciḥ ||	urjaṭe parvate vā api śmaśāne vā yathā ruciḥ 
SA_MB_mahaaguhyakaaliividhaanamHK-76	vighnāntasya saṃbhavaṃti naiva kutrāpi śobhane ||	vighna antasya saṃbhavanti nā eva kutra api śobhane 
SA_MB_mahaaguhyakaaliividhaanamHK-77	puraścaryādikaṃ sarvaṃ mūlavabhparivālayet ||	puraścaryā ādikam sarvam 
SA_MB_mahaaguhyakaaliividhaanamHK-78	iti yoginīhṛdaye guhyekālīrahasya devasya deharakṣakakavacannāma stotraṃ samāptaṃ |	iti yoginīhṛdaye guhyekālīrahasya devasya deharakṣakakavacat nāma stotram samāptam 
SA_MB_mahaaguhyakaaliividhaanamHK-79	atha cakra nyāsaḥ asya sarvasiddhivaktranyāsasya bhairava ṛṣiranuṣṭupchandaḥ sarvbhakṣā devatā	atha cakra nyāsaḥ asya sarva siddhi vaktra nyāsasya bhairavaḥ ṛṣiḥ anuṣṭubh chandaḥ sarva bhakṣāḥ devatā 
SA_MB_mahaaguhyakaaliividhaanamHK-80	phre& vījaṃ saḥ śaktiḥ śeṣaṃ kīlakaṃ mama vākśuddhiprāptaye mithyādoṣapraśamane	phre vījam saḥ śaktiḥ śeṣam kīlakam mama vāc śuddhi prāptaye mithyā doṣa praśamane 
SA_MB_mahaaguhyakaaliividhaanamHK-81	viniyogaḥ ||  p. 6a) iti vaddhāṃjaliḥ ||	viniyogaḥ 
SA_MB_mahaaguhyakaaliividhaanamHK-82	athanyāsaḥ ||	athanyāsaḥ 
SA_MB_mahaaguhyakaaliividhaanamHK-83	phre& hrī& cchrī& strī& hū& phre& saḥ svāhā nijamūlatamo guṇādhiṣṭita mūlavaktrāya svāhā || iti	phre hrī cchrī strī hū phre saḥ svāhā nija mūla tamaḥ guṇa adhiṣṭita mūla vaktrāya svāhā iti 
SA_MB_mahaaguhyakaaliividhaanamHK-84	mukhe ||	mukhe 
SA_MB_mahaaguhyakaaliividhaanamHK-85	phre& hrī& cchrī& strī& hū& saḥ svāhā nijamūlarajoguṇādhiṣṭhitapārśvavaktrāya svāhā ||	phre hrī cchrī strī hū saḥ svāhā nija mūla rajaḥ guṇa adhiṣṭhita pārśva vaktrāya svāhā 
SA_MB_mahaaguhyakaaliividhaanamHK-86	mark ji chek$$$$$p. 6b) vāmabhāge ||	vāma bhāge 
SA_MB_mahaaguhyakaaliividhaanamHK-87	phre& hrī& cchrī& strī& hū& saḥ svāhā nijamūlasatvaguṇādhiṣṭhitapārśvavaktrāya svāhā ||	phre hrī cchrī strī hū saḥ svāhā nija mūla satva guṇa adhiṣṭhita pārśva vaktrāya svāhā 
SA_MB_mahaaguhyakaaliividhaanamHK-88	dakṣabhāge ||	dakṣa bhāge 
SA_MB_mahaaguhyakaaliividhaanamHK-89	phre& hrī& cchrī& hū& saḥ svāhā nijamūlatriguṇādhiṣṭitatrivaktrāyai hū& phaṭ namaḥ svāhā ||	phre hrī cchrī hū saḥ svāhā nija mūla triguṇa adhiṣṭita trivaktrāyai hū phaṭ namaḥ svāhā 
SA_MB_mahaaguhyakaaliividhaanamHK-90	sarvatra maṇḍalākāreṇa || iti vaktranyāsaḥ ||	sarvatra maṇḍala ākāreṇa iti vaktra nyāsaḥ 
SA_MB_mahaaguhyakaaliividhaanamHK-91	asyā śrīguhyakālī sāvitrī vidyāyā vrahmā ṛṣigāyatrī cchandaḥ pavitrādhāni sā vitri gāyatrī	asyāḥ śrī guhyakālī sāvitrī vidyāyāḥ vrahmā ṛṣi gāyatrī chandaḥ sā gāyatrī 
SA_MB_mahaaguhyakaaliividhaanamHK-92	kālikā devatā phre& vījaṃ svāhā śaktiḥ śeṣaṃ kīlakaṃ mama pavitra śodhane viniyogaḥ ||	kālikā devatā phre vījam svāhā śaktiḥ śeṣam kīlakam mama pavitra śodhane viniyogaḥ 
SA_MB_mahaaguhyakaaliividhaanamHK-93	p. 7a) iti vaddhāṃjaliḥ ||	iti vaddha aṃjaliḥ 
SA_MB_mahaaguhyakaaliividhaanamHK-94	phre& prakaṭa sāvitryai vighnahevika gāyatryai dhīmahītantraḥ kālī pracodayāt svāhā || iti	phre prakaṭa sāvitryai vighna hevika gāyatryai dhīmahītantraḥ kālī pracodayāt svāhā iti 
SA_MB_mahaaguhyakaaliividhaanamHK-95	pavitrābhi mantraṇaṃ ||	pavitra abhi mantraṇam 
SA_MB_mahaaguhyakaaliividhaanamHK-96	atha pādakara śodhanaṃ || rahuḥ iti caraṇahastau prakṣālpātaḥ dhhrī iti prokṣye candanena krīṃ iti	atha pāda kara śodhanam rahuḥ iti caraṇa hastau dhhrī iti prokṣye candanena krīṃ iti 
SA_MB_mahaaguhyakaaliividhaanamHK-97	hastapādataleṣu vilikhyate naiva vījena tridhābhimaṃtryātaḥ te naiva vījena tridhābhimaṃtrya	hasta pāda taleṣu vilikhyate na eva vījena tridhā abhimaṃtrya atas te na eva vījena tridhā abhimaṃtrya 
SA_MB_mahaaguhyakaaliividhaanamHK-98	jalaṃtajjalena śarīraṃ siṃcayediti śmaśāna kālī sādhanaka paricāraka śarīrasiddhiḥ ||	jalam tad jalena śarīram siṃcayet iti śmaśāna kālī sādhanaka paricāraka śarīra siddhiḥ 
SA_MB_mahaaguhyakaaliividhaanamHK-99	p. 7b) asya śrīmahākālī vidyāyāmahā śmaśāna bhairava ṛṣistrī ūcchandaḥ	asya śrī mahākālī vidyāyā mahā śmaśāna bhairava ṛṣi strī ūcchandaḥ 
SA_MB_mahaaguhyakaaliividhaanamHK-100	śrīmanmahāguhyakālī kalālī devatācchraṃ vījaṃcchraḥ śaktiḥ śeṣaṃ kīlakaṃ mama sarva	śrīmat mahā guhya kālī kalā ālī devatā acchram vījam śraḥ śaktiḥ śeṣam kīlakam mama sarva 
SA_MB_mahaaguhyakaaliividhaanamHK-101	siddhyarthe viniyogaḥ ||	siddhi arthe viniyogaḥ 
SA_MB_mahaaguhyakaaliividhaanamHK-102	iti vaddhāṃjaliḥ paṭhitvā śirasi ||	iti vaddha aṃjaliḥ paṭhitvā śirasi 
SA_MB_mahaaguhyakaaliividhaanamHK-103	śrīmahāśmaśāna bhairavāaya namaḥ ||	śrī mahā śmaśāna bhairava āaya namaḥ 
SA_MB_mahaaguhyakaaliividhaanamHK-104	mukheḥ triṣṭracchandase nayaḥ nābhau cche& vījāya namaḥ ||	mukheḥ triṣṭracchandase nayaḥ nābhau cche vījāya namaḥ 
SA_MB_mahaaguhyakaaliividhaanamHK-105	p. 8a) mūlādhāne || cchaḥ śaktaye namaḥ || pādayoḥ || śeṣaṃ kīlakāya namaḥ ||	a mūlādhāne cchaḥ śaktaye namaḥ pādayoḥ śeṣam kīlakāya namaḥ 
SA_MB_mahaaguhyakaaliividhaanamHK-106	śirādipādāṃtaṃ || mama sarva siddhyarthe viniyogaḥ || iti tryaṣyādi nyāsaḥ || cchrāṃ	mama sarva siddhi arthe viniyogaḥ iti nyāsaḥ cchrāṃ 
SA_MB_mahaaguhyakaaliividhaanamHK-107	aṃguṣṭābhyāṃ namaḥ || cchrīṃ tarjanībhyāṃ namaḥ || cchruṃ madhyamābhyāṃ namaḥ ||	aṃguṣṭābhyām namaḥ cchrīṃ tarjanībhyām namaḥ cchruṃ madhyamābhyām namaḥ 
SA_MB_mahaaguhyakaaliividhaanamHK-108	cchraiṃ anāmikābhyāṃ namaḥ || cchrauṃ tarjanībhyāṃ namaḥ || cchraḥ	cchraiṃ anāmikābhyām namaḥ cchrauṃ tarjanībhyām namaḥ cchraḥ 
SA_MB_mahaaguhyakaaliividhaanamHK-109	karatalakarapṛṣṭābhyāṃ namaḥ || cchrāṃ hṛdayāya namaḥ || cchrīṃ śirase svāhā || cchūṃ	kara tala kara pṛṣṭābhyām namaḥ c   hṛdayāya namaḥ c   śirase svāhā c   
SA_MB_mahaaguhyakaaliividhaanamHK-110	śikhāyai vaṣaṭ || cchraṃ kavacāya hūṃ ||	śikhāyai vaṣaṭ cchram kavacāya hūm 
SA_MB_mahaaguhyakaaliividhaanamHK-111	p. 8b) cchrauṃ netratrayāya vauṣaṭ | cchraḥ astāya phaṭ dhyāyet ||	p b cchrauṃ netratrayāya vauṣaṭ cchraḥ astāya phaṭ dhyāyet 
SA_MB_mahaaguhyakaaliividhaanamHK-112	śṛṇu devī pravakṣyāmi karālī dhyāna mūntamaṃ ||	śṛṇu devī pravakṣyāmi karālī dhyāna 
SA_MB_mahaaguhyakaaliividhaanamHK-113	trivaktrāṃ śyāmapītāccha rūpāṃ tu raṃganāgabhāṃ ||	tri vaktrām rūpām tu 
SA_MB_mahaaguhyakaaliividhaanamHK-114	mahāmuṇḍaṃ  mudgalacchapānapātradharāṃ tataḥ ||	mahā muṇḍam mudga laccha pāna pātra dharām tatas 
SA_MB_mahaaguhyakaaliividhaanamHK-115	mūdrāṃ kuśaṃ triśūlaṃ ca dhāriṇī muṇḍamālinīṃ ||	mūdrām kuśam triśūlam ca dhāriṇī muṇḍa mālinīm 
SA_MB_mahaaguhyakaaliividhaanamHK-116	naracarmaparīdhānāṃ nāgāraṃ śyāmalāṃ jaṭilāṃ lola ||	nara carma parīdhānām nāgāram śyāmalām jaṭilām 
SA_MB_mahaaguhyakaaliividhaanamHK-117	jihvāṃ draṣṭrabhayaṃkarāṃ ||	jihvām draṣṭṛ abhayaṃkarām 
SA_MB_mahaaguhyakaaliividhaanamHK-118	bhairavena samāśliṣṭāṃ pūrvavat sthāna bhūṣitāṃ ||	bhairavena samāśliṣṭām pūrvavat sthāna bhūṣitām 
SA_MB_mahaaguhyakaaliividhaanamHK-119	p. 9a) evaṃ dhyātvā mūlamantreṇa pūṣpāṃjali trayaṃ datvā ||	evam dhyātvā mūlamantreṇa pūṣpa añjali trayam 
SA_MB_mahaaguhyakaaliividhaanamHK-120	yathāśaktijaptvā japaṃ samarpa || valiṃ dadyāt ||	yathāśakti japtvā japam samarpa valim dadyāt 
SA_MB_mahaaguhyakaaliividhaanamHK-121	mūlamantra śrīmahāguhye kālī karālikālike imaṃvaliṃ gṛhna 2 mama sarvaśāntiṃ duru 2 hū&	mūlamantra śrī mahā guhye kālī karāli kālike imam valim gṛhna mama sarva śāntim hū 
SA_MB_mahaaguhyakaaliividhaanamHK-122	phaṭ svā ||	phaṭ svā 
SA_MB_mahaaguhyakaaliividhaanamHK-123	tato vaddhāṃ jaliḥ || praśamet kālike varadedevī karālikala nātmike ||	tatas vaddhām jaliḥ 
SA_MB_mahaaguhyakaaliividhaanamHK-124	yathāśaktikṛtā pūjā sarvasiddhiṃ prayacchame ||	yathāśakti kṛtā pūjā sarva siddhim prayacchame 
SA_MB_mahaaguhyakaaliividhaanamHK-125	asya śrī jvālā prajvali mahā śmaśāna	asya śrī jvālā prajvali mahā śmaśāna 
SA_MB_mahaaguhyakaaliividhaanamHK-126	p. 9b) guhye kālī mantrasya mahāpralaya kālāgni rudra ṛṣircilāṭ cchando mahā śmaśāna jvālā	guhye kālī mantrasya mahāpralaya kālāgni rudra ṛṣiḥ cilāṭ chandaḥ mahā śmaśāna jvālā 
SA_MB_mahaaguhyakaaliividhaanamHK-127	guhyakālī devatā śrī& vījaṃ hrī& śaktiḥ klīṃ kīlakaṃ hū& kavacaṃ phre& tatvaṃ mamacaturvarga	guhya kālī devatā śrī vījam hrī śaktiḥ klīṃ kīlakam hū kavacam phre mama caturvarga 
SA_MB_mahaaguhyakaaliividhaanamHK-128	phalasiddhyarthe japa hrī& śrī& klī& hū& phre&  jvārājvarita locani mahā śmaśān guhyekālike	phala siddhi arthe japa hrī śrī klī hū phre jvārā jvarita locani mahā śmaśān guhyekālike 
SA_MB_mahaaguhyakaaliividhaanamHK-129	aṃguṣṭhābhyāṃ namaḥ ||  mahāmuṇḍamālini 10 ||  5 rjanībhyāṃ namaḥ || 5	aṃguṣṭhābhyām namaḥ mahāmuṇḍa mālini     rjanībhyām namaḥ 
SA_MB_mahaaguhyakaaliividhaanamHK-130	mahākavandhamālā bhīṣaṇi ||	mahā kavandha mālā bhīṣaṇi 
SA_MB_mahaaguhyakaaliividhaanamHK-131	p. 10a) 10 madhyamābhyāṃ namaḥ || 5 jvārā jvaridraṣṭini 10 anāmikābhyāṃ namaḥ ||	                 
SA_MB_mahaaguhyakaaliividhaanamHK-132	5 mahāvikaṭahāsya bhayaṃkari 10 kaniṣṭikābhyāṃ namaḥ ||	           
SA_MB_mahaaguhyakaaliividhaanamHK-133	5 vidyujjihvā prajvalita lālavahni jihve 10 karatalakarapṛṣṭābhyāṃ namaḥ ||	                     
SA_MB_mahaaguhyakaaliividhaanamHK-134	5 mahākrodhamukhi 10 hṛdayāya namaḥ ||	         
SA_MB_mahaaguhyakaaliividhaanamHK-135	5 śatrujihvāstaṃbhini 10 śirase svāhā ||	śatru jihvā staṃbhini śirase svāhā 
SA_MB_mahaaguhyakaaliividhaanamHK-136	5 daityadānava śoṇitāśana priye 10 śikhāyai vaṣaṭ ||	daitya dānava śoṇita aśana priye śikhāyai vaṣaṭ 
SA_MB_mahaaguhyakaaliividhaanamHK-137	5 madhupānamanttaduprekṣa jvārāmukhi 10 kavacāya hūṃ ||	kavacāya hūm 
SA_MB_mahaaguhyakaaliividhaanamHK-138	p. 10b) duṣṭa hṛdaye māṃsa mālini 10 netratrayāya vauṣaṭ ||	duṣṭa hṛdaye māṃsa mālini netratrayāya vauṣaṭ 
SA_MB_mahaaguhyakaaliividhaanamHK-139	5 cintitamanoratha sādhaki sarvalokabhayaṃkari ||	cintita manoratha sādhaki sarva loka bhayaṃkari 
SA_MB_mahaaguhyakaaliividhaanamHK-140	vrahmaviṣṇudrudrādi pūjita caraṇojvārā jvarita mahāśmaśāna guhye kālike hūṃ phaṭ namaḥ	pūjita caraṇa jvārā jvarita mahā śmaśāna guhye kālike   phaṭ namaḥ 
SA_MB_mahaaguhyakaaliividhaanamHK-141	svāhā astāya phaṭ || dhyānaṃ ||	svāhā astāya phaṭ dhyānam 
SA_MB_mahaaguhyakaaliividhaanamHK-142	ghorāṭṭahāsa duḥprekṣāṃ ghorajihvāti bhīṣaṇīṃ ||	ghora aṭṭahāsa duḥprekṣām ghora jihvā ati bhīṣaṇīm 
SA_MB_mahaaguhyakaaliividhaanamHK-143	jvālā vikaṭa duṣṭābhyāṃ vairī mastaka bhidini ||	jvālā vikaṭa duṣṭābhyām vairī mastaka bhidini 
SA_MB_mahaaguhyakaaliividhaanamHK-144	jvālāni nāda duḥprekṣāṃ jvālā jvalita locanāṃ ||	jvālāni nāda duḥprekṣām jvālā jvalita locanām 
SA_MB_mahaaguhyakaaliividhaanamHK-145	p. 11a) mahāmuṇḍa mahāmālāṃ mahāpreta lalāṭike ||	mahā muṇḍa mahā mālām mahāpreta lalāṭike 
SA_MB_mahaaguhyakaaliividhaanamHK-146	vāmapāda samārūḍhāṃ tatpāda yugalepi ca ||	vāma pāda samārūḍhām ca 
SA_MB_mahaaguhyakaaliividhaanamHK-147	śiṃjantū purapādena savyana mahatāpi ca ||	mahatā api ca 
SA_MB_mahaaguhyakaaliividhaanamHK-148	samākrāntāṃ mahāghaurāṃ vrahmāṇḍā vṛta ||	samākrāntām mahā ghaurām vrahmāṇḍāḥ 
SA_MB_mahaaguhyakaaliividhaanamHK-149	kāṃcī valayaśobhādyā sarpakaṃcūka bhīṣaṇāṃ ||	kāṃcī valaya śobhā ādyā sarpa kaṃcūka bhīṣaṇām 
SA_MB_mahaaguhyakaaliividhaanamHK-150	bhasma saṃcchatra sarvāghnaṃ tripurāṅkita lalāṭikāṃ ||	            
SA_MB_mahaaguhyakaaliividhaanamHK-151	jaṭāmukuṭa śobhādyāṃ candrārddha kṛtaśekharāṃ ||	śobhā ādyām candra arddha kṛta śekharām 
SA_MB_mahaaguhyakaaliividhaanamHK-152	yugāntāgni mahāghorāṃ vamantī mukhagahvarāt ||	yuga anta agni mahā ghorām vamantī mukha gahvarāt 
SA_MB_mahaaguhyakaaliividhaanamHK-153	p. 11b) hālāhalaviṣaṃ caiva muñcantī daśadikṣu ca ||	hālāhala viṣam ca eva muñcantī daśa dikṣu ca 
SA_MB_mahaaguhyakaaliividhaanamHK-154	svapādapadma bhajatāṃ daityadāna varakṣasāṃ ||	sva pāda padma bhajatām daitya dāna varakṣasām 
SA_MB_mahaaguhyakaaliividhaanamHK-155	vrahmādīnāṃ nṛṇāṃ caiva caturvarga phalapradāṃ ||	vrahma ādīnām nṛṇām ca eva caturvarga phala pradām 
SA_MB_mahaaguhyakaaliividhaanamHK-156	jvālāvalibhirāśliṣṭāṃ mahāvahūrbhayaṃkaraṃ ||	jvālā āvalibhiḥ āśliṣṭām mahā vahūḥ bhayaṃkaram 
SA_MB_mahaaguhyakaaliividhaanamHK-157	vilphuliṃga mahādhārāṃvamantaṃmada garvitaṃ ||	vilphuliṃga mahā dhārām vamantam mada garvitam 
SA_MB_mahaaguhyakaaliividhaanamHK-158	jvalacchūlaṃ mahākhaḍgaṃ duṣṭāntaṃ lokabhīṣaṇaṃ ||	jvalat śūlam mahā khaḍgam duṣṭa antam loka bhīṣaṇam 
SA_MB_mahaaguhyakaaliividhaanamHK-159	aṭṭahāsa durārādhyāṃ mahāmuṇḍa mahādbhutāṃ ||	aṭṭahāsa durārādhyām mahā muṇḍa mahā adbhutām 
SA_MB_mahaaguhyakaaliividhaanamHK-160	jvaratsudhā mahāpātraṃ vibhrāṇāṃ karapaṃkajaiḥ ||	jvarat sudhā mahā pātram vibhrāṇām kara paṃkajaiḥ 
SA_MB_mahaaguhyakaaliividhaanamHK-161	bhūtapreta piśācādyai yakṣagaṃdharva rākṣasaiḥ ||	bhūta preta piśāca ādyaiḥ yakṣa gaṃdharva rākṣasaiḥ 
SA_MB_mahaaguhyakaaliividhaanamHK-162	p. 12a) mṛddaṃgaśaṃkhabheryādyaiḥ sevitāṃ ghrisaroruhāṃ ||	mṛd daṅga śaṃkha bherī ādyaiḥ sevitām ghri saroruhām 
SA_MB_mahaaguhyakaaliividhaanamHK-163	madhū gaṃdha mukhāṃ bhojāṃ madhumāṃsādi bhachiṇī ||	bhojām 
SA_MB_mahaaguhyakaaliividhaanamHK-164	matsyaraktasya valibhiḥ śatrumastaka bhakṣaṇīṃ ||	matsya raktasya valibhiḥ śatru mastaka bhakṣaṇīm 
SA_MB_mahaaguhyakaaliividhaanamHK-165	nīlamegha ghanaśyāmāṃ māhāniṣṭura karmiṇīṃ ||	nīla megha ghana śyāmām māhāniṣṭura karmiṇīm 
SA_MB_mahaaguhyakaaliividhaanamHK-166	māhāmāyāṃ māhākālīṃ guhyakālīṃ kumārikāṃ ||	māhāmāyām māhākālīm guhyakālīm kumārikām 
SA_MB_mahaaguhyakaaliividhaanamHK-167	muktavastrāṃ muktakeśī pīnottata mahāstanīṃ ||	mukta vastrām muktakeśī mahā stanīm 
SA_MB_mahaaguhyakaaliividhaanamHK-168	mahāśmaśāna madhyaṣṭāṃ bhūtapretādi saṃkulāṃ ||	bhūta preta ādi 
SA_MB_mahaaguhyakaaliividhaanamHK-169	kāla saṃkarṣaṇī devī kālarātri svarūpiṇī ||	kāla saṃkarṣaṇī devī kālarātri svarūpiṇī 
SA_MB_mahaaguhyakaaliividhaanamHK-170	p. 12b) mātaraṃjagatāṃ sākṣādvandehaṃ yonimudrayā ||	mātaram jagatām sākṣāt vandeham yonimudrayā 
SA_MB_mahaaguhyakaaliividhaanamHK-171	athapaṃcopacāra pūjā ||	atha paṃca upacāra pūjā 
SA_MB_mahaaguhyakaaliividhaanamHK-172	hrī& hū& phre& jvalatpāvaka locani jvara 2 sugaṃdhamālāmālini guhyakālike gaṃdhaṃ samarpayāmi	hrī hū phre jvalat pāvaka locani jvara sugaṃdha mālā mālini guhyakālike gaṃdham samarpayāmi 
SA_MB_mahaaguhyakaaliividhaanamHK-173	|| gaṃdhasya ||	gaṃdhasya 
SA_MB_mahaaguhyakaaliividhaanamHK-174	hrī& hū& phre& ugra jvālā kālike prajvala 2 pālijāta puṣpamālaṃkṛta śarīrīni guhyakāli puṣpaṃ	hrī hū phre ugra jvālā kālike prajvala pāli jāta puṣpam ālaṃkṛta śarīrīni guhyakāli puṣpam 
SA_MB_mahaaguhyakaaliividhaanamHK-175	namaḥ tarpayāmi || puṣpasya ||	namaḥ tarpayāmi puṣpasya 
SA_MB_mahaaguhyakaaliividhaanamHK-176	hrī& hū& phre& dhūpajvālā prajvalita mahāśmaśāna vāsinigarja 2 candanā gurukarpūra kastūrī	hrī hū phre dhūpa jvālā prajvalita mahā śmaśāna candanā guru karpūra kastūrī 
SA_MB_mahaaguhyakaaliividhaanamHK-177	gorocanāadi jvārāmālā prajvarita mahādhūpadhūpita śarīriṇī guhyakāli dhūpaṃ samarpayāmi	śarīriṇī dhūpam samarpayāmi 
SA_MB_mahaaguhyakaaliividhaanamHK-178	p. 13a) dhūpasya || hrī& hū& phre& divyā mṛta kardamabhūṃṣita karpūravat paripita pralayāgni jvālā	dhūpasya hrī hū phre divyā mṛta kardama bhūṃṣita karpūravat paripita pralaya agni jvālā 
SA_MB_mahaaguhyakaaliividhaanamHK-179	dīpi maṇḍita mahāmandira bhayaṅkarinarta 2 guhyakālike dīpaṃ samarpayāmi ||	dīpi maṇḍita mahā mandira bhayaṅkari narta guhyakālike dīpam samarpayāmi 
SA_MB_mahaaguhyakaaliividhaanamHK-180	dīpasya hrī& hū& phre& madhūmatsya māhiṣāja mahāmāṃsaṃ varāhāmiṣādi jvālā mālā	dīpasya hrī hū phre madhū matsya māhiṣa aja mahāmāṃsam varāha āmiṣa ādi jvālā mālā 
SA_MB_mahaaguhyakaaliividhaanamHK-181	prajvalitayadu śopeta divyātta naivedya bhakṣiṇi mama śatrun khāhi 2	prajvalita yadu śopeta divya ātta naivedya bhakṣiṇi mama śatrun khāhi 
SA_MB_mahaaguhyakaaliividhaanamHK-182	p. 13b) guhyakālike naivedyaṃ samarpayāmi naivedyasya ||	guhyakālike naivedyam samarpayāmi naivedyasya 
SA_MB_mahaaguhyakaaliividhaanamHK-183	hrī& hū& phre& caṇḍajvālā prajvalita mahāśmaśāna mahāśmaśāna guhyekāli jvala 2 āgacchā	hrī hū phre caṇḍa jvālā prajvalita mahā śmaśāna mahā śmaśāna guhyekāli jvala āgaccha 
SA_MB_mahaaguhyakaaliividhaanamHK-184	gaccha narta 2 tiṣṭha 2 mamaśatrun bhakṣaya 2 jvālācaṇḍa mahākā nararudhira māṃsa bhakṣiṇi	gaccha narta tiṣṭha mamaśatrun bhakṣaya jvālācaṇḍa nara rudhira māṃsa bhakṣiṇi 
SA_MB_mahaaguhyakaaliividhaanamHK-185	naralokaṃ mahaya 2 mamābhīṣṭaṃ dehi 2 madhū matsya māṃsādyupakarpita samayācāra	nara lokam mahaya mama abhīṣṭam dehi madhu matsya māṃsa ādi upakarpita samayācāra 
SA_MB_mahaaguhyakaaliividhaanamHK-186	pūjāvali mimāmavalokayāvalokaya tubhyaṃ nivedayāmi gṛhna 2 māṃrakṣa 2 hū& phaṭ namaḥ	pūjā āvali m imām avalokaya avalokaya tubhyam nivedayāmi gṛhna mām rakṣa hū phaṭ namaḥ 
SA_MB_mahaaguhyakaaliividhaanamHK-187	svahā ||	svahā 
SA_MB_mahaaguhyakaaliividhaanamHK-188	p. 14a) atha puṣpāṃjaliḥ ||	atha puṣpa añjaliḥ 
SA_MB_mahaaguhyakaaliividhaanamHK-189	hrī& hū& phre& caṇḍapracaṇḍi cara 2 uparaktāṃ kārā prajvarita karavīrādi puṣpa mālini imāṃ	hrī hū phre caṇḍa pracaṇḍi cara uparaktām kārā prajvarita karavīra ādi puṣpa mālini imām 
SA_MB_mahaaguhyakaaliividhaanamHK-190	pūjāṃ jaliṃ gṛhna 2 masaśatrun hana 2 māṃrakṣa 2 guhyakālike hū& phaṭ nama svāhā || atha	pūjām jalim gṛhna masa śatrun hana mām rakṣa guhyakālike hū phaṭ nama svāhā atha 
SA_MB_mahaaguhyakaaliividhaanamHK-191	śaṃkhaṣṭhāpanaṃ ||	śaṃkha ṣṭhāpanam 
SA_MB_mahaaguhyakaaliividhaanamHK-192	hrī& jaya śaṃkhadhyanirāvinikālike namaḥ svāhā ||	hrī jaya namaḥ svāhā 
SA_MB_mahaaguhyakaaliividhaanamHK-193	p. 14b) namaskāra || śrīmahāśaṃkhayoni cakreśvari śmaśāna kālike hū& phaṭ namaḥ svāhā ||	namaskāra śrī mahāśaṃkhayoni cakreśvari śmaśāna kālike hū phaṭ namaḥ svāhā 
SA_MB_mahaaguhyakaaliividhaanamHK-194	prakṣāṇaṃ || yantraṃ likhet || vindu aṣṭadala || caturasrakṣyāmvimva || hu& phaṭ || tripādī	    likhet                         
SA_MB_mahaaguhyakaaliividhaanamHK-195	prakṣālanaṃ || tripādi pūjā || rāṃ agnimaṇḍalāya daśa kalātmane namaḥ || śaṃkhapūjā || hrī&	prakṣālanam tripādi pūjā rāṃ agni maṇḍalāya daśa kalā ātmane namaḥ śaṃkha pūjā hrī 
SA_MB_mahaaguhyakaaliividhaanamHK-196	sūrya maṇḍalāya dvādaśa kalātmane namaḥ || tatradikpālaṃ pūjayet || hrī& hū& phre& indraguhye	sūrya maṇḍalāya dvādaśa kalā ātmane namaḥ tatra dikpālam pūjayet hrī hū phre indraguhye 
SA_MB_mahaaguhyakaaliividhaanamHK-197	kāli śrīpādukāṃ pūjayāmi namaḥ ||	kāli śrī pādukām pūjayāmi namaḥ 
SA_MB_mahaaguhyakaaliividhaanamHK-198	p 15a) 3 agniguhyakālī 13 || 3 yama guhyakālī || 3 nai ṛtyaguhye kara || 3 varuṇā guhye || 3 vāyuguhye	agni guhyakālī    yama guhyakālī  nai ṛtya guhye kara   varuṇā guhye   vāyu guhye 
SA_MB_mahaaguhyakaaliividhaanamHK-199	12 || 3 kūveraguhye 12 || 3 iśāna guhye 12 || 3 vrahmaguhye 12 || 3 bhairava guhye 12 || tato jalena pūjayet	                                                            
SA_MB_mahaaguhyakaaliividhaanamHK-200	|| 3 amṛta jvālāmālike amṛtaṃ pūraya 2 phre& namasvāhā || vaṃśoma maṇḍalāya ṣoḍaśa	amṛta jvālā mālike amṛtam pūraya phre namasvāhā vaṃśa uma maṇḍalāya ṣoḍaśa 
SA_MB_mahaaguhyakaaliividhaanamHK-201	kalātmane namaḥ || tantrayantra likhet || trikoṇa paṃcakoṇa aṣṭapatra bhūvimva ||	kalā ātmane namaḥ tantrayantra likhet trikoṇa paṃcakoṇa aṣṭa pattra bhū vimva 
SA_MB_mahaaguhyakaaliividhaanamHK-202	p. 15b) trikoṇe phre& ||	trikoṇe phre 
SA_MB_mahaaguhyakaaliividhaanamHK-203	paṃcakoṇe laṃ vaṃ raṃ yaṃ phaṃ ||	paṃcakoṇe laṃ vaṃ raṃ yaṃ phaṃ 
SA_MB_mahaaguhyakaaliividhaanamHK-204	aṣṭapatre aṃ kaṃ caṃ taṃ ṭaṃ paṃ yaṃ śaṃ ||	aṣṭa patre aṃ kaṃ caṃ taṃ ṭaṃ paṃ yaṃ śam 
SA_MB_mahaaguhyakaaliividhaanamHK-205	bhūvimva raṃ laṃ taṃ kṣaṃ paṃ yaṃ saṃ haṃ ||	raṃ laṃ taṃ kṣaṃ paṃ yaṃ saṃ haṃ 
SA_MB_mahaaguhyakaaliividhaanamHK-206	aṃ hrī& phre& a& hrī& phre& vrahma guhyekālī śrīpādukāṃ pūjayāmi namaḥ ||	aṃ hrī phre a hrī phre vrahma guhyekālī śrī pādukām pūjayāmi namaḥ 
SA_MB_mahaaguhyakaaliividhaanamHK-207	śaṃkhamūle ||	śaṃkha mūle 
SA_MB_mahaaguhyakaaliividhaanamHK-208	oṃ hrī& phre& viṣṇu guhye kālī 10 ||	om hrī phre viṣṇu guhye kālī 
SA_MB_mahaaguhyakaaliividhaanamHK-209	maṃ hrī& phre& rudra guhyekālī 10 || śakhāgre pūjayet || abhimantrayet ||	maṃ hrī phre rudra guhyekālī śakha agre pūjayet abhimantrayet 
SA_MB_mahaaguhyakaaliividhaanamHK-210	hrī& śrī& phre& amṛte amṛtayogīni kālike jvara 2 śrīṃ namaḥ svāhā || śaṃkha || dhenumudrā	hrī śrī phre amṛte amṛta yogīni kālike jvara śrīṃ namaḥ svāhā śaṃkha dhenu mudrā 
SA_MB_mahaaguhyakaaliividhaanamHK-211	yonimudrāṃ darśana ||	yonimudrām darśana 
SA_MB_mahaaguhyakaaliividhaanamHK-212	p. 16a) iti śaṃkha sthāpanaṃ || atha śrīpātra sthāpanaṃ ||	iti śaṃkha sthāpanam atha śrīpātra sthāpanam 
SA_MB_mahaaguhyakaaliividhaanamHK-213	hrī& śrī& klī& śaktigaṇapatinātha śrīpādukāṃ pūjayāmi namaḥ ||	hrī śrī klī śakti gaṇapati nātha śrī pādukām pūjayāmi namaḥ 
SA_MB_mahaaguhyakaaliividhaanamHK-214	hrī& śrī& klī& gurupādukāṃ pūjayāmi namaḥ ||	hrī śrī klī guru pādukām pūjayāmi namaḥ 
SA_MB_mahaaguhyakaaliividhaanamHK-215	iti yonimudrayā namaskṛtya | phre& śmaśānakālyai nama ||	iti yonimudrayā namaskṛtya phre śmaśānakālyai nama 
SA_MB_mahaaguhyakaaliividhaanamHK-216	yonimudrayā devī namaskṛtya ||	yonimudrayā devī namaskṛtya 
SA_MB_mahaaguhyakaaliividhaanamHK-217	hrī& kāli 2 hūṃ phaṭ namaḥ svāhā ||	hrī kāli   phaṭ namaḥ svāhā 
SA_MB_mahaaguhyakaaliividhaanamHK-218	iti tripādīkṣālanaṃ ||	iti tripādī kṣālanam 
SA_MB_mahaaguhyakaaliividhaanamHK-219	vindutrikoṇa aṣṭadalabhūvimvaṃ likhet ||	        likhet 
SA_MB_mahaaguhyakaaliividhaanamHK-220	madhya hrī& likhet ||	madhya hrī likhet 
SA_MB_mahaaguhyakaaliividhaanamHK-221	p. 16b) hrī& śrī& phre& mahāśmaśāṇāya namaḥ ||	hrī śrī phre mahāśmaśāṇāya namaḥ 
SA_MB_mahaaguhyakaaliividhaanamHK-222	iti maṇḍalaṃ saṃpūjya namaḥ svāhā || tripādīṃ || pūjayet ||	iti maṇḍalam saṃpūjya namaḥ svāhā tripādīm pūjayet 
SA_MB_mahaaguhyakaaliividhaanamHK-223	hrī& śrī& phre& rāṃ rīṃ rūṃ raiṃ rauṃ raḥ vahnimaṇḍalāya daśa kalātmane namaḥ huṃ nama ||	hrī śrī phre rāṃ rīṃ rūṃ raiṃ rauṃ raḥ vahni maṇḍalāya daśa kalā ātmane namaḥ hum nama 
SA_MB_mahaaguhyakaaliividhaanamHK-224	jvalena kṣālanaṃ ||	jvalena kṣālanam 
SA_MB_mahaaguhyakaaliividhaanamHK-225	aiṃ namaḥ dravyeṇakṣālanaṃ ||	aim namaḥ dravyeṇa kṣālanam 
SA_MB_mahaaguhyakaaliividhaanamHK-226	hrī& namaḥ māṃsena mārjanaṃ ||	hrī namaḥ māṃsena mārjanam 
SA_MB_mahaaguhyakaaliividhaanamHK-227	pātraṃ dhūpayet ||	pātram dhūpayet 
SA_MB_mahaaguhyakaaliividhaanamHK-228	hrī& śrī& phre& vrahmakapāleśvari jvara 2 hrī& namaḥ svāhā ||	hrī śrī phre vrahmakapāla īśvari jvara hrī namaḥ svāhā 
SA_MB_mahaaguhyakaaliividhaanamHK-229	pātraṃ saṃsthāpya ||	pātram saṃsthāpya 
SA_MB_mahaaguhyakaaliividhaanamHK-230	hrī& śrī& phre& sūryamaṇḍalāya dvādaśa kalātmane namaḥ ||	hrī śrī phre sūrya maṇḍalāya dvādaśa kalā ātmane namaḥ 
SA_MB_mahaaguhyakaaliividhaanamHK-231	p. 17a) pātraṃ pūjayet ||	pātram pūjayet 
SA_MB_mahaaguhyakaaliividhaanamHK-232	hrī& śrī& phre& amṛte amṛteśvari amṛtaṃ śrāvaya 2 hūṃ phaṭ namaḥ svāhā ||	hrī śrī phre amṛte amṛteśvari amṛtam śrāvaya   phaṭ namaḥ svāhā 
SA_MB_mahaaguhyakaaliividhaanamHK-233	iti dravyeṇa pūrayet ||	iti dravyeṇa pūrayet 
SA_MB_mahaaguhyakaaliividhaanamHK-234	hrīṃ namaḥ māṃsakṣapaṇaṃ ||	hrīṃ namaḥ māṃsa kṣapaṇam 
SA_MB_mahaaguhyakaaliividhaanamHK-235	hrīṃ śrīṃ phreṃ somakalāya ṣoḍaśa kalātmane śmaśāna kālikā śrīpātrāmṛtaṃ	hrīṃ śrīṃ phreṃ somakalāya ṣoḍaśa kalā ātmane śmaśāna kālikā śrīpātra amṛtam 
SA_MB_mahaaguhyakaaliividhaanamHK-236	śrīpādukāṃ pūjayāmi namaḥ ||	śrī pādukām pūjayāmi namaḥ 
SA_MB_mahaaguhyakaaliividhaanamHK-237	iti saṃpūjyatanmadhye trikoṇe phreṃ likhet ||	iti saṃpūjya tad madhye trikoṇe phreṃ likhet 
SA_MB_mahaaguhyakaaliividhaanamHK-238	tanmadhye devī dhyātvā paṃcopacāraiḥ pūjayet ||	tad madhye devī dhyātvā paṃca upacāraiḥ pūjayet 
SA_MB_mahaaguhyakaaliividhaanamHK-239	iti pātra sthāpanaṃ ||	iti pātra sthāpanam 
SA_MB_mahaaguhyakaaliividhaanamHK-240	atha tarpaṇaṃ hrīṃ jvālā kālīṃ tarpayāmi namaḥ ||	atha tarpaṇam hrīṃ jvālā kālīm tarpayāmi namaḥ 
SA_MB_mahaaguhyakaaliividhaanamHK-241	p. 17b) śrīvīra śmaśāna kālī tarpayāmi namaḥ ||	śrīvīra śmaśāna kālī tarpayāmi namaḥ 
SA_MB_mahaaguhyakaaliividhaanamHK-242	phreṃ mahāśmaśāna kālīṃ tarpayāmi namaḥ ||	phreṃ mahā śmaśāna kālīm tarpayāmi namaḥ 
SA_MB_mahaaguhyakaaliividhaanamHK-243	hrīṃ śmaśāna kāli vighnaheguhye kālī dhīmahītatraḥ kālī pracodayāt ||	hrīṃ śmaśāna kāli vighna he guhye kālī kālī pracodayāt 
SA_MB_mahaaguhyakaaliividhaanamHK-244	hrīṃ śrīṃ phreṃ kālī 2 mahākāli sarvajanaṃ meva samānāya hūṃ phaṭ namaḥ svāhā ||	hrīṃ śrīṃ phreṃ kālī mahākāli sarva janam mā iva samānāya hūm phaṭ namaḥ svāhā 
SA_MB_mahaaguhyakaaliividhaanamHK-245	hrīṃ śrīṃ phreṃ vrahmāṇī kālikā śrīpādukā pūjayāmi namaḥ ||	hrīṃ śrīṃ phreṃ vrahmāṇī kālikā śrī pādukā pūjayāmi namaḥ 
SA_MB_mahaaguhyakaaliividhaanamHK-246	3 māheśvarī kālikā 10 ||	māheśvarī kālikā 
SA_MB_mahaaguhyakaaliividhaanamHK-247	3 kaumārī kālikā 10 ||	kaumārī kālikā 
SA_MB_mahaaguhyakaaliividhaanamHK-248	p. 18a) 3 vaiṣṇavī kālikā 10 ||	    
SA_MB_mahaaguhyakaaliividhaanamHK-249	3 vārāhi kālikā 10 ||	vārāhi kālikā 
SA_MB_mahaaguhyakaaliividhaanamHK-250	3 aindrī kālikā 10 ||	aindrī kālikā 
SA_MB_mahaaguhyakaaliividhaanamHK-251	3 cāmuṇḍā kālikā 10 ||	cāmuṇḍā kālikā 
SA_MB_mahaaguhyakaaliividhaanamHK-252	3 mahālakṣmī kālikā 10 ||	    
SA_MB_mahaaguhyakaaliividhaanamHK-253	3 indrakālikā ||	indrakālikā 
SA_MB_mahaaguhyakaaliividhaanamHK-254	3 agni kālikā 10 ||	agni kālikā 
SA_MB_mahaaguhyakaaliividhaanamHK-255	3 yama kālikā 10 ||	yama kālikā 
SA_MB_mahaaguhyakaaliividhaanamHK-256	3 naiṛtyakālikā 10 ||	    
SA_MB_mahaaguhyakaaliividhaanamHK-257	varuṇakālikā || vāyukālikā || kuvelakālikā 3 ||	        
SA_MB_mahaaguhyakaaliividhaanamHK-258	3 īśāna kālikā 3 vrahmakālikā 10 ||	     
SA_MB_mahaaguhyakaaliividhaanamHK-259	3 viṣṇukālikā 10 || 3 hrīṃ śrīṃ phreṃ kālikā 10 ||	viṣṇukālikā    śrīṃ phreṃ kālikā 
SA_MB_mahaaguhyakaaliividhaanamHK-260	3 mahākāli 10 || 3 caṇḍakāli 10 || jvārākālī || 3 kṛṣṇa kālī 10 || 3 karāli kāli 10 ||	                 
SA_MB_mahaaguhyakaaliividhaanamHK-261	p. 18b) 3 agnijihvā kāli 10 || draṃṣṭrinī kāli 10 || 3 kapālinī kāli 10 || 3 digamvarī kāli 10 || 3	                  
SA_MB_mahaaguhyakaaliividhaanamHK-262	ugraṇḍā lālī 10 || 3 kālāntakī kālī 10 || 3 kāla jihvā kāli 10 || 3 kṣobhiṇi kālī || 3 sarvacarvaṇī	                                   
SA_MB_mahaaguhyakaaliividhaanamHK-263	kālī 10 || asyadantadahāvana mantrasya manaścandramā ṛṣiranuṣṭupchandaḥ vasanta kāmeśvaro	mantrasya manaḥ candramāḥ ṛṣiḥ anuṣṭubh chandaḥ vasanta 
SA_MB_mahaaguhyakaaliividhaanamHK-264	devatāvaṃ vījaṃ svāhā śaktiḥ śeṣaṃ kīlakaṃ mama sarvajana mohana purvaka deha śruddhyarthe	vījam svāhā śaktiḥ śeṣam kīlakam mama sarvajana mohana purvaka deha śruddhi arthe 
SA_MB_mahaaguhyakaaliividhaanamHK-265	viniyogaḥ ||	viniyogaḥ 
SA_MB_mahaaguhyakaaliividhaanamHK-266	p. 19a) iti vaddhāṃjaliḥ || dhyāyat ||	p iti vaddha aṃjaliḥ dhyāyat 
SA_MB_mahaaguhyakaaliividhaanamHK-267	kāmeśvaraṃ tato dhyāyadvasantaṃ pavanānvitaṃ ||	kāmeśvaram tatas dhyāyat vasantam pavana anvitam 
SA_MB_mahaaguhyakaaliividhaanamHK-268	raktavarṇaṃ trinetraṃ ca sarvābharaṇa bhūṣitam ||	rakta varṇam trinetram ca sarva ābharaṇa bhūṣitam 
SA_MB_mahaaguhyakaaliividhaanamHK-269	mūlamantreṇa jiyolaja parame ||	mūlamantreṇa parame 
SA_MB_mahaaguhyakaaliividhaanamHK-270	mantraṇā vāvuya || jimanepora lūthvacore asya śrīguhyakālikā mantrasya sadāśiva	mantraṇā asya śrī guhyakālikā mantrasya sadāśiva 
SA_MB_mahaaguhyakaaliividhaanamHK-271	ṛṣirvṛhatīcchandaḥ śrī guhyakālikā devatā phreṃ vījaṃ svāhā śaktiḥ ||	ṛṣiḥ vṛhatī chandaḥ śrī guhya kālikā devatā phreṃ vījam svāhā śaktiḥ 
SA_MB_mahaaguhyakaaliividhaanamHK-272	śeṣaṃ kīlakaṃ mama bhoga mokṣārthe viniyogaḥ ||	śeṣam kīlakam mama bhoga mokṣa arthe viniyogaḥ 
SA_MB_mahaaguhyakaaliividhaanamHK-273	p. 19b) phrāṃ aṃguṣṭābhyāṃ namaḥ ||	phrāṃ aṃguṣṭābhyām namaḥ 
SA_MB_mahaaguhyakaaliividhaanamHK-274	phrīṃ tarjanībhyāṃ namaḥ || phraṃ madhyamābhyāṃ namaḥ ||	phrīṃ tarjanībhyām namaḥ phraṃ madhyamābhyām namaḥ 
SA_MB_mahaaguhyakaaliividhaanamHK-275	phraiṃ anāmikābhyāṃ namaḥ ||	phraiṃ anāmikābhyām namaḥ 
SA_MB_mahaaguhyakaaliividhaanamHK-276	phrauṃ kaniṣṭābhyāṃ namaḥ ||	phrauṃ kaniṣṭābhyām namaḥ 
SA_MB_mahaaguhyakaaliividhaanamHK-277	phreṃ karatalakara pṛṣṭābhyāṃ namaḥ ||	phreṃ kara tala kara pṛṣṭābhyām namaḥ 
SA_MB_mahaaguhyakaaliividhaanamHK-278	evaṃ hṛdayādi || dhyānaṃ || nīlotpaladala śyāmāṃ śmaśānapreta sa sthitāṃ ||	evam hṛdaya ādi dhyānam sa sthitām 
SA_MB_mahaaguhyakaaliividhaanamHK-279	khaḍgaṃ pāśavarābhīti vibhrāṇāṃ karapallavaiḥ ||	khaḍgam pāśa vara abhīti vibhrāṇām kara pallavaiḥ 
SA_MB_mahaaguhyakaaliividhaanamHK-280	mahākālīṃ mahāmāyāṃ muktakeśi digamvarāṃ ||	mahākālīm mahāmāyām muktakeśi digamvarām 
SA_MB_mahaaguhyakaaliividhaanamHK-281	muṇḍā sthikaramālādyāṃ draṣṭā kuṃ vibhāṣaṇāṃ ||	muṇḍā sthi kara mālā ādyām draṣṭā kum vibhāṣaṇām 
SA_MB_mahaaguhyakaaliividhaanamHK-282	p. 20a) asthikuṇḍala saṃkāśāṃ sarvābhīṣṭa phalapradāṃ ||	asthikuṇḍala saṃkāśām sarva abhīṣṭa phala pradām 
SA_MB_mahaaguhyakaaliividhaanamHK-283	guhyekālī mahaṃ vande bhairavāṃ śli vigrahāṃ ||	vande bhairavām 
SA_MB_mahaaguhyakaaliividhaanamHK-284	phreṃ mahāśmaśāna caṇḍaguhyekāli namaḥ svāhā ||	phreṃ mahāśmaśāna caṇḍaguhyekāli namaḥ svāhā 
SA_MB_mahaaguhyakaaliividhaanamHK-285	phreṃ śmaśāna kāli 2 śmaśāna yogini 2 māṃrakṣa 2 hūṃ phaṭ svāhā ||	phreṃ śmaśāna kāli śmaśāna yogini mām rakṣa hūm phaṭ svāhā 
SA_MB_mahaaguhyakaaliividhaanamHK-286	hūṃ sauḥ saṃ saḥ saṃ sau hraṃ svāhā ||	hūm sauḥ saṃ saḥ saṃ sau hraṃ svāhā 
SA_MB_mahaaguhyakaaliividhaanamHK-287	ykṣkhphrau& mvalū uddiṣṭa cāṇḍālinyai namaḥ svāhā ||	ykṣkhphrau mvalū uddiṣṭa cāṇḍālinyai namaḥ svāhā 
SA_MB_mahaaguhyakaaliividhaanamHK-288	mvlūṃ uchiṣṭa cāṇḍāli sarvajanaṃ vaśamānaye svāhā ||	uchiṣṭa cāṇḍāli sarva janam vaśam ānaye svāhā 
SA_MB_mahaaguhyakaaliividhaanamHK-289	athaprātaḥ kṛtyaḥ ||	atha prātar kṛtyaḥ 
SA_MB_mahaaguhyakaaliividhaanamHK-290	p. 20b) asya śrīgurumaṃtrasya mahākāla rudra ṛṣi stṛṣṭūpchandaḥ śrīmanmahā guhye kālī	asya śrī guru mantrasya mahākāla rudra ṛṣi śrīmat mahā guhye kālī 
SA_MB_mahaaguhyakaaliividhaanamHK-291	deśika ānandā nandanātha parama gurudevatā hvau vījaṃ svāhā śaktiḥ śeṣaṃ kīlakaṃ mama	deśika ānandā nandanātha parama guru devatā hvau vījam svāhā śaktiḥ śeṣam kīlakam mama 
SA_MB_mahaaguhyakaaliividhaanamHK-292	sarvakarma phalaprāptaye viniyogaḥ ||	sarva karma phala prāptaye viniyogaḥ 
SA_MB_mahaaguhyakaaliividhaanamHK-293	iti vaddhāṃjaliḥ  hnlāṃ hnlīṃ hnlaṃ hnlaiṃ hnlaḥ iti karaṃganyāsau kṛtvā || dhyāyet ||	iti vaddha aṃjaliḥ hnlāṃ hnlīṃ hnlaṃ hnlaiṃ hnlaḥ iti karaṃga nyāsau kṛtvā dhyāyet 
SA_MB_mahaaguhyakaaliividhaanamHK-294	varābhayaṃ karaṃ śāntaṃ śuklālaṃkāra bhūṣitaṃ ||	vara abhayam karam śāntam śukla alaṃkāra bhūṣitam 
SA_MB_mahaaguhyakaaliividhaanamHK-295	raktaśaktyā samāsīnaṃ kula dhyānena mudrayā ||	rakta śaktyā samāsīnam kula dhyānena mudrayā 
SA_MB_mahaaguhyakaaliividhaanamHK-296	p. 21a) jñānumudrā pustakaṃ ca dadhantaṃsusmṛtaṃ smaret ||	jñānu mudrā pustakam ca dadhantam susmṛtam smaret 
SA_MB_mahaaguhyakaaliividhaanamHK-297	evaṃ dhyātvā mānasopacāraiḥ saṃpujya ||	evam dhyātvā mānasa upacāraiḥ saṃpujya 
SA_MB_mahaaguhyakaaliividhaanamHK-298	phraiṃ hnlauṃ phreṃ iti mūlaṃ daśadhā japitvā japaṃ nivedye ||	phraiṃ hnlaum phreṃ iti mūlam daśadhā japitvā japam nivedye 
SA_MB_mahaaguhyakaaliividhaanamHK-299	vaddhāṃ jatiḥ yasya śrīpāda raja sāraṃjite mastake śivaḥ ||	jatiḥ yasya śrīpāda raja sāraṃjite mastake śivaḥ 
SA_MB_mahaaguhyakaaliividhaanamHK-300	ramate sahapārvatyātahā śaktiḥ śeṣaṃ kīlakaṃ mama sarvakarma phalaprataye viniyogaḥ ||	ramate śaktiḥ śeṣam kīlakam mama sarva karma phala prataye viniyogaḥ 
SA_MB_mahaaguhyakaaliividhaanamHK-301	p. 21b) iti vaddhāṃ jaliḥ || ṣaṭdīrgha bhājā vījena karāṃgaṃ nyāsau kṛtvā ||	iti vaddhām jaliḥ ṣaṣ dīrgha bhājā vījena kara aṅgam nyāsau kṛtvā 
SA_MB_mahaaguhyakaaliividhaanamHK-302	ślāṃ ślīṃ ślūṃ ślaiṃ ślauṃ ślaḥ parvavaddhyātvā mānasopacārai saṃpūjya ||	ślāṃ ślīṃ ślūṃ ślaiṃ ślauṃ ślaḥ parvavat dhyātvā mānasa upacāraiḥ saṃpūjya 
SA_MB_mahaaguhyakaaliividhaanamHK-303	phreṃ ślauṃ phreṃ svāhā ||	phreṃ ślauṃ phreṃ svāhā 
SA_MB_mahaaguhyakaaliividhaanamHK-304	iti mūlaṃ daśadhā japtvā japaṃ nivedya vaddhāṃjaliḥ ||	iti mūlam daśadhā japtvā japam nivedya vaddha aṃjaliḥ 
SA_MB_mahaaguhyakaaliividhaanamHK-305	tvamādyā paramāśaktir gaccaitanya rūpiṇī ||	tvam ādyā paramā aśaktiḥ gaccaitanya rūpiṇī 
SA_MB_mahaaguhyakaaliividhaanamHK-306	jagadamva namastestu mantra siddhiṃ prayacchame ||	jagadamva namaḥ te tu mantra siddhim prayacchame 
SA_MB_mahaaguhyakaaliividhaanamHK-307	asyāḥ śrīpādukā vidyāyā mahāpreta sadāśiva ṛṣiranuṣṭupchandaḥ śrīmanmahā guhyakālī	asyāḥ śrī pādukā vidyāyāḥ mahāpreta sadāśivaḥ ṛṣiḥ anuṣṭubh chandaḥ śrīmat mahā guhyakālī 
SA_MB_mahaaguhyakaaliividhaanamHK-308	pādukāśaktiḥ vatā khroṃ vījaṃ khraḥ śakti śeṣaṃ kīlakaṃ mama tribhuvana siddhyarthe	pādukā śaktiḥ vatā khroṃ vījam khraḥ śakti śeṣam kīlakam mama tribhuvana siddhi arthe 
SA_MB_mahaaguhyakaaliividhaanamHK-309	viniyogaḥ ||	viniyogaḥ 
SA_MB_mahaaguhyakaaliividhaanamHK-310	p. 22a) iti vaddhāṃjaliḥ ||	iti vaddha añjaliḥ 
SA_MB_mahaaguhyakaaliividhaanamHK-311	khrāṃ khrīṃ khrūṃ khraiṃ khrauṃ khraḥ ||	khrāṃ khrīṃ khrūṃ khraiṃ khrauṃ khraḥ 
SA_MB_mahaaguhyakaaliividhaanamHK-312	anena karāṅga nyāsau kṛtvā ||	anena kara aṅga nyāsau kṛtvā 
SA_MB_mahaaguhyakaaliividhaanamHK-313	dhyāyet ||	dhyāyet 
SA_MB_mahaaguhyakaaliividhaanamHK-314	aṣṭa pādāmaṣṭa bhujāṃ caturvakrā trilocanāṃ ||	aṣṭa pādām aṣṭa bhujām catur vakrā tri locanām 
SA_MB_mahaaguhyakaaliividhaanamHK-315	draṣṭrā ghoramukhīṃ śyāmāṃ sarvālaṃkāla bhūṣitāṃ ||	draṣṭrā ghora mukhīm śyāmām sarva alaṃkāla bhūṣitām 
SA_MB_mahaaguhyakaaliividhaanamHK-316	evaṃ dhyātvā mānasāpacāraiḥ saṃpūjyaḥ ||	evam dhyātvā mānasa apacāraiḥ saṃpūjyaḥ 
SA_MB_mahaaguhyakaaliividhaanamHK-317	p. 22b) khroṃ daśadhā japtvā japaṃ samarpa ||	  daśadhā japtvā japam samarpa 
SA_MB_mahaaguhyakaaliividhaanamHK-318	nyāsaṃ kuryāt ||	nyāsam kuryāt 
SA_MB_mahaaguhyakaaliividhaanamHK-319	phreṃ hrīṃ strīṃ cchīṃ hūṃ vidyā tatvātmikāyai satvaguṇā dhiṣṭita śuklapādukāyai namaḥ	phreṃ   strīṃ cchīṃ   vidyā tattva ātmikāyai sattva guṇāḥ śukla pādukāyai namaḥ 
SA_MB_mahaaguhyakaaliividhaanamHK-320	svāhā ||	svāhā 
SA_MB_mahaaguhyakaaliividhaanamHK-321	5 ātmatatvātmikā yairajoguṇadhiṣṭitarakta pādukāyai namaḥ svāhā ||	ātma tattva ātmakā yaiḥ rajaḥ guṇa dhiṣṭita rakta pādukāyai namaḥ svāhā 
SA_MB_mahaaguhyakaaliividhaanamHK-322	5 śiva tatvātmikā yaitamoguṇādhiṣṭita kṛṣṇapādukāyai namaḥ svāhāḥ ||	śiva tatu ātmika kṛṣṇa pādukāyai namaḥ svāhāḥ 
SA_MB_mahaaguhyakaaliividhaanamHK-323	vaddhāṃjaliḥ tvaṃ vrahmaparamaṃ sākṣāt pādukā parameśvari ||	vaddha aṃjaliḥ tvam vrahma paramam sākṣāt pādukā parameśvari 
SA_MB_mahaaguhyakaaliividhaanamHK-324	caturddhā deha bhāvena varadā bhavate namaḥ ||	caturddhā deha bhāvena vara dā bhavate namaḥ 
SA_MB_mahaaguhyakaaliividhaanamHK-325	p. 23a) asyāścaraṇa vidyāyāḥ pādukā ṛṣirvṛhatīcchandaḥ śrīmanmahā guhyakālī	asyāḥ caraṇa vidyāyāḥ pādukā ṛṣiḥ vṛhatī chandaḥ śrīmat mahā guhyakālī 
SA_MB_mahaaguhyakaaliividhaanamHK-326	caraṇātimikā devatā phreṃ vījaṃ phraḥ śaktiḥ śeṣaṃ kīlakaṃ mama sarvaśaktisiddhaye	caraṇātimikā devatā phreṃ vījam phraḥ śaktiḥ śeṣam kīlakam mama sarva śakti siddhaye 
SA_MB_mahaaguhyakaaliividhaanamHK-327	viniyogaḥ ||	viniyogaḥ 
SA_MB_mahaaguhyakaaliividhaanamHK-328	phrāṃ phrīṃ phrūṃ praṃ phraiṃ phrauṃ phraḥ iti karāṅganyāsau kṛtvā || dhyāyet ||	phrām phrīṃ phrūm praṃ phraiṃ phraum phraḥ iti kara aṅganyāsau kṛtvā dhyāyet 
SA_MB_mahaaguhyakaaliividhaanamHK-329	pādukā vattatodhyāyet kālikāṃ caraṇātmikāṃ ||	pādukāḥ vat tatas dhyāyet kālikām caraṇa ātmikām 
SA_MB_mahaaguhyakaaliividhaanamHK-330	jyotirmayīṃ mahāghorāṃ paraṃ vrahma svarūpinī ||	jyotiḥ mayīm mahā ghorām param vrahma svarūpinī 
SA_MB_mahaaguhyakaaliividhaanamHK-331	iti manasopacāraiḥ saṃpūjya ||	iti manasā upacāraiḥ saṃpūjya 
SA_MB_mahaaguhyakaaliividhaanamHK-332	mūlaṃ phroṃ phraḥ svāhā daśadhā japtvājapaṃ samarpa tato nyāsaṃ kuryāt ||	mūlam phroṃ phraḥ svāhā daśadhā japtvā ajapam samarpa tatas nyāsam kuryāt 
SA_MB_mahaaguhyakaaliividhaanamHK-333	phreṃ phrīṃ strīṃ hūṃ chrīṃ vidyā tvātmikā yaitamoguṇātmikāyai miśracaraṇātmikāyai	phreṃ phrīṃ strīm hūm chrīṃ vidyā tu ātmikā yai tamaḥ guṇa ātmikāyai miśra caraṇa ātmikāyai 
SA_MB_mahaaguhyakaaliividhaanamHK-334	namaḥ svāhā ||	namaḥ svāhā 
SA_MB_mahaaguhyakaaliividhaanamHK-335	vaddhāṃjaliḥ ||	vaddha aṃjaliḥ 
SA_MB_mahaaguhyakaaliividhaanamHK-336	p. 24a) tvameva paramaṃ sakṣāccaraṇa vrahma rūpiṇi ||	tvam eva paramam sakṣāccaraṇa vrahma rūpiṇi 
SA_MB_mahaaguhyakaaliividhaanamHK-337	kālikāmarca yāmyadyasiddhiṃ hehi namostute ||	kālikām arca yāmi adya siddhim hehi namostute 
SA_MB_mahaaguhyakaaliividhaanamHK-338	athadanta dhāvanaṃ ||	athadanta dhāvanam 
SA_MB_mahaaguhyakaaliividhaanamHK-339	asyadanta dhāvana mantrasya oṣadhi ṛṣirvirāṭcchando vanaspati devatāvaṃvījaṃ svāhā śaktiḥ	mantrasya oṣadhi ṛṣiḥ virāj chandaḥ vanaspati devatā avaṃvījam svāhā śaktiḥ 
SA_MB_mahaaguhyakaaliividhaanamHK-340	śeṣaṃ kīlakaṃ mamuśarīra śodhane viniyogaḥ ||	śeṣam kīlakam śodhane viniyogaḥ 
SA_MB_mahaaguhyakaaliividhaanamHK-341	vāṃ vīṃ vūṃ vaiṃ vauṃ vaḥ iti karāṅga nyāsau vidhāya ||	vām vīṃ vūṃ vaiṃ vauṃ vaḥ iti kara aṅga nyāsau vidhāya 
SA_MB_mahaaguhyakaaliividhaanamHK-342	dhyāyet || śuklaṃvarṇā tato dhyāyed vanaspati mamāmayaṃ ||	dhyāyet śuklam varṇā tatas dhyāyet vanaspati mama amayam 
SA_MB_mahaaguhyakaaliividhaanamHK-343	jaṭābhāra paritāṅgaṃ sarvāṅgaṃ bhūtibhūṣaṇaṃ ||	sarva aṅgam bhūtibhūṣaṇam 
SA_MB_mahaaguhyakaaliividhaanamHK-344	p. 24b) vāmahastetoyabhāṇḍaṃ dakṣahasteviśodhinīṃ ||	vāma hasta toya bhāṇḍam dakṣa haste viśodhinīm 
SA_MB_mahaaguhyakaaliividhaanamHK-345	sādhakāya prayacchantaṃ kamūlaṃ vanaspataye svāhā ||	sādhakāya prayacchantam ka mūlam vanaspataye svāhā 
SA_MB_mahaaguhyakaaliividhaanamHK-346	daśadhā japtvā samarpa dantakāṣṭābhi mantraṇaṃ ||	daśadhā japtvā samarpa dantaka aṣṭa abhi mantraṇam 
SA_MB_mahaaguhyakaaliividhaanamHK-347	phreṃ hrīṃ hūṃ strīṃ śrīṃ vanaspati vāsinivāsayamamāṅgaṃ mātraṃ huṃ phaṭ namaḥ	phreṃ      strīṃ śrīṃ vanaspati mātram hum phaṭ namaḥ 
SA_MB_mahaaguhyakaaliividhaanamHK-348	svāhā || gaṇḍakhaṃ 12 atha snānaṃ || asyāḥ snānavidyāyā varuṇa ṛṣiranuṣṭa cchandaḥ	svāhā gaṇḍakhaṃ atha snānam asyāḥ snāna vidyāyāḥ chandaḥ 
SA_MB_mahaaguhyakaaliividhaanamHK-349	śrīmanmahā malāpa karṣaṇī devatāmlau vījaṃ mlaḥ śakti śeṣaṃ kīlakaṃ mama deha	karṣaṇī devatā amlau vījam mlaḥ śakti śeṣam kīlakam mama deha 
SA_MB_mahaaguhyakaaliividhaanamHK-350	śuddhyarthe viniyogaḥ ||	śuddhi arthe viniyogaḥ 
SA_MB_mahaaguhyakaaliividhaanamHK-351	p. 25a) mlāṃ mlīṃ mlūṃ mlaiṃ mlauṃ mlaḥ ||	           
SA_MB_mahaaguhyakaaliividhaanamHK-352	iti karaṃganyāsau kṛtvā dhyāyet ||	iti karaṃga nyāsau kṛtvā dhyāyet 
SA_MB_mahaaguhyakaaliividhaanamHK-353	malāpa karṣaṇīṃ dhyāyedrādravastāṃ bhayānakāṃ ||	karṣaṇīm dhyāyet rādravaḥ tām bhayānakām 
SA_MB_mahaaguhyakaaliividhaanamHK-354	toya māṇḍamādravastāṃ dadhantīṃ śyāmalāṃ smaret ||	tām dadhantīm śyāmalām smaret 
SA_MB_mahaaguhyakaaliividhaanamHK-355	evaṃ dhyātvā mānasaupacāraiḥ saṃpūjya ||	evam dhyātvā mānasa aupacāraiḥ saṃpūjya 
SA_MB_mahaaguhyakaaliividhaanamHK-356	mlaumalāparṣaṇimlaḥ svāhā ||	svāhā 
SA_MB_mahaaguhyakaaliividhaanamHK-357	iti mūlaṃ daśadhā japtvājapaṃ samarpa ||	iti mūlam daśadhā japtvā a japam samarpa 
SA_MB_mahaaguhyakaaliividhaanamHK-358	toyetrikoṇavṛtta caturasraṃ vilikhya ||	catur asram vilikhya 
SA_MB_mahaaguhyakaaliividhaanamHK-359	madhya phreṃ  vilikhya ||	madhya phreṃ vilikhya 
SA_MB_mahaaguhyakaaliividhaanamHK-360	snāna vidyayā daśadhābhimaṃtrya yonimudrayā tridhā dhenumudrayā tridhākara samudrayā	snāna vidyayā daśadhā abhimaṃtrya yonimudrayā tridhā dhenumudrayā tridhākara sa mudrayā 
SA_MB_mahaaguhyakaaliividhaanamHK-361	tridhā ātmāna mabhiṣiṃcayet ||	tridhā ātmānam abhiṣiṃcayet 
SA_MB_mahaaguhyakaaliividhaanamHK-362	p. 25b) vaddhāṃjaliḥ || sarvaśuddhiprade devi malāpa karṣaṇīśvari ||	                 
SA_MB_mahaaguhyakaaliividhaanamHK-363	deha śuddhiṃ prayacchādya kālikā marcayāmyahaṃ ||	deha śuddhim prayaccha adya kālikā marcayāmi aham 
SA_MB_mahaaguhyakaaliividhaanamHK-364	atha saṃdhyā || toye trikoṇavṛtta caturasra maṇḍalaṃ viliṣya ||	atha saṃdhyā toye trikoṇa vṛtta caturasra maṇḍalam viliṣya 
SA_MB_mahaaguhyakaaliividhaanamHK-365	trikoṇe phreṃ vilikhya || phreṃ hrīṃ strīṃ cchrīṃ hūṃ vikaṭakālike mlūṃ saḥ svāhā ||	trikoṇe phreṃ vilikhya phreṃ   strīṃ cchrīṃ   vikaṭakālike mlūṃ saḥ svāhā 
SA_MB_mahaaguhyakaaliividhaanamHK-366	ityābhimaṃtrya || cūlukamudrayā kiṃcintoya mādāya vāmaka tiṣṭayā phreṃ garbha trikoṇaṃ	cūluka mudrayā kiṃcid toyam ādāya vāmaka tiṣṭayā phreṃ garbha trikoṇam 
SA_MB_mahaaguhyakaaliividhaanamHK-367	vilikhya ||	vilikhya 
SA_MB_mahaaguhyakaaliividhaanamHK-368	p. 26a) gāyatryābhi maṃtrya tatva mudrayā tarpayet ||	gāyatryā abhi maṃtrya tatva mudrayā tarpayet 
SA_MB_mahaaguhyakaaliividhaanamHK-369	mūlādhāre aiṃsaḥ svāhā || hṛdi 5 haṃsaḥ svāhā || śirasi 5 mnauṃ svaḥ svāhā || ityapyukṣa ||	mūlādhāre aiṃsaḥ svāhā hṛdi haṃsaḥ svāhā śirasi mnauṃ svar svāhā iti apyukṣa 
SA_MB_mahaaguhyakaaliividhaanamHK-370	śeṣodakaṃ vāmanāśā pūṭena hṛdiviśamānīya 5 raṃsaḥ svāhā ||	śeṣa udakam vāmanāśā pūṭena hṛdiviśam ānīya raṃsaḥ svāhā 
SA_MB_mahaaguhyakaaliividhaanamHK-371	sarvapāpaṃ dagdhā dakṣanāśā pūtena sa pāpaṃ tajjalaṃ vahirnismārya ||	sarva pāpam dagdhā dakṣa nāśā pūtena sa pāpam tat jalam vahis nismārya 
SA_MB_mahaaguhyakaaliividhaanamHK-372	sndrauṃsaḥ svāhā || iti vajaśilopari prakṣipet ||	sndra oṃsaḥ svāhā iti vaja śilā upari prakṣipet 
SA_MB_mahaaguhyakaaliividhaanamHK-373	hastaṃ prakṣālyā camyaṃ vaddhāṃjaliḥ ||	hastam prakṣālya ā camyam vaddha aṃjaliḥ 
SA_MB_mahaaguhyakaaliividhaanamHK-374	p. 26b) asyāḥ karālī gāyatrī vidyāyā vikaṭabhairava ṛṣirunuṣṭumchandaḥ śrīman mahākālo	asyāḥ karālī gāyatrī vidyāyāḥ vikaṭabhairavaḥ ṛṣiḥ unuṣṭubh chandaḥ śrīmat mahākālaḥ 
SA_MB_mahaaguhyakaaliividhaanamHK-375	kāma kalā gāyatrī devatā phreṃ vījaṃ saḥ śaktiḥ śeṣaṃ kīlakaṃ mama sarvapāpakṣayeni	kāma kalā gāyatrī devatā phreṃ vījam saḥ śaktiḥ śeṣam kīlakam mama sarva pāpa kṣaya ini 
SA_MB_mahaaguhyakaaliividhaanamHK-376	viyogaḥ ||	viyogaḥ 
SA_MB_mahaaguhyakaaliividhaanamHK-377	phrāṃ phrīṃ phrūṃ phraiṃ phrauṃ phraḥ ||	phrām phrīṃ phrūm phraiṃ phraum phraḥ 
SA_MB_mahaaguhyakaaliividhaanamHK-378	iti karāṅga nyāsau vidhāyet ||	iti kara aṅga nyāsau vidhāyet 
SA_MB_mahaaguhyakaaliividhaanamHK-379	gāyatrīṃ vrahmacidrūpāṃ trivarṇā muṇḍamālinī ||	gāyatrīm vrahma cit rūpām tri varṇā muṇḍa mālinī 
SA_MB_mahaaguhyakaaliividhaanamHK-380	akṣamālāṃ pūstakaṃ ca śivaśaktiṃ varābhayaṃ ||	akṣamālām pūstakam ca śiva śaktim vara abhayam 
SA_MB_mahaaguhyakaaliividhaanamHK-381	gajamudrāṃ ca dadhatī bhairaveṇa kṛtotsavāṃ ||	gajamudrām ca dadhatī bhairaveṇa kṛta utsavām 
SA_MB_mahaaguhyakaaliividhaanamHK-382	sarvālaṃkāra bhūṣadyāṃ vyāghracarma kṛtotsavāṃ ||	sarva alaṃkāra bhūṣadyām vyāghra carma kṛta utsavām 
SA_MB_mahaaguhyakaaliividhaanamHK-383	p 27a) evaṃ dhyātvā mānasopacāraiḥ saṃpūjya arghadadyāt ||	evam dhyātvā mānasa upacāraiḥ saṃpūjya argha dadyāt 
SA_MB_mahaaguhyakaaliividhaanamHK-384	phreṃ phreṃ prakaṭa kālikāyai vighnahe mraiṃ saḥ ||	phreṃ phreṃ prakaṭa kālikāyai vighna he mraiṃ saḥ 
SA_MB_mahaaguhyakaaliividhaanamHK-385	vikaṭadraṃṣṭāyai dhīmahitatrakālī pracodayāt ||	vikaṭa draṃṣṭāyai pracodayāt 
SA_MB_mahaaguhyakaaliividhaanamHK-386	nijamala udyadāditya maṇḍalavartivyai śivacaitanyamayau śrīmanmahā karālī kālikāyai	nija male udyat āditya maṇḍala vartivyai śiva caitanya mayau śrīmat mahā karālī kālikāyai 
SA_MB_mahaaguhyakaaliividhaanamHK-387	idamarghaṃ nivedayāmi pratīccha svāhā ||	idam argham nivedayāmi pratīccha svāhā 
SA_MB_mahaaguhyakaaliividhaanamHK-388	iti tridhārghaṃ nivedye ||	iti tridhā argham nivedye 
SA_MB_mahaaguhyakaaliividhaanamHK-389	yathā śakti gāyatrīṃ japtvā japaṃ nivedya vaddhāṃjaliḥ pasthānaṃ kūryāt || karālī kālī	yathāśakti gāyatrīm japtvā japam nivedya vaddha aṃjaliḥ kūryāt 
SA_MB_mahaaguhyakaaliividhaanamHK-390	gāyatrī paraṃvrahma svarūpiṇi karālī marcayāmyadya sarvapāpakṣayaṃ kūru ||	gāyatrī param vrahma svarūpiṇi karālī marcayāmi adya sarva pāpa kṣayam kūru 
SA_MB_mahaaguhyakaaliividhaanamHK-391	p. 27b) punarupaviśya || tarpaṇaṃ kūryāt || hnlauṃ paramaguruṃ tarpayāmi namaḥ svāhā || tridhā ||	punar upaviśya tarpaṇam kūryāt hnlauṃ parama gurum tarpayāmi namaḥ svāhā tridhā 
SA_MB_mahaaguhyakaaliividhaanamHK-392	5 nhlauṃguru śaktiṃ tarpayāmi namaḥ svāhā ||	nhlauṃ guru śaktim tarpayāmi namaḥ svāhā 
SA_MB_mahaaguhyakaaliividhaanamHK-393	nijamūlaśīmanmahā karālīkalī tarpayāmi namaḥ svāhā ||	karālī kalī tarpayāmi namaḥ svāhā 
SA_MB_mahaaguhyakaaliividhaanamHK-394	5 sphreṃ śrīmanmahā śmaśāna bhairavattarpayāmi nama svāhā ||	sphreṃ śrīman mahā śmaśāna bhairavat tarpayāmi nama svāhā 
SA_MB_mahaaguhyakaaliividhaanamHK-395	5 haṃsaḥ ātmatatvaṃ tarpayāmi namaḥ svāhā ||	haṃsaḥ tarpayāmi namaḥ svāhā 
SA_MB_mahaaguhyakaaliividhaanamHK-396	5 eṃ aiṃ eṃ vidyātatvaṃ tarpayāmi namaḥ svāhā ||	em aim em tarpayāmi namaḥ svāhā 
SA_MB_mahaaguhyakaaliividhaanamHK-397	5 eṃ sauṃ saṃ saḥ saṃkūla tatvaṃ tarpayāmi namaḥ svāhā ||	em sauṃ saṃ saḥ tarpayāmi namaḥ svāhā 
SA_MB_mahaaguhyakaaliividhaanamHK-398	p. 28a) 5 karālī śaktayoyāśca jñātājñāta svarūpakāḥ ||	          
SA_MB_mahaaguhyakaaliividhaanamHK-399	karālī cakra vartinya sarvāsnāstarpayāmyahaṃ || tridhā ||	sarvāsnāḥ tarpayāmi aham tridhā 
SA_MB_mahaaguhyakaaliividhaanamHK-400	tatomūla devatā ṛṣyādinyā saṃkṛtvā dhyātvā yathāśakti mūlaṃ japtvā japaṃ	devatāḥ ṛṣi ādinyā saṃkṛtvā dhyātvā yathāśakti mūlam japtvā japam 
SA_MB_mahaaguhyakaaliividhaanamHK-401	samarpapraṇamyat ||	samarpa praṇamyat 
SA_MB_mahaaguhyakaaliividhaanamHK-402	karālikālike mātaḥ sarvasiddhi pradāyinī ||	          
SA_MB_mahaaguhyakaaliividhaanamHK-403	yat kicidvihitaṃ śaktyā tatsarvaṃ sāṃgamastume ||	yat kicid vihitam śaktyā tat sarvam sāṃgam astu me 
SA_MB_mahaaguhyakaaliividhaanamHK-404	iti saṃdhyā || atha pūjā ||	iti saṃdhyā atha pūjā 
SA_MB_mahaaguhyakaaliividhaanamHK-405	phreṃ apasarpantute bhūtāye bhūtāvighna kārakāḥ ||	phreṃ apasarpantute bhūtāye bhūta avighna kārakāḥ 
SA_MB_mahaaguhyakaaliividhaanamHK-406	ye bhūtā vighna kartārastenaśyantu śivājñayā ||	ye bhūtāḥ vighna kartāraḥ te naśyantu śiva ājñayā 
SA_MB_mahaaguhyakaaliividhaanamHK-407	p. 28b) ityakṣata prakṣepaṇaṃ ||	iti akṣata prakṣepaṇam 
SA_MB_mahaaguhyakaaliividhaanamHK-408	phreṃ phaṭ svāhā || pādadyā tatrayaṃ phreṃ phaṭ saḥ svāhā ititāratrayaṃ phreṃ yaṃ raṃ vaṃ	phreṃ phaṭ svāhā ta trayam phreṃ phaṭ saḥ svāhā iti tāra trayam phreṃ yaṃ raṃ vaṃ 
SA_MB_mahaaguhyakaaliividhaanamHK-409	svāhā || iti prākāra trayaṃ || athabhūta śuddhiṃ || phreṃ yaṃ phreṃ iti śodhanaṃ || phreṃ raṃ	svāhā iti prākāra trayaṃ athabhūta śuddhim phreṃ yaṃ phreṃ iti śodhanam phreṃ raṃ 
SA_MB_mahaaguhyakaaliividhaanamHK-410	phreṃ iti dahanaṃ || phreṃ laṃ phraṃ bhasma plāvanaṃ || phreṃ vaṃ phreṃ ityamṛta plāvanaṃ ||	phreṃ iti dahanam phreṃ laṃ phraṃ bhasma plāvanam phreṃ vaṃ phreṃ iti amṛta plāvanam 
SA_MB_mahaaguhyakaaliividhaanamHK-411	phreṃ ṭaṃ phreṃ iti dṛḍhī karaṇaṃ || phreṃ ā sau haṃ svāhā ||	phreṃ ṭaṃ phreṃ iti dṛḍhī karaṇam phreṃ ā sau haṃ svāhā 
SA_MB_mahaaguhyakaaliividhaanamHK-412	iti divyaśarīra caintanaṃ ||	iti 
SA_MB_mahaaguhyakaaliividhaanamHK-413	vaddhāṃjaliḥ || bhūtaśuddhiḥ kṛtādevitebhyaḥ paramahaṃ paraḥ ||	vaddhāṃjaliḥ bhūtaśuddhiḥ kṛta ādevitebhyaḥ param aham paraḥ 
SA_MB_mahaaguhyakaaliividhaanamHK-414	śodhitaṃ phaladaṃ bhūyāt kālikā marcayāmyahaṃ ||	śodhitam phala dam bhūyāt kālikā marcayāmi aham 
SA_MB_mahaaguhyakaaliividhaanamHK-415	p. 29a) atha prāṇāyāmaḥ phreṃ cchraṃ phraṃ iti pūraṇaṃ ||	atha prāṇāyāmaḥ phreṃ cchraṃ phraṃ iti pūraṇam 
SA_MB_mahaaguhyakaaliividhaanamHK-416	mreṃ cchraṃ mreṃ iti kumbhakaḥ ||	mreṃ cchraṃ mreṃ iti kumbhakaḥ 
SA_MB_mahaaguhyakaaliividhaanamHK-417	khreṃ cchraṃ khreṃ iti recanaṃ ||	khreṃ cchraṃ khreṃ iti recanam 
SA_MB_mahaaguhyakaaliividhaanamHK-418	atha mūladevatāyā ṛṣyādi ṣaḍaṅgaṃ nyāsaḥ atha pītha pūjā ||	atha mūladevatāyāḥ ṛṣi ādi ṣaṣ aṅgam nyāsaḥ atha pītha pūjā 
SA_MB_mahaaguhyakaaliividhaanamHK-419	phreṃ ratikālikāyai svāhā ||	phreṃ ratikālikāyai svāhā 
SA_MB_mahaaguhyakaaliividhaanamHK-420	phreṃ prīti kālikāyai svāhā ||	phreṃ prīti kālikāyai svāhā 
SA_MB_mahaaguhyakaaliividhaanamHK-421	phreṃ kānti kālikāyai svāhā ||	phreṃ kānti kālikāyai svāhā 
SA_MB_mahaaguhyakaaliividhaanamHK-422	phreṃ śānti kālikāyai svāhā ||	phreṃ śānti kālikāyai svāhā 
SA_MB_mahaaguhyakaaliividhaanamHK-423	phreṃ puṣṭi kālikāyai svāhā ||	phreṃ puṣṭi kālikāyai svāhā 
SA_MB_mahaaguhyakaaliividhaanamHK-424	phreṃ tuṣṭikālikāyai svāhā ||	phreṃ tuṣṭikālikāyai svāhā 
SA_MB_mahaaguhyakaaliividhaanamHK-425	phreṃ lakṣmī kālikāyai svāhā ||	phreṃ lakṣmī kālikāyai svāhā 
SA_MB_mahaaguhyakaaliividhaanamHK-426	phreṃ sarasvatī kālikāyai svāhā ||	phreṃ sarasvatī kālikāyai svāhā 
SA_MB_mahaaguhyakaaliividhaanamHK-427	p. 29b) tuṃ hrīṃ strīṃ cchrīṃ hūṃ prakaṭatara guptagutara yoginī cakra sahita śrīmanmahā guhya	tum hrīṃ strīṃ cchrīṃ hūm prakaṭatara yoginī cakra sahita śrīmat mahā guhya 
SA_MB_mahaaguhyakaaliividhaanamHK-428	kālī kalālī cakra cāribhyaḥ hūṃ phaṭ namaḥ svāhā ||	kālī kalālī cakra cāribhyaḥ hūm phaṭ namaḥ svāhā 
SA_MB_mahaaguhyakaaliividhaanamHK-429	iti trayāṃjaliḥ || atha śrīpātra sthāpanaṃ ||	iti trayāṃjaliḥ atha śrīpātra sthāpanam 
SA_MB_mahaaguhyakaaliividhaanamHK-430	trikoṇa vṛtta caturasraṃ vilikhya ||	trikoṇa vṛtta caturasram vilikhya 
SA_MB_mahaaguhyakaaliividhaanamHK-431	hūṃ phaṭ svāhā ||	hūm phaṭ svāhā 
SA_MB_mahaaguhyakaaliividhaanamHK-432	iti pūjā || phreṃ svāhā pādikṣālanaṃ ||	iti pūjā phreṃ svāhā pādi kṣālanam 
SA_MB_mahaaguhyakaaliividhaanamHK-433	phreṃ namaḥ svāhā ||	phreṃ namaḥ svāhā 
SA_MB_mahaaguhyakaaliividhaanamHK-434	iti pūjanaṃ ||	iti pūjanam 
SA_MB_mahaaguhyakaaliividhaanamHK-435	phreṃ hrīṃ strīṃ cchrīṃ hūṃ aiṃ sau saṃ saḥ saṃ sauḥ aiṃ svāhā ||	phreṃ   strīṃ cchrīṃ   aim sau saṃ saḥ saṃ sauḥ aim svāhā 
SA_MB_mahaaguhyakaaliividhaanamHK-436	iti kuladravyābhi mantraṇāṃ ||	iti kula dravya abhi mantraṇām 
SA_MB_mahaaguhyakaaliividhaanamHK-437	phreṃ saṃ saḥ saṃ phreṃ svāhā pūraṇaṃ ||	phreṃ saṃ saḥ saṃ phreṃ svāhā pūraṇam 
SA_MB_mahaaguhyakaaliividhaanamHK-438	p. 30a) phreṃ nvalaṃ saḥ svāhā || pūjānaṃ ||	phreṃ nvalam saḥ svāhā 
SA_MB_mahaaguhyakaaliividhaanamHK-439	tatra trikoṇa ṣaṭkoṇa vṛtta caturasraṃ vilikhya ||	tatra trikoṇa ṣaṭkoṇa vṛtta caturasram vilikhya 
SA_MB_mahaaguhyakaaliividhaanamHK-440	madhye phre trikoṇe vindū trayaṃ ||	madhye phre trikoṇe vindū trayam 
SA_MB_mahaaguhyakaaliividhaanamHK-441	ṣaṭkoṇe ya raṃ laṃ vaṃ haṃ saṃ ||	ṣaṭkoṇe ya raṃ laṃ vaṃ haṃ saṃ 
SA_MB_mahaaguhyakaaliividhaanamHK-442	caturasre vaṃ saṃ ||	catur asre vaṃ sam 
SA_MB_mahaaguhyakaaliividhaanamHK-443	atha pūjanaṃ ||	atha pūjanam 
SA_MB_mahaaguhyakaaliividhaanamHK-444	5 śrīmanmahā guhyakālī karālī parāmṛta vāruṇyai hūṃ phaṭ namaḥ svāhā ||	śrīmat mahā guhyakālī karālī para amṛta vāruṇyai hūm phaṭ namaḥ svāhā 
SA_MB_mahaaguhyakaaliividhaanamHK-445	madhya || trikoṇe ||	madhya trikoṇe 
SA_MB_mahaaguhyakaaliividhaanamHK-446	phreṃ ratiśakti kālikāyai namaḥ svāhā |	phreṃ rati śakti kālikāyai namaḥ svāhā 
SA_MB_mahaaguhyakaaliividhaanamHK-447	phreṃ prīti śakti || phreṃ mvluṃ vāruṇī śakti ||	phreṃ prīti śakti phreṃ mvluṃ vāruṇī śakti 
SA_MB_mahaaguhyakaaliividhaanamHK-448	ṣaṭkoṇe phreṃ amṛtāyai namaḥ svāhā ||	ṣaṭkoṇe phreṃ amṛtāyai namaḥ svāhā 
SA_MB_mahaaguhyakaaliividhaanamHK-449	phreṃ amṛtodbhayai namaḥ svāhā ||	phreṃ amṛtodbhayai namaḥ svāhā 
SA_MB_mahaaguhyakaaliividhaanamHK-450	p. 30a) phreṃ amṛta varṣiṇyai namaḥ svāhā ||	phreṃ amṛta varṣiṇyai namaḥ svāhā 
SA_MB_mahaaguhyakaaliividhaanamHK-451	phreṃ amṛtā karṣiṇyai 4 ||	phreṃ amṛtā karṣiṇyai 
SA_MB_mahaaguhyakaaliividhaanamHK-452	phreṃ amṛtasrāvirāyai namaḥ svāhā ||	phreṃ amṛtasrāvirāyai namaḥ svāhā 
SA_MB_mahaaguhyakaaliividhaanamHK-453	phreṃ amṛtamālinyai 4 ||	phreṃ amṛtamālinyai 
SA_MB_mahaaguhyakaaliividhaanamHK-454	caturasre || phreṃ vāruṇyai 4 ||	catur asre phreṃ vāruṇyai 
SA_MB_mahaaguhyakaaliividhaanamHK-455	phreṃ ghūrṇāyai 4 ||	phreṃ ghūrṇāyai 
SA_MB_mahaaguhyakaaliividhaanamHK-456	phreṃ āmodārāyau ||	phreṃ āmodārāyau 
SA_MB_mahaaguhyakaaliividhaanamHK-457	phreṃ pramodirāyai 4 ||	phreṃ pramodirāyai 
SA_MB_mahaaguhyakaaliividhaanamHK-458	5 śrīmanmahāguhya kālī karālī parāmṛta śakti kālikāyai hūṃ phaṭ namaḥ svāhā ||	śrīmat mahā guhya kālī karālī para amṛta śakti kālikāyai hūm phaṭ namaḥ svāhā 
SA_MB_mahaaguhyakaaliividhaanamHK-459	iti divyāpa pūjā ||	iti divyāpa pūjā 
SA_MB_mahaaguhyakaaliividhaanamHK-460	phreṃ aiṃ sauḥ saṃ saḥ saḥ sau eparānandobhyantī kuru 2 namaḥ svāhā ||	phreṃ aim sauḥ saṃ saḥ saḥ sau kuru namaḥ svāhā 
SA_MB_mahaaguhyakaaliividhaanamHK-461	ityabhi mantraṇaṃ || phreṃ aiṃ phreṃ dhenū mudrā phreṃ mluṃ matsya mudrā ||	iti abhi mantraṇam phreṃ aim phreṃ dhenū mudrā phreṃ mluṃ matsya mudrā 
SA_MB_mahaaguhyakaaliividhaanamHK-462	p. 31a) mūla daśadhābhi mantrayet ||	mūla daśadhā abhi mantrayet 
SA_MB_mahaaguhyakaaliividhaanamHK-463	tadravyeṇa gāyatryā sakala vastu prokṣaṇaṃ || śirasi ||	tad dravyeṇa gāyatryā sakala vastu prokṣaṇam śirasi 
SA_MB_mahaaguhyakaaliividhaanamHK-464	phre mlauṃ paramaguruṃ tarpayāmi ||	phre mlaum parama gurum tarpayāmi 
SA_MB_mahaaguhyakaaliividhaanamHK-465	tridhā || phreṃ mhrauṃ guruśaktiutarpayāmi namaḥ svāhā ||	tridhā phreṃ mhrauṃ namaḥ svāhā 
SA_MB_mahaaguhyakaaliividhaanamHK-466	tridhā | tatoyantre ||	tridhā tatas yantre 
SA_MB_mahaaguhyakaaliividhaanamHK-467	phreṃ mulamantra śrīmanmahā guhyakālī karālīṃ tarpayāmi namaḥ svāhā ||	phreṃ mulamantra śrīmat mahā guhyakālī karālīm tarpayāmi namaḥ svāhā 
SA_MB_mahaaguhyakaaliividhaanamHK-468	tridhā || 5 svātmānaṃ tarpayāmi namaḥ svāhā iti tridhā ||	tridhā sva ātmānam tarpayāmi namaḥ svāhā iti tridhā 
SA_MB_mahaaguhyakaaliividhaanamHK-469	vaddhāṃjaliḥ ||	vaddha aṃjaliḥ 
SA_MB_mahaaguhyakaaliividhaanamHK-470	kūlāmṛta rasaṃdivyaṃ parānanda parigrahaṃ ||	rasam divyam para ānanda parigraham 
SA_MB_mahaaguhyakaaliividhaanamHK-471	tenānanda na saṃtuṣṭaḥ karāliṃ tarpayāmyahaṃ ||	tena ānanda na saṃtuṣṭaḥ karālim tarpayāmi aham 
SA_MB_mahaaguhyakaaliividhaanamHK-472	p. 31b) athāttaryāgaṃ ||	atha āttaryāgam 
SA_MB_mahaaguhyakaaliividhaanamHK-473	mūlādi vrahmaraṃdhāntaṃ jyotismaya mātmānaṃ dhyātvā yathā śakti mūlaṃ japtvā japaṃ	mūla ādi vrahmaraṃdha antam ātmānam dhyātvā yathāśakti mūlam japtvā japam 
SA_MB_mahaaguhyakaaliividhaanamHK-474	samarpa ||	samarpa 
SA_MB_mahaaguhyakaaliividhaanamHK-475	vaddhaṃjaliḥ ||	vaddhaṃjaliḥ 
SA_MB_mahaaguhyakaaliividhaanamHK-476	antarjyoti vihirjyoti vyāpaka jyoti reva ca || tritatva sahitaṃ jyoti sarvajyoti rahaṃ sadā ||	antar jyoti vihirjyoti vyāpaka jyoti reva ca tri tatva sahitam jyoti sarva jyotiḥ aham sadā 
SA_MB_mahaaguhyakaaliividhaanamHK-477	iti mahāvākyaṃ smaret ||	iti mahā vākyam smaret 
SA_MB_mahaaguhyakaaliividhaanamHK-478	athāvāhanaṃ || karakacchapikā vaddhā || mūlāhi vrahma raṇdhāntaṃ jyotirmayaṃ dhyātvā ||	atha āvāhanam karakacchapikā vaddhā mūla ahi vrahma jyotiḥ mayam dhyātvā 
SA_MB_mahaaguhyakaaliividhaanamHK-479	vahannāśā pūṭena phreṃ hrīṃ vaṃ svāhā ||	vahannāśā pūṭena phreṃ   vaṃ svāhā 
SA_MB_mahaaguhyakaaliividhaanamHK-480	iti yantrecchipet ||	iti yantrā id śipet 
SA_MB_mahaaguhyakaaliividhaanamHK-481	p. 32) tatva mudrāṃ vinyasya phreṃ hrīṃ strīṃ cchrīṃ hūṃ yaṃ raṃ laṃ vaṃ śaṃ ṣaṃ saṃ	mudrām vinyasya phreṃ   strīṃ cchrīṃ   yaṃ raṃ laṃ vaṃ śam ṣaṃ saṃ 
SA_MB_mahaaguhyakaaliividhaanamHK-482	śrī manmahā guhyakālī karālī devatāyā prāṇā ihaprāṇātryāṃ hrīṃ kro yaṃ raṃ laṃ vaṃ	śrī mad mahā guhyakālī karālī devatāyāḥ prāṇāḥ ihaprāṇātryām hrīṃ   yaṃ raṃ laṃ vaṃ 
SA_MB_mahaaguhyakaaliividhaanamHK-483	śaṃ ṣaṃ saṃ śrīmanmahā guhyakālī karālī devatāyā jīva iha sthita tryāṃ hrīṃ kroṃ yaṃ	śam ṣaṃ saṃ śrīmat mahā guhyakālī karālī devatāyāḥ jīvaḥ iha sthita tryāṃ hrīṃ kroṃ yaṃ 
SA_MB_mahaaguhyakaaliividhaanamHK-484	raṃ laṃ vaṃ śaṃ ṣaṃ saṃ śrīmanmahā guhyakālī karālī devatāyāḥ sarvendriyāni	raṃ laṃ vaṃ śam ṣaṃ saṃ śrīmat mahā guhyakālī karālī devatāyāḥ sarva indriyāni 
SA_MB_mahaaguhyakaaliividhaanamHK-485	vāgmanaścakṣuḥ śrota ghrāṇa prāṇā ihāgatya sūkhaṃtiraṃ taṣṭhantu svāhā || 5	vāgmanaḥ cakṣuḥ śrota ghrāṇa prāṇāḥ iha āgatya sūkhaṃtiram taṣṭhantu svāhā 
SA_MB_mahaaguhyakaaliividhaanamHK-486	śrīmahāguhya kālī karālī ihāgacchehā	śrī mahā guhya kālī karālī iha āgaccha iha 
SA_MB_mahaaguhyakaaliividhaanamHK-487	MUKTABODHA INDOLOGICAL RESEARCH INSTITUTE©2011 Muktabodha Indological Research Institute  All Rights Reserved.E-texts may be viewed only online or downloaded for private study.E-texts may not, under any circumstances, be copied, republished,reproduced, distributed or sold, either in original or altered form, withoutthe express permission of Muktabodha Indological Research Institute in writing.Data-entered by the staff of Muktabodha under the direction of Mark S. G. Dyczkowski.	muktabodha indological research muktabodha indological research institute all rights reserved texts may be viewed only online or downloaded for private studye texts may not under any circumstances be copied republished reproduced distributed or sold either in original or altered form withoutthe express permission of muktabodha indological research institute in writing data entered by the staff of muktabodha under the direction of mark s g dyczkowski 
