segmentnr	original	analyzed
SA_MB_saandilyopanisatHK-0	Muktabodha E-text in UTF-8	muktabodha etext in utf
SA_MB_saandilyopanisatHK-1	###########################################################################MUKTABODHA INDOLOGICAL RESEARCH INSTITUTEwww.muktabodha.org©2011 Muktabodha Indological Research Institute  All Rights Reserved.E-texts may be viewed only online or downloaded for private study.E-texts may not, under any circumstances, be copied, republished,reproduced, distributed or sold, either in original or altered form, withoutthe express permission of Muktabodha Indological Research Institute in writing.Data-entered by the staff of Muktabodha under the direction of Mark S. G. Dyczkowski.Catalog number : M00113	muktabodha indological research muktabodha indological research institute all rights reserved texts may be viewed only online or downloaded for private studye texts may not under any circumstances be copied republished reproduced distributed or sold either in original or altered form withoutthe express permission of muktabodha indological research institute in writing data entered by the staff of muktabodha under the direction of mark s g dyczkowskicatalog number  /
SA_MB_saandilyopanisatHK-2	Uniform title: śāṇḍilyopaniṣat	uniform title śāṇḍilyopaniṣad 
SA_MB_saandilyopanisatHK-3	Main title: yoga upaniṣads with the commentary of śrī upaniṣad brahmayogin	main title yoga upaniṣads with the commentary of śrī upaniṣad brahmayogin 
SA_MB_saandilyopanisatHK-4	Secondary title: śāṇḍilya upaniṣat	secondary title śāṇḍilya upaniṣad 
SA_MB_saandilyopanisatHK-5	Commentator : brahmayogin	commentatoḥ brahmayogin 
SA_MB_saandilyopanisatHK-6	Alternate name : śrī upaniṣad brahmayogin	alternate name śrī upaniṣad brahmayogin 
SA_MB_saandilyopanisatHK-7	Editor : śāstrī mahādeva	e t itoḥ śāstrī mahādeva 
SA_MB_saandilyopanisatHK-8	Notes: Transcribed by the staff of Muktabodha under the supervision of Mark S. G. Dyczkowski.	notes transcribed by the staff muktabodha under the supervision of mark s g dyczkowski 
SA_MB_saandilyopanisatHK-9	Revision 0: January 28, 2007	revision january 
SA_MB_saandilyopanisatHK-10	Publisher : Adyar library and research centre	publisher adyar library and research centre 
SA_MB_saandilyopanisatHK-11	Publication year : 1920	publication year 
SA_MB_saandilyopanisatHK-12	Publication city : Madras	publication citi madras 
SA_MB_saandilyopanisatHK-13	Publication country : India	publication country india 
SA_MB_saandilyopanisatHK-14	śāṇḍilyopaniṣat	śāṇḍilya upaniṣad 
SA_MB_saandilyopanisatHK-15	bhadraṃ karṇebhiḥ- iti śāntiḥ	bhadram karṇebhiḥ iti śāntiḥ 
SA_MB_saandilyopanisatHK-16	prathamo'dhyāyaḥ	prathamaḥ udhyāyaḥ 
SA_MB_saandilyopanisatHK-17	yogāṣṭāṅganirdeśaḥ	        
SA_MB_saandilyopanisatHK-18	śāṇḍilyo ha vā atharvāṇaṃ	śāṇḍilyaḥ ha vai atharvāṇam 
SA_MB_saandilyopanisatHK-19	papracchātmalābhopāyabhūtamaṣṭāṅgayogamanubrūhīti || 1 || sa	papraccha ātma lābha upāya bhūtam aṣṭāṅga yogam anubrūhi iti sa 
SA_MB_saandilyopanisatHK-20	hovācātharvā- yamaniyamāsanaprāṇāyāmapratyāhāradhāraṇā-	ha uvāca atharvā yama niyama āsana prāṇāyāma pratyāhāra dhāraṇā 
SA_MB_saandilyopanisatHK-21	dhyānasamādhayo'ṣṭāṅgāni || 2 || tatra daśa yamāḥ | tathā niyamāḥ |	dhyāna samādhayaḥ uṣṭāṅgāni    tatra daśa yamāḥ tathā niyamāḥ 
SA_MB_saandilyopanisatHK-22	āsanānyaṣṭau | triḥ prāṇāyāmaḥ | pañca pratyāhārāḥ | tathā	āsanāni aṣṭau tris prāṇāyāmaḥ pañca pratyāhārāḥ tathā 
SA_MB_saandilyopanisatHK-23	dhāraṇāḥ | dviprakāraṃ dhyānam | samādhistvekarūpaḥ || 3 ||	dhāraṇāḥ dvi prakāram dhyānam samādhiḥ tu eka rūpaḥ 
SA_MB_saandilyopanisatHK-24	śāṇḍilyopaniṣatproktayamādyaṣṭāṅgayoginaḥ |	śāṇḍilya upaniṣad prokta yama ādi aṣṭa aṅga yoginaḥ 
SA_MB_saandilyopanisatHK-25	yadbodhādyānti kaivalyaṃ sa rāmo me parā gatiḥ ||	yad bodhāt yānti kaivalyam sa rāmaḥ me parā gatiḥ 
SA_MB_saandilyopanisatHK-26	iha khalu atharvaṇavedapravibhakteyaṃ śāṇḍilyopaniṣat	iha khalu atharvaṇa veda pravibhaktā iyam śāṇḍilya upaniṣad 
SA_MB_saandilyopanisatHK-27	yamādyaṣṭāṅgayogatadgauṇamukhyasiddhiprakāśanavyagrā	                                   
SA_MB_saandilyopanisatHK-28	niṣpratiyogikabrahmamātraparyavasannā vijṛmbhate | asyāḥ	niṣpratiyogika brahma mātra paryavasannā vijṛmbhate asyāḥ 
SA_MB_saandilyopanisatHK-29	p. 519) svalpagranthato vivaraṇamārabhyate |	su alpa granthataḥ vivaraṇam ārabhyate 
SA_MB_saandilyopanisatHK-30	śāṇḍilyātharvapraśnaprativacanarūpeyamākhyāyikā vidyāstutyarthā |	śāṇḍilya atharva praśna prativacana rūpā iyam ākhyāyikā vidyā stuti arthā 
SA_MB_saandilyopanisatHK-31	ākhyāyikāmavatārayati- śāṇḍilya iti | kimiti ? ātmeti || 1 || evaṃ	ākhyāyikām avatārayati śāṇḍilyaḥ iti kim iti ātmā iti     evam 
SA_MB_saandilyopanisatHK-32	śāṇḍilyena pṛṣṭaḥ sa hovāca | kiṃ tat ? yogo'ṣṭāṅga ucyate- yameti || 2-	śāṇḍilyena pṛṣṭaḥ sa ha uvāca kim tat yogaḥ ṣṭāṅgaḥ ucyate yama iti 
SA_MB_saandilyopanisatHK-33	daśavidhayamanirūpaṇam	daśavidha yama nirūpaṇam 
SA_MB_saandilyopanisatHK-34	tatrāhiṃsāsatyāsteyabrahmacaryadayārjavakṣamādhṛtimitāhāra-	tatra ahiṃsā satya asteya brahmacarya dayā ārjava kṣamā dhṛti mita āhāra 
SA_MB_saandilyopanisatHK-35	śaucāni ceti yamā daśa || 4 || tatrāhiṃsā nāma manovākkāyakarmabhiḥ	śaucāni ca iti yamāḥ daśa    tatra ahiṃsā nāma manaḥ vāc kāya karmabhiḥ 
SA_MB_saandilyopanisatHK-36	sarvabhūteṣu sarvadākleśajananam || 5 || satyaṃ nāma	sarva bhūteṣu sarvadā kleśa jananam satyam nāma 
SA_MB_saandilyopanisatHK-37	manovākkāyakarmabhirbhūtahitayathārthābhibhāṣaṇam || 6 || asteyaṃ	manaḥ vāc kāya karmabhiḥ bhūta hita yathārtha abhibhāṣaṇam asteyam 
SA_MB_saandilyopanisatHK-38	nāma manovākkāyakarmabhiḥ paradravyeṣu niḥspṛhā || 7 || brahmacaryaṃ	nāma manaḥ vāc kāya karmabhiḥ para dravyeṣu niḥspṛhā brahmacaryam 
SA_MB_saandilyopanisatHK-39	nāma sarvāvasthāsu manovākkāyakarmabhiḥ sarvatra maithunatyāgaḥ || 8	nāma sarva avasthāsu manaḥ vāc kāya karmabhiḥ sarvatra maithuna tyāgaḥ 
SA_MB_saandilyopanisatHK-40	|| dayā nāma sarvabhūteṣu sarvatrānugrahaḥ || 9 || ārjavaṃ nāma	dayā nāma sarva bhūteṣu sarvatra anugrahaḥ     ārjavam nāma 
SA_MB_saandilyopanisatHK-41	manovākkāyakarmaṇāṃ vihitāvihiteṣu janeṣu pravṛttau nivṛttau vā	manaḥ vāc kāya karmaṇām vihita a vihiteṣu janeṣu pravṛttau nivṛttau vā 
SA_MB_saandilyopanisatHK-42	ekarūpatvam || 10 || kṣamā nāma priyāpriyeṣu sarveṣu tāḍanapūjaneṣu	eka rūpa tvam kṣamā nāma priya apriyeṣu sarveṣu tāḍana pūjaneṣu 
SA_MB_saandilyopanisatHK-43	sahanam || 11 || ghṛtirnāmārthahānau sveṣṭabandhuyoge tatprāptau sarvatra	sahanam 
SA_MB_saandilyopanisatHK-44	cetaḥsthāpanam || 12 || mitāhāro nāma	cetaḥsthāpanam mitāhāraḥ nāma 
SA_MB_saandilyopanisatHK-45	caturthāṃśāvaśeṣakasusnigdhamadhurāhāraḥ || 13 || śaucaṃ nāma	caturtha aṃśa avaśeṣaka su snigdha madhura āhāraḥ         
SA_MB_saandilyopanisatHK-46	dvividhaṃ bāhyamāntaraṃ ceti | tatra mṛjjalābhyāṃ bāhyam |	dvividham bāhyam āntaram ca iti tatra mṛd jalābhyām bāhyam 
SA_MB_saandilyopanisatHK-47	manaḥśuddhirāntaram | tadadhyātmavidyayā labhyam || 14 ||	manaḥ śuddhiḥ āntaram tat adhyātma vidyayā labhyam  /
SA_MB_saandilyopanisatHK-48	iti prathamaḥ khaṇḍaḥ	iti prathamaḥ khaṇḍaḥ 
SA_MB_saandilyopanisatHK-49	daśavidhaniyamanirūpaṇam	        
SA_MB_saandilyopanisatHK-50	tapaḥsaṃtoṣāstikyadāneśvarapūjanasiddhāntaśravaṇahrīmatijapa-	                                                                               
SA_MB_saandilyopanisatHK-51	vratāni daśa niyamāḥ || 1 || tatra tapo nāma	vratāni daśa niyamāḥ    tatra tapaḥ nāma 
SA_MB_saandilyopanisatHK-52	vidhyuktakṛcchracāndrāyaṇādibhiḥ śarīraśoṣaṇam || 2 || saṃtoṣo nāma	vidhi ukta kṛcchra cāndrāyaṇa ādibhiḥ śarīra śoṣaṇam saṃtoṣaḥ nāma 
SA_MB_saandilyopanisatHK-53	yadṛcchālābhatuṣṭiḥ || 3 || āstikyaṃ nāma vedoktadharmādharmeṣu	yadṛcchā lābha tuṣṭiḥ āstikyam nāma veda ukta dharma adharmeṣu 
SA_MB_saandilyopanisatHK-54	viśvāsaḥ || 4 || dānaṃ nāma nyāyārjitadhanadhānyādeḥ	viśvāsaḥ dānam nāma nyāya arjita dhana dhānya ādeḥ 
SA_MB_saandilyopanisatHK-55	śraddhayārthibhyaḥ pradānam || 5 || īśvarapūjanaṃ nāma	śraddhayā arthibhyaḥ pradānam īśvarapūjanam nāma 
SA_MB_saandilyopanisatHK-56	prasannasvabhāvena yathāśakti viṣṇurudrādipūjanam || 6 ||	prasanna svabhāvena yathāśakti viṣṇu rudra ādi pūjanam 
SA_MB_saandilyopanisatHK-57	siddhāntaśravaṇaṃ nāma vedāntārthavicāraḥ || 7 || hrīrnāma	siddhānta śravaṇam nāma vedānta artha vicāraḥ       nāma 
SA_MB_saandilyopanisatHK-58	vedalaukikamārgakutsitakarmaṇi lajjā || 8 || matirnāma	veda laukika mārga kutsita karmaṇi lajjā matiḥ nāma 
SA_MB_saandilyopanisatHK-59	vedavihitakarmamārgeṣu śraddhā || 9 || japo nāma	veda vihita karma mārgeṣu śraddhā japaḥ nāma 
SA_MB_saandilyopanisatHK-60	vidhivadgurūpadiṣṭavedāviruddhamantrābhyāsaḥ | taddvividhaṃ vācikaṃ	vidhivat guru upadiṣṭa veda aviruddha mantra abhyāsaḥ tat dvividham vācikam 
SA_MB_saandilyopanisatHK-61	mānasaṃ ceti | mānasaṃ tu manasā dhyānayuktam | vācikaṃ	mānasam ca iti mānasam tu manasā dhyāna yuktam vācikam 
SA_MB_saandilyopanisatHK-62	dvividhamuccairupāṃśubhedena | uccairuccāraṇaṃ yathoktaphalam |	dvividham uccais upāṃśu bhedena uccais uccāraṇam yathā ukta phalam 
SA_MB_saandilyopanisatHK-63	upāṃśu sahasraguṇam | mānasaṃ koṭiguṇam || 10 || vrataṃ nāma	upāṃśu sahasraguṇam mānasam koṭiguṇam      vratam nāma 
SA_MB_saandilyopanisatHK-64	vedoktavidhiniṣedhānuṣṭhānanaiyatyam || 11 ||	veda ukta vidhi niṣedha anuṣṭhāna naiyatyam 
SA_MB_saandilyopanisatHK-65	daśadhā bhinnayamasvarūpamuktvā tathā niyamasvarūpamāha-	daśadhā bhinna yama svarūpam uktvā tathā niyama svarūpam āha 
SA_MB_saandilyopanisatHK-66	tapa iti || 1-9 || mantrārthānusaṃdhānaṃ mānasamityarthaḥ || 10-11 ||	tapaḥ iti mantra artha anusaṃdhānam mānasam iti arthaḥ 
SA_MB_saandilyopanisatHK-67	iti dvitīyaḥ khaṇḍaḥ	iti dvitīyaḥ khaṇḍaḥ 
SA_MB_saandilyopanisatHK-68	aṣṭavidhāsananirūpaṇam	aṣṭavidha āsana nirūpaṇam 
SA_MB_saandilyopanisatHK-69	svastikagomukhapadmavīrasiṃhabhadramuktamayūrākhyānyāsanā-	svastika gomukha padma vīrasiṃha bhadra mukta mayūra ākhyā anya āsanā 
SA_MB_saandilyopanisatHK-70	nyaṣṭau |	nyaṣṭau 
SA_MB_saandilyopanisatHK-71	svastikaṃ nāma-	svastikam nāma 
SA_MB_saandilyopanisatHK-72	jānūrvorantare samyakkṛtvā pādatale ubhe |	jānu ūrvoḥ antare samyak kṛtvā pāda tale ubhe 
SA_MB_saandilyopanisatHK-73	ṛjukāyaḥ samāsīnaḥ svastikaṃ tatpracakṣate || 1 ||	ṛju kāyaḥ samāsīnaḥ svastikam tat pracakṣate 
SA_MB_saandilyopanisatHK-74	savye dakṣiṇagulphaṃ tu pṛṣṭhapārśve niyojayet |	savye dakṣiṇa gulpham tu pṛṣṭha pārśve niyojayet 
SA_MB_saandilyopanisatHK-75	dakṣiṇe'pi tathā savyaṃ gomukhaṃ gomukhaṃ yathā || 2 ||	dakṣiṇe api tathā savyam gomukham gomukham yathā 
SA_MB_saandilyopanisatHK-76	aṅguṣṭhena nibadhnīyāddhastābhyāṃ vyutkrameṇa ca |	aṅguṣṭhena nibadhnīyāt hastābhyām vyutkrameṇa ca 
SA_MB_saandilyopanisatHK-77	ūrvorupari śāṇḍilya kṛtvā pādatale ubhe |	ūrvoḥ upari śāṇḍilya kṛtvā pāda tale ubhe 
SA_MB_saandilyopanisatHK-78	padmāsanaṃ bhavedetat sarveṣāmapi pūjitam || 3 ||	padmāsanam bhavet etat sarveṣām api pūjitam 
SA_MB_saandilyopanisatHK-79	ekaṃ pādamathaikasmin vinyasyoruṇi saṃsthitaḥ |	ekam pādam atha ekasmin vinyasya ūruṇi saṃsthitaḥ 
SA_MB_saandilyopanisatHK-80	itarasmiṃstathā coruṃ vīrāsanamudīritam || 4 ||	itarasmin tathā ca ūrum vīrāsanam udīritam 
SA_MB_saandilyopanisatHK-81	dakṣiṇaṃ savyagulphena dakṣiṇena tathetaram |	dakṣiṇam savya gulphena dakṣiṇena tathā itaram 
SA_MB_saandilyopanisatHK-82	hastau ca jānvoḥ saṃsthāpya svāṅgulīśca prasārya ca || 5 ||	hastau ca jānvoḥ saṃsthāpya sva aṅgulīḥ ca prasārya ca 
SA_MB_saandilyopanisatHK-83	vyāttavaktro nirīkṣeta nāsāgraṃ susamāhitaḥ |	vyātta vaktraḥ nirīkṣeta nāsā agram su samāhitaḥ 
SA_MB_saandilyopanisatHK-84	siṃhāsanaṃ bhavedetat pūjitaṃ yogibhiḥ sadā || 6 ||	siṃhāsanam bhavet etat pūjitam yogibhiḥ sadā 
SA_MB_saandilyopanisatHK-85	yoniṃ vāmena saṃpīḍya meḍhrādupari dakṣiṇam |	yonim vāmena saṃpīḍya meḍhrāt upari dakṣiṇam 
SA_MB_saandilyopanisatHK-86	bhrūmadhye ca manolakṣyaṃ siddhāsanamidaṃ bhavet || 7 ||	bhrū madhye ca manaḥ lakṣyam siddhāsanam idam bhavet 
SA_MB_saandilyopanisatHK-87	gulphau tu vṛṣaṇasyādhaḥ sīvanyāḥ pārśvayoḥ kṣipet |	gulphau tu vṛṣaṇasya adhas sīvanyāḥ pārśvayoḥ kṣipet 
SA_MB_saandilyopanisatHK-88	pādapārśve tu pāṇibhyāṃ dṛḍhaṃ baddhvā suniścalam |	pāda pārśve tu pāṇibhyām dṛḍham baddhvā su niścalam 
SA_MB_saandilyopanisatHK-89	bhadrāsanaṃ bhavedetat sarvavyādhiviṣāpaham || 8 ||	bhadrāsanam bhavet etat sarva vyādhi viṣa apaham 
SA_MB_saandilyopanisatHK-90	p. 522) saṃpīḍya sīvinīṃ sūkṣmāṃ gulphenaiva tu savyataḥ |	saṃpīḍya sīvinīm sūkṣmām gulphena eva tu savyatas 
SA_MB_saandilyopanisatHK-91	savyaṃ dakṣiṇagulphena muktāsanamidaṃ bhavet || 9 ||	savyam dakṣiṇa gulphena muktāsanam idam bhavet 
SA_MB_saandilyopanisatHK-92	avaṣṭabhya dharāṃ samyak talābhyāṃ tu karadvayoḥ |	avaṣṭabhya dharām samyak talābhyām tu kara dvayoḥ 
SA_MB_saandilyopanisatHK-93	hastayoḥ kūrparau cāpi sthāpayennābhipārśvayoḥ || 10 ||	hastayoḥ kūrparau ca api sthāpayet nābhi pārśvayoḥ 
SA_MB_saandilyopanisatHK-94	samunnataśiraḥpādo daṇḍavadvyomni saṃsthitaḥ |	samunnata śiraḥ pādaḥ daṇḍa vat vyomni saṃsthitaḥ 
SA_MB_saandilyopanisatHK-95	mayūrāsanametattu sarvapāpapraṇāśanam || 11 ||	mayūrāsanam etat tu sarva pāpa praṇāśanam 
SA_MB_saandilyopanisatHK-96	śarīrāntargatāḥ sarvarogā vinaśyanti | viṣāṇi jīryante || 12 || yena	śarīra antargatāḥ sarva rogāḥ vinaśyanti viṣāṇi jīryante     yena 
SA_MB_saandilyopanisatHK-97	kenāsanena sukhadhāraṇaṃ bhavatyaśaktastatsamācaret || 13 ||	kena āsanena sukha dhāraṇam bhavati aśaktaḥ tat samācaret 
SA_MB_saandilyopanisatHK-98	svastikādyaṣṭāsanaprakāramāha- svastiketi || 1 ||	svastika ādi aṣṭa āsana prakāram āha svastika iti 
SA_MB_saandilyopanisatHK-99	gomukhāsanamāha- savya iti || 2 || padmāsanamācaṣṭe- aṅguṣṭheneti || 3 ||	gomukhāsanam āha savye iti   padmāsanam ācaṣṭe aṅguṣṭhena iti 
SA_MB_saandilyopanisatHK-100	vīrāsanalakṣaṇamāha- ekamiti || 4 || siṃhāsanaprakāramāha- dakṣiṇamiti	vīrāsana lakṣaṇam āha ekam iti    siṃhāsana prakāram āha dakṣiṇam iti 
SA_MB_saandilyopanisatHK-101	|| 5-6 || siddhāsanasvarūpamāha- yonimiti || 7 || bhadrāsanamāha- gulphāviti	                 
SA_MB_saandilyopanisatHK-102	|| 8 || muktāsanaprakāramāha- saṃpīḍyeti || 9 || mayūrāsanamāha-	              āha 
SA_MB_saandilyopanisatHK-103	avaṣṭabhyeti || 10-13 ||	avaṣṭabhyeti 
SA_MB_saandilyopanisatHK-104	āsanajayaphalam	āsana jaya phalam 
SA_MB_saandilyopanisatHK-105	yenāsanaṃ vijitaṃ jagattrayaṃ tena vijitaṃ bhavati || 14 ||	yena āsanam vijitam jagattrayam tena vijitam bhavati 
SA_MB_saandilyopanisatHK-106	yamaniyamāsanābhyāsayuktaḥ puruṣaḥ prāṇāyāmaṃ caret | tena	                                                           
SA_MB_saandilyopanisatHK-107	nāḍayaḥ śuddhā bhavanti || 15 ||	nāḍayaḥ śuddhāḥ bhavanti 
SA_MB_saandilyopanisatHK-108	āsanajayaphalamāha- yeneti || 14 || tataḥ kimityata āha- yameti || 15 ||	āsana jaya phalam āha yena iti   tatas kim iti atas āha yama iti   
SA_MB_saandilyopanisatHK-109	iti tṛtīyaḥ khaṇḍaḥ	iti tṛtīyaḥ khaṇḍaḥ 
SA_MB_saandilyopanisatHK-110	nāḍīsaṃkhyādijijñāsā	nāḍī saṃkhyā ādi jijñāsā 
SA_MB_saandilyopanisatHK-111	atha hainamatharvāṇaṃ śāṇḍilyaḥ papraccha kenopāyena nāḍayaḥ	atha ha enam atharvāṇam śāṇḍilyaḥ papraccha kena upāyena nāḍayaḥ 
SA_MB_saandilyopanisatHK-112	śuddhāḥ syuḥ | nāḍayaḥ katisaṃkhyākāḥ tāsāmutpattiḥ kīdṛśī | tāsu	śuddhāḥ syuḥ nāḍayaḥ kati saṃkhyākāḥ tāsām utpattiḥ kīdṛśī tāsu 
SA_MB_saandilyopanisatHK-113	kati vāyavastiṣṭhanti | teṣāṃ kāni sthānāni | tatkarmāṇi kāni | dehe yāni	kati vāyavaḥ tiṣṭhanti teṣām kāni sthānāni tad karmāṇi kāni dehe yāni 
SA_MB_saandilyopanisatHK-114	yāni vijñātavyāni tatsarvaṃ me brūhīti || 1 ||	yāni vijñātavyāni tat sarvam me brūhi iti 
SA_MB_saandilyopanisatHK-115	śāṇḍilyaḥ praśnabījamavaṣṭabhyātharvāṇaṃ pṛcchatītyāha-	śāṇḍilyaḥ praśna bījam avaṣṭabhya atharvāṇam pṛcchati iti āha 
SA_MB_saandilyopanisatHK-116	atheti || 1 ||	atha iti 
SA_MB_saandilyopanisatHK-117	śarīraprāṇapramāṇam	śarīra prāṇa pramāṇam 
SA_MB_saandilyopanisatHK-118	sa hovācātharvā | athedaṃ śarīraṃ ṣaṇṇavatyaṅgulātmakaṃ	sa ha uvāca atharvā atha idam śarīram ṣaṇṇavati aṅgula ātmakam 
SA_MB_saandilyopanisatHK-119	bhavati | śarīrāt prāṇo dvādaśāṅgulādhiko bhavati || 2 ||	bhavati śarīrāt prāṇaḥ dvādaśa aṅgula adhikaḥ bhavati  /
SA_MB_saandilyopanisatHK-120	śāṇḍilyena evaṃ pṛṣṭaḥ saḥ | svasvāṅgulimānena ṣaṇṇavatīti || 2 ||	śāṇḍilyena evam pṛṣṭaḥ saḥ sva sva aṅguli mānena ṣaṇṇavati iti 
SA_MB_saandilyopanisatHK-121	kumbhakavidhiḥ	         
SA_MB_saandilyopanisatHK-122	śarīrasthaṃ prāṇamagninā saha yogābhyāsena samaṃ nyūnaṃ	śarīra stham prāṇam agninā saha yoga abhyāsena samam nyūnam 
SA_MB_saandilyopanisatHK-123	vā yaḥ karoti sa yogipuṅgavo bhavati || 3 ||	vā yaḥ karoti sa yogi puṅgavaḥ bhavati 
SA_MB_saandilyopanisatHK-124	samanyūnaśabdābhyāṃ kumbhakadīrghakumbhakāvucyete ityarthaḥ || 3 ||	sama nyūna śabdābhyām kumbhaka dīrghakumbhakau ucyete iti arthaḥ 
SA_MB_saandilyopanisatHK-125	manuṣyādīnāmagnisthānam	manuṣya ādīnām agni sthānam 
SA_MB_saandilyopanisatHK-126	dehamadhye śikhisthānaṃ trikoṇaṃ taptajāmbūnadaprabhaṃ	deha madhye śikhi sthānam trikoṇam tapta jāmbūnada prabham 
SA_MB_saandilyopanisatHK-127	manuṣyāṇām | catuṣpadāṃ caturaśram | vihagānāṃ vṛttākāram |	manuṣyāṇām catuṣpadām caturaśram vihagānām vṛtta ākāram 
SA_MB_saandilyopanisatHK-128	tanmadhye śubhā tanvī pāvakī śikhā tiṣṭhati || 4 ||	tad madhye śubhā tanvī pāvakī śikhā tiṣṭhati 
SA_MB_saandilyopanisatHK-129	p. 524) manuṣyādīnāmagnisthānamāha- deheti || 4 ||	manuṣya ādīnām agni sthānam āha deha iti 
SA_MB_saandilyopanisatHK-130	manuṣyādidehamadhyalakṣaṇam	manuṣya ādi deha madhya lakṣaṇam 
SA_MB_saandilyopanisatHK-131	guhād dvyaṅgulādūrdhvaṃ meḍhrād dvyaṅgulādadho	guhāt dvi aṅgulāt ūrdhvam meḍhrāt dvi aṅgulāt adhas 
SA_MB_saandilyopanisatHK-132	dehamadhyaṃ manuṣyāṇāṃ bhavati | catuṣpadāṃ hṛnmadhyam |	deha madhyam manuṣyāṇām bhavati catuṣpadām hṛd madhyam 
SA_MB_saandilyopanisatHK-133	vihagānāṃ tundamadhyam | dehamadhyaṃ navāṅgulaṃ	vihagānām tunda madhyam deha madhyam nava aṅgulam 
SA_MB_saandilyopanisatHK-134	caturaṅgulamutsedhāyatamaṇḍākṛti || 5 ||	catur aṅgulam utsedha āyatam aṇḍa ākṛti 
SA_MB_saandilyopanisatHK-135	manuṣyādidehamadhyalakṣaṇamāha- gudāditi || 5-7 ||	manuṣya ādi deha madhya lakṣaṇam āha gudāt iti 
SA_MB_saandilyopanisatHK-136	nābhicakre jīvabhramaṇam	        
SA_MB_saandilyopanisatHK-137	tanmadhye nābhiḥ | tatra dvādaśārayutaṃ cakram | taccakramadhye	tad madhye nābhiḥ tatra dvādaśa ara yutam cakram tad cakra madhye 
SA_MB_saandilyopanisatHK-138	puṇyapāpapracoditā jīvo bhramati || 6 || tantupañjaramadhyasthaḷtikā	puṇya pāpa pracoditā jīvaḥ bhramati 
SA_MB_saandilyopanisatHK-139	yathā bhramati tathā cāsau tatra prāṇaścarati | dehe'smin jīvaḥ	yathā bhramati tathā ca asau tatra prāṇaḥ carati dehe ismin jīvaḥ 
SA_MB_saandilyopanisatHK-140	prāṇārūḍho bhavet || 7 ||	prāṇa ārūḍhaḥ bhavet 
SA_MB_saandilyopanisatHK-141	kuṇḍalinīsvarūpaceṣṭāḥ	           
SA_MB_saandilyopanisatHK-142	nābhestiryagadhordhvaṃ kuṇḍalinīsthānam |	nābheḥ tiryak adhordhvam kuṇḍalinī sthānam 
SA_MB_saandilyopanisatHK-143	aṣṭaprakṛtirūpāṣṭadhā kuṇḍalīkṛtā kuṇḍalinī śaktirbhavati |	aṣṭa prakṛti rūpā aṣṭadhā kuṇḍalīkṛtā kuṇḍalinī śaktiḥ bhavati 
SA_MB_saandilyopanisatHK-144	yathāvadvāyusaṃcāraṃ jalānnādīni paritaḥ skandhapārśveṣu	yathāvat vāyu saṃcāram jala anna ādīni paritas skandha pārśveṣu 
SA_MB_saandilyopanisatHK-145	nirudhyainaṃ mukhenaiṣa samāveṣṭya brahmarandhraṃ	nirudhya enam mukhena eṣa samāveṣṭya brahmarandhram 
SA_MB_saandilyopanisatHK-146	yogakāle'pānenāgninā ca sphurati hṛdayākāśaṃ mahojjvalā	yoga kāle pānena agninā ca sphurati hṛdaya ākāśam mahā ujjvalā 
SA_MB_saandilyopanisatHK-147	jñānarūpā bhavati || 8 ||	jñāna rūpā bhavati 
SA_MB_saandilyopanisatHK-148	tatsvarūpaṃ tacceṣṭāṃ cāha- aṣṭeti | brahmarandhraṃ pucchena ca || 8 ||	tad svarūpam tad ceṣṭām ca āha aṣṭa iti brahmarandhram pucchena ca 
SA_MB_saandilyopanisatHK-149	"p. 525) 			caturdaśanāḍhyaḥ"	caturdaśa nā āḍhyaḥ 
SA_MB_saandilyopanisatHK-150	madhyasthakuṇḍalinīmāśritya mukhyā nāḍyaścaturdaśa bhavanti |	madhyastha kuṇḍalinīm āśritya mukhyāḥ nāḍyaḥ caturdaśa bhavanti 
SA_MB_saandilyopanisatHK-151	iḍā piṅgalā suṣumnā sarasvatī vāruṇā pūṣā hastijihvā yaśasvinī	iḍā piṅgalā suṣumnā sarasvatī vāruṇā pūṣā hastijihvā yaśasvinī 
SA_MB_saandilyopanisatHK-152	viśvodarā kuhūḥ śaṅkhinī payasvinī alambusā gāndhārīti	viśva udarā kuhūḥ śaṅkhinī payasvinī alambusā gāndhārī iti 
SA_MB_saandilyopanisatHK-153	nāḍyaścaturdaśa bhavanti || 9 ||	nāḍyaḥ caturdaśa bhavanti 
SA_MB_saandilyopanisatHK-154	dehamadhyastheti | kāstā ityatra iḍeti || 9 ||	deha madhya sthā iti kāḥ tāḥ iti atra iḍā iti 
SA_MB_saandilyopanisatHK-155	suṣumnānāḍī	suṣumnā nāḍī 
SA_MB_saandilyopanisatHK-156	tatra suṣumnā viśvadhāriṇī mokṣamārgeti cācakṣate | gudasya	tatra suṣumnā viśva dhāriṇī mokṣa mārgā iti ca ācakṣate gudasya 
SA_MB_saandilyopanisatHK-157	pṛṣṭhabhāge vīṇādaṇḍāśritā mūrdhaparyantaṃ brahmarandhreti	pṛṣṭha bhāge vīṇā daṇḍa āśritā mūrdha paryantam brahmarandhra iti 
SA_MB_saandilyopanisatHK-158	vijñeyā vyaktā sūkṣmā vaiṣṇavī bhavati || 10 ||	vijñeyā vyaktā sūkṣmā vaiṣṇavī bhavati 
SA_MB_saandilyopanisatHK-159	suṣumnāsvarūpamāha- gudasyeti || 10 ||	suṣumnā svarūpam āha gudasya iti 
SA_MB_saandilyopanisatHK-160	suṣumnāparitaḥ itaranāḍīsthānāni	suṣumnā paritas itara nāḍī sthānāni 
SA_MB_saandilyopanisatHK-161	suṣumnāyāḥ savyabhāge iḍā tiṣṭhati | dakṣiṇabhāge piṅgalā |	suṣumnāyāḥ savya bhāge iḍā tiṣṭhati dakṣiṇa bhāge piṅgalā 
SA_MB_saandilyopanisatHK-162	iḍāyāṃ candraścarati | piṅgalāyāṃ raviḥ | tamorūpaścandraḥ |	iḍāyām candraḥ carati piṅgalāyām raviḥ tamaḥ rūpaḥ candraḥ 
SA_MB_saandilyopanisatHK-163	rajorūpo raviḥ | viṣabhāgo raviḥ amṛtabhāgaścandramāḥ | tāveva	rajaḥ rūpaḥ raviḥ viṣa bhāgaḥ raviḥ amṛta bhāgaḥ candramāḥ tau eva 
SA_MB_saandilyopanisatHK-164	sarvakālaṃ dhatte | suṣumnā kālabhoktrī bhavati |	sarvakālam dhatte suṣumnā kāla bhoktrī bhavati 
SA_MB_saandilyopanisatHK-165	suṣumnāpṛṣṭhapārśvayoḥ sarasvatīkuhū bhavataḥ |	suṣumnā pṛṣṭha pārśvayoḥ sarasvatī kuhū bhavataḥ 
SA_MB_saandilyopanisatHK-166	yaśasvinīkuhūmadhye vāruṇī pratiṣṭhitā bhavati | pūṣāsarasvatīmadhye	yaśasvinī kuhū madhye vāruṇī pratiṣṭhitā bhavati pūṣā sarasvatī madhye 
SA_MB_saandilyopanisatHK-167	payasvinī bhavati | gāndhārīsarasvatīmadhye yaśasvinī	payasvinī bhavati gāndhārī sarasvatī madhye yaśasvinī 
SA_MB_saandilyopanisatHK-168	p. 526) bhavati | kandamadhye'lambusā bhavati | suṣumnāpūrvabhāge	bhavati bhavati suṣumnā pūrva bhāge 
SA_MB_saandilyopanisatHK-169	meḍhrāntaṃ kuhūrbhavati | kuṇḍalinyā adhaścordhvaṃ vāruṇī	meḍhra antam kuhūḥ bhavati kuṇḍalinyāḥ adhas ca ūrdhvam vāruṇī 
SA_MB_saandilyopanisatHK-170	sarvagāminī bhavati | yaśasvinī saumyā ca pādāṅguṣṭhāntamiṣyate |	sarva gāminī bhavati yaśasvinī saumyā ca pādāṅguṣṭha antam iṣyate 
SA_MB_saandilyopanisatHK-171	piṅgalā cordhvagā yāmyanāsāntaṃ bhavati | piṅgalāyāḥ pṛṣṭhato	piṅgalā ca ūrdhva gā yāmya nāsā antam bhavati piṅgalāyāḥ 
SA_MB_saandilyopanisatHK-172	yāmyanetrāntaṃ pūṣā bhavati | yāmyakarṇāntaṃ yaśasvinī bhavati |	yāmya netra antam pūṣā bhavati yāmya karṇa antam yaśasvinī bhavati 
SA_MB_saandilyopanisatHK-173	jihvāyā ūrdhvāntaṃ sarasvatī bhavati | āsavyakarṇāntamūrdhvagā	jihvāyāḥ ūrdhva antam sarasvatī bhavati āsavya karṇa antam ūrdhva gā 
SA_MB_saandilyopanisatHK-174	śaṅkhinī bhavati | iḍāpṛṣṭhabhāgāt savyanetrāntagā gāndhārī bhavati |	śaṅkhinī bhavati iḍā pṛṣṭhabhāgāt savya netra anta gā gāndhārī bhavati 
SA_MB_saandilyopanisatHK-175	pāyumūlādadhordhvagālambusā bhavati | etāsu caturdaśanāḍīṣvanyā	pāyu mūlāt adhas ūrdhva gā alambusā bhavati etāsu caturdaśa nāḍīṣu anyā 
SA_MB_saandilyopanisatHK-176	nāḍyaḥ saṃbhavanti | tāsvanyāstāsvanyā bhavantīti vijñeyāḥ |	nāḍyaḥ saṃbhavanti tāsu anyāḥ tāsu anyāḥ bhavanti iti vijñeyāḥ 
SA_MB_saandilyopanisatHK-177	yathāśvatthādipatraṃ sirābhirvyāptamevaṃ śarīraṃ nāḍībhirvyāptam	yathā aśvattha ādi patram sirābhiḥ vyāptam evam śarīram nāḍībhiḥ vyāptam 
SA_MB_saandilyopanisatHK-178	suṣumnāyāḥ paritaḥ iḍādināḍyastiṣṭhantītyāha- suṣumnāyā iti	suṣumnāyāḥ paritas iḍā ādi nāḍyaḥ tiṣṭhanti iti āha suṣumnāyāḥ iti 
SA_MB_saandilyopanisatHK-179	prāṇādidaśavāyusthānaceṣṭāḥ	prāṇa ādi daśa vāyu sthāna ceṣṭāḥ 
SA_MB_saandilyopanisatHK-180	prāṇāpānasamānodānavyānā nāgakūrmakṛkaradevadatta-	prāṇa apāna samāna udāna vyānāḥ nāga kūrma kṛkara devadatta 
SA_MB_saandilyopanisatHK-181	dhanaṃjayā ete daśa vāyavaḥ sarvāsu nāḍīṣu caranti || 12 ||	dhanaṃjayāḥ ete daśa vāyavaḥ sarvāsu nāḍīṣu caranti  /
SA_MB_saandilyopanisatHK-182	āsyanāsikākaṇṭhanābhipādāṅguṣṭhadvayakuṇḍalyadhaścordhva-	āsya nāsikā kaṇṭha nābhi pāda aṅguṣṭha dvaya kuṇḍalī adhas ca ūrdhva 
SA_MB_saandilyopanisatHK-183	bhāgeṣu prāṇaḥ saṃcarati | śrotrākṣikaṭigulphaghrāṇagalasphigdeśeṣu	bhāgeṣu prāṇaḥ saṃcarati śrotra akṣi kaṭi gulpha ghrāṇa gala sphic deśeṣu 
SA_MB_saandilyopanisatHK-184	vyānaḥ saṃcarati | gudameḍhrorujānūdaravṛṣaṇakaṭijaṅghānābhi-	vyānaḥ saṃcarati guda meḍhra ūru jānu udara vṛṣaṇa kaṭi jaṅghā nābhi 
SA_MB_saandilyopanisatHK-185	gudāgnyagāreṣvapānaḥ saṃcarati | sarvasaṃdhistha udānaḥ |	guda agnyagāreṣu apānaḥ saṃcarati sarva saṃdhi sthaḥ udānaḥ 
SA_MB_saandilyopanisatHK-186	pādahastayorapi sarvagātreṣu sarvavyāpī samānaḥ | bhuktānnarasādikaṃ	pāda hastayoḥ api sarva gātreṣu sarvavyāpī samānaḥ bhukta anna rasa ādikam 
SA_MB_saandilyopanisatHK-187	gātre'gninā saha vyāpayan dvisaptatisahasreṣu nāḍīmārgeṣu	gātra igninā saha vyāpayan dvisaptati sahasreṣu nāḍī mārgeṣu 
SA_MB_saandilyopanisatHK-188	p. 527) caran samānavāyuragninā saha sāṅgopāṅgakalevaraṃ vyāpya-	caran samāna vāyuḥ agninā saha sa aṅga upāṅga kalevaram vyāpya 
SA_MB_saandilyopanisatHK-189	nāgādivāyavaḥ pañca tvagasthyādisaṃbhavāḥ tundasthaṃ jalamannaṃ	nāga ādi vāyavaḥ pañca tvak asthi ādi saṃbhavāḥ tunda stham jalam annam 
SA_MB_saandilyopanisatHK-190	ca rasādiṣu samīritaṃ- tundamadhyagataḥ prāṇastāni pṛthakkuryāt |	ca rasa ādiṣu samīritam tunda madhya gataḥ prāṇaḥ tāni pṛthakkuryāt 
SA_MB_saandilyopanisatHK-191	agnerupari jalaṃ sthāpya jaloparyannādīni saṃsthāpya svayamapānaṃ	agneḥ upari jalam sthāpya jala upari anna ādīni saṃsthāpya svayam apānam 
SA_MB_saandilyopanisatHK-192	saṃprāpya tenaiva saha mārutaḥ prayāti dehamadhyagataṃ jvalanam |	saṃprāpya tena eva saha mārutaḥ prayāti deha madhya gatam jvalanam 
SA_MB_saandilyopanisatHK-193	vāyunā patito vahnirapānena śanairdehamadhye jvalati | jvalano jvālābhiḥ	vāyunā patitaḥ vahniḥ apānena śanais deha madhye jvalati jvalanaḥ jvālābhiḥ 
SA_MB_saandilyopanisatHK-194	prāṇena koṣṭhamadhyagataṃ jalamatyuṣṇamakarot | jalopari samarpitaṃ	prāṇena koṣṭha madhya gatam jalam ati uṣṇam akarot jala upari samarpitam 
SA_MB_saandilyopanisatHK-195	vyañjanasaṃyuktamannaṃ vahnisaṃyuktavāriṇā pakvamakarot | tena	vyañjana saṃyuktam annam vahni saṃyukta vāriṇā pakvam akarot tena 
SA_MB_saandilyopanisatHK-196	svedamūtrajalaraktavīryarūparasapurīṣādikaṃ prāṇaḥ pṛthakkuryāt |	sveda mūtra jala rakta vīrya rūpa rasa purīṣa ādikam prāṇaḥ pṛthakkuryāt 
SA_MB_saandilyopanisatHK-197	samānavāyunā saha sarvāsu nāḍīṣu rasaṃ vyāpayan śvāsarūpeṇa	samāna vāyunā saha sarvāsu nāḍīṣu rasam vyāpayan śvāsa rūpeṇa 
SA_MB_saandilyopanisatHK-198	dehe vāyuścarati | navabhirvyomarandhraiḥ śarīrasya vāyavaḥ kurvanti	dehe vāyuḥ carati navabhiḥ vyomarandhraiḥ śarīrasya vāyavaḥ kurvanti 
SA_MB_saandilyopanisatHK-199	viṇmūtrādivisarjanam | niśvāsocchvāsakāsaśca prāṇakarmocyate |	viṣ mūtra ādi visarjanam niśvāsa ucchvāsa kāsaḥ ca prāṇa karma ucyate 
SA_MB_saandilyopanisatHK-200	viṇmūtrādivisarjanamapānavāyukarma | hānopādānaceṣṭādi	viṣ mūtra ādi visarjanam apāna vāyu karma hāna upādāna ceṣṭā ādi 
SA_MB_saandilyopanisatHK-201	vyānakarma | dehasyonnayanādikamudānakarma | śarīrapoṣaṇādikaṃ	vyāna karma dehasya unnayana ādikam udāna karma śarīra poṣaṇa ādikam 
SA_MB_saandilyopanisatHK-202	samānakarma | udgārādi nāgakarma nimīlanādi kūrmakarma |	samāna karma udgāra ādi nāga karma nimīlana ādi kūrma karma 
SA_MB_saandilyopanisatHK-203	kṣutkaraṇaṃ kṛkarakarma | tandrī devadattakarma | śleṣmādi	kṣudh karaṇam kṛkara karma tandrī devadatta karma śleṣma ādi 
SA_MB_saandilyopanisatHK-204	dhanaṃjayakarma || 13 ||	dhanaṃjaya karma 
SA_MB_saandilyopanisatHK-205	nāḍībhedamuktvā vāyubhedamāha- prāṇeti || 12 ||	nāḍī bhedam uktvā vāyu bhedam āha prāṇa iti 
SA_MB_saandilyopanisatHK-206	prāṇādiceṣṭāmācaṣṭe- āsyeti || 13-14 ||	prāṇa ādi ceṣṭām ācaṣṭe āsya iti 
SA_MB_saandilyopanisatHK-207	nāḍīśodhanavidhiḥ	        
SA_MB_saandilyopanisatHK-208	evaṃ nāḍīsthānaṃ vāyusthānaṃ tatkarma ca samyajjñātvā	evam nāḍī sthānam vāyu sthānam tad karma ca samyak jñātvā 
SA_MB_saandilyopanisatHK-209	nāḍīsaṃśodhanaṃ kuryāt || 14 ||	nāḍī saṃśodhanam kuryāt 
SA_MB_saandilyopanisatHK-210	iti caturthaḥ khaṇḍaḥ	iti caturthaḥ khaṇḍaḥ 
SA_MB_saandilyopanisatHK-211	yogādhikāriyogamaṭhayoḥ lakṣaṇam	           
SA_MB_saandilyopanisatHK-212	yamaniyamayutaḥ puruṣaḥ sarvasaṅgavivarjitaḥ kṛtavidyaḥ	yama niyama yutaḥ puruṣaḥ sarva saṅga vivarjitaḥ kṛtavidyaḥ 
SA_MB_saandilyopanisatHK-213	satyadharmarato jitakrodho guruśuśrūṣānirataḥ pitṛmātṛvidheyaḥ	satya dharma rataḥ jita krodhaḥ guru śuśrūṣā nirataḥ pitṛ mātṛ vidheyaḥ 
SA_MB_saandilyopanisatHK-214	svāśramoktasadācāravidvacchikṣitaḥ phalamūlodakānvitaṃ tapovanaṃ	sva āśrama ukta sat ācāra vidvas śikṣitaḥ phala mūla udaka anvitam tapovanam 
SA_MB_saandilyopanisatHK-215	prāpya ramyadeśe brahmaghoṣasamanvite svadharmaniratabrahmavitsamāvṛte	prāpya ramya deśe brahmaghoṣa samanvite svadharma nirata brahma vid samāvṛte 
SA_MB_saandilyopanisatHK-216	phalamūlapuṣpavāribhiḥ susaṃpūrṇe devāyatane nadītīre grāme nagare	phala mūla puṣpa vāribhiḥ su saṃpūrṇe devāyatane nadī tīre grāme nagare 
SA_MB_saandilyopanisatHK-217	vāpi suśobhanamaṭhaṃ nātyuccanīcāyatamalpadvāraṃ gomayādiliptaṃ	vā api su śobhana maṭham na ati ucca nīca āyatam alpa dvāram gomaya ādi liptam 
SA_MB_saandilyopanisatHK-218	sarvarakṣāsamanvitaṃ kṛtvā tatra vedāntaśravaṇaṃ kurvan yogaṃ	sarva rakṣā samanvitam kṛtvā tatra vedānta śravaṇam kurvan yogam 
SA_MB_saandilyopanisatHK-219	samārabhet || 1 ||	samārabhet 
SA_MB_saandilyopanisatHK-220	saprakāraṃ sopāyaṃ sāmānyaviśeṣaprāṇāyāmalakṣaṇamāha-	sa prakāram sa upāyam sāmānya viśeṣa prāṇāyāma lakṣaṇam āha 
SA_MB_saandilyopanisatHK-221	yameti | yogādhikārilakṣaṇamuktvā yogamaṭhalakṣaṇamāha- phaleti | tatra	yama iti yoga adhikāri lakṣaṇam uktvā yogamaṭha lakṣaṇam āha phala iti tatra 
SA_MB_saandilyopanisatHK-222	yogamaṭhe || 1 ||	yogamaṭhe 
SA_MB_saandilyopanisatHK-223	prāṇāyāmārambhaprakāraḥ	          
SA_MB_saandilyopanisatHK-224	ādau vināyakaṃ saṃpūjya sveṣṭadevatāṃ natvā pūrvoktāsane	ādau vināyakam saṃpūjya sva iṣṭadevatām natvā pūrva ukta āsane 
SA_MB_saandilyopanisatHK-225	sthitvā prāṅmukha udaṅmukho vāpi mṛdvāsaneṣu jitāsanagato vidvān	sthitvā prāc mukhaḥ udak mukhaḥ vā api mṛdu āsaneṣu jita āsana gataḥ vidvān 
SA_MB_saandilyopanisatHK-226	samagrīvaśironāsāgradṛgbhrūmadhye śaśabhṛdbimbaṃ paśyan	sama grīva śiraḥ nāsā agra dṛś bhrū madhye śaśabhṛt bimbam paśyan 
SA_MB_saandilyopanisatHK-227	netrābhyāsamṛtaṃ dvādaśamātrayā iḍayā vāyumāpūryodare sthitaṃ	netra abhyāsam ṛtam dvādaśa mātrayā iḍayā vāyum āpūrya udare sthitam 
SA_MB_saandilyopanisatHK-228	jvālāvalīyutaṃ rephabinduyuktamagnimaṇḍalayutaṃ dhyāyedrecayet	jvālā āvalī yutam repha bindu yuktam agni maṇḍala yutam dhyāyet recayet 
SA_MB_saandilyopanisatHK-229	piṅgalayā | punaḥ piṅgalayāpūrya kumbhitvā recayediḍayā || 2 ||	piṅgalayā punar piṅgalayā āpūrya kumbhitvā recayet iḍayā  
SA_MB_saandilyopanisatHK-230	yogārambhaprakāramāha- ādāviti | amṛtaṃ sravantaṃ	yoga ārambha prakāram āha ādau iti amṛtam sravantam 
SA_MB_saandilyopanisatHK-231	candramaṇḍalaṃ paśyan || 2 ||	candra maṇḍalam paśyan 
SA_MB_saandilyopanisatHK-232	"p. 529) 		nāḍīśodhakaprāṇāyāmābhyāsakālāvadhiḥ"	             
SA_MB_saandilyopanisatHK-233	tricatustricatuḥ saptatricaturmāsaparyantaṃ trisaṃdhiṣu tadantarāle ca	tri catuḥ tri catuḥ sapta tri catur māsa paryantam tri saṃdhiṣu tad antarāle ca 
SA_MB_saandilyopanisatHK-234	ṣaṭkṛtva ācarennāḍīśuddhirbhavati || 3 ||	ṣaṣ kṛtvas ācaret nāḍī śuddhiḥ bhavati 
SA_MB_saandilyopanisatHK-235	kiyantaṃ kālaṃ kartavyamityatra avadhimāha- tricaturiti |	kiyantam kālam kartavyam iti atra avadhim āha tri catuḥ iti 
SA_MB_saandilyopanisatHK-236	tricatustricatvāriṃśaddinaparyantaṃ vā, tricatustrimāsaṃ caturmāsaṃ	tricatuḥ tricatvāriṃśat dina paryantam vā tricatuḥ tri māsam catur māsam 
SA_MB_saandilyopanisatHK-237	saptamāsaṃ vā, tricaturmāsaparyantaṃ saṃvatsaraparyantaṃ vā, evaṃ	sapta māsam vā tri catur māsa paryantam saṃvatsara paryantam vā evam 
SA_MB_saandilyopanisatHK-238	ṣaṭkālaṃ prāṇāyāmaṃ kurvato nāḍīśuddhiḥ bhavati || 3 ||	ṣaṣ kālam prāṇāyāmam kurvataḥ nāḍī śuddhiḥ bhavati 
SA_MB_saandilyopanisatHK-239	nāḍīśuddhicihnāni	         
SA_MB_saandilyopanisatHK-240	tataḥ śarīralaghudīptivahnivṛddhinādābhivyaktirbhavati || 4 ||	tatas śarīra laghu dīpti vahni vṛddhi nāda abhivyaktiḥ bhavati 
SA_MB_saandilyopanisatHK-241	tataḥ kimityata āha- tata iti | yoginaḥ śarīrasya laghutvaṃ	tatas kim iti atas āha tatas iti yoginaḥ śarīrasya laghu tvam 
SA_MB_saandilyopanisatHK-242	dīptimattvaṃ saundaryādiḥ jāyate ityarthaḥ || 4 ||	dīptimat tvam saundarya ādiḥ jāyate iti arthaḥ 
SA_MB_saandilyopanisatHK-243	iti pañcamaḥ khaṇḍaḥ	iti pañcamaḥ khaṇḍaḥ 
SA_MB_saandilyopanisatHK-244	praṇavātmakaprāṇāyāmaḥ	           
SA_MB_saandilyopanisatHK-245	prāṇāpānasamāyogaḥ prāṇāyāmo bhavati |	prāṇa apāna samāyogaḥ prāṇāyāmaḥ bhavati 
SA_MB_saandilyopanisatHK-246	recakapūrakakumbhakabhedena sa trividhaḥ || 1 || te varṇātmakāḥ | tasmāt	recaka pūraka kumbhaka bhedena sa trividhaḥ   te varṇa ātmakāḥ tasmāt 
SA_MB_saandilyopanisatHK-247	praṇava eva prāṇāyāmaḥ || 2 ||	praṇavaḥ eva prāṇāyāmaḥ 
SA_MB_saandilyopanisatHK-248	praṇavātmakaprāṇāyāmasvarūpamāha- prāṇeti || 1 ||	praṇava ātmaka prāṇāyāma svarūpam āha prāṇa iti 
SA_MB_saandilyopanisatHK-249	recakādayaḥ te | yasmāt recakādayaḥ akārokāramakārātmakāḥ tasmāt ||	recaka ādayaḥ te yasmāt recaka ādayaḥ akāra ukāra makāra ātmakāḥ tasmāt 
SA_MB_saandilyopanisatHK-250	"p. 530) 		praṇavavarṇadhyānaprakāraḥ"	          
SA_MB_saandilyopanisatHK-251	padmādyāsanasthaḥ	padma ādi āsana sthaḥ 
SA_MB_saandilyopanisatHK-252	pumānnāsāgraśaśabhṛdbimbajyotsnājālavitānitākāramūrti raktāṅgī	pumān nāsā agra śaśabhṛt bimba jyotsnā jāla vitānita ākāra mūrti rakta aṅgī 
SA_MB_saandilyopanisatHK-253	haṃsavāhinī daṇḍahastā bālā gāyatrī bhavati | ukāramūrtiḥ	haṃsa vāhinī daṇḍa hastā bālā gāyatrī bhavati ukāra mūrtiḥ 
SA_MB_saandilyopanisatHK-254	śvetāṅgī tārkṣyavāhinī yuvatī cakrahastā sāvitrī bhavati |	śveta aṅgī tārkṣya vāhinī yuvatī cakra hastā sāvitrī bhavati 
SA_MB_saandilyopanisatHK-255	makāramūrtiḥ kṛṣṇāṅgī vṛṣabhavāhinī vṛddhā triśūladhāriṇī	                    
SA_MB_saandilyopanisatHK-256	sarasvatī bhavatī || 3 || akārāditrayāṇāṃ sarvakāraṇamekākṣaraṃ	sarasvatī bhavatī 
SA_MB_saandilyopanisatHK-257	paraṃjyotiḥ praṇavaṃ bhavati || 4 ||	paraṃjyotiḥ praṇavam bhavati 
SA_MB_saandilyopanisatHK-258	yathoktasādhanasaṃpanno yogī	yathā ukta sādhana saṃpannaḥ yogī 
SA_MB_saandilyopanisatHK-259	akārādivarṇatrayavācyagāyatryādimūrtitrayadhyānapūrvakaṃ	akāra ādi varṇa traya vācya gāyatrī ādi mūrti traya dhyāna pūrvakam 
SA_MB_saandilyopanisatHK-260	yathāvidhi prāṇāyāmaṃ kuryādityāha- padmeti || 3 ||	yathāvidhi prāṇāyāmam kuryāt iti āha padma iti 
SA_MB_saandilyopanisatHK-261	akārādimātrātrayasamaṣṭiḥ praṇavo bhavatītyāha- akārādīti |	akāra ādi mātrā traya samaṣṭiḥ praṇavaḥ bhavati iti āha akāra ādi iti 
SA_MB_saandilyopanisatHK-262	praṇavaṃ praṇavasvarūpam || 4 ||	praṇavam praṇava svarūpam 
SA_MB_saandilyopanisatHK-263	prāṇābhyāsaprakāraḥ	        
SA_MB_saandilyopanisatHK-264	iḍayā bāhyādvāyumāpūrya ṣoḍaśamātrābhirakāraṃ cintayan	iḍayā bāhyāt vāyum āpūrya ṣoḍaśa mātrābhiḥ akāram cintayan 
SA_MB_saandilyopanisatHK-265	pūritaṃ vāyuṃ catuḥṣaṣṭimātrābhiḥ kumbhayitvoṃkāraṃ dhyāyan	pūritam vāyum catuḥṣaṣṭi mātrābhiḥ kumbhayitvā oṃkāram dhyāyan 
SA_MB_saandilyopanisatHK-266	pūritaṃ piṅgalayā dvātriṃśanmātrayā makāramūrtidhyānenaivaṃ	pūritam piṅgalayā dvātriṃśat mātrayā makāra mūrti dhyānena evam 
SA_MB_saandilyopanisatHK-267	krameṇa punaḥ punaḥ kuryāt || 5 ||	krameṇa punar punar kuryāt 
SA_MB_saandilyopanisatHK-268	prāṇābhyāsaprakāramāha- iḍayeti || 5 ||	prāṇa abhyāsa prakāram āha iḍayā iti 
SA_MB_saandilyopanisatHK-269	iti ṣaṣṭhaḥ khaṇḍaḥ	iti ṣaṣṭhaḥ khaṇḍaḥ 
SA_MB_saandilyopanisatHK-270	"p. 531)		suṣumnāmalaśodhanārthaprāṇāyāmaḥ"	            
SA_MB_saandilyopanisatHK-271	athāsanadṛḍho yogī vaśī mitahitāśanaḥ	atha āsana dṛḍhaḥ yogī vaśī mita hita aśanaḥ 
SA_MB_saandilyopanisatHK-272	suṣumnānāḍīsthamalaśoṣārthaṃ yogī baddhapadmāsano vāyuṃ	suṣumnā nāḍī stha mala śoṣa artham yogī baddha padmāsanaḥ vāyum 
SA_MB_saandilyopanisatHK-273	candreṇāpūrya yathāśakti kumbhayitvā sūryeṇa recayitvā punaḥ	candreṇa āpūrya yathāśakti kumbhayitvā sūryeṇa recayitvā punar 
SA_MB_saandilyopanisatHK-274	sūryeṇāpūrya kumbhayitvā candreṇa virecya yayā tyajet tayā saṃpūrya	sūryeṇa āpūrya kumbhayitvā candreṇa virecya yayā tyajet tayā saṃpūrya 
SA_MB_saandilyopanisatHK-275	dhārayet | tadete ślokā bhavanti-	dhārayet tat ete ślokāḥ bhavanti 
SA_MB_saandilyopanisatHK-276	prāṇaṃ prāgiḍayā pibenniyamitaṃ bhūyo'nyayā recayet	prāṇam prāc iḍayā pibet niyamitam bhūyonyayā recayet 
SA_MB_saandilyopanisatHK-277	pītvā piṅgalayā samīraṇamatho baddhvā tyajedvāmayā |	pītvā piṅgalayā samīraṇam atho baddhvā tyajet vāmayā 
SA_MB_saandilyopanisatHK-278	sūryācandramasoranena vidhinābhyāsaṃ sadā tanvatāṃ	sūryācandramasoḥ anena vidhinā abhyāsam sadā tanvatām 
SA_MB_saandilyopanisatHK-279	śuddhā nāḍigaṇā bhavanti yamināṃ māsatrayādūrdhvataḥ || 1 ||	śuddhāḥ nāḍi gaṇāḥ bhavanti yaminām māsa trayāt ūrdhvatas 
SA_MB_saandilyopanisatHK-280	yogī suṣumnāntargatamalaśodhanārthaṃ puroktarītyā	yogī suṣumnā antargata mala śodhana artham purā ukta rītyā 
SA_MB_saandilyopanisatHK-281	prāṇāyāmaṃ kuryādityāha- atheti | uktārthe vakṣyamāṇāḥ ślokāḥ	prāṇāyāmam kuryāt iti āha atha iti ukta arthe vakṣyamāṇāḥ ślokāḥ 
SA_MB_saandilyopanisatHK-282	mantrā bhavantītyāha- taditi || 1 ||	mantrāḥ bhavanti iti āha tat iti 
SA_MB_saandilyopanisatHK-283	aharahaḥ kartavyaprāṇāyāmasaṃkhyā	ahar ahar kartavya prāṇāyāma saṃkhyā 
SA_MB_saandilyopanisatHK-284	prātarmadhyaṃdine sāyamardharātre tu kumbhakān |	prātar madhyaṃdine sāyam ardharātre tu kumbhakān 
SA_MB_saandilyopanisatHK-285	śanairaśītiparyantaṃ caturvāraṃ samabhyaset || 2 ||	śanais aśīti paryantam catur vāram samabhyaset 
SA_MB_saandilyopanisatHK-286	aharahaḥ kati prāṇāyāmāḥ kartavyāḥ ityata āha- prātariti || 2 ||	ahar ahar kati prāṇāyāmāḥ kartavyāḥ iti atas āha prātar iti 
SA_MB_saandilyopanisatHK-287	abhyāsocitasiddhibhedaḥ	          
SA_MB_saandilyopanisatHK-288	kanīyasi bhavet svedaḥ kampo bhavati madhyame |	kanīyasi bhavet svedaḥ kampaḥ bhavati madhyame 
SA_MB_saandilyopanisatHK-289	uttiṣṭhatyuttame prāṇarodhe padmāsanaṃ bhavet || 3 ||	uttiṣṭhati uttame prāṇa rodhe padmāsanam bhavet 
SA_MB_saandilyopanisatHK-290	p. 532) jalena śramajātena gātramardanamācaret |	jalena śrama jātena gātra mardanam ācaret 
SA_MB_saandilyopanisatHK-291	dṛḍhatā laghutā cāpi tasya gātrasya jāyate || 4 ||	dṛḍha tā laghu tā ca api tasya gātrasya jāyate 
SA_MB_saandilyopanisatHK-292	abhyāsocitasiddhibhedamācaṣṭe- kanīyasīti || 3 || tena kiṃ syādityatra	abhyāsa ucita siddhi bhedam ācaṣṭe kanīyasī iti tena kim syāt iti atra 
SA_MB_saandilyopanisatHK-293	jaleneti || 4 ||	jalena iti 
SA_MB_saandilyopanisatHK-294	abhyāsakāle āhāraniyamaḥ	           
SA_MB_saandilyopanisatHK-295	abhyāsakāle prathamaṃ śastaṃ kṣīrājyabhojanam |	abhyāsa kāle prathamam śastam kṣīra ājya bhojanam 
SA_MB_saandilyopanisatHK-296	tato'bhyāse sthirībhūte na tāvanniyamagrahaḥ || 5 ||	tatobhyāse sthirībhūte na tāvat niyama grahaḥ 
SA_MB_saandilyopanisatHK-297	āhāraniyamamāha- abhyāseti || 5 ||	āhāra niyamam āha abhyāsa iti 
SA_MB_saandilyopanisatHK-298	abhyāse sāvadhānatāvidhiḥ	          
SA_MB_saandilyopanisatHK-299	yathā siṃho gajo vyāghro bhavedvaśyaḥ śanaiḥ śanaiḥ |	yathā siṃhaḥ gajaḥ vyāghraḥ bhavet vaśyaḥ śanais śanais 
SA_MB_saandilyopanisatHK-300	tathaiva sevito vāyuranyathā hanti sādhakam || 6 ||	tathā eva sevitaḥ vāyuḥ anyathā hanti sādhakam 
SA_MB_saandilyopanisatHK-301	yuktaṃyuktaṃ tyajedvāyuṃ yuktaṃyuktaṃ ca pūrayet |	yuktam yuktam tyajet vāyum yuktam yuktam ca pūrayet 
SA_MB_saandilyopanisatHK-302	yuktaṃ yuktena badhnīyādevaṃ siddhimavāpnuyāt || 7 ||	yuktam yuktena badhnīyāt evam siddhim avāpnuyāt 
SA_MB_saandilyopanisatHK-303	yāvat suṣumnāpraveśaḥ tāvat sāvadhānatayā abhyāsaḥ kāryaḥ	yāvat suṣumnā praveśaḥ tāvat sāvadhāna tayā abhyāsaḥ kāryaḥ 
SA_MB_saandilyopanisatHK-304	ityata āha- yatheti || 6 || tatropāyastu yuktamiti | evam abhyāsaṃ kurvato	iti atas āha yathā iti    tatra upāyaḥ tu yuktam iti evam abhyāsam kurvataḥ 
SA_MB_saandilyopanisatHK-305	nāḍīśuddhiḥ bhavati || 7 ||	nāḍīśuddhiḥ bhavati 
SA_MB_saandilyopanisatHK-306	nāḍīśuddhito manonmanyavasthāprāptiḥ	           
SA_MB_saandilyopanisatHK-307	yatheṣṭadhāraṇaṃ vāyoranalasya pradīpanam |	yathā iṣṭa dhāraṇam vāyoḥ analasya pradīpanam 
SA_MB_saandilyopanisatHK-308	nādābhivyaktirārogyaṃ jāyate nāḍiśodhanāt || 8 ||	nāda abhivyaktiḥ ārogyam jāyate nāḍi śodhanāt 
SA_MB_saandilyopanisatHK-309	p. 533) vidhivat prāṇasaṃyāmairnāḍīcakre viśodhite |	vidhivat prāṇasaṃyāmaiḥ nāḍī cakre viśodhite 
SA_MB_saandilyopanisatHK-310	suṣumnāvadanaṃ bhittvā sukhādviśati mārutaḥ || 9 ||	suṣumnā vadanam bhittvā sukhāt viśati mārutaḥ 
SA_MB_saandilyopanisatHK-311	mārute madhyasaṃcāre manaḥsthairyaṃ prajāyate |	mārute madhya saṃcāre manaḥ sthairyam prajāyate 
SA_MB_saandilyopanisatHK-312	yo manaḥsusthirībhāvaḥ saivāvasthā manonmanī || 10 ||	yaḥ manaḥ susthirībhāvaḥ sā eva avasthā manonmanī   
SA_MB_saandilyopanisatHK-313	tato vāyuḥ suṣumnāṃ praviśya yoginaṃ	tatas vāyuḥ suṣumnām praviśya yoginam 
SA_MB_saandilyopanisatHK-314	manonmanyavasthārūḍhaṃ kuryādityāha- yatheṣṭeti || 8-9 || tena kiṃ	manonmanī avasthā ārūḍham kuryāt iti āha yathā iṣṭa iti      tena kim 
SA_MB_saandilyopanisatHK-315	syādityatra- māruta iti || 10 ||	syāt iti atra mārutaḥ iti 
SA_MB_saandilyopanisatHK-316	bandhatrayasya kartavyatā	bandha trayasya kartavya tā 
SA_MB_saandilyopanisatHK-317	pūrakānte tu kartavyo bandho jālaṃdharābhidhaḥ |	pūraka ante tu kartavyaḥ bandhaḥ jālaṃdhara abhidhaḥ 
SA_MB_saandilyopanisatHK-318	kumbhakānte recakādau bandho jālaṃdharābhidhaḥ || 11 ||	             
SA_MB_saandilyopanisatHK-319	adhastātkuñcanenāśu kaṇṭhasaṃkocane kṛte |	adhastāt kuñcanena āśu kaṇṭha saṃkocane kṛte 
SA_MB_saandilyopanisatHK-320	madhye paścimatānena syāt prāṇo brahmanāḍigaḥ || 12 ||	madhye paścimatānena syāt prāṇaḥ brahmanāḍi gaḥ   /
SA_MB_saandilyopanisatHK-321	bandhatrayapūrvakābhyāsa eva phalavānityāha- pūrakānta iti || 11-12 ||	bandha traya pūrvaka abhyāsaḥ eva phalavān iti āha pūraka ante iti 
SA_MB_saandilyopanisatHK-322	prāṇāpānayogaphalam	         
SA_MB_saandilyopanisatHK-323	apānamūrdhvamutthāpya prāṇaṃ kaṇṭhādadho nayan |	apānam ūrdhvam utthāpya prāṇam kaṇṭhāt adhas nayan 
SA_MB_saandilyopanisatHK-324	yogī jarāvinirmuktaṃ ṣoḍaśo vayasā bhavet || 13 ||	yogī jarā vinirmuktam ṣoḍaśaḥ vayasā bhavet 
SA_MB_saandilyopanisatHK-325	prāṇāpānayogaphalamāha- apānamiti || 13 ||	prāṇa apāna yoga phalam āha apānam iti 
SA_MB_saandilyopanisatHK-326	kapālaśodhanopāyaḥ	        
SA_MB_saandilyopanisatHK-327	sukhāsanastho dakṣanāḍyā bahisthaṃ pavanaṃ	sukha āsana sthaḥ dakṣa nāḍyā bahi stham pavanam 
SA_MB_saandilyopanisatHK-328	samākṛṣyākeśamānakhāgraṃ kumbhayitvā savyanāḍyā recayet | tena	samākṛṣya ākeśam ā nakha agram kumbhayitvā savya nāḍyā recayet tena 
SA_MB_saandilyopanisatHK-329	kapālaśodhanaṃ vātanāḍīgatasarvarogavināśanaṃ bhavati || 13-1 ||	           bhavati 
SA_MB_saandilyopanisatHK-330	p. 534) kapālaśodhanopāyamāha- sukheti | yogī sukhāsanasthaḥ |	kapāla śodhana upāyam āha sukha iti yogī sukha āsana sthaḥ 
SA_MB_saandilyopanisatHK-331	kapālaśodhanaṃ bhavati | tena kiṃ bhavatītyatra- vāteti || 13-1 ||	kapāla śodhanam bhavati tena kim bhavati iti atra vāta iti  /
SA_MB_saandilyopanisatHK-332	ujjāyīprāṇāyāmaḥ	ujjāyīprāṇāyāmaḥ 
SA_MB_saandilyopanisatHK-333	hṛdayādikaṇṭhaparyantaṃ sasvanaṃ nāsābhyāṃ śanaiḥ	hṛdaya ādi kaṇṭha paryantam sa svanam nāsābhyām śanais 
SA_MB_saandilyopanisatHK-334	pavanamākṛṣya yathāśakti kumbhayitvā iḍayā virecya gacchaṃstiṣṭhan	pavanam ākṛṣya yathāśakti kumbhayitvā iḍayā virecya gacchan tiṣṭhan 
SA_MB_saandilyopanisatHK-335	kuryāt | tena śleṣmaharaṃ jāṭharāgnivardhanaṃ bhavati || 13-2 ||	kuryāt tena śleṣma haram jāṭhara agni vardhanam bhavati  /
SA_MB_saandilyopanisatHK-336	śleṣmaharojjāyīlakṣaṇamāha- hṛdayādīti | tiṣṭhan	śleṣma hara ujjāyī lakṣaṇam āha hṛdaya ādi iti tiṣṭhan 
SA_MB_saandilyopanisatHK-337	ujjāyīnāmakaṃ prāṇāyāmaṃ kuryāt || 13-2 ||	ujjāyī nāmakam prāṇāyāmam kuryāt 
SA_MB_saandilyopanisatHK-338	sītkāraprāṇāyāmaḥ	sītkāra prāṇāyāmaḥ 
SA_MB_saandilyopanisatHK-339	vaktreṇa sītkārapūrvakaṃ vāyuṃ gṛhītvā yathāśakti	vaktreṇa sītkāra pūrvakam vāyum gṛhītvā yathāśakti 
SA_MB_saandilyopanisatHK-340	kumbhayitvā nāsābhyāṃ recayet | tena kṣuttṛṣṇālasyanidrā na jāyante ||	kumbhayitvā nāsābhyām recayet tena kṣudh tṛṣṇā ālasya nidrāḥ na jāyante 
SA_MB_saandilyopanisatHK-341	sītkāraprāṇāyāmamāha- vaktreṇeti || 13-3 ||	sītkāra prāṇāyāmam āha vaktreṇa iti 
SA_MB_saandilyopanisatHK-342	śītalaprāṇāyāmaḥ	           
SA_MB_saandilyopanisatHK-343	jihvayā vāyuṃ gṛhītvā yathāśakti kumbhayitvā nāsābhyāṃ	jihvayā vāyum gṛhītvā yathāśakti kumbhayitvā nāsābhyām 
SA_MB_saandilyopanisatHK-344	recayet | tena gulmaplīhajvarapittakṣudhādi naśyati || 13-4 ||	recayet tena gulma plīha jvara pitta kṣudhā ādi naśyati 
SA_MB_saandilyopanisatHK-345	śītalī tu jihvayā || 13-4 ||	śītalī tu jihvayā 
SA_MB_saandilyopanisatHK-346	upāyopeyakumbhakadvayam	          
SA_MB_saandilyopanisatHK-347	kumbhakaḥ sa dvividhaḥ sahitaḥ kevalaśceti | recakapūrakayuktaḥ	kumbhakaḥ sa dvividhaḥ sahitaḥ kevalaḥ ca iti recaka pūraka yuktaḥ 
SA_MB_saandilyopanisatHK-348	sahitaḥ | tadvivarjitaḥ kevalaḥ | kevalasiddhiparyantaṃ sahitamabhyaset |	sahitaḥ tad vivarjitaḥ kevalaḥ kevala siddhi paryantam sahitam abhyaset 
SA_MB_saandilyopanisatHK-349	p. 535) kevalakumbhake siddhe triṣu lokeṣu na tasya durlabhaṃ bhavati |	kevala kumbhake siddhe triṣu lokeṣu na tasya durlabham bhavati 
SA_MB_saandilyopanisatHK-350	kevalakumbhakāt kuṇḍalinībodho jāyate || 13-5 ||	           
SA_MB_saandilyopanisatHK-351	upāyopeyakumbhakadvayamāha- kumbhaka iti | tataḥ kiṃ jāyata	upāya upeya kumbhaka dvayam āha kumbhakaḥ iti tatas kim jāyata 
SA_MB_saandilyopanisatHK-352	ityatra- kevaleti || 13-5 ||	iti atra kevala iti 
SA_MB_saandilyopanisatHK-353	kumbhakābhyāsaphalam	kumbhaka abhyāsa phalam 
SA_MB_saandilyopanisatHK-354	tataḥ kṛśavapuḥ prasannavadano nirmalalocano'bhivyaktanādo	tatas kṛśa vapuḥ prasanna vadanaḥ nirmala locanaḥ abhivyakta nādaḥ 
SA_MB_saandilyopanisatHK-355	nirmuktarogajālo jitabinduḥ paṭvagnirbhavati || 13-6 ||	nirmukta roga jālaḥ jita binduḥ paṭu agniḥ bhavati 
SA_MB_saandilyopanisatHK-356	tataḥ kiṃ syādityatra tataḥ iti || 13-6 ||	tatas kim syāt iti atra tatas iti 
SA_MB_saandilyopanisatHK-357	vaiṣṇavīmudrāprāptiḥ	vaiṣṇavī mudrā prāptiḥ 
SA_MB_saandilyopanisatHK-358	antarlakṣyaṃ bahirdṛṣṭirnimeṣonmeṣavarjitā |	antar lakṣyam bahis dṛṣṭiḥ nimeṣa unmeṣa varjitā 
SA_MB_saandilyopanisatHK-359	eṣā sā vaiṣṇavī mudrā sarvatantreṣu gopitā || 14 ||	eṣā sā vaiṣṇavī mudrā sarva tantreṣu gopitā 
SA_MB_saandilyopanisatHK-360	tena kimityākāṅkṣāyām anena yogī vaiṣṇavīmudrārūḍho	tena kim iti ākāṅkṣāyām anena yogī vaiṣṇavī mudrā ārūḍhaḥ 
SA_MB_saandilyopanisatHK-361	bhavatītyāha- antarlakṣyamiti | mūlādhārānāhatājñāsahasrāreṣu	bhavati iti āha antar lakṣyam iti mūlādhāra anāhata ājñā sahasrāreṣu 
SA_MB_saandilyopanisatHK-362	yathākramaṃ virāṭ sūtraṃ bījaṃ turīyaṃ vā antarlakṣyaṃ	yathākramam virāj sūtram bījam turīyam vai antar lakṣyam 
SA_MB_saandilyopanisatHK-363	tadekatānaṃ manaḥ bahirdṛṣṭistu antardṛṣṭirbhūtvā yadā	tat ekatānam manaḥ bahis dṛṣṭiḥ tu antar dṛṣṭiḥ bhūtvā yadā 
SA_MB_saandilyopanisatHK-364	nimeṣonmeṣavarjitā bhavati tadā dṛṣṭiriyaṃ vaiṣṇavīmudrā	nimeṣa unmeṣa varjitā bhavati tadā dṛṣṭiḥ iyam vaiṣṇavī mudrā 
SA_MB_saandilyopanisatHK-365	bhavatītyarthaḥ || 14 ||	bhavati iti arthaḥ 
SA_MB_saandilyopanisatHK-366	khecarīprāptyā brahmadarśanam	          
SA_MB_saandilyopanisatHK-367	antarlakṣyavilīnacittapavano yogī sadā vartate	antar lakṣya vilīna citta pavanaḥ yogī sadā vartate 
SA_MB_saandilyopanisatHK-368	dṛṣṭyā niścalatārayā bahiradhaḥ paśyannapaśyannapi |	dṛṣṭyā niścala tārayā bahis adhas paśyan a paśyan api 
SA_MB_saandilyopanisatHK-369	mudreyaṃ khalu khecarī bhavati sā lakṣyaikatānā śivā	mudrā iyam khalu khecarī bhavati sā lakṣya ekatānā śivā 
SA_MB_saandilyopanisatHK-370	śūnyāśūnyavivarjitaṃ sphurati sā tattvaṃ padaṃ vaiṣṇavī ||	śūnyāśūnya vivarjitam sphurati sā tattvam padam vaiṣṇavī 
SA_MB_saandilyopanisatHK-371	p. 536) ardhonmīlitalocanaḥ sthiramanā nāsāgradattekṣaṇa-	ardha unmīlita locanaḥ sthira manāḥ nāsā agra datta īkṣaṇa 
SA_MB_saandilyopanisatHK-372	ścandrārkāvapi līnatāmupanayanniṣyandabhāvottaram |	ścandra arkau api līna tām upanayan nisyanda bhāva uttaram 
SA_MB_saandilyopanisatHK-373	jyotīrūpamaśeṣabāhyarahitaṃ dedīpyamānaṃ paraṃ	jyotīrūpam aśeṣa bāhya rahitam dedīpyamānam param 
SA_MB_saandilyopanisatHK-374	tattvaṃ tatparamasti vastu viṣayaṃ śāṇḍilya viddhīha tat ||	tattvam tad param asti vastu viṣayam śāṇḍilya viddhi iha tat 
SA_MB_saandilyopanisatHK-375	yadā yogī vaiṣṇavīmudrārūḍho bhavati tadā iyaṃ	yadā yogī vaiṣṇavī mudrā ārūḍhaḥ bhavati tadā iyam 
SA_MB_saandilyopanisatHK-376	vaiṣṇavīmudrā khecarīpadavīmetya	vaiṣṇavī mudrā khecarī padavīm etya 
SA_MB_saandilyopanisatHK-377	tattvaṃpadalakṣyaikyapratyagabhinnabrahmagocarā bhavatītyāha- antariti |	tattvaṃpada lakṣya aikya pratyagabhinna brahma gocarā bhavati iti āha antar iti 
SA_MB_saandilyopanisatHK-378	antardṛṣṭibhāvamāpannaniścalabahirdṛṣṭireva mudreyam | śūnyaṃ	antar dṛṣṭi bhāvam āpanna niścala bahis dṛṣṭiḥ eva mudrā iyam śūnyam 
SA_MB_saandilyopanisatHK-379	suṣuptiḥ aśūnyaṃ svapnādikaṃ tadubhayavarjitaṃ yathā bhavati tathā	suṣuptiḥ a śūnyam svapna ādikam tad ubhaya varjitam yathā bhavati tathā 
SA_MB_saandilyopanisatHK-380	lakṣyaikatānā vaiṣṇavī sphuratītyarthaḥ || 15 ||	lakṣya ekatānā vaiṣṇavī sphurati iti arthaḥ 
SA_MB_saandilyopanisatHK-381	khecarīmudrārūḍhayoginaḥ sthitiṃ taddhyeyasvarūpaṃ cāha- ardheti |	khecarī mudrā rūḍha yoginaḥ sthitim tad dhyeya svarūpam ca āha ardha iti 
SA_MB_saandilyopanisatHK-382	ardhonmīlitalocanaḥ ityādiviśeṣaṇaviśiṣṭo yogī candrārkau	ardha unmīlita locanaḥ ityādi viśeṣaṇa viśiṣṭaḥ yogī candra arkau 
SA_MB_saandilyopanisatHK-383	iḍāpiṅgalāgocaravāyū manodṛṣṭyagnibhiḥ saha suṣumnāyāṃ	iḍā piṅgalā gocara vāyū manaḥ dṛṣṭi agnibhiḥ saha suṣumnāyām 
SA_MB_saandilyopanisatHK-384	līnatāṃ layabhāvaṃ upanayan yadā tiṣṭhati tadā	līna tām laya bhāvam upanayan yadā tiṣṭhati tadā 
SA_MB_saandilyopanisatHK-385	svāntarbāhyavismārakabrahmānandanadī pravahati | tato	sva antar bāhya vismāraka brahma ānanda nadī pravahati 
SA_MB_saandilyopanisatHK-386	niṣyandabhāvottaraṃ nitarāṃ sravadānandabhāvānubhavānantaraṃ	nisyanda bhāva uttaram nitarām sravat ānanda bhāva anubhava anantaram 
SA_MB_saandilyopanisatHK-387	tadanubhūtyasaṃgatayā yadvastu pratyagjyotīrūpam	tad anubhūti asaṃga tayā yat vastu pratyak jyotīḥ rūpam 
SA_MB_saandilyopanisatHK-388	aśeṣabāhyāntaḥkalanāviralaṃ paramātmābhedena dedīpyamānaṃ paro	aśeṣa bāhya antar kalanā viralam paramātma abhedena dedīpyamānam 
SA_MB_saandilyopanisatHK-389	divo jyotirdīpyate iti śrutisiddhaṃ paraṃ tattvamasti he śāṇḍilya	divaḥ jyotiḥ dīpyate iti śruti siddham param tattvam asti he śāṇḍilya 
SA_MB_saandilyopanisatHK-390	tadviṣayaṃ tadbhāvāpannaṃ vastu brahmāhamiti viddhi || 16 ||	tad viṣayam tad bhāva āpannam vastu brahma aham iti viddhi 
SA_MB_saandilyopanisatHK-391	khecaryā unmanībhāvāpattiḥ	           
SA_MB_saandilyopanisatHK-392	tāraṃ jyotiṣi saṃyojya kiṃcidunnamaya bhruvau |	tāram jyotiṣi saṃyojya kiṃcid unnamaya bhruvau 
SA_MB_saandilyopanisatHK-393	pūrvābhyāsasya mārgo'yamunmanīkārakaḥ kṣaṇāt || 17 ||	pūrva abhyāsasya mārgaḥ yam unmanī kārakaḥ kṣaṇāt 
SA_MB_saandilyopanisatHK-394	tasmāt khecarīmudrāmabhyaset | tatonmanī bhavati | tato yoganidrā	tasmāt khecarī mudrām abhyaset tatas unmanī bhavati tatas yoganidrā 
SA_MB_saandilyopanisatHK-395	bhavati | labdhayoganidrasya yoginaḥ kālo nāsti || 17-1 ||	bhavati labdha yoga nidrasya yoginaḥ kālaḥ na asti  /
SA_MB_saandilyopanisatHK-396	kathamevaṃ jñātuṃ śakyate ityatropāyamāha- tāramiti |	katham evam jñātum śakyate iti atra upāyam āha tāram iti 
SA_MB_saandilyopanisatHK-397	bhrūmadhyavilasajjyotiṣi samabhāvamāpannakṛṣṇatārayugalaṃ dṛḍhaṃ	bhrū madhya vilasat jyotiṣi sama bhāvam āpanna kṛṣṇa tāra yugalam dṛḍham 
SA_MB_saandilyopanisatHK-398	saṃyojya avalokya kiṃcit	saṃyojya avalokya kiṃcid 
SA_MB_saandilyopanisatHK-399	p. 537) bhruvau ūrdhvamunnamayya urdhvotkṣepaṇaṃ kṛtvā atha	bhruvau ūrdhvam unnamayya urdhva utkṣepaṇam kṛtvā atha 
SA_MB_saandilyopanisatHK-400	sahasrāravilasitaturīyaṃ tatkalanāviralaturīyātītaṃ vā svāvaśeṣadhiyā	                                                                                                                
SA_MB_saandilyopanisatHK-401	paśyediti śeṣaḥ | tāraṃ jyotiṣi saṃyojya iti yo darśitaḥ antarlakṣyam	paśyet iti śeṣaḥ tāram jyotiṣi saṃyojyaḥ iti yaḥ darśitaḥ antar lakṣyam 
SA_MB_saandilyopanisatHK-402	ityādipūrvābhyāsasya ayameva mārgaḥ kṣaṇādunmanīkārakaḥ	ityādi pūrva abhyāsasya ayam eva mārgaḥ kṣaṇāt unmanīkārakaḥ 
SA_MB_saandilyopanisatHK-403	nirvikalpakabrahmabhāvāpattiheturityarthaḥ || 17 || yasmādevaṃ tasmāt |	nirvikalpaka brahma bhāva āpatti hetuḥ iti arthaḥ    yasmāt evam tasmāt 
SA_MB_saandilyopanisatHK-404	tatonmanībhavati nirvyāpāraṃ mano bhavatītyarthaḥ | tataḥ kimityata āha-	tatas unmanībhavati nirvyāpāram manaḥ bhavati iti arthaḥ tatas kim iti atas āha 
SA_MB_saandilyopanisatHK-405	tata iti | yoganidrā nirvikalpabhāvāpattiḥ tato vyutthānaśaṅkāṃ vārayati-	tatas iti yoganidrā nirvikalpa bhāva āpattiḥ tatas vyutthāna śaṅkām vārayati 
SA_MB_saandilyopanisatHK-406	labdheti | evaṃ labdhayoganidrasya yoginaḥ nirvikalpakato vyutthāpakakālo	labdha iti evam labdha yoganidrasya yoginaḥ nirvikalpakataḥ vyutthāpaka kālaḥ 
SA_MB_saandilyopanisatHK-407	nāsti || 17-1 ||	na asti 
SA_MB_saandilyopanisatHK-408	kālāparicchinnabrahmaprāptisādhanam	             
SA_MB_saandilyopanisatHK-409	śaktimadhye manaḥ kṛtvā śaktiṃ ca manamadhyagām |	śakti madhye manaḥ kṛtvā śaktim ca mana madhya gām 
SA_MB_saandilyopanisatHK-410	manasā mana ālokya śāṇḍilyaṃ tvaṃ sukhī bhava || 18 ||	manasā manaḥ ālokya śāṇḍilyam tvam sukhī bhava  /
SA_MB_saandilyopanisatHK-411	khamadhye kuru cātmānamātmamadhye ca khaṃ kuru |	kha madhye kuru ca ātmānam ātma madhye ca kham kuru 
SA_MB_saandilyopanisatHK-412	sarvaṃ ca khamayaṃ kṛtvā na kiṃcidapi cintaya || 19 ||	sarvam ca kha mayam kṛtvā na kiṃcid api cintaya 
SA_MB_saandilyopanisatHK-413	kālāparicchinnanirvikalpakabrahmabhāvāpattyupāyamāha-	                                                                                                     
SA_MB_saandilyopanisatHK-414	kuṇḍalinīśaktimadhye manaḥ kṛtvā manolayaṃ kṛtvā tataḥ	kuṇḍalinī śakti madhye manaḥ kṛtvā manaḥ layam kṛtvā tatas 
SA_MB_saandilyopanisatHK-415	kuṇḍalinīśaktiṃ, caśabdāt dṛṣṭiṃ, manamadhyagāṃ	kuṇḍalinī śaktim caśabdāt dṛṣṭim 
SA_MB_saandilyopanisatHK-416	manaḥpravṛttinimittapratyakcaitanyaparyavasannāṃ kṛtvā	manaḥ pravṛtti nimitta pratyak caitanya paryavasannām kṛtvā 
SA_MB_saandilyopanisatHK-417	pratyagbhāvāpannena manasā manaḥ	pratyak bhāva āpannena manasā manaḥ 
SA_MB_saandilyopanisatHK-418	manovṛttisahasrabhāvābhāvaprakāśakapratyagabhinnaṃ brahma	                         
SA_MB_saandilyopanisatHK-419	ahabhasmītyālokya he śāṇḍilya tvaṃ	ahabhasmi iti ālokya he śāṇḍilya tvam 
SA_MB_saandilyopanisatHK-420	tanmātrāvasthānalakṣaṇakaivalyasukhī bhavetyarthaḥ || 18 ||	tanmātra avasthāna lakṣaṇa kaivalya sukhī bhava iti arthaḥ 
SA_MB_saandilyopanisatHK-421	prakārāntaramāha- khamadhya iti | citkhamadhye ātmānamantaḥkaraṇaṃ	prakāra antaram āha kha madhye iti cit kha madhye ātmānam antaḥkaraṇam 
SA_MB_saandilyopanisatHK-422	kuru ātmāntaḥkaraṇamadhye ca khaṃ kuru | eva vyatihāreṇa sarvaṃ	kuru ātma antaḥkaraṇa madhye ca kham kuru eva vyatihāreṇa sarvam 
SA_MB_saandilyopanisatHK-423	citkhamayaṃ kṛtvā cidākāśātiriktaṃ na kiṃcidasti iti cintaya || 19 ||	cit kha mayam kṛtvā cit ākāśa atiriktam na kiṃcid asti iti cintaya 
SA_MB_saandilyopanisatHK-424	"p. 538) 		manovilāpanena kaivalyaprāptiḥ"	          
SA_MB_saandilyopanisatHK-425	bāhyacintā na kartavyā tathaivāntaracintikā |	bāhya cintā na kartavyā tathā eva antara cintikā 
SA_MB_saandilyopanisatHK-426	sarvacintāṃ parityajya cinmātraparamo bhava || 20 ||	sarva cintām parityajya cit mātra paramaḥ bhava 
SA_MB_saandilyopanisatHK-427	karpūramanale yadvat saindhavaṃ salile yathā |	karpūram anale yadvat saindhavam salile yathā 
SA_MB_saandilyopanisatHK-428	tathā ca līyamānaṃ ca manastattve vilīyate || 21 ||	tathā ca līyamānam ca manaḥ tattve vilīyate 
SA_MB_saandilyopanisatHK-429	jñeyaṃ sarvapratītaṃ ca tajjñānaṃ mana ucyate |	jñeyam sarva pratītam ca tat jñānam manaḥ ucyate 
SA_MB_saandilyopanisatHK-430	jñānaṃ jñeyaṃ samaṃ naṣṭaṃ nānyaḥ panthā dvitīyakaḥ || 22 ||	jñānam jñeyam samam naṣṭam na anyaḥ panthāḥ dvitīyakaḥ  
SA_MB_saandilyopanisatHK-431	jñeyavastuparityāge vilayaṃ yāti mānasam |	jñeya vastu parityāge vilayam yāti mānasam 
SA_MB_saandilyopanisatHK-432	mānase vilayaṃ yāte kaivalyamavaśiṣyate || 23 ||	mānase vilayam yāte kaivalyam avaśiṣyate  /
SA_MB_saandilyopanisatHK-433	bāhyāntarvṛttyāvṛtasya kathaṃ cidākāśadṛṣṭiḥ udetītyata āha-	bāhya antar vṛtti āvṛtasya katham cit ākāśa dṛṣṭiḥ udeti iti atas āha 
SA_MB_saandilyopanisatHK-434	bāhyeti || 20 || niṣpratiyogikacinmātrāvagateḥ	bāhya iti niṣpratiyogika cit mātra avagatyāḥ 
SA_MB_saandilyopanisatHK-435	antarbāhyavibhāgakalanāpahnavapūrvakatvāt	antar bāhya vibhāga kalanā apahnava pūrvaka tvāt 
SA_MB_saandilyopanisatHK-436	jñeyasāmānyāsaṃbhavaprabodhasamakālaṃ yogī kaivalyarūpeṇa	jñeya sāmānya asaṃbhava prabodha sama kālam yogī kaivalya rūpeṇa 
SA_MB_saandilyopanisatHK-437	avaśiṣyate ityāha- karpūramiti | dagdhakarpūravat	avaśiṣyate iti āha karpūram iti dagdha karpūra vat 
SA_MB_saandilyopanisatHK-438	jalagatasaindhavapiṇḍavacca jāgradādyavasthātrayalīyamānaṃ manaḥ	jala gata saindhava piṇḍa vat ca jāgrat ādi avasthā traya līyamānam manaḥ 
SA_MB_saandilyopanisatHK-439	svarūpadhyānasaṃskṛtaṃ satprapañcavimukhaṃ bhūtvā svatattve	sva rūpa dhyāna saṃskṛtam sat prapañca vimukham bhūtvā sva tattve 
SA_MB_saandilyopanisatHK-440	brahmaṇi līyate || 21 || prapañcatadgocarajñeyajñānasattvāt kathaṃ manaḥ	brahmaṇi līyate prapañca tad gocara jñeya jñāna sattvāt katham manaḥ 
SA_MB_saandilyopanisatHK-441	svatattve vilīyata ityata āha- jñeyamiti | sarvatra svātirekeṇa pratīyata iti	sva tattve vilīyate iti atas āha jñeyam iti sarvatra sva atirekeṇa pratīyate iti 
SA_MB_saandilyopanisatHK-442	sarvapratītam | avidyāpadaśabdāt jāgradāditatkāryaprapañca ucyate | tat	                                           
SA_MB_saandilyopanisatHK-443	sarvaṃ jñeyaśabdārthaḥ tadgocaraṃ manaḥ jñānamucyate |	sarvam jñeya śabda arthaḥ tad gocaram manaḥ jñānam ucyate 
SA_MB_saandilyopanisatHK-444	brahmātiriktaṃ na kiṃcidasti iti yajjñānasamakālaṃ jñānaṃ jñeyaṃ	brahma atiriktam na kiṃcid asti iti yat jñāna sama kālam jñānam jñeyam 
SA_MB_saandilyopanisatHK-445	samaṃ yugapannaṣṭaṃ bhavati ayameva advitīyabrahmaprāpakaḥ panthāḥ	samam yugapad naṣṭam bhavati ayam eva advitīya brahma prāpakaḥ panthāḥ 
SA_MB_saandilyopanisatHK-446	nāto'nyaḥ kaścidastītyarthaḥ || 22 || yugapat kathaṃ līyate ityata āha-	na atonyaḥ kaścid asti iti arthaḥ    yugapad katham līyate iti atas āha 
SA_MB_saandilyopanisatHK-447	jñeyeti || 23 ||	jñeyā iti 
SA_MB_saandilyopanisatHK-448	"p. 539) 		yogajñānābhyāṃ manolayaḥ"	yoga jñānābhyām manaḥ layaḥ 
SA_MB_saandilyopanisatHK-449	dvau kramau cittanāśasya yogo jñānaṃ munīśvara |	dvau kramau citta nāśasya yogaḥ jñānam muni īśvara 
SA_MB_saandilyopanisatHK-450	yogastu vṛttirodho hi jñānaṃ samyagavekṣaṇam || 24 ||	yogaḥ tu vṛtti rodhaḥ hi jñānam samyak avekṣaṇam 
SA_MB_saandilyopanisatHK-451	tasminnirodhite nūnamupaśāntaṃ mano bhavet |	tasmin nirodhite nūnam upaśāntam manaḥ bhavet 
SA_MB_saandilyopanisatHK-452	manaḥspandopaśāntyāyāṃ saṃsāraḥ pravilīyate || 25 ||	manaḥ spanda upaśāntyāyām saṃsāraḥ pravilīyate 
SA_MB_saandilyopanisatHK-453	sūryālokaparispandaśāntau vyavahṛtiryathā |	sūrya āloka parispanda śāntau vyavahṛtiḥ yathā 
SA_MB_saandilyopanisatHK-454	kathaṃ punaḥ mānasaṃ vilīyate ityāśaṅkya	katham punar mānasam vilīyate iti āśaṅkya 
SA_MB_saandilyopanisatHK-455	pratyagabhinnabrahmagocarayogajñānābhyāṃ mānasaṃ vilīyata iti	                          iti 
SA_MB_saandilyopanisatHK-456	sadṛṣṭāntamāha- dvāviti | yogastu svātiriktāstitvagocarataccittavṛttirodhaḥ,	sa dṛṣṭāntam āha dvau iti yogaḥ tu sva atirikta astitva gocara tad citta vṛtti rodhaḥ 
SA_MB_saandilyopanisatHK-457	jñānaṃ brahmātiriktaṃ na kiṃcidastīti samyagavekṣaṇam || 24 || yaḥ	jñānam brahma atiriktam na kiṃcid asti iti samyak avekṣaṇam yaḥ 
SA_MB_saandilyopanisatHK-458	svātiriktamastīti bhrama udeti tasmin | saṃsāre sati kathaṃ manaḥ	sva atiriktam asti iti bhramaḥ udeti tasmin saṃsāre sati katham manaḥ 
SA_MB_saandilyopanisatHK-459	śāmyatītyatra- mana iti | manaḥspandopaśāntyāyāmityasya	śāmyati iti atra manaḥ iti manaḥ spanda upaśāntyāyām iti asya 
SA_MB_saandilyopanisatHK-460	manaḥspandopaśāntāvityarthaḥ | manaḥspandopaśāntyāyam ityakaṃ	manaḥ spanda upaśāntau iti arthaḥ manaḥ spanda upaśāntyā ayam iti akam 
SA_MB_saandilyopanisatHK-461	pāṭhāntaramapi vartate | saṃsāraḥ pravilīyate, saṃsārasya	pāṭha antaram api vartate saṃsāraḥ pravilīyate saṃsārasya 
SA_MB_saandilyopanisatHK-462	manaḥkalpitatvāt kalpakābhāve kalpyābhāvo yujyate ityarthaḥ || 25 || atra	manaḥ kalpita tvāt kalpaka abhāve kalpya abhāvaḥ yujyate iti arthaḥ       atra 
SA_MB_saandilyopanisatHK-463	dṛṣṭāntaḥ- sūryeti ||	dṛṣṭāntaḥ sūrya iti 
SA_MB_saandilyopanisatHK-464	manolayāt prāṇaspandanirodhaḥ	          
SA_MB_saandilyopanisatHK-465	śāstrasajjanasaṃparkavairāgyābhyāsayogataḥ || 26 ||	śāstra sat jana saṃparka vairāgya abhyāsa yogataḥ 
SA_MB_saandilyopanisatHK-466	anāsthāyāṃ kṛtāsthāyāṃ pūrvaṃ saṃsāravṛttiṣu |	anāsthāyām kṛtāsthāyām pūrvam saṃsāra vṛttiṣu 
SA_MB_saandilyopanisatHK-467	yathābhivāñchitadhyānācciramekatayoditāt || 27 ||	yathā abhivāñchita dhyānāt ciram eka tayā uditāt 
SA_MB_saandilyopanisatHK-468	ekatattvadṛḍhābhyāsāt prāṇaspando nirudhyate |	eka tattva dṛḍha abhyāsāt prāṇa spandaḥ nirudhyate 
SA_MB_saandilyopanisatHK-469	svājñānavikalpitamanaḥspandasya prāṇaspandanapūrvakatvāt | yata	sva ajñāna vikalpita manaḥ spandasya prāṇa spandana pūrvaka tvāt yata 
SA_MB_saandilyopanisatHK-470	evamataḥ tacchāntāvupāya ucyate- śāstreti || 26 || anāsthāyāṃ	evam atas tad śāntau upāyaḥ ucyate śāstra iti      anāsthāyām 
SA_MB_saandilyopanisatHK-471	nivṛttimārge	nivṛtti mārge 
SA_MB_saandilyopanisatHK-472	p. 540) kṛtāsthāyāṃ satyāṃ brahma satyaṃ jagat mithyeti jñānamudeti |	kṛtāsthāyām satyām brahma satyam jagat mithyā iti jñānam udeti 
SA_MB_saandilyopanisatHK-473	tataḥ yatheti || 27 ||	tatas yathā iti 
SA_MB_saandilyopanisatHK-474	prāṇaspandanirodhāt manaḥspandanirodhaḥ	          
SA_MB_saandilyopanisatHK-475	pūrakādyanilāyāmād dṛḍhābhyāsādakhedajāt || 28 ||	pūraka ādi anila āyāmāt dṛḍha abhyāsāt akheda jāt 
SA_MB_saandilyopanisatHK-476	ekāntadhyānayogācca manaḥspando nirudhyate |	ekānta dhyāna yogāt ca manaḥ spandaḥ nirudhyate 
SA_MB_saandilyopanisatHK-477	manaḥspandaśāntiḥ kathamityatra- pūraketi || 28 ||	manaḥ spanda śāntiḥ katham iti atra pūraka iti 
SA_MB_saandilyopanisatHK-478	prāṇaspandaśāntisamakālaṃ mana iti ||	prāṇa spanda śānti sama kālam manaḥ iti 
SA_MB_saandilyopanisatHK-479	prāṇaspandanirodhavividhopāyāḥ	            
SA_MB_saandilyopanisatHK-480	oṃkāroccāraṇaprāntaśabdatattvānubhāvanāt |	oṃkāra uccāraṇa prānta śabda tattva anubhāvanāt 
SA_MB_saandilyopanisatHK-481	suṣupte saṃvido jāte prāṇaspando nirudhyate || 29 ||	suṣupte saṃvidaḥ jāte prāṇa spandaḥ nirudhyate 
SA_MB_saandilyopanisatHK-482	tālumūlagatāṃ yatnājjihvayākramya ghaṇṭikām |	tālu mūla gatām yatnāt jihvayā ākramya ghaṇṭikām 
SA_MB_saandilyopanisatHK-483	ūrdhvarandhraṃ gate prāṇe prāṇaspando nirudhyate || 30 ||	ūrdhva randhram gate prāṇe prāṇa spandaḥ nirudhyate 
SA_MB_saandilyopanisatHK-484	prāṇe galitasaṃvittau tālūrdhvadvādaśāntage |	prāṇe galita saṃvittau tālu ūrdhva dvādaśānta ge 
SA_MB_saandilyopanisatHK-485	abhyāsādūrdhvarandhreṇa prāṇaspando nirudhyate || 31 ||	abhyāsāt ūrdhva randhreṇa prāṇa spandaḥ nirudhyate 
SA_MB_saandilyopanisatHK-486	dvādaśāṅgulaparyante nāsāgre vimalāmbare |	dvādaśa aṅgula paryante nāsā agre vimala ambare 
SA_MB_saandilyopanisatHK-487	saṃviddṛśi prāśāmyantyāṃ prāṇaspando nirudhyate || 32 ||	saṃvid dṛśi prāśāmyantyām prāṇa spandaḥ nirudhyate 
SA_MB_saandilyopanisatHK-488	bhrūmadhye tārakālokaśāntāvantamupāgate |	bhrū madhye tārakā loka śāntāvantam upāgate 
SA_MB_saandilyopanisatHK-489	caitanaikatane baddhe prāṇaspando nirudhyate || 33 ||	caitana ekatane baddhe prāṇa spandaḥ nirudhyate 
SA_MB_saandilyopanisatHK-490	omityeva yadudbhūtaṃ jñānaṃ jñeyātmakaṃ śivam |	om iti eva yat udbhūtam jñānam jñeya ātmakam śivam 
SA_MB_saandilyopanisatHK-491	asaṃspṛṣṭavikārāṃśaṃ prāṇaspando nirudhyate || 34 ||	a saṃspṛṣṭa vikāra aṃśam prāṇa spandaḥ nirudhyate 
SA_MB_saandilyopanisatHK-492	p. 541) cirakālaṃ hṛdekāntavyomasaṃvedanānmune |	cira kālam hṛd ekānta vyoma saṃvedanāt mune 
SA_MB_saandilyopanisatHK-493	avāsanamanodhyānāt prāṇaspando nirudhyate || 35 ||	            
SA_MB_saandilyopanisatHK-494	ebhiḥ kramaistathānyaiśca nānāsaṃkalpakalpitaiḥ |	ebhiḥ kramaiḥ tathā anyaiḥ ca nānā saṃkalpa kalpitaiḥ 
SA_MB_saandilyopanisatHK-495	nānādeśikavaktrasthaiḥ prāṇaspando nirudyate || 36 ||	nānā deśika vaktra sthaiḥ prāṇa spandaḥ nirudyate 
SA_MB_saandilyopanisatHK-496	plutapraṇavānusaṃdhānenāpi prāṇaspando nirudhyata ityāha-	pluta praṇava anusaṃdhānena api prāṇa spandaḥ nirudhyate iti āha 
SA_MB_saandilyopanisatHK-497	oṃkāreti | oṃkāra - - - bhavanāt kāṃsyaghaṇṭāninādavat	oṃkāra iti oṃkāra bhavanāt kāṃsya ghaṇṭā nināda vat 
SA_MB_saandilyopanisatHK-498	praṇavanādānusaṃdhānāt | bāhyāntarbhavasaṃvido viṣayajñānatateḥ	                          
SA_MB_saandilyopanisatHK-499	suṣupte jāte sati atha prāṇeti || 29 || lambikayāpi prāṇaspandaśāntiḥ	suṣupte jāte sati atha prāṇa iti    api        
SA_MB_saandilyopanisatHK-500	syādityāha- tālviti | tadupāyataḥ ūrdhvarandhraṃ gate || 30 ||	syāt iti āha tālu iti tad upāyataḥ ūrdhva randhram gate  /
SA_MB_saandilyopanisatHK-501	rājayogābhyāsapāṭavataḥ prāṇa iti | ṣaṇmukhīmudrayā galitasaṃvittau	                                                                                   
SA_MB_saandilyopanisatHK-502	vigalitabāhyāntaḥ saṃvitkalanāyāṃ satyām abhyāsāt	vigalita bāhya antar saṃvid kalanāyām satyām abhyāsāt 
SA_MB_saandilyopanisatHK-503	tālūrdhvarandhreṇa prāṇe tālūrdhvavilasitadvādaśāntaṃ	tālu ūrdhva randhreṇa prāṇe tālu ūrdhva vilasita dvādaśāntam 
SA_MB_saandilyopanisatHK-504	sahasrāracakraṃ gate sati atha prāṇeti || 31 || bahiḥkumbhakenāpi	sahasrāra cakram gate sati atha prāṇa iti bahis kumbhakena api 
SA_MB_saandilyopanisatHK-505	prāṇajayaḥ syādityāha- dvādaśeti | saṃviddṛśi prāśāmyantyāṃ	prāṇa jayaḥ syāt iti āha dvādaśa iti saṃvid dṛśi prāśāmyantyām 
SA_MB_saandilyopanisatHK-506	svātiriktaviṣayavṛttau nāṣṭāyām || 32 || tārakānusaṃdhānato'pi	sva atirikta viṣaya vṛttau nāṣṭāyām tāraka anusaṃdhānataḥ api 
SA_MB_saandilyopanisatHK-507	bhrūmadhye | tārakālokanaśāntau satyām | tārakālokanaṃ kartavyamiti	bhrū madhye tāraka ālokana śāntau satyām tāraka ālokanam kartavyam iti 
SA_MB_saandilyopanisatHK-508	saṃkalpe antamupāgate atha manasi cetanaikatāne, cetane pratīci ekatāne	saṃkalpe antam upāgate atha manasi cetanā ekatāne cetane pratīci ekatāne 
SA_MB_saandilyopanisatHK-509	baddhe ekatānatayā baddhe manonmanībhāvaṃ gate sati, atha prāṇeti || 33 ||	baddhe ekatāna tayā baddhe manonmanībhāvam gate sati atha prāṇa iti 
SA_MB_saandilyopanisatHK-510	brahmajñānenāpi prāṇaspandaśāntiḥ syādityāha- omiti | tadeva cāhaṃ	brahma jñānena api prāṇa spanda śāntiḥ syāt iti āha om iti tat eva ca aham 
SA_MB_saandilyopanisatHK-511	sakalaṃ vimukta omiti	sakalam vimukte om iti 
SA_MB_saandilyopanisatHK-512	oṃkārārthavicāraṇasaṃjātāsaṃspṛṣṭavikārāṃśajñānasamakālaṃ	oṃkāra artha vicāraṇa saṃjāta a saṃspṛṣṭa vikāra aṃśa jñāna sama kālam 
SA_MB_saandilyopanisatHK-513	prāṇeti || 34 || dhyānāt vāsanākṣayācca prāṇaspandaśāntiḥ	prāṇa iti                     
SA_MB_saandilyopanisatHK-514	syādityāha- cireti | hṛdā ekāntavyomasaṃvedanāt cidvyomātiriktaṃ na	syāt iti āha cira iti hṛdā ekānta vyoma saṃvedanāt cit vyoma atiriktam na 
SA_MB_saandilyopanisatHK-515	kiṃcidasti iti jñānāt vāsanā kṣīyate | tato dhyeyaikagocaraṃ mano bhavati	kiṃcid asti iti jñānāt vāsanā kṣīyate tatas dhyeya eka gocaram manaḥ bhavati 
SA_MB_saandilyopanisatHK-516	| prāṇaspandaśāntiḥ bhavedityarthaḥ || 35 || uktairanuktairvā upāyaiḥ	                                                         
SA_MB_saandilyopanisatHK-517	cirānuṣṭitaiḥ prāṇaspandaśāntiḥ syādityāha- ebhiriti || 36 ||	cira anuṣṭitaiḥ prāṇa spanda śāntiḥ syāt iti āha ebhiḥ iti 
SA_MB_saandilyopanisatHK-518	"p. 542) 	kumbhakena suṣumnābhedanadvārā paramapadagamanam"	kumbhakena suṣumnā bhedana dvārā parama pada gamanam 
SA_MB_saandilyopanisatHK-519	ākuñcanena kuṇḍalinyāḥ kavāṭamudghāṭya mokṣadvāraṃ	ākuñcanena kuṇḍalinyāḥ kavāṭam udghāṭya mokṣadvāram 
SA_MB_saandilyopanisatHK-520	vibhedayet || 36-1 || yena mārgeṇa gantavyaṃ taddvāraṃ mukhenācchādya	vibhedayet     yena mārgeṇa gantavyam tat dvāram mukhena ācchādya 
SA_MB_saandilyopanisatHK-521	prasuptā kuṇḍalinī kuṭilākārā sarpavadveṣṭitā bhavati || 36-2 || sā	prasuptā kuṇḍalinī kuṭila ākārā sarpa vat veṣṭitā bhavati       
SA_MB_saandilyopanisatHK-522	śaktiryena cālitā syāt sa tu mukto bhavati | sā kuṇḍalinī	śaktiḥ yena cālitā syāt sa tu muktaḥ bhavati sā kuṇḍalinī 
SA_MB_saandilyopanisatHK-523	kaṇṭhordhvabhāge suptā cedyogināṃ muktaye bhavati | bandhanāyādho	kaṇṭha ūrdhva bhāge suptā ced yoginām muktaye bhavati bandhanāya adhas 
SA_MB_saandilyopanisatHK-524	mūḍhānām || 36-3 || iḍādimārgadvayaṃ vihāya suṣumnāmārgeṇa	mūḍhānām 
SA_MB_saandilyopanisatHK-525	gacchet tadviṣṇoḥ paramaṃ padam || 36-4 ||	gacchet tat viṣṇoḥ paramam padam 
SA_MB_saandilyopanisatHK-526	prāṇaspandanirodhalakṣaṇakevalakumbhakato yogī kuṇḍalinyā	                   
SA_MB_saandilyopanisatHK-527	suṣumnāvadanaṃ bhedayedityāha- ākuñcaneneti | suṣumnākavāṭam |	suṣumnā vadanam bhedayet iti āha ākuñcanena iti suṣumnā kavāṭam 
SA_MB_saandilyopanisatHK-528	mokṣadvāraṃ brahmarandhraṃ vibhedayet || 36-1 ||	        
SA_MB_saandilyopanisatHK-529	mokṣadvārabhedakakuṇḍalinīsvarūpaṃ taccālanaphalaṃ cāha- yeneti ||	                                                                             
SA_MB_saandilyopanisatHK-530	36-2,3 || yat evam ataḥ iḍādīti | suṣumnāyāḥ viṣṇupadāptidvāratvāt ||	yat evam atas iḍā ādi iti suṣumnāyāḥ viṣṇu pada āpti dvāra tvāt 
SA_MB_saandilyopanisatHK-531	manoyuktaprāṇasya susumnāpraveśanavidhiḥ	             
SA_MB_saandilyopanisatHK-532	marudabhyasanaṃ sarvaṃ manoyuktaṃ samabhyaset |	marut abhyasanam sarvam manaḥ yuktam samabhyaset 
SA_MB_saandilyopanisatHK-533	itaratra na kartavyā manovṛttirmanīṣiṇā || 37 ||	itaratra na kartavyā manīṣiṇā 
SA_MB_saandilyopanisatHK-534	divā na pūjayedviṣṇuṃ rātrau naiva prapūjayet |	divā na pūjayet viṣṇum rātrau na eva prapūjayet 
SA_MB_saandilyopanisatHK-535	satataṃ pūjayedviṣṇuṃ divārātraṃ na pūjayet || 38 ||	satatam pūjayet viṣṇum divārātram na pūjayet 
SA_MB_saandilyopanisatHK-536	manoyogābhyāsaḥ phalavānityarthaḥ || 37 || manoyuktaprāṇam	manas yoga abhyāsaḥ phalavān iti arthaḥ manaḥ yukta prāṇam 
SA_MB_saandilyopanisatHK-537	iḍādimārgadvayamaprāpayitvā mahāpathavyāpṛtaṃ kuryādityāha-	iḍā ādi mārga dvayam a prāpayitvā mahāpatha vyāpṛtam kuryāt iti āha 
SA_MB_saandilyopanisatHK-538	diveti | manoyogato viṣṇuṃ prāṇaṃ	divā iti manaḥ yogataḥ viṣṇum prāṇam 
SA_MB_saandilyopanisatHK-539	p. 543) divā sūryanāḍyāṃ na pūjayet na vyāpārayet | tathā	divā sūryanāḍyām na pūjayet na vyāpārayet tathā 
SA_MB_saandilyopanisatHK-540	candranāḍyāṃ rātrau naiva prapūjayet | tataḥ avyākṛtākāśaṃ tena	candranāḍyām rātrau na eva prapūjayet tatas avyākṛta ākāśam tena 
SA_MB_saandilyopanisatHK-541	pūritaṃ satataṃ suṣumnākhyaṃ mahāpathaṃ prati viṣṇuṃ pūjayet |	pūritam satatam suṣumna ākhyam mahā patham prati viṣṇum pūjayet 
SA_MB_saandilyopanisatHK-542	kadāpi divārātraṃ na pūjayedityarthaḥ || 38 ||	kadāpi divārātram na pūjayet iti arthaḥ   
SA_MB_saandilyopanisatHK-543	khecarīmudrāprāptiḥ	          
SA_MB_saandilyopanisatHK-544	suṣiro jñānajanakaḥ pañcasrotaḥsamanvitaḥ |	              
SA_MB_saandilyopanisatHK-545	tiṣṭhate khecarī mudrā tvaṃ hi śāṇḍilya tāṃ bhaja || 39 ||	tiṣṭhate khecarī mudrā tvam hi śāṇḍilya tām bhaja  /
SA_MB_saandilyopanisatHK-546	savyadakṣiṇanāḍīstho madhye carati mārutaḥ |	savya dakṣiṇa nāḍī sthaḥ madhye carati mārutaḥ 
SA_MB_saandilyopanisatHK-547	tiṣṭhate khecarī mudrā tasmin sthāne na saṃśayaḥ || 40 ||	tiṣṭhate khecarī mudrā tasmin sthāne na saṃśayaḥ 
SA_MB_saandilyopanisatHK-548	iḍāpiṅgalayormadhye śūnyaṃ caivālinaṃ graset |	iḍā piṅgalayoḥ madhye śūnyam ca eva alinam graset 
SA_MB_saandilyopanisatHK-549	tiṣṭhantī khecarī mudrā tatra satyaṃ pratiṣṭhitam || 41 ||	tiṣṭhantī khecarī mudrā tatra satyam pratiṣṭhitam 
SA_MB_saandilyopanisatHK-550	somasūryadvayormadhye nirālambatale punaḥ |	soma sūrya dvayoḥ madhye nirālamba tale punar 
SA_MB_saandilyopanisatHK-551	saṃsthitā vyomacakre sā mudrā nāma ca khecarī || 42 ||	saṃsthitā vyomacakre sā mudrā nāma ca khecarī 
SA_MB_saandilyopanisatHK-552	suṣumnāpraveśataḥ kiṃ syādityāśaṅkya tatra khecarīmudrā	suṣumnā praveśataḥ kim syāt iti āśaṅkya tatra khecarī mudrā 
SA_MB_saandilyopanisatHK-553	vartate tatsākṣātkārāt kṛtakṛtyo bhavasītyāha- suṣira iti | yatra	vartate tad sākṣātkārāt kṛtakṛtyaḥ bhavasi iti āha suṣire iti yatra 
SA_MB_saandilyopanisatHK-554	suṣumnāmadhye suṣiraḥ virāḍāditurīyātītāntapañcasrotassamanvitaḥ	suṣumnā madhye suṣiraḥ virāj ādi turīya atīta anta pañca srotaḥ samanvitaḥ 
SA_MB_saandilyopanisatHK-555	san mūlādhārānāhatājñāsahasrāreṣu yoginaḥ krameṇa	sat mūlādhāra an āhata ājñā sahasra āreṣu yoginaḥ krameṇa 
SA_MB_saandilyopanisatHK-556	virāḍādijñānajanako bhavati tatraiva khecarīmudrā nirvikalpakarūpiṇī	virāṭ ādi jñāna janakaḥ bhavati tatra eva khecarī mudrā nirvikalpaka rūpiṇī 
SA_MB_saandilyopanisatHK-557	vartate | matprasādataḥ tāṃ tvaṃ bhajetyarthaḥ || 39 || uktārthameva punaḥ	vartate mad prasādataḥ tām tvam bhaja iti arthaḥ    ukta artham eva punar 
SA_MB_saandilyopanisatHK-558	punaḥ śabdāntareṇa viśadayati- savyeti || 40 || śūnyaśabdena	punar śabda antareṇa viśadayati savya iti   / śūnya śabdena 
SA_MB_saandilyopanisatHK-559	avyākṛtamākāśamucyate, ākāśasya vāyugrāsatvāt || 41 ||	avyākṛtam ākāśam ucyate ākāśasya vāyu grāsa tvāt 
SA_MB_saandilyopanisatHK-560	vyomacakrasya nirālambatvāt || 42 ||	       
SA_MB_saandilyopanisatHK-561	"p. 544) 		bāhyakhecarīsiddhyupāyaḥ"	         
SA_MB_saandilyopanisatHK-562	chedanacālanadohaiḥ kalāṃ parāṃ jihvāṃ kṛtvā dṛṣṭiṃ	chedana cālana dohaiḥ kalām parām jihvām kṛtvā dṛṣṭim 
SA_MB_saandilyopanisatHK-563	bhrūmadhye sthāpya kapālakuhare jihvā viparītagā yadā bhavati tadā	bhrū madhye sthāpya kapāla kuhare jihvā viparīta gā yadā bhavati tadā 
SA_MB_saandilyopanisatHK-564	khecarī mudrā jāyate | jihvā cittaṃ ca khecarati | tenordhvajihraḥ	khecarī mudrā jāyate jihvā cittam ca khecarati tena ūrdhvajihraḥ 
SA_MB_saandilyopanisatHK-565	pumānamṛto bhavati || 42-1 ||	pumān amṛtaḥ bhavati 
SA_MB_saandilyopanisatHK-566	bāhyakhecarīsiddhyupāyamāha- chedaneti | pratibhānuvāsaraṃ	bāhyakhecarī siddhi upāyam āha chedana iti pratibhānu vāsaram 
SA_MB_saandilyopanisatHK-567	ṣaṇmāsāvadhi snuhipatranibhaśastreṇa romamātraṃ jihvāsirācchedanena	ṣaṣ māsa avadhi snuhi patra nibha śastreṇa roma mātram jihvā sirā chedanena 
SA_MB_saandilyopanisatHK-568	pratibrāhme muhūrte jihvācālanataḥ prātaḥ saindhavapathyācūrṇato	pratibrāhme muhūrte jihvā cālanataḥ prātar saindhava pathyā cūrṇataḥ 
SA_MB_saandilyopanisatHK-569	dohaiḥ kalāṃ parāṃ sūkṣmāṃ jihvāṃ kṛtvā dṛṣṭiyugmaṃ	dohaiḥ kalām parām sūkṣmām jihvām kṛtvā dṛṣṭi yugmam 
SA_MB_saandilyopanisatHK-570	bhrūmadhye sthāpya ghaṇṭikārandhreṇa kapālakuhare jihvā viparītagā	bhrū madhye sthāpya ghaṇṭikā randhreṇa kapāla kuhare jihvā viparīta gā 
SA_MB_saandilyopanisatHK-571	yadā bhavati tadā khecarīmudrā udeti | sahasrārajihvāpraveśato yogī	yadā bhavati tadā khecarī mudrā udeti sahasrāra jihvā praveśataḥ yogī 
SA_MB_saandilyopanisatHK-572	kṛtakṛtyo bhavatītyarthaḥ || 42-1 ||	kṛtakṛtyaḥ bhavati iti arthaḥ 
SA_MB_saandilyopanisatHK-573	abhyāsakāle prāṇajayopāyaḥ	abhyāsa kāle prāṇa jaya upāyaḥ 
SA_MB_saandilyopanisatHK-574	vāmapādamūlena yoniṃ saṃpīḍya dakṣiṇapādaṃ prasārya taṃ	vāma pāda mūlena yonim saṃpīḍya dakṣiṇa pādam prasārya tam 
SA_MB_saandilyopanisatHK-575	karābhyāṃ dhṛtvā nāsābhyāṃ vāyumāpūrya kaṇṭhabandhaṃ	karābhyām dhṛtvā nāsābhyām vāyum āpūrya kaṇṭha bandham 
SA_MB_saandilyopanisatHK-576	samāropyordhvato vāyuṃ dhārayet | tena sarvakleśahāniḥ | tataḥ	samāropya ūrdhvatas vāyum dhārayet tena sarva kleśa hāniḥ tatas 
SA_MB_saandilyopanisatHK-577	pīyūṣamiva viṣaṃ jīryate | kṣayagulmagudāvartajīrṇatvagādidoṣā	pīyūṣam iva viṣam jīryate kṣaya gulma gudāvarta jīrṇa tvac ādi doṣā 
SA_MB_saandilyopanisatHK-578	naśyanti | eṣa prāṇajayopāyaḥ sarvamṛtyūpaghātakaḥ || 42-2 ||	naśyanti eṣa prāṇa jaya upāyaḥ sarva mṛtyu upaghātakaḥ   /
SA_MB_saandilyopanisatHK-579	abhyāsakāle prāṇajayopāyamāha- vāmeti | mahāmudrābhyāsena	abhyāsa kāle prāṇa jaya upāyam āha vāma iti mahāmudrā abhyāsena 
SA_MB_saandilyopanisatHK-580	tena || 42-2 ||	tena 
SA_MB_saandilyopanisatHK-581	"p. 545) 		svātmāparokṣasiddhyupāyaḥ"	          
SA_MB_saandilyopanisatHK-582	vāmapādapārṣṇi yonisthāne niyojya dakṣiṇacaraṇaṃ vāmorupari	vāma pāda pārṣṇi yoni sthāne niyojya dakṣiṇa caraṇam vāma ūru upari 
SA_MB_saandilyopanisatHK-583	saṃsthāpya vāyumāpūrya hṛdaye cubukaṃ nidhāya yonimākuñcya	saṃsthāpya vāyum āpūrya hṛdaye cubukam nidhāya yonim ākuñcya 
SA_MB_saandilyopanisatHK-584	manomadhye yathāśakti dhārayitvā svātmānaṃ bhāvayet |	manaḥ madhye yathāśakti dhārayitvā sva ātmānam bhāvayet 
SA_MB_saandilyopanisatHK-585	tenāparokṣasiddhiḥ || 42-3 ||	tena aparokṣa siddhiḥ   
SA_MB_saandilyopanisatHK-586	svātmāparokṣasiddhyupāyamāha- vāmeti | svātmānaṃ	sva ātma aparokṣa siddhi upāyam āha vāma iti sva ātmānam 
SA_MB_saandilyopanisatHK-587	brahmāhamasmīti bhāvayet | siddhiḥ bhavati || 42-3 ||	brahmā aham asmi iti bhāvayet siddhiḥ bhavati 
SA_MB_saandilyopanisatHK-588	sarvarogavinirmokasādhanaṃ dhāraṇāviśeṣaḥ	             
SA_MB_saandilyopanisatHK-589	bāhyāt prāṇaṃ samākṛṣya pūrayitvodare sthitam |	bāhyāt prāṇam samākṛṣya pūrayitvā udare sthitam 
SA_MB_saandilyopanisatHK-590	nābhimadhye ca nāsāgre pādāṅguṣṭhe ca yatnataḥ || 43 ||	nābhi madhye ca nāsā agre pādāṅguṣṭhe ca yatnatas 
SA_MB_saandilyopanisatHK-591	dhārayenmanasā prāṇaṃ saṃdhyākāleṣu vā sadā |	dhārayet manasā prāṇam saṃdhyā kāleṣu vā sadā 
SA_MB_saandilyopanisatHK-592	sarvarogavinirmukto bhavedyogī gataklamaḥ || 44 ||	sarva roga vinirmuktaḥ bhavet yogī gata klamaḥ 
SA_MB_saandilyopanisatHK-593	dhāraṇāviśeṣamāha- bāhyāditi || 43-44 ||	dhāraṇā viśeṣam āha bāhyāt iti 
SA_MB_saandilyopanisatHK-594	nāsāgrādiṣu saṃyamena vividhasiddhayaḥ	nāsā agra ādiṣu saṃyamena vividha siddhayaḥ 
SA_MB_saandilyopanisatHK-595	nāsāgre vāyuvijayaṃ bhavati | nābhimadhye sarvarogavināśaḥ |	nāsā agre vāyu vijayam bhavati nābhi madhye sarva roga vināśaḥ 
SA_MB_saandilyopanisatHK-596	pādāṅguṣṭhadhāraṇāccharīralaghutā bhavati || 44-1 ||	pādāṅguṣṭha dhāraṇāt śarīra laghu tā bhavati 
SA_MB_saandilyopanisatHK-597	rasanādvāyumākṛṣya yaḥ pibet satataṃ naraḥ |	rasanāt vāyum ākṛṣya yaḥ pibet satatam naraḥ 
SA_MB_saandilyopanisatHK-598	śramadāhau tu na syātāṃ naśyanti vyādhayastathā || 45 ||	śrama dāhau tu na syātām naśyanti vyādhayaḥ tathā 
SA_MB_saandilyopanisatHK-599	saṃdhyayorbrāhmaṇaḥ kāle vāyumākṛṣya yaḥ pibet |	saṃdhyayoḥ brāhmaṇaḥ kāle vāyum ākṛṣya yaḥ pibet 
SA_MB_saandilyopanisatHK-600	trimāsāt tasya kalyāṇī jāyate vāk sarasvatī || 46 ||	tri māsāt tasya kalyāṇī jāyate vāc sarasvatī  /
SA_MB_saandilyopanisatHK-601	p. 546) evaṃ ṣaṇmāsābhyāsāt sarvaroganivṛttiḥ |	evam ṣaṣ māsa abhyāsāt sarva roga nivṛttiḥ 
SA_MB_saandilyopanisatHK-602	jihvayā vāyumānīya jihvāmūle nirodhayet |	jihvayā vāyum ānīya jihvā mūle nirodhayet 
SA_MB_saandilyopanisatHK-603	yaḥ pibedamṛtaṃ vidvān sakalaṃ bhadramaśnute || 47 ||	yaḥ pibet amṛtam vidvān sakalam bhadram aśnute  /
SA_MB_saandilyopanisatHK-604	ātmanyātmānamiḍayā dhārayitvā bhruvo'ntare |	ātmani ātmānam iḍayā dhārayitvā bhruvoḥ ntare 
SA_MB_saandilyopanisatHK-605	vibhedya tridaśāhāraṃ vyādhistho'pi vimucyate || 48 ||	vibhedya tridaśa āhāram vyādhi sthaḥ upi vimucyate  /
SA_MB_saandilyopanisatHK-606	nāḍībhyāṃ vāyumāropya nābhau tundasya pārśvayoḥ |	nāḍībhyām vāyum āropya nābhau tundasya pārśvayoḥ 
SA_MB_saandilyopanisatHK-607	ghaṭikaikāṃ bahedyastu vyādhibhiḥ sa vimucyate || 49 ||	ghaṭikā ekām bahet yaḥ tu vyādhibhiḥ sa vimucyate 
SA_MB_saandilyopanisatHK-608	māsamekaṃ trisaṃdhyaṃ tu jihvayāropya mārutam |	māsam ekam tri saṃdhyam tu jihvayā āropya mārutam 
SA_MB_saandilyopanisatHK-609	vibhedya tridaśāhāraṃ dhārayettundamadhyame || 50 ||	vibhedya tridaśa āhāram dhārayet tunda madhyame 
SA_MB_saandilyopanisatHK-610	jvarāḥ sarve vinaśyanti viṣāṇi vividhāni ca |	jvarāḥ sarve vinaśyanti viṣāṇi vividhāni ca 
SA_MB_saandilyopanisatHK-611	muhūrtamapi yo nityaṃ nāsāgre manasā saha || 51 ||	muhūrtam api yaḥ nityam nāsā agre manasā saha 
SA_MB_saandilyopanisatHK-612	sarvaṃ tarati pāṣmānaṃ tasya janmaśatārjitam |	sarvam tarati pāṣmānam tasya janma śata arjitam 
SA_MB_saandilyopanisatHK-613	tārasaṃyamāt sakalaviṣayajñānaṃ bhavati | nāsāgre	              
SA_MB_saandilyopanisatHK-614	cittasaṃyamādindralokajñānam | tadadhaścittasaṃyamādagnilokajñānam	citta saṃyamāt indra loka jñānam tad adhas citta saṃyamāt agni loka jñānam 
SA_MB_saandilyopanisatHK-615	| cakṣuṣi cittasaṃyamāt sarvalokajñānam | śrotre cittasya	cakṣuṣi citta saṃyamāt sarva loka jñānam śrotre cittasya 
SA_MB_saandilyopanisatHK-616	saṃyamādyamalokajñānam | tatpārśve saṃyamānnir-ṛtilokajñānam |	saṃyamāt yama loka jñānam tad pārśve saṃyamāt nirṛti loka jñānam 
SA_MB_saandilyopanisatHK-617	pṛṣṭhabhāge saṃyamādvaruṇalokajñānam | vāmakarṇe	pṛṣṭha bhāge saṃyamāt varuṇa loka jñānam vāma karṇe 
SA_MB_saandilyopanisatHK-618	saṃyamādvāyulokajñānam | kaṇṭhe saṃyamāt somalokajñānam |	saṃyamāt vāyu loka jñānam kaṇṭhe saṃyamāt soma loka jñānam 
SA_MB_saandilyopanisatHK-619	vāmacakṣuṣi saṃyamācchivalokajñānam | mūrdhni	            
SA_MB_saandilyopanisatHK-620	saṃyamādbrahmalokajñānam | pādādhobhāge	saṃyamāt brahma loka jñānam pāda adhobhāge 
SA_MB_saandilyopanisatHK-621	saṃyamādatalalokajñānam | pāde saṃyamādvitalalokajñānam |	              
SA_MB_saandilyopanisatHK-622	pādasaṃdhau saṃyamānnitalalokajñānam | jaṅghe	            
SA_MB_saandilyopanisatHK-623	saṃyamātsutalalokajñānam | jānau saṃyamānmahātalalokajñānam |	saṃyamāt sutala loka jñānam jānau saṃyamāt mahātala loka jñānam 
SA_MB_saandilyopanisatHK-624	ūrau cittasaṃyamādrasātalalokajñānam |	ūrau citta saṃyamāt rasātala loka jñānam 
SA_MB_saandilyopanisatHK-625	p. 547) kaṭau cittasaṃyamāttalātalalokajñānam | nābhau	            
SA_MB_saandilyopanisatHK-626	cittasaṃyamādbhūlokajñānam | kukṣau saṃyamādbhuvarlokajñānam |	              
SA_MB_saandilyopanisatHK-627	hṛdi cittasaṃyamāt svarlokajñānam | hṛdayordhvabhāge	                      
SA_MB_saandilyopanisatHK-628	cittasaṃyamānmaharlokajñānam | kaṇṭhe cittasaṃyamājjanolokajñānam	                            
SA_MB_saandilyopanisatHK-629	| bhrūmadhye cittasaṃyamāttapolokajñānam | mūrdhni cittasaṃyamāt	                                        
SA_MB_saandilyopanisatHK-630	satyalokajñānam | dharmādharmasaṃyamādatītānāgatajñānam |	satya loka jñānam dharma adharma saṃyamāt atīta anāgata jñānam 
SA_MB_saandilyopanisatHK-631	tattajantudhvanau cittasaṃyamāt sarvajanturutajñānam | saṃcitakarmaṇi	tad tad jantu dhvanau citta saṃyamāt sarva jantu ruta jñānam saṃcita karmaṇi 
SA_MB_saandilyopanisatHK-632	cittasaṃyamāt pūrvajātijñānam | paracitte cittasaṃyamāt	                    
SA_MB_saandilyopanisatHK-633	paracittajñānam | kāyarūpe cittasaṃyamādanyādṛśyarūpam | bale	                   
SA_MB_saandilyopanisatHK-634	cittasaṃyamāddhanumadādibalam | sūrye cittasaṃyamādbhuvanajñānam |	                         
SA_MB_saandilyopanisatHK-635	candre cittasaṃyamāttāravyūhajñānam | dhruve tadgatidarśanam |	                    
SA_MB_saandilyopanisatHK-636	svārthasaṃyamāt puruṣajñānam | nābhicakre kāyavyūhajñānam |	               
SA_MB_saandilyopanisatHK-637	kaṇṭhakūpe kṣutpipāsānivṛttiḥ | kūrmanāḍyāṃ sthairyam | tāre	                
SA_MB_saandilyopanisatHK-638	siddhadarśanam | kāyākāśasaṃyamādākāśagamanam | tattatsthāne	siddha darśanam kāya ākāśa saṃyamāt ākāśagamanam tad tad sthāne 
SA_MB_saandilyopanisatHK-639	saṃyamāttattatsiddhayo bhavanti || 52 ||	saṃyamāt tad tad siddhayaḥ bhavanti 
SA_MB_saandilyopanisatHK-640	nāsāgrādikāyākāśāntasaṃyamādvicitrasiddhayo bhavantītyāha-	nāsā agra ādi kāya ākāśa anta saṃyamāt vicitra siddhayaḥ bhavanti iti āha 
SA_MB_saandilyopanisatHK-641	nāsāgra iti | nāsāgre vāyudhāraṇāt || 44-1 || rasanāt rasanayā || 45-47 ||	nāsā agre iti nāsā agre vāyu dhāraṇāt     rasanāt rasanayā 
SA_MB_saandilyopanisatHK-642	candramaṇḍalaṃ vibhedya | tridaśāhāram amṛtaṃ pītvā || 48-50 || manasā	candra maṇḍalam vibhedya tridaśa āhāram amṛtam pītvā       
SA_MB_saandilyopanisatHK-643	saha yo lakṣyaṃ paśyati || 51 || tārasaṃyamāt tārakacittasaṃyamāt	saha yaḥ lakṣyam paśyati tāra saṃyamāt tāraka citta saṃyamāt 
SA_MB_saandilyopanisatHK-644	bhavatīti sarvatrānuvartate | jaṅghe jaṅghāyām | itthaṃbhūtasiddhiḥ	bhavati iti sarvatra anuvartate jaṅghe jaṅghāyām itthaṃbhūta siddhiḥ 
SA_MB_saandilyopanisatHK-645	puruṣārthasādhanamiti cenna, siddheḥ puruṣārthaparipanthitvāt | na hi	puruṣa artha sādhanam iti ced na siddheḥ puruṣa artha paripanthi tvāt na hi 
SA_MB_saandilyopanisatHK-646	svātirekeṇa svaparaśarīracaturdaśalokatadviṣayakajñānaṃ vāsti | tasmāt	sva atirekeṇa sva para śarīra caturdaśa loka tad viṣayaka jñānam vā asti tasmāt 
SA_MB_saandilyopanisatHK-647	mumukṣubhiḥ siddhimārgo nādartavyaḥ ityarthaḥ || 52 ||	mumukṣubhiḥ siddhi mārgaḥ na ādartavyaḥ iti arthaḥ 
SA_MB_saandilyopanisatHK-648	iti saptamaḥ khaṇḍaḥ	iti saptamaḥ khaṇḍaḥ 
SA_MB_saandilyopanisatHK-649	pañcavidhapratyāhāraḥ	pañcavidha pratyāhāraḥ 
SA_MB_saandilyopanisatHK-650	atha pratyāhāraḥ | sa pañcavidhaḥ | viṣayeṣu	atha pratyāhāraḥ sa pañcavidhaḥ viṣayeṣu 
SA_MB_saandilyopanisatHK-651	vicaratāmindriyāṇāṃ balādāharaṇaṃ pratyāhāraḥ | yadyat paśyati tat	vicaratām indriyāṇām balāt āharaṇam pratyāhāraḥ yat yat paśyati tat 
SA_MB_saandilyopanisatHK-652	sarvamātmeti pratyāhāraḥ | nityavihitakarmaphalatyāgaḥ pratyāhāraḥ |	sarvam ātmā iti pratyāhāraḥ nitya vihita karma phala tyāgaḥ pratyāhāraḥ 
SA_MB_saandilyopanisatHK-653	sarvaviṣayaparāṅmukhatvaṃ pratyāhāraḥ | aṣṭādaśasu marmasthāneṣu	sarva viṣaya parāṅmukha tvam pratyāhāraḥ aṣṭādaśasu marma sthāneṣu 
SA_MB_saandilyopanisatHK-654	kramāddhāraṇaṃ pratyāhāraḥ || 1 || pādāṅguṣṭhagulphajaṅghājānū-	kramāt dhāraṇam pratyāhāraḥ     pādāṅguṣṭha gulpha jaṅghā jānū 
SA_MB_saandilyopanisatHK-655	rupāyumeḍhranābhihṛdayakaṇṭhakūpatālunāsākṣibhrūmadhyalalāṭa-	ru pāyu meḍhra nābhi hṛdaya kaṇṭha kūpa tālu nāsā akṣi bhrū madhya lalāṭa 
SA_MB_saandilyopanisatHK-656	mūrdhni sthānāni | teṣu kramādārohāvarohakrameṇa pratyāharet || 2 ||	mūrdhni sthānāni teṣu kramāt āroha avaroha krameṇa pratyāharet   
SA_MB_saandilyopanisatHK-657	yamaniyamāsanaprāṇāyāmaprāsaṅgikaparamārthopadeśatatprati-	                                                    
SA_MB_saandilyopanisatHK-658	panthinānāvidhasiddhīḥ pratipādya atha	panthi nānāvidha siddhīḥ pratipādya atha 
SA_MB_saandilyopanisatHK-659	yogāṅgaprakṛtapratyāhāramācaṣṭe- atheti | svasvaviṣayato balāt |	yoga aṅga prakṛta pratyāhāram ācaṣṭe atha iti sva sva viṣayataḥ balāt 
SA_MB_saandilyopanisatHK-660	kramāddhāraṇaṃ, dhāraṇaṃ hāraṇaṃ saṃkramaṇaṃ pratyāhāraḥ || 1	kramāt dhāraṇam dhāraṇam hāraṇam saṃkramaṇam pratyāhāraḥ 
SA_MB_saandilyopanisatHK-661	|| marmasthānāni kānītyatra pādeti || 2 ||	marma sthānāni kāni iti atra pāda iti 
SA_MB_saandilyopanisatHK-662	ityaṣṭamaḥ khaṇḍaḥ	iti aṣṭamaḥ khaṇḍaḥ 
SA_MB_saandilyopanisatHK-663	pañcavidhāḥ dhāraṇāḥ	pañcavidhāḥ dhāraṇāḥ 
SA_MB_saandilyopanisatHK-664	atha dhāraṇāḥ | sa pañcavidhaḥ | ātmani manodhāraṇaṃ	atha dhāraṇāḥ sa pañcavidhaḥ ātmani manaḥ dhāraṇam 
SA_MB_saandilyopanisatHK-665	daharākāśe bāhyākāśadhāraṇaṃ pṛthivyaptejovāyvākāśeṣu	daharākāśe bāhya ākāśa dhāraṇam pṛthivī ap tejaḥ vāyu ākāśeṣu 
SA_MB_saandilyopanisatHK-666	pañcamūrtidhāraṇaṃ ceti ||	pañcamūrti dhāraṇam ca iti 
SA_MB_saandilyopanisatHK-667	sa pañcavidhaḥ tāḥ pañcavidhāḥ | pañcabrahma-	sa pañcavidhaḥ tāḥ pañcavidhāḥ pañcabrahma 
SA_MB_saandilyopanisatHK-668	pañcamūrtidhāraṇam ||	        
SA_MB_saandilyopanisatHK-669	iti navamaḥ khaṇḍaḥ	iti navamaḥ khaṇḍaḥ 
SA_MB_saandilyopanisatHK-670	dvividhaṃ dhyānam	dvividham dhyānam 
SA_MB_saandilyopanisatHK-671	atha dhyānam | taddvividhaṃ saguṇaṃ nirguṇaṃ ceti | saguṇaṃ	atha dhyānam tat dvividham sa guṇam nirguṇam ca iti sa guṇam 
SA_MB_saandilyopanisatHK-672	mūrtidhyānam | nirguṇamātmayāthātmyam ||	           
SA_MB_saandilyopanisatHK-673	anātmāpahnavasiddhātmamātrāvaśeṣo hi ātmayāthātmyam ||	anātma apahnava siddha ātma mātra avaśeṣaḥ hi ātma yāthātmyam 
SA_MB_saandilyopanisatHK-674	iti daśamaḥ khaṇḍaḥ	iti daśamaḥ khaṇḍaḥ 
SA_MB_saandilyopanisatHK-675	samādhisvarūpam	          
SA_MB_saandilyopanisatHK-676	atha samādhiḥ | jīvātmaparamātmaikyāvasthā tripuṭīrahitā	atha samādhiḥ jīvātma paramātma aikya avasthā tripuṭī rahitā 
SA_MB_saandilyopanisatHK-677	paramānandasvarūpā śuddhacaitanyātmikā bhavati ||	               
SA_MB_saandilyopanisatHK-678	tūlāvidyopādhiko jīvaḥ mūlāvidyopādhikaḥ paramātmā	              
SA_MB_saandilyopanisatHK-679	tayoraupādhikaviśeṣāṃśāpāyāt pratyakparaikyaṃ yasyāmābhāti	tayoḥ aupādhika viśeṣa aṃśa apāyāt pratyak para aikyam yasyām ābhāti 
SA_MB_saandilyopanisatHK-680	seyaṃ jīvātmaparamātmaikyāvasthā nirvikalpakarūpiṇītyarthaḥ |	sā iyam jīvātma paramātma aikya avasthā nirvikalpaka rūpiṇī iti arthaḥ 
SA_MB_saandilyopanisatHK-681	tripuṭyāṃ satyāṃ nirvikalpatā kuta ityata āha- tripuṭīti |	tripuṭyām satyām nirvikalpa tā kutas iti atas āha tripuṭī iti 
SA_MB_saandilyopanisatHK-682	nirvikalpakaprakṛteḥ tripuṭyādivikṛtigrāsatvāt tripuṭyabhāve duḥkharūpā	nirvikalpaka prakṛteḥ tripuṭi ādi vikṛti grāsa tvāt tripuṭī abhāve duḥkha rūpā 
SA_MB_saandilyopanisatHK-683	syādityata āha- paramānandeti | tripuṭīduḥkhagrāsanirvikalpakasthiteḥ	syāt iti atas āha paramānanda iti tripuṭī duḥkha grāsa nirvikalpaka sthiteḥ 
SA_MB_saandilyopanisatHK-684	paramānandasvarūpatvāt aikyāvasthāyā jaḍatvaṃ syādityāśaṅkya asya	                                                                             
SA_MB_saandilyopanisatHK-685	asaṃprajñātasamādhirūpatayā śuddhacaitanyatāmāha- śuddheti | atra	asaṃprajñāta samādhi rūpa tayā śuddha caitanya tām āha śuddha iti atra 
SA_MB_saandilyopanisatHK-686	jīvātmaparamātmaikyāvasthāśabdena asaṃprajñātasamādhirucyate	jīvātma paramātma aikya avasthā śabdena asaṃprajñāta samādhiḥ ucyate 
SA_MB_saandilyopanisatHK-687	ityarthaḥ ||	iti arthaḥ 
SA_MB_saandilyopanisatHK-688	ityekādaśaḥ khaṇḍaḥ	iti ekādaśaḥ khaṇḍaḥ 
SA_MB_saandilyopanisatHK-689	iti prathamo'dhyāyaḥ	iti prathamaḥ adhyāyaḥ 
SA_MB_saandilyopanisatHK-690	dvitīyo'dhyāyaḥ	dvitīyaḥ adhyāyaḥ 
SA_MB_saandilyopanisatHK-691	nirviśeṣabrahmasvarūpam	           
SA_MB_saandilyopanisatHK-692	atha ha śāṇḍilyo ha vai brahma-ṛṣiścaturṣu vedeṣu	atha ha śāṇḍilyaḥ ha vai brahma ṛṣiḥ caturṣu vedeṣu 
SA_MB_saandilyopanisatHK-693	brahmavidyāmalabhamānaḥ kiṃ nāmetyatharvāṇaṃ	brahma vidyām alabhamānaḥ kim nāma iti atharvāṇam 
SA_MB_saandilyopanisatHK-694	bhagavantamupasannaḥ papraccha adhīhi bhagavan brahmavidyāṃ yena	bhagavantam upasannaḥ papraccha adhīhi bhagavan brahma vidyām yena 
SA_MB_saandilyopanisatHK-695	śreyo'vāpsyāmīti || 1 || sa hovācātharvā śāṇḍilya satyaṃ	śreyaḥ uvāpsyāmi iti sa ha uvāca atharvā śāṇḍilya satyam 
SA_MB_saandilyopanisatHK-696	vijñānamanantaṃ brahma || 2 ||	vijñānam anantam brahma 
SA_MB_saandilyopanisatHK-697	aṣṭāṅgayogacchalena svātmatattvaṃ śrutvāpi yathāvadanadhigata-	aṣṭāṅga yoga chalena sva ātma tattvam śrutvā api yathāvat anadhigata 
SA_MB_saandilyopanisatHK-698	tayā niṣpratiyogikanirviśeṣabrahmamātrajñānabubhutsayā śāṇḍilyaḥ	tayā niṣpratiyogika nirviśeṣa brahma mātra jñāna bubhutsayā śāṇḍilyaḥ 
SA_MB_saandilyopanisatHK-699	punaḥ atharvāṇaṃ pṛcchatītyāha- atheti | vedeṣu arthato'vadhāriteṣvapi	punar atharvāṇam pṛcchati iti āha atha iti vedeṣu 
SA_MB_saandilyopanisatHK-700	niṣpratiyogikabrahmamātravidyām | kiṃ nāma brahma | papraccha- kimiti ?	niṣpratiyogika brahma mātra vidyām kim nāma brahma papraccha kim iti 
SA_MB_saandilyopanisatHK-701	adhīhi | yena tvadupadeśena || 1 || śāṇḍilyenaivaṃ pṛṣṭaḥ sa hovāca | kiṃ	adhīhi yena tvad upadeśena śāṇḍilyena evam pṛṣṭaḥ sa ha uvāca kim 
SA_MB_saandilyopanisatHK-702	nāma brahmeti praśnottaraṃ- śāṇḍilyeti | satyaṃ vijñānamanantaṃ	nāma brahma iti praśna uttaram śāṇḍilya iti satyam vijñānam anantam 
SA_MB_saandilyopanisatHK-703	brahma iti taittirīyake samyak vyākhātametat || 2 ||	brahma iti taittirīyake samyak vyākhātam etat  /
SA_MB_saandilyopanisatHK-704	brahmaṇaḥ anirdeśyatvam	brahmaṇaḥ anirdeśya tvam 
SA_MB_saandilyopanisatHK-705	yasminnidamotaṃ ca protaṃ ca yasminnidaṃ saṃca vicaiti sarvaṃ	yasmin idam otam ca protam ca yasmin idam saṃca vica eti sarvam 
SA_MB_saandilyopanisatHK-706	yasmin vijñāte sarvamidaṃ vijñātaṃ bhavati tadapāṇipādamacakṣuḥ-	yasmin vijñāte sarvam idam vijñātam bhavati tat a pāṇi pādam a cakṣuḥ 
SA_MB_saandilyopanisatHK-707	śrotramajihvamaśarīramagrāhyamanirdeśyam || 3 ||	śrotram ajihvam aśarīram agrāhyam anirdeśyam 
SA_MB_saandilyopanisatHK-708	yat sarvādhikaraṇaṃ tadanirdeśyamityāha- yasminniti | idam	yat sarva adhikaraṇam tat anirdeśyam iti āha yasmin iti idam 
SA_MB_saandilyopanisatHK-709	avidyāpadatatkāryajātaṃ yatra otaprotabhāvametya saṃca vicaiti	avidyā pada tad kārya jātam yatra otaprota bhāvam etya saṃ ca vicaiti 
SA_MB_saandilyopanisatHK-710	saṃkocavikāsatāṃ bhajati, yanmātrajñānataḥ idaṃ svātiriktaṃ neti	saṃkoca vikāsa tām bhajati yad mātra jñānataḥ idam sva atiriktam na iti 
SA_MB_saandilyopanisatHK-711	vijñātaṃ bhavati, tadetatpāṇipādādimadvyaṣṭisamaṣṭyātmakaśarīrā-	vijñātam bhavati tat etat pāṇi pāda ādima dvyaṣṭi samaṣṭi ātmaka śarīrā 
SA_MB_saandilyopanisatHK-712	pahnavasiddhaṃ tattvena nirdeṣṭumaśakyatvāt anirdeśyam || 3 ||	pahnava siddham tattvena nirdeṣṭum aśakya tvāt anirdeśyam 
SA_MB_saandilyopanisatHK-713	"p. 551)		brahmaṇaḥ āvāṅmānasagocaratvam"	brahmaṇaḥ ā vāc mānasa gocara tvam 
SA_MB_saandilyopanisatHK-714	yato vāco nivartante aprāpya manasā saha | yatkevalaṃ	yatas vācaḥ nivartante a prāpya manasā saha yat kevalam 
SA_MB_saandilyopanisatHK-715	jñānagamyam | prajñā ca yasmāt prasṛtā purāṇī | yadekamadvitīyam |	jñāna gamyam prajñā ca yasmāt prasṛtā purāṇī yat ekam advitīyam 
SA_MB_saandilyopanisatHK-716	ākāśavat sarvagataṃ susūkṣmaṃ nirañjanaṃ niṣkriyaṃ sanmātraṃ	ākāśa vat sarva gatam su sūkṣmam nirañjanam niṣkriyam sat mātram 
SA_MB_saandilyopanisatHK-717	cidānandaikarasaṃ śivaṃ praśāntamamṛtaṃ tat paraṃ ca brahma |	cit ānanda eka rasam śivam praśāntam amṛtam tat param ca brahma 
SA_MB_saandilyopanisatHK-718	tattvamasi tajjñānena hi vijānīhi || 4 ||	tat tvam asi tad jñānena hi vijānīhi 
SA_MB_saandilyopanisatHK-719	tasyāvāṅmānasagocaratvaṃ jñānaikagamyatvaṃ	tasya a vāc mānasa gocara tvam jñāna eka gamya tvam 
SA_MB_saandilyopanisatHK-720	prajñājanakatvam advitīyatvaṃ vastutaḥ saccidānandamātratvaṃ cāha-	                                                                                     
SA_MB_saandilyopanisatHK-721	yata iti | kevalaṃ jñānagamyaṃ jñānetarasādhanairagamyamityarthaḥ,	yatas iti kevalam jñāna gamyam jñāna itara sādhanaiḥ agamyam iti arthaḥ 
SA_MB_saandilyopanisatHK-722	nānyaḥ panthā vidyate'yanāya iti śruteḥ | nirvikalpā ca cinmātrā vṛttiḥ	na anyaḥ panthāḥ vidyate iyanāya iti śruteḥ nirvikalpā ca cit mātrā vṛttiḥ 
SA_MB_saandilyopanisatHK-723	prajñeti kathyate iti śrutisiddhā prajñā purāṇī,	prajñā iti kathyate iti śruti siddhā prajñā purāṇī 
SA_MB_saandilyopanisatHK-724	ākaivalyabhāvasthāyitvāt | sā yasmāt prasṛtā vijṛmbhitā |	ākaivalya bhāva sthāyi tvāt sā yasmāt prasṛtā vijṛmbhitā 
SA_MB_saandilyopanisatHK-725	yaccaitanyamātraṃ dvaitādivikṛtiprasaktau advitīyamityādiviśeṣaṇavat	yat caitanya mātram dvaita ādi vikṛti prasaktau advitīyam ityādi viśeṣaṇa vat 
SA_MB_saandilyopanisatHK-726	tadabhāve sanmātram asadanyat iti śruteḥ	tad abhāve sat mātram asat anyat iti śruteḥ 
SA_MB_saandilyopanisatHK-727	yatsarvāsadapahnavasiddhaniṣpratiyogikasanmātramavaśiṣyate tat | tadeva	yat sarva asat apahnava siddha niṣpratiyogika sat mātram avaśiṣyate tat tat eva 
SA_MB_saandilyopanisatHK-728	sarvaṃ tadatiriktaṃ nāstīti budhyasvetyarthaḥ || 4 ||	sarvam tad atiriktam na asti iti budhyasva iti arthaḥ 
SA_MB_saandilyopanisatHK-729	sarvasya paramātmatvam	sarvasya parama ātma tvam 
SA_MB_saandilyopanisatHK-730	ya eko deva ātmaśaktipradhānaḥ sarvajñaḥ sarveśvaraḥ	yaḥ ekaḥ devaḥ ātma śakti pradhānaḥ sarvajñaḥ sarva īśvaraḥ 
SA_MB_saandilyopanisatHK-731	sarvabhūtāntarātmā sarvabhūtādhivāsaḥ sarvabhūtanigūḍho	sarva bhūta antarātmā sarva bhūta adhivāsaḥ sarva bhūta nigūḍhaḥ 
SA_MB_saandilyopanisatHK-732	bhūtayoniryogaikagamyaḥ | yaśca viśvaṃ sṛjati viśvaṃ bibharti viśvaṃ	bhūtayoniḥ yoga eka gamyaḥ yaḥ ca viśvam sṛjati viśvam bibharti viśvam 
SA_MB_saandilyopanisatHK-733	bhuṅkte sa ātmā | ātmani taṃ taṃ lokaṃ vijānīhi || 5 ||	bhuṅkte saḥ ātmā ātmani tam tam lokam vijānīhi 
SA_MB_saandilyopanisatHK-734	kathaṃ punastaddhiyā sarvaṃ jñātuṃ śakyate tadbrahmātirekeṇa	katham punar tad dhiyā sarvam jñātum śakyate tad brahma atirekeṇa 
SA_MB_saandilyopanisatHK-735	viśvakṛdīśvarasattvādityāśaṅkya yaḥ svājñadṛṣṭyā	viśvakṛt īśvara sattvāt iti āśaṅkya yaḥ sva ajña dṛṣṭyā 
SA_MB_saandilyopanisatHK-736	svātirikteśvaravat bhātaḥ sa eva svajñadṛṣṭyā	sva atirikta īśvara vat bhātaḥ saḥ eva svajña dṛṣṭyā 
SA_MB_saandilyopanisatHK-737	p. 552) paramātmatayā avaśiṣyate ityāha- ya iti |	parama ātma tayā avaśiṣyate iti āha yaḥ iti 
SA_MB_saandilyopanisatHK-738	yasyānātmāpahnavasiddhātmamātraśaktiḥ prakṛtiḥ pradhānā mukhyā	yasya an ātma apahnava siddha ātma mātra śaktiḥ prakṛtiḥ pradhānā mukhyā 
SA_MB_saandilyopanisatHK-739	bhavati sākṣitveśvaratvādiśaktistu upasarjanabhūtā ca bhavati so'yam	bhavati sākṣi tva īśvara tva ādi śaktiḥ tu upasarjana bhūtā ca bhavati sā uyam 
SA_MB_saandilyopanisatHK-740	ātmaśaktipradhānaḥ | upasarjanaśaktimavaṣṭabhya sarvajña ityādi |	ātma śakti pradhānaḥ upasarjana śaktim avaṣṭabhya sarvajñaḥ ityādi 
SA_MB_saandilyopanisatHK-741	īśvarasākṣātkārasya yogaikasādhyatvāt īśvarasadbhāvaliṅgamāha-	īśvara sākṣātkārasya yoga eka sādhya tvāt īśvara sadbhāva liṅgam āha 
SA_MB_saandilyopanisatHK-742	yaśceti | yasya liṅgaṃ prapañcaṃ vā sa ma ātmā na saṃśayaḥ iti	yaḥ ca iti yasya liṅgam prapañcam vā sa me ātmā na saṃśayaḥ iti 
SA_MB_saandilyopanisatHK-743	śrutisiddhataṭasthalakṣaṇeneśvarāstitvamavagamya tasmin	śruti siddha taṭastha lakṣaṇena īśvara astitvam avagamya tasmin 
SA_MB_saandilyopanisatHK-744	svājñasamarpitaviśeṣāpāye yo ya īśvaraḥ sākṣī jīvo jagaditi ca	sva ajña samarpita viśeṣa apāye yaḥ yaḥ īśvaraḥ sākṣī jīvaḥ jagat iti ca 
SA_MB_saandilyopanisatHK-745	vyapadiṣṭaḥ taṃ taṃ lokaṃ niṣpratiyogikabrahmamātramiti vijānīhi || 5 ||	vyapadiṣṭaḥ tam tam lokam niṣpratiyogika brahma mātram iti vijānīhi 
SA_MB_saandilyopanisatHK-746	gurūpadeśataḥ sarvātmatvajñānaprāptiḥ	                
SA_MB_saandilyopanisatHK-747	mā śocīrātmavijñānī śokasyāntaṃ gamiṣyasi || 6 ||	mā śocīḥ ātma vijñānī śokasya antam gamiṣyasi  /
SA_MB_saandilyopanisatHK-748	katham evaṃ jñātuṃ śakyamiti mā śucaḥ madupadeśamahimnā	katham evam jñātum śakyam iti mā śucaḥ mad upadeśa mahimnā 
SA_MB_saandilyopanisatHK-749	svātiriktāstitāprabhavaśokāntabrahma bhavasītyāha- mā śocīriti || 6 ||	sva atirikta astitā prabhava śoka anta brahma bhavasi iti āha mā śocīḥ iti 
SA_MB_saandilyopanisatHK-750	iti dvitīyo'dhyāyaḥ	iti dvitīyaḥ adhyāyaḥ 
SA_MB_saandilyopanisatHK-751	tṛtīyo'dhyāyaḥ	tṛtīyaḥ udhyāyaḥ 
SA_MB_saandilyopanisatHK-752	brahmaṇo vastutaḥ niṣpratiyogikasvamātratvam	             
SA_MB_saandilyopanisatHK-753	atha hainaṃ śāṇḍilyo'tharvāṇaṃ papraccha yadekamakṣaraṃ	atha ha enam śāṇḍilyaḥ utharvāṇam papraccha yat ekam akṣaram 
SA_MB_saandilyopanisatHK-754	niṣkriyaṃ śivaṃ sanmātraṃ paraṃ brahma | tasmāt kathamidaṃ viśvaṃ	niṣkriyam śivam sanmātram param brahma tasmāt katham idam viśvam 
SA_MB_saandilyopanisatHK-755	jāyate kathaṃ sthīyate kathamasmiṃllīyate | tanme saṃśayaṃ	jāyate katham sthīyate katham asmin līyate tat me saṃśayam 
SA_MB_saandilyopanisatHK-756	chettumarhasīti || 1 || sa hovācātharvā satyaṃ śāṇḍilya parabrahma	chettum arhasi iti      sa ha uvāca atharvā satyam śāṇḍilya para brahma 
SA_MB_saandilyopanisatHK-757	niṣkriyamakṣaramiti || 2 ||	niṣkriyam akṣaram iti 
SA_MB_saandilyopanisatHK-758	p. 553) brahmaṇo niṣpratiyogikasvamātratvamuktaṃ, tato viśvaṃ jāyate iti	                              
SA_MB_saandilyopanisatHK-759	ca | niṣpratiyogikasvamātratve viśvahetutvaṃ na saṃbhavati, viśvahetutve	ca niṣpratiyogika sva mātra tve viśva hetu tvam na saṃbhavati viśva hetu tve 
SA_MB_saandilyopanisatHK-760	niṣpratiyogikatvaṃ ca na saṃbhavatīti brahmātirikteyattābubhutsayā	niṣpratiyogika tvam ca na saṃbhavati iti brahma atirikta iyat tā bubhutsayā 
SA_MB_saandilyopanisatHK-761	śāṇḍilyo'tharvāṇaṃ pṛcchatītyāha- atheti || 1 || brahma tu	śāṇḍilyaḥ utharvāṇam pṛcchati iti āha atha iti    brahma tu 
SA_MB_saandilyopanisatHK-762	sanmātraprakṛtikaṃ tanniṣpratiyogikasvaprakṛtiṃ vinā	             
SA_MB_saandilyopanisatHK-763	jagajjanamsthitibhaṅgavikṛtitāṃ naiti | vatuyāthātmyājñānato niratāṃ	na eti 
SA_MB_saandilyopanisatHK-764	saṃśayāviṣṭaśāṇḍilyapraśnottaraṃ sa hovāca | he śāṇḍilya	saṃśaya āviṣṭa śāṇḍilya praśna uttaram sa ha uvāca he śāṇḍilya 
SA_MB_saandilyopanisatHK-765	yanmayoktaṃ sanmātraṃ paraṃ brahma niṣpratiyogikaṃ svātirekeṇa astīti	yat mayā uktam sanmātram param brahma niṣpratiyogikam sva atirekeṇa asti iti 
SA_MB_saandilyopanisatHK-766	viśvasanīyaviśvotpādasthitibhaṅgakāryakāraṇavikriyāpahnavasiddhaṃ	viśvasanīya viśva utpāda sthiti bhaṅga kārya kāraṇa vikriyā apahnava siddham 
SA_MB_saandilyopanisatHK-767	paramākṣaramiti tadeva satyam | tasya niṣpratiyogikatve na hi saṃśayo'sti	paramākṣaram iti tat eva satyam tasya niṣpratiyogika tve na hi saṃśayaḥ usti 
SA_MB_saandilyopanisatHK-768	svājñādidṛṣṭimohe satyasati svasyaikarūpatayā sthitatvāt || 2 ||	sva ajña ādi dṛṣṭi mohe sati asati svasya eka rūpa tayā sthita tvāt 
SA_MB_saandilyopanisatHK-769	brahmaṇo rūpatrayam	brahmaṇaḥ rūpa trayam 
SA_MB_saandilyopanisatHK-770	athāpyasyārūpasya brahmaṇastrīṇi rūpāṇi bhavanti niṣkalaṃ	atha api asya arūpasya brahmaṇaḥ trīṇi rūpāṇi bhavanti niṣkalam 
SA_MB_saandilyopanisatHK-771	sakalaṃ sakalaniṣkalaṃ ceti || 3 ||	sakalam sakala niṣkalam ca iti 
SA_MB_saandilyopanisatHK-772	tathā cedviśvakāraṇatā kuta ityāśaṅkya	tathā ced viśva kāraṇatā kutas iti āśaṅkya 
SA_MB_saandilyopanisatHK-773	pāramārthikasvajñasvājñadṛṣṭivaicitryāt niṣpratiyogikaniṣkalamapi	pāramārthika svajña sva ajña dṛṣṭi vaicitryāt niṣpratiyogika niṣkalam api 
SA_MB_saandilyopanisatHK-774	brahma sapratiyogikaniṣkalavat sakalavat sakalaniṣkalavacca bhātītyāha-	brahma sa pratiyogika niṣkala vat sakala vat sakala niṣkala vat ca bhāti iti āha 
SA_MB_saandilyopanisatHK-775	atheti || 3 ||	atha iti 
SA_MB_saandilyopanisatHK-776	niṣkalaṃ brahma	niṣkalam brahma 
SA_MB_saandilyopanisatHK-777	yatsatyaṃ vijñānamānandaṃ viṣkriyaṃ nirañjanaṃ sarvagataṃ	yat satyam vijñānam ānandam viṣkriyam nirañjanam sarvagatam 
SA_MB_saandilyopanisatHK-778	susūkṣmaṃ sarvatomukhamanirdeśyamamṛtamasti tadidaṃ niṣkalaṃ	su sūkṣmam sarvatomukham anirdeśyam amṛtam asti tat idam niṣkalam 
SA_MB_saandilyopanisatHK-779	rūpam || 4 ||	rūpam 
SA_MB_saandilyopanisatHK-780	paramārthadṛṣṭyā yat niṣpratiyogikaniṣkalamityuktaṃ tat tiṣṭhatu,	paramārtha dṛṣṭyā yat niṣpratiyogika niṣkalam iti uktam tat tiṣṭhatu 
SA_MB_saandilyopanisatHK-781	tadavagateḥ sapratiyogikakalanāpahnavapūrvakatvāt,	tad avagateḥ sa pratiyogika kalanā apahnava pūrvaka tvāt 
SA_MB_saandilyopanisatHK-782	cinmātrameva cinmātramakhaṇḍaikarasaṃ rasam |	cit mātram eva cit mātram akhaṇḍa eka rasam rasam 
SA_MB_saandilyopanisatHK-783	sarvavarjitacinmātraṃ brahmamātramasanna hi ||	sarva varjita cit mātram brahma mātram asat na hi 
SA_MB_saandilyopanisatHK-784	p. 554) ityādi śruteḥ | tatra ādau svajñadṛṣṭimavaṣṭabhya	ityādi śruteḥ tatra ādau svajña dṛṣṭim avaṣṭabhya 
SA_MB_saandilyopanisatHK-785	sapratiyogikaniṣkalasvarūpaṃ viśadayati- yaditi |	sa pratiyogika niṣkala svarūpam viśadayati yat iti 
SA_MB_saandilyopanisatHK-786	satyajñānānandādyuktaviśeṣaṇānāmanṛtajaḍaduḥkhādipratiṣedhakatve	satya jñāna ānanda ādi ukta viśeṣaṇānām anṛta jaḍa duḥkha ādi pratiṣedhaka tve 
SA_MB_saandilyopanisatHK-787	sapratiyogikatvaṃ yujyate, niṣpratiyogikapakṣe tu taddṛṣṭyā	sa pratiyogika tvam yujyate niṣpratiyogika pakṣe tu tad dṛṣṭyā 
SA_MB_saandilyopanisatHK-788	apahnotavyaviṣayasāmānyamasti nāstīti vibhramasyāpyapahnavaṃ	apahnotavya viṣaya sāmānyam asti na asti iti vibhramasya api apahnavam 
SA_MB_saandilyopanisatHK-789	gatatvāt || 4 ||	gata tvāt 
SA_MB_saandilyopanisatHK-790	sakalaṃ brahma	sakalam brahma 
SA_MB_saandilyopanisatHK-791	athāsya yā sahajāsti vidyā mūlaprakṛtirmāyā lohitaśuklakṛṣṇā	atha asya yā sahajā asti vidyā mūlaprakṛtiḥ māyā lohita śukla kṛṣṇā 
SA_MB_saandilyopanisatHK-792	tayā sahajavān devaḥ kṛṣṇapiṅgalo maheśvara īṣṭe | tadidamasya sakalaṃ	tayā sahajavān devaḥ kṛṣṇa piṅgalaḥ maheśvaraḥ īṣṭe tat idam asya sakalam 
SA_MB_saandilyopanisatHK-793	rūpam || 5 ||	rūpam 
SA_MB_saandilyopanisatHK-794	sapratiyogikasakalarūpaṃ spaṣṭayati- atheti | ya eṣa niṣpratiyogika-	sa pratiyogika sakala rūpam spaṣṭayati atha iti yaḥ eṣa niṣpratiyogika 
SA_MB_saandilyopanisatHK-795	niṣkalatayā avaśiṣṭaḥ sa eva svājñadṛṣṭyā sapratiyogikaniṣkala iti	niṣkala tayā avaśiṣṭaḥ saḥ eva sva ajña dṛṣṭyā sa pratiyogika niṣkalaḥ iti 
SA_MB_saandilyopanisatHK-796	khyātaḥ | sa evātha svājñadṛṣṭyā vikalpānantaraṃ sarveśvaro bhavati |	khyātaḥ saḥ eva atha sva ajña dṛṣṭyā vikalpa anantaram sarveśvaraḥ bhavati 
SA_MB_saandilyopanisatHK-797	asyeśvaratvahetuḥ ketyata āha- yeti | svājñadṛṣṭisahajā yā	asya īśvara tva hetuḥ kā iti atas āha yā iti sva ajña dṛṣṭi sahajā yā 
SA_MB_saandilyopanisatHK-798	mūlaprakṛtitvena prakṛtā triguṇātmikā māyāsti tayā sahajavān devaḥ	mūlaprakṛti tvena prakṛtā triguṇa ātmikā māyā asti tayā sahajavān devaḥ 
SA_MB_saandilyopanisatHK-799	triguṇayogataḥ kṛṣṇapiṅgalo maheśvaraḥ sarveśvaratvamavalambya	triguṇa yogataḥ kṛṣṇapiṅgalaḥ maheśvaraḥ sarva īśvara tvam avalambya 
SA_MB_saandilyopanisatHK-800	svājñadṛṣṭiprasaktasvāvidyāpadatatkāryajātam īṣṭe | tadidamasya	īṣṭe tat idam asya 
SA_MB_saandilyopanisatHK-801	sakalaṃ rūpam, īśvarasya nirāvṛtakriyājñānecchāśaktimattvena	sakalam rūpam īśvarasya nirāvṛta kriyā jñāna icchā śaktimat tvena 
SA_MB_saandilyopanisatHK-802	svadṛṣṭyeśitavyasvāvidyāpadatatkāryavairalyāt svasyaiva niṣpratiyogika-	sva dṛṣṭyā īśitavya sva avidyā pada tad kārya vairalyāt svasya eva 
SA_MB_saandilyopanisatHK-803	niṣkalatvāt asya sakalatvaṃ svājñadṛṣṭiniṣṭhamevetyarthaḥ || 5 ||	niṣkala tvāt asya sakala tvam sva ajña dṛṣṭi niṣṭham eva iti arthaḥ 
SA_MB_saandilyopanisatHK-804	sakalaniṣkalaṃ brahma	sakala niṣkalam brahma 
SA_MB_saandilyopanisatHK-805	athaiṣa jñānamayena tapasā cīyamāno'kāmayata bahu syāṃ	atha eṣa jñāna mayena tapasā cīyamānā ukāmayata bahu syām 
SA_MB_saandilyopanisatHK-806	prajāyeyeti | athaitasmāt tapyamānāt trīṇyakṣarāṇyajāyanta |	prajāyeya iti atha etasmāt tapyamānāt trīṇi akṣarāṇi ajāyanta 
SA_MB_saandilyopanisatHK-807	p. 555) tisro vyāhṛtayastripadā gāyatrī trayo vedāstrayo devāstrayo	tisraḥ vyāhṛtayaḥ tri padā gāyatrī trayaḥ vedāḥ trayaḥ devāḥ trayaḥ 
SA_MB_saandilyopanisatHK-808	varṇāstrayo'gnayaśca jāyante | yo'sau devo bhagavān	varṇāḥ trayaḥ agnayaḥ ca jāyante yaḥ asau devaḥ bhagavān 
SA_MB_saandilyopanisatHK-809	sarvaiśvaryasaṃpannaḥ sarvavyāpī sarvabhūtānāṃ hṛdaye saṃniviṣṭo	sarva aiśvarya saṃpannaḥ sarva vyāpī sarva bhūtānām hṛdaye saṃniviṣṭaḥ 
SA_MB_saandilyopanisatHK-810	māyāvī māyayākṛtiḥ sa brahmā sa viṣṇuḥ sa rudraḥ sa indraḥ sa sarve	māyāvī māyayā ākṛtiḥ sa brahmā sa viṣṇuḥ sa rudraḥ saḥ indraḥ sa sarve 
SA_MB_saandilyopanisatHK-811	devāḥ sarvāṇi bhūtāni sa eva purastāt sa eva paścāt sa evottarataḥ sa eva	devāḥ sarvāṇi bhūtāni saḥ eva purastāt saḥ eva paścāt saḥ eva uttaratas saḥ eva 
SA_MB_saandilyopanisatHK-812	dakṣiṇataḥ sa evādhastāt sa evopariṣṭāt sa eva sarvam | athāsya	dakṣiṇatas saḥ eva adhastāt saḥ eva upariṣṭāt saḥ eva sarvam atha asya 
SA_MB_saandilyopanisatHK-813	devasyātmaśaktikrīḍasya bhaktānukampino dattātreyarūpā surūpā	devasya ātma śakti krīḍasya bhakta anukampinaḥ dattātreya rūpā surūpā 
SA_MB_saandilyopanisatHK-814	tanūravāsā indīvaradalaprākhyā caturbāhuraghorāpāpakāśinī |	tanūra vāsāḥ indīvara dala prākhyā caturbāhuḥ aghorā apāpa kāśinī 
SA_MB_saandilyopanisatHK-815	tadidamasya sakalaniṣkalaṃ rūpam || 6 ||	tat idam asya sakala niṣkalam rūpam 
SA_MB_saandilyopanisatHK-816	ardhasvajñadṛṣṭimavaṣṭabhya sakalasvarūpaprapañcanapūrvakaṃ	ardha svajña dṛṣṭim avaṣṭabhya sakala sva rūpa prapañcana pūrvakam 
SA_MB_saandilyopanisatHK-817	sakalaniṣkalasvarūpamācaṣṭe- atheti | ādyantayoḥ sakalaṃ madhye	sakala niṣkala svarūpam ācaṣṭe atha iti ādi antayoḥ sakalam madhye 
SA_MB_saandilyopanisatHK-818	niṣkalaṃ yatra dṛśyate tat sakalaniṣkalasvarūpam | tatrādau īśvara eko'pi	niṣkalam yatra dṛśyate tat sakala niṣkala svarūpam tatra ādau īśvaraḥ ekaḥ api 
SA_MB_saandilyopanisatHK-819	tapasā cīyamāno vardhamānaḥ san bahu syāṃ prajāyeya iti	tapasā cīyamānaḥ vardhamānaḥ san bahu syām prajāyeya iti 
SA_MB_saandilyopanisatHK-820	bahubhu[bha]vanasaṃkalpaṃ kṛtavān | evaṃ	bahu bhu bhavana saṃkalpam kṛtavān evam 
SA_MB_saandilyopanisatHK-821	satyasaṃkalpāttasmādīśvarāt akārokāramakārabhedena	satya saṃkalpāt tasmāt īśvarāt akāra ukāra makāra bhedena 
SA_MB_saandilyopanisatHK-822	trīṇyakṣarāṇyajāyanta- iti sarvatra vacanānurodhena ūhyam | bhūrādi	trīṇi akṣarāṇi ajāyanta iti sarvatra vacana anurodhena ūhyam bhūḥ ādi 
SA_MB_saandilyopanisatHK-823	bhedena tisro vyāhṛtayaḥ, padatrayātmikā gāyatrī, ṛgādibhedena trayo	bhedena tisraḥ vyāhṛtayaḥ pada traya ātmikā gāyatrī ṛk ādi bhedena trayaḥ 
SA_MB_saandilyopanisatHK-824	vedāḥ, brahmādibhedena trayo devāḥ, brāhmaṇādibhedena trayo varṇāḥ,	vedāḥ brahma ādi bhedena trayaḥ devāḥ brāhmaṇa ādi bhedena trayaḥ varṇāḥ 
SA_MB_saandilyopanisatHK-825	gārhapatyādibhedena trayo'gnayaśca jāyante | so'yamīśvaro	gārhapatya ādi bhedena trayaḥ agnayaḥ ca jāyante saḥ yam īśvaraḥ 
SA_MB_saandilyopanisatHK-826	niravadhikavibhūtisaṃpannaḥ svena antaryāmirūpeṇa sarvavyāpī	niravadhika vibhūti saṃpannaḥ svena antaryāmi rūpeṇa sarvavyāpī 
SA_MB_saandilyopanisatHK-827	sarvabhūtahṛdāsanaḥ | tasyākṛtimatvaṃ māyayā, na svataḥ, svato	sarva bhūta hṛdāsanaḥ tasya ākṛtima tvam māyayā na svatas 
SA_MB_saandilyopanisatHK-828	nirākṛtitvāt | brahmādirūpeṇāpi sa eva vartate | digvidikadhaścordhvaṃ	nirākṛti tvāt brahma ādi rūpeṇa api saḥ eva vartate diś vidiś adhas ca ūrdhvam 
SA_MB_saandilyopanisatHK-829	cāpi sa eva | dattātreyarūpeṇāpi sa eva vartate | surūpā tanū avāsāḥ iti	ca api saḥ eva dattātreya rūpeṇa api saḥ eva vartate iti 
SA_MB_saandilyopanisatHK-830	viśeṣaṇato'syā avadhūtatvamavagamyate, jaḍabharataddattātreyaraivataka-	viśeṣaṇatā usyāḥ avadhūta tvam avagamyate jaḍa bharata ddattātreya raivataka 
SA_MB_saandilyopanisatHK-831	ṛbhunidāgha iti śruteḥ | evaṃ ardhasvajñadṛṣṭyanurodhena	ṛbhu nidāghaḥ iti śruteḥ evam ardha svajña dṛṣṭi anurodhena 
SA_MB_saandilyopanisatHK-832	sakalaniṣkalasvarūpaṃ pratipāditamityarthaḥ || 6 ||	sakala niṣkala svarūpam pratipāditam iti arthaḥ 
SA_MB_saandilyopanisatHK-833	iti prathamaḥ khaṇḍaḥ	iti prathamaḥ khaṇḍaḥ 
SA_MB_saandilyopanisatHK-834	sanmātrasya parabrahmatvanirvacanam	            
SA_MB_saandilyopanisatHK-835	atha hainamatharvāṇaṃ śāṇḍilyaḥ papraccha bhagavan sanmātraṃ	atha ha enam atharvāṇam śāṇḍilyaḥ papraccha bhagavan sat mātram 
SA_MB_saandilyopanisatHK-836	cidānandaikarasaṃ kasmāducyate paraṃ brahmeti || 1 || sa hovācātharvā	cit ānanda eka rasam kasmāt ucyate param brahma iti        ha uvāca atharvā 
SA_MB_saandilyopanisatHK-837	yasmācca bṛhati bṛṃhayati ca sarvaṃ tasmāducyate paraṃ brahmeti || 2 ||	yasmāt ca bṛhati bṛṃhayati ca sarvam tasmāt ucyate param brahma iti 
SA_MB_saandilyopanisatHK-838	brahmaṇaḥ sanmātratvaṃ parabrahmatvam ātmatvaṃ	brahmaṇaḥ sat mātra tvam para brahma tvam ātma tvam 
SA_MB_saandilyopanisatHK-839	maheśvaratvaṃ ca kathamiti śāṇḍilyo'tharvāṇaṃ pṛcchati,	maheśvara tvam ca katham iti śāṇḍilyaḥ utharvāṇam pṛcchati 
SA_MB_saandilyopanisatHK-840	bhagavānatharvāpi tatpraśnapūraṇaṃ kṛtavānityāha- atheti |	bhagavān atharvā api tad praśna pūraṇam kṛtavān iti āha atha iti 
SA_MB_saandilyopanisatHK-841	niṣpratiyogikasaccidānandamātraṃ kasmāt || 1-8 ||	niṣpratiyogika saccidānanda mātram kasmāt 
SA_MB_saandilyopanisatHK-842	sanmātrasya ātmatvanirvacanam	          
SA_MB_saandilyopanisatHK-843	atha kasmāducyate ātmeti || 3 || yasmāt sarvamāpnoti sarvamādatte	atha kasmāt ucyate ātmā iti    yasmāt sarvam āpnoti sarvam ādatte 
SA_MB_saandilyopanisatHK-844	sarvamatti ca tasmāducyate ātmeti || 4 ||	sarvam atti ca tasmāt ucyate ātmā iti 
SA_MB_saandilyopanisatHK-845	sanmātrasya maheśvaratvanirvacanam	            
SA_MB_saandilyopanisatHK-846	atha kasmāducyate iti || 5 || yasmānmahata īśaḥ śabdadhvanyā	atha kasmāt ucyate iti     yasmāt mahataḥ īśaḥ śabda dhvanyā 
SA_MB_saandilyopanisatHK-847	cātmaśaktyā tasmāducyate maheśvara iti || 6 ||	ca ātma śaktyā tasmāt ucyate maheśvaraḥ iti 
SA_MB_saandilyopanisatHK-848	sanmātrasya dattātreyatvanirvacanam	sat mātrasya dattātreya tva nirvacanam 
SA_MB_saandilyopanisatHK-849	atha kasmāducyate dattātreya iti || 7 || yasmāt suduścaraṃ	atha kasmāt ucyate dattātreyaḥ iti    yasmāt su duścaram 
SA_MB_saandilyopanisatHK-850	tapastapyamānāyātraye putrakāmāyātitarāṃ tuṣṭena jyotirmayenātmaiva	tapaḥ tapyamānāya atraye putra kāmāya atitarām tuṣṭena jyotiḥ mayena ātmā eva 
SA_MB_saandilyopanisatHK-851	p. 557) datto yasmāccānasūyāyāmatrestanayo'bhavat tasmāducyate	dattaḥ yasmāt ca anasūyāyām atreḥ tanayaḥ bhavat tasmāt ucyate 
SA_MB_saandilyopanisatHK-852	dattātreya iti || 8 ||	dattātreyaḥ iti 
SA_MB_saandilyopanisatHK-853	niruktivedanaphalam	nirukti vedana phalam 
SA_MB_saandilyopanisatHK-854	atha yo'sya niruktāni veda sa sarvaṃ veda || 9 || atha yo ha vai	atha yaḥ asya niruktāni veda sa sarvam veda       atha yaḥ ha vai 
SA_MB_saandilyopanisatHK-855	vidyainaṃ paramupāste so'hamiti sa brahmavidbhavati || 10 ||	vidyā enam param upāste saḥ ham iti sa brahma vid bhavati  /
SA_MB_saandilyopanisatHK-856	atraite ślokā bhavanti-	atra ete ślokāḥ bhavanti 
SA_MB_saandilyopanisatHK-857	dattātreyaṃ śivaṃ śāntamindranīlanibhaṃ prabhum |	dattātreyam śivam śāntam indranīla nibham prabhum 
SA_MB_saandilyopanisatHK-858	ātmamāyārataṃ devamavadhūtaṃ digambaram || 11 ||	ātma māyā ratam devam avadhūtam digambaram 
SA_MB_saandilyopanisatHK-859	bhasmoddhūlitasarvāṅgaṃ jaṭājūṭadharaṃ vibhum |	bhasma uddhūlita sarva aṅgam jaṭā jūṭa dharam vibhum 
SA_MB_saandilyopanisatHK-860	caturbāhumudārāṅgaṃ praphullakamalekṣaṇam || 12 ||	catur bāhum udāra aṅgam praphulla kamala īkṣaṇam 
SA_MB_saandilyopanisatHK-861	jñānayoganidhiṃ viśvaguruṃ yogijanapriyam |	              
SA_MB_saandilyopanisatHK-862	bhaktānukampinaṃ sarvasākṣiṇaṃ siddhasevitam || 13 ||	bhakta anukampinam sarva sākṣiṇam siddha sevitam 
SA_MB_saandilyopanisatHK-863	evaṃ yaḥ satataṃ dhyāyeddevadevaṃ sanātanam |	evam yaḥ satatam dhyāyet devadevam sanātanam 
SA_MB_saandilyopanisatHK-864	sa muktaḥ sarvapāpebhyo niḥśreyasamavāpnuyāt || 14 ||	sa muktaḥ sarva pāpebhyaḥ niḥśreyasam avāpnuyāt 
SA_MB_saandilyopanisatHK-865	ityoṃ satyamityupaniṣat || 15 ||	iti om satyam iti upaniṣad 
SA_MB_saandilyopanisatHK-866	uktaniruktatrayavedanaphalamāha- atheti | brahmaṇaḥ	ukta nirukta traya vedana phalam āha atha iti brahmaṇaḥ 
SA_MB_saandilyopanisatHK-867	sarvavyāpakatvena brahmavedanataḥ sarvavittvaṃ syādityarthaḥ || 9 || ya	sarva vyāpaka tvena brahma vedanataḥ sarva vid tvam syāt iti arthaḥ 
SA_MB_saandilyopanisatHK-868	etadbrahma viditvopāste sa tadeva bhavatītyāha- atheti | vidya viditvetyarthaḥ ||	etat brahma viditvā upāste sa tat eva bhavati iti āha atha iti vidya viditvā iti arthaḥ 
SA_MB_saandilyopanisatHK-869	10-13 || ya evamuktaprakāreṇa sadā devadevaṃ paramātmānam	yaḥ evam ukta prakāreṇa sadā devadevam paramātmānam 
SA_MB_saandilyopanisatHK-870	ayamahamasmīti viditvā dhyāyet sa niḥśreyasaṃ	ayam aham asmi iti viditvā dhyāyet sa niḥśreyasam 
SA_MB_saandilyopanisatHK-871	p. 558) tatpadamāpnuyāt || 14 || yat satyamoṃkārāgravidyotamānaṃ tadeva	tat padam āpnuyāt    yat satyam oṃkāra agra vidyotamānam tat eva 
SA_MB_saandilyopanisatHK-872	bhavatītyarthaḥ || ityupaniṣacchabdaḥ śāṇḍilyopaniṣatsamāptyarthaḥ || 15 ||	bhavati iti arthaḥ iti upaniṣad śabdaḥ śāṇḍilya upaniṣad samāpti arthaḥ 
SA_MB_saandilyopanisatHK-873	iti dvitīyaḥ khaṇḍaḥ samāptaḥ, tṛtīyo'dhyāyaśca ||	iti dvitīyaḥ khaṇḍaḥ samāptaḥ tṛtīya adhyāyaḥ ca 
SA_MB_saandilyopanisatHK-874	śrīvāsudevendraśiṣyopaniṣadbrahmayoginā |	              
SA_MB_saandilyopanisatHK-875	śāṇḍilyopaniṣadvyākhyā likhitā brahmagocarā |	śāṇḍilya upaniṣad vyākhyā likhitā brahma gocarā 
SA_MB_saandilyopanisatHK-876	śāṇḍilyopaniṣadvyākhyāgranthastu triśataṃ smṛtaḥ ||	śāṇḍilya upaniṣad vyākhyā granthaḥ tu tri śatam smṛtaḥ 
SA_MB_saandilyopanisatHK-877	iti śrīmadīśādyaṣṭottaraśatopaniṣacchāstravivaraṇe	iti śrīmat īśa ādi aṣṭottaraśata upaniṣad śāstra vivaraṇe 
SA_MB_saandilyopanisatHK-878	aṣṭapañcāśatsaṃkhyāpūrakaṃ śāṇḍilyopaniṣadvivaraṇaṃ	aṣṭapañcāśat saṃkhyā pūrakam śāṇḍilya upaniṣad vivaraṇam 
SA_MB_saandilyopanisatHK-879	saṃpūrṇam	saṃpūrṇam 
SA_MB_saandilyopanisatHK-880	MUKTABODHA INDOLOGICAL RESEARCH INSTITUTE©2011 Muktabodha Indological Research Institute  All Rights Reserved.E-texts may be viewed only online or downloaded for private study.E-texts may not, under any circumstances, be copied, republished,reproduced, distributed or sold, either in original or altered form, withoutthe express permission of Muktabodha Indological Research Institute in writing.Data-entered by the staff of Muktabodha under the direction of Mark S. G. Dyczkowski.	muktabodha indological research muktabodha indological research institute all rights reserved texts may be viewed only online or downloaded for private studye texts may not under any circumstances be copied republished reproduced distributed or sold either in original or altered form withoutthe express permission of muktabodha indological research institute in writing data entered by the staff of muktabodha under the direction of mark s g dyczkowski 
