segmentnr	original	analyzed
SA_MB_dattatreyabodhaHK-0	Muktabodha E-text in UTF-8	muktabodha etext in utf
SA_MB_dattatreyabodhaHK-1	###########################################################################MUKTABODHA INDOLOGICAL RESEARCH INSTITUTEwww.muktabodha.org©2011 Muktabodha Indological Research Institute  All Rights Reserved.E-texts may be viewed only online or downloaded for private study.E-texts may not, under any circumstances, be copied, republished,reproduced, distributed or sold, either in original or altered form, withoutthe express permission of Muktabodha Indological Research Institute in writing.Data-entered by the staff of Muktabodha under the direction of Mark S. G. Dyczkowski.Catalog number : E0003	muktabodha indological research muktabodha indological research institute all rights reserved texts may be viewed only online or downloaded for private studye texts may not under any circumstances be copied republished reproduced distributed or sold either in original or altered form withoutthe express permission of muktabodha indological research institute in writing data entered by the staff of muktabodha under the direction of mark s g dyczkowskicatalog number  /
SA_MB_dattatreyabodhaHK-2	Uniform title: dattātreyabodha	uniform title dattātreya bodha 
SA_MB_dattatreyabodhaHK-3	Manuscript : IFP transcript T0638	manuscript ifp transcript 
SA_MB_dattatreyabodhaHK-4	Description: Transcribed from T. no. 638	description transcribed from t no 
SA_MB_dattatreyabodhaHK-5	copied from MS No D. 4346 belonging to the Government Oriental Library of Madras	copied from ms no d  belonging to the government oriental library of madras 
SA_MB_dattatreyabodhaHK-6	A short tract on Haṭha Yoga	a short tract on haṭha yoga 
SA_MB_dattatreyabodhaHK-7	See Muktabodha digital library, IFP/EFEO collection at www.muktabodha.org for full bibliographic details.	see muktabodha digital library ifpefeo collection at www muktabodha org for full bibliographic details 
SA_MB_dattatreyabodhaHK-8	Notes: Transcribed by the staff of Muktabodha under the supervision of Mark S. G. Dyczkowski.	notes transcribed by the staff muktabodha under the supervision of mark s g dyczkowski 
SA_MB_dattatreyabodhaHK-9	Revision 0: Feb. 16, 2013	revision feb 
SA_MB_dattatreyabodhaHK-10	Internet publisher : Muktabodha	internet publisher mukta bodha 
SA_MB_dattatreyabodhaHK-11	Publication year : 2013	publication year 
SA_MB_dattatreyabodhaHK-12	Publication country : United States	publication country united states 
SA_MB_dattatreyabodhaHK-13	bahukālasamābhyāsāt sthiro bhavati śāśvate ||	bahu kāla sama abhyāsāt sthiraḥ bhavati śāśvate 
SA_MB_dattatreyabodhaHK-14	paścānnāsti rujo dehe vārdhakyaṃ naiva dṛśyate |	paścāt nā asti rujaḥ dehe vārdhakyam nā eva dṛśyate 
SA_MB_dattatreyabodhaHK-15	siddhaḥ sarvaguṇopeto nānāchnairupa sthitaḥ |	siddhaḥ sarva guṇa upetaḥ sthitaḥ 
SA_MB_dattatreyabodhaHK-16	gupta liṅgī sadākāle vartate vanamadhyataḥ ||	gupta liṅgī sadākāle vartate vana madhyataḥ 
SA_MB_dattatreyabodhaHK-17	sutanurvitanuḥ kvāpi prāṇināṃ pravibhāsate |	su tanuḥ vitanuḥ kvāpi prāṇinām pravibhāsate 
SA_MB_dattatreyabodhaHK-18	atarkya mahimā yasmāttasmāttaṃ nāvamānayet ||	a tarkya mahimā yasmāt tasmāt tam na avamānayet 
SA_MB_dattatreyabodhaHK-19	aśraddhadhānaḥ pāpātmā nāstiko bhinna saṃśayaḥ |	pāpa ātmā nāstikaḥ bhinna saṃśayaḥ 
SA_MB_dattatreyabodhaHK-20	hetuko bakavṛttiśca teṣāṃ yogī na gocaraḥ ||	hetukaḥ bakavṛttiḥ ca teṣām yogī na gocaraḥ 
SA_MB_dattatreyabodhaHK-21	tasya līlāṃ na jānanti nindāṃ kurvanti ye'dhamāḥ |	tasya līlām na jānanti nindām kurvanti yedhamāḥ 
SA_MB_dattatreyabodhaHK-22	yogīśvarasya pāpiṣṭhāḥ patanti narake dhruvam ||	yogi īśvarasya pāpiṣṭhāḥ patanti narake dhruvam 
SA_MB_dattatreyabodhaHK-23	jano'pi yogināṃ dehe vitarkaṃ naiva kārayet |	janaḥ api yoginām dehe vitarkam nā eva kārayet 
SA_MB_dattatreyabodhaHK-24	krīḍanti lokamadhye tu yathā vai prākṛto naraḥ ||	krīḍanti loka madhye tu yathā vai prākṛtaḥ naraḥ 
SA_MB_dattatreyabodhaHK-25	yogīśvarasya yogasya yogaśāstrasya pārvati |	yogi īśvarasya yogasya yoga śāstrasya pārvati 
SA_MB_dattatreyabodhaHK-26	nindāṃ ca ye prakurvanti rākṣasāstena rākṣasaḥ ||	nindām ca ye prakurvanti rākṣasāḥ tena rākṣasaḥ 
SA_MB_dattatreyabodhaHK-27	pāṣaṇḍinaḥ pāparatāḥ svadharma vimukhāstute |	pāṣaṇḍinaḥ pāpa ratāḥ svadharma vimukhāḥ tu te 
SA_MB_dattatreyabodhaHK-28	yaiścāvamānitoyogī teṣāṃ trātā na bhūtale ||	yaiḥ ca avamānitaḥ yogī teṣām trātā na bhū tale 
SA_MB_dattatreyabodhaHK-29	āyuḥ kāntiryaśaḥ puṇyaṃ naśyante tasya suvrate |	āyuḥ kāntiḥ yaśaḥ puṇyam naśyante tasya suvrate 
SA_MB_dattatreyabodhaHK-30	yasya yoge matirdṛṣṭā jāyate mokṣarūpiṇī ||	yasya yoge matiḥ dṛṣṭā jāyate mokṣa rūpiṇī 
SA_MB_dattatreyabodhaHK-31	svadharma pratikūloyo yogastasya na rocate |	svadharma pratikūlaḥ yaḥ yogaḥ tasya na rocate 
SA_MB_dattatreyabodhaHK-32	so'pi garbho bhavedduḥkhaṃ bhuṃjate ca nirantaram || 10 ||	saḥ api garbhaḥ bhavet duḥkham bhuṃjate ca nirantaram 
SA_MB_dattatreyabodhaHK-33	saṃkṛte ||	saṃkṛte 
SA_MB_dattatreyabodhaHK-34	p. 3)	p 
SA_MB_dattatreyabodhaHK-35	caturāśīti lakṣe tu āsaneṣūttamā śṛṇu |	lakṣe tu āsaneṣu uttamā śṛṇu 
SA_MB_dattatreyabodhaHK-36	ādi nāthena saṃproktaṃ padmāsanamihocyate ||	ādi nāthena saṃproktam padmāsanam iha ucyate 
SA_MB_dattatreyabodhaHK-37	uttānau caraṇau kṛtvā ūrū saṃsthau prayatnataḥ |	uttānau caraṇau kṛtvā ūrū saṃsthau prayatnataḥ 
SA_MB_dattatreyabodhaHK-38	ūrumadhye tathottānau pāṇī kṛtvā tato dṛśau ||	ūru madhye tathā uttānau pāṇī kṛtvā tatas dṛśau 
SA_MB_dattatreyabodhaHK-39	nāsāgre vinyasetprājñaḥ dantamūlañca jihvayā |	nāsā agre vinyaset prājñaḥ danta mūlam ca jihvayā 
SA_MB_dattatreyabodhaHK-40	uttabhya cubukaṃ vakṣe saṃsthāpya pavanaṃ śanaiḥ ||	uttabhya cubukam vakṣe saṃsthāpya pavanam śanais 
SA_MB_dattatreyabodhaHK-41	idaṃ padmāsanaṃ prokta sarvavyādhi vināśanam |	idam padmāsanam sarva vyādhi vināśanam 
SA_MB_dattatreyabodhaHK-42	durlabhaṃ yena kenāpi dhīmatā labhyate bhuvi ||	durlabham yena kena api dhīmatā labhyate bhuvi 
SA_MB_dattatreyabodhaHK-43	sāṃkṛte śṛṇu tatvajña yogābhyāsakramaṃ mayā |	sāṃkṛte śṛṇu tatva jña yoga abhyāsa kramam mayā 
SA_MB_dattatreyabodhaHK-44	vakṣyamāṇaṃ prayatnena yogānāñca salakṣaṇaiḥ ||	vakṣyamāṇam prayatnena yogānām ca sa lakṣaṇaiḥ 
SA_MB_dattatreyabodhaHK-45	yuvā vāpyati vṛddho vā vyādhito vā śanaiḥ śanaiḥ |	yuvā vā api ati vṛddhaḥ vā vyādhitaḥ vā śanais śanais 
SA_MB_dattatreyabodhaHK-46	abhyāsāt siddhimāpnoti sarvayogeṣvatandritaḥ ||	abhyāsāt siddhim āpnoti sarva yogeṣu atandritaḥ 
SA_MB_dattatreyabodhaHK-47	brahmaṇā śramaṇovāpi bauddho vā patito'pi vā |	brahmaṇā bauddhaḥ vā patitaḥ api vā 
SA_MB_dattatreyabodhaHK-48	kāpāliko vā cārvākaḥ śraddhayā sahitaḥ sudhīḥ ||	kāpālikaḥ vā cārvākaḥ śraddhayā sahitaḥ sudhīḥ 
SA_MB_dattatreyabodhaHK-49	yogābhyāsarasonityaṃ sarvasiddhimavāpnuyāt |	yoga abhyāsa rasaḥ nityam sarva siddhim avāpnuyāt 
SA_MB_dattatreyabodhaHK-50	kriyā yuktasya siddhiḥ syādakriyasya kathaṃ bhavet ||	kriyā yuktasya siddhiḥ syāt akriyasya katham bhavet 
SA_MB_dattatreyabodhaHK-51	na śāstra pāṭhamātreṇa yogasiddhiḥ prajāyate ||	na śāstra pāṭha mātreṇa yoga siddhiḥ prajāyate 
SA_MB_dattatreyabodhaHK-52	muṇḍī vā maṇḍadhārī vā kāṣāya vasano'pi vā |	muṇḍī vā maṇḍa dhārī vā vā 
SA_MB_dattatreyabodhaHK-53	nārāyaṇa paro vāpi jaṭilo bhasma lepanaḥ ||	nārāyaṇa paraḥ vā api jaṭilaḥ bhasma lepanaḥ 
SA_MB_dattatreyabodhaHK-54	namaḥ śivāya vākyo vā bāhyārcā pūjako'pi vā |	namaḥ śivāya vākyaḥ vā bāhya arcā pūjakaḥ api vā 
SA_MB_dattatreyabodhaHK-55	sthāna dvādaśa pūrākṣamālā bahu vibhūṣitaḥ ||	sthāna dvādaśa pūrākṣamālā bahu vibhūṣitaḥ 
SA_MB_dattatreyabodhaHK-56	kriyāhīno'thavā krūraḥ kathaṃ siddhimavāpnuyāt |	kriyā hīnaḥ athavā krūraḥ katham siddhim avāpnuyāt 
SA_MB_dattatreyabodhaHK-57	saveṣa dhāraṇaṃ siddhi kāraṇaṃ tañca tatkatham |	dhāraṇam kāraṇam tat ca tat katham 
SA_MB_dattatreyabodhaHK-58	kriyaiva kāraṇaṃ siddhessatyamecca sāṃkṛte ||	kriyā eva kāraṇam siddheḥ satyamet ca sāṃkṛte 
SA_MB_dattatreyabodhaHK-59	śiśnodarārtha yogaśca kathayaṃ yogadhāraṇaḥ |	śiśna udara artha yogaḥ ca yoga dhāraṇaḥ 
SA_MB_dattatreyabodhaHK-60	anuṣṭhāna vihīnāstu vañcayanti janāḥ kila ||	anuṣṭhāna vihīnāḥ tu vañcayanti janāḥ kila 
SA_MB_dattatreyabodhaHK-61	p. 4)	p 
SA_MB_dattatreyabodhaHK-62	uccāvacā vipralaṃbhāmūḍhā yogaparāyaṇāḥ |	uccāvacāḥ vipralaṃbha amūḍhāḥ yoga parāyaṇāḥ 
SA_MB_dattatreyabodhaHK-63	śanaistān tadvidhājñātvā yogābhyāsa vivarjitān ||	śanais tān tadvidha ājñātvā yoga abhyāsa vivarjitān 
SA_MB_dattatreyabodhaHK-64	kṛtvārtha vañcane naiva varjayedveṣadhāriṇaḥ |	kṛtvā artha vañcane na eva varjayet veṣa dhāriṇaḥ 
SA_MB_dattatreyabodhaHK-65	yadasti vighna bhūtāni yogābhyāsasya sarvadā ||	yat asti vighna bhūtāni yoga abhyāsasya sarvadā 
SA_MB_dattatreyabodhaHK-66	varjayet tadviśeṣeṇa īdṛśān siddhijāḥ kriyāḥ |	varjayet tad viśeṣeṇa īdṛśān siddhi jāḥ kriyāḥ 
SA_MB_dattatreyabodhaHK-67	prathamābhyāsakāle tu pramādā vividhā mune || 16 ||	prathama abhyāsa kāle tu pramādāḥ vividhāḥ mune 
SA_MB_dattatreyabodhaHK-68	ālasyaṃ prathamo vighno dvitīyastu prakathyate |	ālasyam prathamaḥ vighnaḥ dvitīyaḥ tu prakathyate 
SA_MB_dattatreyabodhaHK-69	pūrvoktadhūrta goṣṭhī ca tṛtīyomantrasādhanam ||	pūrva ukta dhūrta goṣṭhī ca tṛtīyaḥ mantra sādhanam 
SA_MB_dattatreyabodhaHK-70	caturtho dhātu vādaśca kakṣyāvādastu pañcamaḥ |	caturthaḥ dhātu vādaḥ ca kakṣyā vādaḥ tu pañcamaḥ 
SA_MB_dattatreyabodhaHK-71	ityevaṃ bahavo vighnāḥ mṛgatṛṣṇā samāmune ||	iti evam bahavaḥ vighnāḥ mṛgatṛṣṇā samāmune 
SA_MB_dattatreyabodhaHK-72	sthirāsanasya jāyante tān jñātvā santyajet sudhīḥ |	sthira āsanasya jāyante tān jñātvā santyajet sudhīḥ 
SA_MB_dattatreyabodhaHK-73	prāṇāyāmaṃ tataḥ kuryāt padmāsanagataḥ svayam |	prāṇāyāmam tatas kuryāt padmāsana gataḥ svayam 
SA_MB_dattatreyabodhaHK-74	suśobhanaṃ maṭhaṃ kuryāt sūkṣmadvārañca nirbraṇam ||	su śobhanam maṭham kuryāt sūkṣma dvāram ca nirbraṇam 
SA_MB_dattatreyabodhaHK-75	suṣṭhu liptaṃ gomayena sudhayā vā prayatnataḥ |	suṣṭhu liptam gomayena sudhayā vā prayatnataḥ 
SA_MB_dattatreyabodhaHK-76	matkuṇaiḥ maśakairlūtairvarjitañca dine dine ||	matkuṇaiḥ maśakaiḥ lūtaiḥ varjitam ca dine dine 
SA_MB_dattatreyabodhaHK-77	saṃmṛṣṭaṃ saṃmārjanyā * * * * * na tandritaḥ |	saṃmṛṣṭam saṃmārjanyā      na tandritaḥ 
SA_MB_dattatreyabodhaHK-78	vāsitañca sugandhena dhūpitaṃ guggulādibhiḥ |	vāsitam ca sugandhena dhūpitam guggula ādibhiḥ 
SA_MB_dattatreyabodhaHK-79	malamūtrādibhirvegairaṣṭādaśabhireva ca ||	mala mūtra ādibhiḥ vegaiḥ aṣṭādaśabhiḥ eva ca 
SA_MB_dattatreyabodhaHK-80	varjitaścānna sampannaṃ kabalādina saṃyutam |	varjitaḥ ca anna sampannam 
SA_MB_dattatreyabodhaHK-81	nātyunnataṃ nātinī caṃ parasaṅga vivarjitam ||	para saṅga vivarjitam 
SA_MB_dattatreyabodhaHK-82	tasmin maṭhe samāstīrya hyāsanaṃ nistaraṅgakam |	tasmin maṭhe samāstīrya hi āsanam nistaraṅgakam 
SA_MB_dattatreyabodhaHK-83	tatropaviśyamedhāvī padmāsana samanvitaḥ |	tatra upaviśya medhāvī padmāsana samanvitaḥ 
SA_MB_dattatreyabodhaHK-84	ṛju kāyaḥ prāñjaliśca praṇamyābhīṣṭa devatāḥ ||	ṛju kāyaḥ prāñjaliḥ ca praṇamya abhīṣṭa devatāḥ 
SA_MB_dattatreyabodhaHK-85	tato dakṣiṇahastasyāṅguṣṭhe naiva piṅgalām |	tatas dakṣiṇa hastasya aṅguṣṭhe na eva piṅgalām 
SA_MB_dattatreyabodhaHK-86	nirudhya pūrayedvāyumiḍayā tu śanaiḥ śanaiḥ ||	nirudhya pūrayet vāyum iḍayā tu śanais śanais 
SA_MB_dattatreyabodhaHK-87	yathā śaktyā nirodhena tataḥ kuryācca kumbhakam ||	yathā śaktyā nirodhena tatas kuryāt ca kumbhakam 
SA_MB_dattatreyabodhaHK-88	p. 5)	p 
SA_MB_dattatreyabodhaHK-89	punastyajet piṅgalayā śanaireva na vegataḥ |	punar tyajet piṅgalayā śanais eva na vegataḥ 
SA_MB_dattatreyabodhaHK-90	punaḥ piṅgalyā pūrya pūrayedudaraṃ śanaiḥ ||	punar piṅgalyā pūrya pūrayet udaram śanais 
SA_MB_dattatreyabodhaHK-91	dhārayitvā yathā śaktirecayediḍyā śanaiḥ |	dhārayitvā yathā śakti recayet iḍyā śanais 
SA_MB_dattatreyabodhaHK-92	yathā tyajet yathā pūrya dhārayedanirodhanaḥ ||	yathā tyajet yathā pūrya dhārayet anirodhanaḥ 
SA_MB_dattatreyabodhaHK-93	evaṃ prātaḥ prakūrvīta śaktyā viṃśati saṃkhyayā |	evam prātar prakūrvīta śaktyā viṃśati saṃkhyayā 
SA_MB_dattatreyabodhaHK-94	kumbhakaḥ sahito nāma sarvagraha vivarjitaḥ ||	kumbhakaḥ sahitaḥ nāma sarva graha vivarjitaḥ 
SA_MB_dattatreyabodhaHK-95	evamevārdha rātre'pi punarviṃśati kumbhakān |	evam eva ardha rātre pi punar viṃśati kumbhakān 
SA_MB_dattatreyabodhaHK-96	kurvīta recapūrābhyāṃ sahitaṃ prati vāsaram ||	kurvīta reca pūrābhyām sahitam prati vāsaram 
SA_MB_dattatreyabodhaHK-97	sahito recapūrābhyāṃ tasmātsahita kumbhakaḥ |	sahitaḥ reca pūrābhyām tasmāt sahita kumbhakaḥ 
SA_MB_dattatreyabodhaHK-98	evaṃ māsatrayaṃ kuryānnāḍīśuddhistato bhavet ||	evam māsa trayam kuryāt nāḍī śuddhiḥ tatas bhavet 
SA_MB_dattatreyabodhaHK-99	yadā tu nāḍiśuddhiḥ syāt tadā cihnāni bāhyataḥ |	yadā tu nāḍi śuddhiḥ syāt tadā cihnāni bāhyatas 
SA_MB_dattatreyabodhaHK-100	jāyante yogino dehe tāni vakṣyāmyaśeṣataḥ ||	jāyante yoginaḥ dehe tāni vakṣyāmi aśeṣatas 
SA_MB_dattatreyabodhaHK-101	śarīra laghutādīptirvahnerjaṭhara vartinaḥ |	śarīra laghu tā dīptiḥ vahneḥ jaṭhara vartinaḥ 
SA_MB_dattatreyabodhaHK-102	kṛśatvaṃ ca śarīrasya tadā jāyeta niścitam || 17 ||	kṛśa tvam ca śarīrasya tadā jāyeta niścitam 
SA_MB_dattatreyabodhaHK-103	tathā bhojyāni vakṣyāmi kṣipraṃ yoga prasiddhaye |	tathā bhojyāni vakṣyāmi kṣipram yoga prasiddhaye 
SA_MB_dattatreyabodhaHK-104	kṣīraṃ ghṛtañca miṣṭānnaṃ mitāhārañca śasyate ||	kṣīram ghṛtam ca miṣṭānnam mita āhāraḥ ca śasyate 
SA_MB_dattatreyabodhaHK-105	pūrvokta kāle kuryācca pavanābhyāsameva ca |	pūrva ukta kāle kuryāt ca pavana abhyāsam eva ca 
SA_MB_dattatreyabodhaHK-106	tataḥ paraṃ yatheṣṭhaṃ tu śaktiḥ syādvāyudhāraṇe ||	tatas param yatheṣṭham tu śaktiḥ syāt vāyu dhāraṇe 
SA_MB_dattatreyabodhaHK-107	yatheṣṭha dhāraṇādvāyoḥ siddhyet kevala kumbhakaḥ |	yatheṣṭha dhāraṇāt vāyoḥ siddhyet kevala kumbhakaḥ 
SA_MB_dattatreyabodhaHK-108	kevale kumbhake siddhe recapūra vivarjite ||	kevale kumbhake siddhe recapūra vivarjite 
SA_MB_dattatreyabodhaHK-109	na tatra durlabhaṃ kiñcit triṣu lokeṣu vidyate |	na tatra durlabham kiñcid triṣu lokeṣu vidyate 
SA_MB_dattatreyabodhaHK-110	prasvedo jāyate pūrvaṃ mardanaṃ tena kārayet ||	prasvedaḥ jāyate pūrvam mardanam tena kārayet 
SA_MB_dattatreyabodhaHK-111	tato'pi dhāraṇādvāyoḥ krameṇaiva śanaiḥ śanaiḥ |	tatas api dhāraṇāt vāyoḥ krameṇa eva śanais śanais 
SA_MB_dattatreyabodhaHK-112	ka pā bhavati dehasya āsane tasya yoginaḥ ||	ka pā bhavati dehasya āsane tasya yoginaḥ 
SA_MB_dattatreyabodhaHK-113	tato'dhikatarābhyāsāddurdaro jāyate dhruvam |	tatas adhikatara abhyāsāt durdaraḥ jāyate dhruvam 
SA_MB_dattatreyabodhaHK-114	yathā ca dadadrurodghoṣamutpatyotpatya bhūtale ||	yathā ca dadadrurā udghoṣam utpatya utpatya bhū tale 
SA_MB_dattatreyabodhaHK-115	p. 6)	p 
SA_MB_dattatreyabodhaHK-116	padmāsana sthito yogī tathā ca gati bhūtale |	padmāsana sthitaḥ yogī tathā ca bhū tale 
SA_MB_dattatreyabodhaHK-117	tatodhikatarābhyāsādbhūmistyāgaśca jāyate ||	tatas adhikatara abhyāsāt bhūmiḥ tyāgaḥ ca jāyate 
SA_MB_dattatreyabodhaHK-118	padmāsanastha evāsau bhūmimaspṛśya vartate |	padmāsana sthaḥ eva asau bhūmim a spṛśya vartate 
SA_MB_dattatreyabodhaHK-119	nirādhāro vicitraṃ hi tathā sāmarthyamāpnuyāt ||	nirādhāraḥ vicitram hi tathā sāmarthyam āpnuyāt 
SA_MB_dattatreyabodhaHK-120	abhuktvā yadi vā bhuktvā yogī na vyathate tathā |	a bhuktvā yadi vā bhuktvā yogī na vyathate tathā 
SA_MB_dattatreyabodhaHK-121	alpamūtra purīṣaḥ syāt svalpanidrā ca jāyate |	syāt su alpa nidrā ca jāyate 
SA_MB_dattatreyabodhaHK-122	kīṭakā dūṣitā lālā svedo durgandhatānane ||	kīṭakāḥ dūṣitāḥ lālā svedaḥ durgandha tā ānane 
SA_MB_dattatreyabodhaHK-123	etāni sarvadā tasya na jāyante tataḥ param |	etāni sarvadā tasya na jāyante tatas param 
SA_MB_dattatreyabodhaHK-124	tatodhika tarābhyāsāt balamutpadyate bhṛśam ||	tatas adhika tara abhyāsāt balam utpadyate bhṛśam 
SA_MB_dattatreyabodhaHK-125	yena bhūcarasiddhissyādbhūcaraṇāṃ jaye kṣamaḥ |	yena bhūcara siddhiḥ syāt bhūcaraṇām jaye kṣamaḥ 
SA_MB_dattatreyabodhaHK-126	vyāghro lulāyo vanyo vā gavayo gaja eva vā ||	vyāghraḥ lulāyaḥ vanyaḥ vā gavayaḥ gajaḥ eva vā 
SA_MB_dattatreyabodhaHK-127	siṃho vā yoginā tena mriyate nātra saṃśayaḥ |	siṃhaḥ vā yoginā tena mriyate na atra saṃśayaḥ 
SA_MB_dattatreyabodhaHK-128	tasmin kāle mahāvighno yoginaḥ syāt pramādataḥ |	tasmin kāle mahā vighnaḥ yoginaḥ syāt pramādataḥ 
SA_MB_dattatreyabodhaHK-129	tadrūpa vaśagānārya kāsṛ?kṣante tasya saṅgamam |	tasya saṅgamam 
SA_MB_dattatreyabodhaHK-130	yadi saṅgaṃ karotyeva bindustasya vinaśyati ||	yadi saṅgam karoti eva binduḥ tasya vinaśyati 
SA_MB_dattatreyabodhaHK-131	āyuḥ kṣayo bindu hāni rasāmarthyañca jāyate |	āyuḥ kṣayaḥ bindu hāni rasāmarthyañca jāyate 
SA_MB_dattatreyabodhaHK-132	tasmāt strīṇāṃ varjya saṅgaṃ kuryādabhyāsamādarāt ||	tasmāt strīṇām varjya saṅgam kuryāt abhyāsam ādarāt 
SA_MB_dattatreyabodhaHK-133	yogino'ṅge sugandhaḥ syāt satataṃ bindudhāraṇāt |	yoginā uṅge sugandhaḥ syāt satatam bindu dhāraṇāt 
SA_MB_dattatreyabodhaHK-134	tasmāt sarva prayatnena bindurakṣā hi yoginaḥ |	tasmāt sarva prayatnena bindurakṣā hi yoginaḥ 
SA_MB_dattatreyabodhaHK-135	tato rahasyupāviṣṭaḥ praṇavaṃ plutaṃ mātrayā ||	tatas rahasi upāviṣṭaḥ praṇavam plutam mātrayā 
SA_MB_dattatreyabodhaHK-136	japet pūrvārjitānāñca pāpānāṃ nāśahatave |	japet pūrva arjitānām ca pāpānām nāśa hatave 
SA_MB_dattatreyabodhaHK-137	sarva vighna haraścāyaṃ praṇavassarva doṣahā ||	sarva vighna haraḥ ca ayam praṇavaḥ sarva doṣa hā 
SA_MB_dattatreyabodhaHK-138	evamabhyāsa yogena siddhirāraṃbha saṃbhavā |	evam abhyāsa yogena siddhiḥ āraṃbha saṃbhavā 
SA_MB_dattatreyabodhaHK-139	bhavettato ghaṭāvasthā pavanābhyāsatassadā ||	bhavet tatas ghaṭa avasthā pavana abhyāsataḥ sadā 
SA_MB_dattatreyabodhaHK-140	prāṇāpāno manovāyurjīvātma paramātmanoḥ |	prāṇa apānaḥ manaḥ vāyuḥ jīvātma paramātmanoḥ 
SA_MB_dattatreyabodhaHK-141	anyonyasyā viśuddhenaikatāṃ ghaṭe yataḥ |	anyonyasyāḥ viśuddhena eka tām ghaṭe yatas 
SA_MB_dattatreyabodhaHK-142	tasmād ghaṭākhyāyāvasthā prasiddhā yoginaḥ smṛtā ||	tasmāt ghaṭa ākhyāya avasthā prasiddhā yoginaḥ smṛtā 
SA_MB_dattatreyabodhaHK-143	tatra cihnāni yāni syustāni vakṣyāmyaśeṣataḥ |	tatra cihnāni yāni syuḥ tāni vakṣyāmi aśeṣatas 
SA_MB_dattatreyabodhaHK-144	pūrvaṃ catkathitābhyāsa caturthātsaṃparityajet ||	pūrvam caturthāt saṃparityajet 
SA_MB_dattatreyabodhaHK-145	divā vā yadi vā rātrau yāma mātraṃ samabhyaset |	divā vā yadi vā rātrau yāma mātram samabhyaset 
SA_MB_dattatreyabodhaHK-146	ekavāraṃ pṛ kuryāt kevala kumbhakam |	eka vāram kuryāt kumbhakam 
SA_MB_dattatreyabodhaHK-147	pratyāhāro yamenasyā deva kartuṃ hi yoginaḥ ||	pratyāhāraḥ deva kartum hi yoginaḥ 
SA_MB_dattatreyabodhaHK-148	indriyāṇīndriyārthebhyo yaḥ pratyāharati svayam |	indriyāṇi indriyārthebhyaḥ yaḥ pratyāharati svayam 
SA_MB_dattatreyabodhaHK-149	yogīkumbhakamāsthāya pratyāhāraḥ sa ucyate ||	                
SA_MB_dattatreyabodhaHK-150	yadyat paśyati cakṣurbhyāṃ taṃtamātmeti bhāvayet |	yat yat paśyati cakṣurbhyām taṃ tama ātmā iti bhāvayet 
SA_MB_dattatreyabodhaHK-151	yadyacchruṇoti karṇābhyātaṃtamātmeti bhāvayet ||	yat yat śruṇoti ātmā iti bhāvayet 
SA_MB_dattatreyabodhaHK-152	yadyajjighrati nāsāyāṃ taṃtamātmeti bhāvayet |	yat yat jighrati nāsāyām taṃ tam ātmā iti bhāvayet 
SA_MB_dattatreyabodhaHK-153	jihvayā yadrasayatitaṃtamātmeti bhāvayet ||	jihvayā yat rasayati tat tam ātmā iti bhāvayet 
SA_MB_dattatreyabodhaHK-154	tvacā yat spṛśyate yogī taṃtamātmeti bhāvayet ||	tvacā yat spṛśyate yogī taṃtama ātmā iti bhāvayet 
SA_MB_dattatreyabodhaHK-155	evaṃ jñānendriyāṇāñca tattatsaṃkhyāñca bhāvayet |	evam jñāna indriyāṇām ca tad tad saṃkhyām ca bhāvayet 
SA_MB_dattatreyabodhaHK-156	yāmamātraṃ pratidinaṃ yogī yatnādatandritaḥ ||	yāma mātram pratidinam yogī yatnāt atandritaḥ 
SA_MB_dattatreyabodhaHK-157	tato vicitrasāmarthyaṃ jāyate yogino bhṛśam |	tatas vicitra sāmarthyam jāyate yoginaḥ bhṛśam 
SA_MB_dattatreyabodhaHK-158	dūradṛṣṭirdūraśrutiḥ kṣaṇāddūrā gamastathā |	dūra dṛṣṭiḥ dūra śrutiḥ kṣaṇāt dūrā gamaḥ tathā 
SA_MB_dattatreyabodhaHK-159	khecaratvaṃ hi jāyeta santatābhyāsa yogataḥ ||	khecara tvam hi jāyeta santata abhyāsa yogataḥ 
SA_MB_dattatreyabodhaHK-160	tathā buddhimatāṃ bhāvyaṃ yogināṃ yogasiddhaye |	tathā buddhimatām bhāvyam yoginām yoga siddhaye 
SA_MB_dattatreyabodhaHK-161	ete vighnā mahāsiddhernarametteṣu buddhimān ||	ete vighnāḥ mahā siddheḥ na ramet teṣu buddhimān 
SA_MB_dattatreyabodhaHK-162	na darśayecca lokāya svasāmarthyaṃ hi sarvadā |	na darśayet ca lokāya sva sāmarthyam hi sarvadā 
SA_MB_dattatreyabodhaHK-163	kadāciddarśayet prītyā bhakti yuktāya vā punaḥ ||	kadācid darśayet prītyā bhakti yuktāya vā punar 
SA_MB_dattatreyabodhaHK-164	yathā mukto yathā mūḍho yathā badhira eva vā |	yathā muktaḥ yathā mūḍhaḥ yathā badhiraḥ eva vā 
SA_MB_dattatreyabodhaHK-165	tathā varteta lokeṣu svasāmarthyasya guptaye ||	tathā varteta lokeṣu sva sāmarthyasya guptaye 
SA_MB_dattatreyabodhaHK-166	p. 8)	p 
SA_MB_dattatreyabodhaHK-167	nocecchiṣya bahavo bhavantyeva priyaṅkarāḥ |	no ced śiṣya bahavaḥ bhavanti eva priyaṅkarāḥ 
SA_MB_dattatreyabodhaHK-168	svasvakāryeṣu yogīndraṃ prārthayanti na saṃśayaḥ ||	sva sva kāryeṣu yogi indram prārthayanti na saṃśayaḥ 
SA_MB_dattatreyabodhaHK-169	tatkarmakāraṇātyugra svābhyāso vismṛto bhavet |	tad karma kāraṇā ati ugra sva abhyāsaḥ vismṛtaḥ bhavet 
SA_MB_dattatreyabodhaHK-170	abhyāsena vihīnastu tato laukikatāṃ vrajet ||	abhyāsena vihīnaḥ tu tatas laukika tām vrajet 
SA_MB_dattatreyabodhaHK-171	avismṛtya gurorvākyamabhyaset tadaharniśam |	a vismṛtya guroḥ vākyam abhyaset tat aharniśam 
SA_MB_dattatreyabodhaHK-172	evaṃ bhaved ghaṭāvasthā satatābhyāsayogataḥ ||	evam bhavet ghaṭa avasthā satata abhyāsa yogataḥ 
SA_MB_dattatreyabodhaHK-173	anabhyāsena taccaiva vṛthā goṣṭhyo na siddhyati |	anabhyāsena tat ca eva vṛthā goṣṭhyaḥ na siddhi ati 
SA_MB_dattatreyabodhaHK-174	tasmāt sarva prayatnena yogameva samabhyaset |	tasmāt sarva prayatnena yogam eva samabhyaset 
SA_MB_dattatreyabodhaHK-175	tataḥ paricayāvasthā jāyate bhyāsa yogataḥ ||	tatas paricaya avasthā jāyate bhyāsa yogataḥ 
SA_MB_dattatreyabodhaHK-176	vāyuḥ paricito yasmāt agninā sahakuṇḍalīm |	vāyuḥ paricitaḥ yasmāt agninā saha kuṇḍalīm 
SA_MB_dattatreyabodhaHK-177	bodhayitvā suṣumnāyāṃ praviśedavirodhataḥ ||	bodhayitvā suṣumnāyām praviśet avirodhataḥ 
SA_MB_dattatreyabodhaHK-178	vāyunā saha cittañca praviśecca mahāpatham |	vāyunā saha cittam ca praviśet ca mahāpatham 
SA_MB_dattatreyabodhaHK-179	mahāpatha śmaśānaṃ ca suṣumnāpyekameva hi |	mahāpatha śmaśānam ca suṣumna api ekam eva hi 
SA_MB_dattatreyabodhaHK-180	nāmnā maṃtāntare bhedaḥ phalabhedena vidyate ||	nāmnā maṃtā antare bhedaḥ phala bhedena vidyate 
SA_MB_dattatreyabodhaHK-181	vartamānaṃ bhaviṣyañca bhūtāsannaiva veṣṭhiyam |	vartamānam bhaviṣyat ca bhūta āsanna eva 
SA_MB_dattatreyabodhaHK-182	yasya citraṃ savapanaṃ suṣumnaṃ praviśediha ||	yasya citram sa vapanam suṣumnam praviśet iha 
SA_MB_dattatreyabodhaHK-183	bhāvyānyarthāni vijñeyā yogorahasti yatnataḥ |	bhāvyāni arthāni vijñeyāni yogorahaḥ ti yatnataḥ 
SA_MB_dattatreyabodhaHK-184	pañcavādhāraṇaṃ kuryāt tattadbhūta bhayāpahām ||	kuryāt tad tad bhūta bhaya apahām 
SA_MB_dattatreyabodhaHK-185	nābheradho gudasyordhvaṃ ghuṭikā pañcadhārayet |	nābheḥ adhas gudasya ūrdhvam guṭikā pañca dhārayet 
SA_MB_dattatreyabodhaHK-186	vāyvo labhate pṛthvī dhāraṇāt tadbhayāpahā ||	vāyvaḥ labhate pṛthvī dhāraṇāt tad bhaya apahā 
SA_MB_dattatreyabodhaHK-187	pṛthivī saṃbhavo mṛtyurna bhavedasya yoginaḥ |	pṛthivī saṃbhavaḥ mṛtyuḥ na bhavet asya yoginaḥ 
SA_MB_dattatreyabodhaHK-188	iti pṛthvī dhāraṇā ||	iti pṛthvī dhāraṇā 
SA_MB_dattatreyabodhaHK-189	nābhisthāna tato vāyuḥ dhārayet pañca nāḍikāḥ ||	nābhisthāna tatas vāyuḥ dhārayet pañca nāḍikāḥ 
SA_MB_dattatreyabodhaHK-190	agni yathā vidhanna mṛtyustasya vahninā |	agni yathā vidhan na mṛtyuḥ tasya vahninā 
SA_MB_dattatreyabodhaHK-191	nadahyataśśarīrañca pratiṣṭhedagni maṇḍala ityagni dhāraṇam ||	na dahyataḥ śarīram ca pratiṣṭhet agni maṇḍale iti agni dhāraṇam 
SA_MB_dattatreyabodhaHK-192	nābhi bhrūghrāṇa madhye tu pradeśa trayasaṃmite |	nābhi bhrū ghrāṇa madhye tu pradeśa traya saṃmite 
SA_MB_dattatreyabodhaHK-193	dhārayat pañcaghaṭikāṃ vāyuśeṣā hi vāyavi ||	dhārayat pañca ghaṭikām vāyu śeṣā hi vāyavi 
SA_MB_dattatreyabodhaHK-194	p. 9)	p 
SA_MB_dattatreyabodhaHK-195	dhāraṇānna tu vāyvostu bhayaṃ bhavatu yoginaḥ || iti vāyu dhāraṇā ||	dhāraṇāt na tu vāyvoḥ tu bhayam bhavatu yoginaḥ iti 
SA_MB_dattatreyabodhaHK-196	bhrumadhyādupari tu dhārayet pañcanāḍikāḥ | vāyuṃ yogī prayatnena	bhru madhyāt upari tu dhārayet pañca nāḍikāḥ vāyum yogī prayatnena 
SA_MB_dattatreyabodhaHK-197	vyayamākāśa dhāraṇā || ākāśadhāraṇaṃ kurvan mṛtyuṃ jayati adbhutam |	vyayam ākāśa dhāraṇā ākāśa dhāraṇam kurvan mṛtyum jayati adbhutam 
SA_MB_dattatreyabodhaHK-198	yatra kutra sthito vāpi sukhamatyantamaśnute || iti pañca vidhāṃ bhūtāṃ	yatra kutra sthitaḥ vā api sukham atyantam aśnute iti pañca vidhām bhūtām 
SA_MB_dattatreyabodhaHK-199	bhūtadhāraṇāṃ yaḥ samabhyaset | brahmaṇaḥ pralayedyāpi tasya mṛtyurna	bhūtadhāraṇām yaḥ samabhyaset brahmaṇaḥ pralayet yā api tasya mṛtyuḥ na 
SA_MB_dattatreyabodhaHK-200	vidyate || samabhyaset tadā dhyānaṃ ghaṭikā ṣaṣṭimeva ca | vāyumārudhya	vidyate samabhyaset tadā dhyānam ghaṭikā ṣaṣṭim eva ca vāyum ārudhya 
SA_MB_dattatreyabodhaHK-201	cākārādevatāmiṣṭadāyinīm || saguṇa dhyānametasya daṇimādi guṇa pradam |	cākārā devatām iṣṭa dāyinīm saguṇa dhyānam etasya daṇima ādi guṇa pradam 
SA_MB_dattatreyabodhaHK-202	nirguṇaṃ khamiva dhyātvā mokṣamārgaṃ prapadyate || nirguṇadhyānametañca	nirguṇam kham iva dhyātvā mokṣa mārgam prapadyate nirguṇa dhyānam etat ca 
SA_MB_dattatreyabodhaHK-203	samādhiñca tato bhyaset | dinadvādaśakenaiva samādhiṃ samavāpnuyāt || vāyuṃ	samādhim ca tatas bhyaset dina dvādaśakena eva samādhim samavāpnuyāt vāyum 
SA_MB_dattatreyabodhaHK-204	nirudhya medhāvī jīvanmukto bhaved dṛḍham | samādhiḥ samatāvasthā jīvātma	nirudhya medhāvī jīvanmuktaḥ bhavet dṛḍham samādhiḥ samatā avasthā jīvātma 
SA_MB_dattatreyabodhaHK-205	paramātmanoḥ ||	parama ātmanoḥ 
SA_MB_dattatreyabodhaHK-206	yadi svadehamutsṛṣṭamicchecchedudvrajet svayam |	yadi sva deham utsṛṣṭam icchet icchet udvrajet svayam 
SA_MB_dattatreyabodhaHK-207	para brahmaṇi līyante tyaktvā karma śubhāśubham ||	para brahmaṇi līyante tyaktvā karma śubha aśubham 
SA_MB_dattatreyabodhaHK-208	acanocet samutsraṣṭuṃ svaśarīraṃ yadi priyam |	acana ucet samutsraṣṭum sva śarīram yadi priyam 
SA_MB_dattatreyabodhaHK-209	sarvalokeṣu vicaret dakṣiṇamādi guṇānvitaḥ ||	sarva lokeṣu vicaret dakṣiṇamādi guṇa anvitaḥ 
SA_MB_dattatreyabodhaHK-210	kadācitsvecchayā deho bhūtvā svarge'pi saṃbhave |	kadācid sva icchayā dehaḥ bhūtvā svarge api saṃbhave 
SA_MB_dattatreyabodhaHK-211	manuṣyo vāpi yoṣā vā svecchayā pekṣaṇādbhavet ||	manuṣyaḥ vā api yoṣā vā sva icchayā pekṣaṇāt bhavet 
SA_MB_dattatreyabodhaHK-212	siṃho vyāghra gajo vā syāt icchayā jantunāṃ vrajet |	siṃhaḥ vyāghra gajaḥ vā syāt icchayā jantunām vrajet 
SA_MB_dattatreyabodhaHK-213	yadīṣṭameva dhatte tu yogī yadyanmaheśvaraḥ |	yadi iṣṭam eva dhatte tu yogī yat yat maheśvaraḥ 
SA_MB_dattatreyabodhaHK-214	kapi mārgo'yamuktaste sāṃskṛteṣṭāṃga yogataḥ ||	kapi mārgaḥ yam uktaḥ te sāṃskṛta iṣṭāṃga yogataḥ 
SA_MB_dattatreyabodhaHK-215	tato bhavedrāja yogonānāntarā bhavati dhruvam |	tatas bhavet rāja yogaḥ ūna anā antarā bhavati dhruvam 
SA_MB_dattatreyabodhaHK-216	na cinmātreṇa siddhiḥ syāt dabhyāsādeva jāyate ||	na cit mātreṇa siddhiḥ syāt d abhyāsāt eva jāyate 
SA_MB_dattatreyabodhaHK-217	rāja yogapadaṃ prāpya sarvasatvavaśaṃkara |	rāja yoga padam prāpya sarva satva vaśaṃkara 
SA_MB_dattatreyabodhaHK-218	sarvaṃ kuryānnavā kuryādyathā ruciviśeṣayet ||	sarvam kuryāt na vā kuryāt yathā ruci viśeṣayet 
SA_MB_dattatreyabodhaHK-219	yathā tu rājayogena niṣpannā yoginaḥ kriya |	yathā tu rājayogena niṣpannāḥ yoginaḥ 
SA_MB_dattatreyabodhaHK-220	tadā vasthā diniṣpannā unmanyā nandarūpiṇī ||	tadā vasthā diniṣpannā unmanyā nanda rūpiṇī 
SA_MB_dattatreyabodhaHK-221	saṃsiddhā yoginaścāsya bhuktimukti pradāpayet |	saṃsiddhāḥ yoginaḥ ca asya bhukti mukti pradāpayet 
SA_MB_dattatreyabodhaHK-222	sarvaṃ tu kalitaṃ brahman saṃsmṛtaṃ yogamācaret || 16 ||	sarvam tu kalitam brahman saṃsmṛtam yogam ācaret 
SA_MB_dattatreyabodhaHK-223	sarvasiddhimavāpyāsmaddattātreya prasādataḥ |	sarva siddhim avāpya asmat dattātreya prasādataḥ 
SA_MB_dattatreyabodhaHK-224	yastaditthaṃ paṭhennityaṃ sādhubhyaḥ kathayediti |	yaḥ tat ittham paṭhet nityam sādhubhyaḥ kathayet iti 
SA_MB_dattatreyabodhaHK-225	tasya yoga krameṇaiva sidhyatyeva na saṃśayaḥ ||	tasya yoga krameṇa eva sidhyati eva na saṃśayaḥ 
SA_MB_dattatreyabodhaHK-226	p. 10)	p 
SA_MB_dattatreyabodhaHK-227	yoginobhyāsa saṃsaktā araṇyeṣu gṛheṣu vā |	yoginaḥ abhyāsa saṃsaktāḥ araṇyeṣu gṛheṣu vā 
SA_MB_dattatreyabodhaHK-228	bahukālaṃ ramantyeva janasaṃghavivarjitāḥ ||	bahukālam ramanti eva jana saṃgha vivarjitāḥ 
SA_MB_dattatreyabodhaHK-229	tasmātsarvaprayatnena sāṃgameva samabhyaset ||	tasmāt sarva prayatnena sa aṃgam eva samabhyaset 
SA_MB_dattatreyabodhaHK-230	yogābhyāso janma phalaṃ niṣphalā itarāḥ kriyāḥ |	yoga abhyāsaḥ janma phalam niṣphalāḥ itarāḥ kriyāḥ 
SA_MB_dattatreyabodhaHK-231	mahāmāyā prabhāveṇa sarveṣāmastu citsukham |	mahāmāyā prabhāveṇa sarveṣām astu cit sukham 
SA_MB_dattatreyabodhaHK-232	yatnassarvastadāyattattāmevā rādhayet tataḥ ||	yatnaḥ sarvaḥ tadā āyattat tām eva rādhayet tatas 
SA_MB_dattatreyabodhaHK-233	iti dattātreyabodhaḥ samāptaḥ ||	iti dattātreya bodhaḥ samāptaḥ 
SA_MB_dattatreyabodhaHK-234	|| hariḥ oṃ ||	hariḥ om 
SA_MB_dattatreyabodhaHK-235	śubhamastu ||	śubham astu 
SA_MB_dattatreyabodhaHK-236	MUKTABODHA INDOLOGICAL RESEARCH INSTITUTE©2011 Muktabodha Indological Research Institute  All Rights Reserved.E-texts may be viewed only online or downloaded for private study.E-texts may not, under any circumstances, be copied, republished,reproduced, distributed or sold, either in original or altered form, withoutthe express permission of Muktabodha Indological Research Institute in writing.Data-entered by the staff of Muktabodha under the direction of Mark S. G. Dyczkowski.	muktabodha indological research muktabodha indological research institute all rights reserved texts may be viewed only online or downloaded for private studye texts may not under any circumstances be copied republished reproduced distributed or sold either in original or altered form withoutthe express permission of muktabodha indological research institute in writing data entered by the staff of muktabodha under the direction of mark s g dyczkowski 
