segmentnr	original	analyzed
SA_MB_mahaalak-0	Muktabodha E-text in UTF-8	muktabodha etext in utf
SA_MB_mahaalak-1	###########################################################################MUKTABODHA INDOLOGICAL RESEARCH INSTITUTEwww.muktabodha.org©2011 Muktabodha Indological Research Institute  All Rights Reserved.E-texts may be viewed only online or downloaded for private study.E-texts may not, under any circumstances, be copied, republished,reproduced, distributed or sold, either in original or altered form, withoutthe express permission of Muktabodha Indological Research Institute in writing.Data-entered by the staff of Muktabodha under the direction of Mark S. G. Dyczkowski.Catalog number : M04004	muktabodha indological research muktabodha indological research institute all rights reserved texts may be viewed only online or downloaded for private studye texts may not under any circumstances be copied republished reproduced distributed or sold either in original or altered form withoutthe express permission of muktabodha indological research institute in writing data entered by the staff of muktabodha under the direction of mark s g dyczkowskicatalog number  /
SA_MB_mahaalak-2	Uniform title: mahālakṣmīdīpadānavidhiḥ	uniform title mahālakṣmī dīpa dāna vidhiḥ 
SA_MB_mahaalak-3	Manuscript : NGMCP manuscript no: 1571 reel No. A 246/2	manuscript ns U 
SA_MB_mahaalak-4	Description: A liturgical manual on the worship of mahālakṣmī	description a liturgical manual on the worship of mahālakṣmī 
SA_MB_mahaalak-5	Notes: Data entered by the staff of Muktabodha under the direction of Mark S. G. Dyczkowski.	notes data entered by the staff muktabodha under the direction of mark s g dyczkowski 
SA_MB_mahaalak-6	Revision 0: April 27, 2017	revision april 
SA_MB_mahaalak-7	Publication country : India	publication country india 
SA_MB_mahaalak-8	p. 1a) śrīgurubhyo namaḥ ||	a śrī gurubhyaḥ namaḥ 
SA_MB_mahaalak-9	śrīmahālakṣmī devyai ||	śrī mahālakṣmī devyai 
SA_MB_mahaalak-10	athamahādīpacchoyarkayā pūjāvidhi likhyate ||	likhyate 
SA_MB_mahaalak-11	petavāsanamālakocoya vidhithyaṃ jiyake ||	vidhithyam jiyake 
SA_MB_mahaalak-12	yajamānapuṣpabhājanaṃ || adyādi || vākya ||	yajamāna puṣpa bhājanam 
SA_MB_mahaalak-13	mānavagotrayajamānasya śrī śrī jayarūpatīndramallavarvaṇa śrīśrīśrī mahālakṣmī	mānava gotra yajamānasya śrī śrī jayarūpati indramallavarvaṇa śrī śrī śrī mahālakṣmī 
SA_MB_mahaalak-14	devatā prītyarthaṃ ||	devatā prīti artham 
SA_MB_mahaalak-15	viśvajātrāmahādīpa prajvālita pañcopacārapūjākatuṃ puṣpabhājanaṃ	viśva jātrā mahā dīpa prajvālita pañca upacāra pūjā katum puṣpa bhājanam 
SA_MB_mahaalak-16	samarpayāmi ||	samarpayāmi 
SA_MB_mahaalak-17	śrīsamvartā maṇḍalānte kramapadanihitā nandaśaktiḥ subhīmāsṛṣṭaṃ	śrī samvartā maṇḍala ante krama pada nihitā nanda śaktiḥ 
SA_MB_mahaalak-18	nyāyacatuṣkaṃ akulakulagataṃ paṃcakaṃ cānya ṣaṭkaṃ |	nyāya catuṣkam a kula kula gatam paṃcakam 
SA_MB_mahaalak-19	p. 1b) catvāraḥ pañcakonyaṃ punarapicaturaṃ tatvato maṇḍalena saṃsṛṣṭaṃ yena	catvāraḥ punar api caturam maṇḍalena saṃsṛṣṭam yena 
SA_MB_mahaalak-20	tasmainamanaguruvaraṃ bhairavaśrīkujeśa ||	tasmai nam an aguru varam bhairava śrī kuja īśa 
SA_MB_mahaalak-21	vrahmāṇīkamalendu saumyavadanī māheśvarī lirayā kaumārī ripudarghanāsanakarī	                        
SA_MB_mahaalak-22	cakrāyudhā vaiṣṇavī ||	cakra āyudhā vaiṣṇavī 
SA_MB_mahaalak-23	vārāhīghanaghora gharghanamukhī endrī ca vajrāyudhā cāmuṇḍāgaṇanātha bhairava	vārāhī ghana ghora gharghana mukhī ca vajrāyudhā cāmuṇḍā gaṇanātha bhairava 
SA_MB_mahaalak-24	gaṇārakṣantume mātṛkā ||	mātṛkā 
SA_MB_mahaalak-25	śyāmāraktāninetrā stanabharaṇamitāmattamāṭaṃ gagāmi vimvosthicārunetrā pṛthuta	stana bharaṇa mita āmatta māṭam stana bharaṇa mita āmatta māṭam 
SA_MB_mahaalak-26	rajaṃghanāmekharāratna sobhe || devāgevayusobhe varavarakusume varvare keśabhāre	vara vara kusume varvare keśabhāre 
SA_MB_mahaalak-27	sāmeśrīkubjikākhyā vitaratutarasājñānadi vyoghamogha ||	vyogha mogha 
SA_MB_mahaalak-28	p. 2a) utphullāmvujakarṇikopari | gatāśrīsiddhilakṣmī parākarpūre	utphulla ambuja karṇikā upari gatā aśrī siddhi lakṣmī parā karpūre 
SA_MB_mahaalak-29	sphaṭikendukuṇḍadhavarāniśrekapāpopahā |	               
SA_MB_mahaalak-30	saṃsārātnavaduḥkha paṃkajaharinīskampamaṃ sarvadā śrīmatpañcamukhāmvujā	sarvadā śrīmat pañcamukha amvujā 
SA_MB_mahaalak-31	daśabhujāpreta sthitāpātuva ||	sthitāpātuva 
SA_MB_mahaalak-32	saundaryasāraruvirāṃ kamalāyatākṣīṃ pīnastanīṃ lalitahārasuśobha mānā |	saundarya sāra ruvirām kamala āyata akṣīm pīna stanīm lalita hāra su śobha mānā 
SA_MB_mahaalak-33	khaḍga triśūlavaradābhayapāṇi rūpāṃ lakṣmīṃ namāmiśirasāmahanīñca	khaḍga triśūla varada abhaya pāṇi rūpām lakṣmīm namāmi śirasāmahanīm ca 
SA_MB_mahaalak-34	mūrtiṃ ||	mūrtim 
SA_MB_mahaalak-35	p. 2b) siddhirayūkriyārambhe vṛddhirayūdhanāgame |	siddhirayū kriyā ārambhe vṛddhirayū dhana āgame 
SA_MB_mahaalak-36	puṣṭhirayūśarīreṣu śāntirayūgṛhetava |	puṣṭhirayū śarīreṣu 
SA_MB_mahaalak-37	sarvavighnipraśamanaṃ sarvaśāntikaraṃ śubhaṃ |	             
SA_MB_mahaalak-38	āyuḥ putravakāmaṃ ca lakṣmīḥ santativardhanaṃ yathā vānaprahārāṇāṃ kavacaṃ	āyuḥ ca lakṣmīḥ santati vardhanam yathā vānaprahārāṇām kavacam 
SA_MB_mahaalak-39	bhava tu vāraṇaṃ tadvadevavidhātrāṇāṃ śāntibhava tu vāraṇaṃ ||	bhava tu vāraṇam tadvat deva vidhātrāṇām śānti bhava tu vāraṇam 
SA_MB_mahaalak-40	puṣpabhājanaṃ samappayāmiḥ || gurunamaskāla ||	puṣpa bhājanam 
SA_MB_mahaalak-41	ai& 5 hrā& ātmatatvāya svāhā || ai 5 hrī& vidyātatvāyasvāhā || ai 5 hū& śivatatvāya	ai hrāḥ ātma tatvāya svāhā ai hrī vidyā tatvāya svāhā ai hū śiva tatvāya 
SA_MB_mahaalak-42	svāhā || ai 5 akhaṇḍamaṇḍalākāraṃ vyāptaṃ yena carācaraṃ |	svāhā ai akhaṇḍa maṇḍala ākāram vyāptam yena carācaram 
SA_MB_mahaalak-43	tat padaṃ daśitaṃ yena tasmai śrīguruvenamaḥ ||	tat padam daśitam yena tasmai śrī guru venamaḥ 
SA_MB_mahaalak-44	p. 3a) ai& 5 guruvahmāguruviṣṇugurudeva maheśvaraṃ |	guru vahma a guru viṣṇu guru deva maheśvaram 
SA_MB_mahaalak-45	gurudevajagatsarvaṃ tasmaiśrīguruvenamaḥ || paramagurubhyo namaḥ || parameṣṭhī	guru deva jagat sarvam tasmai śrī guru ve namaḥ parama gurubhyaḥ namaḥ parameṣṭhī 
SA_MB_mahaalak-46	gurubhyo namaḥ || paramācārya gurubhyo namaḥ || vali || padmāsanāya namaḥ || thavake	gurubhyaḥ namaḥ parama ācārya gurubhyaḥ namaḥ vali padmāsanāya namaḥ thavake 
SA_MB_mahaalak-47	kūrmāsanāya pādukāṃ || nyāsa ||	kūrma āsanāya pādukām 
SA_MB_mahaalak-48	ai& 5 hū& phaṭ vajrapaṃjare svāhā || calamakule kulamacare hrī& hrū& phaṭ svāhā || ma&	ai hū phaṭ vajrapaṃjare svāhā calamakule kulamacare hrī hrū phaṭ svāhā 
SA_MB_mahaalak-49	astrāya phaṭ || karaśodhanaṃ || mā& kaniṣṭhāya namaḥ || mī& anāmikāya svāhā || mū&	astrāya phaṭ kara śodhanam mā kaniṣṭhāya namaḥ mī anāmikāya svāhā 
SA_MB_mahaalak-50	madhyemāyavoṣaṭ || mai& tarjanyāya hū& || mau& aṅgaṣṭhāya vaṣaṭ || ma& astrāya phaṭ ||	mai tarjanyāya hū mau aṅgaṣṭhāya vaṣaṭ ma astrāya phaṭ 
SA_MB_mahaalak-51	p. 3b) mā& hṛdayāya namaḥ || mī& śirase svāhā || mū& śikhāya vauṣaṭ || mai& kavacāya	p mā hṛdayāya namaḥ mī śirase svāhā mū śikhāya vauṣaṭ mai kavacāya 
SA_MB_mahaalak-52	hū& || mau& netratrayāyavaṣaṭ || ma& astrāyaphaṭ || jalapātrapūjā || ai& 5 hrī&	hū mau netratrayāya vaṣaṭ ma astrāya phaṭ jala pātra pūjā ai hrī 
SA_MB_mahaalak-53	jalapātrāsanāya pādukāṃ || ai& 5 hskṣmlvryū& ānandaśakti bhairavānanda	jala pātra āsanāya pādukām ai ānanda śakti bhairava ānanda 
SA_MB_mahaalak-54	vīrādhīpataye ydkṣmlvryī& śrījalapātrabhaṭṭārikāya pādukāṃ || ṣaḍaṃga || mā&	vīra adhīpataye śrī jalapātra bhaṭṭārikāya pādukām 
SA_MB_mahaalak-55	hṛdayāya namaḥ || mā& śirase svāhā || mu& śikhāya vauṣaṭ || mai& kavacāya hū& || mau&	hṛdayāya namaḥ mā śirase svāhā mu śikhāya vauṣaṭ mai kavacāya hū mau 
SA_MB_mahaalak-56	netratrayāyavaṣaṭ || ma& || astrāya phaṭ || āvāhanādi || dhenumudrāṃ darśayet || yrtrī|| ai&	netratrayāya vaṣaṭ ma astrāya phaṭ āvāhana ādi dhenumudrām darśayet 
SA_MB_mahaalak-57	5 mahālakṣmī vidmahesiṃhāsanāya dhīmahetannolakṣmī pracodayāt ||	mahā lakṣmī vidmahe siṃhāsanāya dhīmahe tat naḥ lakṣmī pracodayāt 
SA_MB_mahaalak-58	p. 4a) arghapātrapūjā || ai& 5 arghapātrāsanāya pādukau || ai& 5 hrā& hrī& hrū& hraḥ	a arghapātra pūjā ai arghapātra āsanāya pādukau ai hrā hrī hrū hraḥ 
SA_MB_mahaalak-59	prasphura 2 ghora 2 taratanu 2 rūpavaṭ 2 pracaṭa 2 kaha 2 vama 2 dama 2 ghāṭaya 2	prasphura ghora taratanu rūpavaṭ pracaṭa kaha vama dama ghāṭaya 
SA_MB_mahaalak-60	vighāṭaya 2 vighni 2 hū& 3 phaṭ krau& śrīmahākaumārivicce pādukāṃ || ai& 5	vighāṭaya vighni   phaṭ   śrī mahākaumāri vicce pādukām 
SA_MB_mahaalak-61	śkṣmlvryī& ānandaśaktibhairavānanda śrīmahāvidyārājeśvarī hskṣmlvryū&	ānanda śakti bhairava ānanda śrī mahāvidyā rāja īśvarā 
SA_MB_mahaalak-62	śrīarghapātrabhaṭṭārikāya pādukāṃ || ṣaḍaṃga || mā& hṛdayāya namaḥ || mī& śirase	śrī arghapātra bhaṭṭārikāya pādukām ṣaṣ aṃga mā hṛdayāya namaḥ mī śirase 
SA_MB_mahaalak-63	svāhā || mu& śikhāya vauṣaṭ | mai& kavacāya hū& || mau& netratrayāya vaṣaṭ ||	svāhā mu śikhāya vauṣaṭ mai kavacāya hū mau netratrayāya vaṣaṭ 
SA_MB_mahaalak-64	p. 4b) maḥ astrāya phaṭ || āvāhanādi || yonimudrāṃ darśayet || bhūtaśuddhi || ai& hrī&	p b maḥ astrāya phaṭ āvāhana ādi yonimudrām darśayet bhūtaśuddhi ai hrī 
SA_MB_mahaalak-65	śrī& hsphre& hskau& hskauḥ hskauḥ hsphre& śrī& hrī& ai& || ātmapūjā || ai& caṇḍanaṃ	śrī hsphre hskau hskauḥ hskauḥ hsphre śrī hrī ai ātma pūjā ai caṇḍanaṃ 
SA_MB_mahaalak-66	pādukāṃ || hrī& akṣataṃ pādukāṃ || śrī& vīrabhasmaṃ pādukāṃ || hsphre& sarva	pādukām hrī akṣatam pādukām śrī vīra bhasmam pādukām 
SA_MB_mahaalak-67	janamohanī pādukāṃ || hskau& nānācchatrālaṃkālapuṣpaṃ pādukāṃ || ai& kuśau	janamohanī pādukām nānā chatra alaṃkāla puṣpam pādukām kuśau 
SA_MB_mahaalak-68	pādukāṃ || 3 || tāhāraṣo pūjā || oṃ gaṃgāyai namaḥ || oṃ yamuyai namaḥ || oṃ	pādukām pūjā om gaṃgāyai namaḥ om yamuyai namaḥ om 
SA_MB_mahaalak-69	narmadāyai namaḥ || oṃ kauśakti namaḥ || oṃ gaṇḍakī namaḥ || oṃ sarayu namaḥ ||	narmadāyai namaḥ om kauśakti namaḥ om gaṇḍakī namaḥ om sarayu namaḥ 
SA_MB_mahaalak-70	p. 5a) oṃ saptasamudrebhyo namaḥ || oṃ saṃpūrṇakaraṇāyai namaḥ || ai& 5 hskṣmlvryū&	a om sapta samudrebhyaḥ namaḥ om saṃpūrṇa karaṇāyai namaḥ ai 
SA_MB_mahaalak-71	kulavṛkṣamahāsena saṃmohanasakalatīrthamantradevatā kalā tatvādhipataye	                                                                          
SA_MB_mahaalak-72	vrahmaviṣṇurudrātmane ātmavidyā śivatatvāyai hskṣmlvryū& saṃpūrṇakalasa murtaye	vrahma viṣṇu rudra ātmane ātma vidyā śiva tatvāyai hskṣmlvryū saṃpūrṇa kalasa murtaye 
SA_MB_mahaalak-73	pādukāṃ || āvāhanādi || dhenumudrāṃ darśayet || devasnāna || adyādi || vākya ||	pādukām āvāhana ādi dhenumudrām darśayet 
SA_MB_mahaalak-74	ūkāraṃ vāyuvījaṃ taduparivaruṇaṃ vajrapāṇintadūrddhaṃ kālaṃ varṇāntayuktaṃ	ūkāram vāyuvījam tad upari varuṇam vajrapāṇin tad ūrddham kālam varṇa anta yuktam 
SA_MB_mahaalak-75	tadupariparamaṃ vahnivījaṃ sahaṃsaṃ |	tad upari paramam vahnivījam sa haṃsam 
SA_MB_mahaalak-76	p. 5b) induṃ vinduṃ layāntaṃ śitakamalavaraṃ kṣīradhārāśravantaṃ dṛṣṭvā	indum vindum laya antam śita kamala varam kṣīra dhārā śravantam dṛṣṭvā 
SA_MB_mahaalak-77	kuṭantunityaṃ dahatikulamalaṃ merutulyaṃ hi pāpaṃ || vudu ||	dahati kula malam meru tulyam hi pāpam 
SA_MB_mahaalak-78	payasāmṛtapuna na pṛthivyāṃ paripūritaṃ |	na pṛthivyām paripūritam 
SA_MB_mahaalak-79	kāmadhyenu śravannityaṃ snāpayāmi śivājñayā || dhari || dadhiḍamāpatiṃ devaṃ	kāma dhyenu śravat nityam snāpayāmi śiva ājñayā dadhiḍamā patim devam 
SA_MB_mahaalak-80	devānāmati vallabhaṃ ||	devānām ati vallabham 
SA_MB_mahaalak-81	vāṃccharkapaṭala sthānaṃ yena snānena labhyate || ghera ||	sthānam yena snānena labhyate 
SA_MB_mahaalak-82	ghṛtaputaṃ vinākena liṅgapūtaṃ pinākiṇi |	ghṛta putam vinākena liṅga pūtam pinākiṇi 
SA_MB_mahaalak-83	agniśakti svarūpeṇa tārtilokācanaṃ śivaṃ || kasti ||	agni śakti svarūpeṇa śivam 
SA_MB_mahaalak-84	gomukhī vipinobhūtaṃ devānāṃ priyamurtamaṃ |	devānām 
SA_MB_mahaalak-85	p. 6a) vāṃcchākalpataru snānaṃ yena snānena labhyate || śākhaḍga ||	snānam yena snānena labhyate śākhaḍga 
SA_MB_mahaalak-86	khaṇḍametan mahāsvādumanasāḥ śītalaṃ sadā |	khaṇḍam etat mahā svādu manasāḥ śītalam sadā 
SA_MB_mahaalak-87	khaṇḍandu snāpitaṃ devaṃ akhaṇḍitavala pradā || paṃcāmṛta ||	snāpitam 
SA_MB_mahaalak-88	tathā paṃcādi payasaṃ paṃcavrahmā nivāsinaṃ |	tathā paṃca ādi paṃca vrahmā nivāsinam 
SA_MB_mahaalak-89	paṃcadravya samāyuktaṃ paṃcāṅgaiḥ snāpayāmyahaṃ |	paṃca dravya samāyuktam paṃcāṅgaiḥ snāpayāmi aham 
SA_MB_mahaalak-90	alisnāna śkṣmlvryū& pādukaṃ || ceta ||	ali snāna pādukam ceta 
SA_MB_mahaalak-91	śrīkhaṇḍacandanaṃ divyaṃ gaṃdhādya svamanoharaṃ |	śrīkhaṇḍa candanam divyam gaṃdha adya sva manoharam 
SA_MB_mahaalak-92	ābhūṣitaṃ lalātaṅge candanaṃ prati gṛhyatāṃ ||	ābhūṣitam lalātaṅge candanam prati gṛhyatām 
SA_MB_mahaalak-93	candanaṃ llepitaṃ puṇyaṃ pavitraṃ pāpanāśanaṃ āpadāharate nityaṃ lakṣmīrājya	candanam llepitam puṇyam pavitram pāpa nāśanam āpadā āharate nityam lakṣmī rājya 
SA_MB_mahaalak-94	sukhapradāṃ ||	sukha pradām 
SA_MB_mahaalak-95	p. 6b) siṃdhara || vīreśvarī mahāvīra vīrabhasma vibhūṣitaṃ |	vīreśvarī mahāvīra vīra bhasma vibhūṣitam 
SA_MB_mahaalak-96	trailokyā karṣaṇī devī siṃdulāruṇa murtamaṃ || akṣata ||	trailokyā karṣaṇī devī siṃdula aruṇa 
SA_MB_mahaalak-97	akṣataṃ akṣayokāmaṃ dharmakāmārtha siddhidaṃ |	akṣatam akṣayokāmam dharma kāma artha siddhi dam 
SA_MB_mahaalak-98	ispitemevaraṃ devī paratre ca parāṅgatiṃ || dṛṣṭi ||	devī paratre ca parāṅgatim 
SA_MB_mahaalak-99	dhyānadṛṣṭiviśāleṣu lalitaṃ vīra cakṣuṣu |	dhyāna dṛṣṭi viśāleṣu lalitam vīra cakṣuṣu 
SA_MB_mahaalak-100	somasūryāgnibhuvanṃ vai samaṃ netranirmalaṃ || jajamekā ||	vai samam netra nirmalam 
SA_MB_mahaalak-101	jajñopavītaṃ paramaṃ pavitraṃ pajāpra tejasahaja purastāt āyuṣmagaṅdhaṃ	jajñopavītam paramam pavitram purastāt āyuṣmagaṅdham 
SA_MB_mahaalak-102	pratimacaṇḍatraṃ yajñopavitaṃ paramamtu teja || aduvāra ||	pratima caṇḍatram yajña upavitam paramam tu tejaḥ 
SA_MB_mahaalak-103	nānāvastravicitrārgaṃ kṣaumakāryāsa nirmitaṃ |	nānā vastra vicitra argam nirmitam 
SA_MB_mahaalak-104	p. 7a) devāṅgaṃ bhūṣaṇaśreṣṭhaṃ gṛhāṇa parameśvaraṃ || cacchumāḍhe ||	deva aṅgam bhūṣaṇa śreṣṭham gṛhāṇa parameśvaram 
SA_MB_mahaalak-105	cchatraṃcintāmaṇiṃ divyaṃ pūrṇacandranibhaṃsitaṃ |	chatram cintāmaṇim divyam 
SA_MB_mahaalak-106	tena dartenadeveśadehimecintitaṃ phalaṃ || svāna||	phalam 
SA_MB_mahaalak-107	nānāpuṣpa sugandhādimāratī kusumodayaṃ saubhāgyasiddhidaṃ bhadrapuṣvārohana	kusuma udayam saubhāgya siddhi dam 
SA_MB_mahaalak-108	muttamaṃ || pañcapatākā ||	pañca patākā 
SA_MB_mahaalak-109	patākāpaṃcavarṇābhā karṇayoḥ parilamvinī |	patākā paṃca varṇa ābhā karṇayoḥ parilamvinī 
SA_MB_mahaalak-110	paṃcabhūtātmikā paṃcadartayaṃ kṣaumanirmitā || karṇapatākā ||	          
SA_MB_mahaalak-111	śurddhasiṃdulavarṇābhāṃ patākāṃ karṇasaṃjñakāṃ ||	śurddha siṃdula varṇa ābhām patākām karṇa saṃjñakām 
SA_MB_mahaalak-112	gṛhāṇaparameśānacatuḥkoṇā suśobhanā |	gṛhāṇa parameśāna catur koṇā su śobhanā 
SA_MB_mahaalak-113	p. 7b) śvatecchāyalaye pitacūrnanajā pūjā voyamālakvacoya || tritatvenācanaṃ ||	pūjā 
SA_MB_mahaalak-114	oṃ hrā& ātmatatvāya svāhā || oṃ hrā& vidyātatvāya svāhā || oṃ hrū& śivatatvāya svāhā	om hrāḥ ātma tatvāya svāhā  om hrāḥ vidyā tatvāya svāhā  om hrū śiva tatvāya svāhā 
SA_MB_mahaalak-115	|| sūryārgha || adyādi || vākya ||	sūrya argha adya ādi vākya 
SA_MB_mahaalak-116	varṇāntaṃ vijamuddhṛtya tasyopariśivaṃ nyaset ||	varṇa antam vijam uddhṛtya tasya upari śivam nyaset 
SA_MB_mahaalak-117	ādimadhyā vaśāne tu magnitraya vibhūṣitaṃ ||	tu 
SA_MB_mahaalak-118	varmaṇādipitaṃ kṛtvā sāvityā caiva mūrddharet |	kṛtvā sāvityā ca eva mūrddharet 
SA_MB_mahaalak-119	eṣakūtavaraḥ śreṣṭo mahāmārtaṇḍa bhairava || arghannamaḥ puṣpaṃ namaḥ ||	eṣakūta varaḥ śreṣṭaḥ mahā mārtaṇḍa bhairava puṣpam namaḥ 
SA_MB_mahaalak-120	hrī& śrīmahāmārtaṇḍa bhairavāya namaḥ || gurunamaskāra ||	hrī śrī mahā mārtaṇḍa bhairavāya namaḥ guru namaskāra 
SA_MB_mahaalak-121	ai& 5 akhaṇḍakṣu maṇḍalākāraṃ vyāptaṃ yena carācaraṃ ||	ai maṇḍala ākāram vyāptam yena carācaram 
SA_MB_mahaalak-122	p. 8a) tat padaṃ darśitaṃ yena tasmai śrīguruve namaḥ ||	a tat padam darśitam yena tasmai śrī guruve namaḥ 
SA_MB_mahaalak-123	guruvrahmāguruviṣṇugurudeva maheśvara ||	guru vrahma a guru viṣṇu guru deva maheśvara 
SA_MB_mahaalak-124	gurudevajagat sarvaṃ tasmai śrīguruve namaḥ || paramagurubhyo namaḥ || parameṣṭhī	guru deva jagat sarvam tasmai śrī guruve namaḥ parama gurubhyaḥ namaḥ parameṣṭhī 
SA_MB_mahaalak-125	gurubhyo namaḥ || paramācāryagurubhyo namaḥ || valisaḥ || padmāsanāya namaḥ ||	gurubhyaḥ namaḥ parama ācārya gurubhyaḥ namaḥ valisaḥ padmāsanāya namaḥ 
SA_MB_mahaalak-126	thavakaṃ kurmāsanāya namaḥ ||	thavakam kurma āsanāya namaḥ 
SA_MB_mahaalak-127	hu& phaṭ vajrapañjare svāhā || darśadvāraparśanaṃ || ai& 5 calamakulekulamacale hrā&	hu phaṭ vajrapañjare svāhā darśa dvāra parśanam ai calam akulekulam acale hrā 
SA_MB_mahaalak-128	hū& phaṭ svāhā ||	hū phaṭ svāhā 
SA_MB_mahaalak-129	nyāstabhyamaṃ astrāya phaṭ | karaśodhanaṃ || mā& kaniṣṭobhyāṃ namaḥ || mī&	astrāya phaṭ kara śodhanam mā kaniṣṭobhyām namaḥ 
SA_MB_mahaalak-130	anāmikābhyāṃ svāhā || mū& madhyemāyabhyāṃ nama ||	anāmikābhyām svāhā mu madhye māyabhyām nama 
SA_MB_mahaalak-131	p. 8b) mai& tarjanībhyāṃ hū& | ai& 5 mau& aṃguṣṭhābhyāṃ namaḥ || ma&	tarjanībhyām hū ai mau aṅguṣṭhābhyām namaḥ ma 
SA_MB_mahaalak-132	kalatarapṛṭābhyāṃ namaḥ || ai& 5 mā& hṛdayāya namaḥ || ai& 5 mī& hṛdayāya namaḥ || ai&	namaḥ ai mī hṛdayāya namaḥ ai mī hṛdayāya namaḥ ai 
SA_MB_mahaalak-133	mī& sirase svāhā || ai& 5 mū& śikhāyai vauṣaṭ || ai& 5 mai kavacāya hū& || ai& 5 mau&	mī sirase svāhā ai mū śikhāyai vauṣaṭ ai mai kavacāya hū ai mau 
SA_MB_mahaalak-134	netratrayāya vaṣaṭ || maḥ astrāya phaṭ || jalapātrapūjā || ai& 5 jalapātrāṃsanāya	netratrayāya vaṣaṭ maḥ astrāya phaṭ jala pātra pūjā ai jala pātra aṃsanāya 
SA_MB_mahaalak-135	pādukāṃ || ai& 5 hskṣmlvryū& ānandaśaktibhairavānanda vīrādhipataye yvkṣmlvryī&	pādukām ai ānanda śakti bhairava ānanda vīra adhipataye 
SA_MB_mahaalak-136	śrījalapātrabhaṭṭārikāya pādukāṃ || ṣaḍaṃga || mā& hṛdayāya namaḥ ||	śrī jalapātra bhaṭṭārikāya pādukām ṣaṣ aṃga mā hṛdayāya namaḥ 
SA_MB_mahaalak-137	p. 9a) mī śirase svāhā || mū& śikhāya vauṣaṭ || mai& kavacāya hū& || mau& netratrayāya	a mī śirase svāhā mū śikhāya vauṣaṭ mai kavacāya hū mau netratrayāya 
SA_MB_mahaalak-138	vaṣaṭ || ma& astrāya phaṭ || āvāhanādi || dhenumudrāṃ darśayet || gāyatrī || ai& 5	vaṣaṭ ma astrāya phaṭ āvāhana ādi dhenumudrām darśayet gāyatrī 
SA_MB_mahaalak-139	mahālakṣmīrvidmahe siṃhāsanāya dhīmahetannolakṣmī pracodayāt || arghapātrapūjā	mahā lakṣmīḥ vidmahe siṃhāsanāya dhīmahe itat naḥ lakṣmī pracodayāt arghapātra pūjā 
SA_MB_mahaalak-140	|| arghapātrāsanāya pādukāṃ || ai& 5 hrā& hrī& hrū& hraḥ prasphura 2 ghora 2 taratanu 2	arghapātra āsanāya pādukām ai hrā hrī hrū hraḥ prasphura ghora taratanu 
SA_MB_mahaalak-141	rūpacaṭa 2 pracaṭa 2 kaha 2 vama 2 dama 2 ghātaya 2 vighātaya 2 vighni 2 hū& 3 phaṭ krau&	rūpacaṭaiḥ pracaṭaiḥ kaha vama dama ghātaya vighātaya vighni hū phaṭ krau 
SA_MB_mahaalak-142	śrīmahākaumārikā vicce pādukāṃ || ydkṣmlvryī& ānandaśaktibhairavānanda	śrī mahākaumārikāḥ vicce pādukām ānanda śakti bhairava ānanda 
SA_MB_mahaalak-143	śrīmahāvidyārājeśvarī hskṣmlvryū& śrīarghapātra bhaṭṭārikāyai pādukāṃ ||	śrī mahāvidyā rāja īśvarī śrī arghapātra bhaṭṭārikāyai pādukām 
SA_MB_mahaalak-144	p. 9b) ṣaḍaṃga || mā& hṛdayāya namaḥ || ai& 5 mī& śirase svāhā || ai& 5 mū& śikhāya	ṣaṣ aṅga mā hṛdayāya namaḥ ai mī śirase svāhā ai mū śikhāya 
SA_MB_mahaalak-145	vauṣaṭ || ai& 5 mai& kavacāya hūṃ || ai& 5 mau& netratrayāya vaṣaṭ || ai& 5 ma& astrāya phaṭ ||	vauṣaṭ ai mai kavacāya   ai   netratrayāya vaṣaṭ ai ma astrāya phaṭ 
SA_MB_mahaalak-146	āvāhanādi || yonimudrāṃ darśayet || bhūtaśuddhi || ai& hrī& śrī& hsphre& hskau& hskau&	āvāhana ādi yonimudrām darśayet bhūtaśuddhi ai hrī śrī hsphre hskau hskau 
SA_MB_mahaalak-147	hsphre& śrī& hrī& ai& || ātmapūjā || ai& candanaṃ pādukāṃ || hrī& akṣataṃ pādukāṃ ||	śrī hrī ai ātma pūjā ai candanam pādukām hrī akṣatam pādukām 
SA_MB_mahaalak-148	śrī& vīrabhasmaṃ pādukāṃ || hsphre& sarvajanamohanī pādukāṃ || hskau& nānācchatrā	śrī vīra bhasmam pādukām sarva jana mohanī pādukām 
SA_MB_mahaalak-149	laṃkālapuṣpaṃ pādukāṃ || ai 5 hskṣmlvryū& ānandaśakti bhairavānanda	pādukām ai ānanda śakti bhairava ānanda 
SA_MB_mahaalak-150	vīrādhipataye śkṣmlvryī& ātmanepuṣpaṃ pādukāṃ ||	vīra adhipataye ātmanepuṣpam pādukām 
SA_MB_mahaalak-151	p. 10) ai& 5 kusau& pādukāṃ 3 || mālatidaṇḍakaṃ paṭhet || oṃ namaścaṇḍikāyai || śrī	pādukām mālati daṇḍakam paṭhet om namaḥ caṇḍikāyai śrī 
SA_MB_mahaalak-152	bhairava uvāca ||	bhairavaḥ uvāca 
SA_MB_mahaalak-153	ai& 5 yatvaṃ mālinī devī nirmalemala nāśinī ||	mālinī devī nirmala imala nāśinī 
SA_MB_mahaalak-154	jñānaśaktiprabhūddevī vuddhistvaṃteja varddhanī ||	vuddhiḥ tvam teja varddhanī 
SA_MB_mahaalak-155	janani sarva bhūtānāṃ saṃsāre'smin vyavasthitā ||	janani sarva bhūtānām saṃsāresmin vyavasthitā 
SA_MB_mahaalak-156	mātāvīrāvalidevī kāruṇyaṃ kulavatsale ||	             
SA_MB_mahaalak-157	jayatiparama tatvanirvāṇa saṃbhūtitejomayīḥ nisṛtāvyaktarūpā	jayati parama tatva nirvāṇa saṃbhūti tejaḥ mayīḥ nisṛta avyakta rūpā 
SA_MB_mahaalak-158	parājñānaśaktistvaṃ micchākriyāmaṅgalā ṛjvirekhāpunaḥ suptanāgendra	parā ajñānaśaktiḥ tvam micchā kriyā maṅgalā supta nāga indra 
SA_MB_mahaalak-159	vatkuṇḍalākārarūpā prabhūrnādaśaktistusaṃgīyase bhāsurājyotirūpāsvarūpā	prabhūḥ nāda śaktiḥ tu saṃgīyase bhāsura a jyotiḥ rūpā a svarūpā 
SA_MB_mahaalak-160	prabhurnādaśaktistu saṃgīyase bhāsurajyotirūpāsvarūpāṇi vājyeṣṭhaṃ nāmā ca	prabhuḥ nāda śaktiḥ tu saṃgīyase ca 
SA_MB_mahaalak-161	vāmā ca raudrīmanākhyāvikā vindurūpā vadhutārddhacandrākṛtatvaṃ tikoṇā	vāmā ca vindu rūpā ti koṇā 
SA_MB_mahaalak-162	aḍamakāra īkara saṃjyonaikatva māpadyasenastvaṃ rūpābhagākāra vasthāyinī	aḍamakāraḥ īkara māpadyase inaḥ tvam 
SA_MB_mahaalak-163	āditaḥ kṣāntatva bhavāyonisvarūpā śrīkaṇṭhasaṃvodhanī rudramātā tathā	āditas śrīkaṇṭha saṃvodhanī rudra mātā 
SA_MB_mahaalak-164	nantaśaktiḥ suśukṣmātrimurtya marīśārghinī bhārabhūtistithi śātmikā	marīśa arghinī bhārabhūtiḥ tithi 
SA_MB_mahaalak-165	sthāṇubhūtāharākṣā ca ṛṃthiśabhautīśa sa śadyātmikā	ca 
SA_MB_mahaalak-166	p. 11) nugrahaśārcitātvaṃ krālaśārgaṃ mahāsena saṃbhoginī ṣoḍaśāntā	mahāsena saṃbhoginī ṣoḍaśāntā 
SA_MB_mahaalak-167	mṛtāvindusaṃdohaniḥ syaṃ dehaplutā śeṣaśamyaka parānirvāṇa saukhyaprade	syam deha plutā 
SA_MB_mahaalak-168	bhairavībhairavodyāna krīḍānu śaktiḥ parāmālinī rudramātācitaṃ rudraśaktiḥ khagī	śaktiḥ parā mālinī rudramātrī ācitam rudra śaktiḥ khagī 
SA_MB_mahaalak-169	siddhiyogeśvarī siddhimātāṃ vibhuḥ tiśavdarāśīti yoginyārṇavī vāgviśuddhā	siddhiyogeśvarī vibhuḥ yoginī ārṇavī vāc viśuddhā 
SA_MB_mahaalak-170	śivāsiddhivāgeśvarī mātṛkāsiddhimicchā kriyā maṅgalāsiddhi lakṣmīrvibhūtiḥ	śivā a siddhi vāgeśvarī mātṛkā a siddhim icchā kriyā maṅgalā a siddhi lakṣmīḥ vibhūtiḥ 
SA_MB_mahaalak-171	saṃbhūtirgatiḥ śāśvatākhyānti nārāyaṇīraktacaṇḍākalālekṣaṇābhīmarūpā	saṃbhūtiḥ gatiḥ śāśvatā ākhyānti nārāyaṇī rakta caṇḍā kalāla īkṣaṇā abhīma rūpā 
SA_MB_mahaalak-172	mahocchuṣmayoge priyātvaṃ jayatsyājitā rudra saṃmohinītvaṃ navātmākhya devasya	mahā ucchuṣma yoge priyā tvam rudra saṃmohinī tvam devasya 
SA_MB_mahaalak-173	cotsaṃgayā nāśritāmantramārgānugairmantribhirvīrapānānu raktaiḥ subhaktauśca	ca utsaṃgayā na āśritā a mantra mārga anugaiḥ mantribhiḥ vīra pāna anu raktaiḥ su bhaktauḥ ca 
SA_MB_mahaalak-174	saṃpūjyase devī pañcāmṛtaiddivyapānotsavai muṇḍakaṃ kārakāpālinī ekajanma	saṃpūjyase devī muṇḍakam kāra kāpālinī eka janma 
SA_MB_mahaalak-175	dvijanmatrijanmacatuḥ pañca ṣaḍsaptajanmobhaivaistaiśca nānaiḥ śubhaiḥ	dvijanma tri janma catuḥ pañca ṣaṣ sapta janma ubha evaiḥ taiḥ ca nānaiḥ śubhaiḥ 
SA_MB_mahaalak-176	phalguṣaistarghasemadyamāṃsa priyemantra vidyāvratī bhāśibhirmuṇḍakakāla	vidyāvratī 
SA_MB_mahaalak-177	kāpālibhirdirvyacaryā nuruḍhai namaskāra oṃkāra svāhā svadhākāra vauṣaṭ vaṣakāra	namaskāra oṃkāra svāhā svadhākāra vauṣaṭ vaṣakāra 
SA_MB_mahaalak-178	hūṃkāra phaṭkārajātibhiretaiśca	hūṃkāra phaṭkāra jātibhiḥ etaiḥ ca 
SA_MB_mahaalak-179	p. 12) mantrākṣarocāribhirvā mahastasthitai rakṣasūtrāvali jāpibhiḥ sādhakaiḥ	mantra akṣara ucāribhiḥ vā jāpibhiḥ sādhakaiḥ 
SA_MB_mahaalak-180	putrakaiḥ rmātṛbhirmaṇḍalaiddīkṣitai yogibhiryoginīvṛndamelāpakai rudrakrīḍārasaiḥ	putrakaiḥ r mātṛbhiḥ maṇḍalaiḥ dīkṣitaiḥ yogibhiḥ yoginī vṛnda melāpakaiḥ rudra krīḍā rasaiḥ 
SA_MB_mahaalak-181	pūjyasayoginīyogasiddhipradedevītvaṃ padmapatropamaillocanaiḥ snehapūrṇestu	pūjya sa yoginī yoga siddhi prade devī tvam padma patra upamaiḥ locanaiḥ 
SA_MB_mahaalak-182	saṃpaśyase tasyadivyāntarikṣasthitā saptapātālasaṃkhecarī siddhidevyā hatāvartane	saṃpaśyase tasya divya antarikṣa sthitā sapta pātāla saṃkhecarī siddhidevyāḥ hata āvartane 
SA_MB_mahaalak-183	bhaktitoyaḥ paṭheddaṇḍakaṃme ekakālaṃdvikālaṃ catuḥpaṃca ṣaḍsaptacāṣṭau	bhakti toyaḥ paṭhet daṇḍakam me eka kālam dvi kālam catur paṃca ṣaṣ sapta ca aṣṭau 
SA_MB_mahaalak-184	śuciḥ sasmaredyaḥ sadāmānavaḥ sopicaurāgniśastrārṇave parvatāgrepi saṃrajyasedevī	śuciḥ sasmaret yaḥ sadā mānavaḥ saḥ api caura agni śastra arṇave parvata agre api saṃrajyase devī 
SA_MB_mahaalak-185	putrānurāgān mahālakṣmīpriye hemacaurānyadārānu śaktaśca vrahmaghna	putra anurāgāt mahā lakṣmī priye hema caura anya dāra anu śaktaḥ ca vrahma ghna 
SA_MB_mahaalak-186	mahādoṣaduṣṭāvimuñcanti saṃsmṛtya devī tvaṃdīyaṃ mukhaṃ pūrṇa	mahā doṣa duṣṭau vimuñcanti saṃsmṛtya devī tvaṃdīyam mukham pūrṇa 
SA_MB_mahaalak-187	candrānukāre sphuraddivyamāṇikya satkuloghṛṣṭha gaṇḍasthalaṃ ye'pivadvādṛḍhai	candra anukāre sphurat divya māṇikya gaṇḍa sthalam 
SA_MB_mahaalak-188	vandhanainnāgapāśai bhujāvarddhapādāṃgulaistepitvaṃ nnāma saṃkīttanārdevi	vandhanaiḥ nāgapāśaiḥ 
SA_MB_mahaalak-189	muñcantighoraimmahāvyādhibhiḥ saṃsmṛtya pādāravinda dvayante	saṃsmṛtya pāda aravinda 
SA_MB_mahaalak-190	mahākālikālāgnitejaḥ prabheskanda vrahmendracandrārka puṣvāyudhai molimālāli	                     
SA_MB_mahaalak-191	satpadmakiñjalkasatpiñjare sarvavīrāmvike bhairavibhairasteśara nāgatohaṃ	sat padma kiñjalka sat piñjare sarva vīra amvike 
SA_MB_mahaalak-192	kṣamasvāparādhaṃ 2 śive ||	kṣamasva aparādham śive 
SA_MB_mahaalak-193	p. 13) evaṃ stutvā mahādevi bhairavena mahātmanā |	evam stutvā mahādevi bhairaveṇa mahātmanā 
SA_MB_mahaalak-194	tato liṅgaṃ vinibhadre nirgatāṃ parameśvarī || pañcavaliḥ ||	tatas liṅgam vinibhadre nirgatām parameśvarī pañca valiḥ 
SA_MB_mahaalak-195	ai& 5 mayūrāsanāya pādukāṃ ||	ai mayūrāsanāya pādukām 
SA_MB_mahaalak-196	ai& 5 śrī& hrī& kulaputravaṭukanāthāya pādukāṃ || valiḥ ||	ai śrī hrī kula putra vaṭuka nāthāya pādukām valiḥ 
SA_MB_mahaalak-197	ai& 5 narāsanāya pādukāṃ ||	ai narāsanāya pādukām 
SA_MB_mahaalak-198	ai& 5 thrau& prastaradvīpa dambhakīdevī mahādhvāṃkṣa kṣetrapālāya pādukāṃ ||	ai thrau prastaradvīpa dambhakīdevī mahādhvāṃkṣa kṣetrapālāya pādukām 
SA_MB_mahaalak-199	ai& 5 śavāsanāya pādukāṃ ||	ai śavāsanāya pādukām 
SA_MB_mahaalak-200	p. 13b) ai& 5 yā& yoginībhyo pādukāṃ ||	p yā yoginībhyaḥ pādukām 
SA_MB_mahaalak-201	ai& 5 yekecita yoginīnāṃ pīṭhajākṣetrajāsahajā jogajāgarbhajā kulajā sandoha	ai ye kecid yoginīnām pīṭha jā kṣetra jā sahajā joga jā garbha jā kula jā sandoha 
SA_MB_mahaalak-202	jāyekevidyoginīnāṃ khecarī bhūcarī gocarī ekākṣarī dvyakṣarī tryakṣarī catuḥ	khecarī bhūcarī gocarī eka akṣarī dvi akṣarī tri akṣarī catuḥ 
SA_MB_mahaalak-203	pañca ṣaṭ saptāṣṭakanavākṣarīṇāṃ bhṛjagāminīnāṃ yathopapannānāṃ valiṃ	pañca ṣaṭ sapta aṣṭaka nava akṣarīṇām bhṛja gāminīnām yathā upapannānām valim 
SA_MB_mahaalak-204	gṛhna 2 svāhā ||	gṛhna svāhā 
SA_MB_mahaalak-205	ai& 5 pretāsanāya pādukāṃ ||	ai preta āsanāya pādukām 
SA_MB_mahaalak-206	ai& 5 hskhphre& śrīsiddhi cāmuṇḍeśvarī pādukāṃ || valiḥ ||	ai hskhphre śrī siddhi cāmuṇḍeśvarī pādukām valiḥ 
SA_MB_mahaalak-207	ai& 5 mūṣāsanāya pādukāṃ ||	ai mūṣā āsanāya pādukām 
SA_MB_mahaalak-208	ai& 5 gā& gī& gū& gaḥ glau& śrīkulagaṇeśvarāya pādukāṃ || dhananaṃ valiḥ ||	ai gā gī gū gaḥ glau śrī kula gaṇa īśvarāya pādukām valiḥ 
SA_MB_mahaalak-209	āvāhanādi ||	āvāhana ādi 
SA_MB_mahaalak-210	p. 14a) caṇḍatarjanīyonivindu gajamudrāṃ || japa || śrī& hrī& svāhā 10 || thrau& svāhā 10 ||	caṇḍa tarjanī yoni vindu gajamudrām japa śrī hrī svāhā   thrau svāhā 
SA_MB_mahaalak-211	yā& svāhā 10 || hskhphre& svāhā 10 || glau& svāhā 10 || stotra ||	svāhā   svāhā   svāhā 
SA_MB_mahaalak-212	gauryā putraputraṃ kumālaṃ gagaṇata nadhṛtaṃ kṣetrakaṃ yoginīñcacāmuṇḍacaṇḍa	gauryā putra putram kumālam kṣetrakam 
SA_MB_mahaalak-213	rūpā duritabhayaharaṃ vighnihāraṃ gaṇesaṃ |	durita bhaya haram vighni hāram 
SA_MB_mahaalak-214	puṣpādyā dhūpadīpāmiṣamadhuvalibhircarcitā bhūṣitāṅgā cakre	puṣpa ādyā dhūpa dīpa āmiṣa madhu valibhiḥ carcitā bhūṣita aṅgā cakre 
SA_MB_mahaalak-215	saṃpūjyekānāṃ vividhanahitābhuktimukti pradānā ||	saṃpūjya ikānām 
SA_MB_mahaalak-216	pañcavalyārcanavidhe tatsarvaṃ paripūrṇamamtu || vindutraya 3 || āvāhana ||	pañcavalyā arcana vidhe tat sarvam paripūrṇam amtu vindu traya 
SA_MB_mahaalak-217	śrīsaṃvartāmaṇḍalānte kṛṣṇavī 2 ||	         
SA_MB_mahaalak-218	p. 14b) ai& 5 raudrī 2 || ai& 5 carcikāyai 2 || ai& 5 īśvarīye 2 || ai& 5 vārāhi 2 || ai& 5	p ai raudrī carcikāyai ai īśvarīye ai vārāhi 
SA_MB_mahaalak-219	nārasiṃhī 2 || ai& 5 śivāduti namaḥ || svatenaṃvaliḥ ||	nārasiṃhī  ai namaḥ 
SA_MB_mahaalak-220	ai& 5 śaṃśrītīśra pīṭheya 2 || ai& 5 devīkoṭa kṣetrāya 2 || ai& 5 kauṣaṭigṛhe 2 || ai& 5	ai   ai   / ai   / ai   /
SA_MB_mahaalak-221	śivadūtī 2 || ai& 5 cittedevī 2 || ai& 5 kaṃketu bhairavāya 2 || ai& 5 mahātrama bhūtāya 2 ||	              
SA_MB_mahaalak-222	śvatesaṃ valiḥ || ai& 5 śrī& hkṣmlvryū& jayā devī namaḥ || ai& 5 kṣmlvryū& śrīvijayā	valiḥ ai śrī hkṣmlvryū jayā devī namaḥ ai śrī vijayā 
SA_MB_mahaalak-223	devī 2 || ai& 5 ymlvryū& śrī ajitāya devī 2 || ai& 5 lmlvryū& śrī aparājitā devī 2 ||	devī  ai  śrī ajitāya devī  ai  śrī aparājitā devī 
SA_MB_mahaalak-224	17a?? p. 15a) ai& 5 smlvryū& śrī jaṃbhanī devī 2 || ai& 5 nmlvryū& śrīstambhanī devī 2 ||	p ai śrī jaṃbhanī devī   / ai śrī stambhanī devī 
SA_MB_mahaalak-225	ai& 5 vmlvryū& mohanī devī 2 || ai& 5 ymlvryū& śrī ākarṣanī devī 2 || śvatenaṃ valiḥ || ai&	ai mohanī devī   / ai śrī ākarṣanī devī valiḥ 
SA_MB_mahaalak-226	5 ḍā& ḍākinī 2 || ai& 5 rā& rākinī 2 || ai& 5 lā& lākinī 2 || ai& 5 kā& kākinī 2 || ai& 5 sā&	ḍā ḍākinī  rā rākinī  rā lā lākinī  rā kā kākinī  rā 
SA_MB_mahaalak-227	sākinī 2 || ai& 5 hā& hākinī namaḥ || śvatenaṃ vali || ai& 5 vrahmāyanī devī 2 || ai& 5 kaṃ	sākinī  ai hā hākinī namaḥ ai  vrahmāyanī devī  ai kaṃ 
SA_MB_mahaalak-228	māheśvarī devī 2 || ai& 5 ca& komāri devī 2 || ai& 5 ṭa& vaiṣṇavī devī 2 || ai& 5 vai& vārāhi	māheśvarī devī ca komāri devī   ai vaiṣṇavī devī  vai vārāhi 
SA_MB_mahaalak-229	devī 2 || 5 pa& indrāṇī devī 2 || 5 ya& cāmuṇḍā devī 2 || 5 yā& yognityapā 2 || vali ||	devī indrāṇī devī   cāmuṇḍā devī 
SA_MB_mahaalak-230	triyāñjali || vali || gāyatrī || vali || āvāhanādi || vinduyoni mudrāṃ ||	              
SA_MB_mahaalak-231	17b?? p. 15b) mapadaśahitānanandaśaktisubhī māsṛṣṭaṃ nyāya catuskaṃ	mā sṛṣṭam catuskam 
SA_MB_mahaalak-232	akulakulagataṃ pañcakaṃ cānyaṣaṭkaṃ catvāropañcakonyaṃ punarapicaturaṃ tartato	pañcakam ca anya ṣaṭkam punar api caturam 
SA_MB_mahaalak-233	maṇḍalena saṃsṛṣṭaṃ jena tasmai naman guruvaraṃ bhairavaṃ śrī kujeśa || ?? ai& 5	maṇḍalena saṃsṛṣṭam jena tasmai naman guru varam bhairavam śrī kujeśa 
SA_MB_mahaalak-234	narāsanāya pādukāṃ ||	narāsanāya pādukām 
SA_MB_mahaalak-235	ai& 5 mayūrāsanāya pādukāṃ ||	ai mayūrāsanāya pādukām 
SA_MB_mahaalak-236	ai& 5 mūśāsanāya pādukāṃ || hrā& kṣhsrau& prastaradīpadambhakī devī	ai mūśāsanāya pādukām hrā   prastara dīpa dambhakī devī 
SA_MB_mahaalak-237	mahādhvāṃkṣakṣetrapālāya pādukāṃ || valiṃ || śrī& hrī& kulaputra vaṭukanāthāya	mahādhvāṃkṣa kṣetrapālāya pādukām valim śrī hrī kula putra vaṭuka nāthāya 
SA_MB_mahaalak-238	pādukāṃ || vali || gā& gī& gū& gaḥ glau& śrīkulagaṇeśvarāya pādukāṃ ||	pādukām vali gā gī gū gaḥ glau śrī kula gaṇa īśvarāya pādukām 
SA_MB_mahaalak-239	15a?? p. 16a) vali || āvāhanasthāpanacandanākṣatapuṣpaṃ namaḥ ||	          
SA_MB_mahaalak-240	tarjanīdaṇḍagajamudrāṃ darśayet || yoginī ||	tarjanī daṇḍa gaja mudrām darśayet yoginī 
SA_MB_mahaalak-241	ai& 5 siṃhāsanāya pādukāṃ ||	ai siṃhāsanāya pādukām 
SA_MB_mahaalak-242	ai& 5 yā& yo& ginityopādukāṃ || vali ||	ai 
SA_MB_mahaalak-243	āvāhana sthāpana candanākṣatapuṣpaṃ namaḥ || yonimudrāṃ ||	āvāhana sthāpana candana akṣata puṣpam namaḥ yonimudrām 
SA_MB_mahaalak-244	||3 || āvāhanādi || mudrāṃ || āsanaṃ ||	        
SA_MB_mahaalak-245	ai& 5 ādhāraśakte namaḥ || anantāsanāya namaḥ || kandāsanāya namaḥ || nārāsanāya	ai ādhāra śakte namaḥ ananta āsanāya namaḥ kanda āsanāya namaḥ nārāsanāya 
SA_MB_mahaalak-246	namaḥ || patrāsanāya namaḥ || keśarāsanāya namaḥ ||	namaḥ pattrāsanāya namaḥ keśarāsanāya namaḥ 
SA_MB_mahaalak-247	15b?? p. 16b) karṇikāsanāya namaḥ || padmāsanāya namaḥ || dharmāya namaḥ ||	            
SA_MB_mahaalak-248	jñānāyanamaḥ || vairāgyāye namaḥ || ai& śvaryāya namaḥ || adharmāya namaḥ ||	jñānāya namaḥ vairāgyāya namaḥ ai śvaryāya namaḥ adharmāya namaḥ 
SA_MB_mahaalak-249	ajñānāya namaḥ || avairājñāya namaḥ || anaiśvaryāya namaḥ || siṃhāsanāya namaḥ	ajñānāya namaḥ avairājñāya namaḥ anaiśvaryāya namaḥ siṃhāsanāya namaḥ 
SA_MB_mahaalak-250	|| dhyānaṃ || ai& 5 aprajaṃvījapurañcakapālaṃ paṅkajaṃ karaiḥ vahantī	dhyānam ai paṅkajam karaiḥ vahantī 
SA_MB_mahaalak-251	hemasaṃkāśā mahālakṣmīḥ samīritā || iti dhyānaṃ || trīyāñjali ||	hema saṃkāśā mahā lakṣmīḥ samīritā iti dhyānam 
SA_MB_mahaalak-252	ai& 5 aghore amoghe varadevīmale śrīmahālakṣmī vicce pādukāṃ || 3 || valiḥ || ai& 5 śa&	ai aghore amoghe varadevī male śrī mahālakṣmī vicce pādukām valiḥ 
SA_MB_mahaalak-253	ṣa& sa& ha& mmlvryū& śrīmahālakṣmī vicce pādukāṃ ||	ṣa sa ha śrī mahālakṣmī vicce pādukām 
SA_MB_mahaalak-254	16a?? p. 17a) vali || ṣaḍaṃga || mā& hṛdayāyatyādi || gāyatrī ||	          
SA_MB_mahaalak-255	ai& 5 mahālakṣmī vidmahe siṃhāsanāyadhīmahe tannolakṣmī pracodayāt || vali ||	ai mahālakṣmī vidmahe siṃhāsanāya dhīmahe tat naḥ lakṣmī pracodayāt 
SA_MB_mahaalak-256	pūjanaṃ ||	pūjanam 
SA_MB_mahaalak-257	oṃ hrā& saṃhālabhairavāya 2 ||	om hrā saṃhāla bhairavāya 
SA_MB_mahaalak-258	ai& 5 hā& hī& hū& hmlvryū& hu& īśānāya triśūrahastāya bhūtādhipataye 2 ||	ai hā hī hū hu īśānāya triśūra hastāya bhūta adhipataye 
SA_MB_mahaalak-259	ai& 5 devīkotamahākṣetra pālāya 2 ||	ai devīkota mahā kṣetra pālāya 
SA_MB_mahaalak-260	ai& 5 nmlvryū& bhimarūpakṣetra pālāya 2 ||	ai bhima rūpa kṣetra pālāya 
SA_MB_mahaalak-261	ai& 5 vidyārāja bhairavāya 2 ||	ai vidyārāja bhairavāya 
SA_MB_mahaalak-262	ai& 5 kurikāya 2 || ai& 5 hū& īśāna śmaśānāya 2 || śvnaṃvali || parivālapūjā ||	ai kurikāya ai hū īśāna śmaśānāya  parivāla pūjā 
SA_MB_mahaalak-263	ai& 5 vrahmāṇī 2 || ai& 5 vaiḍhasukatvākāmānavalihāṣake ??||	ai vrahmāṇī 
SA_MB_mahaalak-264	16b p. 17b) ai& 5 īśānavidigvāsitya īśānasaṃhārabhīmarūpake tu mahānmabhūta	īśāna vidiś vāsityaḥ īśāna saṃhāra bhīma rūpake tu 
SA_MB_mahaalak-265	yogniṣṭasahitāya sāṃgāyasagaṇaparivārāya idaṃ puṣpadhūpadīpapūjāṃ	yaḥ ugniṣṭa sahitāya sa āṃgāyasa gaṇa parivārāya idam puṣpa dhūpa dīpa pūjām 
SA_MB_mahaalak-266	mayāyathopanītāṃ alivalipiśitaṃ pūjāṃ valiṃ gṛhna 2 bhuru 2 muru 2 la 2 kha 2 khāhi	mayā ayathā upanītām ali vali piśitam pūjām valim gṛhna bhuru muru la kha khāhi 
SA_MB_mahaalak-267	2 śāntiṃ kuru 2 hū& phaṭ svāhā ||	śāntim kuru hū phaṭ svāhā 
SA_MB_mahaalak-268	ai& 5 sarvapīṭhopapīṭhāni dvāropadvārameva ca kṣetropakṣe saṃdoha sarvadigbhāga	sarva pīṭha upapīṭhāni dvāra upadvāram eva ca kṣetra upakṣe saṃdoha sarva digbhāga 
SA_MB_mahaalak-269	saṃsthitā ||	saṃsthitā 
SA_MB_mahaalak-270	yoginīyogavīrendrāḥ sarva tatra samāgatāḥ ||	yoginī yoga vīra indrāḥ sarve tatra samāgatāḥ 
SA_MB_mahaalak-271	idaṃ parvamahācakraṃ śrīnāthovarado mama ||	idam parva mahācakram śrī nāthaḥ vara daḥ mama 
SA_MB_mahaalak-272	ye bhaktāḥ śāsane devī gurupādārcaneratāḥ ||	ye bhaktāḥ śāsane devī guru pāda arcane ratāḥ 
SA_MB_mahaalak-273	p. 18a) sarvasiddhiprasādomedevi teṣāṃbhave sadā ||	sarva siddhi prasāda ume devi teṣām bhave sadā 
SA_MB_mahaalak-274	vīrāṇāṃ yoginīnā ca yedīkṣintī mahītare |	vīrāṇām yoginīnā ca mahī itare 
SA_MB_mahaalak-275	tadātatra validadyāt samayācāra menake ||	tadā tatra vali dadyāt samayācāra menake 
SA_MB_mahaalak-276	śruti smṛtimanaḥ puṣṭimāṃsamedosthi jīvitaṃ |	śruti smṛti manaḥ puṣṭi māṃsa medaḥ asthi jīvitam 
SA_MB_mahaalak-277	nikṛtayantu duṣṭānāṃ yoginīgaṇa saṃkulāḥ ||	nikṛtayantu duṣṭānām yoginī gaṇa saṃkulāḥ 
SA_MB_mahaalak-278	kuhukādi kusvapnādidurninirtādu bhāṣitā ||	bhāṣitā 
SA_MB_mahaalak-279	oṃ kārādiṣu yebhūtāstrayaḥ sārā prakīrtitāḥ ||	om kārā ādiṣu yebhūtāḥ trayaḥ sārā prakīrtitāḥ 
SA_MB_mahaalak-280	ḍoṣadhī tu sandohādiśāsuvidiśāsu ca |	ḍoṣadhī tu sandoha ādiśā su vidiśāsu ca 
SA_MB_mahaalak-281	mahīpātāla vrahmāṇḍe sarvasthānāntareṣu ca ||	mahī pātāla vrahmāṇḍe sarva sthāna antareṣu ca 
SA_MB_mahaalak-282	yoginīyoga yuktātmā satyaṃ tiṣṭaṃti sādhakā ||	satyam tiṣṭanti 
SA_MB_mahaalak-283	siddhāśca putrakācāryāḥ śādhakāḥ kṣitiśāyinaḥ |	siddhāḥ ca putraka ācāryāḥ śādhakāḥ kṣiti śāyinaḥ 
SA_MB_mahaalak-284	p. 18b) nānārūpadharī devī vaṭajā vividhāni ca ||	nānā rūpa dharī devī vaṭajā vividhāni ca 
SA_MB_mahaalak-285	teca sarvepi santuṣṭā valiṃ gṛhnantu sarvadā ||	te ca sarve api santuṣṭāḥ valim gṛhnantu sarvadā 
SA_MB_mahaalak-286	śaraṇāgatopyaha steṣāṃ sarvametat phalapradaṃ ||	śaraṇa āgataḥ api aham teṣām sarvam etat phala pradam 
SA_MB_mahaalak-287	prālarddhaṃ yanmayākammayet kariṣyāmi yat kṛtaṃ ||	kariṣyāmi yat kṛtam 
SA_MB_mahaalak-288	valipuṣpa pradānena santuṣṭā mama caṇḍikā ||	valipuṣpa pradānena santuṣṭā mama caṇḍikā 
SA_MB_mahaalak-289	sarvakarmāṇi sāddhyantu sarvadoṣaḥ prasāntume |	sarva karmāṇi sāddhyantu sarva doṣaḥ 
SA_MB_mahaalak-290	śivaśakti pradānena śrīkukārāṃ namāmyahaṃ ||	śiva śakti pradānena śrī kukārām namāmi aham 
SA_MB_mahaalak-291	iti samaya valiḥ ||	iti samaya valiḥ 
SA_MB_mahaalak-292	ai& 5 ajaraścāpa kumbhaśca iḍācārastathaiva ca ||	ajaraḥ ca apa kumbhaḥ ca iḍācāraḥ tathā eva ca 
SA_MB_mahaalak-293	indramūrtiśca ulkāsya ūṣmāṇḍoripu sūdanaḥ || ṛ muktaṭaptakāyaśca	indra mūrtiḥ ca ulkā āsya ūṣmāṇḍa uripu sūdanaḥ 
SA_MB_mahaalak-294	phalāpādaika daṣṭakaḥ |	daṣṭakaḥ 
SA_MB_mahaalak-295	p. 19) erāvataścaḍodyāmvā ḍoṣadhīsa tathā paraḥ ||	tathā paraḥ 
SA_MB_mahaalak-296	antako arthavāhuśca kamalaśca kharānanaḥ |	antakaḥ arthavāhuḥ ca kamalaḥ ca kharānanaḥ 
SA_MB_mahaalak-297	gomukhaścaiva ghaṇḍāloḍaṇanaścaṇḍa dhārakaḥ |	gomukhaḥ ca eva ghaṇḍāloḍaṇanaḥ caṇḍa dhārakaḥ 
SA_MB_mahaalak-298	cchaṭāṭopojaṭālākhyo ṛkāroñca bhaṭeśvaraḥ ṭaṃkapāṇistathā	bhaṭeśvaraḥ ṭaṃkapāṇiḥ tathā 
SA_MB_mahaalak-299	cānyaṣṭānuvanvaśca ḍāmaraḥ |	ḍāmaraḥ 
SA_MB_mahaalak-300	ṭarṭṭakarṇṇeṇatīkānte taḍidbhāsthavirastathā |	taḍidbhā sthaviraḥ tathā 
SA_MB_mahaalak-301	dantuḥ rodhanadaścaiva nāgakarṇaḥ pracaṇḍavān ||	dantuḥ rodhanadaḥ ca eva nāgakarṇaḥ pracaṇḍavān 
SA_MB_mahaalak-302	phetkārovīrasiṃhaśca bhṛkuṭīkṣomegha bhāsuraḥ |	          
SA_MB_mahaalak-303	yugānto rauravaścaiva lamvoṣṭovatsalastathā ||	yugāntaḥ rauravaḥ ca eva lamvoṣṭovatsalaḥ tathā 
SA_MB_mahaalak-304	śukatuṇḍaḥ ṣaḍālāsyaḥ sunāsohu hu kastathā |	śukatuṇḍaḥ ṣaṣ ālāsyaḥ kaḥ tathā 
SA_MB_mahaalak-305	kṣayāntakamtu paṃcāśatkṣetrapālaḍa dāhṛtāḥ ||	kṣaya antakam tu 
SA_MB_mahaalak-306	p. 19b) paṃcāśavarṇamudvrāsthānasthāḥ kṣetralakāḥ śeṣāvarṇa vihīnāstu	kṣetralakāḥ 
SA_MB_mahaalak-307	kṣetrapāla caturdaśaḥ ||	kṣetrapāla caturdaśaḥ 
SA_MB_mahaalak-308	ekaliṃge ca huṃkāra śmaśāne ca bhayāvahaṃ |	eka liṃge ca huṃkāra śmaśāne ca bhaya āvaham 
SA_MB_mahaalak-309	mahālakṣmī vaneghore jvālāmukhī vase sadā |	mahā lakṣmī vaneghore jvālāmukhī vase sadā 
SA_MB_mahaalak-310	eka vṛkṣavaṭevātha viḍāla vadano vaset |	eka vṛkṣa vaṭā iva atha viḍāla vadanaḥ vaset 
SA_MB_mahaalak-311	ghaṇṭhārāvo guhāvāse padmakhaṇḍajalāmvaraḥ |	            
SA_MB_mahaalak-312	saṅgamebhūridhāroghaḥ parvate marutastathā |	parvate marutaḥ tathā 
SA_MB_mahaalak-313	nirjhare śravaṇipravahonidhāna maṇibhadrake ||	nirjhare maṇibhadrake 
SA_MB_mahaalak-314	rasakṣetradhanāḍhyakṣo yajñevāṭeṣu kroṣṭakaḥ |	rasa kṣetra dhana āḍhyakṣaḥ yajña vāṭeṣu kroṣṭakaḥ 
SA_MB_mahaalak-315	araṣṭhā śavanaṃ vidyādudyāne madhukaraḥ smṛtā ||	araṣṭhā śavanam vidyāt udyāne madhukaraḥ smṛtā 
SA_MB_mahaalak-316	catuḥ ṣaṣṭī mahāvīryāḥ pālayitvā sthitā jagat |	catuḥ ṣaṣṭī mahā vīryāḥ pālayitvā sthitāḥ jagat 
SA_MB_mahaalak-317	tatra kṣetrasadā kālaṃ valipūjāṃ nivedayet |	tatra kṣetra sadā kālam vali pūjām nivedayet 
SA_MB_mahaalak-318	p. 20) catvārastatra bhūpāladvijādyā gṛhnate valiṃ |	catvāraḥ tatra bhūpāla dvija ādyāḥ gṛhnate valim 
SA_MB_mahaalak-319	bhūkhagatarūpākṣī casvācārīvalikāṃ kṣiṇaḥ |	bhū kha gata rūpa akṣī ca su ācārī valikām kṣiṇaḥ 
SA_MB_mahaalak-320	nityādhikāra catvāraḥ kadyāṃvā itarajanāvarvarāpigakeśāśca piṅgarūpiṅga	catvāraḥ catvāraḥ 
SA_MB_mahaalak-321	locanaḥ |	locanaḥ 
SA_MB_mahaalak-322	daṣṭākarāla abhyugrāḥ kapāla bharaṇojvalāḥ |	daṣṭa akarāla abhyugrāḥ kapāla bharaṇa ujvalāḥ 
SA_MB_mahaalak-323	kāśmīracandra śrīkhaṇḍaimmṛgālimīna phalguṣaiḥ |	kāśmīra candra śrīkhaṇḍaiḥ mṛga ali mīna phalguṣaiḥ 
SA_MB_mahaalak-324	puṣpervastaistathā cchatraiddīpaidhūpaistu guggulaiḥ |	puṣpeḥ vastaiḥ tathā chatraiḥ dīpaiḥ dhūpaiḥ tu guggulaiḥ 
SA_MB_mahaalak-325	bhāvitānmabhirādyaiśca kramapūjāparālāpavanāṅgī ḍalomikā |	bhāvita anmabhiḥ ādyaiḥ ca krama pūjā para ālāpa vana aṅgī ḍalomikā 
SA_MB_mahaalak-326	p. 20b) bhīṣaṇā ca mahānandā jvālāmukhī tathaiva ca |	bhīṣaṇā ca mahānandā jvālāmukhī tathā eva ca 
SA_MB_mahaalak-327	piśācī hastinī caiva yakṣanīdhūrjaṭīstathā |	piśācī hastinī ca eva yakṣanī dhūrjaṭīḥ tathā 
SA_MB_mahaalak-328	viṣabhakṣī sarvasiddhistuṣṭi icchā tathaiva ca |	viṣa bhakṣī sarva siddhiḥ tuṣṭi icchā tathā eva ca 
SA_MB_mahaalak-329	kuṃkārī bhāśvarīdīrghā dhūmrākṣī kalaha priye |	           
SA_MB_mahaalak-330	mātaṅgī kākadṛṣṭi ca tathā tripuracāntakī ||	mātaṅgī kākadṛṣṭi ca tathā tripuracāntakī 
SA_MB_mahaalak-331	rākṣasīghoranādā ca raktāṅgī viśvarūpiṇī |	rākṣasī ghora nādā ca rakta aṅgī viśva rūpiṇī 
SA_MB_mahaalak-332	bhayaṃkarī raudrī vībhraśuskāṅgīkanana bhojanī |	        
SA_MB_mahaalak-333	vīrabhadra mahākārīkaṃ kālī vikṛtā nanā |	vīrabhadra mahā kārīkam kālī vikṛtā nanā 
SA_MB_mahaalak-334	vrāhmī ca vaiṣṇavī raudrī carcikā iśvarī tathā ||	vrāhmī ca vaiṣṇavī raudrī carcikā iśvarī tathā 
SA_MB_mahaalak-335	vārāhīnārasiṃhī ca śivādutiyaṇī ||	vārāhī nārasiṃhī ca 
SA_MB_mahaalak-336	p. 21) ghaṇṭhā vādyaiśca gītādyaitardvitā kāma sadā |	ghaṇṭhāḥ vādyaiḥ ca kāma sadā 
SA_MB_mahaalak-337	5 oṃ hrī& hrū& amukāya avatara 2 kṣetrakālakapilajaṭābhāra bhāsuratrinetra jvālāmukhī	om hrī   amukāya avatara kṣetra kāla kapila jaṭā bhāra bhāsura trinetra jvālā mukhī 
SA_MB_mahaalak-338	gaṃdhapuṣ.paṃ valipūjāṃ gṛhna 2 bhairavarūpeṇa bhuru 2 muru 2 kha 2 la 2 hra& phra&	gaṃdha puṣpam vali pūjām gṛhna bhairava rūpeṇa bhuru muru kha la hra phra 
SA_MB_mahaalak-339	haḥ mahāḍāmarādhipataye svāhā ||	haḥ mahā ḍāmara adhipataye svāhā 
SA_MB_mahaalak-340	ai& 5 jayāśca vijayācaiva jayantī cāparājitā |	ai jayāḥ ca vijayā ca eva jayantī ca aparājitā 
SA_MB_mahaalak-341	nandā bhadrā jayā bhīmā kalā caivāṣṭakastathā ||	nandā bhadrā jayā bhīmā kalā ca eva aṣṭakaḥ tathā 
SA_MB_mahaalak-342	divya yoginīmahāyogni siddhiyogni gaṇeśvarī |	            
SA_MB_mahaalak-343	śākinī kālarātrī ca ūrddhakeśī niśācarī |	         
SA_MB_mahaalak-344	gambhīrāghoṣaṇīsthu catuḥ ṣaṣṭikā ||	catuḥ ṣaṣṭikā 
SA_MB_mahaalak-345	p. 20b) idaṃ devyāmahāyogni valiṃ gṛhnantume sadā |	idam valim sadā 
SA_MB_mahaalak-346	hrī& cauṣaṣṭiyognibhyo valiṃ gṛhna 2 sarvaśāntiṃ kuru 2 sarvavighnivināsaya	hrī valim gṛhna sarva śāntim kuru sarva vighni vināsaya 
SA_MB_mahaalak-347	sarvarogāyaśānti kuru 2 hna phaṭ svāhā |	sarva rogāya śānti kuru hna phaṭ svāhā 
SA_MB_mahaalak-348	ai& 5 vrahmaṃ vrahmāṇḍakhaṇḍaṃ pivarudhira sadāsiṃdhu 2 pravaddhā	ai vrahmam vrahmāṇḍa khaṇḍam pravaddhā 
SA_MB_mahaalak-349	nānuṣṇokṛṣṇaraktā paśupiśitapatat parvato purajāgre |	na an uṣṇa u kṛṣṇa raktā 
SA_MB_mahaalak-350	vajrenidrāntakārā kurukanagiritā tāṇḍavotiṣṭa sambhodevī cakraṃ cikiṣu	vajrenidrā anta kārā sambhodevī cakram 
SA_MB_mahaalak-351	svayamiticaṭavovanditājñā punā tu ||	tu 
SA_MB_mahaalak-352	ūrddhavrahmāṇḍatovādi vigagaṇatale bhūtaleniṣkarevā pātālevānale	ūrddha vrahmāṇḍataḥ vādi bhū tale niṣkare vā pātāle iva anale 
SA_MB_mahaalak-353	vāsalirapavayoryatra kutra sthito vā |	vāsaliḥ apavayoḥ yatra kutra sthitaḥ vā 
SA_MB_mahaalak-354	kṣetrapīṭhopapīṭhādiṣu ca kṛta padāpuṣpadhūpādikena prītādevyāḥ sadānaḥ	kṣetra pīṭha upapīṭha ādiṣu ca prītā devyāḥ 
SA_MB_mahaalak-355	śubhavalividhinā pātu vīrendra vaṃdyāḥ |	śubha vali vidhinā pātu vīra indra vaṃdyāḥ 
SA_MB_mahaalak-356	p. 22a) sādhyasiddhyeśca sarve alipisite valipūjāṃ gṛhna 2 mama śāntikāmaṃ kuru 2	sarve sarve ali pi site vali pūjām gṛhna mama śānti kāmam kuru 
SA_MB_mahaalak-357	hūṃ phaṭ svāhā ||	hūm phaṭ svāhā 
SA_MB_mahaalak-358	ai& 5 hrā& hrī& hrū& yakṣarākṣasa bhūtāśca vetālā kṣetra pālakā |	ai hrā hrī hrū yakṣa rākṣasa bhūtāḥ ca vetālā kṣetra 
SA_MB_mahaalak-359	ḍākinī ca tathā mālā pūtanākata pūtanā ||	ḍākinī ca tathā mālā pūtanākata pūtanā 
SA_MB_mahaalak-360	pīṭhajākṣetrajāścaiva garbhajāsahajāstathā |	pīṭha ja a kṣetra jāḥ ca eva garbha ja a sahajāḥ tathā 
SA_MB_mahaalak-361	yogajāmantrajāścaiva kulajāśca viśeṣataḥ |	yoga ja a mantra jāḥ ca eva kula jāḥ ca viśeṣataḥ 
SA_MB_mahaalak-362	nānārūpadharācānyā yoginīnyāva na vantalā |	nānā rūpa dharā ca anyā na vantalā 
SA_MB_mahaalak-363	nānādeśanivāsinyā asmiṃ cakre samāgato |	nānā deśa nivāsinyāḥ asmin cakre 
SA_MB_mahaalak-364	samayāsthenaya cānyā tathā ca valikāṃkṣiṇa |	ca anyā tathā ca 
SA_MB_mahaalak-365	tṛpyante āsavaiddivyaiggandhapuṣpādi phalguṣaiḥ |	tṛpyante āsavaiḥ ddivyaiḥ gandha puṣpa ādi phalguṣaiḥ 
SA_MB_mahaalak-366	p. 22b) tṛpyandadantumekānāṃ vāṃcchitārthaṃ dadasvame |	tṛpyan dadantum ekānām vāṃchita artham dadasva ame 
SA_MB_mahaalak-367	hna 3 phaṭ valiṃ gṛhna 2 svāhā |	hna phaṭ valim gṛhna svāhā 
SA_MB_mahaalak-368	oṃ& hrī& śrī& khphre& śivābhagavatiścaiva māyābhadrā tathaiva ca |	om hrī śrī khphre śivā bhagavatiḥ ca eva māyā bhadrā tathā eva ca 
SA_MB_mahaalak-369	kiṃkinī vimalālī ca yamajihvātvakṣa karṣiṇī |	         
SA_MB_mahaalak-370	ghaṇṭhoderī coramātākiṃkinī kākinīstathā |	          
SA_MB_mahaalak-371	siddhilakṣmī trayodaśyāṃ valiṃ gṛhnantume sadā |	siddhi lakṣmī trayodaśyām valim sadā 
SA_MB_mahaalak-372	sarvavighni vināśāyasarvaśatru nivāraṇaṃ |	sarva vighni vināśāya sarva śatru nivāraṇam 
SA_MB_mahaalak-373	trayodaśamelāpaka śrīsiddhilakṣmībhyovaliṃ gṛhna 2 svāhā |	trayodaśa melāpaka śrī siddhi lakṣmībhyaḥ valim gṛhna svāhā 
SA_MB_mahaalak-374	ai& 5 kavarṇekaṃ kāmarūpapulavipula gatājālapīṭhe jayākhye ṣaṭkoṇemadhe pīṭhe	ai ka varṇa ikam kāmarūpa pula vipula pīṭhe jaya ākhye pīṭhe 
SA_MB_mahaalak-375	tripathagatiyuto devadevitaśṛgātakāraṃ |	tripatha gati yutaḥ deva devita śṛgāta kāram 
SA_MB_mahaalak-376	p. 23a) ācāryaḥ siddhisaṃghista tadukaliyugeṣaṣṭakaṃ yonivṛndai yūktohaṃ	ācāryaḥ 
SA_MB_mahaalak-377	paṃcakādyairḍalarakasahajā devadeviṃ namāmiḥ ||	paṃcaka ādyaiḥ ḍa laraka sahajāḥ devadevim namāmiḥ 
SA_MB_mahaalak-378	ai& 5 yābhūdivyāṇtarikṣa daśadiśibhuvane saptapātālamūle kṣetre pīṭhopapīṭhe	ai daśa diśi bhuvane sapta pātāla mūle kṣetre pīṭha upapīṭhe 
SA_MB_mahaalak-379	viṣamacatupaṭhemalakevā śmśāne |	viṣama catu paṭhā imalakā iva śmśāne 
SA_MB_mahaalak-380	siddhyautī caiva vṛkṣa ḍa dadhiśubhataṭedhumrakārā vatālekolaryā pūrṇagiryāmatha	ca eva pūrṇagiryām atha 
SA_MB_mahaalak-381	ca puravareṇoḍiyāne pradhāne jālākhyayoga mukhyekulapatinagale	ca pura vareṇa uḍiyāne pradhāne jāla ākhya yoga mukhye kula pati nagale 
SA_MB_mahaalak-382	kāmarūpesurupeḍarjanyāṃ maṭṭahāsepaṭpaṭaharavīlāḍadeśe pradeśo śrīśaile	kāmarūpesurupeḍarjanyām maṭṭa hāse paṭpaṭa haravīlāḍa deśe śrīśaile 
SA_MB_mahaalak-383	pālijāte paśupatinilaye hemavindhyāvalena śrīmokāvāḍadeśe marutapathagirau	pāli jāte paśupati nilaye hema vindhya āvalena śrī mokāvāḍa deśe marutapatha girau 
SA_MB_mahaalak-384	ḍākinī śākinīnāṃ ||	ḍākinī śākinīnām 
SA_MB_mahaalak-385	p. 23b) kāsmīre cāndradeśe draviḍamalayake vrahmavāhe kulutestrīrājehakvaḍokve	kāsmīre cāndra deśe draviḍa malayake vrahma vāhe 
SA_MB_mahaalak-386	urasivirajake siddhikṣetre udāre |	urasivirajake siddhikṣetre udāre 
SA_MB_mahaalak-387	erudyāṃ pālijāte himagiriśikharekāṃ videśe priyāge |	erudyām pālijāte himagiri śikhara ikām videśe priyāge 
SA_MB_mahaalak-388	saurāṣṭramadhedaśe bhṛgupuranagalekośarekāmrakevā ||	saurāṣṭram adhedaśe 
SA_MB_mahaalak-389	karṇāṭekāṃkaṇe vāmagadhapuravarakarṇakuvjekaliṃge vacchome haṃsavāhe	karṇāṭekāṃkaṇe vāmagadha pura varakarṇa kuvjekaliṃge vacchome haṃsavāhe 
SA_MB_mahaalak-390	himarajapatalepāṭaleḍogarākhya agauhemātṛcakre munigananilaya ḍohare	agauhe mātṛ cakre ḍohare 
SA_MB_mahaalak-391	candradeśerāmaura puṣpanākhyāgirigahireguhevākuhe siṃhanāde ||	siṃhanāde 
SA_MB_mahaalak-392	p. 24a) vaṃgākhye bhomanāde śivapuranagalebhadramūle jayākhye	vaṃga ākhye bhomanāde śivapura nagalebhadramūle jaya ākhye 
SA_MB_mahaalak-393	śrīvidyāṃkhyaikacchatrepravalagirītaṭe yakṣakumbhe ca laṃke ||	yakṣakumbhe ca laṃke 
SA_MB_mahaalak-394	vārāṇasyāṃ viśāle tripathamunipathe śuddhakule ca mārge stacchānte stacchamālya	vārāṇasyām viśāle tripatha muni pathe śuddha kule ca mārge stad śānte 
SA_MB_mahaalak-395	malayagiriguhābrahmadeśe purevā ||	malaya giri guhā brahmadeśe purā iva 
SA_MB_mahaalak-396	bhadrāṃge mūlathāne prakṛtipuralaye siṃhakarṇeśāśāketriśotre vyomamadhya	bhadrāṃge mūla thāne prakṛti pura laye vyoma madhya 
SA_MB_mahaalak-397	suravarasayane gahvarākhye sthalekhu yoginyāmaṇḍajāśca vividhavudhanutāṃ	suravara sayane gahvara ākhye sthalekhu yoginyām aṇḍajāḥ ca vividha vudha nutām 
SA_MB_mahaalak-398	mātarastāstāñca sarvāntūṣṭāḥ susiddhā vividhavudhanutā divyaṃ siddhiṃdadā tu |	mātaraḥ tāḥ tān ca su siddhāḥ vividha vudha nutāḥ divyam siddhiṃdadā tu 
SA_MB_mahaalak-399	p. 24b) khaḍgamvā mantrasiddhiṃ puravaravisadaṃ khegatiṃ rocanamvāśantustambhaṃ	khaḍgam vā mantra siddhim puravara visadam khegatim 
SA_MB_mahaalak-400	ripulaṃvaliparitajayaṃ stambhanaṃ sarvavidyā |	stambhanam sarva vidyā 
SA_MB_mahaalak-401	dīghāyuṣyaṃ kavitvaṃ nidhirasagutikāpādukāṃ kāmasiddhiṃ savāśyetrādadantu	dīgha āyuṣyam kavi tvam nidhi rasa gutikā pādukām kāma siddhim 
SA_MB_mahaalak-402	alipisitaratā bhairavenāruraktāḥ ||	a lipi sita ratāḥ bhairavena āruraktāḥ 
SA_MB_mahaalak-403	duṣṭacaurārimārigrahagaṇaragale vidyupātera nevārāja dvāreṅga raudyevighataya tu	tu 
SA_MB_mahaalak-404	bhayaṃ dhyāyutaṃ ścarmamuṇḍā |	bhayam dhyā ayutam ścarma muṇḍā 
SA_MB_mahaalak-405	vau& cchau& oṃkārayantī |	vau cchau oṃkārayantī 
SA_MB_mahaalak-406	p. 25a) ha ha ha ha hasitaiścarcayantī pivantī nṛtyantī mantramātā kilikilitakiliḥ	ha ha ha ha hasitaiḥ carcayantī pivantī nṛtyantī mantramātrī kili kilita kiliḥ 
SA_MB_mahaalak-407	kaulabhāṣā girantī |	kaula bhāṣā girantī 
SA_MB_mahaalak-408	sā śuṣkā kāmarūpāya ralavapaṭa hā hā ha ku&kāranādā utiṣṭā nīlakaṇṭhā	sā śuṣkā kāmarūpāya hā hā ha kukāra nādā nīla kaṇṭhā 
SA_MB_mahaalak-409	amalasu hṛdayāvindumuddhi praśastā ||	praśastā 
SA_MB_mahaalak-410	phre& phre& phetkārayantī ru ru rudhiravasākhādyamānā saroṣā jihvāgre lālantī la la la	phre phre phetkārayantī ru ru rudhira vasā ākhādyamānā sa roṣā jihvā agre lālantī la la la 
SA_MB_mahaalak-411	la la latā drāvayantī pivantī ||	la la latā drāvayantī pivantī 
SA_MB_mahaalak-412	kṛṣṇā kāmākhyadūti amalaguṇanutā vindunādāntalinā śakyante siddhidāmāparam	amala guṇa nutā śakyante 
SA_MB_mahaalak-413	apadagatāvad vitāraṅgamaṅgā ||	a pada gatā vat vitāraṅgam aṅgā 
SA_MB_mahaalak-414	p. 25b) prāgarbhā lokapālā gasapamanayutā pathivenonuyuktā	prāgarbhā lokapālā gasapamana yutā 
SA_MB_mahaalak-415	ṣaṣṭhasthā vinduyuktā kulakamalaratā tāriṇī kuṇḍalākhyā |	                
SA_MB_mahaalak-416	vikhyātā rudraśaktiḥ sa ca disatu śivaṃ bhīṣaṇī bhadra kālī	vikhyātā rudra śaktiḥ sa ca disatu śivam bhīṣaṇī bhadra kālī 
SA_MB_mahaalak-417	kā& kī& kū& kāmarūpā akulakulagatā dveṣiṇāṃ bhakṣayantī ||	kā kī kū kāmarūpā a kula kula gatā dveṣiṇām bhakṣayantī 
SA_MB_mahaalak-418	some śrīkuvjikākhyā vitare tu paramaṃ vāmadivyaṃ	some śrīkuvjikā ākhyā vitare tu paramam vāma divyam 
SA_MB_mahaalak-419	ghamoghaṃ cāmuṇḍā kaulamārge kulakamalamaya	cāmuṇḍā kaula mārge kula kamala maya 
SA_MB_mahaalak-420	kaulinī koṅkaṇākhyā ākhyātā vāmamārge prakaṭitanilayālinī vindudehā ||	kaulinī koṅkaṇa ākhyā ākhyātā vāma mārge prakaṭita nilaya ālinī vindu dehā 
SA_MB_mahaalak-421	oṃ kāre maṇḍale vā akulamayā yognicakre pratiṣṭhā	om kāre maṇḍale vā akula mayā pratiṣṭhā 
SA_MB_mahaalak-422	śrīnāthotsaṃgagāmā pravaramunigaṇe	              
SA_MB_mahaalak-423	carcitā bhīmamūrtiḥ sā devī lokamātā	carcitā bhīma mūrtiḥ sā devī lokamātā 
SA_MB_mahaalak-424	śivasakalamukhāpātu śrīnātha cakre |	śiva sakala mukhā āpātu śrī nātha cakre 
SA_MB_mahaalak-425	p. 26a) śrīkaṇṭhābhyarcāmānā ca turyagasahitā madhyaliṃge nvikākhyā	                
SA_MB_mahaalak-426	pīṭhasthā purayantī cakacakitakalā kaulamārgoditābhā |	                   
SA_MB_mahaalak-427	nāmnā śrīkuvjikākhyā tripathagatiyutātryikṣe	nāmnā śrī kuvjikā ākhyā 
SA_MB_mahaalak-428	rātriprakārātān devīṃ naumi bhaktyā	devīm naumi bhaktyā 
SA_MB_mahaalak-429	prakaṭitanilayā pañcakādyanta bhinnā |	prakaṭita nilayā pañcaka ādi anta bhinnā 
SA_MB_mahaalak-430	kālīkaṃ kālarūpā kalitatararavā bhīṣaṇī bhakṣayantī	kālīkam kālarūpā kalitatara ravā bhīṣaṇī bhakṣayantī 
SA_MB_mahaalak-431	sā me śrīkuvjikāmvā prakaṭayatu mahājñānadivyaughamoghaṃ ||	sā me śrī kuvjikā amvā prakaṭayatu mahā jñāna divya ogham ogham 
SA_MB_mahaalak-432	p. 26b) hrī& glū& hrī& slū& hrī& plū& hrī& mlū& hrī& nlū& hsau& hsphre& śrī& hrī& ai& ||	hrī glū hrī slū hrī plū hrī mlū hrī nlū hsau hsphre śrī hrī ai 
SA_MB_mahaalak-433	ṛddhiṃ dehi siddhi dehi jñānaṃ dehi āyurddahi dhanaṃ dehi dhānyaṃ dehi lakṣmīṃ	ṛddhim dehi siddhi dehi jñānam dehi dhanam dehi dhānyam dehi lakṣmīm 
SA_MB_mahaalak-434	dehi imāṃ valiṃ gṛhna 2 amṛtāvedya svāhā ||	dehi imām valim gṛhna amṛtāvedya svāhā 
SA_MB_mahaalak-435	samastamantrapīthe || ukānuktaṃ || kṣamasva varado mama svāhā ||	samasta mantra pīthe kṣamasva vara daḥ mama svāhā 
SA_MB_mahaalak-436	yajamānanatriyāñjalicchāyake || mūlamantrana || 3 || vālaḥ || ṣaḍaṃgapūjā ||	                
SA_MB_mahaalak-437	āvāhanādi || dhenumudrā yonimudrā darśayet ||	āvāhana ādi dhenumudrāḥ yonimudrāḥ darśayet 
SA_MB_mahaalak-438	p. 27a) nirvāṇacchāya || valiḥ || tvākamahāvalina dhunake || āvāhanādi	valiḥ āvāhana ādi 
SA_MB_mahaalak-439	yonivindumudrāṃ darśayet ||	yonivindumudrām darśayet 
SA_MB_mahaalak-440	valisacatasindhara akṣata svānataya || dhūpa ||	valisacatasindhara akṣata su ānataya dhūpa 
SA_MB_mahaalak-441	dīvyagandhasamāyuktaṃ sarvadeva priyāruhāḥ |	dīvya gandha samāyuktam sarva deva priyāruhāḥ 
SA_MB_mahaalak-442	āghrāyaḥ sarvadevānāṃ dhūpo 'yaṃ pratigṛhyatāṃ ||	āghrāyaḥ sarva devānām dhūpaḥ yam pratigṛhyatām 
SA_MB_mahaalak-443	dhūpāhāreṣu bhagavan viśvarūpa maheśvara dhūpenāne deveśī suprītāṃ	dhūpa āhāreṣu bhagavan viśvarūpa maheśvara deveśī su prītām 
SA_MB_mahaalak-444	parameśvarī || dīpa ||	parameśvarī dīpa 
SA_MB_mahaalak-445	suprakāśamahātejaḥ sarvatra timirāpahaṃ |	su prakāśa mahā tejaḥ sarvatra timira apaham 
SA_MB_mahaalak-446	p. 27b) savāhyāntaraṃ jyotiddīpoyaṃ pratigṛhyatāṃ || moho nihaya ||	sa vāhya antaram jyotiḥ dīpaḥ yam pratigṛhyatām mohaḥ 
SA_MB_mahaalak-447	vindu nahāyasalimelāyāduvane sārakocoyāva mohānihaya ||	vindu 
SA_MB_mahaalak-448	cet sindharataya svānataya || māhonisa pūjāyāya || ai& 5 padmāsanāya namaḥ || ai& 5	ced sindharataya svānataya māhonisa pūjāyāya ai padmāsanāya namaḥ ai 
SA_MB_mahaalak-449	śkṣmlvryī& śrīḍoṣadhī karmabhaṭṭārikāyai pādukāṃ || 3 ||	śrīḥ ḍoṣadhī karma bhaṭṭārikāyai pādukām 
SA_MB_mahaalak-450	mūlamantra na triyāñjali || śa& mahālakṣmī saṃhārabhairavāya pādukāṃ ||	mahālakṣmī saṃhārabhairavāya pādukām 
SA_MB_mahaalak-451	ṣaḍaṃga || mā& hṛdayāya namaḥ || mi& sirase svāhā ||	ṣaṣ aṃga mā hṛdayāya namaḥ mī sirase svāhā 
SA_MB_mahaalak-452	p. 28a) mū& śikhāya vauṣaṭ || mai& kavacāya huṃ || mau& netratrayāya vaṣaṭ || maḥ	                    
SA_MB_mahaalak-453	astrāya phaṭ || āvāhanādi || mudrā || naivyadyaḥ ||	astrāya phaṭ āvāhana ādi mudrā naivyadyaḥ 
SA_MB_mahaalak-454	annamahorasaṃdivyaṃ  raśeṣadbhi samanvitaṃ |	annam ahorasam divyam samanvitam 
SA_MB_mahaalak-455	mayāniveditabhaktyā gṛhāna parameśvarī ||	mayā a nivedita bhaktyā parameśvarī 
SA_MB_mahaalak-456	naivyadya gṛhyatāṃ devī bhaktime ca parāṃ kuru apamṛtyu haraṃ devī paratre ca parāṃ	gṛhyatām devī bhakti me ca parām kuru apamṛtyu haram devī paratre ca parām 
SA_MB_mahaalak-457	gati || japa || trideva || thrau& svāhā 10 || śrī& hrī& svāhā || glau& svāhā || thavamārayāya ||	gati japa trideva thrau svāhā  śrī hrī svāhā glau svāhā thavamārayāya 
SA_MB_mahaalak-458	smlvryū& svāhā 10 || nirvānayāhako yāya || idaṃ japaṃ gṛhānaṃ svāhā ||	svāhā    idam japam svāhā 
SA_MB_mahaalak-459	svānadevaske cchāya || japa svānaviya ||	svānadevaske chāya japa 
SA_MB_mahaalak-460	p. 28b) 1 maṇḍala dayake || ke vā 5 vātaya || stotra ||	maṇḍala dayake ke vā vātaya stotra 
SA_MB_mahaalak-461	ai& 5 akhaṇḍamaṇḍalākālaṃ vyāptaṃ yena carācaraṃ |	akhaṇḍa maṇḍala akālam vyāptam yena carācaram 
SA_MB_mahaalak-462	tatpadaṃ darśitaṃ yena tasmai śrīguruve namaḥ ||	tad padam darśitam yena tasmai śrī guruve namaḥ 
SA_MB_mahaalak-463	śrī mahābhairavāya ||	śrī mahābhairavāya 
SA_MB_mahaalak-464	śrīdevyuvāca ||	śrī devī uvāca 
SA_MB_mahaalak-465	śrīsaṃvartāmaṇḍalānte kramapadanihitānandaśakti subhīmāsṛṣṭaṃ nyāyacatuṣkaṃ	śrī saṃvartā maṇḍala ante krama pada nihita ānanda śakti su bhīma āsṛṣṭam nyāya catuṣkam 
SA_MB_mahaalak-466	akulakulagataṃ pañcakaṃ cānyaṣaṭkaṃ |	a kula kula gatam pañcakam ca anya ṣaṭkam 
SA_MB_mahaalak-467	catvāraḥ paṃcakonyaṃ punarapicaturaṃ ṣoḍaśājñāviśeṣo devyāstau mūrtimadhyeha	catvāraḥ paṃcakonyam punar api caturam ṣoḍaśa ājñā viśeṣaḥ devyāḥ tau mūrti madhyā iha 
SA_MB_mahaalak-468	sakhaphalakarāvindupuṣpākṣa mudrā ||	mudrā 
SA_MB_mahaalak-469	vṛrddhaṃ kaimālavāraṃ paramaśivakalācakra devī kramānyā śrīnāthaṃ	kaimālavāram devī kramānyā śrīnātham 
SA_MB_mahaalak-470	candrapujyā navanavakalitaṃ yugma bhede tu sāraṃ ||	candra pujyāḥ nava nava kalitam yugma bhede tu sāram 
SA_MB_mahaalak-471	p. 29a) tritatvaṃ siddhāvatāraṃ prathamakaliyuge koṅkaṇesvādhikāraṃ teṣāṃ vai	trita tvam siddha avatāram prathama kali yuge koṅkaṇe sva adhikāram teṣām vai 
SA_MB_mahaalak-472	putraśiṣyā navapurakhagamate teṣumadhyedi raṣṭau ||	putra śiṣyāḥ 
SA_MB_mahaalak-473	santānaṃ gotrapiṇḍaṃ kulakamasakalaṃ ṣoḍaśāntā kramāntaṃ	santānam gotra piṇḍam kulakam asakalam ṣoḍaśāntā krama antam 
SA_MB_mahaalak-474	ādauddhemaṇḍalādyai paribharalamalaṃ pūjyasat bhāvavṛndaṃ ||	pūjya sat bhāva vṛndam 
SA_MB_mahaalak-475	ādhāvasthā daśāntaṃ kulakramasakalamaṇḍalasthānapūrvaṃ saṃskāraṃ	ādhā avasthā daśa antam kula krama sakala maṇḍala sthāna pūrvam saṃskāram 
SA_MB_mahaalak-476	trikṣematatpaśu janabhayakṛdvindusiddhi śivāgnau ||	śiva agnau 
SA_MB_mahaalak-477	madhye viśrāma bhūmi prabhavamanubhaya pratyayaṃ svādhikāraṃ saṃsṛṣṭaṃ yena	madhye sva adhikāram saṃsṛṣṭam yena 
SA_MB_mahaalak-478	tasmai namatuguruvaraṃ bhairavaṃ śrīkujeśaṃ ||	tasmai namatu guru varam bhairavam śrī kuja īśam 
SA_MB_mahaalak-479	ai& yāsāśaktirbhagākhyā tripathagatiyutā trikṣarātriprakārā ai& tasyā śrīoḍiyāne	ai tripathagati yutā trikṣarā tri prakārā 
SA_MB_mahaalak-480	parakarasahitaṃ madhyesaṃsthaṃ sudīptaṃ ||	para kara sahitam madhye saṃstham su dīptam 
SA_MB_mahaalak-481	p. 29b) hrī& tacchrī jālaṃdharākhya prakatitanilayadakṣiṇe caiva koṇe śrīvāme	                                          
SA_MB_mahaalak-482	śrīpūrṇapīthe paśujanabhayakṛtpūjitaṃ yenaviśvaṃ ||	śrī pūrṇa pīthe paśu jana bhaya kṛt pūjitam yena viśvam 
SA_MB_mahaalak-483	hsphre& tasyāgrekāmarūpaṃ madanakaliyutaṃ sarvasiddhālayaṃ ca hsau& trikoṇānte	tasya agre kāmarūpam madana kali yutam sarva siddha ālayam ca hsau trikoṇa ante 
SA_MB_mahaalak-484	samastaṃ paramaśivakalālaṃ kṛtaṃ yogavṛndaṃ |	samastam parama śiva kalā alam kṛtam yoga vṛndam 
SA_MB_mahaalak-485	hyau& tanmadhye divyaliṅgaṃ paramasuṣakaraṃ vindurūpaṃ ṣarūpaṃ klī&	tad madhye divya liṅgam parama suṣa karam vindu rūpam ṣa rūpam klī 
SA_MB_mahaalak-486	nityānandasvarūpaṃ tadupariparamaṃ ṣaprakārairvibhinnaṃ ||	                
SA_MB_mahaalak-487	glū& vidyābhogāpagamya manubhayavimaraṃ triśapīṭhe lalāṭe aiṃ avaṃ vyāptaṃ	vidyā bhoga apagamya manu bhaya vimaram triśa pīṭhe lalāṭe aim avam vyāptam 
SA_MB_mahaalak-488	samastaṃ sthitilayajananī rudraśaktitribhedā ||	samastam sthiti laya jananī rudra śakti tri bhedā 
SA_MB_mahaalak-489	p. 30a) ai& tatasthā devadevī akulakulamayānandadhā trisvarūpā oṃ gurvājñā	                            
SA_MB_mahaalak-490	vindubhūtāyaśujanaharaṇī siddhidivyogha rūpā ||	rūpā 
SA_MB_mahaalak-491	hsau& nityaklinnā suraktā bhagamudita padānandadhātriprasirddhā kṣmau& kurvantī	nitya klinnā su raktā kṣmau kurvantī 
SA_MB_mahaalak-492	tatvakāmāṃ kṣubhitavaranuṃ śrījākṣānnamāmi ||	kṣubhita varanum śrī jākṣān namāmi 
SA_MB_mahaalak-493	santānaṃ merumārgena anvayaṃ tratra devatā ||	santānam meru mārgena anvayam devatā 
SA_MB_mahaalak-494	nirgamaḥ pīṭha oṃkāraṃ siddhāṃnvaya prakīrtitā ||	nirgamaḥ pīṭhaḥ oṃkāram prakīrtitā 
SA_MB_mahaalak-495	bhūṣṇībhūtīguhāvāsī vṛkṣaścaiva kadamvakaḥ |	bhūṣṇī bhūtī guhā vāsī vṛkṣaḥ ca eva kadamvakaḥ 
SA_MB_mahaalak-496	saṃkhetasyavitaṃ proktaṃ amvā ca guhavāsinī ||	proktam amvā ca guhavāsinī 
SA_MB_mahaalak-497	gṛheścandrapuraṃ proktaṃ bhedomanthāna bhairavaṃ |	proktam bhedomanthāna bhairavam 
SA_MB_mahaalak-498	p. 30b) gotra amalikādevī vāmamārge pralpayat ||	gotra amalikādevī vāma mārge 
SA_MB_mahaalak-499	anvayaṃ pratyayaścāra madhikāraśca koṅkaṇe |	anvayam pratyayaḥ ca āra madhikāraḥ ca koṅkaṇe 
SA_MB_mahaalak-500	janmavrahmaśirāsthāne sthitiśrīkāma rūpake ||	janma vrahma śira āsthāne sthiti śrī kāma rūpake 
SA_MB_mahaalak-501	kīrtiściñcinivṛkṣa tu siddhicaiva tu śāgare |	tu tu śāgare 
SA_MB_mahaalak-502	tuṣṭāhaṃ tasya deveśi yojānāti kulākramaṃ ||	tuṣṭā aham tasya deveśi yaḥ jānāti kula ākramam 
SA_MB_mahaalak-503	ṣoḍaśādhāra bhedena nyāsaṃ kuṭaṃ kramaṃ tathā ||	ṣoḍaśa ādhāra bhedena nyāsam kuṭam kramam tathā 
SA_MB_mahaalak-504	pūjitaṃ siddhidaṃ bhadre suśiṣyāya nivedayet ||	pūjitam siddhi dam bhadre su śiṣyāya nivedayet 
SA_MB_mahaalak-505	oṃ namo'stute mahāmāya sūkṣmadehe parāpare |	om namaḥ stu te mahāmāya sūkṣma dehe parāpare 
SA_MB_mahaalak-506	ekākiniviśvadhātmānādākhyavindu mālinī ||	            
SA_MB_mahaalak-507	adehāyasamutpanne acareviśva dhāriṇī ||	a dehāya samutpanne a care viśva dhāriṇī 
SA_MB_mahaalak-508	mahākuṇḍalani nityaṃ haṃsamadhye vyavasthitā ||	nityam haṃsa madhye vyavasthitā 
SA_MB_mahaalak-509	p. 31a) somasūryāgnimadhyesthe vyomavyāpi parāpare |	                
SA_MB_mahaalak-510	oṃkāravigrahāvasthai hakārārdhārdha dhāriṇī ||	oṃkāra vigraha avasthā hakāra ardha ardha dhāriṇī 
SA_MB_mahaalak-511	vālāgraśatadhāsūkṣme antecākṣayavyaya |	vāla agra śatadhā sūkṣme 
SA_MB_mahaalak-512	hakārārddhakalādhāre padmakiñjalkamāśrite ||	hakāra arddha kalā ādhāre padma kiñjalkam āśrite 
SA_MB_mahaalak-513	sakalākhye mahāmāye varadeloka pūjite |	sakala ākhye mahāmāye vara de loka pūjite 
SA_MB_mahaalak-514	ekaikanādi madhyesthe marmamekaika bhedinī ||	marmam ekaika bhedinī 
SA_MB_mahaalak-515	aṣṭatriṃśat kalādevī bhedinī brahmarandhrake ||	          
SA_MB_mahaalak-516	vidyullatānibhā devī bhujaṃ kuṭilākṛti ||	vidyut latā nibhā devī bhujam kuṭila ākṛti 
SA_MB_mahaalak-517	vrahmāviṣṇuśca raudraśca īśvaraśva sadāśivaḥ |	raudraḥ ca sadāśivaḥ 
SA_MB_mahaalak-518	etapañcamahā pratāpādamūle vyavasthitā ||	eta pañca mahā pratāpāt a mūle vyavasthitā 
SA_MB_mahaalak-519	trailokyajananī devī namasteśakti rupiṇī ||	trailokya jananī devī namaḥ te śakti rupiṇī 
SA_MB_mahaalak-520	p. 31b) iḍāpiṅgalamadhyesthe mṛṇāratantu rupiṇī ||	iḍā piṅgala madhyesthe mṛṇāra tantu rupiṇī 
SA_MB_mahaalak-521	umākhyehṛgate gaurī dvādaśāditya varcase |	gaurī dvādaśa āditya varcase 
SA_MB_mahaalak-522	sūnyesūnyāntārāvasthehaṃ sākṣaprāṇa dhāriṇī ||	sūnye sūnya antāra avasthā iham sā akṣa prāṇa dhāriṇī 
SA_MB_mahaalak-523	lamvākhya paramādevi dakṣiṇortara gāminī ||	lamva ākhya paramādevi gāminī 
SA_MB_mahaalak-524	nāsāgre ca samuttīrṇe madhyesūtra pravāhiṇī ||	nāsā agre ca samuttīrṇe madhyesūtra pravāhiṇī 
SA_MB_mahaalak-525	hallekhe parmānande tālamuddhi vyavasthitā ||	        
SA_MB_mahaalak-526	nādaghaṇṭhika saṃghṛṭe guṇāṣṭaka samanvite ||	nādaghaṇṭhika saṃghṛṭe guṇa aṣṭaka samanvite 
SA_MB_mahaalak-527	sthūle sūkṣmetva saṃkrūrddhe dharmādharma putadvaya |	sthūle 
SA_MB_mahaalak-528	kāryakāraṇakatṛtvaṃ triśūnyanā vigrahe ||	kārya kāraṇa katṛ tvam vigrahe 
SA_MB_mahaalak-529	parāparapareśu caitanyaśāśvate dhruve |	caitanya śāśvate dhruve 
SA_MB_mahaalak-530	sarvavarṇadharī devī guhyatatva triviśrute ||	devī tri viśrute 
SA_MB_mahaalak-531	śaktimūle mahāvyuhe vinduvijasamanvite |	śakti mūle mahā vyuhe vindu vija samanvite 
SA_MB_mahaalak-532	p. 32a) aśarīre mahābhāge saṃsārārṇava tāriṇī ||	aśarīre mahābhāge saṃsāra arṇava tāriṇī 
SA_MB_mahaalak-533	jayā ca vijayā caiva jayantī cāparājitā |	jayā ca vijayā ca eva jayantī ca aparājitā 
SA_MB_mahaalak-534	tumvuruvījamadhyesthe namastepāpa mocanī ||	tumvuru vīja madhyesthe mocanī 
SA_MB_mahaalak-535	vandhamokṣavarī ṣoḍaśāntā vyavasthitā |	            
SA_MB_mahaalak-536	ḍamanī śaktiśūla na mahāvyuhe samanvite ||	ḍamanī samanvite 
SA_MB_mahaalak-537	bhamanī bhāmaṇī gaurī māyāyaṃtra pravāhinī ||	bhamanī bhāmaṇī gaurī māyāyaṃtra pravāhinī 
SA_MB_mahaalak-538	svacchanda bhairavī devī krodha unmarta bhairavī ||	svacchanda bhairavī devī krodha unmarta bhairavī 
SA_MB_mahaalak-539	pañcāsavarṇarūpa sthātvayā rudrāḥ prakīrtitāḥ |	rudrāḥ prakīrtitāḥ 
SA_MB_mahaalak-540	amṛtākhye ruruścandra namastejñāna bhairavī ||	amṛta ākhye ruru ścandra namaḥ te jñāna bhairavī 
SA_MB_mahaalak-541	daṃṣṭrotkaṭo vidyujihvetālakākṣī bhayānane |	              
SA_MB_mahaalak-542	namāmi devadeveśī aghoreghora vikrame ||	namāmi devadeveśī aghoreghora vikrame 
SA_MB_mahaalak-543	p. 32b) jvālāmukhī vegavatī umādevī namostute ||	jvālāmukhī vegavatī umā devī namaḥ stu te 
SA_MB_mahaalak-544	yoginī ca śrayādevī gaurīlakṣmīsarasvatī ||	yoginī ca śrayā devī gaurī lakṣmī sarasvatī 
SA_MB_mahaalak-545	haṃsasvarādhake devī gomukhī śakti mālinī ||	         
SA_MB_mahaalak-546	kroṣṭakī śubhagādevī durgākātyāyanīstathā ||	kroṣṭakī śubhagā devī durgā kātyāyanīḥ tathā 
SA_MB_mahaalak-547	nityaṃ klinnā samākhyātā raktā ekākṣarāparā |	nityam klinnā samākhyātā raktā eka akṣara aparā 
SA_MB_mahaalak-548	vrāhminī hanī māheśvarī caiva kaumārī vaiṣṇavī tathā ||	vrāhminī hanī māheśvarī ca eva kaumārī vaiṣṇavī tathā 
SA_MB_mahaalak-549	vārāhī caiva māhendrī cāmuṇḍātvaṃ bhayānanā ||	vārāhī ca eva māhendrī cāmuṇḍā tvam bhaya ānanā 
SA_MB_mahaalak-550	yogeśītvaṃ hi deveśi kulāṣṭaka vibhūṣite ||	yogeśī tvam hi deveśi kula aṣṭaka vibhūṣite 
SA_MB_mahaalak-551	aṣṭāṣṭaka dharīdevī lakṣmītvaṃ vahurūpiṇī ||	aṣṭa aṣṭaka lakṣmī tvam vahu rūpiṇī 
SA_MB_mahaalak-552	aindrī caiva tu āgneyāṃ yāmyāṃ ṛtyavāhiṇī ||	aindrī ca eva tu āgneyām yāmyām ṛtya vāhiṇī 
SA_MB_mahaalak-553	vāyuvyāṃ caiva kovalī iśāne ca mudrā hṛtā |	vāyuvyām ca eva kovalī iśāne ca mudrā hṛtā 
SA_MB_mahaalak-554	p. 33a) prayāgā varuṇā kolā aṭṭahāsa jayantikā ||	prayāgā varuṇā kolā aṭṭahāsa jayantikā 
SA_MB_mahaalak-555	caritre kāmrakaṃ caiva devī koṭaṃ tathā kramaṃ |	caritre kāmrakam ca eva devī koṭam tathā kramam 
SA_MB_mahaalak-556	tathā kālī umādevī devadūti namostute ||	tathā kālī umā devī deva dūti namostute 
SA_MB_mahaalak-557	bhadrakāli mahāmāyā carmamuṇḍā bhayāvahe |	bhadrakāli mahāmāyā carmamuṇḍā bhaya āvahe 
SA_MB_mahaalak-558	mahośūkṣme mahāsānte namasteśakti rūpiṇī ||	mahā sānte namaḥ te śakti rūpiṇī 
SA_MB_mahaalak-559	bhurbhuvasvati svāhānte dayānārthaṃ kurukṣame |	bhuḥ bhuvasvati svāhā ante kurukṣame 
SA_MB_mahaalak-560	jñānāthito mahāmāya etardikṣāmivedituṃ ||	jñāna athitaḥ mahāmāyaḥ 
SA_MB_mahaalak-561	yastvidaṃ paṭhyate stotraṃ trisaṃdhyāṃ caiva mānavaḥ |	yaḥ tu idam paṭhyate stotram trisaṃdhyām ca eva mānavaḥ 
SA_MB_mahaalak-562	prāpnoti cintitā kāmān strīṇāṃ bhava tu vallabhaḥ ||	prāpnoti cintitā kāmān strīṇām bhava tu vallabhaḥ 
SA_MB_mahaalak-563	iti śivaśaktisamarasatvaṃ mahāmāyā stotraṃ samāptaṃ ||	iti śiva śakti samarasa tvam mahāmāyā stotram samāptam 
SA_MB_mahaalak-564	p. 33b) piṅgākṣiraktakeśāṃ kiṇikiṇidhavaraṃ kiṅkiṇī mālajālaṃ draṣṭrāsyaṃ	piṅga akṣi rakta keśām kiṇi kiṇidha varam kiṅkiṇī māla jālam draṣṭṛ āsyam 
SA_MB_mahaalak-565	krūlabhāvaṃ sakalabhayaharaṃ pātrahastaṃ ca nādaṃ ||	krūla bhāvam sakala bhaya haram pātra hastam ca nādam 
SA_MB_mahaalak-566	suvyaktaṃ siṃhanādaṃ la la la la la valaṃ varcanaṃ vyomatatvaṃ bhūtapretādināthaṃ	su vyaktam siṃhanādam varcanam bhūta preta ādinātham 
SA_MB_mahaalak-567	grahagaṇanamitaṃ kṣatrapālaṃ namāmi ||	graha gaṇa namitam kṣatrapālam namāmi 
SA_MB_mahaalak-568	raktāmvalaṃ jvalitapiṅgajatākalāpaṃ jvālāvali ratirathaḥ dadharapracandraṃ ||	rakta amvalam jvalita piṅga jatā kalāpam jvālā āvali rati rathaḥ 
SA_MB_mahaalak-569	sūryādayāt kanekakānta na saṅgagauragaurīsutaḥ vaṭukanātha mahaṃ namāmiḥ ||	sūryāt ayāt na saṅga gaura gaurī sutaḥ vaṭuka nātha maham namāmiḥ 
SA_MB_mahaalak-570	hantārṣākṣota dukhaṃ samita bhavabhayaṃ sarvavighnāntakāya gā& gī& gū& gai&	hanta ārṣa akṣa uta dukham samita bhava bhayam sarva vighna antakāya gā gī gū gai 
SA_MB_mahaalak-571	khaḍaṃgegagaṇagatigate siddhisarvārtha bhāve |	siddhi sarva artha bhāve 
SA_MB_mahaalak-572	p. 34a) oṃ hrū& mudrā gajākhyagasapavanagate āyānekasasthe oṃ hrīṃ hūṃ hāṃ gāṃ	om hrū mudrā gaja ākhya ga sa pavana gate om hrīṃ   hāṃ gāṃ 
SA_MB_mahaalak-573	gaṇesedviradaviṣagaṇevighnināthaṃ namaste ||	namaḥ te 
SA_MB_mahaalak-574	icchājñānī kriyā sāsuravaranamitā sāśriyāmaṅgalākhyā sāgaurī sā ca durgā	icchā jñānī kriyā sa asura vara namitā sa āśriyā maṅgala ākhyā sā agaurī sā ca durgā 
SA_MB_mahaalak-575	bhagavati sudhā mātṛkā carmamuṇḍā |	bhagavati sudhā mātṛkā carma muṇḍā 
SA_MB_mahaalak-576	sā vrahmā sā ca viṣṇū grahagaṇanamitā bhairavī kṣetrapālā sānekarūpā	sā vrahmā sā ca viṣṇū graha gaṇana mitā bhairavī kṣetrapālā sā aneka rūpā 
SA_MB_mahaalak-577	vividhaguṇadayā goginītvāṃ namāmi ||	vividha guṇa dayā goginī tvām namāmi 
SA_MB_mahaalak-578	ūkāro nityapādoha sakṣamalabhujocodaraścāgniliṅgaṃ vāyuvyāghrāṃ jināka	ūkāraḥ 
SA_MB_mahaalak-579	śaśisakalaśiro vindunādorddha yukte ||	            
SA_MB_mahaalak-580	p. 34b) nirjiṅgaṅgāvudhārā ṛjuparamakarā bhairavomantramurtiḥ pāyādevonavātmā	ṛju para makarāḥ bhairavaḥ mantra murtiḥ pāyādevaḥ nava ātmā 
SA_MB_mahaalak-581	sakalaguruvaraṃ bhairavaṃ śrīkujeśaḥ ||	              
SA_MB_mahaalak-582	vrahmāṇīkamalendu saumyavadanī māheśvarī lilayā kaumālī ripurdarpanāsanakarī	                        
SA_MB_mahaalak-583	cakrayudhā vaiṣṇavī |	cakra yudhā vaiṣṇavī 
SA_MB_mahaalak-584	vārāhī ghanaghoraghaghanamukhī aindrī ca vajrāyudhācāmuṇḍā	vārāhī ghanaghoraghaghanamukhī aindrī ca vajrāyudhā cāmuṇḍā 
SA_MB_mahaalak-585	gananāthabhairagaṇārakṣantume mātṛkā ||	mātṛkā 
SA_MB_mahaalak-586	madhye trisāsanasthā madamuditamukhī vrajrapadmosudīptā vrahmāṇyāṣṭe patre	madhye trisāsana sthā mada mudita mukhī vrajra padma ūsu dīptā vrahmāṇī ā aṣṭe patre 
SA_MB_mahaalak-587	svaradikapraṇame śrīprayāgādīkṣetre |	svara dika praṇame śrī prayāga ādi kṣetre 
SA_MB_mahaalak-588	yuktāstā viṃśakonavasaṣasahasake vajraśṛge sphuranti sāṣṭāviṃśāti bhedā	yuktāḥ tāḥ viṃśaka ūnava saṣa sahasake vajra śṛge sphuranti sā aṣṭāviṃśā ati bhedā 
SA_MB_mahaalak-589	kramakulanugatāpā tu dvātriṃśavarṇāḥ ||	tu dvātriṃśa varṇāḥ 
SA_MB_mahaalak-590	p. 35a) khaḍgamvāmantrasiddhiṃ parapuravisanaṃ khegati rocanamvā śastrestambhaṃ	khaḍgam vā a mantra siddhim para pura visanam khegati rocanam vā 
SA_MB_mahaalak-591	ripurṇāṃcalipaliṭha jayaṃ staṃbhanaṃ sarvavidyā ||	jayam staṃbhanam sarva vidyā 
SA_MB_mahaalak-592	dīrghāyukṣaṃ cacitvaṃ nidhirasagutikā pādukā kāmasiddhi sarvānetrādadantu	dīrgha āyukṣam pādukā kāma siddhi 
SA_MB_mahaalak-593	alipisitaratā bhairave nānuraktā ||	a lipi sita ratā bhairave na anuraktā 
SA_MB_mahaalak-594	śyāmāraktā trinetrā stanabharaṇamitāmatta mātaṅgagāmi vimvoṣṭhī cārunetrā	śyāma āraktā tri netrā stana bharaṇa mita amatta mātaṅga gāmi cāru netrā 
SA_MB_mahaalak-595	pṛthutarajaghanā mekhalāratnasobhet ||	pṛthutara jaghanā 
SA_MB_mahaalak-596	devāṅge vastrasobhevaravarakumevarvare keśabhāresāme śrīkuvjikākhyā vitaratutara	deva aṅge śrī kuvjikā ākhyā 
SA_MB_mahaalak-597	sājñānadivyaughamogha ||	sa ajñāna divya ogha mogha 
SA_MB_mahaalak-598	p. 35b) utphullāmvujakarṇikoparigatā śrīsiddhilakṣmī parā karpūra sphaṭikendukundu	                     
SA_MB_mahaalak-599	dhavalā |	dhavalā 
SA_MB_mahaalak-600	niśeṣapāpopahā |	niśeṣa pāpa upahā 
SA_MB_mahaalak-601	saṃsārārṇavaduḥkhapaṃkadahanī niṣkaṃpanaṃ sarvadā śrīmatpañcamuṣāmvujā	saṃsāra arṇava duḥkha paṃka dahanī niṣkaṃpanam sarvadā śrīmat pañca muṣā amvujā 
SA_MB_mahaalak-602	daśabhujāpretasthitā pātuvaḥ ||	daśabhujā pretasthitā pātuvaḥ 
SA_MB_mahaalak-603	yāsāntakāgni kuharosthitibhāsvarūpāṃ somārkavahni tripathodalamadhye saṃsthā |	soma arka vahni saṃsthā 
SA_MB_mahaalak-604	ciccetarintaviṣayāṣya vilīnarūpāṃ svābhāvabhāvanti paramāṃ praṇamāmikālī ||	vilīna rūpām paramām 
SA_MB_mahaalak-605	aindrasaivasarāsanasyadadhatī madhyelalāṭe prabhāsau& klī& kāntimanuṣṇagaurī	aindra saiva sarāsanasya dadhatī madhye lalāṭe prabhā asau klī kānti manuṣṇa gaurī 
SA_MB_mahaalak-606	vasirasyātanvatī sarvataḥ |	vasirasya ātanvatī sarvatas 
SA_MB_mahaalak-607	p. 36a) eṣā sau tripurāhṛdi dvitirivoślāsosadādasthita |	eṣā sau tripurā hṛdi 
SA_MB_mahaalak-608	cchindyādva sahasāpadaistibhirūghaṃ jyotirmayīvāhnmayī ||	chindyāt vai sahasā padaiḥ tibhiḥ ūgham jyotiḥ mayī iva ahn mayī 
SA_MB_mahaalak-609	māyā kuṇḍalanīkriyā madhumatīkālīkalāmālinī mātaṅgīvijayājayā bhagavatīdevī	                                        
SA_MB_mahaalak-610	śivāśāmbhavī śaktiḥ karavallabhā trinayanivāgvādinī bhairavīhrī& kālitripurā	                              
SA_MB_mahaalak-611	parāparamayīmātā komālityasi ||	parāpara mayī mātā komālitī asi 
SA_MB_mahaalak-612	mahālakṣmīmahādevī saubhāgye surasundarī ||	           
SA_MB_mahaalak-613	vaiduryapādukārūḍhā siṃhāsanopari sthitā ||	vaidurya pādukā ārūḍhā siṃhāsana upari sthitā 
SA_MB_mahaalak-614	p. 36b) caturbhujāṃ viśālākṣī kaḍgapheṭaka dhāriṇī |	catur bhujām viśāla akṣī kaḍga pheṭaka dhāriṇī 
SA_MB_mahaalak-615	nūpurahārakeyūrā ratnakuṇḍaladhāriṇī ||	nūpura hāra keyūrā ratna kuṇḍala dhāriṇī 
SA_MB_mahaalak-616	ratnotkhacitasarvāṅgī cūḍāmaṇi vibhūṣitā |	ratna utkhacita sarva aṅgī cūḍāmaṇi vibhūṣitā 
SA_MB_mahaalak-617	vicitrapuṣparatnañca vastragandhānu lepinī ||	vicitra puṣpa ratnam ca vastra gandha anu lepinī 
SA_MB_mahaalak-618	trailokyevyāpinīdevī sarvasthaṃ sacarācaraṃ ||	          
SA_MB_mahaalak-619	siddhigandharvanamitā vidyādharasurārcitā ||	siddhi gandharva namitā vidyādhara sura arcitā 
SA_MB_mahaalak-620	devīkoṭe mahāplakṣaṃ saṃhārāṣṭa kulakramaṃ |	devīkoṭe mahāplakṣam saṃhāra aṣṭa kulakramam 
SA_MB_mahaalak-621	īśānapīthasaṃsthāya mahālakṣmī namostute ||	īśāna pītha saṃsthāya mahā lakṣmī namaḥ stute 
SA_MB_mahaalak-622	saundaryasārarūcirāṃ kamalāyatākṣīṃ pīnastanī lalitahārasu śobhamānā |	saundarya sāra rūcirām kamala āyata akṣīm pīna stanī lalita hāra su śobhamānā 
SA_MB_mahaalak-623	khaḍgatriśūlavaradābhaya pāṇirūpāṃ lakṣmīṃ namāmiśirasā mahanīñcamurtiṃ ||	khaḍga triśūla vara da abhaya pāṇi rūpām lakṣmīm namāmi śirasā 
SA_MB_mahaalak-624	p. 37a) jathāvāṇaprahārāṇāṃ kavacaṃ bhavatu vāraṇaṃ tadvadevavidhātrānāṃ	jathā vāṇa prahārāṇām kavacam bhavatu vāraṇam tadvat deva vidhātrānām 
SA_MB_mahaalak-625	śāntibhavatuvāranaṃ ||	śānti bhavatu vāranam 
SA_MB_mahaalak-626	svasthānakṣetrapālāya vrahmāṇyādi aśitāṅgamahābhairava sahitāyagaṇavaṭu tu	sva sthāna kṣetrapālāya vrahmāṇī ādi aśita aṅga mahābhairava sahitāya gaṇa vaṭu tu 
SA_MB_mahaalak-627	yoginī kṣetrapālāsāṅgālāya sagaṇasyarivārāya digavidigi indrādilokapālāya	yoginī diś avidigi indra ādi lokapālāya 
SA_MB_mahaalak-628	suprītāvaradābhavantu ||	su prītā avara dāḥ bhavantu 
SA_MB_mahaalak-629	yajamānasya sagaṇasyarivārāṇāṃ  āyurārogyamaiśvaryā janadhanalakṣmī	yajamānasya sa gaṇasya arivārāṇām āyuḥ ārogyam aiśvaryā jana dhana lakṣmī 
SA_MB_mahaalak-630	santatisantānavṛddhirastu yathā śāstrotraphalavaradāyano bhavantu ||	santati santāna vṛddhiḥ astu yathā bhavantu 
SA_MB_mahaalak-631	anyatrasaraṇaṃ nāstitvamevaśaraṇaṃ mamaḥ tasmāt kāruṇya bhāvena rakṣarakṣa	anyatra saraṇam nāstitvam eva śaraṇam mamaḥ tasmāt kāruṇya bhāvena rakṣa rakṣa 
SA_MB_mahaalak-632	parameśvarī || gvayadakṣiṇā || namaskā || tarpaṇa || prītipretā ||	           
SA_MB_mahaalak-633	p. 37b) mahādīpadadyakeyā vidhiḥ || hvathukohnu ṛlusiyāya || ekabhaktayāya || saṃti	vidhiḥ saṃti 
SA_MB_mahaalak-634	ācāryayā ṛlusiyāya || vastrahere || yajamānasucī vastrahere || pūjāju 1	ācārya yā vastra here 
SA_MB_mahaalak-635	paṃcopacālajorana || sūryakāntisavyāḍhāmataṃ dayake || paripu 1 garbhataya ||	dayake 
SA_MB_mahaalak-636	hyāḍhuakṣata gautraḍhā 5 || paṃcaratna luḍhohomuti gharāvanaputra || lepanayāvāsala ||	gautraḍhā  paṃcaratna 
SA_MB_mahaalak-637	nāsāka aguḍikapurakasturikāthapale śrīkhaṇḍaraktacandanagāthavanaphūlakuṃkuma ||	śrīkhaṇḍa rakta candana gātha vana phūla kuṃkuma 
SA_MB_mahaalak-638	śvateniyāvapaṃcaratnahyāḍhu akṣatagva 5 ||	akṣatagva 
SA_MB_mahaalak-639	mahādīpayācosatayā vatāle ||	vatāle 
SA_MB_mahaalak-640	p. 38a) vethānethe || mivakothetule || mahādīpayolakṣaṇa || yajamānayājavalāhātana ||	vetha anethe  miva kotha itule mahā dīpa yos lakṣaṇa 
SA_MB_mahaalak-641	mahādīpayātalasa || mla 1 hyāḍhu akṣata || lukṣakotatayāvapotraceyāvataya || kṣetrā	mahādīpayātalasa mla kṣetrā 
SA_MB_mahaalak-642	itātrapu 4 ghe lasavulāvataya || valiyāta || bhujāvanagva 1 || nyalāne utaśca 1 || khālapāta	itātrapu ghe valiyāta                  
SA_MB_mahaalak-643	10 || ne utapu 10 || naivedyamāla || kuśahāmala || ācārya || yajamāna nehyaṃ pūjāvane ||	naivedya mālaiḥ kuśa hā amalaiḥ ācāryaiḥ yajamānaiḥ nehyam pūjā vane 
SA_MB_mahaalak-644	devayā anukramana pūjādyāya || dhūpadīpa || jāpa || stotra || aṣṭapatrapadmacoyāva ||	deva yā anukramana pūjā ādyāya dhūpa dīpa jāpa stotra 
SA_MB_mahaalak-645	khāśitaya || khāśiḍhoyake khālapāta 10 ||	khāśitaye 
SA_MB_mahaalak-646	p. 38b) pātacchi vali || aghapātrahvavanetaya || mahādīpa pūjāyāye || tritatve nācamya | oṃ	pātacchi vali  mahādīpa pūjāyāye  na ācamya om 
SA_MB_mahaalak-647	hrā& ātmatatvāya svāhā | oṃ hrī& vidyātatvāya svāhā | oṃ hrū& śivatatvāya svāhā ||	hrāḥ ātma tatvāya svāhā  om hrī vidyā tatvāya svāhā  om hrū śiva tatvāya svāhā 
SA_MB_mahaalak-648	gurunamaskāra ||	guru namaskāra 
SA_MB_mahaalak-649	ai& 5 akhaṇḍamaṇḍalākāraṃ vyāptaṃ yena carācaraṃ |	akhaṇḍa maṇḍala ākāram vyāptam yena carācaram 
SA_MB_mahaalak-650	tatpadaṃ darśitaṃ yena tasmai śrīguruve namaḥ ||	tad padam darśitam yena tasmai śrī guruve namaḥ 
SA_MB_mahaalak-651	gururvrahmāgururviṣṇu gurudevamaheśvaraṃ |	guruḥ vrahmā a guruḥ viṣṇu guru deva maheśvaram 
SA_MB_mahaalak-652	gurudeva jagatsarvaṃ tasmai śrīguruve namaḥ ||	guru deva jagat sarvam tasmai śrī guruve namaḥ 
SA_MB_mahaalak-653	5 paramagurūbhyo namaḥ || 5 parameṣṭhi gurubhyonamaḥ || 5 paramācārya	parama gurubhyaḥ namaḥ parameṣṭhi gurubhyaḥ namaḥ parama ācārya 
SA_MB_mahaalak-654	gurubhyonamaḥ || śrīādideva pādukāṃ ||	gurubhyaḥ namaḥ śrī ādideva pādukām 
SA_MB_mahaalak-655	p. 39a) padmāsanāya pādukāṃ || kūrmāsanāya pādukāṃ || ātmāsanāya pādukāṃ	padmāsanāya pādukām kūrmāsanāya pādukām ātmāsanāya pādukām 
SA_MB_mahaalak-656	| oṃ hraḥ agnaya strāya phaṭ ||	om   agnaye strāya phaṭ 
SA_MB_mahaalak-657	ai& 5 hu& phaṭ vajrapañjale svāhā || calamakule kulamacale hrī& hra& phaṭ svāhā ||	ai hu phaṭ vajrapañjale svāhā calamakule kulamacale hrī hra phaṭ svāhā 
SA_MB_mahaalak-658	nyāsa | oṃ hraḥ agni astrāya phaṭ || kalaśodhanaṃ |	nyāsa om hraḥ agni astrāya phaṭ kalaśodhanam 
SA_MB_mahaalak-659	oṃ hrā& agnayakaniṣṭhikāya namaḥ | oṃ hrā& agnaye anāmikāya namaḥ |	om hrāḥ agnaye akaniṣṭhikāya namaḥ om hrāḥ agnaye anāmikāya namaḥ 
SA_MB_mahaalak-660	oṃ hrā& agnayamadhyemāya namaḥ | oṃ hrā& agnayetarjanyāya namaḥ |	om hrāḥ namaḥ om hrāḥ agnaye tarjanyāya namaḥ 
SA_MB_mahaalak-661	oṃ hrā& agnaye aṃguṣṭhāya namaḥ | oṃ hrā& agnaya astrāya phaṭ ||	om hrāḥ agnaye aṃguṣṭhāya namaḥ om hrāḥ agnaye astrāya phaṭ 
SA_MB_mahaalak-662	iti karaṃ nyāsaḥ || oṃ hrā& agnaye hṛdayāya namaḥ ||	iti karam nyāsaḥ om hrāḥ agnaye hṛdayāya namaḥ 
SA_MB_mahaalak-663	p. 39b) oṃ hrā& agnayeśirase svāhā || oṃ hrā& agnayeśikhāyai vauṣaṭ ||	om hrāḥ agnaye śirase svāhā om hrāḥ agnaye śikhāyai vauṣaṭ 
SA_MB_mahaalak-664	oṃ hrā& agnaye kavacāya hūṃ || oṃ hrā& agnaye netra trayāya vaṣaṭ ||	om hrāḥ agnaye kavacāya hūm om hrāḥ agnaye netra trayāya vaṣaṭ 
SA_MB_mahaalak-665	oṃ hrā& agnaye astrāya phaṭ || ityaṃga nyāsaḥ || jalapātra pūjā ||	om hrā agnaye astrāya phaṭ iti aṃga nyāsaḥ jalapātra pūjā 
SA_MB_mahaalak-666	ai& 5 jalapātrāsanāya pādukāṃ ||	ai jala pātra āsanāya pādukām 
SA_MB_mahaalak-667	ai& 5 hrā& hmkṣmlvryū& ānandaśaktibhairavānanda vīrādhipataye śkṣmlvryī& śrī	ai hrā hm kṣml vryū ānanda śakti bhairava ānanda vīra adhipataye śkṣml vryī śrī 
SA_MB_mahaalak-668	jalapātra bhaṭṭārikāya pādukāṃ ||	jala pātra bhaṭṭārikāya pādukām 
SA_MB_mahaalak-669	ṣaḍaṅga || oṃ hrā& agnaye hṛdayāya namaḥ || oṃ hrā& agnaye śirase svāhā ||	om hrāḥ agnaye hṛdayāya namaḥ om hrāḥ agnaye śirase svāhā 
SA_MB_mahaalak-670	oṃ hrā& agnaye śirase svāhā || oṃ hrā& agnayekavacāya hūṃ ||	om hrāḥ agnaye śirase svāhā om hrāḥ agnaye kavacāya hūm 
SA_MB_mahaalak-671	p. 40a)  oṃ hrā& agnayenetratrayāya vaṣaṭ || oṃ hrā& agnaye astrāya phaṭ || āvāhanādi ||	om   agnaye netratrayāya vaṣaṭ om   agnaye astrāya phaṭ āvāhana ādi 
SA_MB_mahaalak-672	dhenumudrāṃ || gāyatrī || oṃ vahnirūpāya vidmahehutāsanāya dhīmahetannovahni	dhenumudrām gāyatrī om vahni rūpāya vidmahe huta āsanāya dhīmahe tat naḥ vahni 
SA_MB_mahaalak-673	pracodayāt ||	pracodayāt 
SA_MB_mahaalak-674	iti jalapātra pūjā || arghapātra pūjā ||	iti jalapātra pūjā arghapātra pūjā 
SA_MB_mahaalak-675	ai& hrā& arghapātrāsanāya pādukāṃ ||	ai hrāḥ arghapātra āsanāya pādukām 
SA_MB_mahaalak-676	ai& 5 hrā& hrī& hrū& hraḥ prasphura 2 ghora 2 taratanu 2 rūpacaṭa 2 pracata 2 kaha 2 vama 2	ai hrā hrī hrū hraḥ prasphura ghora taratanu rūpacaṭaiḥ pracataiḥ vama 
SA_MB_mahaalak-677	dama 2 ghātaya 2 vighātaya 2 vighni 2 hū& 3 phaṭ kro& śrīmahākomārikā vicce	dama ghātaya vighātaya vighni hū phaṭ kro śrī mahākomārikā vicce 
SA_MB_mahaalak-678	pādukāṃ ||	pādukām 
SA_MB_mahaalak-679	ai& 5 śkṣmlvryī& ānandaśakti bhairavānanda śrīmahāvidyārājeśvarī hskṣmlvryū& śrī	ai ānanda śakti bhairava ānanda śrī mahāvidyā rāja īśvarā śrī 
SA_MB_mahaalak-680	arghapātrabhaṭṭārikāyai pādukāṃ ||	arghapātra bhaṭṭārikāyai pādukām 
SA_MB_mahaalak-681	p. 40b) oṃ hrā& agnaye hṛdayāya namaḥ || oṃ hrā& agnaye śirase svāhā || oṃ hrā&	om hrāḥ agnaye hṛdayāya namaḥ om hrāḥ agnaye śirase svāhā om hrāḥ 
SA_MB_mahaalak-682	agnayeśikhāya vauṣaṭ || oṃ hrā& agnaye kavacāya hūṃ || oṃ hrā& agnaye netratrayāya	agnayeśikhāya vauṣaṭ om   agnaye kavacāya    om   agnaye netratrayāya 
SA_MB_mahaalak-683	vaṣaṭ || oṃ hrā& agnaye astrāya phaṭ || āvāhanādi || yonimudrāṃ || bhūtaśuddhi ||	vaṣaṭ om   agnaye astrāya phaṭ āvāhana ādi yonimudrām bhūtaśuddhi 
SA_MB_mahaalak-684	ai& hrī& śrī& hsphre& hskau& hskau& hsphre& śrī& hrī& ai& || ātmapūjā ||	ai hrī śrī hsphre hskau hskau hsphre śrī hrī ai ātma pūjā 
SA_MB_mahaalak-685	ai& candanaṃ pādukāṃ || hrī& akṣataṃ pādukāṃ || śrī& vīrabhasma pādukāṃ || hsphre&	ai candanam pādukām hrī akṣatam pādukām śrī vīra bhasma pādukām 
SA_MB_mahaalak-686	sarvajanamohonī pādukāṃ || hskau& nānācchatra alaṃkāla puṣpaṃ pādukāṃ || ai&	pādukām nānā chatra alaṃkāla puṣpam pādukām 
SA_MB_mahaalak-687	kusau& pādukāṃ || 3 ||	kusau pādukām 
SA_MB_mahaalak-688	p. 41a) pūrvādi īśānāntaṃ khāśiḍhova pūjā || indrādi || indrāya namaḥ || agnaye	pūrva ādi īśāna antam pūjā indra ādi indrāya namaḥ agnaye 
SA_MB_mahaalak-689	namaḥ || umāya namaḥ || nai ṛtyāya namaḥ || varuṇāya namaḥ || vāyuve namaḥ ||	namaḥ umāya namaḥ nai ṛtyāya namaḥ varuṇāya namaḥ vāyuve namaḥ 
SA_MB_mahaalak-690	kuvalāya namaḥ || īśānāya namaḥ || anantāya namaḥ || vrahmaṇe namaḥ || śvatenaṃ vali	kuvalāya namaḥ īśānāya namaḥ anantāya namaḥ vrahmaṇe namaḥ 
SA_MB_mahaalak-691	|| hetukādi || hrā& hetuka bhairavāya namaḥ || hrā& tripurāntaka bhairavāya namaḥ || hrā&	hetuka ādi hrā hetuka bhairavāya namaḥ hrā tripurāntaka bhairavāya namaḥ hrā 
SA_MB_mahaalak-692	agnivetāla bhairavāya namaḥ || hrā& agnijihvā bhairavāya namaḥ || hrā& kārākhye	agni vetāla bhairavāya namaḥ   agni jihvā bhairavāya namaḥ   kārā ākhye 
SA_MB_mahaalak-693	bhairavāya namaḥ || hrā& karālina bhairavāya namaḥ || hrā& ekapāda bhairavāya namaḥ ||	bhairavāya namaḥ   karālina bhairavāya namaḥ   ekapāda bhairavāya namaḥ 
SA_MB_mahaalak-694	p. 41b) hrī& bhīmarūpabhairavāya namaḥ || hrā& hāṭakabhairavāya namaḥ || hrā&	             
SA_MB_mahaalak-695	gagaṇabhairavāya namaḥ || śvatenaṃ valiḥ || vrahmāṇyādi || aṃ vrahmāyaṇī	gagaṇa bhairavāya namaḥ valiḥ vrahmāṇī ādi aṃ vrahmāyaṇī 
SA_MB_mahaalak-696	pādukāṃ || kaṃ māheśvarīpādukāṃ || ca& komārīpādukāṃ || ṭa&	pādukām kam māheśvarī pādukām ca komārī pādukām ṭa 
SA_MB_mahaalak-697	vaiṣṇavīpādukāṃ || taṃ vārāhīpādukāṃ || pa& indrāyaṇīpādukāṃ || yaṃ	vaiṣṇavī pādukām tam vārāhī pādukām indrāyaṇī pādukām yam 
SA_MB_mahaalak-698	cāmuṇḍāya pādukāṃ || śa& mahālakṣmīpādukāṃ || śvatenaṃ valiḥ ||	cāmuṇḍāya pādukām mahālakṣmī pādukām valiḥ 
SA_MB_mahaalak-699	mahādīpaśodharapa || nirikṣaṇādi || rā rī rū& rmlvryū& vahnimūrtaye namaḥ ||	nirikṣaṇa ādi rā rī rū vahni mūrtaye namaḥ 
SA_MB_mahaalak-700	nirikṣaṇā || oṃ hraḥ astrāya phaṭ || prokṣaṇa || oṃ hra& agnaya astrāya phaṭ || tāḍana ||	nirikṣaṇā om hraḥ astrāya phaṭ prokṣaṇa om hra agnaye astrāya phaṭ tāḍana 
SA_MB_mahaalak-701	p. 42a) oṃ hre& kavacāya hūṃ || avaguṇṭhanaṃ || śvate catusaṃskāra || punaḥ	om hre kavacāya hūm avaguṇṭhanam punar 
SA_MB_mahaalak-702	tritatvenaśodharape || kuśena pṛṣṭvātribhāga || aphrā& ātmatatvāya vrahmaṇe namaḥ ||	kuśena vrahmaṇe namaḥ 
SA_MB_mahaalak-703	pārasa || śrī& vidyātatvāya namaḥ || madhyasa || śrū& śivatatvāya rudrāya namaḥ || cosu	namaḥ madhyasa śrū śiva tatvāya rudrāya namaḥ 
SA_MB_mahaalak-704	|| śvat dhunaḍhāva || cosagholaghaḍā itāḍa pepo 4 catupathayāḍhataya ||	śvat dhunaḍhāva cosagholaghaḍā itāḍa pepo 
SA_MB_mahaalak-705	nebhāravimavivelasavyāya || sūryakānti savyāḍhāmataṃkāyāva yajamāna na	sūryakānti yajamāna na 
SA_MB_mahaalak-706	mahādīpa vyāpake || svativācana paṭhet || svasti kuryāt sadāvighni svasti mārtaṇḍameva	mahā dīpa vyāpake svativācana paṭhet svasti kuryāt sadā avighni svasti mārtaṇḍam eva 
SA_MB_mahaalak-707	ca ||	ca 
SA_MB_mahaalak-708	p. 42b) yoginī svasti sarvāśca svasti pīṭhā svakṣatrakā ||	yoginī svasti sarvāḥ ca svasti pīṭhā svakṣatrakā 
SA_MB_mahaalak-709	pūrvaṃ dakṣiṇa paścāt ruttaroddhastarathāsvistiṣaṭkā gamasthāstu guptā prakaṭa	guptā 
SA_MB_mahaalak-710	devatā ||	devatā 
SA_MB_mahaalak-711	bhairavī bhairavośāṅgā svastiṃ sva svaḥ svacakrakā |	                
SA_MB_mahaalak-712	svamantāśca svamudrāśca svāyudhā parivārikā ||	sva mantāḥ ca sva mudrāḥ ca sva āyudhā parivārikā 
SA_MB_mahaalak-713	grahanakṣatrarāsisthā svastiṃ sarvasamastaya |	svastim 
SA_MB_mahaalak-714	svasti devādideveśa mantrarājo nirantaraṃ ||	svasti deva ādideva īśa mantrarājaḥ nirantaram 
SA_MB_mahaalak-715	havyaparālitṛptāśca svastiṃ kulāgnidevatā |	havya para ali tṛptāḥ ca svastim kula agni devatā 
SA_MB_mahaalak-716	svasti rājā prajānāṃ ca yajamānāṃ svasti sarvadā ||	svasti rājā prajānām ca yajamānām svasti sarvadā 
SA_MB_mahaalak-717	ācāryasyaṃ mahādīpa pūjāyāya ||	ācāryasyam mahādīpa 
SA_MB_mahaalak-718	oṃ vahnirūpāya vidmahe hutāsanāya dhīmahe tanno vahni pracodayāt ||	om vahni rūpāya vidmahe hutāsanāya dhīmahe tat naḥ vahni pracodayāt 
SA_MB_mahaalak-719	p. 43a) prokṣaṇācandanādi pūjanaṃ ||	prokṣaṇa ācandana ādi pūjanam 
SA_MB_mahaalak-720	oṃ ra& kṣa& jvālinī namaḥ || 1 || oṃ rudhrumāyai namaḥ || 2 ||	om ra kṣa jvālinī namaḥ   om rudhrumāyai namaḥ 
SA_MB_mahaalak-721	oṃ raṃkākapilāya namaḥ || 3 || oṃ rā& vāvisphuriṃginī namaḥ || 4 ||	om raṃkākapilāya namaḥ   om rā vā visphuriṃginī namaḥ 
SA_MB_mahaalak-722	oṃ rā& nāyai namaḥ || 5 || oṃ vicikrikravyādāyai namaḥ || 6 ||	om rā nāyai namaḥ   om vicikrikravyādāyai namaḥ 
SA_MB_mahaalak-723	oṃ ru& raktāyai namaḥ || 7 || oṃ re& ā arcitāyai namaḥ || 8 ||	om ru raktāyai namaḥ   om re ā arcitāyai namaḥ 
SA_MB_mahaalak-724	pūrvādi īśānāntaṃ pūjyā || triyāñjali || oṃ rā& rī& rū& rmlvryū& vahnimūrtaye	pūrva ādi īśāna antam pūjyā triyā añjali om rā rī rū vahni mūrtaye 
SA_MB_mahaalak-725	namaḥ || 3 || oṃ hrā& agnayahṛdayāya namaḥ || oṃ hrā& agnayeśirase svāhā || oṃ hrā&	namaḥ   om hrāḥ agnaye hṛdayāya namaḥ om hrāḥ agnaye śirase svāhā om hrāḥ 
SA_MB_mahaalak-726	agnayeśirase svāhā || oṃ hrā& agnaye śikhāya vauṣaṭ ||	agnayeśirase svāhā om hrāḥ agnaye śikhāya vauṣaṭ 
SA_MB_mahaalak-727	p. 43b) oṃ hrā& agnaye kavacāya hūṃ || oṃ hrā& agnayenetratrayā vaṣaṭ || oṃ hrā& agnaye	om   agnaye kavacāya   om   agnaye netratrayā vaṣaṭ  om   agnaye 
SA_MB_mahaalak-728	strāya phaṭ || ṣaḍaṃgena saṃpūjya || vali || āvāhanādi yonimudrā || tvāka mahāvali ||	strāya phaṭ ṣaḍaṃgena saṃpūjya vali āvāhana ādi yonimudrā tvāka mahāvali 
SA_MB_mahaalak-729	5 kṣā& kṣī& kṣū& kṣaḥ kṣetrapālāya valiṃ gṛhna 2 svāhā ||	kṣā kṣī kṣū kṣaḥ kṣetrapālāya valim gṛhna svāhā 
SA_MB_mahaalak-730	śrī& hrī& kulaputra vaṭukanāthāya valiṃ gṛhna 2 svāhā ||	śrī hrī kula putra vaṭuka nāthāya valim gṛhna svāhā 
SA_MB_mahaalak-731	gā& gī& gū& gaḥ glau& śrīkulagaṇeśvarāya valiṃ gṛhna 2 svāhā ||	gā gī gū gaḥ glau śrī kula gaṇa īśvarāya valim gṛhna svāhā 
SA_MB_mahaalak-732	hūṃ mahākanavāra śmaśānādhipataye valiṃ gṛhna 2 svāhā ||	hūm mahākanavāra śmaśāna adhipataye valim gṛhna svāhā 
SA_MB_mahaalak-733	hskhphre& śrīsiddhicāmuṇḍāyavaliṃ gṛhna 2 svāhā ||	śrī siddhicāmuṇḍāya valim gṛhna svāhā 
SA_MB_mahaalak-734	ākāśa cāriṇī savargebhyo valiṃ gṛhna 2 svāhā ||	ākāśa cāriṇī savargebhyaḥ valim gṛhna svāhā 
SA_MB_mahaalak-735	p. 44a) sarvebhyo bhūtebhyopi śācebhyaḥ sarvebhyaḥ iṣṭadevatābhyo valiṃ gṛhna 2	sarvebhyaḥ bhūtebhyaḥ api śācebhyaḥ sarvebhyaḥ iṣṭadevatābhyaḥ valim gṛhna 
SA_MB_mahaalak-736	svāhā || āvāhanādi || yonimudrāṃ darśayet || vindutriya 3 || dhūpa ||	svāhā āvāhana ādi yonimudrām darśayet 
SA_MB_mahaalak-737	divyagandhasamāyuktaṃ sarvadevopiyoruhā |	divya gandha samāyuktam 
SA_MB_mahaalak-738	āghrānaṃ sarvadevānāṃ dhūpāyaṃ prati gṛhyatāṃ ||	āghrānam sarva devānām dhūpāyam prati gṛhyatām 
SA_MB_mahaalak-739	dhupāhāreṣu bhagavān viśvarūpī maheśvarī |	bhagavān viśva rūpī maheśvarī 
SA_MB_mahaalak-740	dhūpanānena deveśisuprītāṃ parameśvarī || dīpa ||	dhūpana anena deveśi su prītām parameśvarī 
SA_MB_mahaalak-741	suprakāśomahāteja sarvatastimināpahaṃ |	su prakāśa umahā teja sarvatas timinā apaham 
SA_MB_mahaalak-742	śavāhyābhyantaraṃ jyoti dīpoyaṃ pratigṛhyatāṃ || jyotirdaśyāmi ||	śavāhya abhyantaram jyoti dīpaḥ yam pratigṛhyatām jyotiḥ daśyāmi 
SA_MB_mahaalak-743	p. 44b) naivedya || annaṃ mahārasaṃ divyaṃ masekhabhisamanvitaṃ |	naivedya annam mahārasam divyam 
SA_MB_mahaalak-744	mayāniveditaṃ bhaktyā gṛhāṇa parameśvarī ||	mayā a niveditam bhaktyā gṛhāṇa parameśvarī 
SA_MB_mahaalak-745	naivedyaṃ gṛhyatāṃ devī bhaktime acarāṃ kuru |	naivedyam gṛhyatām devī bhakti me acarām kuru 
SA_MB_mahaalak-746	phalapuṣpatāmbūla dhūpadīpa idaṃ naivedyaṃ namaḥ || jāpa ||	phala puṣpa tāmbūla dhūpa dīpa idam naivedyam namaḥ jāpa 
SA_MB_mahaalak-747	rmlvryū& svāhā 54 || maṇḍaladayake || kevākavoya || stotra ||	svāhā maṇḍaladayake stotra 
SA_MB_mahaalak-748	suprakāso mahāteja sarvatastimirāpahaṃ |	su prakāsaḥ mahā teja sarvatas timira apaham 
SA_MB_mahaalak-749	savāhyābhyantaraṃ dīpaṃ tejarūpaṃ namostute || atragandhādi || pratiṣṭhā ||	sa vāhya abhyantaram dīpam teja rūpam namaḥ stute te atra gandha ādi pratiṣṭhā 
SA_MB_mahaalak-750	pratiṣṭhitosi devatvaṃ supratiṣṭhā tu vanatrayaṃ |	pratiṣṭhitaḥ asi deva tvam supratiṣṭhā tu vana trayam 
SA_MB_mahaalak-751	p. 45a) sānnidhyaṃ pratigṛhnāni yajamānādi vṛrddhaye |	sānnidhyam pratigṛhnāni yajamāna ādi vṛrddhaye 
SA_MB_mahaalak-752	sannostu dvipadenityaṃ sannorādya tathaiva ca |	sannoḥ tu tathā eva ca 
SA_MB_mahaalak-753	yajamāna saṃbhūtoyaṃ suputra paṇḍavāndhavaḥ ||	yajamāna saṃbhūtaḥ ayam su putra paṇḍava andhavaḥ 
SA_MB_mahaalak-754	rakṣatvaṃ sarvakāleṣudeśa na bhairava namostute ||	rakṣatvam sarva kāla iṣu deśa na bhairava namaḥ stute 
SA_MB_mahaalak-755	kuśahāmaravāyā vāghāsana yajamāna na joḍhā ca mahādīpathisyaṃ taye || vākya ||	kuśa ha amaravāyāḥ vāghāsana yajamāna na joḍhā ca taye 
SA_MB_mahaalak-756	adyavārāhaklpetyādi || rāsenakṣatra ||	adya vārāha klpa ityādi 
SA_MB_mahaalak-757	sūryānta modayaṃ yāvattāvatkāla mayāprabho |	sūrya anta mā udayam yāvat tāvatkāla mayā aprabho 
SA_MB_mahaalak-758	devadevyo svaprītyarthaṃ mahādīpa prajvālitaṃ ||	sva prīti artham mahā dīpa prajvālitam 
SA_MB_mahaalak-759	dīpadānanavedeva karotu mama śāntikaṃ |	karotu mama śāntikam 
SA_MB_mahaalak-760	āyurārogya maiśvarya lakṣmī santāna varddhanaṃ ||	āyuḥ ārogya maiśvarya lakṣmī santāna varddhanam 
SA_MB_mahaalak-761	p. 45b) mānavagotra yajamāna śrī śrījaya rūpatīndramalla devasya śrīmahālakṣmī	                
SA_MB_mahaalak-762	devyai prītyarthaṃ mahādīpadāna mahaṃ saṃpradattaṃ ||	devyai prīti artham mahā dīpa dāna maham saṃpradattam 
SA_MB_mahaalak-763	anena dānena yathā śāstotra phalavaradāyino bhavantu || dakṣiṇa || tarpaṇa || dāḍhā	anena dānena yathā phala vara dāyinaḥ bhavantu dakṣiṇa tarpaṇa dāḍhā 
SA_MB_mahaalak-764	vāḍhā ca || devayāhva vanecopi pūjāyāya || laṃkhanarūpiṇire || candanādiyāyaṃ ||	ca 
SA_MB_mahaalak-765	nyāsaḥ || kartikāya astrāya phaṭ || kartikāya kaniṣṭhāyaya namaḥ || kārtikāya	nyāsaḥ kartikāya astrāya phaṭ kartikāya namaḥ kārtikāya 
SA_MB_mahaalak-766	anāmikāya svāhā || kārtikāya madhyemāya vauṣaṭ || kārtikāya tarjanyāya hūṃ ||	anāmikāya svāhā kārtikāya madhyemāya vauṣaṭ kārtikāya tarjanyāya hūm 
SA_MB_mahaalak-767	p. 46a) kārtikāya aṃguṣṭhāya vaṣaṭ || kārtikāya astrāya phaṭ || kārtikāya hṛdayāya	kārtikāya aṃguṣṭhāya vaṣaṭ kārtikāya astrāya phaṭ kārtikāya hṛdayāya 
SA_MB_mahaalak-768	namaḥ || kārtikāya śrirase svāhā || kārtikāya śikhāyai vauṣaṭ || kārtikāya kavacāya	namaḥ kārtikāya śrirase svāhā kārtikāya śikhāyai vauṣaṭ kārtikāya kavacāya 
SA_MB_mahaalak-769	huṃ || kārtikāyane etrayāya vaṣaṭ || kārtikāya astrāya phaṭ || pūjanaṃ || ai& 5 kālī	hum kārtikāyane etrayāya vaṣaṭ kārtikāya astrāya phaṭ pūjanam ai kālī 
SA_MB_mahaalak-770	vajreśvarī lohanandāya namaḥ || 3 || hṛdayādi || stotra || khaḍgāyakhalunāya śaktiḥ	vajreśvarī lohanandāya namaḥ   hṛdaya ādi stotra śaktiḥ 
SA_MB_mahaalak-771	kāryāya tatparaṃ | paśucchedatvayā śrīgraṃ khaḍganāthaṃ namostute || atragandhādi ||	kāryāya tat param paśu cheda tvayā khaḍganātham namaḥ stute 
SA_MB_mahaalak-772	iti vupī pūjā || athapaśujāga || dvandune utaya ||	iti pūjā  dvandune 
SA_MB_mahaalak-773	p. 46b) evāyakte || hraḥ astrāya phaṭ || nivaṃcchana || ai& 5 kiṇi 2 vicce koṅkaṇāyai hraḥ	eva ayakte   astrāya phaṭ nivaṃcchana ai kiṇi vicce koṅkaṇāyai hraḥ 
SA_MB_mahaalak-774	astrāya phaṭ || 3 || valiviya || bhūtāya vividhā kālābhūdivyānta rikṣagā | pātāletare	astrāya phaṭ bhūtāya vividhā 
SA_MB_mahaalak-775	vāsinyā tenasyantu śivājñeyā || valisamatāvi ca || suprakāśa mahāteja	śivā ajñeyāḥ ca su prakāśa mahā teja 
SA_MB_mahaalak-776	sarvatastimirāpahaṃ | sarvādyā bhyaṃtaraṃ jyotidīpoyaṃ pratigṛhyatāṃ ||	sarvatas timira apaham sarva ādi abhyaṃtaram jyoti dīpaḥ yam pratigṛhyatām 
SA_MB_mahaalak-777	jyotirdaśyāmi || valicchoya || duggulaṃ khanahāya || ūkāraṃ vāyuvījaṃ tadupari	duggulam khana hāya ūkāram vāyuvījam tad upari 
SA_MB_mahaalak-778	paramaṃ vahnivīja sahasraṃ | induvindulayātaṃ sitakamalavaraṃ kṣīradhārā śravantaṃ	paramam sahasram sita kamala varam kṣīra dhārā śravantam 
SA_MB_mahaalak-779	dṛtvā kuṭaṃ tu nityaṃ dahati kulavarameru tulyāhi pāpaṃ ||	dṛtvā kuṭam tu nityam dahati pāpam 
SA_MB_mahaalak-780	p. 47a) ceta || śrīkhaṇḍacandanaṃ divyaṃ gandhādya sumanoharaṃ |	ceta śrīkhaṇḍa candanam divyam gandha adya su manoharam 
SA_MB_mahaalak-781	ābhūṣitaṃ lalātākṣa candanaṃ prati gṛhyatāṃ |	ābhūṣitam lalāta akṣa candanam prati gṛhyatām 
SA_MB_mahaalak-782	candanaṃ lepitaṃ puṣpaṃ pavitraṃ pāpa nāsanaṃ |	candanam lepitam puṣpam pavitram pāpa na āsanam 
SA_MB_mahaalak-783	āpadāhate nityaṃ lakṣmī rāje sadāni ca || siṃdhara ||	āpad āhate nityam lakṣmī rāje sadāni ca siṃdhara 
SA_MB_mahaalak-784	vīreśvarī mahāvīravīrabhasma vibhūṣitāṃ |	vīreśvarī mahāvīra vīra bhasma 
SA_MB_mahaalak-785	trailokyāṃ karṣaṇī devī siṃdūrāruṇa murtamaṃ || svāna ||	karṣaṇī devī siṃdūra aruṇa 
SA_MB_mahaalak-786	nānāpuṣpa sugandhāni mālatī kusumodayaṃ |	mālatī kusuma udayam 
SA_MB_mahaalak-787	saubhāgyaṃ siddhidaṃ bhadre puṣpārohaṇa mūrtamaṃ ||	saubhāgyam siddhi dam bhadre puṣpa ārohaṇa 
SA_MB_mahaalak-788	syākantaṃ yatāceta svānaviyā nyāsaḥ ||	syākantam svānaviyā nyāsaḥ 
SA_MB_mahaalak-789	p. 47b) sa& astrāya phaṭ || kalaśodharaṃ || 4 || mā& kaniṣṭhāya namaḥ || mī& anāmikāya	sa astrāya phaṭ kalaśodharam    mā kaniṣṭhāya namaḥ mī anāmikāya 
SA_MB_mahaalak-790	namaḥ || mū& madhyemāya namaḥ || mai& tarjanyāya namaḥ || mau& aṃguṣṭhāya namaḥ ||	namaḥ mū madhyemāya namaḥ mai tarjanyāya namaḥ mau aṃguṣṭhāya namaḥ 
SA_MB_mahaalak-791	maḥ astrāya phaṭ || mā& hṛdayāya namaḥ || mī& śirase svāhā || mū& śikhāya vauṣaṭ ||	maḥ astrāya phaṭ mā hṛdayāya namaḥ mī śirase svāhā mū śikhāya vauṣaṭ 
SA_MB_mahaalak-792	mai& kavacāya hu& || mau& netratrayāya namaḥ || maḥ astrāya phaṭ || pūjanaṃ || hrau&	mai kavacāya hu mau netratrayāya namaḥ maḥ astrāya phaṭ pūjanam hrau 
SA_MB_mahaalak-793	śāttyātitakalāya namaḥ || modasa || hrai& śāntikalāya namaḥ || nūśvaḍasa || hū&	namaḥ modasa hrai śānti kalāya namaḥ hū 
SA_MB_mahaalak-794	vidyākalāya namaḥ || techusa || hrī& pratiṣṭhā kayāya namaḥ || liṃgasa || hrā& nivṛrti	vidyākalāya namaḥ techusa hrī pratiṣṭhā kayāya namaḥ liṃgasa hrā nivṛrti 
SA_MB_mahaalak-795	kalāya namaḥ || cchugoḍasa || lomavilomana pūjā ||	kalāya namaḥ cchugoḍasa lomavilomana pūjā 
SA_MB_mahaalak-796	p. 48a) ṣaḍaṃgena pūjanaṃ || avahnasvarotejodrāva || gāyatrī ||	ṣaṣ aṅgena pūjanam gāyatrī 
SA_MB_mahaalak-797	u& paśupāśāya vidmahe viśvakarmāyadhī mahetanno jīva prayodayāt ||	u paśu pāśāya vidmahe mahā itat naḥ jīva 
SA_MB_mahaalak-798	vindunahāyāva dugusamayanake || kaṃgolalaṃ khajodvāvataya || adyādi || cānya ||	kaṃgolalam adya ādi 
SA_MB_mahaalak-799	paśuṃ gṛhnāsi devesi daśyayā upavācitaṃ |	paśum gṛhnāsi deva isi daśyayā upavācitam 
SA_MB_mahaalak-800	asyāpi svargasaṃprāpti māheśvarī prayacchame || mūhā nadvāvatyāvake |	asya api svarga saṃprāpti māheśvarī 
SA_MB_mahaalak-801	mahālakṣmī mahādevī saubhāgya surasundarī |	          
SA_MB_mahaalak-802	vaidurya pādukā rūḍhā siṃhāsano paristhitā ||	vaidurya pādukā rūḍhā 
SA_MB_mahaalak-803	caturbhujā viśālākṣī khaḍga pheṭaka dhāriṇī |	catur bhujā viśāla akṣī khaḍga pheṭaka dhāriṇī 
SA_MB_mahaalak-804	nupurahāra keyūrāratnakuṇḍala dhāriṇī |	        
SA_MB_mahaalak-805	p. 48b) ratnotkhacita sarvāṅgī cūḍāmaṇi vibhūṣitā ||	ratna utkhacita sarva aṅgā cūḍāmaṇi vibhūṣitā 
SA_MB_mahaalak-806	vicitrapuṣparatnañca vastragandhānu lepinī ||	vicitra puṣpa ratnam ca vastra gandha anu lepinī 
SA_MB_mahaalak-807	trailokya vyāpinī devī sarvasthaṃ sacarācaraṃ |	trailokya vyāpinī devī sarva stham sacarācaram 
SA_MB_mahaalak-808	siddhigandharva namitā vidyādhara surārcitā ||	siddhi gandharva namitā vidyādhara sura arcitā 
SA_MB_mahaalak-809	devīkoṭe mahāplakṣaṃ  saṃhārāṣṭa kulākramaṃ |	devīkoṭe mahāplakṣam saṃhāra aṣṭa kula ākramam 
SA_MB_mahaalak-810	īśānapīṭha saṃsthāya mahālakṣmī namostute || astra || arghapātra nahāya ||	īśānapīṭha saṃsthāya mahālakṣmī namostute astra arghapātra nahāya 
SA_MB_mahaalak-811	śiracchedana yācake || thamajodvāvahinati cakre || śiracchāya || iti paśujāṃga vidhiḥ ||	śiracchedana yācake cakre śiracchāya iti paśujāṃga vidhiḥ 
SA_MB_mahaalak-812	samayacchāya || hyutasamayaviya || samayajodvāva || tarpaṇa ||	tarpaṇa 
SA_MB_mahaalak-813	prītaḥ pretāsanacchā bhavatu viharaṇo bhairavā mantra mūrtiścaṇḍī caṇḍāsanasthā	prītaḥ preta āsana chā bhavatu viharaṇaḥ bhairavāḥ mantra mūrtiḥ caṇḍī caṇḍāsana sthā 
SA_MB_mahaalak-814	praṇati sphaṇiphalārlokapālā phaṇīndrāḥ |	praṇati phaṇi indrāḥ 
SA_MB_mahaalak-815	p. 49a) yakṣā ṛkṣāśva daityāḥ pibhṛgaṇa sahitā mātarāḥ kṣepālā yogi	yakṣāḥ ṛkṣāśva daityāḥ pibhṛgaṇa sahitāḥ mātarāḥ kṣepālāḥ yogi 
SA_MB_mahaalak-816	nyāryāgayuktā jalavalakhacalāḥ pānametat pivantu || pivantu devatāḥ sarveḥ	pānam etat pivantu pivantu devatāḥ 
SA_MB_mahaalak-817	sarudrāścaiva vināyakāḥ | yoginī kṣetrapālāśca  mamadehade vyavasthita || vindutraya 3	sa rudrāḥ ca eva vināyakāḥ yoginī kṣetrapālāḥ ca mama deha de vyavasthita vindu traya 
SA_MB_mahaalak-818	|| svānakokāyamate va || valiśvayaṃ mate va || kutiṃsvānakāyāva || yajamānastaṃ viya ||	valiśvayam mate va 
SA_MB_mahaalak-819	thavataṃ kāya || cacchi tu yakaṃ mahādīpa cchāyakaṃ taya || śvate	thavatam kāya tu yakam mahā dīpa chāyakam taya śvate 
SA_MB_mahaalak-820	mahādīpacchoyakekorurāvidhiḥ ||	          
SA_MB_mahaalak-821	p. 49b) santī kuhuyāsanānādi nityakarmamālakodhunake ||	nitya karma māla kodhunake 
SA_MB_mahaalak-822	mahādīpacchokathoyasasarāpā pūjāyāya dhūpadīpa jāpa ||	pūjā yāya dhūpa dīpa jāpa 
SA_MB_mahaalak-823	stotratāṃ dhātake || devadakṣiṇā || tarpaṇa 3 || svānakokāya || ekāmuttira nekadhā	deva dakṣiṇā tarpaṇa ekām uttira na ekadhā 
SA_MB_mahaalak-824	trijagatipūrṇeśvarī vāsavebhūteśī gagaṇopamā bhagavatinaiśeśvarī dakṣiṇe |	trijagatī pūrṇeśvarī gagaṇa upamā bhagavati naiśeśvarī dakṣiṇe 
SA_MB_mahaalak-825	sthānāgamya kujeśvarī kulagaṇevāruṇyadignāya || śrīvāmāṃ praṇamāmi	sthāna āgamya kuja īśvarī kula gaṇā iva aruṇya dignāya śrī vāmām praṇamāmi 
SA_MB_mahaalak-826	viśvajananī darśeśvarī siddhidāṃ || ācāryadakṣiṇā || vācanataya || mohonīkokāya ||	viśva jananī darśa īśvarā siddhi dām ācārya dakṣiṇā 
SA_MB_mahaalak-827	devasakecchāyāṃ || svātakokāyāvako ḍholasataya ||	devasaka icchāyām 
SA_MB_mahaalak-828	p. 50a) thamaṃsthūya || sva ātmaśirvādhā || anvepūrvaṃ gataṃ padaṃ bhagavati	anvepūrvam gatam padam bhagavati 
SA_MB_mahaalak-829	caitanyarūpāmiko | jñānacchāvahu tathā hariharau vrahmārīvitrayaṃ |	               
SA_MB_mahaalak-830	bhāsvabhairava paṃcakaṃ tadanuva śrīyoginī paṃcakaṃ candrāktau ca marīci	paṃcakam śrī yoginī paṃcakam candra aktau ca 
SA_MB_mahaalak-831	ṣaṭkavimalaṃ pā tu nityaṃ śrīkuja || vācanalaṃ khakāyāvataya || mohanītama ||	tu nityam śrī kuja 
SA_MB_mahaalak-832	yajamānādi mālakolaṃ khanahāya || ukāraṃ vāyuvījaṃ tadupariparamaṃ vahnivīja	yajamāna ādi mālakolam khana hāye ukāram vāyuvījam tad upari paramam vahnivīja 
SA_MB_mahaalak-833	sahasraṃ induṃvinduṃ layātaṃ sitakamalavaraṃ kṣīradhārā śravantaṃ dṛṣṭvā	sahasram induṃvindum layātam sita kamala varam kṣīra dhārā śravantam dṛṣṭvā 
SA_MB_mahaalak-834	kutaṃ tu nityaṃ dahati kulamalaṃ melutulyāhi pāpaṃ ||	kutam tu nityam dahati kula malam pāpam 
SA_MB_mahaalak-835	p. 50b) ceta || śrīkhaṇḍa candanaṃ divyaṃ gaṃdhādyasu manoharaṃ |	ceta śrīkhaṇḍa candanam divyam gandha ādya su manoharam 
SA_MB_mahaalak-836	ābhūṣitaṃ lalātākṣa candanaṃ pratigṛhyatāṃ ||	ābhūṣitam lalāta akṣa candanam pratigṛhyatām 
SA_MB_mahaalak-837	candanaṃ lepitaṃ puṇyaṃ pavitrapāpa nāsanaṃ |	candanam lepitam puṇyam pavitra pāpa na āsanam 
SA_MB_mahaalak-838	āpadāharate nityaṃ lakṣmīrājya sadāni ca || siṃdhava ||	āpadā āharate nityam lakṣmī rājya sadāni ca siṃdhava 
SA_MB_mahaalak-839	vīreśvarī mahāvīra vīrabhasma vibhūṣitaṃ |	vīreśvarī mahāvīra vīra bhasma vibhūṣitam 
SA_MB_mahaalak-840	trailokyāṃ karṣaṇīdevī siṃdurāruṇa murtanaṃ || rohanī || trailokya mohanīsyāṃ	rohanī 
SA_MB_mahaalak-841	ripukuladanī bhaṃjanī sarvavighni bhūtapretapiśācā bhayamukhagaraṇī dhvaṃsinī	                   
SA_MB_mahaalak-842	dākinīnāṃ | rakṣābhūtā na rāmāṃ śivasakalamukhā sarvamaṅgalya yuktā sā devī	dākinīnām rakṣā bhūtā na yuktā sā devī 
SA_MB_mahaalak-843	mohanīyaṃ tripathagati yutāsarvasaṃpartidāyu ||	mohanīyam tripathagati yuta a sarva saṃparti dāyu 
SA_MB_mahaalak-844	p. 51a) yajamānayā tāsvānataya || māhālakṣmī mahādevī saubhāgya surasundarī ||	māhālakṣmī mahādevī saubhāgya surasundarī 
SA_MB_mahaalak-845	vaidurya pādukārūḍhā siṃhāsanā paristhitā ||	pādukā ārūḍhā siṃha āsanā paristhitā 
SA_MB_mahaalak-846	caturbhujā viśālākṣī khaḍgapheṭaka dhāriṇī |	         
SA_MB_mahaalak-847	nupurahāra keyurāratnakuṇḍala dhāriṇī ||	dhāriṇī 
SA_MB_mahaalak-848	ratnotkhacita sarvāṅgī cūḍāmaṇi vibhūṣitā |	ratna utkhacita sarva aṅgī cūḍāmaṇi vibhūṣitā 
SA_MB_mahaalak-849	vicitra puṣparatnañca vastragandhanu lepanī ||	vicitra 
SA_MB_mahaalak-850	trailokye vyāpanī devī sarvasthaṃ sa carācaraṃ |	trailokye vyāpanī devī sarva stham sa carācaram 
SA_MB_mahaalak-851	siddhigandharva na mitā vidyādhara surārcitā ||	na mitā vidyādhara sura arcitā 
SA_MB_mahaalak-852	devī koṭe mahāplakṣaṃ saṃhārāṣṭa kulākramaṃ |	devī koṭe mahāplakṣam saṃhāra aṣṭa kula ākramam 
SA_MB_mahaalak-853	īśānapīṭhasaṃsthāya mahālakṣmī namostute ||	īśāna pīṭha saṃsthāya mahā lakṣmī namaḥ stute 
SA_MB_mahaalak-854	p. 51b) mālakostrāsyāna viya || astramantreṇavaliḥ visarjanayāya || māśiya ||	astramantreṇavaliḥ 
SA_MB_mahaalak-855	valiḥbhovārūya || mahādīpa visarjanayāya || khusisacoyakalacchoya || sākṣipāya || iti śrī	mahādīpa visarjanayāya sākṣipāya iti śrī 
SA_MB_mahaalak-856	śrī śrīmahālakṣmīsake mahādīpacchota kāyā vidhiḥ samāptaḥ || 7 || śubha ||	śrī śrī mahālakṣmīsake mahādīpacchota kāyāḥ vidhiḥ samāptaḥ    
SA_MB_mahaalak-857	MUKTABODHA INDOLOGICAL RESEARCH INSTITUTE©2011 Muktabodha Indological Research Institute  All Rights Reserved.E-texts may be viewed only online or downloaded for private study.E-texts may not, under any circumstances, be copied, republished,reproduced, distributed or sold, either in original or altered form, withoutthe express permission of Muktabodha Indological Research Institute in writing.Data-entered by the staff of Muktabodha under the direction of Mark S. G. Dyczkowski.	muktabodha indological research muktabodha indological research institute all rights reserved texts may be viewed only online or downloaded for private studye texts may not under any circumstances be copied republished reproduced distributed or sold either in original or altered form withoutthe express permission of muktabodha indological research institute in writing data entered by the staff of muktabodha under the direction of mark s g dyczkowski 
