segmentnr	original	analyzed
SA_MBSAAMBAPA__NCAASIKAAhk-0	Muktabodha E-text in UTF-8	muktabodha etext in utf
SA_MBSAAMBAPA__NCAASIKAAhk-1	###########################################################################MUKTABODHA INDOLOGICAL RESEARCH INSTITUTEwww.muktabodha.org©2011 Muktabodha Indological Research Institute  All Rights Reserved.E-texts may be viewed only online or downloaded for private study.E-texts may not, under any circumstances, be copied, republished,reproduced, distributed or sold, either in original or altered form, withoutthe express permission of Muktabodha Indological Research Institute in writing.Data-entered by the staff of Muktabodha under the direction of Mark S. G. Dyczkowski.Catalog number : M00076	muktabodha indological research muktabodha indological research institute all rights reserved texts may be viewed only online or downloaded for private studye texts may not under any circumstances be copied republished reproduced distributed or sold either in original or altered form withoutthe express permission of muktabodha indological research institute in writing data entered by the staff of muktabodha under the direction of mark s g dyczkowskicatalog number  /
SA_MBSAAMBAPA__NCAASIKAAhk-2	Uniform title: sāmbapañcāśikā	uniform title sāmbapañcāśikā 
SA_MBSAAMBAPA__NCAASIKAAhk-3	Main title: sāmbapañcāśikā with the commentary of kṣemarāja	main title sāmbapañcāśikā with the commentary of kṣemarāja 
SA_MBSAAMBAPA__NCAASIKAAhk-4	Commentator : kṣemarāja	commentatoḥ kṣemarāja 
SA_MBSAAMBAPA__NCAASIKAAhk-5	Description: This e-text was transcribed from Trivandrum Sanskrit Series, volume 104	description this etext was transcribed from trivandrum sanskrit series volume 
SA_MBSAAMBAPA__NCAASIKAAhk-6	Notes: Transcribed by the staff of Muktabodha under the supervision of Mark S. G. Dyczkowski .	notes transcribed by the staff muktabodha under the supervision of mark s g dyczkowski 
SA_MBSAAMBAPA__NCAASIKAAhk-7	Revision 0: Nov. 29, 2005	revision 
SA_MBSAAMBAPA__NCAASIKAAhk-8	Publisher : Trivandrum Sanskrit Series	publisher trivandrum sanskrit series 
SA_MBSAAMBAPA__NCAASIKAAhk-9	Publication year : 1930	publication year 
SA_MBSAAMBAPA__NCAASIKAAhk-10	Publication city : Trivandrum	publication citi 
SA_MBSAAMBAPA__NCAASIKAAhk-11	Publication country : India	publication country india 
SA_MBSAAMBAPA__NCAASIKAAhk-12	sāmbapañcāśikā	sāmbapañcāśikā 
SA_MBSAAMBAPA__NCAASIKAAhk-13	rājānakaśrīkṣemarājakṛtayā ṭīkayā sametā	rājānaka śrī kṣemarāja kṛtayā ṭīkayā sametā 
SA_MBSAAMBAPA__NCAASIKAAhk-14	puṣṇan devānamṛtavisarairindumāsrāvya samyag	puṣṇan devān amṛta visaraiḥ indum āsrāvya samyak 
SA_MBSAAMBAPA__NCAASIKAAhk-15	bhābhiḥ svābhī rasayati rasaṃ yaḥ paraṃ nityameva |	bhābhiḥ svābhiḥ rasayati rasam yaḥ param nityam eva 
SA_MBSAAMBAPA__NCAASIKAAhk-16	kṣīṇaṃ kṣīṇaṃ punarapi ca taṃ pūrayatyevamīdṛg	kṣīṇam kṣīṇam punar api ca tam pūrayati evam īdṛś 
SA_MBSAAMBAPA__NCAASIKAAhk-17	dolālīlollasitahṛdayaṃ naumi cidbhānumekam ||	dolā līlā ullasita hṛdayam naumi cit bhānum ekam 
SA_MBSAAMBAPA__NCAASIKAAhk-18	etadāveśavaivaśyapronmiṣaddhiṣaṇā vayam |	etad āveśa vaivaśya pronmiṣat hiṣaṇāḥ vayam 
SA_MBSAAMBAPA__NCAASIKAAhk-19	vimṛśāmo manākchrīmatsāmbapañcāśikāstutim ||	vimṛśāmaḥ manāk śrīmat sāmbapañcāśikā stutim 
SA_MBSAAMBAPA__NCAASIKAAhk-20	so'yaṃ parāmṛtaraso rasajñairiha rasyatām |	saḥ uyam para amṛta rasaḥ rasajñaiḥ iha rasyatām 
SA_MBSAAMBAPA__NCAASIKAAhk-21	āyuṣyājyāmṛtasparśaḥ śatapadyā hi śāntaye ||	āyuṣya ājya amṛta sparśaḥ śatapadyā hi śāntaye 
SA_MBSAAMBAPA__NCAASIKAAhk-22	samastāgamamahāmnāyarahasyavinmahāyogīgisahasrasaṃpradāya-	                               
SA_MBSAAMBAPA__NCAASIKAAhk-23	saṃpūrṇaḥ śrīvāsudevasya bhagavataḥ putraḥ śrīsāmbaḥ	saṃpūrṇaḥ śrī vāsudevasya bhagavataḥ putraḥ śrī sāmbaḥ 
SA_MBSAAMBAPA__NCAASIKAAhk-24	svātmavivasvatstutiṃ jagato'nugrahāya vaktumupakramate -	sva ātma vivasvat stutim jagataḥ anugrahāya vaktum upakramate 
SA_MBSAAMBAPA__NCAASIKAAhk-25	śabdārthatvavivartamānaparamajyotīruco gopate-	śabda artha tva vivartamāna parama jyotīrucaḥ gopate 
SA_MBSAAMBAPA__NCAASIKAAhk-26	rudgītho'bhyuditaḥ puro'ruṇatayā yasya trayīmaṇḍalam |	puroruṇa tayā yasya trayī maṇḍalam 
SA_MBSAAMBAPA__NCAASIKAAhk-27	bhāvyadvarṇapadakrameritatamaḥsaptasvarāśvairviya-	bhāvya dvarṇa pada krama īrita tamaḥ sapta svara aśvaiḥ 
SA_MBSAAMBAPA__NCAASIKAAhk-28	dvidyāsyandanamunnayanniva namastasmai parabrahmaṇe || 1 ||	dvidyā syandanam unnayan iva namaḥ tasmai para brahmaṇe 
SA_MBSAAMBAPA__NCAASIKAAhk-29	tasmai parasmai sarvotkṛṣṭāya viśvapūrṇādikartre ca | ata eva	tasmai parasmai sarva utkṛṣṭāya viśva pūrṇa ādi kartre ca atas eva 
SA_MBSAAMBAPA__NCAASIKAAhk-30	cābhāvaśāntabrahmacitrabrahmādisarvabrahmakroḍīkartre brahmaṇe bṛhate	ca abhāva śānta brahma citra brahma ādi sarva brahma kroḍī kartre brahmaṇe bṛhate 
SA_MBSAAMBAPA__NCAASIKAAhk-31	vyāpakāya bṛhaṇāya ca viśvakartre cidātmane namaḥ |	vyāpakāya bṛhaṇāya ca viśvakartre cit ātmane namaḥ 
SA_MBSAAMBAPA__NCAASIKAAhk-32	dehādipramātṛtāpraśamanena tadevāviśāmītyarthaḥ | yasya brahmaṇaḥ	deha ādi pramātṛ tā praśamanena tat eva āviśāmi iti arthaḥ yasya brahmaṇaḥ 
SA_MBSAAMBAPA__NCAASIKAAhk-33	sambandhi ūrdhvamaśeṣaviśvābhedātmatayā utkṛṣṭatayā gīyate vimṛśyata	sambandhi ūrdhvam aśeṣa viśva abheda ātma tayā utkṛṣṭa tayā gīyate vimṛśyata 
SA_MBSAAMBAPA__NCAASIKAAhk-34	ityudrīthaḥ prathamonmeṣātmaśabdabrahmarūpaḥ praṇavo dhvaniḥ |	iti udrīthaḥ prathama unmeṣa ātma śabda brahma rūpaḥ praṇavaḥ dhvaniḥ 
SA_MBSAAMBAPA__NCAASIKAAhk-35	devatāstutikarmapradhānasāmargyajurvedākhyā trayyeva śākhā	devatā stuti karma pradhāna sāma ṛc yajurveda ākhyā trayī eva śākhā 
SA_MBSAAMBAPA__NCAASIKAAhk-36	prapañcakroḍīkṛtasamastāmnāyavākyaikavākyatāvyāptyā maṇḍalam |	                  
SA_MBSAAMBAPA__NCAASIKAAhk-37	ataścaitatsarvāsāṃ vidyānāṃ mantraśāstravijñānānāṃ	atas ca etat sarvāsām vidyānām mantra śāstra vijñānānām 
SA_MBSAAMBAPA__NCAASIKAAhk-38	syandanamāspadaṃ prasavakāraṇaṃ ca karmabhūtaṃ ca	syandanam āspadam prasava kāraṇam ca karma bhūtam ca 
SA_MBSAAMBAPA__NCAASIKAAhk-39	viyatparākāśamunnayannullāsayaṃstanmayatvamāpādayanniva puraḥ	viyat para ākāśam unnayan ullāsayan tad maya tvam āpādayan iva puras 
SA_MBSAAMBAPA__NCAASIKAAhk-40	prathamamaruṇatayā'tidīptatvenoditaḥ  svayamunmiṣitaḥ |	prathamam aruṇa tayā ati dīpta tvena uditaḥ svayam unmiṣitaḥ 
SA_MBSAAMBAPA__NCAASIKAAhk-41	viyanmayasyāpyasya dīptasyonmeṣāvaṣṭambhapuraḥsaraṃ tathā	viyat mayasya api asya dīptasya unmeṣa avaṣṭambha puraḥsaram tathā 
SA_MBSAAMBAPA__NCAASIKAAhk-42	sphuraṇādunnayannivetyuktam | etacca trayīmaṇḍalaṃ bhāsvadbhiḥ	sphuraṇāt unnayan iva iti uktam etat ca trayī maṇḍalam bhāsvadbhiḥ 
SA_MBSAAMBAPA__NCAASIKAAhk-43	prodgīthāruṇimnā	prodgītha aruṇimnā 
SA_MBSAAMBAPA__NCAASIKAAhk-44	sphuritairvarṇapadakramairakṣaravācakatadānupūrvībhirīritaṃ dhvastaṃ	sphuritaiḥ varṇa pada kramaiḥ akṣara vācaka tad ānupūrvībhiḥ īritam dhvastam 
SA_MBSAAMBAPA__NCAASIKAAhk-45	tamo'jñānaṃ yena tādṛk | uccāraṇapadārthavākyārthapratipattiṣu	tamaḥ jñānam yena tādṛś uccāraṇa padārtha vākya artha pratipattiṣu 
SA_MBSAAMBAPA__NCAASIKAAhk-46	paramacidabhedaviśrāntidamityarthaḥ | kena viyadunnayan | sapta ye svarāḥ svayaṃ	parama cit abheda viśrānti dam iti arthaḥ kena viyat unnayan sapta ye svarāḥ svayam 
SA_MBSAAMBAPA__NCAASIKAAhk-47	rājamānā viśvākṣepiṇo varṇāḥ paśyantyādipravartanaprāṇitakalpāḥ	rājamānāḥ viśva ākṣepiṇaḥ varṇāḥ paśyantī ādi pravartana prāṇita kalpāḥ 
SA_MBSAAMBAPA__NCAASIKAAhk-48	ṣaḍjādidhvanivimarśāsta eva sarvatrāśusaṃcāritvādaśvāstaiḥ | yasya	ṣaḍja ādi dhvani vimarśāḥ te eva sarvatra āśu saṃcāri tvāt aśvāḥ taiḥ yasya 
SA_MBSAAMBAPA__NCAASIKAAhk-49	brahmaṇaḥ kīdṛśasya | gopateḥ parādivākprabhormarīcicakreśvarasya ca | ata eva	brahmaṇaḥ kīdṛśasya gopateḥ parādi vāc prabhoḥ marīci cakra īśvarasya ca atas eva 
SA_MBSAAMBAPA__NCAASIKAAhk-50	śabdārthatvena nānālaukiketaraśabdatadarthatatsaṃbandhairvicitratayā	śabda artha tvena nānā laukika itara śabda tad artha tad saṃbandhaiḥ vicitra tayā 
SA_MBSAAMBAPA__NCAASIKAAhk-51	vartamānaṃ svātantryādetadvaicitryābhāsātma yatparaṃ jyotiḥ śāktaṃ	vartamānam svātantryāt etat vaicitrya ābhāsa ātma yat param jyotiḥ śāktam 
SA_MBSAAMBAPA__NCAASIKAAhk-52	vīryaṃ tena ca rugdīptiryasya | bāhyasyāpi sūryasya jñānaśaktiḥ parā	vīryam tena ca ruj dīptiḥ yasya bāhyasya api sūryasya jñānaśaktiḥ parā 
SA_MBSAAMBAPA__NCAASIKAAhk-53	hyeṣā tapatyādityavigrahā ityāmnāyanītyā parabrahmapratibimbakalpasya	hi eṣā tapati āditya vigrahā iti āmnāya nītyā para brahma pratibimba kalpasya 
SA_MBSAAMBAPA__NCAASIKAAhk-54	praṇavavyāptiko'ruṇaḥ pūrvamuditaḥ | trayīvyāptikaṃ	                    
SA_MBSAAMBAPA__NCAASIKAAhk-55	maṇḍalamitaravidyāvyāptikaṃ syandanaṃ ca karmabhāsvadvarṇaiḥ	maṇḍalam itara vidyā vyāptikam syandanam ca karma bhāsvat varṇaiḥ 
SA_MBSAAMBAPA__NCAASIKAAhk-56	padakramairdedīpyamānacaraṇavinyāsairīritatamaso ye saptasvaravyāptikā	pada kramaiḥ dedīpyamāna caraṇa vinyāsaiḥ īrita tamasaḥ ye sapta svara vyāptikā 
SA_MBSAAMBAPA__NCAASIKAAhk-57	aśvāstairviyadutkṣipati | atha ca	aśvāḥ taiḥ viyat utkṣipati atha ca 
SA_MBSAAMBAPA__NCAASIKAAhk-58	vicitravācyavācakātmajagadvṛtteściccakreśvarasyodgīthaḥ śaktyaṅkuronmeṣo	vicitra vācya vācaka ātma jagat vṛtteḥ ciccakra īśvarasya udgīthaḥ śakti aṅkura unmeṣaḥ 
SA_MBSAAMBAPA__NCAASIKAAhk-59	dīpto brahmaviṣṇurudrajāgratsvapnasuṣuptibrahmamūlamāyāṇḍāditrayī-	dīptaḥ brahma viṣṇu rudra jāgrat svapna suṣupti brahma mūla māyā aṇḍa ādi trayī 
SA_MBSAAMBAPA__NCAASIKAAhk-60	maṇḍalam | viyadvyāpakam | vedanānādidharmasya paramātmatvabodhanā	maṇḍalam viyat vyāpakam vedanā nānā ādi dharmasya parama ātma tva bodhanā 
SA_MBSAAMBAPA__NCAASIKAAhk-61	ityādyāmnāyaniruktonmanāśaktyākhyā vidyāsyandanaṃ	ityādi āmnāya nirukta unmanā śakti ākhyā vidyā syandanam 
SA_MBSAAMBAPA__NCAASIKAAhk-62	svarairvicitrairmantrairdhvanibhirunnayanniva prathamamuditaḥ | kiṃ kṛtvā ?	svaraiḥ vicitraiḥ mantraiḥ dhvanibhiḥ unnayan iva prathamam uditaḥ kim kṛtvā 
SA_MBSAAMBAPA__NCAASIKAAhk-63	bhāsvatāṃ varṇānāmākārādimātrāṇāṃ padānāṃ	bhāsvatām varṇānām ākāra ādi mātrāṇām padānām 
SA_MBSAAMBAPA__NCAASIKAAhk-64	bindvādiviśrāntīnāṃ krameṇa paripāṭyā īritaṃ tamaḥ samanāntaṃ	bindu ādi viśrāntīnām krameṇa paripāṭyā īritam tamaḥ samana antam 
SA_MBSAAMBAPA__NCAASIKAAhk-65	pāśajālaṃ yatra || 1 ||	pāśa jālam yatra 
SA_MBSAAMBAPA__NCAASIKAAhk-66	evaṃ sāmānyavyāptyā paramārkaṃ stutvā	evam sāmānya vyāptyā parama arkam stutvā 
SA_MBSAAMBAPA__NCAASIKAAhk-67	dehasthamadhyanāḍīvyāptyā stauti -	deha stha madhyanāḍī vyāptyā stauti 
SA_MBSAAMBAPA__NCAASIKAAhk-68	omityantanadati niyataṃ yaḥ pratiprāṇi śabdo	om iti antanadati niyatam yaḥ 
SA_MBSAAMBAPA__NCAASIKAAhk-69	vāṇī yasmāt prasarati parā śabdatanmātragarbhā |	vāṇī yasmāt prasarati parā śabda tanmātra garbhā 
SA_MBSAAMBAPA__NCAASIKAAhk-70	prāṇāpānau vahati ca samau yo mitho grāsasaktau	prāṇa apānau vahati ca samau yaḥ mithas grāsa saktau 
SA_MBSAAMBAPA__NCAASIKAAhk-71	dehasthaṃ taṃ sapadi paramādityamādyaṃ prapadye || 2 ||	deha stham tam sapadi paramādityam ādyam prapadye 
SA_MBSAAMBAPA__NCAASIKAAhk-72	taṃ paramādityaṃ parabrahmasvarūpameva dehasthitaṃ	tam paramādityam para brahma svarūpam eva deha sthitam 
SA_MBSAAMBAPA__NCAASIKAAhk-73	madhyanāḍīgataprāṇabrahmaniviṣṭam ādyaṃ viśvacitrabhittibhūtaṃ sapadi	madhyanāḍī gata prāṇa brahma niviṣṭam ādyam viśva citra bhitti bhūtam sapadi 
SA_MBSAAMBAPA__NCAASIKAAhk-74	prapadye abhisandhyavadhānena samāviśāmi | kaṃ tamityāha - ya omitiśabdaḥ	prapadye abhisandhi avadhānena samāviśāmi kam tam iti āha yaḥ om iti śabdaḥ 
SA_MBSAAMBAPA__NCAASIKAAhk-75	kroḍīkṛtāśeṣaśabdanātmanādarūpo mahāpraṇavaḥ pratiprāṇi sarvabhūteṣu	kroḍīkṛta aśeṣa śabdana ātma nāda rūpaḥ mahāpraṇavaḥ pratiprāṇi sarva bhūteṣu 
SA_MBSAAMBAPA__NCAASIKAAhk-76	niyatamavicchinnapravāheṇāntarnadati parāvāgātmasvarūpaṃ vimṛśan sthitaḥ |	niyatam avicchinna pravāheṇa antar nadati parā vāc ātma svarūpam vimṛśan sthitaḥ 
SA_MBSAAMBAPA__NCAASIKAAhk-77	yasmācca śabdatanmātragarbhā āsūtritakramā	yasmāt ca śabda tanmātra garbhā āsūtrita kramā 
SA_MBSAAMBAPA__NCAASIKAAhk-78	ādikṣāntaśabdasāmānyamātrā'vibhāgajyotirmayī parādvitīyā vāṇī	ādi kṣānta śabda sāmānya mātrā vibhāga jyotiḥ mayī parā advitīyā vāṇī 
SA_MBSAAMBAPA__NCAASIKAAhk-79	paśyantī prasaratyunmiṣati | yaśca mitho grāsasaktāvanyonyakavalanaparau samau	paśyantī prasarati unmiṣati yaḥ ca mithas grāsa saktau anyonya kavalana parau samau 
SA_MBSAAMBAPA__NCAASIKAAhk-80	samānabhūmikārūḍhau prāṇāpānau vahati |	samāna bhūmikā ārūḍhau prāṇa apānau vahati 
SA_MBSAAMBAPA__NCAASIKAAhk-81	udānavahnyātmanijamahājyotirmayau karoti || 2 ||	udāna vahni ātma nija mahā jyotiḥ mayau karoti  /
SA_MBSAAMBAPA__NCAASIKAAhk-82	evaṃ mahāvyāptyā sūkṣmavyāptyā cānavacchinnaṃ	evam mahāvyāptyā sūkṣmavyāptyā ca anavacchinnam 
SA_MBSAAMBAPA__NCAASIKAAhk-83	madhyadhāmasthaṃ ca cidarkaṃ nutvā prapañcavyāptyāpi stauti -	madhya dhāma stham ca cit arkam nutvā prapañca vyāptyā api stauti 
SA_MBSAAMBAPA__NCAASIKAAhk-84	yastvakcakṣuḥśravaṇarasanāghrāṇapāṇyaṅghrivāṇī-	yaḥ tvac cakṣuḥ śravaṇa rasanā ghrāṇa pāṇi aṅghri vāṇī 
SA_MBSAAMBAPA__NCAASIKAAhk-85	pāyupasthasthitirapi manobuddhyahaṅkāramūrtiḥ |	pāyu pastha sthitiḥ api manaḥ buddhi ahaṅkāra mūrtiḥ 
SA_MBSAAMBAPA__NCAASIKAAhk-86	tiṣṭhatyantarbahirapi jagadbhāsayan dvādaśātmā	tiṣṭhati antar bahis api jagat bhāsayan dvādaśātmā 
SA_MBSAAMBAPA__NCAASIKAAhk-87	mārtaṇḍaṃ taṃ sakalakaraṇādhāramekaṃ prapadye || 3 ||	mārtaṇḍam tam sakala karaṇa ādhāram ekam prapadye 
SA_MBSAAMBAPA__NCAASIKAAhk-88	mṛtānāṃ vedyaikarūpatayā śavaprāyāṇāmaṇḍānāṃ	mṛtānām vedya eka rūpa tayā śava prāyāṇām aṇḍānām 
SA_MBSAAMBAPA__NCAASIKAAhk-89	dehaprāṇādipiṇḍānāmayamanuprāṇako	deha prāṇa ādi piṇḍānām ayam anuprāṇakaḥ 
SA_MBSAAMBAPA__NCAASIKAAhk-90	mārtaṇḍaścidbhānustamekamadvitīyamapi prapañcavyāptyā sakalānāṃ	mārtaṇḍaḥ cit bhānuḥ tam ekam advitīyam api prapañca vyāptyā sakalānām 
SA_MBSAAMBAPA__NCAASIKAAhk-91	pramātṝṇāṃ sakalāni karaṇāni ca trayodaśakaraṇāni ca	pramātṝṇām sakalāni karaṇāni ca trayodaśa karaṇāni ca 
SA_MBSAAMBAPA__NCAASIKAAhk-92	teṣāmādhāramanuprāṇakamavibhinnamāśrayaṃ prapadye |	teṣām ādhāram anuprāṇakam avibhinnam āśrayam prapadye 
SA_MBSAAMBAPA__NCAASIKAAhk-93	yastvagādyahaṅkārāntasvīkṛtatrayodaśendriyamūrtiḥ |	yaḥ tvac ādi ahaṅkāra anta svīkṛta trayodaśa indriya mūrtiḥ 
SA_MBSAAMBAPA__NCAASIKAAhk-94	ataścāntarahaṅkārātmā vedagrāhakarūpaḥ bahiścādhyavasāyādi	atas ca antar ahaṅkāra ātmā veda grāhaka rūpaḥ bahis ca adhyavasāya ādi 
SA_MBSAAMBAPA__NCAASIKAAhk-95	vyāpārabuddhyādikaraṇadvādaśātmā grāhyarūpaṃ	vyāpāra buddhi ādi karaṇa dvādaśa ātmā grāhya rūpam 
SA_MBSAAMBAPA__NCAASIKAAhk-96	jagadbhāsayaṃstiṣṭhatīti sthūladṛśārthaḥ | rahasyadṛśā tu	jagat bhāsayan tiṣṭhati iti sthūla dṛśā arthaḥ rahasya dṛśā tu 
SA_MBSAAMBAPA__NCAASIKAAhk-97	gṛhītasarvendriyamūrtirapi yaḥ	gṛhīta sarva indriya mūrtiḥ api yaḥ 
SA_MBSAAMBAPA__NCAASIKAAhk-98	sṛṣṭyādimarīcicakracitrasaṃcāracāturyāddvādaśātmā eka eva	sṛṣṭi ādi marīci cakra citra saṃcāra cāturyāt dvādaśa ātmā ekaḥ eva 
SA_MBSAAMBAPA__NCAASIKAAhk-99	cidarko'ntarbahiśca jagatkālānalādi vyomakalāntaṃ viśvaṃ	cit arka untar bahis ca jagat kāla anala ādi vyoma kalā antam viśvam 
SA_MBSAAMBAPA__NCAASIKAAhk-100	bhāsayaṃsturyadhāmātmanijabhāsā cakramayatvamāpādayan	bhāsayan turya dhāma ātma nija bhāsā cakra maya tvam āpādayan 
SA_MBSAAMBAPA__NCAASIKAAhk-101	sarvakaraṇānyādhāratayā nijaujojvalanajvalitānyāśritya sthitastaṃ prakarṣeṇa	sarva karaṇāni ādhāra tayā nija ojaḥ jvalana jvalitāni āśritya sthitaḥ tam prakarṣeṇa 
SA_MBSAAMBAPA__NCAASIKAAhk-102	prapadye | nijavyutthānaṃ sākṣātkurvan sthito'smītyarthaḥ || 3 ||	prapadye nija vyutthānam sākṣātkurvan sthitaḥ asmi iti arthaḥ 
SA_MBSAAMBAPA__NCAASIKAAhk-103	prapañcavyāptyākhilendriyādhāre stute'pi bhagavati	prapañca vyāptyā akhila indriya ādhāre stute pi bhagavati 
SA_MBSAAMBAPA__NCAASIKAAhk-104	prakāśavimarśaparamārthe tadvimarśaprasarasaraṇiṃ vāṇīṃ stauti -	             stauti 
SA_MBSAAMBAPA__NCAASIKAAhk-105	yā sā mitrāvaruṇasadanāduccarantī triṣaṣṭiṃ	yā sā mitrāvaruṇa sadanāt uccarantī triṣaṣṭim 
SA_MBSAAMBAPA__NCAASIKAAhk-106	varṇānatra prakaṭakaraṇaiḥ prāṇasaṅgāt prasūtān |	varṇān atra prakaṭa karaṇaiḥ prāṇa saṅgāt prasūtān 
SA_MBSAAMBAPA__NCAASIKAAhk-107	tāṃ paśyantīṃ prathamamuditāṃ madhyamāṃ buddhisaṃsthāṃ	tām paśyantīm prathama muditām madhyamām buddhi saṃsthām 
SA_MBSAAMBAPA__NCAASIKAAhk-108	vācaṃ vaktre karaṇaviśadāṃ vaikharīṃ ca prapadye || 4 ||	vācam vaktre karaṇa viśadām vaikharīm ca prapadye 
SA_MBSAAMBAPA__NCAASIKAAhk-109	avibhāgāttu paśyantī sarvataḥ saṃhṛtakramā |	avibhāgāt tu paśyantī sarvatas saṃhṛta kramā 
SA_MBSAAMBAPA__NCAASIKAAhk-110	svarūpajyotirevāntaḥ sūkṣmā vāganapāyinī || ityādinā lakṣitāṃ	sva rūpa jyotiḥ eva antar sūkṣmā vāc anapāyinī ityādinā lakṣitām 
SA_MBSAAMBAPA__NCAASIKAAhk-111	prathamamādābuditāmunmiṣitāṃ tāṃ svarūpajyotīrūpāṃ	prathamam ādau uditām unmiṣitām tām sva rūpa jyotīḥ rūpām 
SA_MBSAAMBAPA__NCAASIKAAhk-112	paśyantyākhyāṃ tadanu tāmeva buddhisaṃsthāṃ buddhyabhyāsaṃ prāptām |	paśyantī ākhyām tadanu tām eva buddhi saṃsthām buddhi abhyāsam prāptām 
SA_MBSAAMBAPA__NCAASIKAAhk-113	kevalaṃ buddhyupādānāt kramarūpānupātinī prāṇavṛttimatikramya	kevalam buddhi upādānāt krama rūpa anupātinī prāṇa vṛttim atikramya 
SA_MBSAAMBAPA__NCAASIKAAhk-114	madhyamā vāk pravartate || ityādilakṣitām | madhye bhavatvānmadhyamāṃ	madhyamā vāc pravartate ityādi lakṣitām madhye bhava tvāt madhyamām 
SA_MBSAAMBAPA__NCAASIKAAhk-115	madhye'ntaḥkaraṇe vartamānām | tadanu vaktre vadane karaṇeṣu	madhye ntaḥkaraṇe vartamānām tadanu vaktre vadane karaṇeṣu 
SA_MBSAAMBAPA__NCAASIKAAhk-116	jihvāmūlajihvāmadhyamādiṣu viśadāṃ nirmalām | sthāneṣu vivṛte vāyau	jihvā mūla jihvā madhyama ādiṣu viśadām nirmalām sthāneṣu vivṛte vāyau 
SA_MBSAAMBAPA__NCAASIKAAhk-117	kṛtavarṇaparigrahā | vaikharī vākprayoktṝṇāṃ prāṇavṛttinibandhanā ||	                        
SA_MBSAAMBAPA__NCAASIKAAhk-118	ityādinā lakṣitām | vikhare śarīre  bhavatvāttadākhyāṃ vācaṃ	ityādinā lakṣitām vikhare śarīre bhava tvāt tad ākhyām vācam 
SA_MBSAAMBAPA__NCAASIKAAhk-119	prapanno'smi | kāṃ tāmityāha - yā sā	prapannā asmi kām tām iti āha yā sā 
SA_MBSAAMBAPA__NCAASIKAAhk-120	mitrāvaruṇasadanādagnīṣomamayātmanaḥ	mitrāvaruṇa sadanāt agnīṣoma maya ātmanaḥ 
SA_MBSAAMBAPA__NCAASIKAAhk-121	parāvākpradhānānmadhyadhāmno'karādīṃstriṣaṣṭiṃ varṇānuccarantī	parāvāc pradhānāt madhya dhāmnaḥ ukara ādīn triṣaṣṭim varṇān uccarantī 
SA_MBSAAMBAPA__NCAASIKAAhk-122	āsūtritakramatayā bhedābhedābhyāṃ bhedena ca vimṛśantī | kenoccarantī ?	āsūtrita krama tayā bheda abhedābhyām bhedena ca vimṛśantī kena uccarantī 
SA_MBSAAMBAPA__NCAASIKAAhk-123	prakaṭairantarmukhībhāvenābhinnasphuṭaprakāśaikamadhyamāptaiḥ karaṇaiḥ	prakaṭaiḥ antarmukhībhāvena abhinna sphuṭa prakāśa eka madhyam āptaiḥ karaṇaiḥ 
SA_MBSAAMBAPA__NCAASIKAAhk-124	sarvendriyaiḥ | kīdṛśān varṇān ? prāṇasaṅgāt prasūtānudbhūtān | tatra	sarva indriyaiḥ kīdṛśān varṇān prāṇa saṅgāt prasūta an udbhūtān tatra 
SA_MBSAAMBAPA__NCAASIKAAhk-125	cijjyotiṣi guṇībhūtasūkṣmaprāṇasaṅgāt paśyantyāṃ	cit jyotiṣi guṇībhūta sūkṣma prāṇa saṅgāt paśyantyām 
SA_MBSAAMBAPA__NCAASIKAAhk-126	guṇībhūtacitsūkṣmaprāṇasaṅgānmadhyamāyāṃ	guṇībhūta cit sūkṣma prāṇa saṅgāt madhyamāyām 
SA_MBSAAMBAPA__NCAASIKAAhk-127	sthūlaprāṇasaṅgādvaikharyāṃ varṇā jāyante | te ca triṣaṣṭiḥ | tadyathā - a- i-	sthūla prāṇa saṅgāt vaikharyām varṇāḥ jāyante te ca triṣaṣṭiḥ tat yathā a i 
SA_MBSAAMBAPA__NCAASIKAAhk-128	u -ṛ - varṇāścatvāro hrasvadīrghaplutabhedā dvādaśa ḷkārasya dīrgho nāstīti	u ṛ varṇāḥ catvāraḥ hrasva dīrgha pluta bhedāḥ dvādaśa ḷkārasya dīrghaḥ na asti iti 
SA_MBSAAMBAPA__NCAASIKAAhk-129	hrasvaplutabhedād dvividhaḥ | saṃdhyakṣarāṇāṃ hrasvā na santīti	hrasva pluta bhedāt dvividhaḥ saṃdhyakṣarāṇām hrasvāḥ na santi iti 
SA_MBSAAMBAPA__NCAASIKAAhk-130	dīrghaplutabhedādaṣṭavidhāḥ | evaṃ svarā dvāviṃśatiḥ | kādayo māntāḥ	dīrgha pluta bhedāt aṣṭavidhāḥ evam svarāḥ dvāviṃśatiḥ ka ādayaḥ ma antāḥ 
SA_MBSAAMBAPA__NCAASIKAAhk-131	pañcaviṃśatiḥ sparśāḥ | antasthāścatvāraḥ | ūṣmāṇaścatvāraḥ | kuṃ	pañcaviṃśatiḥ sparśāḥ antasthāḥ catvāraḥ ūṣmāṇaḥ catvāraḥ kuṃ 
SA_MBSAAMBAPA__NCAASIKAAhk-132	khuṃ guṃ dhuṃ iti yamāścatvāraḥ |	khum gum dhum iti yamāḥ catvāraḥ 
SA_MBSAAMBAPA__NCAASIKAAhk-133	anusvāravisargajihvāmūlīyopadhmānīyā aṃ aḥ / ka / pa iti catvāraḥ | yathoktam	anusvāra visarga jihvāmūlīya upadhmānīyāḥ aṃ aḥ ka pa iti catvāraḥ yathoktam 
SA_MBSAAMBAPA__NCAASIKAAhk-134	svarā dvāviṃśatiścaiva sparśānāṃ pañcaviṃśatiḥ |	svarāḥ dvāviṃśatiḥ ca eva sparśānām pañcaviṃśatiḥ 
SA_MBSAAMBAPA__NCAASIKAAhk-135	yādayaḥ śādayaścāṣṭau catvāraśca yamāḥ smṛtāḥ ||	yādayaḥ śādayaḥ ca aṣṭau catvāraḥ ca yamāḥ smṛtāḥ 
SA_MBSAAMBAPA__NCAASIKAAhk-136	anusvāro visargaśca / ka / pa iti parāśrayau |	anusvāraḥ visargaḥ ca ka pa iti para āśrayau 
SA_MBSAAMBAPA__NCAASIKAAhk-137	ta ete gaditā varṇāstriṣaṣṭiriha sūribhiḥ || iti |	te ete gaditāḥ varṇāḥ triṣaṣṭiḥ iha sūribhiḥ iti 
SA_MBSAAMBAPA__NCAASIKAAhk-138	mitraḥ sūryo'ntaraśeṣadvaitaploṣakāritvādagniḥ | varuṇo	mitraḥ varuṇaḥ 
SA_MBSAAMBAPA__NCAASIKAAhk-139	hlādāpyāyakāritvāt somaḥ | varṇānantaḥ prakaṭakaraṇaiḥ prāṇasaṅgāt	hlāda āpyāya kāri tvāt somaḥ varṇa anantaḥ prakaṭa karaṇaiḥ prāṇa saṅgāt 
SA_MBSAAMBAPA__NCAASIKAAhk-140	prasūte iti pāṭhāntare yā parāvākśaktirmitrāvaruṇasadanāduccarantī	prasūte iti pāṭha antare yā parā avāk śaktiḥ mitrāvaruṇa sadanāt uccarantī 
SA_MBSAAMBAPA__NCAASIKAAhk-141	pramāṇaprameyātmakasūryacandrāśrayeṇātmākāśādūrdhvaṃ sarantī	pramāṇa prameya ātmaka sūrya candra āśrayeṇa ātma ākāśāt ūrdhvam sarantī 
SA_MBSAAMBAPA__NCAASIKAAhk-142	sarvottīrṇaṃ nijaṃ dhāma pramātṛrūpaṃ sravantī asti | saivāntaḥ	sarva uttīrṇam nijam dhāma pramātṛ rūpam sravantī asti sā eva antar 
SA_MBSAAMBAPA__NCAASIKAAhk-143	prakaṭairantareva sphuṭairindriyaiḥ kṛtvā triṣaṣṭiṃ varṇān prāṇasaṅgāddhetoḥ	prakaṭaiḥ antar eva sphuṭaiḥ indriyaiḥ kṛtvā triṣaṣṭim varṇān prāṇa saṅgāt hetoḥ 
SA_MBSAAMBAPA__NCAASIKAAhk-144	prasūte janayatītyanvayaḥ | indriyāṇāṃ rūpādyupalabdhyānumeyatvād bahiḥ	prasūte janayati iti anvayaḥ indriyāṇām rūpa ādi upalabdhyā anumeya tvāt bahis 
SA_MBSAAMBAPA__NCAASIKAAhk-145	sphuṭatvābhāvenāntaḥ prakaṭībhāvaḥ | etadabhidheyapakṣe	sphuṭa tva abhāvena antar prakaṭībhāvaḥ etad abhidheya pakṣe 
SA_MBSAAMBAPA__NCAASIKAAhk-146	uccāraṇaprasūtyoḥ krameṇānuvādyavidheyabhāvaḥ || 4 ||	uccāraṇa prasūtyoḥ krameṇa anuvādya vidheya bhāvaḥ 
SA_MBSAAMBAPA__NCAASIKAAhk-147	evaṃ vākprasarāntaṃ bhagavantaṃ stutvā	evam vāc prasara antam bhagavantam stutvā 
SA_MBSAAMBAPA__NCAASIKAAhk-148	madhyamadhāmasāphalyamarthayate -	madhyamadhāma sāphalyam arthayate 
SA_MBSAAMBAPA__NCAASIKAAhk-149	ūrdhvādhaḥsthānyatanubhuvanānyantarā saṃniviṣṭā	ūrdhva adhas sthāni a tanu bhuvanāni antarā saṃniviṣṭā 
SA_MBSAAMBAPA__NCAASIKAAhk-150	nānānāḍiprasavagahanā sarvabhūtāntarasthā |	nānā nāḍi prasava gahanā sarva bhūta antara sthā 
SA_MBSAAMBAPA__NCAASIKAAhk-151	prāṇāpānagrasananirataiḥ prāpyate brahmanāḍī	prāṇa apāna grasana nirataiḥ prāpyate brahmanāḍī 
SA_MBSAAMBAPA__NCAASIKAAhk-152	sā naḥ śvetā bhavatu paramādityamūrtiḥ prasannā || 5 ||	sā naḥ śvetā bhavatu parama āditya mūrtiḥ prasannā 
SA_MBSAAMBAPA__NCAASIKAAhk-153	paramādityasya cidbhānorbrahmanāḍīrūpā yā seti divyā mūrtiḥ	paramādityasya cit bhānoḥ brahmanāḍī rūpā yā sā iti divyā mūrtiḥ 
SA_MBSAAMBAPA__NCAASIKAAhk-154	samucchritākṛtirno'smākaṃ prasannā praśastā praśamitaprāṇādikāluṣyā ata	samucchritā ākṛtiḥ na usmākam prasannā praśastā praśamita prāṇa ādi kāluṣyā atas 
SA_MBSAAMBAPA__NCAASIKAAhk-155	eva śvetā cidānandaghanatayā sphurantī astu | kīdṛśī sā ? yā ūrdhvamadhaśca	eva śvetā cit ānanda ghana tayā sphurantī astu kīdṛśī sā yā ūrdhvam adhas ca 
SA_MBSAAMBAPA__NCAASIKAAhk-156	sthitāni atanūnyanalpāni	sthitāni atanūni analpāni 
SA_MBSAAMBAPA__NCAASIKAAhk-157	anāśritādikālāgnyantabhuvaneśanānābhuvanāni dehe bahiścāntarā madhye	anāśrita ādi kālāgni anta bhuvana īśa nānā bhuvanāni dehe bahis ca antarā madhye 
SA_MBSAAMBAPA__NCAASIKAAhk-158	saṃniviṣṭā vyāpyāvasthitā | tathā nānānāḍīnāṃ	saṃniviṣṭā vyāpya avasthitā tathā nānā nāḍīnām 
SA_MBSAAMBAPA__NCAASIKAAhk-159	cakṣurādiromarandhrāntānāṃ suṣirāṇāṃ prasavena sphāreṇa gahanā	cakṣuḥ ādi romarandhra antānām suṣirāṇām prasavena sphāreṇa gahanā 
SA_MBSAAMBAPA__NCAASIKAAhk-160	sarvairduṣprāpā | sarveṣāṃ sthāvarādidevayonibhedāntānāṃ	sarvaiḥ duṣprāpā sarveṣām sthāvara ādi deva yoni bheda antānām 
SA_MBSAAMBAPA__NCAASIKAAhk-161	bhūtānāmantarasthā dehamadhye vartamānā | yataścoktayuktyā gahanā ata eva	bhūtānām antara sthā deha madhye vartamānā yatas ca ukta yuktyā gahanā atas eva 
SA_MBSAAMBAPA__NCAASIKAAhk-162	kaiścideva prāṇāpānayoḥ	kaiścid eva prāṇa apānayoḥ 
SA_MBSAAMBAPA__NCAASIKAAhk-163	sarvavāhaprasavapraveśayorgrasananiratairbhakṣaṇapragalbhaiḥ prāpyate	sarva vāha prasava praveśayoḥ grasana nirataiḥ bhakṣaṇa pragalbhaiḥ prāpyate 
SA_MBSAAMBAPA__NCAASIKAAhk-164	samāviśyate || 5 ||	samāviśyate 
SA_MBSAAMBAPA__NCAASIKAAhk-165	kiñca -	kiñca 
SA_MBSAAMBAPA__NCAASIKAAhk-166	na brahmāṇḍavyavahitapathā nātiśītoṣṇarūpā	na brahmāṇḍa vyavahita pathā na ati śīta uṣṇa rūpā 
SA_MBSAAMBAPA__NCAASIKAAhk-167	no vā naktaṃdivagamamitātāpanīyāparāhuḥ |	na u vā naktaṃdiva gama mitā tāpanīya a parāhuḥ 
SA_MBSAAMBAPA__NCAASIKAAhk-168	vaikuṇṭhīyā tanuriva rave rājate maṇḍalasthā	vaikuṇṭhīyā tanuḥ iva raveḥ rājate maṇḍala sthā 
SA_MBSAAMBAPA__NCAASIKAAhk-169	sā naḥ śvetā bhavatu paramādityamūrtiḥ prasannā || 6 ||	sā naḥ śvetā bhavatu parama āditya mūrtiḥ prasannā 
SA_MBSAAMBAPA__NCAASIKAAhk-170	brahmaṇo brahmabilāvaraṇaniviṣṭasyāṇḍaṃ	brahmaṇaḥ brahma bila āvaraṇa niviṣṭasya aṇḍam 
SA_MBSAAMBAPA__NCAASIKAAhk-171	garbhīkṛtabhūmūlamāyāṇḍaprapañcaśaktyaṇḍaṃ tena na vyavahitā api tu	garbhīkṛta bhū mūla māyā aṇḍa prapañca śakti aṇḍam tena na vyavahitāḥ api tu 
SA_MBSAAMBAPA__NCAASIKAAhk-172	samantataḥ kroḍīkārī panthāḥ prasaramārgo yasyāḥ, tathā atiśītaḥ somaḥ,	samantataḥ kroḍīkārī panthāḥ prasara mārgaḥ yasyāḥ tathā atiśītaḥ somaḥ 
SA_MBSAAMBAPA__NCAASIKAAhk-173	atyuṣṇo vahniḥ, iyaṃ tu dvaitadāhādadvaitānandasyanditvācca naivaṃrūpā | api	ati uṣṇaḥ vahniḥ iyam tu dvaita dāhāt advaita ānanda syandi tvāt ca na evaṃrūpā api 
SA_MBSAAMBAPA__NCAASIKAAhk-174	tu samarasībhūtāgnīṣomātmā | tathā naktaṃdinaṃ rātridinaṃ yo gamo	tu samarasībhūta agnīṣoma ātmā tathā naktaṃdinam rātri dinam yaḥ 
SA_MBSAAMBAPA__NCAASIKAAhk-175	bhramaṇaṃ tena no itā prameyabhāvaṃ na prāptā tadvatī | tathā atāpanīyā	bhramaṇam tena no itā prameya bhāvam na prāptā tadvatī tathā a tāpanīyā 
SA_MBSAAMBAPA__NCAASIKAAhk-176	paramāhlādapradā | tathā apagato rāhurācchādanapradhānaḥ śūnyapramātā	parama āhlāda pradā tathā apagataḥ rāhuḥ ācchādana pradhānaḥ śūnya pramātā 
SA_MBSAAMBAPA__NCAASIKAAhk-177	yasyāḥ sā | kiñca, raveścidbhānormaṇḍale raśmipariveṣe rājate dīpyate |	yasyāḥ sā kiñca raveḥ cit bhānoḥ maṇḍale raśmi pariveṣe rājate dīpyate 
SA_MBSAAMBAPA__NCAASIKAAhk-178	bāhyārkamūrtistu brahmāṇḍavyavahitā svarlokāntamātrāvabhāsikā	bāhya arka mūrtiḥ tu brahmāṇḍa vyavahitā svarloka anta mātra avabhāsikā 
SA_MBSAAMBAPA__NCAASIKAAhk-179	śiśiragrīṣmādāvatiśītoṣṇarūpā aharniśaṃ bhramantī santāpikā	śiśira grīṣma ādau ati śīta uṣṇa rūpā aharniśam bhramantī santāpikā 
SA_MBSAAMBAPA__NCAASIKAAhk-180	rāhvabhibhūtā ceti vyatirekadhvaniḥ | vaikuṇṭhasya viṣṇormūrtirivetyupamā |	rāhu abhibhūtā ca iti vyatireka dhvaniḥ vaikuṇṭhasya viṣṇoḥ mūrtiḥ iva iti upamā 
SA_MBSAAMBAPA__NCAASIKAAhk-181	sāpi ca balivañcanāvasare brahmāṇḍe brahmāṇḍāntarniruddhamārgā na	sā api ca bali vañcana avasare brahmāṇḍe brahmāṇḍa antar niruddha mārgā na 
SA_MBSAAMBAPA__NCAASIKAAhk-182	kenacit | ata eva nātiśītoṣṇarūpā | prakāśāhlādadā bhaktānāmityarthaḥ |	kenacid atas eva na ati śīta uṣṇa rūpā prakāśa āhlāda dā bhaktānām iti arthaḥ 
SA_MBSAAMBAPA__NCAASIKAAhk-183	naktaṃdivagamenāhorātraparibhramaṇena na mitā | devādibhirneyattayā	naktaṃdiva gamena ahar rātra paribhramaṇena na mitā deva ādibhiḥ na iyattayā 
SA_MBSAAMBAPA__NCAASIKAAhk-184	paricchinnetyarthaḥ | tāpanīyā mahāpratāpavatī |	paricchinnā iti arthaḥ tāpanīyā mahā pratāpavatī 
SA_MBSAAMBAPA__NCAASIKAAhk-185	apagatarāhurapakrāntaravimaṇḍalā ceti śleṣaḥ | evamayamatropamāśleṣo	apagata rāhuḥ apakrānta ravi maṇḍalā ca iti śleṣaḥ evam ayam atra upamā āśleṣaḥ 
SA_MBSAAMBAPA__NCAASIKAAhk-186	vyatirekadhvaninā saṃsṛṣṭaḥ || 6 ||	vyatireka dhvaninā saṃsṛṣṭaḥ 
SA_MBSAAMBAPA__NCAASIKAAhk-187	atha yugapadantarbahiścārkamūrtiṃ stauti -	atha yugapad antar bahis ca arka mūrtim stauti 
SA_MBSAAMBAPA__NCAASIKAAhk-188	yatrārūḍhaṃ triguṇavapuṣi brahma tadbindurūpaṃ	yatra ārūḍham triguṇa vapuṣi brahma tat bindu rūpam 
SA_MBSAAMBAPA__NCAASIKAAhk-189	yogīndrāṇāṃ yadapi paramaṃ bhāti nirvāṇamārgaḥ |	yogi indrāṇām yat api paramam bhāti nirvāṇa mārgaḥ 
SA_MBSAAMBAPA__NCAASIKAAhk-190	trayyādhāraḥ praṇava iti yanmaṇḍalaṃ caṇḍaraśme-	trayī ādhāraḥ praṇavaḥ iti yat maṇḍalam caṇḍaraśme 
SA_MBSAAMBAPA__NCAASIKAAhk-191	rantaḥsūkṣmaṃ bahirapi bṛhanmuktaye'haṃ prapannaḥ || 7 ||	rantar sūkṣmam bahis api bṛhat muktayā iham prapannaḥ 
SA_MBSAAMBAPA__NCAASIKAAhk-192	taccaṇḍaraśmeściddīptāṃśormaṇḍalaṃ muktaye	tat caṇḍaraśmeḥ cit dīpta aṃśoḥ maṇḍalam muktaye 
SA_MBSAAMBAPA__NCAASIKAAhk-193	samāveśātmajīvanmuktyarthaṃ prapanno'smi | kīdṛśam ? antaścidbhuvi	samāveśa ātma jīvanmukti artham prapannaḥ asmi kīdṛśam antar cit bhuvi 
SA_MBSAAMBAPA__NCAASIKAAhk-194	sūkṣmamādyonmeṣātma | yogīndraireva labhyam | bahirapi	sūkṣmam ādya unmeṣa ātma yogi indraiḥ eva labhyam bahis api 
SA_MBSAAMBAPA__NCAASIKAAhk-195	bṛhanmahāparimāṇam | yatra	bṛhat mahā parimāṇam yatra 
SA_MBSAAMBAPA__NCAASIKAAhk-196	sṛṣṭisthitisaṃhārakārirajaḥsattvatamoniviṣṭabrahmaviṣṇurudrābhidhāyyakāro-	                                                              
SA_MBSAAMBAPA__NCAASIKAAhk-197	kāramakārākhyahrasvadīrghaplutavarṇatrayātmatriguṇavapuṣi praṇave	kāra makāra ākhya hrasva dīrgha pluta varṇa traya ātma triguṇa vapuṣi praṇave 
SA_MBSAAMBAPA__NCAASIKAAhk-198	viśvavedyāvibhāgavedanātmā binduriti	viśva vedya a vibhāga vedana ātmā binduḥ iti 
SA_MBSAAMBAPA__NCAASIKAAhk-199	tadupalakṣitonmanāntāprameyaparipāṭīrūpaṃ yasya tādṛg brahma bṛhad	tad upalakṣita unmanā anta aprameya paripāṭī rūpam yasya tādṛś brahma bṛhat 
SA_MBSAAMBAPA__NCAASIKAAhk-200	bṛṃhakaṃ ca śāktateja ārūḍhamatyutkṛṣṭatayā vyavasthitam | yacca	bṛṃhakam ca śākta tejaḥ ārūḍham ati utkṛṣṭa tayā vyavasthitam yat ca 
SA_MBSAAMBAPA__NCAASIKAAhk-201	paramamasāmānyam | yogīndrāṇāṃ mitayogyatiśāyiparatattvaikabhājāṃ	paramam asāmānyam yogi indrāṇām mita yogi atiśāyi para tattva eka bhājām 
SA_MBSAAMBAPA__NCAASIKAAhk-202	nirvāṇamārgo jīvanmuktyupāyo bhāti svaprakāśatayā sphurati | trayyāḥ	                       
SA_MBSAAMBAPA__NCAASIKAAhk-203	prāṅnirṇītāyā ādhāra āśrayaḥ | prakarṣeṇa nūyate utkṛṣṭatayā vimṛśyate	prāc nirṇītāyāḥ ādhāraḥ āśrayaḥ prakarṣeṇa nūyate utkṛṣṭa tayā vimṛśyate 
SA_MBSAAMBAPA__NCAASIKAAhk-204	paraṃ pārameśvaraṃ svarūpaṃ yeneti kṛtvā praṇava ityetannāma yat |	param pārameśvaram svarūpam yena iti kṛtvā praṇavaḥ iti etat nāma yat 
SA_MBSAAMBAPA__NCAASIKAAhk-205	bāhye'pyarkamaṇḍale navayojanasāhasro vigraho'rkasya maṇḍalam |	bāhye api arka maṇḍale nava yojana sāhasraḥ vigraha ūrkasya maṇḍalam 
SA_MBSAAMBAPA__NCAASIKAAhk-206	triguṇam iti svacchandādiṣṭanītyā yatra bindurūpamiti sitavartulākāraṃ	triguṇam iti svacchandāt iṣṭa nītyā yatra bindu rūpam iti sita vartula ākāram 
SA_MBSAAMBAPA__NCAASIKAAhk-207	brahmamayaṃ tadasāmānyaṃ bimbamārūḍham | tacca yogināṃ	brahma mayam tat asāmānyam bimbam ārūḍham tat ca yoginām 
SA_MBSAAMBAPA__NCAASIKAAhk-208	nirvāṇamārgaḥ, teṣāṃ hi sūryamaṇḍalabhedanasya śravaṇāt | tathā	nirvāṇa mārgaḥ teṣām hi sūrya maṇḍala bhedanasya śravaṇāt tathā 
SA_MBSAAMBAPA__NCAASIKAAhk-209	vakṣyamāṇadṛśā sāmargyajurmayadhāmamaṇḍalākṛtitvāt trayyādhāraḥ |	vakṣyamāṇa dṛśā sāma ṛc yajuḥ maya dhāma maṇḍala ākṛti tvāt trayī ādhāraḥ 
SA_MBSAAMBAPA__NCAASIKAAhk-210	prakarṣeṇa nūyamānatvātpraṇavo viśva śarītvācca praṇavaḥ || 7 ||	prakarṣeṇa nūyamāna tvāt praṇavaḥ praṇavaḥ 
SA_MBSAAMBAPA__NCAASIKAAhk-211	yasmin somaḥ surapitṛnarairanvahaṃ pīyamānaḥ	yasmin somaḥ sura pitṛ naraiḥ anvaham pīyamānaḥ 
SA_MBSAAMBAPA__NCAASIKAAhk-212	kṣīṇaḥ kṣīṇaḥ praviśati yato vardhate cāpi bhūyaḥ |	kṣīṇaḥ kṣīṇaḥ praviśati yatas vardhate ca api bhūyas 
SA_MBSAAMBAPA__NCAASIKAAhk-213	yasmin vedā madhuni saraghākāravadbhānti cāgre	yasmin vedāḥ madhuni saraghā ākāra vat bhānti ca agre 
SA_MBSAAMBAPA__NCAASIKAAhk-214	taccaṇḍāṃśoramitamamṛtaṃ maṇḍalasthaṃ prapadye || 8 ||	tat caṇḍāṃśoḥ amitam amṛtam maṇḍala stham prapadye 
SA_MBSAAMBAPA__NCAASIKAAhk-215	cidbhānormaṇḍalasthaṃ madhyadhāmaniviṣṭaṃ	cidbhānoḥ maṇḍala stham madhya dhāma niviṣṭam 
SA_MBSAAMBAPA__NCAASIKAAhk-216	tatparamānandarūpamamitamanalpamamṛtaṃ prapadye samāśraye | yatrāmṛte	tat paramānanda rūpam amitam analpam amṛtam prapadye samāśraye yatra amṛte 
SA_MBSAAMBAPA__NCAASIKAAhk-217	somaḥ sarvo meyavargaḥ surādibhiḥ sarvaiḥ pramātṛbhiḥ pratidinaṃ	somaḥ sarvaḥ meya vargaḥ sura ādibhiḥ sarvaiḥ pramātṛbhiḥ pratidinam 
SA_MBSAAMBAPA__NCAASIKAAhk-218	kalāgrāsayuktyā pīyamānatvāt kṣīṇaḥ kṣīṇaḥ san punaḥ punaḥ praviśati	kalā grāsa yuktyā pīyamāna tvāt kṣīṇaḥ kṣīṇaḥ san punar punar praviśati 
SA_MBSAAMBAPA__NCAASIKAAhk-219	hṛdviśrāntyanantaraṃ nimajjati | yata eva maṇḍalād bhūyo'pi	hṛd viśrānti anantaram nimajjati yatas eva maṇḍalāt bhūyas api 
SA_MBSAAMBAPA__NCAASIKAAhk-220	vardhate'bhivyajyate meyarūpaścandraḥ | yasmiṃśca vedāḥ sarvaśāstrāṇi	vardhate abhivyajyate meya rūpaḥ candraḥ yasmin ca vedāḥ sarva śāstrāṇi 
SA_MBSAAMBAPA__NCAASIKAAhk-221	madhuni mākṣike saraghāṇāṃ madhukarīṇāmākāra ivāgre bhānti puraḥ	madhuni mākṣike saraghāṇām madhukarīṇām ākāre iva agre bhānti puras 
SA_MBSAAMBAPA__NCAASIKAAhk-222	sphuranti | yathā saraghā mākṣikaṃ saṃcitya parivṛttya sollāsamāsate, tathā	sphuranti yathā saraghāḥ mākṣikam saṃcitya parivṛttya sa ullāsam āsate tathā 
SA_MBSAAMBAPA__NCAASIKAAhk-223	sarve vedā vākyaikavākyatayā parādvayamamṛtamāmṛśya bhrājante |	sarve vedāḥ vākya eka vākya tayā parā dvayam amṛtam āmṛśya bhrājante 
SA_MBSAAMBAPA__NCAASIKAAhk-224	bāhyo'pi somaḥ kṛṣṇapakṣeṣu	bāhyaḥ api somaḥ kṛṣṇapakṣeṣu 
SA_MBSAAMBAPA__NCAASIKAAhk-225	pitṛdevanaragrastakalāpañcadaśako'māvāsyāyāṃ sūryamaṇḍalaṃ praviśya	pitṛ deva nara grasta kalā pañcadaśaka umāvāsyāyām sūrya maṇḍalam praviśya 
SA_MBSAAMBAPA__NCAASIKAAhk-226	vardhate | vedāścārkajyotirlagnā āsate || 8 ||	vardhate vedāḥ ca arka jyotiḥ lagnāḥ āsate 
SA_MBSAAMBAPA__NCAASIKAAhk-227	aindrīmāśāṃ pṛthukavapuṣā pūrayitvā krameṇa	aindrīm āśām pṛthuka vapuṣā pūrayitvā krameṇa 
SA_MBSAAMBAPA__NCAASIKAAhk-228	krāntāḥ sapta prakaṭahariṇā yena pādena lokāḥ |	krāntāḥ sapta prakaṭa hariṇāḥ yena pādena lokāḥ 
SA_MBSAAMBAPA__NCAASIKAAhk-229	kṛtvā dhvāntaṃ vigalitabalivyaktipātālalīnaṃ	kṛtvā dhvāntam vigalita bali vyakti pātāla līnam 
SA_MBSAAMBAPA__NCAASIKAAhk-230	viśvālokaḥ sa jayati raviḥ sattvamevordhvaraśmiḥ || 9 ||	viśva ālokaḥ sa jayati raviḥ sattvam eva ūrdhva raśmiḥ   
SA_MBSAAMBAPA__NCAASIKAAhk-231	yo hi yasmād guṇotkṛṣṭaḥ sa tasmādūrdhvamiṣyate iti sthityā	yaḥ hi yasmāt guṇa utkṛṣṭaḥ sa tasmāt ūrdhvam iṣyate iti sthityā 
SA_MBSAAMBAPA__NCAASIKAAhk-232	ūrdhvā viśvotkṛṣṭā raśmayo yasya | ata eva satāṃ	ūrdhvāḥ viśva utkṛṣṭāḥ raśmayaḥ yasya atas eva satām 
SA_MBSAAMBAPA__NCAASIKAAhk-233	vidyamānānāmaśeṣāṇāṃ bhāvaḥ sattvaṃ mahāprakāśātmarūpam |	vidyamānānām aśeṣāṇām bhāvaḥ sattvam mahā prakāśa ātma rūpam 
SA_MBSAAMBAPA__NCAASIKAAhk-234	tadeva tatparamārthaḥ | tataśca prakāśamānatayā prakāśātmanyeva viśvasya	tat eva tat paramārthaḥ tatas ca prakāśamāna tayā prakāśa ātmani eva viśvasya 
SA_MBSAAMBAPA__NCAASIKAAhk-235	magnatvāt prakāśo viśvālokaḥ sa eva raviścidbhānurjayati sarvotkarṣeṇa vartate	magna tvāt prakāśaḥ viśva ālokaḥ saḥ eva raviḥ cit bhānuḥ jayati sarva utkarṣeṇa vartate 
SA_MBSAAMBAPA__NCAASIKAAhk-236	| yenaindrīmāśāṃ prācyonmeṣadaśāṃ pṛthukavapuṣā	yena aindrīm āśām prācyā unmeṣa daśām pṛthuka vapuṣā 
SA_MBSAAMBAPA__NCAASIKAAhk-237	yogigamyasūkṣmaśāktaspandātmanā pūrayitvā	yogi gamya sūkṣma śākta spanda ātmanā pūrayitvā 
SA_MBSAAMBAPA__NCAASIKAAhk-238	unmiṣitaprāṇādisaṃkocacitprādhānyocchalitāṃ kṛtvā	unmiṣita prāṇa ādi saṃkoca cit prādhānya ucchalitām kṛtvā 
SA_MBSAAMBAPA__NCAASIKAAhk-239	śivādisakalātmāntāḥ śaktimantaḥ prakīrtitāḥ iti śrīpūrvādiṣṭanītyā	śiva ādi sakala ātma antāḥ śaktimantaḥ prakīrtitāḥ iti śrī pūrvāt iṣṭa nītyā 
SA_MBSAAMBAPA__NCAASIKAAhk-240	śivamantramaheśvaramantreśvaramantravijñānākalapralayākalasakalākhyāḥ	                               
SA_MBSAAMBAPA__NCAASIKAAhk-241	kramātkramaṃ prāṇīyatuṭisthā nijaśaktisahitāḥ saptalokāḥ pādo'sya viśvā	kramāt kramam prāṇīya tuṭi sthāḥ nija śakti sahitāḥ sapta lokāḥ pādaḥ usya viśvā 
SA_MBSAAMBAPA__NCAASIKAAhk-242	bhūtāni iti sthityā pādena nijāṃśamātreṇākrāntāḥ kroḍīkṛtya	bhūtāni iti sthityā pādena nija aṃśa mātreṇa ākrāntāḥ kroḍīkṛtya 
SA_MBSAAMBAPA__NCAASIKAAhk-243	svajyotirmayīkṛtāḥ | kīdṛśena ? prakaṭāḥ svātmābhāsā	sva jyotiḥ mayīkṛtāḥ kīdṛśena prakaṭāḥ sva ātma ābhāsā 
SA_MBSAAMBAPA__NCAASIKAAhk-244	rūpādiviśvaharaṇāddharayaścakṣurādiśaktayo yasya | taduktaṃ śrutau - yuktā	rūpa ādi viśva haraṇāt harayaḥ cakṣuḥ ādi śaktayaḥ yasya tat uktam śrutau yuktā 
SA_MBSAAMBAPA__NCAASIKAAhk-245	hyasya harayaḥ śatā daśa iti | niḥsaṃkhyaśaktirātmeti hyasyārthaḥ | kathaṃ	hi asya harayaḥ śatāḥ daśa iti niḥsaṃkhya śaktiḥ ātmā iti hi asya arthaḥ katham 
SA_MBSAAMBAPA__NCAASIKAAhk-246	krāntāḥ ? dhvāntamātmanyanātmapratītyātmājñānaṃ vigalitā	krāntāḥ dhvāntam ātmani anātma pratīti ātma ajñānam vigalitā 
SA_MBSAAMBAPA__NCAASIKAAhk-247	baliranātmanyātmābhidhāyinī vyaktiryasya tādṛk pātālalīnaṃ	baliḥ anātmani ātma abhidhāyinī vyaktiḥ yasya tādṛś pātāla līnam 
SA_MBSAAMBAPA__NCAASIKAAhk-248	niḥśeṣapraśamitaṃ kṛtvā | bāhyenāpyarkeṇa saptāśvārūḍhenaindrīṃ	niḥśeṣa praśamitam kṛtvā bāhyena api arkeṇa sapta aśva ārūḍhena aindrīm 
SA_MBSAAMBAPA__NCAASIKAAhk-249	diśaṃ sūkṣmarūpeṇāpūrya bhūrādilokāḥ pādena marīcibhirdhvāntaṃ	diśam sūkṣma rūpeṇa āpūrya bhūḥ ādi lokāḥ pādena marīcibhiḥ dhvāntam 
SA_MBSAAMBAPA__NCAASIKAAhk-250	dhvaṃsayitvā krameṇa krāntāḥ | prakaṭahariṇā ca nārāyaṇena vigalitā	dhvaṃsayitvā krameṇa krāntāḥ prakaṭa hariṇā ca nārāyaṇena vigalitā 
SA_MBSAAMBAPA__NCAASIKAAhk-251	balyākhyasya dānavendrasya vyaktiryatra taddhvāntaṃ dānavakulaṃ	bali ākhyasya dānava indrasya vyaktiḥ yatra tat hvāntam dānava kulam 
SA_MBSAAMBAPA__NCAASIKAAhk-252	pātālalīnaṃ kṛtvā bhūrādilokāścaraṇavinyāsakrameṇākrāntāḥ | kiṃ	pātāla līnam kṛtvā bhūḥ ādi lokāḥ caraṇa vinyāsa krameṇa ākrāntāḥ kim 
SA_MBSAAMBAPA__NCAASIKAAhk-253	kṛtvā ? pṛthukavapuṣā bālavāmanaśarīreṇa indrādidigāpūraṇaṃ kṛtvā |	kṛtvā pṛthuka vapuṣā bāla vāmana śarīreṇa indra ādi diś āpūraṇam kṛtvā 
SA_MBSAAMBAPA__NCAASIKAAhk-254	so'pi viśvālokaḥ sattvapradhānaścetyatra śleṣālaṅkāraḥ |	saḥ api viśva ālokaḥ sattva pradhānaḥ ca iti atra śleṣa alaṅkāraḥ 
SA_MBSAAMBAPA__NCAASIKAAhk-255	śleṣopamādhvanisaṃsṛṣṭiriyam || 9 ||	śleṣa upamā dhvani saṃsṛṣṭiḥ iyam 
SA_MBSAAMBAPA__NCAASIKAAhk-256	dhyātvā brahma prathamamatanu prāṇamūle nadantaṃ	dhyātvā brahma prathamam atanu prāṇa mūle nadantam 
SA_MBSAAMBAPA__NCAASIKAAhk-257	dṛṣṭvā cāntaḥ praṇavamukharaṃ vyāhṛtīḥ samyaguktvā |	dṛṣṭvā ca antar praṇava mukharam vyāhṛtīḥ samyak uktvā 
SA_MBSAAMBAPA__NCAASIKAAhk-258	yattadvede taditi saviturbrahmaṇoktaṃ vareṇyaṃ	yat tat vede tat iti savituḥ brahmaṇā uktam vareṇyam 
SA_MBSAAMBAPA__NCAASIKAAhk-259	tadbhargākhyaṃ kimapi paramaṃ dhāmagarbhaṃ prapadye || 10 ||	tat bharga ākhyam kim api paramam dhāma garbham prapadye 
SA_MBSAAMBAPA__NCAASIKAAhk-260	brahmaṇā prajāpatinā vedeṣu praṇavamukharamoṅkāroccāraṇapūrva	brahmaṇā prajāpatinā vedeṣu 
SA_MBSAAMBAPA__NCAASIKAAhk-261	tadityādi gāyatryāḥ saviturviśvaprasūtihetościdādityasya	tat ityādi gāyatryāḥ savituḥ viśva prasūti hetoḥ cit ādityasya 
SA_MBSAAMBAPA__NCAASIKAAhk-262	yattatkimapītyasāmānyaṃ bharga ityākhyā yasya tatparamaṃ sarvotkṛṣṭaṃ	yat tat kim api iti asāmānyam bhargaḥ iti ākhyā yasya tat paramam sarva utkṛṣṭam 
SA_MBSAAMBAPA__NCAASIKAAhk-263	dhāma parisphurattātma śāktaṃ tejo	dhāma śāktam tejaḥ 
SA_MBSAAMBAPA__NCAASIKAAhk-264	bāhyasūryasomavahnyādidhāmakroḍīkāritvāddhāmagarbhaṃ	bāhya sūrya soma vahni ādi dhāma kroḍīkāri tvāt dhāmagarbham 
SA_MBSAAMBAPA__NCAASIKAAhk-265	vareṇyamanugrahakāri ukta tatprapadye samāviśāmi | kiṃ kṛtvā brahmaṇoktam ?	vareṇyam anugraha kāri ukta tat prapadye samāviśāmi kim kṛtvā brahmaṇā uktam 
SA_MBSAAMBAPA__NCAASIKAAhk-266	kiṃ kṛtvā ca prapadye ? prathamamādāvatanu aśarīraṃ	kim kṛtvā ca prapadye prathamam ādau atanu aśarīram 
SA_MBSAAMBAPA__NCAASIKAAhk-267	śrībhargaśikhādiṣṭanītyā akāraparāmarśātma vīreśvarākhyaṃ ca brahma	śrī bhargaśikha ādiṣṭa nītyā akāra parāmarśa ātma vīreśvara ākhyam ca brahma 
SA_MBSAAMBAPA__NCAASIKAAhk-268	bṛhad bṛṃhakaṃ ca paraṃ śāktaṃ dhāma prāṇamūle	bṛhat bṛṃhakam ca param śāktam dhāma prāṇa mūle 
SA_MBSAAMBAPA__NCAASIKAAhk-269	aprāṇādyasphurattādhāmni dhyātvā vicintyānantaraṃ nadantamiti nādākhyaṃ	                                                                                             
SA_MBSAAMBAPA__NCAASIKAAhk-270	paravimarśātmānamantarityuktaśāktarūpaprāṇitakalpatayā sthitaṃ dṛṣṭvā	para vimarśa ātmānam antar iti ukta śākta rūpa prāṇita kalpa tayā sthitam dṛṣṭvā 
SA_MBSAAMBAPA__NCAASIKAAhk-271	svātmatayā sākṣātkṛtya	sva ātma tayā sākṣātkṛtya 
SA_MBSAAMBAPA__NCAASIKAAhk-272	tannādavimarśānupraveśāvaṣṭambhabalonmiṣatpraṇavoccāraṇapūrvam | tathā	tat nāda vimarśa anupraveśa avaṣṭambha bala unmiṣat praṇava uccāraṇa pūrvam tathā 
SA_MBSAAMBAPA__NCAASIKAAhk-273	bhūḥ svāhā bhuvaḥ svāhā svaḥ svāhā bhurbhūvaḥ svaḥ svāhā iti ca	bhūḥ svāhā bhuvaḥ svāhā svar svāhā bhuḥ bhūvaḥ svar svāhā iti ca 
SA_MBSAAMBAPA__NCAASIKAAhk-274	mantrarūpā samagrameyamānapramātṝṇāṃ sasaṃskārāṇāṃ	mantra rūpā samagra meya māna pramātṝṇām sa saṃskārāṇām 
SA_MBSAAMBAPA__NCAASIKAAhk-275	parabrahmamayatvāmarśinīrvyāhṛtīścatasraḥ	para brahma maya tva āmarśinīḥ vyāhṛtīḥ catasraḥ 
SA_MBSAAMBAPA__NCAASIKAAhk-276	samyagityantarāmarśāvaṣṭambhāśaithilyenoktvā uccārya | atha ca	samyak iti antar āmarśa avaṣṭambha aśaithilyena uktvā uccārya atha ca 
SA_MBSAAMBAPA__NCAASIKAAhk-277	sarvavyavahārānekarūpāḥ kathā japaḥ iti śivasūtrādiṣṭanītyā	sarva vyavahāra aneka rūpāḥ kathā japaḥ iti śivasūtra ādiṣṭa nītyā 
SA_MBSAAMBAPA__NCAASIKAAhk-278	tadabhedāmarśapradhānatayā  paraśāktarasaplāvitān saṃpādya |	tad abheda āmarśa pradhāna tayā para śākta rasa plāvitān saṃpādya 
SA_MBSAAMBAPA__NCAASIKAAhk-279	śāktadhāmaikāgryavaśāsāditaśāmbhavadhāmāvaṣṭambhabalena	śākta dhāma aikāgrya vaśa āsādita śāmbhava dhāma avaṣṭambha balena 
SA_MBSAAMBAPA__NCAASIKAAhk-280	vyutthānadaśāmapi tadabhedarasaprokṣitāṃ vidhāyetyarthaḥ |	vyutthāna daśām api tad abheda rasa prokṣitām vidhāya iti arthaḥ 
SA_MBSAAMBAPA__NCAASIKAAhk-281	dhāmagarbhamityatra dhāmaśabdastantreṇa dviruktaḥ | tathā praṇavamukharamiti ||	dhāma garbham iti atra dhāma śabdaḥ tantreṇa dvis uktaḥ tathā praṇava mukharam iti 
SA_MBSAAMBAPA__NCAASIKAAhk-282	tvāṃ stoṣyāmi stutibhiriti me yastu bhedagraho'yaṃ	tvām stoṣyāmi stutibhiḥ iti me yaḥ tu bheda grahaḥ yam 
SA_MBSAAMBAPA__NCAASIKAAhk-283	saivāvidyā tadapi sutarāṃ tadvināśāya yuktaḥ |	sā eva avidyā tat api sutarām tad vināśāya yuktaḥ 
SA_MBSAAMBAPA__NCAASIKAAhk-284	staumyevāhaṃ trividhamuditaṃ sthūlasūkṣmaṃ paraṃ vā	staumi eva aham trividham uditam sthūla sūkṣmam param vā 
SA_MBSAAMBAPA__NCAASIKAAhk-285	vidyopāyaḥ para iti budhairgīyate khalvavidyā || 11 ||	vidyā upāyaḥ paraḥ iti budhaiḥ gīyate khalu avidyā 
SA_MBSAAMBAPA__NCAASIKAAhk-286	he bhagavan, tvāṃ stutibhiḥ stoṣyāmīti stotṛstutyastutikalpanātmā yo me	he bhagavan tvām stutibhiḥ stoṣyāmi iti stotṛ stutya stuti kalpanā ātmā yaḥ me 
SA_MBSAAMBAPA__NCAASIKAAhk-287	bhedagraha eṣaiva cidadvayāprathanātmāvidyā, tathāpi tasyā avidyāyāḥ	bheda grahaḥ eṣā eva cit advaya aprathana ātmā avidyā tathā api tasyāḥ avidyāyāḥ 
SA_MBSAAMBAPA__NCAASIKAAhk-288	sutarāmatiśayena vināśāya niḥśeṣonmūlanāya yukto nityasaṃbaddhastvāṃ	sutarām atiśayena vināśāya niḥśeṣa unmūlanāya yuktaḥ nitya saṃbaddhaḥ tvām 
SA_MBSAAMBAPA__NCAASIKAAhk-289	staumyeva dehādipramātṛtānimajjanena sarvotkṛṣṭatayā satataṃ parāmṛśāmi,	staumi eva deha ādi pramātṛ tā nimajjanena sarva utkṛṣṭa tayā satatam parāmṛśāmi 
SA_MBSAAMBAPA__NCAASIKAAhk-290	na tu kṣaṇamapyudāsīna āse | tvāmeva cidarkaṃ staumi na tu parimitāṃ	na tu kṣaṇam api udāsīnaḥ āse tvām eva cit arkam staumi na tu parimitām 
SA_MBSAAMBAPA__NCAASIKAAhk-291	kāñcana devatām | kīdṛśaṃ tvām ? sthūlaṃ bāhyaprāṇārkarūpam |	kāñcana devatām kīdṛśam tvām sthūlam bāhya prāṇa arka rūpam 
SA_MBSAAMBAPA__NCAASIKAAhk-292	sūkṣmaṃ madhyanāḍīgataṃ prāṇabrahmarūpam | paraṃ cānavacchinnaṃ	sūkṣmam madhyanāḍī gatam prāṇa brahma rūpam param ca anavacchinnam 
SA_MBSAAMBAPA__NCAASIKAAhk-293	viśvātmacidānandaghanam | taditi prāktanavākyavyāvarṇitamekameva |	                                   
SA_MBSAAMBAPA__NCAASIKAAhk-294	nityoditaṃ ca | vāśabdaścārthe | yuktaṃ caitat | yato budhaistattvajñairavidyaiva	nityoditam ca vā śabdaḥ ca arthe yuktam ca etat yatas budhaiḥ tattva jñaiḥ avidyā eva 
SA_MBSAAMBAPA__NCAASIKAAhk-295	vidyopāyaḥ para ityuktaḥ | stotrastutyādivibhāgakalpanātmāvidyayā	vidyā upāyaḥ paraḥ iti uktaḥ stotra stutya ādi vibhāga kalpanā ātma avidyayā 
SA_MBSAAMBAPA__NCAASIKAAhk-296	samastāvidyābījadehādipramātṛtvābhimānapraśamanena	                                   
SA_MBSAAMBAPA__NCAASIKAAhk-297	cidānandaghanaparamātmotkarṣaparāmarśātmā stutiḥ	                       
SA_MBSAAMBAPA__NCAASIKAAhk-298	paramasamāveśapradetyarthaḥ || 11 ||	         
SA_MBSAAMBAPA__NCAASIKAAhk-299	staumyevetyuktiṃ prapañcayati -	staumi eva iti uktim prapañcayati 
SA_MBSAAMBAPA__NCAASIKAAhk-300	yo'nādyanto'pyatanuraguṇo'ṇoraṇīyān mahīyān	yona ādi antaḥ upi a tanuḥ a guṇa uṇoḥ aṇīyān mahīyān 
SA_MBSAAMBAPA__NCAASIKAAhk-301	viśvākāraḥ saguṇa iti vā kalpanākalpitāṅgaḥ |	viśva ākāraḥ sa guṇaḥ iti vā kalpanā kalpita aṅgaḥ 
SA_MBSAAMBAPA__NCAASIKAAhk-302	nānābhūtaprakṛtivikṛtīrdarśayan bhāti yo vā	nānā bhūta prakṛti vikṛtīḥ darśayan bhāti yaḥ vā 
SA_MBSAAMBAPA__NCAASIKAAhk-303	tasmai tasmai bhavatu paramāditya nityaṃ namaste || 12 ||	tasmai tasmai bhavatu parama āditya nityam namaḥ te   
SA_MBSAAMBAPA__NCAASIKAAhk-304	he paramāditya cidarka, tasmai tasmai iti parasūkṣmasthūlarūpāya	he parama āditya cit arka tasmai tasmai iti para sūkṣma sthūla rūpāya 
SA_MBSAAMBAPA__NCAASIKAAhk-305	viśvātmane tubhyaṃ nityaṃ namaḥ | sarvakālaṃ dehādiprahvatayā	viśvātmane tubhyam nityam namaḥ sarvakālam deha ādi prahva tayā 
SA_MBSAAMBAPA__NCAASIKAAhk-306	parāmṛśaṃstvāmeva samāviśāmītyarthaḥ | kīdṛśāya tasmai ? yo anādyanto	parāmṛśan tvām eva samāviśāmi iti arthaḥ kīdṛśāya tasmai 
SA_MBSAAMBAPA__NCAASIKAAhk-307	deśakālādyanavacchinnaḥ | atanurākārāniyantritaḥ | ataśca	deśa kāla ādi anavacchinnaḥ a tanuḥ ākāra a niyantritaḥ atas ca 
SA_MBSAAMBAPA__NCAASIKAAhk-308	sārvajñādiguṇāspṛṣṭaḥ | aṇoratyantasūkṣmarūpatayā yogidṛśyāt	sārvajña ādi guṇa āspṛṣṭaḥ aṇoḥ atyanta sūkṣma rūpa tayā yogi dṛśyāt 
SA_MBSAAMBAPA__NCAASIKAAhk-309	paramāṇorapyaṇīyānatisūkṣmaḥ na kasyāpi vedyaḥ | api tu	paramāṇoḥ api aṇīyān ati sūkṣmaḥ na kasya api vedyaḥ api tu 
SA_MBSAAMBAPA__NCAASIKAAhk-310	svaprakāśacidekarūpaḥ na tu deśataḥ saṃkucitaḥ | paramāṇoḥ sūkṣmasya	sva prakāśa cit eka rūpaḥ na tu deśataḥ saṃkucitaḥ paramāṇoḥ sūkṣmasya 
SA_MBSAAMBAPA__NCAASIKAAhk-311	vedyatvād dṛśyatvācca | mahīyān vyāpakaḥ | ataśca	vedya tvāt dṛśya tvāt ca mahīyān vyāpakaḥ atas ca 
SA_MBSAAMBAPA__NCAASIKAAhk-312	viśvakroḍīkāritvādviśvākāraḥ | sārvajñādiguṇayogāt saguṇaḥ | ityevaṃ	viśva kroḍīkāri tvāt viśva ākāraḥ sārvajña ādi guṇa yogāt sa guṇaḥ iti evam 
SA_MBSAAMBAPA__NCAASIKAAhk-313	prakārayā kalpanayā  kalpitāni pṛthakpṛthagullikhitānyaṅgāni	prakārayā kalpanayā kalpitāni pṛthak pṛthak ullikhitāni aṅgāni 
SA_MBSAAMBAPA__NCAASIKAAhk-314	tattaddharmarūpā avayavabhāgā yasya tādṛg	tad tad dharma rūpāḥ avayava bhāgāḥ yasya tādṛś 
SA_MBSAAMBAPA__NCAASIKAAhk-315	vetyanayoktyā'vacchinnavastuviṣayaśabdavikalpāsaṃspṛṣṭaṃ paramekaṃ	vā iti anayā uktyā avacchinna vastu viṣaya śabda vikalpa asaṃspṛṣṭam param ekam 
SA_MBSAAMBAPA__NCAASIKAAhk-316	svarūpamanavacchinnamiti dhvanayati | nānābhūtāni vicitrāḥ	sva rūpam anavacchinnam iti dhvanayati nānā bhūtāni vicitrāḥ 
SA_MBSAAMBAPA__NCAASIKAAhk-317	sthāvarādibrahmāṇḍāntāḥ prāṇinasteṣāṃ	sthāvara ādi brahmāṇḍa antāḥ prāṇinaḥ teṣām 
SA_MBSAAMBAPA__NCAASIKAAhk-318	prakṛtīrmāyāprakṛtiśukraśoṇitādikāraṇāni, vikṛtīḥ kalābuddhidehādikān	prakṛtīḥ māyā prakṛti śukra śoṇita ādi kāraṇāni vikṛtīḥ kalā buddhi deha ādikān 
SA_MBSAAMBAPA__NCAASIKAAhk-319	darśayan ya ābhāti | saṃkucitasarvābhāsollāsakatayā vā yaḥ sphuratītyarthaḥ ||	darśayan yaḥ ābhāti saṃkucita sarva ābhāsa ullāsaka tayā vā yaḥ sphurati iti arthaḥ 
SA_MBSAAMBAPA__NCAASIKAAhk-320	tattvākhyāne tvayi munijanā neti neti bruvantaḥ	tattva ākhyāne tvayi muni janāḥ na iti na iti bruvantaḥ 
SA_MBSAAMBAPA__NCAASIKAAhk-321	śrāntāḥ samyak tvamiti na ca tairīdṛśo veti coktaḥ |	śrāntāḥ samyak tvam iti na ca taiḥ īdṛśaḥ vā iti ca uktaḥ 
SA_MBSAAMBAPA__NCAASIKAAhk-322	tasmāttubhyaṃ nama iti vacomātramevāsmi vacmi	tasmāt tubhyam namaḥ iti vacaḥ mātram eva asmi vacmi 
SA_MBSAAMBAPA__NCAASIKAAhk-323	prāyo yasmātprasaratitarāṃ bhāratī jñānagarbhā || 13 ||	prāyas yasmāt prasaratitarām bhāratī jñāna garbhā 
SA_MBSAAMBAPA__NCAASIKAAhk-324	yasmāttvatto bhāratī paśyantyādivāk jñānagarbhā	yasmāt tvattaḥ bhāratī paśyantī ādi vāc jñāna garbhā 
SA_MBSAAMBAPA__NCAASIKAAhk-325	svāvabhāsasaṃvitpradhānā prasarati tasmai tubhyaṃ nama iti vacomātrameva, na	sva avabhāsa saṃvid pradhānā prasarati tasmai tubhyam namaḥ iti vacaḥ mātram eva na 
SA_MBSAAMBAPA__NCAASIKAAhk-326	tvatiriktaṃ stutivākyādi vacmi | jñānasya sarvavākprasarahetoranavacchinnasya	tu atiriktam stuti vākya ādi vacmi jñānasya sarva vāc prasara hetoḥ anavacchinnasya 
SA_MBSAAMBAPA__NCAASIKAAhk-327	vibhinnastutivāgbhiḥ stotumaśakyatvāt | namaḥśabdena tu dehādiprahvatāṃ	vibhinna stuti vāgbhiḥ stotum aśakya tvāt namaḥ śabdena tu deha ādi prahva tām 
SA_MBSAAMBAPA__NCAASIKAAhk-328	turīyakasvacitprakarṣaparāmarśanasya kartuṃ śakyatvāt | yuktaṃ caitat |	turīyaka sva cit prakarṣa parāmarśanasya kartum śakya tvāt yuktam ca etat 
SA_MBSAAMBAPA__NCAASIKAAhk-329	yasmānmunayo'pi tvayi tvadviṣaye tattvākhyāne aṇurna mahān na hrasvaṃ	yasmāt munayaḥ api tvayi tvad viṣaye tattva ākhyāne aṇuḥ na mahān na hrasvam 
SA_MBSAAMBAPA__NCAASIKAAhk-330	dīrghaṃ netyādi bruvantaḥ śrāntāḥ kliṣṭāḥ | na ca taistvamityevaṃvidho'sīti	dīrgham na ityādi bruvantaḥ śrāntāḥ kliṣṭāḥ na ca taiḥ tvam iti evaṃvidhā asi iti 
SA_MBSAAMBAPA__NCAASIKAAhk-331	etādṛśo veti etattulyo veti samyaguktaḥ | vāgagocaratvādevetyarthaḥ || 13 ||	etādṛśaḥ vā iti etad tulyaḥ vā iti samyak uktaḥ vāc agocara tvāt eva iti arthaḥ   
SA_MBSAAMBAPA__NCAASIKAAhk-332	sarvāṅgīṇaḥ sakalavapuṣāmantare yo'ntarātmā	sarvāṅgīṇaḥ sakala vapuṣām antare yaḥ ntarātmā 
SA_MBSAAMBAPA__NCAASIKAAhk-333	tiṣṭhan kāṣṭhe dahana iva no dṛśyase yuktiśūnyaiḥ |	tiṣṭhan kāṣṭhe dahanaḥ iva no dṛśyase yukti śūnyaiḥ 
SA_MBSAAMBAPA__NCAASIKAAhk-334	yaśca prāṇāraṇiṣu niyatairmathyamānāsu sadbhi-	yaḥ ca prāṇa araṇiṣu niyataiḥ mathyamānāsu 
SA_MBSAAMBAPA__NCAASIKAAhk-335	rdṛśyaṃ jyotirbhavasi paramāditya tasmai namaste || 14 ||	rdṛśyam jyotiḥ bhavasi parama āditya tasmai namaḥ te 
SA_MBSAAMBAPA__NCAASIKAAhk-336	he paramāditya cidarka, tasmai nirviśeṣāya te tubhyaṃ namaḥ | yastvaṃ	he parama āditya cit arka tasmai nirviśeṣāya te tubhyam namaḥ yaḥ tvam 
SA_MBSAAMBAPA__NCAASIKAAhk-337	sthāvarādidevayonyantānāṃ rudrakṣetrajñānāṃ ca sarveṣāṃ sarvāṅgeṣu	sthāvara ādi devayoni antānām rudra kṣetrajñānām ca sarveṣām sarva aṅgeṣu 
SA_MBSAAMBAPA__NCAASIKAAhk-338	bhavo vyāpakaḥ sakalavapuṣāmantare mitagrāhakātmani svarūpe yo'ntarātmā	bhavaḥ vyāpakaḥ sakala vapuṣām antare mita grāhaka ātmani svarūpe yaḥ ntarātmā 
SA_MBSAAMBAPA__NCAASIKAAhk-339	paramānandatvāt ātmā caivāntarātmā ca iti	parama ānanda tvāt ātmā ca eva antarātmā ca iti 
SA_MBSAAMBAPA__NCAASIKAAhk-340	śrīsvacchandādiṣṭapuryaṣṭakapramātā tiṣṭhannavasthāsnurapi yuktyā yogena	śrī svacchanda ādiṣṭa puryaṣṭaka pramātā tiṣṭhan avasthā snuḥ api yuktyā yogena 
SA_MBSAAMBAPA__NCAASIKAAhk-341	śūnyairapi na dṛśyase | yathā kāṣṭhe'gnistiṣṭhannapi	śūnyaiḥ api na dṛśyase yathā kāṣṭha igniḥ tiṣṭhan api 
SA_MBSAAMBAPA__NCAASIKAAhk-342	yuktiśūnyairaraṇimathanānabhijñairna dṛśyate	yukti śūnyaiḥ araṇi mathana anabhijñaiḥ na dṛśyate 
SA_MBSAAMBAPA__NCAASIKAAhk-343	tatkāṣṭhakavalīkārijvaladrūpatayā nopalabhyate | yaśca tvaṃ prāṇāraṇiṣu	tat kāṣṭha kavalīkāri jvalat rūpa tayā na upalabhyate yaḥ ca tvam prāṇa araṇiṣu 
SA_MBSAAMBAPA__NCAASIKAAhk-344	sarvavāhamārgodaya viśrāntipadeṣu	sarva vāha mārga udaya viśrānti padeṣu 
SA_MBSAAMBAPA__NCAASIKAAhk-345	sadbhiryogibhirniyatairabhiyuktairmathyamānāsu - ūrdhvaśaktinipātācca	sadbhiḥ yogibhiḥ niyataiḥ abhiyuktaiḥ mathyamānāsu  ūrdhva śakti nipātāt ca 
SA_MBSAAMBAPA__NCAASIKAAhk-346	adhaḥśaktinikuñcanāt | rudraśaktisamāveśaṃ yo jānāti sa paṇḍitaḥ ||	adhas śakti nikuñcanāt rudra śakti samāveśam yaḥ jānāti sa paṇḍitaḥ 
SA_MBSAAMBAPA__NCAASIKAAhk-347	ityāmnāyādiṣṭayuktyā'navaratāndolanataḥ praśamitamarudvyāpikāsu	iti āmnāya ādiṣṭa yuktyā anavarata āndolanataḥ praśamita marut vyāpikāsu 
SA_MBSAAMBAPA__NCAASIKAAhk-348	dṛśyaṃ jyotirbhavasi svaprakāśacidrūpaḥ sphurasi | atra paryāyeṇa	dṛśyam jyotiḥ bhavasi sva prakāśa cit rūpaḥ sphurasi atra paryāyeṇa 
SA_MBSAAMBAPA__NCAASIKAAhk-349	prāṇāpānāvurdhvādharāraṇirūpau | yogiprayatno mathanakāṣṭham || 14 ||	prāṇa apānau urdhva adhara araṇi rūpau yogi prayatnaḥ mathana kāṣṭham 
SA_MBSAAMBAPA__NCAASIKAAhk-350	stotā stutyaḥ stutiriti bhavān kartṛkarmakriyātmā	stotā stutyaḥ stutiḥ iti bhavān kartṛ karma kriyā ātmā 
SA_MBSAAMBAPA__NCAASIKAAhk-351	krīḍatyekastava nutividhāvasvatantrastato'ham |	krīḍati ekaḥ tava nuti vidhau asvatantraḥ tatas ham 
SA_MBSAAMBAPA__NCAASIKAAhk-352	yadvā vacmi praṇayasubhagaṃ gopate tacca tathyaṃ	yat vā vacmi praṇaya subhagam gopate tat ca tathyam 
SA_MBSAAMBAPA__NCAASIKAAhk-353	tvatto hyanyatkimiva jagatāṃ vidyate tanmṛṣā syāt || 15 ||	tvattaḥ hi anyat kim iva jagatām vidyate tat mṛṣā syāt 
SA_MBSAAMBAPA__NCAASIKAAhk-354	he gopate cinmarīcicakreśvara, bhavāneko'dvitīyaḥ stotrādirūpatayā	he gopate cit marīci cakra īśvara bhavān ekaḥ dvitīyaḥ stotra ādi rūpa tayā 
SA_MBSAAMBAPA__NCAASIKAAhk-355	krīḍati svasvātantryāttattadrūpatayā sphurati | yaduktaṃ mayaiva	krīḍati sva svātantryāt tad tad rūpa tayā sphurati yat uktam mayā eva 
SA_MBSAAMBAPA__NCAASIKAAhk-356	bhairavānukaraṇastotre - stotā stutyaḥ stutiriti yadapi vibhinnaṃ na	bhairava anukaraṇa stotre stotā stutyaḥ stutiḥ iti yat api vibhinnam na 
SA_MBSAAMBAPA__NCAASIKAAhk-357	kiñcidastīha | mṛśasi yathā yadrūpaṃ cidrūpatayā bhavasyetat || iti |	kiñcid asti iha mṛśasi yathā yad rūpam cit rūpa tayā bhavasi etat iti 
SA_MBSAAMBAPA__NCAASIKAAhk-358	yato'hamiti bhavatkalpitameva | tato'hamiti saṃkocapradhāno māyāpramātā	yatas ham iti bhavat kalpitam eva tatas ham iti saṃkoca pradhānaḥ māyā pramātā 
SA_MBSAAMBAPA__NCAASIKAAhk-359	tvatstotrakaraṇe'svatantrastvāmeva cidātmānaṃ staumi | na tvahaṃ nāmānyaḥ	tvad stotra karaṇe svatantraḥ tvām eva cit ātmānam staumi na tu aham nāma anyaḥ 
SA_MBSAAMBAPA__NCAASIKAAhk-360	kaścidityarthaḥ | yacca kiñcittvadātmaivāhaṃ praṇayasubhagaṃ	kaścid iti arthaḥ yat ca kiñcid tvad ātmā eva aham praṇaya subhagam 
SA_MBSAAMBAPA__NCAASIKAAhk-361	prārthanāsundaraṃ vacmi tatsarvaṃ tathyaṃ tvatparamārthameva |	prārthanā sundaram vacmi tat sarvam tathyam tvad parama artham eva 
SA_MBSAAMBAPA__NCAASIKAAhk-362	yatastvattaścidātmano vyatiriktaṃ jagatāṃ kimiva vidyate ? na kiñcidasti | yadi vā	yatas tvattaḥ cit ātmanaḥ vyatiriktam jagatām kim iva vidyate na kiñcid asti yadi vā 
SA_MBSAAMBAPA__NCAASIKAAhk-363	tathāpi kiñcitsaṃkalpyate tanmṛṣā syāt | naiva bhavet | cidātmatāṃ vinā	tathā api kiñcid saṃkalpyate tat mṛṣā syāt na eva bhavet cit ātma tām vinā 
SA_MBSAAMBAPA__NCAASIKAAhk-364	kasyacidapi cetanā ceti tasya saṃkalpavikalpaviṣayatvasyāpyayogena	kasyacid api cetanā ca iti tasya saṃkalpa vikalpa viṣaya tvasya api ayogena 
SA_MBSAAMBAPA__NCAASIKAAhk-365	gaganakusumato'pi nikṛṣṭatvāt | itthaṃ yuktitastvadabhedasāraiva stutiḥ || 15 ||	                
SA_MBSAAMBAPA__NCAASIKAAhk-366	prātītikakrameṇa tu yadyapi bhedastathāpītthaṃ	prātītika krameṇa tu yadi api bhedaḥ tathā api ittham 
SA_MBSAAMBAPA__NCAASIKAAhk-367	tvamārādhyo'smākamityāha -	tvam ārādhyaḥ smākam iti āha 
SA_MBSAAMBAPA__NCAASIKAAhk-368	jñānaṃ nāntaḥkaraṇarahitaṃ vidyate'smādvidhānāṃ	jñānam na antaḥkaraṇa rahitam vidyate smāt vidhānām 
SA_MBSAAMBAPA__NCAASIKAAhk-369	tvaṃ cātyantaṃ sakalakaraṇāgocaratvādacintyaḥ |	tvam ca atyantam sakala karaṇa agocara tvāt acintyaḥ 
SA_MBSAAMBAPA__NCAASIKAAhk-370	dhyānātītastvamiti na vinā bhaktiyogena labhya-	dhyāna atītaḥ tvam iti na vinā bhakti yogena 
SA_MBSAAMBAPA__NCAASIKAAhk-371	stasmādbhaktiṃ śaraṇamamṛtaprāptaye'haṃ prapannaḥ || 16 ||	s tasmāt bhaktim śaraṇam amṛta prāptayā iham prapannaḥ 
SA_MBSAAMBAPA__NCAASIKAAhk-372	aindriyakajñānavatāṃ māyāpramātṝṇāmasmākamindriyāgocaro	aindriyaka jñānavatām māyā pramātṝṇām asmākam indriya agocaraḥ 
SA_MBSAAMBAPA__NCAASIKAAhk-373	bhavānacintyatvāddhyānaviṣayo na bhavatīti	bhavān acintya tvāt dhyāna viṣayaḥ na bhavati iti 
SA_MBSAAMBAPA__NCAASIKAAhk-374	dehādimitapramātṛtāmajjanonmajjanacidarkabhajanātmakabhaktiyoga-	                               
SA_MBSAAMBAPA__NCAASIKAAhk-375	saṃpādanīyatvādbhagavato bhaktimeva	saṃpādanīya tvāt bhagavataḥ bhaktim eva 
SA_MBSAAMBAPA__NCAASIKAAhk-376	śāktasphārāveśamayāmṛtaprāptaye'smyāśritaḥ | uktaṃ ca vijñānabhairave	śākta sphāra āveśa maya amṛta prāptaye smi āśritaḥ uktam ca vijñānabhairave 
SA_MBSAAMBAPA__NCAASIKAAhk-377	- bhaktyudrekādviraktasya yādṛśī jāyate daśā | sā śaktiḥ śāṅkarī	bhakti udrekāt viraktasya yādṛśī jāyate daśā sā śaktiḥ śāṅkarī 
SA_MBSAAMBAPA__NCAASIKAAhk-378	nityaṃ bhāvayettāṃ tataḥ śivaḥ || iti || 16 ||	nityam bhāvayet tām tatas śivaḥ iti 
SA_MBSAAMBAPA__NCAASIKAAhk-379	hārdaṃ hanti prathamamuditā yā tamaḥsaṃśritānāṃ	hārdam hanti prathama muditā yā tamaḥ saṃśritānām 
SA_MBSAAMBAPA__NCAASIKAAhk-380	sattvodrekāttadanu ca rajaḥ karmayogakrameṇa |	sattva udrekāt tadanu ca rajaḥ karma yoga krameṇa 
SA_MBSAAMBAPA__NCAASIKAAhk-381	svabhyastā ca prathayatitarāṃ sattvameva prapannā	su abhyastā ca prathayatitarām sattvam eva prapannā 
SA_MBSAAMBAPA__NCAASIKAAhk-382	nirvāṇāya vrajati śamināṃ te'rka bhaktitrayīva || 17 ||	nirvāṇāya vrajati śaminām bhakti trayī iva 
SA_MBSAAMBAPA__NCAASIKAAhk-383	he arka, tava bhaktiḥ prapannā samāśritā satī śamināṃ	he arka tava bhaktiḥ prapannā samāśritā satī śaminām 
SA_MBSAAMBAPA__NCAASIKAAhk-384	śāntarāgādikalaṅkānāṃ nirvāṇāya mokṣāya vrajati	śānta rāga ādi kalaṅkānām nirvāṇāya mokṣāya vrajati 
SA_MBSAAMBAPA__NCAASIKAAhk-385	jīvacchivatvābhivyaktaye ghaṭate | trayī yathā | sāpi hi kāmyakarma	jīvat śiva tva abhivyaktaye ghaṭate trayī yathā sā api hi kāmya karma 
SA_MBSAAMBAPA__NCAASIKAAhk-386	parihṛtyānuṣṭhīyamānā trayyantavidāmapavargahetuḥ | tathā caiṣā	parihṛtya anuṣṭhīyamānā trayī anta vidām apavarga hetuḥ tathā ca eṣā 
SA_MBSAAMBAPA__NCAASIKAAhk-387	prathamamuditā samunmiṣitamātrā hārdaṃ prakāśānandātmahṛdbhavaṃ	prathama muditā samunmiṣita mātrā hārdam prakāśa ānanda ātma hṛd bhavam 
SA_MBSAAMBAPA__NCAASIKAAhk-388	tamastvabhedākhyātirūpamāṇavaṃ malaṃ saṃśritānāṃ bhaktibhājāṃ hanti	tamaḥ tu abheda akhyāti rūpam āṇavam malam saṃśritānām bhakti bhājām hanti 
SA_MBSAAMBAPA__NCAASIKAAhk-389	nāśayati | tadanu sattvasya prakāśasyodrekātprakarṣātkarmayogakrameṇa	nāśayati tadanu sattvasya prakāśasya udrekāt prakarṣāt karma yoga krameṇa 
SA_MBSAAMBAPA__NCAASIKAAhk-390	svātmadevatāviśrāntiphalaśārīrakarmānuṣṭhānena kārmamalarūpaṃ rajo	sva ātma devatā viśrānti phala śārīra karma anuṣṭhānena kārma mala rūpam rajaḥ 
SA_MBSAAMBAPA__NCAASIKAAhk-391	hanti | tathā suṣṭhu abhyastā pariśīlanena svīkṛtā sato bhāvaḥ sattvaṃ	hanti tathā suṣṭhu abhyastā pariśīlanena svīkṛtā sataḥ bhāvaḥ sattvam 
SA_MBSAAMBAPA__NCAASIKAAhk-392	prakāśaikaghanatvameva prakāśamāne sarvatra prathayatitarām | na tu	prakāśa eka ghana tvam eva prakāśamāne sarvatra prathayatitarām na tu 
SA_MBSAAMBAPA__NCAASIKAAhk-393	paśuvanmāyīyamalātmabhinnavedyaprathākṛt | trayyapi trayyantavidāṃ	paśu vat māyīya mala ātma bhinna vedya prathā kṛt trayī api trayī anta vidām 
SA_MBSAAMBAPA__NCAASIKAAhk-394	tanniṣṭhānāṃ sattvaṃ prathayati || 17 ||	tad niṣṭhānām sattvam prathayati 
SA_MBSAAMBAPA__NCAASIKAAhk-395	tāmāsādya śriyamiva gṛhe kāmadhenuṃ pravāse	tām āsādya śriyam iva gṛhe kāmadhenum pravāse 
SA_MBSAAMBAPA__NCAASIKAAhk-396	dhvānte bhātiṃ dhṛtimiva vane yojane brahmanāḍim |	dhvānte bhātim dhṛtim iva vane yojane brahmanāḍim 
SA_MBSAAMBAPA__NCAASIKAAhk-397	nāvaṃ cāsmin viṣamaviṣayagrāhasaṃsārasindhau	nāvam ca asmin viṣama viṣaya grāha saṃsāra sindhau 
SA_MBSAAMBAPA__NCAASIKAAhk-398	gaccheyaṃ te paramamamṛtaṃ yanna śītaṃ na coṣṇam || 18 ||	gaccheyam te paramam amṛtam yat na śītam na ca uṣṇam 
SA_MBSAAMBAPA__NCAASIKAAhk-399	tāṃ bhaktimāśritya cidarkasya te sambandhi paramamamṛtaṃ paraṃ	tām bhaktim āśritya cit arkasya te sambandhi paramam amṛtam param 
SA_MBSAAMBAPA__NCAASIKAAhk-400	śāktaṃ dhāma gaccheyaṃ samāviśeyam |	śāktam dhāma gaccheyam samāviśeyam 
SA_MBSAAMBAPA__NCAASIKAAhk-401	yacchaiśiragraiṣmabāhyārkadhāmavailakṣaṇyācchītamuṣṇaṃ ca na bhavati | api	yat śaiśira graiṣma bāhya arka dhāma vailakṣaṇyāt śītam uṣṇam ca na bhavati api 
SA_MBSAAMBAPA__NCAASIKAAhk-402	tu mohadāhaprakāśāhlādakṛdagniṣomātma | kīdṛśīṃ tām ? gṛhe śūnye	tu moha dāha prakāśa āhlāda kṛt agniṣoma ātma kīdṛśīm tām gṛhe śūnye 
SA_MBSAAMBAPA__NCAASIKAAhk-403	veśmani śriyamiva | sampūrṇabhogapradatvāt | pravāse riktabandhudeśe	veśmani śriyam iva sampūrṇa bhoga prada tvāt pravāse rikta bandhu deśe 
SA_MBSAAMBAPA__NCAASIKAAhk-404	kāmadhenumiva cintitamātrābhīṣṭaphalapradatvāt | dhvānte gāḍhatamasi	kāmadhenum iva cintita mātra abhīṣṭa phala prada tvāt dhvānte gāḍha tamasi 
SA_MBSAAMBAPA__NCAASIKAAhk-405	bhātimiva | pūrṇaprathāhetutvāt | vane gahanaparvatādau dhṛtimiva |	bhātim iva pūrṇa prathā hetu tvāt vane gahana parvata ādau dhṛtim iva 
SA_MBSAAMBAPA__NCAASIKAAhk-406	viśrāntihetutvāt | yojane paraśivātmaikyāveśe brahmanāḍiṃ suṣumṇām |	                    
SA_MBSAAMBAPA__NCAASIKAAhk-407	paramopāyatvāt | viṣamaviṣayā eva grāhā bhīṣaṇā jalacarā yatra tādṛśe	parama upāya tvāt viṣama viṣayāḥ eva grāhāḥ bhīṣaṇāḥ jalacarāḥ yatra tādṛśe 
SA_MBSAAMBAPA__NCAASIKAAhk-408	saṃsārasamudre nāvamiva | uttārakatvāt || 18 ||	saṃsāra samudre nāvam iva uttāraka tvāt 
SA_MBSAAMBAPA__NCAASIKAAhk-409	agnīṣomāvakhilajagataḥ kāraṇaṃ tau mayukhaiḥ	agnīṣomau akhila jagataḥ kāraṇam tau mayukhaiḥ 
SA_MBSAAMBAPA__NCAASIKAAhk-410	sargādāne sṛjasi bhagavan hrāsavṛddhikrameṇa |	sarga ādāne sṛjasi bhagavan hrāsa vṛddhi krameṇa 
SA_MBSAAMBAPA__NCAASIKAAhk-411	tāvevāntarviṣuvati samau juhvatāmātmavahnau	tau eva antar viṣuvati samau juhvatām ātma vahnau 
SA_MBSAAMBAPA__NCAASIKAAhk-412	dvāvapyastaṃ nayasi yugapanmuktaye bhaktibhājām || 19 ||	dvau api astam nayasi yugapad muktaye bhakti bhājām 
SA_MBSAAMBAPA__NCAASIKAAhk-413	he bhagavan, akhilasya bāhyasya nīlasukhādergrāhyarūpasyāntarasya ca	he bhagavan akhilasya bāhyasya nīla sukha ādeḥ grāhya rūpasya āntarasya ca 
SA_MBSAAMBAPA__NCAASIKAAhk-414	grāhakarūpasya dehāderjagato yāvagnīṣomau sarvavāhavāhī prāṇo'pānaśca	grāhaka rūpasya deha ādeḥ jagataḥ yau agnīṣomau sarva vāha vāhī prāṇa upānaḥ ca 
SA_MBSAAMBAPA__NCAASIKAAhk-415	prakāśanāvasthānahetutvātkāraṇam | tau	prakāśana avasthāna hetu tvāt kāraṇam tau 
SA_MBSAAMBAPA__NCAASIKAAhk-416	prasisṛkṣāpravivikṣātmasargādānasamaye	prasisṛkṣā pravivikṣā ātma sarga ādāna samaye 
SA_MBSAAMBAPA__NCAASIKAAhk-417	vastvābhāsanavimarśātmasṛṣṭyādau tannimittaṃ ca hrāsavṛddhikrameṇa	vastu ābhāsana vimarśa ātma sṛṣṭi ādau tad nimittam ca hrāsa vṛddhi krameṇa 
SA_MBSAAMBAPA__NCAASIKAAhk-418	dvādaśaṣoḍaśakalākalanaparyāyato mayukhaiḥ sṛṣṭyādi	dvādaśa ṣoḍaśa kalā kalana paryāyataḥ sṛṣṭi ādi 
SA_MBSAAMBAPA__NCAASIKAAhk-419	devyātmanijamarīcibhiḥ sṛjasi muhurmuhurnirmimīṣe | tāveva ca	devī ātma nija marīcibhiḥ sṛjasi muhur muhur nirmimīṣe tau eva ca 
SA_MBSAAMBAPA__NCAASIKAAhk-420	bhaktibhājāmantarviṣuvati  samyṅnayanātmasamānamarutpradhāne	bhakti bhājām antar viṣuvati samyak nayana ātma samāna marut pradhāne 
SA_MBSAAMBAPA__NCAASIKAAhk-421	kumbhake samau somasūryakalānyonyasaṃgharṣamiśritau	kumbhake samau soma sūrya kalā anyonya saṃgharṣa miśritau 
SA_MBSAAMBAPA__NCAASIKAAhk-422	santāvātmavahnāvudānavahnau juhvatāṃ muktaye	santau ātma vahnau udāna vahnau juhvatām muktaye 
SA_MBSAAMBAPA__NCAASIKAAhk-423	śivātmabhedaprathārūpāṇavādimalatrayapluṣṭopalakṣitaśivādvaitaprāptaye	śiva ātma bheda prathā rūpa āṇava ādi mala traya pluṣṭa upalakṣita śiva advaita prāptaye 
SA_MBSAAMBAPA__NCAASIKAAhk-424	dvāvapi yugapatkramaṃ mayūkhairevāstaṃ nayasi	dvau api yugapad kramam mayūkhaiḥ eva astam nayasi 
SA_MBSAAMBAPA__NCAASIKAAhk-425	viśvātmakavyānavyāptimāviśya	viśvātmaka vyāna vyāptim āviśya 
SA_MBSAAMBAPA__NCAASIKAAhk-426	jñānakriyātmaparāgnīṣomarūpasvātmamayau saṃpādayasi || 19 ||	jñāna kriyā ātma para agnīṣoma rūpa sva ātma mayau saṃpādayasi 
SA_MBSAAMBAPA__NCAASIKAAhk-427	sthūlatvaṃ te prakṛtigahanaṃ naiva lakṣyaṃ hyanantaṃ	sthūla tvam te prakṛti gahanam nā eva lakṣyam hi anantam 
SA_MBSAAMBAPA__NCAASIKAAhk-428	sūkṣmatvaṃ vā tadapi sadasadvyaktyabhāvādacintyam |	sūkṣma tvam vā tat api sat asat vyakti abhāvāt acintyam 
SA_MBSAAMBAPA__NCAASIKAAhk-429	dhyāyāmītthaṃ kathamaviditaṃ tvāmanādyantamanta-	dhyāyāmi ittham katham aviditam tvām anādi antam anta 
SA_MBSAAMBAPA__NCAASIKAAhk-430	stasmādarka praṇiyini mayi svātmanaiva prasīda || 20 ||	mayi sva ātmanā eva prasīda 
SA_MBSAAMBAPA__NCAASIKAAhk-431	he arka, te tava sthūlatvaṃ viśvavyāpakatvaṃ prakṛtyā gahanatvānnaiva	he arka te tava sthūla tvam viśva vyāpaka tvam prakṛtyāḥ gahana tvāt na eva 
SA_MBSAAMBAPA__NCAASIKAAhk-432	lakṣayituṃ śakyam | yasmādanantaṃ dikkālākārairanavacchinnam |	lakṣayitum śakyam yasmāt anantam diś kāla ākāraiḥ anavacchinnam 
SA_MBSAAMBAPA__NCAASIKAAhk-433	sūkṣmatvamapi vā aṇoraṇīyān ityetadvyākhyānāvasaravyākṛtayuktyā	sūkṣma tvam api vā aṇoḥ aṇīyān iti etad vyākhyāna avasara vyākṛta yuktyā 
SA_MBSAAMBAPA__NCAASIKAAhk-434	parapramātrātma yattadapi	para pramātṛ ātma yat tat api 
SA_MBSAAMBAPA__NCAASIKAAhk-435	sadasadvyaktyabhāvādbhāvābhāvarūpatvenāpratīteracintyam |	sat asat vyakti abhāvāt bhāva abhāva rūpa tvena apratīteḥ acintyam 
SA_MBSAAMBAPA__NCAASIKAAhk-436	taditthamanādyantatvādaviditaṃ tvāṃ kathamantaḥ svānte cintayāmi na	tat ittham anādi anta tvāt aviditam tvām katham antar svānte cintayāmi na 
SA_MBSAAMBAPA__NCAASIKAAhk-437	kathañcit | tasmānmayi praṇayini tvatprārthanāvahite svayameva prasīda	kathañcid tasmāt mayi praṇayini tvad prārthanā avahite svayam eva prasīda 
SA_MBSAAMBAPA__NCAASIKAAhk-438	praśamitadehādipramātṛtābhimānakāluṣyaḥ prasphura || 20 ||	praśamita deha ādi pramātṛ tā abhimāna kāluṣyaḥ prasphura 
SA_MBSAAMBAPA__NCAASIKAAhk-439	yattadvedyaṃ kimapi paramaṃ śabdatattvaṃ tvamanta-	yat tat vedyam kim api paramam śabda tattvam tvam anta 
SA_MBSAAMBAPA__NCAASIKAAhk-440	statsadvyaktiṃ jigamiṣu śanairlāti mātrākalāḥ khe |	śanais lāti mātrā kalāḥ khe 
SA_MBSAAMBAPA__NCAASIKAAhk-441	avyaktena praṇavavapuṣā bindunādoditaṃ sa-	avyaktena praṇava vapuṣā bindu nāda uditam sa 
SA_MBSAAMBAPA__NCAASIKAAhk-442	cchabdabrahmoccaritakaraṇavyañjitaṃ vācakaṃ te || 21 ||	cchabda brahma uccarita karaṇa vyañjitam vācakam te 
SA_MBSAAMBAPA__NCAASIKAAhk-443	yatkimapyasāmānyaṃ tvaṃ	yat kim api asāmānyam tvam 
SA_MBSAAMBAPA__NCAASIKAAhk-444	tadantarityantarmukhānavacchinnaprakāśātmani pade | śabdatattvamiti śāstraṃ	tat antar iti antarmukha anavacchinna prakāśa ātmani pade śabda tattvam iti śāstram 
SA_MBSAAMBAPA__NCAASIKAAhk-445	śabdātmakaṃ sarvaṃ śabdo haṃsaḥ prakīrtitaḥ iti	śabda ātmakam sarvam śabdaḥ haṃsaḥ prakīrtitaḥ iti 
SA_MBSAAMBAPA__NCAASIKAAhk-446	śrīsvacchandādiṣṭānāhatabhaṭṭārakarūpam | paramamiti paramotkṛṣṭam |	                           
SA_MBSAAMBAPA__NCAASIKAAhk-447	yaduktaṃ śrīkālottare - nādākhyaṃ yatparaṃ bījaṃ iti | vedyamiti	yat uktam śrī kālottare nāda ākhyam yat param bījam iti vedyam iti 
SA_MBSAAMBAPA__NCAASIKAAhk-448	suprakaṭasusphurattātmakatvādanapahnavanīyam | na tu vidikriyākarmātmakam |	su prakaṭa su sphurat tā ātmaka tvāt anapahnavanīyam na tu vidi kriyā karma ātmakam 
SA_MBSAAMBAPA__NCAASIKAAhk-449	yaduktaṃ śrīsvacchande -	              
SA_MBSAAMBAPA__NCAASIKAAhk-450	yasya rūpaṃ śarīraṃ vā nāsti varṇaḥ kriyā tathā |	yasya rūpam śarīram vā na asti varṇaḥ kriyā tathā 
SA_MBSAAMBAPA__NCAASIKAAhk-451	sa kathaṃ gṛhyate sūkṣmo hyagrāhyo nityamavyayaḥ || iti |	sa katham gṛhyate sūkṣmaḥ hi agrāhyaḥ nityam avyayaḥ iti 
SA_MBSAAMBAPA__NCAASIKAAhk-452	śrībhargaśikhāyāmapi -	śrī bhargaśikhāyām api 
SA_MBSAAMBAPA__NCAASIKAAhk-453	naiṣa varṇo na vā śabdo na caivāyaṃ kalātmakaḥ |	na eṣa varṇaḥ na vā śabdaḥ na ca eva ayam kalā ātmakaḥ 
SA_MBSAAMBAPA__NCAASIKAAhk-454	kevalaḥ paramānando vīro nityodito raviḥ ||	          
SA_MBSAAMBAPA__NCAASIKAAhk-455	nāstameti na codeti na śānto na vikāravān |	na astam eti na ca udeti na śāntaḥ na vikāravān 
SA_MBSAAMBAPA__NCAASIKAAhk-456	sarvabhūtāntaracaro bhānurbharga iti smṛtaḥ || iti |	sarva bhūta antara caraḥ bhānuḥ bhargaḥ iti smṛtaḥ iti 
SA_MBSAAMBAPA__NCAASIKAAhk-457	tadetatparabrahmātmaśaktimadrūpam | sadvyaktiṃ jigamiṣviti | oṃ tatsaditi	tat etat para brahma ātma śaktimat rūpam sat vyaktim jigamiṣu iti om tat sat iti 
SA_MBSAAMBAPA__NCAASIKAAhk-458	nirdeśo brahmaṇastrividhaḥ smṛtaḥ iti sthityā śaktyātmabrahmarūpatāṃ	nirdeśaḥ brahmaṇaḥ trividhaḥ smṛtaḥ iti sthityā śakti ātma brahma rūpa tām 
SA_MBSAAMBAPA__NCAASIKAAhk-459	jighṛkṣu khe suṣumṇādhāmni akārokāramakārādimātrārūpāḥ kalā	jighṛkṣu khe suṣumṇā dhāmni akāra ukāra makāra ādi mātrā rūpāḥ kalā 
SA_MBSAAMBAPA__NCAASIKAAhk-460	vimarśaśaktīḥ śanaiḥ śanaiḥ krameṇa lāti gṛhṇāti | itthaṃ	vimarśa śaktīḥ śanais śanais krameṇa lāti gṛhṇāti ittham 
SA_MBSAAMBAPA__NCAASIKAAhk-461	śaktimaccidarkāvabhāsitaśabdabrahmabhittau praṇavavapuṣā oṃkārātmanā	śaktimat cit arka avabhāsita śabda brahma bhittau praṇava vapuṣā oṃkāra ātmanā 
SA_MBSAAMBAPA__NCAASIKAAhk-462	avyaktena paśyantīvākpradhānena rūpeṇa na tu vyaktena	avyaktena paśyantī vāc pradhānena rūpeṇa na tu vyaktena 
SA_MBSAAMBAPA__NCAASIKAAhk-463	madhyamādivāgbhūmikāspṛśā | praṇavaḥ sarvavedeṣu iti sthityā	                                                                                                                      
SA_MBSAAMBAPA__NCAASIKAAhk-464	kroḍīkṛtāśeṣavācyavācakasphāraṃ śabdabrahmoccarati svayaṃ pravartate | na	kroḍīkṛta aśeṣa vācya vācaka sphāram śabdabrahma uccarati svayam pravartate na 
SA_MBSAAMBAPA__NCAASIKAAhk-465	tūccāryate | kīdṛk ? bindunādābhyāṃ	tu uccāryate kīdṛś bindu nādābhyām 
SA_MBSAAMBAPA__NCAASIKAAhk-466	samastavedyābhedivedanasamastavācakābhediparāmarśarūpābhyāmuditam |	samasta vedya abhedi vedana samasta vācaka abhedi parāmarśa rūpābhyām uditam 
SA_MBSAAMBAPA__NCAASIKAAhk-467	sarvotkṛṣṭagaganārūḍhaṃ satkathaṃ samuccarati atrāgamikīṃ yuktiṃ	sarva utkṛṣṭa gagana ārūḍham sat katham samuccarati atra āgamikīm yuktim 
SA_MBSAAMBAPA__NCAASIKAAhk-468	smārayati - karaṇena divyakaraṇabandhena na tu jihvāmūlamadhyādinā	smārayati karaṇena divya karaṇa bandhena na tu jihvā mūla madhya ādinā 
SA_MBSAAMBAPA__NCAASIKAAhk-469	vyañjitaṃ prakaṭīkṛtam | yaduktaṃ śrīsvacchande -	vyañjitam prakaṭīkṛtam yat uktam śrī svacchande 
SA_MBSAAMBAPA__NCAASIKAAhk-470	divyaṃ tu karaṇaṃ kṛtvā tattvasyoccāraṇaṃ kuru ityādi |	divyam tu karaṇam kṛtvā tattvasya uccāraṇam kuru ityādi 
SA_MBSAAMBAPA__NCAASIKAAhk-471	yaccaitacchabdabrahmatattvaśaktisvarūpāmarśanamukhenaiva te vācakaṃ	yat ca etat śabda brahma tattva śakti svarūpa āmarśana mukhena eva te vācakam 
SA_MBSAAMBAPA__NCAASIKAAhk-472	tatsvarūpāmarśakam || 21 ||	      
SA_MBSAAMBAPA__NCAASIKAAhk-473	prātaḥ sandhyāruṇakiraṇabhāgṛṅmayaṃ rājasaṃ yanmadhye	prātar sandhyā aruṇa kiraṇa bhāgṛh mayam rājasam yat madhye 
SA_MBSAAMBAPA__NCAASIKAAhk-474	cāpi jvaladiva yajuḥ śuklabhāḥ sāttvikaṃ vā |	ca api jvalat iva yajuḥ śukla bhās sāttvikam vā 
SA_MBSAAMBAPA__NCAASIKAAhk-475	sāyaṃ sāmāstamitakiraṇaṃ yattamollāsirūpaṃ	sāyam sāma astamita kiraṇam yat tamaḥ ullāsi rūpam 
SA_MBSAAMBAPA__NCAASIKAAhk-476	sāhnaḥ sargasthitilayavidhāvākṛtiste trayīva || 22 ||	sā ahnaḥ sarga sthiti laya vidhau ākṛtiḥ te trayī iva 
SA_MBSAAMBAPA__NCAASIKAAhk-477	he bhagavaṃścidarka ahnaḥ sārvajanīnasya prāṇadinasya	he bhagavan cit arka ahnaḥ sārvajanīnasya prāṇa dinasya 
SA_MBSAAMBAPA__NCAASIKAAhk-478	sargasthitilayavidhau te sambandhinī sā kṛtiḥ	sarga sthiti laya vidhau te sambandhinī sā kṛtiḥ 
SA_MBSAAMBAPA__NCAASIKAAhk-479	kroḍīkṛtāśeṣasṛṣṭyādisturyākhyā śaktirvijṛmbhata ityarthaḥ | kā sā ityāha -	kroḍīkṛta aśeṣa sṛṣṭi ādiḥ turya ākhyā śaktiḥ vijṛmbhate iti arthaḥ kā sā iti āha 
SA_MBSAAMBAPA__NCAASIKAAhk-480	prātaḥ hṛdunmeṣātmani prabhāte guṇībhūtaprāṇāpānavṛttīḥ	prātar hṛd unmeṣa ātmani prabhāte guṇībhūta prāṇa apāna vṛttīḥ 
SA_MBSAAMBAPA__NCAASIKAAhk-481	śivaśaktisaṃghaṭṭātmā yā sandhyā tatra ye'ruṇakiraṇā	śiva śakti saṃghaṭṭa ātmā yā sandhyā tatra yeruṇa kiraṇā 
SA_MBSAAMBAPA__NCAASIKAAhk-482	anunmiṣitavaicitryāddiptāḥ śarīrādayaścakṣurādiprakāśāstān bhajate yadata	an unmiṣita vaicitryāt diptāḥ śarīra ādayaḥ cakṣuḥ ādi prakāśāḥ tān bhajate 
SA_MBSAAMBAPA__NCAASIKAAhk-483	eva rājasaṃ viśvarājānaṃ viśvaprasarāsūtraṇaṃ ca ṛṅmayam | yacca	eva rājasam viśva rājānam viśva prasara āsūtraṇam ca ṛk mayam yat ca 
SA_MBSAAMBAPA__NCAASIKAAhk-484	paradhāmāmarśanātmā stutikṛcca madhye madhyadhāmni	para dhāma āmarśana ātmā stuti kṛt ca madhye madhya dhāmni 
SA_MBSAAMBAPA__NCAASIKAAhk-485	yajuściddevatāpūjātmakriyāśaktipradhānam | dvaitendhanaploṣādiva jvalat |	yajuḥ cit devatā pūjā ātma kriyā śakti pradhānam dvaita indhana ploṣāt iva jvalat 
SA_MBSAAMBAPA__NCAASIKAAhk-486	hlādātmasomavyāptyunmajjanācchuklabhāḥ amalamātmabhāḥsvarūpam |	hlāda ātma soma vyāpti unmajjanāt śukla bhās amalam ātma bhās svarūpam 
SA_MBSAAMBAPA__NCAASIKAAhk-487	sāttvikaṃ ca satāṃ bhāvaḥ sattvaṃ prakāśamānatvaṃ tasyedaṃ sampādakam	sāttvikam ca satām bhāvaḥ sattvam prakāśamāna tvam tasya idam sampādakam 
SA_MBSAAMBAPA__NCAASIKAAhk-488	| svaprakāśāveśena viśvaprakāśakamityarthaḥ |	sva prakāśa āveśena viśva prakāśakam iti arthaḥ 
SA_MBSAAMBAPA__NCAASIKAAhk-489	sāyamūrdhvatuṭyardhe'stamitakiraṇaṃ galitaprāṇādisaṃskārakṣayāt	sāyam ūrdhva tuṭi ardha astamita kiraṇam galita prāṇa ādi saṃskāra kṣayāt 
SA_MBSAAMBAPA__NCAASIKAAhk-490	praśāntasitojjvalitamarīcinicayam | ataśca	praśānta sita ujjvalita marīci nicayam atas ca 
SA_MBSAAMBAPA__NCAASIKAAhk-491	niḥsaṃskāradvaitādvaitakavalanāttadapekṣayaiva tamovastuviśrāntyaikarasatvāt	niḥsaṃskāra dvaita advaita kavalanāt tad apekṣayā eva tamaḥ vastu viśrāntyā ekarasa tvāt 
SA_MBSAAMBAPA__NCAASIKAAhk-492	sāma | etattrividhaṃ sthūlasūkṣmaparasvarūpaṃ yallāsi gṛhṇāsi sā	sāma etat trividham sthūla sūkṣma para svarūpam yat lāsi gṛhṇāsi sā 
SA_MBSAAMBAPA__NCAASIKAAhk-493	tavākṛtistrayīva ṛgyajuḥsāmānīva | tathāhi - prātararkadevatāstutipradhānā	tava ākṛtiḥ trayī iva ṛk yajuḥ sāmāni iva tathā hi prātar arka devatā stuti pradhānā 
SA_MBSAAMBAPA__NCAASIKAAhk-494	ṛgvedavyāptiḥ | madhye karmānuṣṭhānātmā yajurvedodayaḥ | sāyaṃ	                  
SA_MBSAAMBAPA__NCAASIKAAhk-495	viśrāntihetugītapradhānā sāmavedapradhānateti pratidinaṃ sthitiḥ || 22 ||	viśrānti hetu gīta pradhānā sāmaveda pradhāna tā iti pratidinam sthitiḥ 
SA_MBSAAMBAPA__NCAASIKAAhk-496	ye pātālodadhimuninagadvīpalokādhibīja-	ye 
SA_MBSAAMBAPA__NCAASIKAAhk-497	cchandobhūtasvaramukhanadatsaptasaptiḥ prapannāḥ |	cchandaḥ bhūta svara mukha nadat saptasaptiḥ prapannāḥ 
SA_MBSAAMBAPA__NCAASIKAAhk-498	ye caikāśvaṃ niravayavavāgbhāvamātrādhirūḍhaṃ	ye ca eka aśvam niravayava vāc bhāva mātra adhirūḍham 
SA_MBSAAMBAPA__NCAASIKAAhk-499	te tvāmeva svaraguṇakalāvarjitaṃ yāntyanaśvam || 23 ||	te tvām eva svara guṇa kalā varjitam yānti anaśvam 
SA_MBSAAMBAPA__NCAASIKAAhk-500	atalādīni sapta pātālāni | kṣīrādyāḥ saptodadhayaḥ | atryādyāḥ sapta	a tala ādīni sapta pātālāni kṣīra ādyāḥ sapta udadhayaḥ atri ādyāḥ sapta 
SA_MBSAAMBAPA__NCAASIKAAhk-501	munayaḥ | mahendrādyāḥ sapta parvatāḥ | jambvādīni sapta dvīpāni |	munayaḥ mahendra ādyāḥ sapta parvatāḥ jambu ādīni sapta dvīpāni 
SA_MBSAAMBAPA__NCAASIKAAhk-502	bhūrādyāḥ sapta lokāḥ |	bhūḥ ādyāḥ sapta lokāḥ 
SA_MBSAAMBAPA__NCAASIKAAhk-503	moho madaśca garvaśca viṣādaḥ krodha eva ca |	mohaḥ madaḥ ca garvaḥ ca viṣādaḥ krodhaḥ eva ca 
SA_MBSAAMBAPA__NCAASIKAAhk-504	bhayaṃ ca harṣaṇaṃ caiva dehe saptādhayaḥ smṛtāḥ ||	bhayam ca harṣaṇam ca eva dehe sapta ādhayaḥ smṛtāḥ 
SA_MBSAAMBAPA__NCAASIKAAhk-505	ityuktā mohādyāḥ saptādhayaḥ | yavādīni saptabījāni | gāyatryādīni	iti uktāḥ moha ādyāḥ sapta ādhayaḥ yava ādīni sapta bījāni gāyatrī ādīni 
SA_MBSAAMBAPA__NCAASIKAAhk-506	saptacchandāṃsi | bhūtāḥ prāptāḥ | etadāmāśatvāt |	sapta chandāṃsi bhūtāḥ prāptāḥ etad āmāśa tvāt 
SA_MBSAAMBAPA__NCAASIKAAhk-507	īdṛgviśvaprapañcarūpā ye ṣaḍjādyāḥ sapta svarāste mukheṣu yeṣāṃ te	īdṛś viśva prapañca rūpāḥ ye ṣaḍja ādyāḥ sapta svarāḥ te mukheṣu yeṣām te 
SA_MBSAAMBAPA__NCAASIKAAhk-508	tanmukhāstānevārthānnadanto dhvanantaḥ sapta saptayo	tad mukhāḥ tān eva arthān nadantaḥ dhvanantaḥ sapta 
SA_MBSAAMBAPA__NCAASIKAAhk-509	manobuddhīndriyātmāno'śvā yasya tādṛśaṃ tvāṃ prapannāḥ | ye ca	manaḥ buddhi indriya ātmānaḥ ūśvāḥ yasya tādṛśam tvām prapannāḥ ye ca 
SA_MBSAAMBAPA__NCAASIKAAhk-510	niravayavā vāk paśyantī tasyā bhāvaḥ sattā tanmātrādhirūḍhaṃ	niravayavā vāc paśyantī tasyāḥ bhāvaḥ sattā tanmātra adhirūḍham 
SA_MBSAAMBAPA__NCAASIKAAhk-511	madhyadhāmonmiṣatpaśyantyāmarśaparimarśitam | ataścaikāśvaṃ ca tvāṃ	madhya dhāma unmiṣat paśyantī āmarśa parimarśitam atas ca ekāśvam ca tvām 
SA_MBSAAMBAPA__NCAASIKAAhk-512	buddhvā ye prapannāḥ, ubhaye'pi te tvāmevānaśvaṃ cidarkaṃ paraṃ brahma	buddhvā ye prapannāḥ ubhaye pi te tvām eva anaśvam cit arkam param brahma 
SA_MBSAAMBAPA__NCAASIKAAhk-513	yāntitvadekatāmāpnuvanti | kīdṛśam ? svaraiḥ ṣaḍjādibhiḥ guṇaiḥ	yānti tvad eka tām āpnuvanti kīdṛśam svaraiḥ ṣaḍja ādibhiḥ guṇaiḥ 
SA_MBSAAMBAPA__NCAASIKAAhk-514	sattvādibhiḥ kalābhirakārādibhirvarjitaṃ nirupādhiprakāśānandaghanam |	sattva ādibhiḥ kalābhiḥ akāra ādibhiḥ varjitam nirupādhi prakāśa ānanda ghanam 
SA_MBSAAMBAPA__NCAASIKAAhk-515	sāśvopāsanānaśvaprāptiheturiti virodhābhāsaḥ || 23 ||	sa aśva upāsana an aśva prāpti hetuḥ iti virodha ābhāsaḥ 
SA_MBSAAMBAPA__NCAASIKAAhk-516	divyaṃ jyotiḥ salilapavanaiḥ pūrayitvā trilokī-	divyam jyotiḥ salila pavanaiḥ pūrayitvā trilokī 
SA_MBSAAMBAPA__NCAASIKAAhk-517	mekībhūtaṃ punarapi ca tatsāramādāya gobhiḥ |	mekībhūtam punar api ca tad sāram ādāya gobhiḥ 
SA_MBSAAMBAPA__NCAASIKAAhk-518	antarlīno viśasi vasudhāṃ tadgataḥ sūyase'nnaṃ	antar līnaḥ viśasi vasudhām tad gataḥ 
SA_MBSAAMBAPA__NCAASIKAAhk-519	tacca prāṇāstvamiti jagatāṃ prāṇabhṛt sūrya ātmā || 24 ||	tat ca prāṇāḥ tvam iti jagatām prāṇabhṛt sūryaḥ ātmā   
SA_MBSAAMBAPA__NCAASIKAAhk-520	he bhagavan, tvaṃ jyotiḥsalilapavanaiścitprakāśakarandhra-	he bhagavan tvam jyotiḥ salila pavanaiḥ cit prakāśaka randhra 
SA_MBSAAMBAPA__NCAASIKAAhk-521	praviśacchāktāmṛtaprāṇamarudbhistrilokīṃ jāgarasvapnasuṣuptitrayīṃ	praviśat śākta amṛta prāṇa marudbhiḥ trilokīm jāgara svapna suṣupti trayīm 
SA_MBSAAMBAPA__NCAASIKAAhk-522	pūrayitvā tasyāmeva trilokyāmekībhūtaṃ sāmarasyaṃ prāptaṃ divyaṃ	pūrayitvā tasyām eva trilokyām ekībhūtam sāmarasyam prāptam divyam 
SA_MBSAAMBAPA__NCAASIKAAhk-523	sāraṃ turyānandaghanaṃ gobhiranuttarairmarīcibhiḥ punariti punaḥ punarādāya	sāram turya ānanda ghanam gobhiḥ anuttaraiḥ marīcibhiḥ punar iti punar punar ādāya 
SA_MBSAAMBAPA__NCAASIKAAhk-524	camatkṛtya antariti antarmukhe pade līno vasudhāṃ parāṃ bhūmiṃ viśasi	camatkṛtya antar iti antarmukhe pade līnaḥ vasudhām parām bhūmim viśasi 
SA_MBSAAMBAPA__NCAASIKAAhk-525	tanmayatayā sphurasi tadgataścānnamadanaviṣayaṃ vedyajātaṃ sūyase	tad maya tayā sphurasi tad gataḥ ca anna madana viṣayam vedya jātam sūyase 
SA_MBSAAMBAPA__NCAASIKAAhk-526	āśyānībhūya tadrūpatayā sphurasi | taccānnaṃ	āśyānībhūya tad rūpa tayā sphurasi tat ca annam 
SA_MBSAAMBAPA__NCAASIKAAhk-527	prāṇāpānāvasthitihetustvameva na tvanyat kiñciditi | anayā yuktyā sūryaḥ	prāṇa apāna avasthiti hetuḥ tvam eva na tu anyat kiñcid iti anayā yuktyā sūryaḥ 
SA_MBSAAMBAPA__NCAASIKAAhk-528	prāṇabhṛdātmā ca kathyase | yadāha śrutiḥ -	prāṇabhṛt ātmā ca kathyase yat āha śrutiḥ 
SA_MBSAAMBAPA__NCAASIKAAhk-529	ahamannamahamannado'hamannādaśca iti | bāhyo'pi sūryo	aham annam aham anna doham anna ādaḥ ca iti sūryaḥ 
SA_MBSAAMBAPA__NCAASIKAAhk-530	bhūrbhuvaḥsvastrayīṃ jyotiḥsalilapavanaistatra tatra samaya āpūrya	bhūḥ bhuvaḥ svar trayīm jyotiḥ salila pavanaiḥ tatra tatra samaye āpūrya 
SA_MBSAAMBAPA__NCAASIKAAhk-531	samarasībhūtaṃ  divyaṃ trilokyāṃ rasarūpaṃ sāraṃ	            
SA_MBSAAMBAPA__NCAASIKAAhk-532	raśmibhirgrīṣmādāvādāya punarapi bhūmimantastāpanayuktyā līnaḥ san	raśmibhiḥ grīṣma ādau ādāya punar api bhūmimantaḥ tāpana yuktyā līnaḥ san 
SA_MBSAAMBAPA__NCAASIKAAhk-533	viśati | tadgataścānnamoṣadhyākhyaṃ prāṇāvasthitihetuṃ janayati | tataḥ sa	viśati tad gataḥ ca annam oṣadhi ākhyam prāṇa avasthiti hetum janayati tatas sa 
SA_MBSAAMBAPA__NCAASIKAAhk-534	evānnamannado'nnādaśca || 24 ||	eva annam anna da unnādaḥ ca 
SA_MBSAAMBAPA__NCAASIKAAhk-535	agnīṣomau prakṛtipuruṣau bindunādau ca nityau	agnīṣomau prakṛti puruṣau bindu nādau ca nityau 
SA_MBSAAMBAPA__NCAASIKAAhk-536	prāṇāpānāvapi dinaniśe ye ca satyānṛte dve |	prāṇa apānau api dina niśe ye ca satya anṛte dve 
SA_MBSAAMBAPA__NCAASIKAAhk-537	dharmādharmau sadasadubhayaṃ yo'ntarāveśya yogī	dharma adharmau sat asat ubhayam yaḥ ntar āveśya yogī 
SA_MBSAAMBAPA__NCAASIKAAhk-538	vartetātmanyuparatamatirnirguṇaṃ tvāṃ viśet saḥ || 25 ||	varteta ātmani uparata matiḥ nirguṇam tvām viśet saḥ 
SA_MBSAAMBAPA__NCAASIKAAhk-539	yo yogī nityau satatavāhinau prāṇāpānāveva	yaḥ yogī nityau satata vāhinau prāṇa apānau eva 
SA_MBSAAMBAPA__NCAASIKAAhk-540	kavalanāpyāyanahetutvādagnīṣomau jñānakriyāśaktiprādhānyāt	kavalana āpyāyana hetu tvāt agnīṣomau jñāna kriyā śakti prādhānyāt 
SA_MBSAAMBAPA__NCAASIKAAhk-541	prakṛtipuruṣau vedanavimarśatvād bindunādau prasaraviśrāntipadatvād dinaniśe	                           
SA_MBSAAMBAPA__NCAASIKAAhk-542	vikāsasaṃkocanimittatvāt satyānṛte ūrdhvādhogatikāraṇatvād dharmādharmau	vikāsa saṃkoca nimitta tvāt satya anṛte ūrdhva adhas gati kāraṇa tvāt dharma adharmau 
SA_MBSAAMBAPA__NCAASIKAAhk-543	bāhyānāṃ sattāsattayorjñāpakatvāt sadasadubhayamantarudānadhāmni	bāhyānām sattā asattayoḥ jñāpaka tvāt sat asat ubhayam antar udāna dhāmni 
SA_MBSAAMBAPA__NCAASIKAAhk-544	āveśya vilāpyātmani ciddhāmni vartetāvatiṣṭheta sa tvāṃ nirguṇaṃ	āveśya vilāpya ātmani cit dhāmni varteta avatiṣṭheta sa tvām nirguṇam 
SA_MBSAAMBAPA__NCAASIKAAhk-545	sattvādiguṇātītaṃ paramādityaṃ viśatyeva || 25 ||	sattva ādi guṇa atītam paramādityam viśati eva 
SA_MBSAAMBAPA__NCAASIKAAhk-546	garbhādhānaprasavavidhaye suptayorindubhāsā	garbhādhāna prasava vidhaye suptayoḥ indu bhāsā 
SA_MBSAAMBAPA__NCAASIKAAhk-547	sāpatnyenābhimukhamiva khe kāntayormadhyasaṃsthaḥ |	sāpatnyena abhimukham iva khe kāntayoḥ madhya saṃsthaḥ 
SA_MBSAAMBAPA__NCAASIKAAhk-548	dyāvāpṛthvyorvadanakamale gomukhairbodhayitvā	dyāvāpṛthvyoḥ vadana kamale gomukhaiḥ bodhayitvā 
SA_MBSAAMBAPA__NCAASIKAAhk-549	paryāyeṇāpibasi bhagavan ṣaḍrasāsvādalolaḥ || 26 ||	paryāyeṇa apibasi bhagavan ṣaṣ rasa āsvāda lolaḥ 
SA_MBSAAMBAPA__NCAASIKAAhk-550	he bhagavaṃścidbhāno ! dyāvāpṛthvyoḥ	he bhagavan cit bhāno dyāvāpṛthvyoḥ 
SA_MBSAAMBAPA__NCAASIKAAhk-551	sarvadvādaśāntātmāntarikṣadehabhūmyoḥ kāntayornijavijñānenaiva	sarva dvādaśānta ātma antarikṣa deha bhūmyoḥ kāntayoḥ nija vijñānena eva 
SA_MBSAAMBAPA__NCAASIKAAhk-552	ramaṇīyatāṃ prāpitayorvadanakamale śaktinaline	ramaṇīya tām prāpitayoḥ vadana kamale śakti naline 
SA_MBSAAMBAPA__NCAASIKAAhk-553	gomukhairanuttarairmarīcibhirbodhayitvā vikāsya	gomukhaiḥ anuttaraiḥ marīcibhiḥ bodhayitvā vikāsya 
SA_MBSAAMBAPA__NCAASIKAAhk-554	asāmānyaśāktānandāsvādanalampaṭaḥ san paryāyeṇa	asāmānya śākta ānanda āsvādana lampaṭaḥ san paryāyeṇa 
SA_MBSAAMBAPA__NCAASIKAAhk-555	vicitronmeṣanimeṣakramairāpibasi camatkuruṣe | kīdṛśaḥ ?	vicitra unmeṣa nimeṣa kramaiḥ āpibasi camatkuruṣe kīdṛśaḥ 
SA_MBSAAMBAPA__NCAASIKAAhk-556	madhyasaṃstho'gnīṣomādhirūḍhaḥ | kimartham ? garbhe svāntaryadādhānaṃ	madhya saṃstha ugnīṣoma adhirūḍhaḥ kimartham garbhe sva antar yat ādhānam 
SA_MBSAAMBAPA__NCAASIKAAhk-557	prakṣepo'rthādviśvasya prasavastadaucityena bhāsanaṃ tadvidhānārtham |	prakṣepa ūrthāt viśvasya prasavaḥ tad aucityena bhāsanam tad vidhāna artham 
SA_MBSAAMBAPA__NCAASIKAAhk-558	kīdṛśyordyāvāpṛthivyoḥ ? khe śūnyapramātari suptayoḥ kalodvalitametacca	kīdṛśyoḥ dyāvāpṛthivyoḥ khe śūnya pramātari suptayoḥ kalā udvalitam etat ca 
SA_MBSAAMBAPA__NCAASIKAAhk-559	cittattvaṃ kartṛtāmayam | acidrūpasya śūnyādermitaṃ guṇatayā sthitam	cit tattvam kartṛtā mayam acit rūpasya śūnya ādeḥ mitam guṇatayā sthitam 
SA_MBSAAMBAPA__NCAASIKAAhk-560	|| iti nītyā śūnyapradhānatāśrayeṇa	iti nītyā śūnya pradhāna tā āśrayeṇa 
SA_MBSAAMBAPA__NCAASIKAAhk-561	nimajjitapāramārthikasvarūpayorabhimukhāvasthitayoḥ | kathaṃ suptayoḥ ?	nimajjita pāramārthika svarūpayoḥ abhimukha avasthitayoḥ katham suptayoḥ 
SA_MBSAAMBAPA__NCAASIKAAhk-562	sāpatnyena parasparapratiyogitayaivābhimukhaṃ kṛtvā |	sāpatnyena paraspara pratiyogitayā eva abhimukham kṛtvā 
SA_MBSAAMBAPA__NCAASIKAAhk-563	ubhayānukūlatvādābhimukhyamāśrityetyarthaḥ | bāhyo'pyarko	ubhaya anukūla tvāt ābhimukhyam āśritya iti arthaḥ 
SA_MBSAAMBAPA__NCAASIKAAhk-564	dyāvāpṛthivyo rātrābindubhāsā	dyāvāpṛthivyaḥ rātrā bindu bhāsā 
SA_MBSAAMBAPA__NCAASIKAAhk-565	suptayormīlitasvarūpayorabhimukhāvasthitayormadhya gobhirvadananaline vikāsya	suptayoḥ mīlita svarūpayoḥ abhimukha avasthitayoḥ madhya gobhiḥ vadana naline vikāsya 
SA_MBSAAMBAPA__NCAASIKAAhk-566	tadīyavicitrarasāsvādalola āpibati bhaumāntarikṣān rasān | garbhādhānāya	tadīya vicitra rasa āsvāda lolaḥ āpibati bhauma āntarikṣān rasān garbhādhānāya 
SA_MBSAAMBAPA__NCAASIKAAhk-567	grīṣmādau karṣaṇyādinijaraśmyantarniveśanāya | prāvṛḍādau ca prasavāya	grīṣma ādau karṣaṇī ādi nija raśmi antar niveśanāya prāvṛṣ ādau ca prasavāya 
SA_MBSAAMBAPA__NCAASIKAAhk-568	varṣaṇyādimarīcivisargato nānauṣadhyuptaye | atha ca sāpatnyenābhimukhayoḥ	varṣaṇi ādi marīci visargataḥ nānā oṣadhi uptaye atha ca sāpatnyena abhimukhayoḥ 
SA_MBSAAMBAPA__NCAASIKAAhk-569	suptayorindubhāsopalakṣitayoḥ karpūrāchhuritayoḥ	suptayoḥ indu bhāsā upalakṣitayoḥ karpūra āchhuritayoḥ 
SA_MBSAAMBAPA__NCAASIKAAhk-570	kāntayormadhyasaṃstho nāyako vaidagdhyād gomukhairvaktrapadme paryāyeṇa	kāntayoḥ madhya saṃsthaḥ nāyakaḥ vaidagdhyāt gomukhaiḥ vaktra padme paryāyeṇa 
SA_MBSAAMBAPA__NCAASIKAAhk-571	yugapad bodhayitvā locanaparicumbanapuraḥsaramunnidre vidhāya	yugapad bodhayitvā locana paricumbana puraḥsaram unnidre vidhāya 
SA_MBSAAMBAPA__NCAASIKAAhk-572	vaktrāsavāmṛtalampaṭo garbhasyādhānaprasavanimittamāpibati rataye'tyarthaṃ	vaktra āsava amṛta lampaṭaḥ garbhasya ādhāna prasava nimittam āpibati ratayā iti artham 
SA_MBSAAMBAPA__NCAASIKAAhk-573	"paricumbatīti śleṣā""ṅkāraḥ śleṣadhvanisaṃsṛṣṭaśca || 26 ||"	paricumbati iti śleṣa aṅkāraḥ śleṣa dhvani saṃsṛṣṭaḥ ca 
SA_MBSAAMBAPA__NCAASIKAAhk-574	somaṃ pūrṇāmṛtamiva caruṃ tejasā sādhayitvā	somam pūrṇa amṛtam iva carum tejasā sādhayitvā 
SA_MBSAAMBAPA__NCAASIKAAhk-575	kṛtvā tenānalamukhajagattarpaṇaṃ vaiśvadevam |	kṛtvā tena anala mukha jagat tarpaṇam vaiśvadevam 
SA_MBSAAMBAPA__NCAASIKAAhk-576	āmāvasyaṃ vighasamiva khe tatkalāśeṣamaśnan	āmāvasyam vighasam iva khe tad kalā śeṣam aśnan 
SA_MBSAAMBAPA__NCAASIKAAhk-577	brahmāṇḍāntargṛhapatiriva svātmayāgaṃ karoṣi || 27 ||	brahmāṇḍa antar gṛhapatiḥ iva sva ātma yāgam karoṣi 
SA_MBSAAMBAPA__NCAASIKAAhk-578	he cidarka ! brahmarandhrāvasthitaśāktabrahmopalakṣitasyāṇḍasya antariti	he cit arka brahmarandhra avasthita śākta brahma upalakṣitasya aṇḍasya antar iti 
SA_MBSAAMBAPA__NCAASIKAAhk-579	dharāmūlamāyāśaktyaṇḍacatuṣṭayasya madhye gṛhe svātmayāgaṃ karoṣi |	dharā mūla māyā śakti aṇḍa catuṣṭayasya madhye gṛhe sva ātma yāgam karoṣi 
SA_MBSAAMBAPA__NCAASIKAAhk-580	kiṃ kṛtvā ? somaṃ rūpādipañcadaśātmakamevaṃ tejasā	kim kṛtvā somam rūpa ādi pañcadaśa ātmakam evam tejasā 
SA_MBSAAMBAPA__NCAASIKAAhk-581	nijamarīcivisphuraṇena pūrṇāmṛtaṃ caruriva sādhayitvā ekaikatra ca tattve'pi	nija marīci visphuraṇena pūrṇa amṛtam caruḥ iva sādhayitvā eka ekatra ca tattve pi 
SA_MBSAAMBAPA__NCAASIKAAhk-582	ṣaṭtriṃśattattvarūpatā iti kṛtvā viśvātmanijaśāktāmṛtābhāsamayaṃ	ṣaṭtriṃśat tattva rūpa tā iti kṛtvā viśva ātma nija śākta amṛta ābhāsa mayam 
SA_MBSAAMBAPA__NCAASIKAAhk-583	svasaṃniviṣṭaṃ vidhāya | anala udānavahnirmukhaṃ prāptyupāyo yasya	sva saṃniviṣṭam vidhāya analaḥ udāna vahniḥ mukham prāpti upāyaḥ yasya 
SA_MBSAAMBAPA__NCAASIKAAhk-584	brahmādyanāśritāntakāraṇādhiṣṭhitadharādiśivatattvāntādhva-	                                          
SA_MBSAAMBAPA__NCAASIKAAhk-585	visphāramayasya jagatastasya tarpaṇaṃ yattadeva vaiśvadevaṃ yāgaṃ tena somena	visphāra mayasya jagataḥ tasya tarpaṇam yat tat eva vaiśvadevam yāgam tena somena 
SA_MBSAAMBAPA__NCAASIKAAhk-586	caruṇā vidhāya tasya somasya kalāśeṣaṃ	caruṇā vidhāya tasya somasya kalā śeṣam 
SA_MBSAAMBAPA__NCAASIKAAhk-587	jagattarpaṇopayuktakalāpañcadaśāvaśiṣṭamūrdhvatuṭyārdhākhyāmāvasyā-	jagat tarpaṇa upayukta kalā pañcadaśa avaśiṣṭam ūrdhva tuṭyā ardha ākhyā amāvasyā 
SA_MBSAAMBAPA__NCAASIKAAhk-588	sambandhi amākhyakalārūpaṃ vighasamiva	sambandhi ama ākhya kalā rūpam vighasam iva 
SA_MBSAAMBAPA__NCAASIKAAhk-589	kavalitāśeṣasaṃskārakalpamivāśnan |	kavalita aśeṣa saṃskāra kalpam iva aśnan 
SA_MBSAAMBAPA__NCAASIKAAhk-590	amṛtaṃ candrarūpeṇa dvidhā ṣoḍaśadhā punaḥ |	amṛtam candra rūpeṇa dvidhā ṣoḍaśadhā punar 
SA_MBSAAMBAPA__NCAASIKAAhk-591	pibanti ca surāḥ sarve daśa pañca parāḥ kalāḥ ||	pibanti ca surāḥ sarve daśa pañca parāḥ kalāḥ 
SA_MBSAAMBAPA__NCAASIKAAhk-592	amāśeṣaguhāntaḥsthāmāvasyā viśvatarpiṇī ||	                     
SA_MBSAAMBAPA__NCAASIKAAhk-593	iti śrīkālikākramādiṣṭanītyā viśvadevatā paramārthe svātmani camatkurvan |	iti śrī kālikā krama ādiṣṭa nītyā viśvadevatā paramārthe sva ātmani camatkurvan 
SA_MBSAAMBAPA__NCAASIKAAhk-594	kīdṛk tvam ? gṛhapatiriva | so'pi hi pūrṇāmṛtakalpamāmāvasyaṃ caruṃ	kīdṛś tvam gṛhapatiḥ iva saḥ api hi pūrṇa amṛta kalpam āmāvasyam carum 
SA_MBSAAMBAPA__NCAASIKAAhk-595	prasādhya tenāgnipramukhasarvajagattarpaṇaṃ vaiśvadevaṃ ca kṛtvā	prasādhya tena agni pramukha sarva jagat tarpaṇam vaiśvadevam ca kṛtvā 
SA_MBSAAMBAPA__NCAASIKAAhk-596	taccheṣamaśnan svātmadevatāyāgaṃ karoti | bāhyo'pi sūryaḥ	tad śeṣam aśnan sva ātma devatā yāgam karoti sūryaḥ 
SA_MBSAAMBAPA__NCAASIKAAhk-597	svaraśmitāpapradrāvitasomakalāpañcadaśakena devarṣinarātmajagattarpaṇaṃ	sva raśmi tāpa pradrāvita soma kalā pañcadaśakena deva ṛṣi nara ātma jagat tarpaṇam 
SA_MBSAAMBAPA__NCAASIKAAhk-598	vidhāyāmākhyakalācamatkaraṇātmaśvātmayāgaṃ	            
SA_MBSAAMBAPA__NCAASIKAAhk-599	brahmāṇḍasyāntarvidhatte || 27 ||	brahmāṇḍasya antar vidhatte 
SA_MBSAAMBAPA__NCAASIKAAhk-600	kṛtvā naktaṃ dinamiva jagadbījamāvyaktikaṃ yat	kṛtvā naktam dinam iva jagat bījam āvyaktikam yat 
SA_MBSAAMBAPA__NCAASIKAAhk-601	tatraivāntardinakara tathā brāhmamanyattato'lpam |	tatra eva antar dinakara tathā brāhmam anyat tatas ulpam 
SA_MBSAAMBAPA__NCAASIKAAhk-602	daivaṃ pitryaṃ kramaparigataṃ mānuṣaṃ cālpamalpaṃ	daivam pitryam krama parigatam mānuṣam ca alpam alpam 
SA_MBSAAMBAPA__NCAASIKAAhk-603	kurvan kurvan kalayasi jagat pañcadhāvartanābhiḥ || 28 ||	kurvan kurvan kalayasi jagant pañcadhā āvarta nābhiḥ 
SA_MBSAAMBAPA__NCAASIKAAhk-604	he dinakara viśvodayakāridivasasaṃpādaka cidbhāno, jagataḥ	he dinakara viśva udaya kāri divasa saṃpādaka cit bhāno jagataḥ 
SA_MBSAAMBAPA__NCAASIKAAhk-605	sadāśivāntasya viśvasya yad bījamārambhāvasānayorudayāpavargakāraṇaṃ	sadāśiva antasya viśvasya yat bījam ārambha avasānayoḥ udaya apavarga kāraṇam 
SA_MBSAAMBAPA__NCAASIKAAhk-606	śrīsvacchandādiṣṭavitataparārdhātmakālarūpamahorātraṃ tatkṛtvābhāsya	śrī svacchanda ādiṣṭa vitata parārdha ātma kāla rūpam ahorātram tat kṛtvā ābhāsya 
SA_MBSAAMBAPA__NCAASIKAAhk-607	tatraivāntarjagataḥ kalādikṣityantasyāśuddhādhvarūpasya bījaṃ	tatra eva antar jagataḥ kalā ādi kṣiti antasya aśuddha adhva rūpasya bījam 
SA_MBSAAMBAPA__NCAASIKAAhk-608	māyeyamahorātraṃ tadantarapyāvyaktikaṃ prākṛtaṃ tadantarapi brāhmaṃ	māyā iyam ahorātram tad antar api āvyaktikam prākṛtam tad antar api brāhmam 
SA_MBSAAMBAPA__NCAASIKAAhk-609	tatrāpi daivaṃ tatrāpi pitryaṃ pitṛsambandhi tatrāpi mānuṣaṃ	tatra api daivam tatra api pitryam pitṛ sambandhi tatra api mānuṣam 
SA_MBSAAMBAPA__NCAASIKAAhk-610	krameṇālpamalpaṃ kurvan kurvanniva vaicitryasahasrairābhāsayanniva	krameṇa alpam alpam kurvan kurvan iva vaicitrya sahasraiḥ ābhāsayan iva 
SA_MBSAAMBAPA__NCAASIKAAhk-611	jagadviśvaṃ pañcadhāvartanābhirvicitrajāgarādidaśāpañcakaparāvartanaiḥ	jagat viśvam pañcadhā āvartanābhiḥ vicitra jāgara ādi daśā pañcaka parāvartanaiḥ 
SA_MBSAAMBAPA__NCAASIKAAhk-612	kalayasi antaravasthitaṃ bahiḥ kṣipasi | nirmimīṣe nirmitaṃ ca kalayasi |	kalayasi antar avasthitam bahis kṣipasi nirmimīṣe nirmitam ca kalayasi 
SA_MBSAAMBAPA__NCAASIKAAhk-613	idamitthamidamidamiti saṃkhyānena sthāpayasi | sthāpitamapi kalayasi	idam ittham idam idam iti saṃkhyānena sthāpayasi sthāpitam api kalayasi 
SA_MBSAAMBAPA__NCAASIKAAhk-614	antaḥsaṃharasi | saṃhṛtamapi kalayasi saṃskāragālanena vimṛśasi | vimṛṣṭamapi	antar saṃharasi saṃhṛtam api kalayasi saṃskāra gālanena vimṛśasi vimṛṣṭam api 
SA_MBSAAMBAPA__NCAASIKAAhk-615	kalayasi svātmābhedena jānīṣe svaprakāśaikātmyamāpādayasi | tathā punarapi	kalayasi sva ātma abhedena jānīṣe sva prakāśa aikātmyam āpādayasi tathā punar api 
SA_MBSAAMBAPA__NCAASIKAAhk-616	svarūpāt kalayasi navaṃ navamullāsayasi | ityevaṃ	svarūpāt kalayasi navam navam ullāsayasi iti evam 
SA_MBSAAMBAPA__NCAASIKAAhk-617	sargasthitisaṃhṛtivilāpanasvātmaikyābhāsanaparasparāndolanalīlākrāntaṃ	                                   
SA_MBSAAMBAPA__NCAASIKAAhk-618	karoṣi | atra jagadbījamāvartya dviryojyam | alpamalpamiti vīpsāyām |	karoṣi atra jagat bījam āvartya dvis yojyam alpam alpam iti vīpsāyām 
SA_MBSAAMBAPA__NCAASIKAAhk-619	ayamāśayaḥ - yadyasya yāvadahorātraṃ tattadīye prāṇacāre	ayam āśayaḥ yat yasya yāvat ahorātram tat tadīye prāṇa cāre 
SA_MBSAAMBAPA__NCAASIKAAhk-620	tadaṃśāṃśakāsvapi vā	tad aṃśa aṃśakāsu api vā 
SA_MBSAAMBAPA__NCAASIKAAhk-621	śrīsvacchandādiṣṭamāsodayādiṣaṣṭyabdodayāntaprakriyayā	                          
SA_MBSAAMBAPA__NCAASIKAAhk-622	yogijñānāpekṣayātiparimitamābhāsayati bhagavān,	yogi jñāna apekṣayā atiparimitam ābhāsayati bhagavān 
SA_MBSAAMBAPA__NCAASIKAAhk-623	tatrāpyantarviśvaikātmyaprathanāt	tatra api antar viśva aikātmya prathanāt 
SA_MBSAAMBAPA__NCAASIKAAhk-624	sādāśivāntakālakalanāmaśeṣāmābhāsayatītyābhāsamāno'yaṃ kālo na	sādāśiva anta kāla kalanām aśeṣām ābhāsayati iti ābhāsamānaḥ iyam kālaḥ na 
SA_MBSAAMBAPA__NCAASIKAAhk-625	tvasya vāstavaṃ kiñcittattvamasti | ata eva kurvannivetīvaśabdenāyamevārthaḥ	tvasya vāstavam kiñcid tattvam asti atas eva kurvan iva iti iva śabdena ayam eva arthaḥ 
SA_MBSAAMBAPA__NCAASIKAAhk-626	spaṣṭaḥ | vastuto hyetāvadviśvodayāvasthānavilāpanādyātmā parameśvara	spaṣṭaḥ vastutas hi etāvat viśva udaya avasthāna vilāpana ādi ātmā parameśvara 
SA_MBSAAMBAPA__NCAASIKAAhk-627	eveti sphurati | na tu cidekavapuṣastato'tiriktaṃ kimapyasti | atra ca	eva iti sphurati na tu cit eka vapuṣaḥ tata utiriktam kim api asti atra ca 
SA_MBSAAMBAPA__NCAASIKAAhk-628	mānuṣādyahorātrapramāṇaṃ śrīsvacchande coktam | tadyathā -	mānuṣa ādi ahorātra pramāṇam śrī svacchande ca uktam tat yathā 
SA_MBSAAMBAPA__NCAASIKAAhk-629	muhūrtāstu tathā triṃśadahorātrastu mānuṣaḥ |	muhūrtāḥ tu tathā triṃśat ahorātraḥ tu mānuṣaḥ 
SA_MBSAAMBAPA__NCAASIKAAhk-630	dakṣiṇaṃ cāyanaṃ rātriruttaraṃ cāyanaṃ dinam ||	dakṣiṇam ca ayanam rātriḥ uttaram ca ayanam dinam 
SA_MBSAAMBAPA__NCAASIKAAhk-631	pitṝṇāṃ tadahorātramanenābdaṃ tu pūrvavat |	pitṝṇām tat ahorātram anena abdam tu pūrvavat 
SA_MBSAAMBAPA__NCAASIKAAhk-632	evaṃ devaistvahorātraḥ ........................................... || iti |	evam devaiḥ tu ahorātraḥ iti 
SA_MBSAAMBAPA__NCAASIKAAhk-633	yattviha daivaṃ pitryaṃ pṛthaguktaṃ tatpitṛsambandhyahorātro jñeyaḥ |	yat tu iha daivam pitryam pṛthak uktam tad pitṛ sambandhī ahorātraḥ jñeyaḥ 
SA_MBSAAMBAPA__NCAASIKAAhk-634	teṣāṃ śuklakṛṣṇarūpo hi saḥ | kiñca -	teṣām śukla kṛṣṇa rūpaḥ hi saḥ kiñca 
SA_MBSAAMBAPA__NCAASIKAAhk-635	kalpo brahmadinaṃ proktaṃ caturyugasahasrakam |	kalpaḥ brahmadinam proktam caturyuga sahasrakam 
SA_MBSAAMBAPA__NCAASIKAAhk-636	ṣaṭtriṃśattu sahasrāṇi brahmaṇaḥ pralayodbhavaḥ ||	ṣaṭtriṃśat tu sahasrāṇi brahmaṇaḥ pralaya udbhavaḥ 
SA_MBSAAMBAPA__NCAASIKAAhk-637	avyaktastheṣu rudreṣu dinarātriśca tāvatī |	avyakta stheṣu rudreṣu dina rātriḥ ca tāvatī 
SA_MBSAAMBAPA__NCAASIKAAhk-638	prādhānikaparārdhena daśadhā guṇitena tu |	prādhānika parārdhena daśadhā guṇitena tu 
SA_MBSAAMBAPA__NCAASIKAAhk-639	māyā saṃharate sarvaṃ punaścaiva sṛjejjagat || iti |	māyā saṃharate sarvam punar ca eva sṛjet jagat iti 
SA_MBSAAMBAPA__NCAASIKAAhk-640	tathā -	tathā 
SA_MBSAAMBAPA__NCAASIKAAhk-641	śaktirkālaparārdhasya koṭidhā guṇitasya ca |	śaktiḥ kāla parārdhasya koṭidhā guṇitasya ca 
SA_MBSAAMBAPA__NCAASIKAAhk-642	anāśritasya devasya dinametat prakīrtitam ||	anāśritasya devasya dinam etat prakīrtitam 
SA_MBSAAMBAPA__NCAASIKAAhk-643	ityevamādi | tathaikatra prāṇacāre ghaṭikodayāt prabhṛti ṣaṣṭyabdodayāntaṃ	iti evamādi tathā ekatra prāṇa cāre ghaṭikā udayāt prabhṛti ṣaṣṭi abda udaya antam 
SA_MBSAAMBAPA__NCAASIKAAhk-644	vitataṃ tatrādiṣṭaṃ granthagauravabhayānna darśitam | evamahorātrakṛttvena	vitatam tatra ādiṣṭam grantha gaurava bhayāt na darśitam evam ahorātra kṛt tvena 
SA_MBSAAMBAPA__NCAASIKAAhk-645	jagadviparivartakatvaṃ bhagavata uktam || 28 ||	jagat viparivartaka tvam bhagavataḥ uktam 
SA_MBSAAMBAPA__NCAASIKAAhk-646	ye tvahorātrapraśame rūḍhāste lokottarā evetyāha -	ye tu ahar rātra praśame rūḍhāḥ te loka uttarāḥ eva iti āha 
SA_MBSAAMBAPA__NCAASIKAAhk-647	tattvāloke tapana sudine ye paraṃ saṃprabuddhā	tattva āloke tapana sudine ye param saṃprabuddhā 
SA_MBSAAMBAPA__NCAASIKAAhk-648	ye vā cittopaśamarajanīyoganidrāmupetāḥ |	ye vā citta upaśama rajanī yoga nidrām upetāḥ 
SA_MBSAAMBAPA__NCAASIKAAhk-649	te'horātroparamaparamānandasaṃdhyāsu sauraṃ	sauram 
SA_MBSAAMBAPA__NCAASIKAAhk-650	bhittvā jyotiḥ paramaparamaṃ yānti nirvāṇasaṃjñam || 29 ||	bhittvā jyotiḥ parama paramam yānti nirvāṇa saṃjñam 
SA_MBSAAMBAPA__NCAASIKAAhk-651	he tapana mahāprakāśarūpa, ye yoginastattvālokātmani	he tapana mahā prakāśa rūpa ye yoginaḥ tattva āloka ātmani 
SA_MBSAAMBAPA__NCAASIKAAhk-652	śobhane'niśodite'nastamite dine pāramārthike sarvadaśānusyūte sarvatomukhe	dine pāramārthike sarva daśa anusyūte sarvatomukhe 
SA_MBSAAMBAPA__NCAASIKAAhk-653	citprakāśe samyak prāṇāyāmādyāyāsaṃ vinā vimarśayuktyā prabuddhā	cit prakāśe samyak prāṇāyāma ādi āyāsam vinā vimarśa yuktyā prabuddhā 
SA_MBSAAMBAPA__NCAASIKAAhk-654	galitākhyātitāmisrāḥ | ye cānye cittopaśama eva	galita ākhyāti tāmisrāḥ ye ca anye citta upaśame eva 
SA_MBSAAMBAPA__NCAASIKAAhk-655	sarvabāhyābhyāsanivṛttihetutvād rajanī, tasyāṃ yoganidrāmupetāḥ |	sarva bāhya abhyāsa nivṛtti hetu tvāt rajanī tasyām yoga nidrām upetāḥ 
SA_MBSAAMBAPA__NCAASIKAAhk-656	praśamitavikalpasavikalpaprakāśaikyamāpannāḥ | ubhaye'pi te	praśamita vikalpa sa vikalpa prakāśa aikyam āpannāḥ ubhaye api te 
SA_MBSAAMBAPA__NCAASIKAAhk-657	prāgvarṇitasamastāhorātroparama eva paramānandarūpāḥ sandhyā	                 
SA_MBSAAMBAPA__NCAASIKAAhk-658	nimajjatprāṇāpānavyāptiśivasāmarasyabhuvaḥ sarvatodikkamuditāstāsu	nimajjat prāṇa apāna vyāpti śiva sa amarasya bhuvaḥ sarvatodikka muditāḥ tāsu 
SA_MBSAAMBAPA__NCAASIKAAhk-659	sauramiti prāṇīyamaparamamiti sthūlaṃ jyotiḥ saṃkucitaṃ prakāśaṃ bhittvā	sauram iti prāṇīyam aparamam iti sthūlam jyotiḥ saṃkucitam prakāśam bhittvā 
SA_MBSAAMBAPA__NCAASIKAAhk-660	niḥsaṃskāraṃ vilāpya paraṃ nirvāṇamārgaṃ yānti sadā paraṃ śāktaṃ	niḥsaṃskāram vilāpya param nirvāṇa mārgam yānti sadā param śāktam 
SA_MBSAAMBAPA__NCAASIKAAhk-661	dhāmāśliṣyante || 29 ||	dhām āśliṣyante   /
SA_MBSAAMBAPA__NCAASIKAAhk-662	na kevalāṃ citrāṃ kālakalanāmakālakalitasvarūpasamāpattiṃ ca	na kevalām citrām kāla kala nāma kāla kalita sva rūpa samāpattim ca 
SA_MBSAAMBAPA__NCAASIKAAhk-663	darśayasi, yāvajjagadudayāpāyāvapītyāha -	darśayasi yāvat jagat udaya apāyau api iti āha 
SA_MBSAAMBAPA__NCAASIKAAhk-664	ā brahmedaṃ navamiva jagajjaṅgamasthāvarāntaṃ	ā brahma idam navam iva jagat jaṅgama sthāvara antam 
SA_MBSAAMBAPA__NCAASIKAAhk-665	sarge sarge visṛjasi rave gobhirudriktasomaiḥ |	sarge sarge visṛjasi rave gobhiḥ udrikta somaiḥ 
SA_MBSAAMBAPA__NCAASIKAAhk-666	dīptaiḥ pratyāharasi ca laye tadyathāyoni bhūyaḥ	dīptaiḥ pratyāharasi ca laye tat yathāyoni bhūyas 
SA_MBSAAMBAPA__NCAASIKAAhk-667	sargāntādau prakaṭavibhavāṃ darśayan raśmilīlām || 30 ||	sarga anta ādau prakaṭa vibhavām darśayan raśmi līlām 
SA_MBSAAMBAPA__NCAASIKAAhk-668	ābrahmaṇaḥ śāktādrūpādābrahma nijaṃ paraṃ śāktaṃ rūpaṃ	ābrahmaṇaḥ śāktāt rūpāt ābrahma nijam param śāktam rūpam 
SA_MBSAAMBAPA__NCAASIKAAhk-669	varjayitvā idaṃ sarvaṃ sādāśivādikṣityantaṃ jaṅgamasthāvare antau bhāgau	varjayitvā idam sarvam sādāśiva ādi kṣiti antam jaṅgama sthāvare antau bhāgau 
SA_MBSAAMBAPA__NCAASIKAAhk-670	yasya tādṛg jagatsarge sarge prathamecchonmeṣātmanyādisarge bhūyo bhūya	yasya tādṛś jagat sarge sarge prathama icchā unmeṣa ātmani ādisarge bhūyas bhūya 
SA_MBSAAMBAPA__NCAASIKAAhk-671	udriktasomaiḥ sphītaśāktāmṛtairgobhirmarīcibhirvisṛjasi āśyānībhūtaṃ	udrikta somaiḥ sphīta śākta amṛtaiḥ gobhiḥ marīcibhiḥ visṛjasi āśyānībhūtam 
SA_MBSAAMBAPA__NCAASIKAAhk-672	nijaraśmirūpaṃ prakaṭayasi | bhūyo dīptairagnipradhānirgobhistajjagadyathāyoni	nija raśmi rūpam prakaṭayasi bhūyas dīptaiḥ agni pradhāniḥ gobhiḥ tat jagat yathāyoni 
SA_MBSAAMBAPA__NCAASIKAAhk-673	pratyāharasi svasvātantryāvabhāsitatattatkāraṇaniveśapuraḥsaraṃ laye	pratyāharasi sva svātantrya avabhāsita tad tad kāraṇa niveśa puraḥsaram laye 
SA_MBSAAMBAPA__NCAASIKAAhk-674	svacidaikyābhāsanātmani saṃhāre pratīpamāharasi cidekamayameva karoṣi | kiṃ	sva cit aikya ābhāsana ātmani saṃhāre pratīpam āharasi cit eka mayam eva karoṣi kim 
SA_MBSAAMBAPA__NCAASIKAAhk-675	kurvan ? sargasya sṛṣṭerādau ante prakaṭavibhavāṃ sphuṭamāhātmyāṃ	kurvan sargasya sṛṣṭeḥ ādau ante prakaṭa vibhavām sphuṭa māhātmyām 
SA_MBSAAMBAPA__NCAASIKAAhk-676	raśmilīlāṃ prakaṭayannijamarīcivilāsamābhāsayan || 30 ||	raśmi līlām prakaṭayan nija marīci vilāsam ābhāsayan 
SA_MBSAAMBAPA__NCAASIKAAhk-677	śritvā nityopacitamucitaṃ brahmatejaḥprakāśaṃ	śritvā nitya upacitam ucitam brahma tejaḥ prakāśam 
SA_MBSAAMBAPA__NCAASIKAAhk-678	rūpaṃ sargasthitilayamucā sarvabhūteṣu madhye |	rūpam sarga sthiti laya mucā sarva bhūteṣu madhye 
SA_MBSAAMBAPA__NCAASIKAAhk-679	antevāsiṣviva suguruṇā yaḥ parokṣaḥ prakṛtyā	antevāsiṣu iva su guruṇā yaḥ parokṣaḥ prakṛtyā 
SA_MBSAAMBAPA__NCAASIKAAhk-680	pratyakṣo'sau jagati bhavatā darśitaḥ svātmanātmā || 31 ||	pratyakṣaḥ asau jagati bhavatā darśitaḥ sva ātmanā ātmā 
SA_MBSAAMBAPA__NCAASIKAAhk-681	he bhagavan, yaḥ prakṛtyā svabhāvena parokṣo'kṣāgocara ātmā asau	he bhagavan yaḥ prakṛtyā svabhāvena parokṣa ukṣā gocaraḥ ātmā asau 
SA_MBSAAMBAPA__NCAASIKAAhk-682	jagati sarvabhūteṣu madhye bhavatā'ntevāsiṣu anugrāhyeṣu ātmanaiva pratyakṣo	jagati sarva bhūteṣu madhye bhavatā antevāsiṣu anugrāhyeṣu ātmanā eva 
SA_MBSAAMBAPA__NCAASIKAAhk-683	darśitaḥ svaprakāśatayā prakaṭīkṛtaḥ | kiṃ kṛtvā ? nityopacitaṃ sadā	darśitaḥ sva prakāśa tayā prakaṭīkṛtaḥ kim kṛtvā nitya upacitam sadā 
SA_MBSAAMBAPA__NCAASIKAAhk-684	paripūrṇamucitaṃ cidānandaghanaṃ rūpaṃ śritvā dehādinimajjanenonmagnaṃ	paripūrṇam ucitam cit ānanda ghanam rūpam śritvā deha ādi nimajjanena unmagnam 
SA_MBSAAMBAPA__NCAASIKAAhk-685	vidhāya | kīdṛg rūpam ? brahmatejaḥprakāśaṃ bṛhattvād bṛṃhakatvācca	vidhāya kīdṛś rūpam brahma tejaḥ prakāśam bṛhat tvāt bṛṃhaka tvāt ca 
SA_MBSAAMBAPA__NCAASIKAAhk-686	brahma dvaitadāhitvāttejo yasya tādṛśaḥ prakāśaḥ prathā yasya | kīdṛśena	brahma dvaita dāhi tvāt tejaḥ yasya tādṛśaḥ prakāśaḥ prathā yasya kīdṛśena 
SA_MBSAAMBAPA__NCAASIKAAhk-687	bhavatā ? sargasthitilayamucā jananādiśūnyena yathāntevāsiṣu śiṣyeṣu	bhavatā sarga sthiti laya mucā janana ādi śūnyena yathā antevāsiṣu śiṣyeṣu 
SA_MBSAAMBAPA__NCAASIKAAhk-688	śobhanena dṛṣṭatattvena guruṇā ātmā darśyate cinmayī sattā prakaṭīkriyate,	śobhanena dṛṣṭa tattvena guruṇā ātmā darśyate cit mayī sattā prakaṭīkriyate 
SA_MBSAAMBAPA__NCAASIKAAhk-689	tathā tvayāntaḥ paramātmatayā bahiśca tejo viśvarūpatayā svayamātmā	tathā tvayā antar parama ātma tayā bahis ca tejaḥ viśva rūpa tayā svayam ātmā 
SA_MBSAAMBAPA__NCAASIKAAhk-690	prakaṭīkriyate || 31 ||	prakaṭīkriyate 
SA_MBSAAMBAPA__NCAASIKAAhk-691	lokāḥ sarve vapuṣi niyataṃ te sthitāstvaṃ ca teṣā-	lokāḥ sarve vapuṣi niyatam te sthitāḥ tvam ca teṣā 
SA_MBSAAMBAPA__NCAASIKAAhk-692	mekaikasmin yugapadaguṇo viśvahetorguṇīva |	yugapad aguṇaḥ viśva hetoḥ guṇī iva 
SA_MBSAAMBAPA__NCAASIKAAhk-693	itthaṃbhūte bhavati bhagavanna tvadanyo'smi satyaṃ	itthaṃbhūte bhavati bhagavan na tvad anyaḥ asmi satyam 
SA_MBSAAMBAPA__NCAASIKAAhk-694	kintu jñastvaṃ paramapuruṣo'haṃ prakṛtyaiva cājñaḥ || 32 ||	kintu jñaḥ tvam parama puruṣaḥ ham prakṛtyā eva ca ajñaḥ 
SA_MBSAAMBAPA__NCAASIKAAhk-695	he bhagavan parānandātmaka	he bhagavan para ānanda ātmaka 
SA_MBSAAMBAPA__NCAASIKAAhk-696	svātantryaśaktisvarūpaparāvāgāliṅgitamūrte, te tava	svātantrya śakti svarūpa parāvāc āliṅgita mūrte te tava 
SA_MBSAAMBAPA__NCAASIKAAhk-697	viśvahetoraśeṣakāraṇasya vapuṣi prakāśānandaghane svarūpe sarve lokā	viśva hetoḥ aśeṣa kāraṇasya vapuṣi prakāśa ānanda ghane sva rūpe sarve 
SA_MBSAAMBAPA__NCAASIKAAhk-698	lokyamānāḥ padārthāḥ, lokayitāraśca rudrakṣetrajñarūpāḥ pramātāraḥ	lokyamānāḥ padārthāḥ lokayitāraḥ ca rudra kṣetrajña rūpāḥ pramātāraḥ 
SA_MBSAAMBAPA__NCAASIKAAhk-699	sthitāḥ | tvaccidātmikāṃ sattāṃ vinā hi kathamete tvatto viśvahetorudiyuḥ |	sthitāḥ tvad cit ātmikām sattām vinā hi katham ete tvattaḥ viśva hetoḥ udiyuḥ 
SA_MBSAAMBAPA__NCAASIKAAhk-700	teṣāṃ ca lokānāṃ saṃbandhinyekaikasmin vapuṣi tvaṃ yugapadakrameṇaiva	teṣām ca lokānām saṃbandhini ekaikasmin vapuṣi tvam yugapad akrameṇa eva 
SA_MBSAAMBAPA__NCAASIKAAhk-701	sthitaḥ | anyathā te tvatprakāśatāṃ vinā hi kathaṃ prakāśeran | ataśca tvaṃ	sthitaḥ anyathā te tvad prakāśa tām vinā hi katham prakāśeran atas ca tvam 
SA_MBSAAMBAPA__NCAASIKAAhk-702	sattvādiguṇahīno'pi viśvātmatābhāsaguṇād guṇīvābhāsi | itthamupavarṇite	sattva ādi guṇa hīnaḥ api viśva ātma tā ābhāsa guṇāt guṇī iva ābhāsi ittham upavarṇite 
SA_MBSAAMBAPA__NCAASIKAAhk-703	viśvātmani bhavati sati satyamasmi nānyaḥ | kintu tvamevaṃbhūtaḥ paramaḥ	viśvātmani bhavati sati satyam asmi na anyaḥ kintu tvam evaṃbhūtaḥ paramaḥ 
SA_MBSAAMBAPA__NCAASIKAAhk-704	puruṣo jñaḥ paripūrṇaḥ sārvajñyādidharmaḥ | ahamiti tvayaiva dehādiṣu	puruṣaḥ jñaḥ paripūrṇaḥ sārvajñya ādi dharmaḥ aham iti tvayā eva deha ādiṣu 
SA_MBSAAMBAPA__NCAASIKAAhk-705	grāhitapramātṛbhāvaḥ prakṛtyā tvanmāyāmāhātmyādajñaḥ | ataśca	grāhita pramātṛ bhāvaḥ prakṛtyā tvad māyā māhātmyāt ajñaḥ atas ca 
SA_MBSAAMBAPA__NCAASIKAAhk-706	dehādipramātṛtānimajjanenājñatāṃ praśamayya nityaṃ svātmasamāveśena	deha ādi pramātṛ tā nimajjanena ajña tām praśamayya nityam sva ātma samāveśena 
SA_MBSAAMBAPA__NCAASIKAAhk-707	jñatāṃ mamonmajjayetyarthāduktaṃ bhavati || 32 ||	jña tām mama unmajjaya iti arthāt uktam bhavati 
SA_MBSAAMBAPA__NCAASIKAAhk-708	saṃkalpecchādyakhilakaraṇaprāṇavāṇyo vareṇyāḥ	saṃkalpa icchā ādi akhila karaṇa prāṇa vāṇyaḥ vareṇyāḥ 
SA_MBSAAMBAPA__NCAASIKAAhk-709	saṃpannā me tvadabhinavanājjanma cedaṃ śaraṇyam |	saṃpannā me tvad abhinavanāt janma ca idam śaraṇyam 
SA_MBSAAMBAPA__NCAASIKAAhk-710	manye cāstaṃ jigamiṣu śanaiḥ puṇyapāpadvayaṃ tad	manye ca astam śanais puṇya pāpa dvayam tat 
SA_MBSAAMBAPA__NCAASIKAAhk-711	bhaktiśraddhe tava caraṇayoranyathā no bhavetām || 33 ||	bhakti śraddhe tava caraṇayoḥ anyathā naḥ bhavetām 
SA_MBSAAMBAPA__NCAASIKAAhk-712	itthamajñasyāpi me	ittham ajñasya api me 
SA_MBSAAMBAPA__NCAASIKAAhk-713	tvadabhinavanāccidātmatvadābhimukhyapravṛttatvatparāmarśātmastutivaśāt |	tvad abhinavanāt cit ātma tvad ābhimukhya pravṛtta tvad parāmarśa ātma stuti vaśāt 
SA_MBSAAMBAPA__NCAASIKAAhk-714	saṃkalpaḥ sthūlecchā | icchā saṅkalpakāraṇabhūtā	saṃkalpaḥ sthūla icchā icchā saṅkalpa kāraṇa bhūtā 
SA_MBSAAMBAPA__NCAASIKAAhk-715	sūkṣmavikalpaparāmarśātmā | ādiśabdāt	                  
SA_MBSAAMBAPA__NCAASIKAAhk-716	prayatnastadanantaramālocanādānādipravṛttāni vāgvarjānyakhilāni karaṇāni	prayatnaḥ tad anantaram ālocanā ādāna ādi pravṛttāni vāc varjāni akhilāni karaṇāni 
SA_MBSAAMBAPA__NCAASIKAAhk-717	satsahavṛttiḥ prāṇaḥ, sarvatrātra sūkṣmaparāmarśarūpatayā vyāpakatvena	sat sahavṛttiḥ prāṇaḥ sarvatra atra sūkṣma parāmarśa rūpa tayā vyāpaka tvena 
SA_MBSAAMBAPA__NCAASIKAAhk-718	sthitā vāṇī cetyete mama varaṇe parānugrahe sādhavo vareṇyā jātāḥ,	sthitā vāṇī ca iti ete mama varaṇe para anugrahe sādhavaḥ vareṇyāḥ jātāḥ 
SA_MBSAAMBAPA__NCAASIKAAhk-719	tathedamiti paścimajanma śaraṇyaṃ śaraṇe sādhu anugrāhyānugrahaikaparaṃ	tathā idam iti paścima janma śaraṇyam śaraṇe sādhu anugrāhya anugraha eka param 
SA_MBSAAMBAPA__NCAASIKAAhk-720	sampannam | ahaṃ hi sarvadaśāsu cidarkaparāmarśaparaḥ parānapyanugṛhṇan	sampannam aham hi sarva daśāsu cit arka parāmarśa paraḥ parān api anugṛhṇan 
SA_MBSAAMBAPA__NCAASIKAAhk-721	sthitaḥ | kiñca, manye svānubhavenaivaitaccetaye yatpuṇyapāpadvayaṃ	sthitaḥ kiñca manye sva anubhavena eva etat cetaye yat puṇya pāpa dvayam 
SA_MBSAAMBAPA__NCAASIKAAhk-722	sukṛtāsukṛtajātaṃ sarvaṃ tadityanantajanmārjitaṃ śanairastaṃ jigamiṣu	su kṛta a sukṛta jātam sarvam tat iti ananta janma arjitam śanais astam jigamiṣu 
SA_MBSAAMBAPA__NCAASIKAAhk-723	himavilāyaṃ vilīyamānaṃ sthitam | prāksaṃcitasarvakarmaṇāṃ hi dhvaṃse'pi	himavilāyam vilīyamānam sthitam prāc saṃcita sarva karmaṇām hi dhvaṃse pi 
SA_MBSAAMBAPA__NCAASIKAAhk-724	dehārambhakakarmaṇāṃ dhvaṃsonmukhatvājjigamiṣvityuktam | anyatheti | yadi	deha ārambhaka karmaṇām dhvaṃsa unmukha tvāt jigamiṣu iti uktam anyathā iti yadi 
SA_MBSAAMBAPA__NCAASIKAAhk-725	naivaṃ syāttatkathaṃ bhavaccaraṇayorbhaktiśraddhe bhavetām | naiva syātām |	na evam syāt tat katham bhavat caraṇayoḥ bhakti śraddhe bhavetām na eva syātām 
SA_MBSAAMBAPA__NCAASIKAAhk-726	yaduktaṃ nandiśikhāyām -	yat uktam nandiśikhāyām 
SA_MBSAAMBAPA__NCAASIKAAhk-727	yadā śive'bhilāṣo vai jāyate ca nṛṇāṃ sadā |	yadā śiva ibhilāṣaḥ vai jāyate ca nṛṇām sadā 
SA_MBSAAMBAPA__NCAASIKAAhk-728	tadā śivābhimānāste jāyante paramāṇavaḥ ||	tadā śiva abhimānāḥ te jāyante paramāṇavaḥ 
SA_MBSAAMBAPA__NCAASIKAAhk-729	muktāstadaiva te dīkṣāṃ prāpnuvanti gurostataḥ || iti || 33 ||	muktāḥ tadā eva te dīkṣām prāpnuvanti guroḥ tatas iti 
SA_MBSAAMBAPA__NCAASIKAAhk-730	satyaṃ bhūyo jananamaraṇe tvatprapanneṣu na sta-	satyam bhūyas janana maraṇe tvad prapanneṣu na sta 
SA_MBSAAMBAPA__NCAASIKAAhk-731	statrāpyekaṃ tava nutiphalaṃ janma yāce tadittham |	s tatra api ekam tava nuti phalam janma yāce tat ittham 
SA_MBSAAMBAPA__NCAASIKAAhk-732	trailokyeśaḥ śama iva paraḥ puṇyakāyo'pyayoniḥ	trailokya īśaḥ śamaḥ iva paraḥ puṇya kāya upi ayoniḥ 
SA_MBSAAMBAPA__NCAASIKAAhk-733	saṃsārābdhau plava iva jagattāraṇāya sthiraḥ syām || 34 ||	saṃsāra abdhau plavaḥ iva jagat tāraṇāya sthiraḥ syām 
SA_MBSAAMBAPA__NCAASIKAAhk-734	he deva, yadyapi tvatprapanneṣu tvatsamāviṣṭeṣu	he deva yadi api tvad prapanneṣu tvad samāviṣṭeṣu 
SA_MBSAAMBAPA__NCAASIKAAhk-735	saṃsārahetusarvavāsanādāhād bhūyo jananamaraṇe na staḥ, tathāpi	saṃsāra hetu sarva vāsanā dāhāt bhūyas janana maraṇe na staḥ tathā api 
SA_MBSAAMBAPA__NCAASIKAAhk-736	tvannutistvatstutireva phalaṃ yasya tādṛgidamekaṃ paścimajanma yāce | yathā	tvad nutiḥ tvad stutiḥ eva phalam yasya tādṛś idam ekam paścimajanma yāce yathā 
SA_MBSAAMBAPA__NCAASIKAAhk-737	bhavadavamarśātmacamatkārādhāyi etanmāgāt | taditthamanenaiva	bhavat avamarśa ātma camatkāra ādhāyi etat mā agāt tat ittham anena eva 
SA_MBSAAMBAPA__NCAASIKAAhk-738	tvannutirasāviṣṭena prakāreṇāsminneva dehe paraḥ śama iva śāmyatyasmin	tvad nuti rasa āviṣṭena prakāreṇa asmin eva dehe paraḥ śamaḥ iva śāmyati asmin 
SA_MBSAAMBAPA__NCAASIKAAhk-739	viśvamiti vyutpattyā paraḥ śaṅkarātmasvabhāva iva jāgratsvapnasuṣuptātmani	viśvam iti vyutpattyā paraḥ śaṅkara ātma svabhāvaḥ iva jāgrat svapna suṣupta ātmani 
SA_MBSAAMBAPA__NCAASIKAAhk-740	trailokye īśaḥ prabhuḥ | na tu paratantraḥ | ata eva puṇyo darśanasparśanādinā	trailokye īśaḥ prabhuḥ na tu paratantraḥ atas eva puṇyaḥ darśana sparśana ādinā 
SA_MBSAAMBAPA__NCAASIKAAhk-741	parānugrāhī kāyo yasya tādṛk | ayoniriti nityoditacidānandaikaghanaḥ san jagato	para anugrāhī kāyaḥ yasya tādṛś ayoniḥ iti nitya udita cit ānanda eka ghanaḥ san 
SA_MBSAAMBAPA__NCAASIKAAhk-742	viśvasya tāraṇāya saṃsārābdhimadhye plava iva pota iva sthiraḥ syāṃ	viśvasya tāraṇāya saṃsāra abdhi madhye plavaḥ iva potaḥ iva sthiraḥ syām 
SA_MBSAAMBAPA__NCAASIKAAhk-743	cirakālaṃ bhūyāsam || 34 ||	cira kālam bhūyāsam 
SA_MBSAAMBAPA__NCAASIKAAhk-744	sauṣumṇena tvamamṛtapathenaitya śītāṃśubhāvaṃ	sauṣumṇena tvam amṛta pathena etya śītāṃśu bhāvam 
SA_MBSAAMBAPA__NCAASIKAAhk-745	puṣṇāsyagre suranarapitṝn śāntabhābhiḥ kalābhiḥ |	puṣṇāsi agre sura nara pitṝn śānta bhābhiḥ kalābhiḥ 
SA_MBSAAMBAPA__NCAASIKAAhk-746	paścādambho viśasi vividhāścauṣadhīstadgato'pi	paścāt ambhaḥ viśasi vividhāḥ ca oṣadhīḥ tad gataḥ upi 
SA_MBSAAMBAPA__NCAASIKAAhk-747	prīṇāsyevaṃ tribhuvanamataste jaganmitratārka || 35 ||	prīṇāsi evam tribhuvanam atas te jagat mitra tārka 
SA_MBSAAMBAPA__NCAASIKAAhk-748	he arka ! ato hetoste jagato mitratā yaugikamitraśabdābhidheyatvam,	he arka atas hetoḥ te jagataḥ mitra tā yaugika mitra śabda abhidheya tvam 
SA_MBSAAMBAPA__NCAASIKAAhk-749	yatastvaṃ sauṣumṇena madhyamenāmṛtapathenāpyāyinā mārgeṇa	yatas tvam sauṣumṇena madhyamena amṛta pathena āpyāyinā mārgeṇa 
SA_MBSAAMBAPA__NCAASIKAAhk-750	śītāṃśubhāvamapānacandratvametyāgatyāgre prathamaṃ surādīn sarvān	śītāṃśu bhāvam apāna candra tvam etya āgatya agre prathamam sura ādīn sarvān 
SA_MBSAAMBAPA__NCAASIKAAhk-751	pramātṝn puṣṇāsi labdhāvasthitīn karoṣi | kena	pramātṝn puṣṇāsi labdha avasthitīn karoṣi kena 
SA_MBSAAMBAPA__NCAASIKAAhk-752	śāntamābhirantarmukhībhāvenopasaṃhṛtabāhyaprathābhiḥ	śāntam ābhiḥ antar mukhībhāvena upasaṃhṛta bāhya prathābhiḥ 
SA_MBSAAMBAPA__NCAASIKAAhk-753	kalābhirādivisargāntasvābhāvimarśaśaktibhiḥ | paścādanantaramambha iti	kalābhiḥ ādi visarga anta sva abhā vimarśa śaktibhiḥ paścāt anantaram ambhaḥ iti 
SA_MBSAAMBAPA__NCAASIKAAhk-754	bahiḥ prasarapravṛttān sarvavāhān viśasi svāmṛtācchuritān karoṣi |	bahis prasara pravṛttān sarva vāhān viśasi sva amṛta ācchuritān karoṣi 
SA_MBSAAMBAPA__NCAASIKAAhk-755	vividhāścauṣadhīrviśasi sthāvarādisarvabāhyābhāsān svaprakāśāpūritān	vividhāḥ ca oṣadhīḥ viśasi sthāvara ādi sarva bāhya ābhāsān sva prakāśa āpūritān 
SA_MBSAAMBAPA__NCAASIKAAhk-756	vidhatse | tadgato meyaprapañcātmatayā sphurito'pi tribhuvanaṃ viśvamevamiti	vidhatse tad gataḥ meya prapañca ātma tayā sphuritaḥ upi tribhuvanam viśvam evam iti 
SA_MBSAAMBAPA__NCAASIKAAhk-757	tadābhāsanavimarśanayuktyaiva candratvametya pūrvoktanītyā surādīn prīṇāsi	tad ābhāsana vimarśana yuktyā eva candra tvam etya pūrva ukta nītyā sura ādīn prīṇāsi 
SA_MBSAAMBAPA__NCAASIKAAhk-758	tarpayasi | bāhyo'pyarkaḥ suṣumṇāmārgeṇāmṛtasaṃkramaṇayuktyā	tarpayasi suṣumṇā mārgeṇa amṛta saṃkramaṇa yuktyā 
SA_MBSAAMBAPA__NCAASIKAAhk-759	candratvametya pūrvoktanītyā surādīn puṣṇāti | śāntabhābhirnivṛttadīptibhiḥ	candra tvam etya pūrva ukta nītyā sura ādīn puṣṇāti śānta bhābhiḥ nivṛtta dīptibhiḥ 
SA_MBSAAMBAPA__NCAASIKAAhk-760	kalābhiḥ śaktibhirambho viśati dakṣiṇāyane āsārarūpatāṃ svīkaroti |	kalābhiḥ śaktibhiḥ ambhaḥ viśati dakṣiṇāyane āsāra rūpa tām svīkaroti 
SA_MBSAAMBAPA__NCAASIKAAhk-761	oṣadhīśca viśati sarasāḥ karoti | tadgataśca vaiśvadevayāgānuyāgakrameṇa	oṣadhīḥ ca viśati sa rasāḥ karoti tad gataḥ ca vaiśvadeva yāga anuyāga krameṇa 
SA_MBSAAMBAPA__NCAASIKAAhk-762	tribhuvanaṃ puṣṇan jaganmitratvameva darśayati || 35 ||	tribhuvanam puṣṇan jagat mitra tvam eva darśayati 
SA_MBSAAMBAPA__NCAASIKAAhk-763	mandākrānte tamasi bhavatā nātha doṣāvasāne	manda ākrānte tamasi bhavatā nātha doṣa avasāne 
SA_MBSAAMBAPA__NCAASIKAAhk-764	nāntarlīnā mama matiriyaṃ gāḍhanidrāṃ jahāti |	na antar līnā mama matiḥ iyam gāḍha nidrām jahāti 
SA_MBSAAMBAPA__NCAASIKAAhk-765	tasmādastaṃgamitatamasā padminīvātmabhāsā	tasmāt astaṃgamita tamasā padminī iva ātma bhāsā 
SA_MBSAAMBAPA__NCAASIKAAhk-766	saurītyeṣā dinakara paraṃ nīyatāmāśu bodham || 36 ||	saurī iti eṣā dinakara param nīyatām āśu bodham 
SA_MBSAAMBAPA__NCAASIKAAhk-767	he nātha dinakara svāmin cidarka, tvayā tamasyajñāne mandākrānte	he nātha dinakara svāmin cit arka tvayā tamasi ajñāne manda ākrānte 
SA_MBSAAMBAPA__NCAASIKAAhk-768	nirmūlanāyāghrāte sati iyaṃ madīyā matirdhī rāgadveṣāṇāmavasāne	nirmūlanāya āghrāte sati iyam madīyā matiḥ dhī rāga dveṣāṇām avasāne 
SA_MBSAAMBAPA__NCAASIKAAhk-769	jāte'pi antarlīnāntarmukhībhūtāpi gāḍhanidrāṃ tvadabhedākhyātiṃ na	jātā ipi antar līnā antar mukhībhūtā api gāḍha nidrām tvad abheda ākhyātim na 
SA_MBSAAMBAPA__NCAASIKAAhk-770	jahāti | tasmādeṣā tvayā astaṃgamitaṃ tamo yayā tādṛśyātmabhāsā	jahāti tasmāt eṣā tvayā astaṃgamitam tamaḥ yayā tādṛśī ātma bhāsā 
SA_MBSAAMBAPA__NCAASIKAAhk-771	svadīptyā kāraṇabhūtayā āśvavilambitameva paraṃ bodhaṃ	sva dīptyā kāraṇa bhūtayā āśu avilambitam eva param bodham 
SA_MBSAAMBAPA__NCAASIKAAhk-772	praśāntākhyātinijajyotirātmatāṃ nīyatāṃ prāpyatām | sūryo devatā	praśānta ākhyāti nija jyotiḥ ātma tām nīyatām prāpyatām sūryaḥ devatā 
SA_MBSAAMBAPA__NCAASIKAAhk-773	yasyāḥ sā saurīti kṛtvā padminīva nalinīva | sāpi tvayā doṣāvasāne prabhāte	yasyāḥ sā saurī iti kṛtvā padminī iva nalinī iva  sā api tvayā doṣa avasāne prabhāte 
SA_MBSAAMBAPA__NCAASIKAAhk-774	tamasi mandākrānte'ntarlīnā karṇikāsaṃśliṣṭadalā gāḍhanidrāṃ na	tamasi manda ākrānta intar līnā karṇikā saṃśliṣṭa dalā gāḍha nidrām na 
SA_MBSAAMBAPA__NCAASIKAAhk-775	jahātītyastaṃgamitatamasā svātmabhāsā gāḍhībhūtajyotiṣā prabodhyate	jahāti iti astaṃgamita tamasā sva ātma bhāsā gāḍhībhūta jyotiṣā prabodhyate 
SA_MBSAAMBAPA__NCAASIKAAhk-776	tvayā || 36 ||	tvayā 
SA_MBSAAMBAPA__NCAASIKAAhk-777	yena grāsīkṛtamiva jagatsarvamāsīttadastaṃ	yena grāsīkṛtam iva jagat sarvam āsīt tat astam 
SA_MBSAAMBAPA__NCAASIKAAhk-778	dhvāntaṃ nītvā punarapi vibho taddayāghrātacittaḥ |	dhvāntam nītvā punar api vibho tad dayā āghrāta cittaḥ 
SA_MBSAAMBAPA__NCAASIKAAhk-779	dhatse naktaṃdinamapi gatī śuklakṛṣṇe vibhajya	dhatse naktaṃdinam api gatī śukla kṛṣṇe vibhajya 
SA_MBSAAMBAPA__NCAASIKAAhk-780	trātā tasmādbhavaparibhave duṣkṛte me'pi bhāno || 37 ||	trātā tasmāt bhava paribhave duṣkṛte mā ipi bhāno 
SA_MBSAAMBAPA__NCAASIKAAhk-781	he vibho bhāno cinmarīcimālin, yena tamasā'jñānena jagadidaṃ	he vibho bhāno cit marīci mālin yena tamasā ajñānena jagat idam 
SA_MBSAAMBAPA__NCAASIKAAhk-782	grāsīkṛtamāsīt, tadanugṛhītān pratyastaṃ nītvā vināśya taddayāghrātacitta	grāsīkṛtam āsīt tad anugṛhītān pratyastam nītvā vināśya tad dayā āghrāta citta 
SA_MBSAAMBAPA__NCAASIKAAhk-783	iva tadanukampayaiva śuklakṛṣṇagatī  vibhajya vyutthānāvasare	iva tad anukampayā eva śukla kṛṣṇa gatī vibhajya vyutthāna avasare 
SA_MBSAAMBAPA__NCAASIKAAhk-784	prāṇāpānabhūmikāmavaruhya tad dhvāntaṃ punarapi dhatse puṣṇāsi |	prāṇa apāna bhūmikām avaruhya tat dhvāntam punar api dhatse puṣṇāsi 
SA_MBSAAMBAPA__NCAASIKAAhk-785	nirvyutthanaṃ samādhiṃ jhagiti na vitarasītyarthaḥ | yathā bāhyo	nirvyutthanam samādhim na vitarasi iti arthaḥ yathā 
SA_MBSAAMBAPA__NCAASIKAAhk-786	bhānurgrāsīkṛtajagattimiraṃ vināśya punardayayeva naktaṃdinaṃ niśādine	bhānuḥ grāsīkṛta jagat timiram vināśya punar dayayā iva naktaṃdinam niśā dine 
SA_MBSAAMBAPA__NCAASIKAAhk-787	vibhajya dhatte puṣṇātīti śleṣopamā | yata evaṃ durātmani tamasyapi	vibhajya dhatte puṣṇāti iti śleṣa upamā yatas evam durātmani tamasi api 
SA_MBSAAMBAPA__NCAASIKAAhk-788	tvamanukampāvāniva tato me mama paribhave vyutthānātmani kleśe'pi trātā	tvam anukampāvān iva tatas me mama paribhave vyutthāna ātmani kleśe pi trātā 
SA_MBSAAMBAPA__NCAASIKAAhk-789	rakṣitā bhava | kīdṛśe paribhave ? duṣkṛte duṣṭaṃ kṛtaṃ karaṇaṃ	rakṣitā bhava kīdṛśe paribhave duṣkṛte duṣṭam kṛtam karaṇam 
SA_MBSAAMBAPA__NCAASIKAAhk-790	viṣayahānādānādiparibhavo yatra | nirvyutthānasamāveśarasāsvādinaṃ māṃ	                            
SA_MBSAAMBAPA__NCAASIKAAhk-791	kurvityarthaḥ || 37 ||	kuru iti arthaḥ 
SA_MBSAAMBAPA__NCAASIKAAhk-792	vyutthitaḥ samāveśamaprāpnuvan vyutthānadaśānirbhartsanaparaḥ	vyutthitaḥ samāveśam a prāpnuvan vyutthāna daśā nirbhartsana paraḥ 
SA_MBSAAMBAPA__NCAASIKAAhk-793	samāveśaparaṃ bhagavantaṃ prārthayitumāha -	samāveśa param bhagavantam prārthayitum āha 
SA_MBSAAMBAPA__NCAASIKAAhk-794	āsaṃsāropacitasadasatkarmabandhāśritānā-	ā saṃsāra upacita sat asat karma bandha āśritānā 
SA_MBSAAMBAPA__NCAASIKAAhk-795	mādhivyādhiprajanamaraṇakṣutpipāsārditānām |	mādhi vyādhi prajana maraṇa kṣudh pipāsā arditānām 
SA_MBSAAMBAPA__NCAASIKAAhk-796	mithyājñānaprabalatamasā nātha cāndhīkṛtānāṃ	mithyā jñāna prabala tamasā nātha ca andhīkṛtānām 
SA_MBSAAMBAPA__NCAASIKAAhk-797	tvaṃ nastrātā bhava karuṇayā yatratatrasthitānām || 38 ||	tvam naḥ trātā bhava karuṇayā yatra tatra sthitānām 
SA_MBSAAMBAPA__NCAASIKAAhk-798	satpuṇyam | asatpāpam | yatratatrasthitānāmiti deśe kāle'vasthāvaicitrye	sat puṇyam asat pāpam yatra tatra sthitānām iti deśe kāla ivasthā vaicitrye 
SA_MBSAAMBAPA__NCAASIKAAhk-799	ca trātā samāveśaprathanena rakṣakaḥ | śiṣṭaṃ spaṣṭam || 38 ||	ca trātā samāveśa prathanena rakṣakaḥ śiṣṭam spaṣṭam  
SA_MBSAAMBAPA__NCAASIKAAhk-800	satyāsatyaskhalitavacasāṃ śaucalajjojjhitānā-	satya asatya skhalita vacasām śauca lajjā ujjhita ānā 
SA_MBSAAMBAPA__NCAASIKAAhk-801	majñānānāmaphalasaphalaprārthanākātarāṇām |	m a jñānānām aphala sa phala prārthanā kātarāṇām 
SA_MBSAAMBAPA__NCAASIKAAhk-802	sarvāvasthāsvakhilaviṣayābhyastakautūhalānāṃ	sarva avasthāsu akhila viṣaya abhyasta kautūhalānām 
SA_MBSAAMBAPA__NCAASIKAAhk-803	tvaṃ nastrātā bhava pitṛtayā bhogalolārbhakāṇām || 39 ||	tvam naḥ trātā bhava pitṛ tayā bhoga lola arbhakāṇām 
SA_MBSAAMBAPA__NCAASIKAAhk-804	bhogeṣu viṣayasukheṣu lampaṭānāmasmākamarbhakāṇāṃ	bhogeṣu viṣaya sukheṣu lampaṭānām asmākam arbhakāṇām 
SA_MBSAAMBAPA__NCAASIKAAhk-805	bālānāmiva tvaṃ pitṛtayā janakatvena trātā bhaveti prāgvat | tvaṃ hyasmākaṃ	bālānām iva tvam pitṛ tayā janaka tvena trātā bhava iti prāgvat tvam hi asmākam 
SA_MBSAAMBAPA__NCAASIKAAhk-806	tattvadṛṣṭyā janakaḥ | satyāsatyetyubhayatra samam | skhalitaṃ pramādi ekatra,	tattva dṛṣṭyā janakaḥ satya asatya iti ubhayatra samam skhalitam pramādi ekatra 
SA_MBSAAMBAPA__NCAASIKAAhk-807	anyatrā'spaṣṭavarṇatvam | evaṃ śaucaṃ caittaṃ śārīraṃ ca | aphalā saphalā	anyatra aspaṣṭa varṇa tvam evam śaucam caittam śārīram ca aphalā sa phalā 
SA_MBSAAMBAPA__NCAASIKAAhk-808	ca yā prārthanā tayā kātarāṇāmadhīrāṇām | yattatprārthayamānānāmiti |	ca yā prārthanā tayā kātarāṇām adhīrāṇām yat tat prārthayamānānām iti 
SA_MBSAAMBAPA__NCAASIKAAhk-809	subodhamanyat || 39 ||	su bodham anyat  /
SA_MBSAAMBAPA__NCAASIKAAhk-810	yāvaddehaṃ jarayati jarā nāntakādetya dūtī	yāvat deham jarayati jarā na antakāt etya dūtī 
SA_MBSAAMBAPA__NCAASIKAAhk-811	no vā bhīmastriphaṇabhujagākāradurvārapāśaḥ |	no vā bhīmaḥ triphaṇa bhujaga ākāra durvāra pāśaḥ 
SA_MBSAAMBAPA__NCAASIKAAhk-812	gāḍhaṃ kaṇṭhe lagati sahasā jīvitaṃ lelihāna-	gāḍham kaṇṭhe lagati sahasā jīvitam lelihāna 
SA_MBSAAMBAPA__NCAASIKAAhk-813	stāvadbhaktābhayada sadayaṃ śreyase naḥ prasīda || 40 ||	stāvat bhakta abhaya da sa dayam śreyase naḥ prasīda 
SA_MBSAAMBAPA__NCAASIKAAhk-814	he bhaktābhayada, yāvadvyutthitāmaraṇāvasānāṃ durdaśāṃ	he bhakta abhaya da yāvat vyutthita amaraṇa avasānām durdaśām 
SA_MBSAAMBAPA__NCAASIKAAhk-815	nāpnumastāvanno'smākaṃ prasīda dehādisaṃskārakāluṣyapraśamanena	na āpnumaḥ tāvat na usmākam prasīda deha ādi saṃskāra kāluṣya praśamanena 
SA_MBSAAMBAPA__NCAASIKAAhk-816	nirmalībhava | nirvyutthānaprakāśānandaghanaparamasamāveśā-	                                   
SA_MBSAAMBAPA__NCAASIKAAhk-817	mṛtarasāsvādasukhitānasmān saṃpādayetyarthaḥ | spaṣṭamanyat || 40 ||	mṛta rasa āsvāda sukhitān asmān saṃpādaya iti arthaḥ spaṣṭam anyat  /
SA_MBSAAMBAPA__NCAASIKAAhk-818	viśvaprāṇagrasanarasanāṭopakopapragalbhaṃ	viśva prāṇa grasana rasana āṭopa kopa pragalbham 
SA_MBSAAMBAPA__NCAASIKAAhk-819	mṛtyorvaktraṃ dahananayanoddāmadaṃṣṭrākarālam |	mṛtyoḥ vaktram dahana nayana uddāma daṃṣṭrā karālam 
SA_MBSAAMBAPA__NCAASIKAAhk-820	yāvad dṛṣṭvā vrajati na bhiyā pañcatāmeṣa kāya-	yāvat dṛṣṭvā vrajati na bhiyā pañcatām eṣa kāya 
SA_MBSAAMBAPA__NCAASIKAAhk-821	stāvannityāmṛtamaya rave pāhi naḥ kāṃdiśīkān || 41 ||	stāvan nitya amṛta maya rave pāhi naḥ kāṃdiśīkān 
SA_MBSAAMBAPA__NCAASIKAAhk-822	mṛtyorantakasya vaktraṃ dṛṣṭvā yāvadeṣa kāya iti sapuryaṣṭako deho	mṛtyoḥ antakasya vaktram dṛṣṭvā yāvat eṣa kāyaḥ iti sa puryaṣṭakaḥ 
SA_MBSAAMBAPA__NCAASIKAAhk-823	bhiyā bhītyā pañcatāṃ mṛtyuṃ na vrajati tāvadeva rave cidarka nityāmṛtamaya	bhiyā bhītyā pañcatām mṛtyum na vrajati tāvat eva rave cit arka nitya amṛta maya 
SA_MBSAAMBAPA__NCAASIKAAhk-824	anastamitaparamānandaikaghanasvabhāva no'smān kāṃdiśīkān vyutthāne	an astamita paramānanda eka ghana svabhāva na usmān kāṃdiśīkān vyutthāne 
SA_MBSAAMBAPA__NCAASIKAAhk-825	tvatsamāveśaprāptiṃ vinā kāṃ diśaṃ kāyataḥ kā dikkā digasmākamiti	tvad samāveśa prāptim vinā kām diśam kāyataḥ kā diś kā diś asmākam iti 
SA_MBSAAMBAPA__NCAASIKAAhk-826	krandataḥ pāhi nirvyutthanasamāveśān saṃpādaya | kīdṛṅ mṛtyorvaktram ?	krandataḥ pāhi nirvyutthana samāveśān saṃpādaya kīdṛś mṛtyoḥ vaktram 
SA_MBSAAMBAPA__NCAASIKAAhk-827	viśveṣāṃ prāṇagrasano jīvitabhakṣako rasanāṭopo lolarasanāvyāpāro yasya	viśveṣām prāṇa grasanaḥ jīvita bhakṣakaḥ rasanā āṭopaḥ lola rasanā vyāpāraḥ yasya 
SA_MBSAAMBAPA__NCAASIKAAhk-828	tādṛśi kope pragalbhaṃ prauḍham | tathā dahanāni ploṣakāṇi nayanāni yasya	tādṛśi kope pragalbham prauḍham tathā dahanāni ploṣakāṇi nayanāni yasya 
SA_MBSAAMBAPA__NCAASIKAAhk-829	tādṛk | tathā uddāmābhirūrjitābhirdaṃṣṭrābhiḥ karālam || 41 ||	tādṛś tathā uddāmābhiḥ ūrjitābhiḥ daṃṣṭrābhiḥ karālam  /
SA_MBSAAMBAPA__NCAASIKAAhk-830	śabdākāraṃ viyadiva vapuste yajuḥsāmadhāmnaḥ	śabda ākāram viyat iva vapuḥ te yajuḥ sāma dhāmnaḥ 
SA_MBSAAMBAPA__NCAASIKAAhk-831	saptacchandāṃsyapi ca turagā ṛṅmayaṃ maṇḍalaṃ ca |	sapta chandāṃsi api ca turagāḥ ṛc mayam maṇḍalam ca 
SA_MBSAAMBAPA__NCAASIKAAhk-832	evaṃ sarvaśrutimayatayā maddayānugrahādvā	evam sarva śruti maya tayā mad dayā anugrahāt vā 
SA_MBSAAMBAPA__NCAASIKAAhk-833	kṣipraṃ mattaḥ kṛpaṇakaruṇākrandamākarṇayemam || 42 ||	kṣipram mattaḥ kṛpaṇa karuṇa ākrandam ākarṇaya imam 
SA_MBSAAMBAPA__NCAASIKAAhk-834	he bhagavan, te tava nirṇītadṛśā sāmavedātmakaṃ dhāma tejo yasya	he bhagavan te tava nirṇīta dṛśā sāmaveda ātmakam dhāma tejaḥ yasya 
SA_MBSAAMBAPA__NCAASIKAAhk-835	tādṛśaḥ | yajurvedātmakaṃ śabdākāraṃ vapuḥ śarīraṃ viyadiva vyāpakam |	tādṛśaḥ yajurveda ātmakam śabda ākāram vapuḥ śarīram viyat iva vyāpakam 
SA_MBSAAMBAPA__NCAASIKAAhk-836	tadapi śabdākāramiti śabdānākaroti samastaśabdāśrayaḥ | api ca gāyatryādi	tat api śabda ākāram iti śabdān ākaroti samasta śabda āśrayaḥ api ca gāyatrī ādi 
SA_MBSAAMBAPA__NCAASIKAAhk-837	saptacchandāṃsi te turagāḥ | maṇḍalaṃ prabhā pariveṣo'pi ṛgvedamaya ityevaṃ	sapta chandāṃsi te turagāḥ maṇḍalam prabhā pariveṣaḥ api ṛgveda mayaḥ iti evam 
SA_MBSAAMBAPA__NCAASIKAAhk-838	sarvaśrutimayatvāt | yadvā anukampāpradhānādanugrahānmatto	sarva śruti maya tvāt yat vā anukampā pradhānāt anugrahāt mattaḥ 
SA_MBSAAMBAPA__NCAASIKAAhk-839	matsakāśāduktavakṣyamāṇaprārthanāparatvāt kṛpaṇaṃ virasaṃ	mad sakāśāt ukta vakṣyamāṇa prārthanā para tvāt kṛpaṇam virasam 
SA_MBSAAMBAPA__NCAASIKAAhk-840	saṃsāravibhāvakatvācca karuṇaṃ karuṇarasapradhānamimamākrandaṃ	saṃsāra vibhāvaka tvāt ca karuṇam karuṇa rasa pradhānam imam ākrandam 
SA_MBSAAMBAPA__NCAASIKAAhk-841	tvatprasādaprārthanāparaṃ pralapitaṃ kṣipramudīraṇānantaramevākarṇaya	tvad prasāda prārthanā param pralapitam kṣipram udīraṇa anantaram eva ākarṇaya 
SA_MBSAAMBAPA__NCAASIKAAhk-842	karuṇayā'smadanujighṛkṣayā'vadhāraya || 42 ||	karuṇayā asmad anujighṛkṣayā avadhāraya 
SA_MBSAAMBAPA__NCAASIKAAhk-843	nāśaṃ nāsmaccaraṇaśaraṇā yāntyapi grasyamānā	nāśam nā asmad caraṇa śaraṇā yānti api grasyamānā 
SA_MBSAAMBAPA__NCAASIKAAhk-844	devairitthaṃ sitamiva yaśo darśayan svaṃ trilokyām |	devaiḥ ittham sitam iva yaśaḥ darśayan svam trilokyām 
SA_MBSAAMBAPA__NCAASIKAAhk-845	manye somaṃ kṣatatanumamāgarbhavṛddhyā vivasvan	manye somam kṣata tanumam ā garbha vṛddhyā vivasvan 
SA_MBSAAMBAPA__NCAASIKAAhk-846	śuklacchāyāṃ nayasi śanakaiḥ svāṃ suṣumṇāṃśubhāsā || 43 ||	śukla chāyām nayasi śanakais svām suṣumṇā aṃśu bhāsā 
SA_MBSAAMBAPA__NCAASIKAAhk-847	he bhagavan vivasvan cidbhāno asmaccaraṇaśaraṇā devairapi grasyamānā	he bhagavan vivasvan cidbhāno asmad caraṇa śaraṇā devaiḥ api grasyamānā 
SA_MBSAAMBAPA__NCAASIKAAhk-848	nāśaṃ na yānti ityevaṃ sitaṃ śubhraṃ yaśastrilokyāṃ darśayanniva somaṃ	nāśam na yānti iti evam sitam śubhram yaśaḥ trilokyām darśayan iva somam 
SA_MBSAAMBAPA__NCAASIKAAhk-849	kṣatatanuṃ devairapi grastasamastakalaṃ suṣumṇākhyamadhyanāḍyā aṃśavo	kṣata tanum devaiḥ api grasta samasta kalam suṣumṇā ākhya madhya nāḍyāḥ aṃśavaḥ 
SA_MBSAAMBAPA__NCAASIKAAhk-850	marīcayastadbhāsā dīptyā hetubhūtayā amākhyakalayā garbhe'ntaryā	marīcayaḥ tad bhāsā dīptyā hetu bhūtayā ama ākhya kalayā garbhentaryā 
SA_MBSAAMBAPA__NCAASIKAAhk-851	vṛddhistayā svāṃ śuklāṃ chāyāṃ saṃpūrṇasitāṃ kāntiṃ nayasi	vṛddhiḥ tayā svām śuklām chāyām saṃpūrṇa sitām kāntim nayasi 
SA_MBSAAMBAPA__NCAASIKAAhk-852	prāpayasīti manye  jānāmi | atra rahasyadṛśā devā indriyāṇi	prāpayasi iti manye jānāmi atra rahasya dṛśāḥ devāḥ indriyāṇi 
SA_MBSAAMBAPA__NCAASIKAAhk-853	somo'pānayuktyāntaḥpraviṣṭaḥ ṣoḍaśakalārūpātmā meyavargaḥ	soma upāna yuktyā antar praviṣṭaḥ ṣoḍaśa kalā rūpa ātmā meya vargaḥ 
SA_MBSAAMBAPA__NCAASIKAAhk-854	sarvavāhollāsayuktyā kalāgrāsena kṣīṇakalaḥ san suṣumṇāṃśubhāsā	sarva vāha ullāsa yuktyā kalā grāsena kṣīṇa kalaḥ san suṣumṇā aṃśu bhāsā 
SA_MBSAAMBAPA__NCAASIKAAhk-855	madhyadhāmasphāreṇonmiṣacchubhākhyaturyaprakāśadīptyā amāyā	                 
SA_MBSAAMBAPA__NCAASIKAAhk-856	antatuṭyardhasphuracchaktergarbhe'ntaryā vṛddhiḥ	            
SA_MBSAAMBAPA__NCAASIKAAhk-857	prāṇādiprādhānyanimeṣonmiṣacchāktavīryabhābhiḥ sphuritā, tayā śuklāṃ	prāṇa ādi prādhānya nimeṣa unmiṣat śākta vīrya bhābhiḥ sphuritā tayā śuklām 
SA_MBSAAMBAPA__NCAASIKAAhk-858	cidekaghanāṃ nayasi prāpayasītyarthaḥ | bāhyastu spaṣṭaḥ || 43 ||	cit eka ghanām nayasi prāpayasi iti arthaḥ bāhyaḥ tu spaṣṭaḥ  /
SA_MBSAAMBAPA__NCAASIKAAhk-859	āstāṃ janmaprabhṛti bhavataḥ sevanaṃ taddhi loke	āstām janma prabhṛti bhavataḥ sevanam tat hi loke 
SA_MBSAAMBAPA__NCAASIKAAhk-860	vācyaṃ kenāparimitaphalaṃ bhuktimuktiprakāram |	vācyam kena aparimita phalam bhukti mukti prakāram 
SA_MBSAAMBAPA__NCAASIKAAhk-861	jyotirmātraṃ smṛtipathamito jīvitānte'pi bhāsvan	jyotiḥ mātram smṛtipatham itas jīvitānta ipi bhāsvan 
SA_MBSAAMBAPA__NCAASIKAAhk-862	nirvāṇāya prabhavasi satāṃ tena te kaḥ samo'nyaḥ || 44 ||	nirvāṇāya prabhavasi satām tena te kaḥ samaḥ nyaḥ 
SA_MBSAAMBAPA__NCAASIKAAhk-863	he bhāsvan, janmaprabhṛti yattvatsevanaṃ tadaparimitaphalaṃ kena vācyaṃ	he bhāsvan janma prabhṛti yat tvad sevanam tat aparimita phalam kena vācyam 
SA_MBSAAMBAPA__NCAASIKAAhk-864	kena vaktuṃ śakyam, iyattayā paricchedyatvābhāvāt | tadyasmād	kena vaktum śakyam iyat tayā paricchedya tva abhāvāt tat yasmāt 
SA_MBSAAMBAPA__NCAASIKAAhk-865	bhuktimuktiprakāraṃ bhuktirviṣayabhoga eva svātmānandaviśrāntidatvena	bhukti mukti prakāram bhuktiḥ viṣaya bhogaḥ eva sva ātma ānanda viśrānti da tvena 
SA_MBSAAMBAPA__NCAASIKAAhk-866	jīvacchivatvābhivyaktātmā muktireva ca ciccamatkārāveśarūpā bhuktiḥ, na tu	jīvat śiva tva abhivyakta ātmā muktiḥ eva ca cit camatkāra āveśa rūpā bhuktiḥ na tu 
SA_MBSAAMBAPA__NCAASIKAAhk-867	viṣayāsaktirūpā | tāṃ bhuktiṃ muktiṃ prakāśayati sevakāṃstanmayān	viṣaya āsakti rūpā tām bhuktim muktim prakāśayati sevakān tad mayān 
SA_MBSAAMBAPA__NCAASIKAAhk-868	saṃpādayati jīvitānte nirvāṇāvasare'pi jyotirmātrātmā tvaṃ satāṃ	saṃpādayati jīvitānte nirvāṇa avasare pi jyotiḥ mātra ātmā tvam satām 
SA_MBSAAMBAPA__NCAASIKAAhk-869	smṛtipathaṃ prāpto nirvāṇāya muktaye prabhavasi | ataste samaḥ ko'nyaḥ |	smṛtipatham prāptaḥ nirvāṇāya muktaye prabhavasi atas te samaḥ kaḥ nyaḥ 
SA_MBSAAMBAPA__NCAASIKAAhk-870	asāmānyamahimā'sītyarthaḥ || 44 ||	asāmānya mahimā asi iti arthaḥ 
SA_MBSAAMBAPA__NCAASIKAAhk-871	apratyakṣatridaśabhajanādyatparokṣaṃ phalaṃ tat	apratyakṣa tridaśa bhajanāt yat parokṣam phalam tat 
SA_MBSAAMBAPA__NCAASIKAAhk-872	puṃsāṃ yuktaṃ bhavati hi samaṃ kāraṇenaiva kāryam |	puṃsām yuktam bhavati hi samam kāraṇena eva kāryam 
SA_MBSAAMBAPA__NCAASIKAAhk-873	pratyakṣastvaṃ sakalajagatāṃ yatsamakṣaṃ phalaṃ me	pratyakṣaḥ tvam sakala jagatām yat samakṣam phalam me 
SA_MBSAAMBAPA__NCAASIKAAhk-874	yuṣmadbhakteḥ samucitamatastattu yāce yathā tvām || 45 ||	yuṣmad bhakteḥ samucitam atas tat tu yāce yathā tvām 
SA_MBSAAMBAPA__NCAASIKAAhk-875	apratyakṣendra candrādidevatārādhanādārādhakānāṃ	apratyakṣa indra candra ādi devatā ārādhanāt ārādhakānām 
SA_MBSAAMBAPA__NCAASIKAAhk-876	yatsvargaprāptyādi parokṣaṃ kālāntare bhāvi phalaṃ tadyuktam | yato mṛda iva	yat svarga prāpti ādi parokṣam kāla antare bhāvi phalam tat yuktam yatas mṛdaḥ iva 
SA_MBSAAMBAPA__NCAASIKAAhk-877	mṛṇmayo ghaṭaḥ kāraṇocitameva sarvatra kāryaṃ bhavati | tvaṃ tu cidarkaḥ	mṛṇmayaḥ ghaṭaḥ kāraṇa ucitam eva sarvatra kāryam bhavati tvam tu cit arkaḥ 
SA_MBSAAMBAPA__NCAASIKAAhk-878	sarveṣāṃ pratyakṣaḥ svaprakāśaḥ, cidarkasvaprakāśātmatāṃ vinā	sarveṣām pratyakṣaḥ sva prakāśaḥ cit arka sva prakāśa ātmatām vinā 
SA_MBSAAMBAPA__NCAASIKAAhk-879	kasyāpyaprakāśāditi | tvadbhakterhetormama nityoditatvatsamāveśātmaphalaṃ	kasya api aprakāśāt iti tvad bhakteḥ hetoḥ mama nitya udita tvad samāveśa ātma phalam 
SA_MBSAAMBAPA__NCAASIKAAhk-880	samucitam | ato hetostatphalaṃ yāce prārthaye | yathā kṛtimatīṣu devatāsu satīṣu	samucitam atas hetoḥ tat phalam yāce prārthaye yathā kṛtimatīṣu devatāsu satīṣu 
SA_MBSAAMBAPA__NCAASIKAAhk-881	tvāmeva yāce tathā nirvyutthānasamāveśātmaiva phalaṃ yāce | na tu mitaṃ	tvām eva yāce tathā nirvyutthāna samāveśa ātmā eva phalam yāce na tu mitam 
SA_MBSAAMBAPA__NCAASIKAAhk-882	kiñcit || 45 ||	kiñcid 
SA_MBSAAMBAPA__NCAASIKAAhk-883	ye cārogyaṃ diśati bhagavān sevito'pyevamāhu-	ye ca ārogyam diśati bhagavān sevitaḥ upi evam āhu 
SA_MBSAAMBAPA__NCAASIKAAhk-884	ste tattvajñā jagati subhagā bhogayogapradhānāḥ |	ste tattva jñāḥ jagati subhagāḥ bhoga yoga pradhānāḥ 
SA_MBSAAMBAPA__NCAASIKAAhk-885	bhuktermukterapi ca jagatāṃ yacca pūrṇaṃ sukhānāṃ	bhukteḥ mukteḥ api ca jagatām yat ca pūrṇam sukhānām 
SA_MBSAAMBAPA__NCAASIKAAhk-886	tasyānyorkādamṛtavapuṣaḥ ko hi nāmāstu dātā || 46 ||	tasya anya ūrkāt amṛta vapuṣaḥ kaḥ hi nāma astu dātā   
SA_MBSAAMBAPA__NCAASIKAAhk-887	ye'pi ca kecidavimṛṣṭasamāveśātmamukhyaphalā bhagavānsevita	ye pi ca kecid avimṛṣṭa samāveśa ātma mukhya phalāḥ bhagavān sevita 
SA_MBSAAMBAPA__NCAASIKAAhk-888	ārogyaṃ diśatītyāhuste'pi jagati tattvajñāśca subhagāśca | yato	ārogyam diśati iti āhuḥ te pi jagati tattva jñāḥ ca subhagāḥ ca yatas 
SA_MBSAAMBAPA__NCAASIKAAhk-889	bhogayogapradhānā bhogāya yogāya cārogyaṃ vāñcanti | yuktaṃ caitat |	bhoga yoga pradhānāḥ bhogāya yogāya ca ārogyam vāñcanti yuktam ca etat 
SA_MBSAAMBAPA__NCAASIKAAhk-890	yato'mṛtavapuṣaḥ parānandaprakāśaghanāccidarkādanyaḥ ko nāma	yatas mṛta vapuṣaḥ para ānanda prakāśa ghanāt cit arkāt anyaḥ kaḥ nāma 
SA_MBSAAMBAPA__NCAASIKAAhk-891	bhogamoṣayostadāśrayasya pūrṇasukhātmana ārogyasya ca dātā | na kaścit |	bhoga moṣayoḥ tad āśrayasya pūrṇa sukha ātmanaḥ ārogyasya ca dātā na kaścid 
SA_MBSAAMBAPA__NCAASIKAAhk-892	pūraṇaguṇasuhitārtha iti tṛptyarthaiḥ saha ṣaṣṭhīsamāsaniṣedhājjñāpakāt	pūraṇa guṇa su hita arthaḥ iti tṛpti arthaiḥ saha ṣaṣṭhī samāsa niṣedhāt jñāpakāt 
SA_MBSAAMBAPA__NCAASIKAAhk-893	sukhānāṃ pūrṇamityatra ṣaṣṭhī || 46 ||	sukhānām pūrṇam iti atra ṣaṣṭhī 
SA_MBSAAMBAPA__NCAASIKAAhk-894	hitvā hitvā gurucapalatāmapyanekānnijārthā-	hitvā hitvā guru capala tām api anekān nija arthā 
SA_MBSAAMBAPA__NCAASIKAAhk-895	nyairekārthīkṛtamiva bhavatsevanaṃ matpriyārtham |	nyaiḥ ekārthīkṛtam iva bhavat sevanam mad priya artham 
SA_MBSAAMBAPA__NCAASIKAAhk-896	teṣāmicchāmyupakṛtimahaṃ svendriyāṇāṃ priyāṇā-	teṣām icchāmi upakṛtim aham sva indriyāṇām 
SA_MBSAAMBAPA__NCAASIKAAhk-897	mādau tasmānmama dinapate dehi tebhyaḥ prasādam || 47 ||	mā ādau tasmāt mama dinapate dehi tebhyaḥ prasādam 
SA_MBSAAMBAPA__NCAASIKAAhk-898	he dinapate cidbhāno, yairindriyairantarbahiḥkaraṇairgurvīṃ capalatāṃ	he dinapate cit bhāno yaiḥ indriyaiḥ antar bahiḥkaraṇaiḥ gurvīm capalatām 
SA_MBSAAMBAPA__NCAASIKAAhk-899	mahatīmanavasthitiṃ punaḥ punaḥ pravṛttāmapi tathā'nekānnijārthān	mahatīm anavasthitim punar punar pravṛttām api tathā anekān nija arthān 
SA_MBSAAMBAPA__NCAASIKAAhk-900	viṣayaviśrāntyātmakāni nānāsvaprayojanāni hitvā tyaktvā	viṣaya viśrānti ātmakāni nānā sva prayojanāni hitvā tyaktvā 
SA_MBSAAMBAPA__NCAASIKAAhk-901	bhavatsevanamantarmukhībhāvayuktyā tvatpariśīlanaṃ mama	bhavat sevanam antarmukhībhāva yuktyā tvad pariśīlanam mama 
SA_MBSAAMBAPA__NCAASIKAAhk-902	priyārthamevaikārthīkṛtamabhiniveśenāśritam | teṣāṃ priyāṇāṃ	priya artham eva ekārthīkṛtam abhiniveśena āśritam teṣām priyāṇām 
SA_MBSAAMBAPA__NCAASIKAAhk-903	svendriyāṇāmahamupakāramicchāmi | tasmānmamādau tebhyaḥ prasādaṃ dehi	sva indriyāṇām aham upakāram icchāmi tasmāt mama ādau tebhyaḥ prasādam dehi 
SA_MBSAAMBAPA__NCAASIKAAhk-904	māyīyadehaparihāreṇa nijamarīcicakrātmatāṃ prakaṭayetyarthaḥ || 47 ||	māyīya deha parihāreṇa nija marīci cakra ātma tām prakaṭaya iti arthaḥ 
SA_MBSAAMBAPA__NCAASIKAAhk-905	kiṃ tannāmoccarati vacanaṃ yasya noccārakastvaṃ	kim tat nāma uccarati vacanam yasya na uccārakaḥ tvam 
SA_MBSAAMBAPA__NCAASIKAAhk-906	kiṃ tadvācyaṃ sakalavacasāṃ viśvamūrte na yat tvam |	kim tat vācyam sakala vacasām viśvamūrte na yat tvam 
SA_MBSAAMBAPA__NCAASIKAAhk-907	tasmāduktaṃ yadapi tadapi tvannutau bhaktiyogā-	tasmāt uktam yat api tat api tvad nutau bhakti yogā 
SA_MBSAAMBAPA__NCAASIKAAhk-908	dasmābhistadbhavatu bhagavaṃstvatprasādena dhanyam || 48 ||	dasmābhiḥ tat bhavatu bhagavan tvad prasādena dhanyam  /
SA_MBSAAMBAPA__NCAASIKAAhk-909	he viśvamūrte anavacchinna, tvannutiviṣaye idantāvacchedapradhānatayā	he viśvamūrte anavacchinna tvad nuti viṣaye idanta avaccheda pradhāna tayā 
SA_MBSAAMBAPA__NCAASIKAAhk-910	asamañjasaprāyaṃ kimapyasmābhistvadbhaktita uktaṃ tadviśvasya	asamañjasa prāyam kim api asmābhiḥ tvad bhaktitaḥ uktam tat viśvasya 
SA_MBSAAMBAPA__NCAASIKAAhk-911	vācyavācakātmanastava prasādādantarnairmalyaprāpterdhanyamastu	vācya vācaka ātmanaḥ tava prasādāt antar nairmalya prāpteḥ dhanyam astu 
SA_MBSAAMBAPA__NCAASIKAAhk-912	tvadrūpatayaiva sphuratu || 48 ||	tvad rūpa tayā eva sphuratu  /
SA_MBSAAMBAPA__NCAASIKAAhk-913	yā panthānaṃ diśati śiśirādyuttaraṃ devayānaṃ	yā panthānam diśati śiśira ādi uttaram deva yānam 
SA_MBSAAMBAPA__NCAASIKAAhk-914	yā vā kṛṣṇaṃ pitṛpathamatho dakṣiṇaṃ prāvṛḍādyam |	yā vā kṛṣṇam pitṛpatham atho dakṣiṇam prāvṛṣ ādyam 
SA_MBSAAMBAPA__NCAASIKAAhk-915	tābhyāmanyā viṣuvadabhijinmadhyamā kṛtyaśūnyā	tābhyām anyā viṣuvat abhijit madhyamā kṛtya śūnyā 
SA_MBSAAMBAPA__NCAASIKAAhk-916	dhanyā kācitprakṛtipuruṣāvantarā me'stu vṛttiḥ || 49 ||	dhanyā kācid prakṛti puruṣau antarā meḥ tu vṛttiḥ 
SA_MBSAAMBAPA__NCAASIKAAhk-917	prakṛtipuruṣau vāmadakṣiṇabāhau antarā tanmadhye kācidasāmānyā	prakṛti puruṣau vāma dakṣiṇa bāhau antarā tad madhye kācid asāmānyā 
SA_MBSAAMBAPA__NCAASIKAAhk-918	dhanyā saṃpanmayī me vṛttiḥ sthitirastu | kīdṛśī ? viṣuṃ vyāptimarhatīti	dhanyā saṃpad mayī me vṛttiḥ sthitiḥ astu kīdṛśī viṣum vyāptim arhati iti 
SA_MBSAAMBAPA__NCAASIKAAhk-919	viṣuvat | abhijayati  dvaitapraśamanāt sarvotkarṣeṇa vartata ityabhijit |	viṣuvat abhijayati dvaita praśamanāt sarva utkarṣeṇa vartate iti abhijit 
SA_MBSAAMBAPA__NCAASIKAAhk-920	sarvamadhyavartitvānmadhyamā | svānandaviśrāntisāratvāt kṛtyaiḥ	sarva madhya varti tvāt madhyamā sva ānanda viśrānti sāra tvāt kṛtyaiḥ 
SA_MBSAAMBAPA__NCAASIKAAhk-921	saumyakrūrādibhiḥ kāryaiḥ śūnyā | tathā devaprītikāritvāddevayānaṃ hṛdo	saumya krūra ādibhiḥ kāryaiḥ śūnyā tathā deva prīti kāri tvāt devayānam 
SA_MBSAAMBAPA__NCAASIKAAhk-922	dvādaśāntaṃ yāvat prasaraṇarūpaṃ	dvādaśāntam yāvat prasaraṇa rūpam 
SA_MBSAAMBAPA__NCAASIKAAhk-923	śiśiravasantagrīṣmasvabhāvamuttarapanthānamuttarāyaṇaṃ yā prāṇākhyā	śiśira vasanta grīṣma svabhāvam uttara panthānam uttarāyaṇam yā prāṇa ākhyā 
SA_MBSAAMBAPA__NCAASIKAAhk-924	vṛttirdiśati prathayati, yā vā apānākhyā vṛttirdvādaśāntāddhṛtpraveśarūpā	vṛttiḥ diśati prathayati yā vā apāna ākhyā vṛttiḥ dvādaśāntāt hṛd praveśa rūpā 
SA_MBSAAMBAPA__NCAASIKAAhk-925	prāvṛṭśaraddhemantarūpaṃ dakṣiṇaṃ panthānaṃ dakṣiṇāyanaṃ	prāvṛṣ śarad hemanta rūpam dakṣiṇam panthānam dakṣiṇāyanam 
SA_MBSAAMBAPA__NCAASIKAAhk-926	bhogapradatvāt kṛṣṇaṃ pitṛprītihetutvātpitṛpathaṃ diśati tābhyāmanyā	bhoga prada tvāt kṛṣṇam pitṛ prīti hetu tvāt pitṛpatham diśati tābhyām anyā 
SA_MBSAAMBAPA__NCAASIKAAhk-927	vyatiriktā jīvanmuktipradā | unmanākhyetyarthaḥ |	vyatiriktā jīvanmukti pradā unmanā ākhyā iti arthaḥ 
SA_MBSAAMBAPA__NCAASIKAAhk-928	ṣaṭtriṃśadaṅgule'ṅgulaṣaṭke hṛdaḥprabhṛti makarādirāśyudaya ityarthaḥ	ṣaṭtriṃśat aṅgula iṅgula ṣaṭke hṛdaḥ prabhṛti makara ādi rāśi udaye iti arthaḥ 
SA_MBSAAMBAPA__NCAASIKAAhk-929	śrīsvacchandādi śāstreṣvasti || 49 ||	śrī svacchanda ādi śāstreṣu asti 
SA_MBSAAMBAPA__NCAASIKAAhk-930	sthitvā kiñcinmana iva piban setubandhasya madhye	sthitvā kiñcid manaḥ iva piban setubandhasya madhye 
SA_MBSAAMBAPA__NCAASIKAAhk-931	prāpyopeyaṃ dhruvapadamatho vyaktamuddālya tālu |	prāpya upeyam dhruva padam atho vyaktam uddālya tālu 
SA_MBSAAMBAPA__NCAASIKAAhk-932	satyādūrdhvaṃ kimapi paramaṃ vyoma somāgniśūnyaṃ	satyāt ūrdhvam kim api paramam vyoma soma agni śūnyam 
SA_MBSAAMBAPA__NCAASIKAAhk-933	gaccheyaṃ tvāṃ surapitṛgatī cāntarā brahmabhūtaḥ || 50 ||	gaccheyam tvām sura pitṛ gatī ca antarā brahma bhūtaḥ 
SA_MBSAAMBAPA__NCAASIKAAhk-934	surapitṛgatī antarā	sura pitṛ gatī antarā 
SA_MBSAAMBAPA__NCAASIKAAhk-935	ūrdhvādhaḥpraveśātmanirṇītadevapitṛmārgayormadhye cakārāt	ūrdhva adhas praveśa ātma nirṇīta deva pitṛ mārgayoḥ madhye cakārāt 
SA_MBSAAMBAPA__NCAASIKAAhk-936	sarvavāhānāmapyantarbrahmabhūto'navacchinnatāṃ prāptastvāṃ gaccheyaṃ	sarva vāhānām api antar brahma bhūtaḥ ūnavacchinna tām prāptaḥ tvām gaccheyam 
SA_MBSAAMBAPA__NCAASIKAAhk-937	paratattvātmacidarkarūpaḥ syām | kīdṛśaṃ tvām ? satyādviśvasattāpradāt	para tattva ātma cit arka rūpaḥ syām kīdṛśam tvām satyāt viśva sattā pradāt 
SA_MBSAAMBAPA__NCAASIKAAhk-938	sāmarasyāddhāmna ūrdhvamutkṛṣṭaṃ prakāśānandaikaghanaṃ kimapi	sāmarasyāt dhāmnaḥ ūrdhvam utkṛṣṭam prakāśa ānanda eka ghanam kim api 
SA_MBSAAMBAPA__NCAASIKAAhk-939	paramaṃ vyometyanuttaracidākāśarūpaṃ somāgniśūnyaṃ	paramam vyoma iti anuttara cit ākāśa rūpam soma agni śūnyam 
SA_MBSAAMBAPA__NCAASIKAAhk-940	praśāntaprāṇāpānasaṃskāram | kiṃ kṛtvā ?	praśānta prāṇa apāna saṃskāram kim kṛtvā 
SA_MBSAAMBAPA__NCAASIKAAhk-941	tālulambikākhyaraudragranthidhāmavyaktiṃ kṛtvā | divyakaraṇabandhāśrayata	tālu lambikā ākhya raudra granthi dhāma vyaktim kṛtvā divya karaṇa bandhā āśrayata 
SA_MBSAAMBAPA__NCAASIKAAhk-942	uddālya nirbhidya | atho anantaraṃ dhruvapadaṃ prāpya	uddālya nirbhidya atha u anantaram dhruva padam prāpya 
SA_MBSAAMBAPA__NCAASIKAAhk-943	samastavedyāvibhāgaprakāśātmabindusthānamāsādya | setubandhasya madhya	samasta vedyā vibhāga prakāśa ātma bindu sthānam āsādya setubandhasya madhya 
SA_MBSAAMBAPA__NCAASIKAAhk-944	iti nirodhakordhvaśaktyā	iti nirodhaka ūrdhva śaktyā 
SA_MBSAAMBAPA__NCAASIKAAhk-945	taṭadvayāntarvāhiprāṇāpānādyuttaraṇopāyanādanādātmasṛṣṭiniruddha-	                   
SA_MBSAAMBAPA__NCAASIKAAhk-946	samastakarandhramārge sthitvā'dhiruhya kiñcinmanaḥ pibanniva	samasta karandhra mārge sthitvā adhiruhya kiñcid manaḥ piban iva 
SA_MBSAAMBAPA__NCAASIKAAhk-947	samanāntasavikalpakamanaḥsaṃskāraṃ praśamayan || 50 ||	            
SA_MBSAAMBAPA__NCAASIKAAhk-948	sarvātmatvaṃ savituriti yo vāṅmanaḥkāyabuddhyā	sarva ātma tvam savituḥ iti yaḥ vāc manaḥ kāya buddhyā 
SA_MBSAAMBAPA__NCAASIKAAhk-949	rāgadveṣopaśamasamatāyogamevārurukṣuḥ |	rāga dveṣa upaśama sama tā yogam eva ārurukṣuḥ 
SA_MBSAAMBAPA__NCAASIKAAhk-950	dharmādharmagrasanaraśanāmuktaye yuktiyuktāṃ	dharma adharma grasana raśanā muktaye yukti yuktām 
SA_MBSAAMBAPA__NCAASIKAAhk-951	sa śrīsāmbaḥ stutimiti raveḥ svapraśāntāṃ cakāra || 51 ||	sa śrī sāmbaḥ stutim iti raveḥ sva praśāntām cakāra 
SA_MBSAAMBAPA__NCAASIKAAhk-952	śrayantyetāṃ yogina iti śrīstayā mokṣalakṣmyā sahitaḥ sāmbo	śrayanti etām yoginaḥ iti śrīḥ tayā mokṣa lakṣmyā sahitaḥ sāmbo 
SA_MBSAAMBAPA__NCAASIKAAhk-953	bhagavadvāsudevasuta ityevaṃrūpāṃ raveścidarkasya stutiṃ	bhagavat vāsudeva sutaḥ iti evaṃrūpām raveḥ cit arkasya stutim 
SA_MBSAAMBAPA__NCAASIKAAhk-954	svapraśāntāmātmaviśrāntiparāmakarot | supratiṣṭhām iti vā pāṭhaḥ |	sva praśāntām ātma viśrānti parām akarot supratiṣṭhām iti vā pāṭhaḥ 
SA_MBSAAMBAPA__NCAASIKAAhk-955	kīdṛśīṃ stutim ? yuktyā parasvarūpaviśrāntyātmanā yogena yuktām |	kīdṛśīm stutim yuktyā para svarūpa viśrānti ātmanā yogena yuktām 
SA_MBSAAMBAPA__NCAASIKAAhk-956	tatkhyāpayitrīmityarthaḥ | sa ityasya viṣayaṃ darśayati - yāḥ	tad khyāpayitrīm iti arthaḥ saḥ iti asya viṣayam darśayati yāḥ 
SA_MBSAAMBAPA__NCAASIKAAhk-957	saviturviśvakāraṇasya cidbhānoḥ sarvātmatvaṃ vaiśvarūpyameva	savituḥ viśva kāraṇasya cit bhānoḥ sarva ātma tvam vaiśvarūpyam eva 
SA_MBSAAMBAPA__NCAASIKAAhk-958	yogamekatvamicchati | vastuno'nyena vastunā ityāmnāyadṛśā  yogaṃ	yogam eka tvam icchati vastunaḥ unyena vastunā iti āmnāya dṛśā yogam 
SA_MBSAAMBAPA__NCAASIKAAhk-959	paraikyamityuktadṛśāroḍhumicchuḥ svīcikīrṣuḥ | na tvanyatkiñcit | kīdṛśaṃ	para aikyam iti ukta dṛśā āroḍhum icchuḥ svīcikīrṣuḥ na tu anyat kiñcid kīdṛśam 
SA_MBSAAMBAPA__NCAASIKAAhk-960	yogam ? sarvadoṣamūrdhanyayo rāgadveṣayorupaśame sati yā samatā sāmyaṃ	yogam sarva doṣa mūrdhanyayoḥ rāga dveṣayoḥ upaśame sati yā sama tā sāmyam 
SA_MBSAAMBAPA__NCAASIKAAhk-961	tadrūpam | kena ? vāṅmanaḥ - kāyasahitayā buddhyā | vācā stutibhiḥ,	tad rūpam kena vāc manaḥ kāya sahitayā buddhyā vācā stutibhiḥ 
SA_MBSAAMBAPA__NCAASIKAAhk-962	manasā'nusaṃdhānataḥ, kāyena kāyaprādhyānyena	manasā anusaṃdhānataḥ kāyena kāya prādhyānyena 
SA_MBSAAMBAPA__NCAASIKAAhk-963	nimajjanātmakapraṇāmena, buddhyā'dhyavasāyena | kimarthamimāṃ	nimajjana ātmaka praṇāmena buddhyā adhyavasāyena kimartham imām 
SA_MBSAAMBAPA__NCAASIKAAhk-964	stutimakarodityāha - dharmādharmābhyāṃ yadgrasanamarthādabuddhasya	stutim akarot iti āha dharma adharmābhyām yat grasanam arthāt abuddhasya 
SA_MBSAAMBAPA__NCAASIKAAhk-965	jagatastadeva raśanā bandhanarajjustasyā muktaye |	jagataḥ tat eva raśanā bandhana rajjuḥ tasyāḥ muktaye 
SA_MBSAAMBAPA__NCAASIKAAhk-966	etatstotrapāṭhāvamarśābhyāṃ janā jīvanmuktimāyāntvityāśayādityarthaḥ ||	etad stotra pāṭha avamarśābhyām janāḥ jīvanmuktim āyāntu iti āśayāt iti arthaḥ 
SA_MBSAAMBAPA__NCAASIKAAhk-967	bhaktiśraddhādyakhilataruṇīvallabhenedamuktaṃ	bhakti śraddhā ādi akhila taruṇī vallabhena idam uktam 
SA_MBSAAMBAPA__NCAASIKAAhk-968	śrīsāmbena prakaṭagahanaṃ stotramadhyātmagarbham |	śrī sāmbena prakaṭa gahanam stotram adhyātma garbham 
SA_MBSAAMBAPA__NCAASIKAAhk-969	yaḥ sāvitraṃ paṭhati niyataṃ svātmavat sarvalokān	yaḥ sāvitram paṭhati niyatam sva ātma vat sarva lokān 
SA_MBSAAMBAPA__NCAASIKAAhk-970	paśyan so'nte vrajati śukavanmaṇḍalaṃ caṇḍaraśmeḥ || 52 ||	paśyan saḥ unte vrajati śuka vat maṇḍalam caṇḍaraśmeḥ  /
SA_MBSAAMBAPA__NCAASIKAAhk-971	idamadhyātmagarbhaṃ kroḍīkṛtarahasyam, prakaṭaṃ bāhyārthadṛśā,	idam adhyātma garbham kroḍīkṛta rahasyam prakaṭam bāhya artha dṛśā 
SA_MBSAAMBAPA__NCAASIKAAhk-972	gahanaṃ cādhyātmakārthayogāt, sāvitraṃ cidbhānusambandhi stotraṃ	gahanam ca adhyātmaka artha yogāt sāvitram cit bhānu sambandhi stotram 
SA_MBSAAMBAPA__NCAASIKAAhk-973	śrīsāmbenoktaṃ yaḥ kaścit svātmānamiva sarvalokān	śrī sāmbena uktam yaḥ kaścid sva ātmānam iva sarva lokān 
SA_MBSAAMBAPA__NCAASIKAAhk-974	paśyaṃścidabhedātmaviśvaṃ stotrārthaṃ bhāvayanniyataṃ niścayena paṭhati	paśyan cit abheda ātma viśvam stotra artham bhāvayan niyatam niścayena paṭhati 
SA_MBSAAMBAPA__NCAASIKAAhk-975	anavarataṃ vimṛśati, so'nte caṇḍaraśmerdvaitagrāsinaścidarkasya maṇḍalaṃ	anavaratam vimṛśati saḥ unte caṇḍaraśmeḥ dvaita grāsinaḥ cit arkasya maṇḍalam 
SA_MBSAAMBAPA__NCAASIKAAhk-976	līḍhaviśvasamarasībhūtamarīcicakrameti | tanmayo jāyate | śukavad	līḍha viśva sama rasībhūta marīci cakram eti tad mayaḥ jāyate śuka vat 
SA_MBSAAMBAPA__NCAASIKAAhk-977	bhagavadvyāsasutavat | kīdṛśena sāmbena ? bhaktiśraddhe ādī yāsāṃ	bhagavat vyāsa suta vat kīdṛśena sāmbena bhakti śraddhe ādī yāsām 
SA_MBSAAMBAPA__NCAASIKAAhk-978	tattvārthacintādīnāṃ tā evākhilāstaruṇyo navanavāḥ sundaryastāsāṃ	tattva artha cintā ādīnām tāḥ eva akhilāḥ taruṇyaḥ nava navāḥ sundaryaḥ tāsām 
SA_MBSAAMBAPA__NCAASIKAAhk-979	vallabhena kṣaṇamapi parihartumaśakyena preyasā | na tu	vallabhena kṣaṇam api parihartum aśakyena preyasā na tu 
SA_MBSAAMBAPA__NCAASIKAAhk-980	rūpalāvaṇyātiśayamātrāt samastabāhyaramaṇīspṛhaṇīyena | ityanena	rūpa lāvaṇya atiśaya mātrāt samasta bāhya ramaṇī spṛhaṇīyena iti anena 
SA_MBSAAMBAPA__NCAASIKAAhk-981	vyatirekalabhyenārthena bhagavadvāsudevasutatvamātmanaḥ prakaṭayati || 52 ||	vyatireka labhyena arthena bhagavat vāsudeva suta tvam ātmanaḥ prakaṭayati 
SA_MBSAAMBAPA__NCAASIKAAhk-982	upasaṃhārabhaṅgyā janānanujighṛkṣurāśāste -	upasaṃhāra bhaṅgyā janān anujighṛkṣuḥ āśāste 
SA_MBSAAMBAPA__NCAASIKAAhk-983	iti paramarahasyaślokapañcāśadeṣā	iti parama rahasya śloka pañcāśat eṣā 
SA_MBSAAMBAPA__NCAASIKAAhk-984	tapananavanapuṇyā sāgamabrahmacarcā |	tapana navana puṇyā sa āgama brahmacarcā 
SA_MBSAAMBAPA__NCAASIKAAhk-985	haratu duritamasmadvarṇitākarṇitā vo	haratu duritam asmad varṇitā ākarṇitā vaḥ 
SA_MBSAAMBAPA__NCAASIKAAhk-986	diśatu ca śubhasiddhiṃ mātṛvadbhaktibhājām || 53 ||	diśatu ca śubha siddhim mātṛ vat bhakti bhājām 
SA_MBSAAMBAPA__NCAASIKAAhk-987	ityuktakramānmahārahasyārthayuktā sthitvā kiñcinmana iva piban	iti ukta kramāt mahā rahasya artha yuktā sthitvā kiñcid manaḥ iva piban 
SA_MBSAAMBAPA__NCAASIKAAhk-988	ityantaślokānāṃ pañcāśadeṣā tapanasya viśvavicitrākhaṇḍitapratāpasya	iti anta ślokānām pañcāśat eṣā tapanasya viśva vicitra a khaṇḍita pratāpasya 
SA_MBSAAMBAPA__NCAASIKAAhk-989	bhagavataścidarkasya navanena stutyā puṇyā pavitrā | tathā sāgamā	bhagavataḥ cit arkasya navanena stutyā puṇyā pavitrā tathā sa āgamā 
SA_MBSAAMBAPA__NCAASIKAAhk-990	viśvopaniṣadrūpamāheśvaraśāstrārthasatattvagarbhā brahmacarcā	viśva upaniṣad rūpa māheśvara śāstra artha sa tattva garbhā brahmacarcā 
SA_MBSAAMBAPA__NCAASIKAAhk-991	parādvayavimarśo yasyāṃ tādṛśī asmadvarṇitā satī ākarṇitā vo yuṣmākaṃ	parā dvaya vimarśaḥ yasyām tādṛśī asmad varṇitā satī ākarṇitā vaḥ yuṣmākam 
SA_MBSAAMBAPA__NCAASIKAAhk-992	sarveṣāṃ  duritaṃ haratu kilviṣaṃ duradhyavasāyaṃ ca nāśayatu |	sarveṣām duritam haratu kilviṣam duradhyavasāyam ca nāśayatu 
SA_MBSAAMBAPA__NCAASIKAAhk-993	bhaktibhājāṃ ca śubhasiddhiṃ diśatu abhīṣṭāṃ bhogamokṣalakṣmīṃ	bhakti bhājām ca śubha siddhim diśatu abhīṣṭām bhoga mokṣa lakṣmīm 
SA_MBSAAMBAPA__NCAASIKAAhk-994	ghaṭayatāmiti śivam || 53 ||	ghaṭayatām iti śivam 
SA_MBSAAMBAPA__NCAASIKAAhk-995	kaścicchaivaḥ paraśivasamāveśagāḍhānurāgo-	kaścid śaivaḥ para śiva samāveśa gāḍha anurāgaḥ 
SA_MBSAAMBAPA__NCAASIKAAhk-996	drekasphūrjannabhinavadaśāveśavaivaśyaśālī |	dreka sphūrjan abhinava daśā āveśa vaivaśya śālī 
SA_MBSAAMBAPA__NCAASIKAAhk-997	satstotre'smin vivṛtiracanāṃ kṣemarājo nyayuṅkte-	sat stotre ismin vivṛti racanām kṣemarājaḥ nyayuṅkte 
SA_MBSAAMBAPA__NCAASIKAAhk-998	tyetannaivaṃ jhaṭiti ghaṭitaṃ darśanīyaṃ hi sadbhiḥ ||	ti etat nā evam jhaṭiti ghaṭitam darśanīyam hi sadbhiḥ 
SA_MBSAAMBAPA__NCAASIKAAhk-999	iti mahāmāheśvarācāryavaryaśrīmadabhinavaguptapādapadmopajīvirājānaka	iti 
SA_MBSAAMBAPA__NCAASIKAAhk-1000	śrīkṣemarājapraṇītavivṛtisametā	śrī kṣemarāja praṇīta vivṛti sametā 
SA_MBSAAMBAPA__NCAASIKAAhk-1001	śrīsāmbapañcāśikā	         
SA_MBSAAMBAPA__NCAASIKAAhk-1002	samāptā |	samāptā 
SA_MBSAAMBAPA__NCAASIKAAhk-1003	|| samāpto'yaṃ granthaḥ ||	samāptaḥ ayam granthaḥ 
SA_MBSAAMBAPA__NCAASIKAAhk-1004	MUKTABODHA INDOLOGICAL RESEARCH INSTITUTE©2011 Muktabodha Indological Research Institute  All Rights Reserved.E-texts may be viewed only online or downloaded for private study.E-texts may not, under any circumstances, be copied, republished,reproduced, distributed or sold, either in original or altered form, withoutthe express permission of Muktabodha Indological Research Institute in writing.Data-entered by the staff of Muktabodha under the direction of Mark S. G. Dyczkowski.	muktabodha indological research muktabodha indological research institute all rights reserved texts may be viewed only online or downloaded for private studye texts may not under any circumstances be copied republished reproduced distributed or sold either in original or altered form withoutthe express permission of muktabodha indological research institute in writing data entered by the staff of muktabodha under the direction of mark s g dyczkowski 
