segmentnr	original	analyzed
SA_MB_siddhalaksmipujapaddhatiHK-0	Muktabodha E-text in UTF-8	muktabodha etext in utf
SA_MB_siddhalaksmipujapaddhatiHK-1	###########################################################################MUKTABODHA INDOLOGICAL RESEARCH INSTITUTEwww.muktabodha.org©2011 Muktabodha Indological Research Institute  All Rights Reserved.E-texts may be viewed only online or downloaded for private study.E-texts may not, under any circumstances, be copied, republished,reproduced, distributed or sold, either in original or altered form, withoutthe express permission of Muktabodha Indological Research Institute in writing.Data-entered by the staff of Muktabodha under the direction of Mark S. G. Dyczkowski.Catalog number : M00257	muktabodha indological research muktabodha indological research institute all rights reserved texts may be viewed only online or downloaded for private studye texts may not under any circumstances be copied republished reproduced distributed or sold either in original or altered form withoutthe express permission of muktabodha indological research institute in writing data entered by the staff of muktabodha under the direction of mark s g dyczkowskicatalog number  /
SA_MB_siddhalaksmipujapaddhatiHK-2	Uniform title: siddhalakṣṃīpūjāpaddhati	uniform title siddhalakṣṇī pūjā paddhati 
SA_MB_siddhalaksmipujapaddhatiHK-3	Main title: siddhalakṣṃīpūjāpaddhati	main title siddhalakṣṃī pūjā paddhati 
SA_MB_siddhalaksmipujapaddhatiHK-4	Secondary title: kulavāgīśvarī pūjāna	secondara title 
SA_MB_siddhalaksmipujapaddhatiHK-5	Secondary title: vanadurgā pūjāna	secondary title 
SA_MB_siddhalaksmipujapaddhatiHK-6	Manuscript : Kashmir Research Center accession no: 2376 (S no: 936)	manuscript kashmir research center accession no s no 
SA_MB_siddhalaksmipujapaddhatiHK-7	Description: Comprises Kashmir Research Centers manuscript with accession numbers  2376.1 thru 2376.12 as described in their on-line catalog at	description comprises kashmir research centers manuscript with accession numbers thru as described in their online catalog at 
SA_MB_siddhalaksmipujapaddhatiHK-8	http://www.jkpubliclibraries.nic.in/catalogue%20of%20manuscripts/sanskrit%20manuscript.pdf	Ro
SA_MB_siddhalaksmipujapaddhatiHK-9	Notes: Date entered by the staff of Muktabodha under the supervision of Mark S.G. Dyczkowski.	notes date entered by the staff of muktabodha under the supervision of mark sg dyczkowski 
SA_MB_siddhalaksmipujapaddhatiHK-10	Revision 0: April 5, 2012	revision april 
SA_MB_siddhalaksmipujapaddhatiHK-11	Publication country : India	publication country india 
SA_MB_siddhalaksmipujapaddhatiHK-12	oṃ namo kulavāgīśvaryai ||	om namaḥ kula vāc īśvaryai 
SA_MB_siddhalaksmipujapaddhatiHK-13	oṃ devīṃ kadambavanagāmaruṇatrikoṇasaṃsthāṃ sitāṃ sitavarāmbujakarṇikāsthām |	om devīm kadamba vana gām aruṇa trikoṇa saṃsthām sitām sita vara ambuja karṇikā sthām 
SA_MB_siddhalaksmipujapaddhatiHK-14	satpustakākṣavalayānvitapāṇipadmāṃ vāgīśvarīṃ kulaguruṃ praṇamāmi nityam ||	sat pustaka akṣa valaya anvita pāṇi padmām vāgīśvarīm kula gurum praṇamāmi nityam 
SA_MB_siddhalaksmipujapaddhatiHK-15	ullikhantīṃ jagaccittramannullekhepi śāṅkarīm | sarvasiddhipradāṃ śaktiṃ tripurāmbā namāmyaham ||	ullikhantīm śāṅkarīm sarva siddhi pradām śaktim tripurāmbā namāmi aham 
SA_MB_siddhalaksmipujapaddhatiHK-16	hrīṃ vāgīśāya vidmahe klīṃ kāmeśāya dhīṃ sauḥ tannaḥ śaktiḥ pracoḥ || gāyatrīṃ triḥ paṭhitvā ||	hrīṃ vāgīśāya vidmahe klīṃ kāmeśāya dhīṃ sauḥ tat naḥ śaktiḥ pracoḥ gāyatrīm tris paṭhitvā 
SA_MB_siddhalaksmipujapaddhatiHK-17	oṃ hrīṃ phaṭ ityastrapātraṃ svadakṣe | tena sarvadravyaprokṣaṇam ||	om hrīṃ phaṭ iti astra pātram sva dakṣe tena sarva dravya prokṣaṇam 
SA_MB_siddhalaksmipujapaddhatiHK-18	aiṃ trikoṇapīṭhapāda ityāsane puṣpaṃ datvā tatropaviśya prāṇāyāmādividhāya svānusandhānād	aim trikoṇa pīṭha pādaḥ iti āsane puṣpam da tvā tatra upaviśya prāṇāyāma ādi vidhāya sva anusandhānāt 
SA_MB_siddhalaksmipujapaddhatiHK-19	dvādaśakalānyāsaḥ ||	        
SA_MB_siddhalaksmipujapaddhatiHK-20	oṃ aiṃ hṛ | oṃ klīṃ śi | oṃ sauḥ śi | oṃ aiṃ kṛ | oṃ klīṃ ne | oṃ sauḥ astrāḥ ||	om aim hṛ  om klīṃ śi om sauḥ śi  om aim kṛ om klīṃ ne om sauḥ astrāḥ 
SA_MB_siddhalaksmipujapaddhatiHK-21	aiṃ aiśānyambā pāda * * * * * * * * * * * * * *? pāda hṛdi | aiṃ vāmāmbāpāda kuṇḍalinyām |	aim aiśānī ambā pāda hṛdi aim vāma ambā pāda kuṇḍalinyām 
SA_MB_siddhalaksmipujapaddhatiHK-22	aiṃ ambāmbāpāda jīvadhāmni || iti vāgbhava kalāpañcakam ||	aim ambā ambā pāda jīva dhāmni iti vāc bhava kalā pañcakam 
SA_MB_siddhalaksmipujapaddhatiHK-23	klīṃ vaindavyambāpāda | bindusthāne | klīṃ mohinyambāpāda bhrūmadhye klīṃ aindryambāpāda hṛdi | klīṃ	klīṃ vaindavī ambā pāda bindu sthāne klīṃ mohinī ambā pāda bhrū madhye klīṃ aindrī ambā pāda hṛdi klīṃ 
SA_MB_siddhalaksmipujapaddhatiHK-24	kāmāmbāpāda guhye | iti kāmakalānyāsaḥ || sauḥ visargakalāmbāpāda mūrdhni | sauḥ triśūlakalāmbāpāda |	kāma ambā pāda guhye iti kāma kalā nyāsaḥ sauḥ visarga kalā ambā pāda mūrdhni sauḥ triśūla kalā ambā pāda 
SA_MB_siddhalaksmipujapaddhatiHK-25	nāḍitraye | sauḥ sañjīvanakalāmbāpāda | jīvadhāmni || iti śaktikalātrayanyāsaḥ ||	                                                                            
SA_MB_siddhalaksmipujapaddhatiHK-26	hrīṃ phaṭ karaśarīroddīpanam dehaśuddhiḥ abhinavadehotpādanam karamūlamadhyānteṣu vāgbhavakalānyāsaḥ ||	hrīṃ phaṭ kara śarīra uddīpanam deha śuddhiḥ abhinava deha utpādanam kara mūla madhya anteṣu vāc bhava kalā nyāsaḥ 
SA_MB_siddhalaksmipujapaddhatiHK-27	gudanābhikuhareṣu caitad vījanyāsaḥ || klīṃ phaḍiti digbandhanam hūmityavaguṇṭhanam | ityamṛtīkaraṇam ||	guda nābhi kuhareṣu ca etat vījanyāsaḥ klīṃ phaṭ iti digbandhanam hūm iti avaguṇṭhanam iti amṛtīkaraṇam 
SA_MB_siddhalaksmipujapaddhatiHK-28	tataḥ prāṇāyāmapūrvaṃ śoṣaṇādidhāraṇādibhirdivyadehaḥ karaṇagaṇasampramoṣād devīmavyaktarūpāṃ |	tatas prāṇāyāma pūrvam śoṣaṇa ādi dhāraṇa ādibhiḥ divya dehaḥ karaṇa gaṇa sampramoṣāt devīm avyakta rūpām 
SA_MB_siddhalaksmipujapaddhatiHK-29	nādasvabhāvāṃ sthūlāṃ pustakākṣasūtravalayāṃ kadambamālābharaṇāṃ mātṛkāṃ udgirantīṃ sañcitya	nāda svabhāvām sthūlām pustaka akṣasūtra valayām kadamba mālā ābharaṇām mātṛkām udgirantīm sañcitya 
SA_MB_siddhalaksmipujapaddhatiHK-30	variṣṭhairmānasaiḥ padārthaiḥ pūjayet | iti manoyāgaṃ vidhāya pātraṃ prakālya tribhirupayuktairbījaiḥ	variṣṭhaiḥ mānasaiḥ padārthaiḥ pūjayet iti manaḥ yāgam vidhāya pātram prakālya tribhiḥ upayuktaiḥ bījaiḥ 
SA_MB_siddhalaksmipujapaddhatiHK-31	saṃskṛtya svajātyucitairdravyaiḥ pūrayet | tatra tripañcaka krameṇa pūjayet | tataḥ svātmapūjāṃ vidhāya	saṃskṛtya sva jāti ucitaiḥ dravyaiḥ pūrayet tatra tri pañcaka krameṇa pūjayet tatas sva ātma pūjām vidhāya 
SA_MB_siddhalaksmipujapaddhatiHK-32	bāhyayāgaṃ vidadhyāt ||	bāhyayāgam vidadhyāt 
SA_MB_siddhalaksmipujapaddhatiHK-33	aiṃ hrīṃ kāmadevanāthapāda | aiṃ hrīṃ ratyambāpāda | oṃ vasantanātha pāda | oṃ prītyambāpāda | oṃ	aim   kāmadeva nātha pāda aim   rati ambā pāda om vasanta nātha pāda om prīti ambā pāda om 
SA_MB_siddhalaksmipujapaddhatiHK-34	udyānanāthapāda || dvāravāmadakṣiṇamadhyeṣu sampūjya vāgbhavabījamuccārya ||	udyāna nātha pāda dvāra vāma dakṣiṇa madhyeṣu sampūjya vāc bhava bījam uccārya 
SA_MB_siddhalaksmipujapaddhatiHK-35	aiṃ tripuravāgīśagurunāthapāda | klīṃ tripurasundaraparamagurunāthapāda | sauḥ	aim tripura vāgīśa guru nātha pāda klīṃ tripura sundara parama guru nātha pāda sauḥ 
SA_MB_siddhalaksmipujapaddhatiHK-36	tripuravīraparamācāryagurunāthapāda ||	tripura vīra parama ācārya guru nātha pāda 
SA_MB_siddhalaksmipujapaddhatiHK-37	iti gurutraye vyomadakṣiṇataḥ pūjyam | aiṃ ṣaṣṭheśanāthapāda | klīṃ mitreśanāthapāda |	iti guru traye vyoma dakṣiṇatas pūjyam aim ṣaṣṭha īśa nātha pāda klīṃ mitreśa nātha pāda 
SA_MB_siddhalaksmipujapaddhatiHK-38	sauḥ uḍḍīśanāthapāda ||	sauḥ uḍḍīśa nātha pāda 
SA_MB_siddhalaksmipujapaddhatiHK-39	iti vyomavāme siddhatrayam || atha vyomapaścādbhāge |	iti vyoma vāme siddha trayam atha vyoma paścādbhāge 
SA_MB_siddhalaksmipujapaddhatiHK-40	aiṃ hrīṃ kāmeśvaryambāpāda | aiṃ hrīṃ sumanādevyambāpāda | aiṃ hrīṃ saubhāgyadevyambāpāda | aiṃ	aim   kāmeśvarī ambā pāda aim   sumanādevī ambā pāda  aim   saubhāgyadevi ambā pāda  aim 
SA_MB_siddhalaksmipujapaddhatiHK-41	hrīṃ ānandādevyambāpāda | aiṃ hrīṃ manmathādevyambāpāda | aiṃ hrīṃ pradyumnādevyambāpāda | aiṃ hrīṃ	hrīṃ ānandādevī ambā pāda aim hrīṃ manmathādevī ambā pāda aim hrīṃ pradyumnādevī ambā pāda aim hrīṃ 
SA_MB_siddhalaksmipujapaddhatiHK-42	mahādevanāthapāda | aiṃ hrīṃ anaṅgādevanāthapāda | aiṃ hrīṃ vāmadevanāthapāda | aiṃ hrīṃ	mahādeva nātha pāda aim hrīṃ anaṅgā deva nātha pāda aim hrīṃ vāmadeva nātha pāda aim hrīṃ 
SA_MB_siddhalaksmipujapaddhatiHK-43	śaṅkarānandanāthapāda | aiṃ hrīṃ sāmbhavajñānānandanāthapāda | aiṃ hrīṃ suguptānandanāthapāda | aiṃ	śaṅkara ānanda nātha pāda aim   sāmbhava jñāna ānanda nātha pāda aim   sugupta ānanda nātha pāda aim 
SA_MB_siddhalaksmipujapaddhatiHK-44	hrīṃ musvalānandanātha | aiṃ hrīṃ sugurunātha ||	hrīṃ musvalānandanātha aim   su guru nātha 
SA_MB_siddhalaksmipujapaddhatiHK-45	iti siddhamānavaughāḥ |	iti siddha mānava oghāḥ 
SA_MB_siddhalaksmipujapaddhatiHK-46	tato bahiraṣṭau mātṝḥ pūjayet ||	tatas bahis aṣṭau mātṝḥ pūjayet 
SA_MB_siddhalaksmipujapaddhatiHK-47	aiṃ hrīṃ brāhmyambāpāda | oṃ māheśvaryambāpāda | oṃ kaumāryambāpāda | oṃ vaiṣṇavyambā0 | oṃ	aim   brāhmī ambā pāda om māheśvarī ambā pāda om kaumārī ambā pāda om vaiṣṇavī ambā  om 
SA_MB_siddhalaksmipujapaddhatiHK-48	vārāhyambā0 | oṃ aindryambā0 | oṃ aiśānyambā0 | oṃ āgneyyambā0 ||	vārāhī ambā om aindrī ambā om aiśānī ambā om āgneyī ambā 
SA_MB_siddhalaksmipujapaddhatiHK-49	iti svāgrādārabhyavāmāvartakrameṇa pūjyāḥ ||	iti sva agrāt ārabhya vāma āvarta krameṇa pūjyāḥ 
SA_MB_siddhalaksmipujapaddhatiHK-50	aiṃ trikoṇapīṭhapāda aiṃ ambujapīṭhapāda | aiṃ karṇikāgrapīṭhapāda | aiṃ kambalagolapīṭhapāda ||	aim trikoṇa pīṭha pāda aim ambuja pīṭha pāda  aim karṇikā agra pīṭha pāda  aim kambala gola pīṭha pāda 
SA_MB_siddhalaksmipujapaddhatiHK-51	ityāsanaṃ dalatrayasyāntaḥ saṃpūjya | yonimudrābandhena devīmavyaktarūpāṃ kadambagolakākārāṃ sūkṣmāṃ	iti āsanam dala trayasya antar saṃpūjya yonimudrā bandhena devīm avyakta rūpām kadamba golaka ākārām sūkṣmām 
SA_MB_siddhalaksmipujapaddhatiHK-52	nādamayīṃ | sthūlāṃ pustakākṣasūttrahastāṃ kadambamālābharaṇāṃ mātṛkāmudgirantīṃ tridhā sañcitya	nāda mayīm sthūlām pustaka akṣa sūttra hastām kadamba mālā ābharaṇām mātṛkām udgirantīm tridhā sañcitya 
SA_MB_siddhalaksmipujapaddhatiHK-53	kadambamadhye anacche pūjayet ||	kadamba madhye anacche pūjayet 
SA_MB_siddhalaksmipujapaddhatiHK-54	tato mūlam ||	tatas mūlam 
SA_MB_siddhalaksmipujapaddhatiHK-55	aiṃ klīṃ sauḥ kulavāgīśvaryambāpāda || iti mūlam ||	aim klīṃ sauḥ kula vāgīśvarī ambā pādaḥ iti mūlam 
SA_MB_siddhalaksmipujapaddhatiHK-56	tryaśrāntatriviṣṭatridalasaroje pratyekaṃ dalatrayasya pūrvadakṣiṇavāmeṣu karṇikāyāmupari ca pañcasu	                                        
SA_MB_siddhalaksmipujapaddhatiHK-57	sthāneṣu tripañcaka kramaḥ pūjyaḥ ||	sthāneṣu tripañcaka kramaḥ pūjyaḥ 
SA_MB_siddhalaksmipujapaddhatiHK-58	aiṃ paścimābhimukha liṅgapāda | klīṃ yonimudrāmbāpāda | sauḥ trisrotaḥ pīṭhapāda | pūrve ||	aim paścima abhimukha liṅga pāda klīṃ yonimudrā ambā pāda sauḥ trisrotaḥ pīṭha pāda pūrve 
SA_MB_siddhalaksmipujapaddhatiHK-59	aiṃ hṛdayasvayambhūliṅgapāda | klīṃ kṣobhiṇī	aim hṛdaya svayambhu liṅga pāda   kṣobhiṇī 
SA_MB_siddhalaksmipujapaddhatiHK-60	mudrāmbāpāda | sauḥ uḍḍiyānapīṭhapāda | dakṣe aiṃ bindubāṇaliṅgapāda | klīṃ drāviṇīmudrāmbāpāda	mudrā ambā pāda sauḥ uḍḍiyāna pīṭha pāda dakṣe aim bindu bāṇa liṅga pāda klīṃ drāviṇī mudrā ambā pāda 
SA_MB_siddhalaksmipujapaddhatiHK-61	| sauḥ pūrṇagiripīṭhapāda | vāme || aiṃ itaraliṅgapīṭhapāda | klīṃ sarvāṅgāsundarī mudrāmbāpāda |	sauḥ pūrṇagiri pīṭha pāda vāme  aiṃ itara liṅga pīṭha pāda klīṃ sarva aṅga asundarī mudrā ambā pāda 
SA_MB_siddhalaksmipujapaddhatiHK-62	sauḥ kāmarūpapīṭhapāda | aiṃ akulākāśa liṅgapāda | klīṃ nirālambāmudrāmbāpāda | sauḥ	sauḥ kāmarūpa pīṭha pāda aim akula ākāśa liṅga pāda klīṃ nirālambā mudrā ambā pāda sauḥ 
SA_MB_siddhalaksmipujapaddhatiHK-63	jālandharapīṭhapāda ||	jālandhara pīṭha pāda 
SA_MB_siddhalaksmipujapaddhatiHK-64	iti karṇikopari | iti tripañcakakrameṇa pūjayet ||	iti karṇikā upari iti tri pañcaka krameṇa pūjayet 
SA_MB_siddhalaksmipujapaddhatiHK-65	astrārgha pātrāt pādyādi ete naivābhyukṣitaṃ bhakṣyabhojyādi naivedyaṃ dattvā tṛptāṃ devīṃ dhyātvā	astra argha pātrāt pādya ādi ete na eva abhyukṣitam bhakṣya bhojya ādi naivedyam dattvā tṛptām devīm dhyātvā 
SA_MB_siddhalaksmipujapaddhatiHK-66	amṛtamudrāṃ baddhvā japaḥ kāryaḥ ||	amṛta mudrām baddhvā japaḥ kāryaḥ 
SA_MB_siddhalaksmipujapaddhatiHK-67	vaṭukayoginībhyo baliḥ | oṃ aiṃ īṃ klīṃ blūṃ saḥ saḥ samayāmbāpāda | iti samayāṃ paṭhitvā	vaṭuka yoginībhyaḥ baliḥ om aim īm klīṃ blūṃ saḥ saḥ samaya ambā pādaḥ iti samayām paṭhitvā 
SA_MB_siddhalaksmipujapaddhatiHK-68	nirālambamudrāṃ baddhvā devīṃ svadhāmni visarjayet ||	            
SA_MB_siddhalaksmipujapaddhatiHK-69	iti kulavāgīśvarī pūjanam ||	iti kulavāgīśvarī pūjanam 
SA_MB_siddhalaksmipujapaddhatiHK-70	atha durgāpūjanam ||	atha durgā pūjanam 
SA_MB_siddhalaksmipujapaddhatiHK-71	oṃ hrīṃ duṃ siṃhāsanāya namaḥ | oṃ hrīṃ duṃ padmāsanāya namaḥ | oṃ hrīṃ duṃ durgāmūrtaye namaḥ | iti	om   duṃ siṃhāsanāya namaḥ  om   duṃ padmāsanāya namaḥ om   duṃ durgā mūrtaye namaḥ iti 
SA_MB_siddhalaksmipujapaddhatiHK-72	mūrtimantraḥ ||	mūrti mantraḥ 
SA_MB_siddhalaksmipujapaddhatiHK-73	sāṅgamantra nyāsapūrvaṃ svātmapūjāṃvidhāya || śaṅkharicāpa śarabhinnakarāṃ trinettrāṃ	sa aṅga mantra nyāsa pūrvam sva ātma pūjām vidhāya śaṅkhari cāpa śara bhinna karām tri nettrām 
SA_MB_siddhalaksmipujapaddhatiHK-74	tira?detarāṃśu kalāyā vikasatkirīṭām | siṃha sthitāmasurasiddhanutāṃ ca durgāṃ dūrvānibhāṃ	kalāyāḥ vikasat kirīṭām siṃha sthitām asura siddha nutām ca durgām dūrvā nibhām 
SA_MB_siddhalaksmipujapaddhatiHK-75	duritaduḥkhaharīṃ namāmi ||	durita duḥkha harīm namāmi 
SA_MB_siddhalaksmipujapaddhatiHK-76	iti dhyātvā ||	iti dhyātvā 
SA_MB_siddhalaksmipujapaddhatiHK-77	oṃ hrāṃ hrīṃ duṃ sakalabhayaharī durgāsukhaṃ dadārtu svāhā ||	om     duṃ sakala bhaya harī durgā sukham dadārtu svāhā 
SA_MB_siddhalaksmipujapaddhatiHK-78	iti mūlena pūjayet ||	iti mūlena pūjayet 
SA_MB_siddhalaksmipujapaddhatiHK-79	tato hrāmītyaṅgāni naivedyaṃ nivedayet visarjayet | oṃ hrīṃ duṃ durgāyai namaḥ || oṃ hrīṃ hṛ | duṃ śi |	tatas hrāmi iti aṅgāni naivedyam nivedayet visarjayet om hrīṃ duṃ durgāyai namaḥ om hrīṃ hṛ duṃ śi 
SA_MB_siddhalaksmipujapaddhatiHK-80	duḥ śi | gā ka yai ne | namaḥ astrā0 ||	dus śi gā ka yai ne namaḥ astrā 
SA_MB_siddhalaksmipujapaddhatiHK-81	atha vanadurgāpūjanam ||	atha vana durgā pūjanam 
SA_MB_siddhalaksmipujapaddhatiHK-82	kālameghasannibhāṃkalitāndhacandraśiroḍahāṃ bālanettravibhūṣaṇāṃ bhayadāyi siṃhaneṣeduṣīm |	kāla megha sannibhām kalita andha candra śiraḥ ḍahām bāla nettra vibhūṣaṇām bhaya dāyi 
SA_MB_siddhalaksmipujapaddhatiHK-83	śaṅkhacakrakṛpāṇa(khaḍga)kheṭakaśāṅga?bāṇakaroṭikā (kapāla)	śaṅkha cakra kṛpāṇa khaḍga kheṭa kaśā aṅga bāṇa karoṭikā kapāla 
SA_MB_siddhalaksmipujapaddhatiHK-84	sthūlavāhibhujāṃbhajejitākhilāsurasainikām |	sthūla vāhi bhujām bhaja ījita akhila asura sainikām 
SA_MB_siddhalaksmipujapaddhatiHK-85	iti dhyānam ||	iti dhyānam 
SA_MB_siddhalaksmipujapaddhatiHK-86	asya śrīvanadurgāmantrasya | araṇyaka ṛṣiḥ anuṣṭupchandaḥ |	asya śrī vana durgā mantrasya araṇyakaḥ ṛṣiḥ anuṣṭubh chandaḥ 
SA_MB_siddhalaksmipujapaddhatiHK-87	śrīvanadurgādevatā iṣṭasiddhyarthaṃ viniyogaḥ |	śrī vana durgā devatā iṣṭa siddhi artham viniyogaḥ 
SA_MB_siddhalaksmipujapaddhatiHK-88	ādau tāvadaṅgaṣaṭkena mūlena ca nyāsaṃ kuryāt |	ādau tāvat aṅga ṣaṭkena mūlena ca nyāsam kuryāt 
SA_MB_siddhalaksmipujapaddhatiHK-89	ātmapūjāṃ kuryāt |	ātma pūjām kuryāt 
SA_MB_siddhalaksmipujapaddhatiHK-90	oṃ hrīṃ duṃ icchāśaktyai namaḥ | oṃ hrīṃ duṃ jñānaśaktyai namaḥ | oṃ kriyāśaktyai namaḥ | oṃ kāminyai	om   duṃ icchā śaktyai namaḥ om   duṃ jñāna śaktyai namaḥ om kriyā śaktyai namaḥ om kāminyai 
SA_MB_siddhalaksmipujapaddhatiHK-91	namaḥ | oṃ kātyāyanyai namaḥ | oṃ ratipriyāyai namaḥ | oṃ ānandāyai namaḥ | oṃ manonmanyai namaḥ |	namaḥ om kātyāyanyai namaḥ  om ratipriyāyai namaḥ om ānandāyai namaḥ om manonmanyai namaḥ 
SA_MB_siddhalaksmipujapaddhatiHK-92	iti pīṭha śaktayaḥ ||	iti pīṭha śaktayaḥ 
SA_MB_siddhalaksmipujapaddhatiHK-93	oṃ āṃ prabhāyai namaḥ | īṃ māyāyai namaḥ | eṃ sūkṣmāya namaḥ | aiṃ viśuddhāyai namaḥ | oṃ nandinyai	om āṃ prabhāyai namaḥ īṃ māyāyai namaḥ eṃ sūkṣmāya namaḥ aim viśuddhāyai namaḥ om nandinyai 
SA_MB_siddhalaksmipujapaddhatiHK-94	namaḥ | auṃ suprabhāyai namaḥ | aṃ jayāyai namaḥ | aḥ sarvasiddhipradāyai namaḥ | iti vā pīṭhaśaktayaḥ	namaḥ aum suprabhāyai namaḥ aṃ jayāyai namaḥ aḥ sarva siddhi pradāyai namaḥ iti vā pīṭha śaktayaḥ 
SA_MB_siddhalaksmipujapaddhatiHK-95	pūjyāḥ ||	pūjyāḥ 
SA_MB_siddhalaksmipujapaddhatiHK-96	atha dvārapūjā |	atha dvāra pūjā 
SA_MB_siddhalaksmipujapaddhatiHK-97	oṃ gāṃ gaṇapataye namaḥ | vāṃ vaṭukāya kṣāṃ kṣettrapālāya |	om gāṃ gaṇapataye namaḥ vām vaṭukāya   kṣettrapālāya 
SA_MB_siddhalaksmipujapaddhatiHK-98	śaṃśaṅkhanidhaye | paṃ padmanidhaye | jmryūṃ jayāyai | bhmryūṃ vijayāyai | oṃ duṃ dhanurdharāyai namaḥ |	śam śaṅkhanidhaye paṃ padmanidhaye jmryūm jayāyai bhmryūm vijayāyai om duṃ dhanurdharāyai namaḥ 
SA_MB_siddhalaksmipujapaddhatiHK-99	iti dvārapūjā |	iti dvāra pūjā 
SA_MB_siddhalaksmipujapaddhatiHK-100	madhye |	madhye 
SA_MB_siddhalaksmipujapaddhatiHK-101	oṃ hrīṃ hūṃ mahiṣāsurāya namaḥ | oṃ hrīṃ hūṃ mahāsiṃhāya namaḥ |	om     mahiṣa asurāya namaḥ om    mahā siṃhāya namaḥ 
SA_MB_siddhalaksmipujapaddhatiHK-102	tadupari bhagavatīṃ pūjayet |	tad upari bhagavatīm pūjayet 
SA_MB_siddhalaksmipujapaddhatiHK-103	uttiṣṭhapuruṣi kiṃ svapiṣi bhayaṃ me samupasthitaṃ yadi śaktyamaśakyaṃ vā tanme bhagavati śamaya svāhā |	uttiṣṭha puruṣi kim svapiṣi bhayam me samupasthitam yadi śaktyam aśakyam vā tat me bhagavati śamaya svāhā 
SA_MB_siddhalaksmipujapaddhatiHK-104	varṇāḥ 37 |	varṇāḥ 
SA_MB_siddhalaksmipujapaddhatiHK-105	uttiṣṭha puruṣi hṛda | kiṃ svapiṣiśi | bhayaṃ me samupasthitaṃ śikhā | yadi śakyamaśakyaṃ vā kava | tanme	uttiṣṭha puruṣi kim bhayam me samupasthitam śikhā yadi śakyam aśakyam vā tat me 
SA_MB_siddhalaksmipujapaddhatiHK-106	bhagavati ne | śamaya svāhā astrā0 | ityaṅga ṣaṭkam |	bhagavati ne śamaya svāhā astrā iti aṅga ṣaṭkam 
SA_MB_siddhalaksmipujapaddhatiHK-107	athaṣaṭkoṇe |	atha ṣaṣ koṇe 
SA_MB_siddhalaksmipujapaddhatiHK-108	brahma sarasvatībhyāṃ namaḥ | lakṣmīnārāyaṇābhyāṃ namaḥ | gaurīśaṅkarābhyāṃ namaḥ |	brahma sarasvatībhyām namaḥ lakṣmī nārāyaṇābhyām namaḥ gaurī śaṅkarābhyām namaḥ 
SA_MB_siddhalaksmipujapaddhatiHK-109	iti pṛṣṭhe |	iti pṛṣṭhe 
SA_MB_siddhalaksmipujapaddhatiHK-110	oṃ hrīṃ duṃ madhukaiṭabhavidrāviṇyai namaḥ | oṃ mahiṣāsuramardinyai namaḥ | oṃ sumbhanisumbhamathinyai namaḥ	om   duṃ madhu kaiṭabha vidrāviṇyai namaḥ  om mahiṣa asura mardinyai namaḥ om sumbha nisumbha mathinyai namaḥ 
SA_MB_siddhalaksmipujapaddhatiHK-111	| ityadhaḥ | athāṣṭadaleṣu dalamūleṣu | oṃ	iti adhas atha aṣṭadaleṣu dala mūleṣu om 
SA_MB_siddhalaksmipujapaddhatiHK-112	āryāyai namaḥ | durgāyai bhadrāyai bhadrakālyai ambikāyai kṣemāyai vedagarbhāyai kṣemaṅkaryai | ādau	āryāyai namaḥ durgāyai bhadrāyai bhadrakālyai ambikāyai kṣemāyai vedagarbhāyai kṣemaṅkaryai ādau 
SA_MB_siddhalaksmipujapaddhatiHK-113	daleṣu | śaṅkhāya namaḥ | cakrāya khaḍgāya kheṭāya bāṇāya dhanuṣe śūlāya kapālāya namaḥ |	daleṣu śaṅkhāya namaḥ cakrāya khaḍgāya kheṭāya bāṇāya dhanuṣe śūlāya kapālāya namaḥ 
SA_MB_siddhalaksmipujapaddhatiHK-114	atha dalāgreṣu mātaraḥ ||	atha dala agreṣu mātaraḥ 
SA_MB_siddhalaksmipujapaddhatiHK-115	oṃ hrīṃ duṃ āṃ brāhmyai namaḥ | ḷṃ īṃ māheśvaryai | ḷṃ ūṃ kaumāryai | ḷṃ eṃ vaiṣṇavyai | ḷṃ	om   duṃ ām brāhmyai namaḥ ḷṃ īṃ māheśvaryai ḷṃ ūm kaumāryai ḷṃ eṃ vaiṣṇavyai 
SA_MB_siddhalaksmipujapaddhatiHK-116	ḹṃ vārāhyai ḷṃ aiṃ aindrai ḷṃ auṃ cāmuṇḍāyai ḷṃ aḥ mahālakṣmyai namaḥ |	ḹm vārāhyai ḷṃ aim aindraiḥ ḷṃ aum cāmuṇḍāyai ḷṃ aḥ mahālakṣmyai namaḥ 
SA_MB_siddhalaksmipujapaddhatiHK-117	tato lokapālāḥ |	tatas lokapālāḥ 
SA_MB_siddhalaksmipujapaddhatiHK-118	lūṃ indrāya vajrahastāya namaḥ | rūṃ agnaye śaktihastāyetyādi | oṃ hūṃ śivadūtyai namaḥ | oṃ hrīṃ	lūṃ indrāya vajrahastāya namaḥ rūṃ agnaye śakti hastāya ityādi om   śivadūtyai namaḥ om   
SA_MB_siddhalaksmipujapaddhatiHK-119	kṣāṃ krāṃ śarebhyo namaḥ | oṃ hrīṃ śrīṃ duṃ jvale jvāle śūlini duṣṭagaralaṃ hūṃ phaṭ svāhā ||	kṣāṃ krāṃ śarebhyaḥ namaḥ om hrīṃ śrīṃ duṃ jvale jvāle śūlini duṣṭa garalam hūm phaṭ svāhā 
SA_MB_siddhalaksmipujapaddhatiHK-120	iti vana durgāpūjanaṃ samāptam ||	iti vana durgā pūjanam samāptam 
SA_MB_siddhalaksmipujapaddhatiHK-121	atha gaurīpūjanam ||	atha gaurī pūjanam 
SA_MB_siddhalaksmipujapaddhatiHK-122	sāme bhavatu suprītā gaurīśikharavāsinī | ugreṇa tapasā labdho yayā paśupatiḥ patiḥ |	sā āme bhavatu su prītā gaurīśikhara vāsinī ugreṇa tapasā labdhaḥ yayā paśupatiḥ patiḥ 
SA_MB_siddhalaksmipujapaddhatiHK-123	śūlākṣasūttramakurakumbhānsavyāpasavyayoḥ | siṃhasthāṃ bibhratīṃ devīṃ nettradvitayaśālinīm |	śūla akṣa sūttra makura kumbhān savya apasavyayoḥ siṃha sthām bibhratīm devīm nettra dvitaya śālinīm 
SA_MB_siddhalaksmipujapaddhatiHK-124	prottaṅgastananamrāṅgīṃ vilolavilasatkacām | dviraṣṭavatsarākārāṃ devīṃ bhagavatīṃ numaḥ ||	prottaṅga stana namra aṅgīm vilola vilasat kacām dvis aṣṭa vatsara ākārām devīm bhagavatīm numaḥ 
SA_MB_siddhalaksmipujapaddhatiHK-125	padmāsanāyanamaḥ | gauryāsanāyanamaḥ | oṃ gauṃ gaurīmūrtaye namaḥ |	padmāsanāya namaḥ gaurī āsanāya namaḥ om gauṃ gaurī mūrtaye namaḥ 
SA_MB_siddhalaksmipujapaddhatiHK-126	tadupari |	tad upari 
SA_MB_siddhalaksmipujapaddhatiHK-127	oṃ hrīṃ saḥ mahāgauri rudradayite svāhā |	om   saḥ mahāgauri rudra dayite svāhā 
SA_MB_siddhalaksmipujapaddhatiHK-128	iti mūlam |	iti mūlam 
SA_MB_siddhalaksmipujapaddhatiHK-129	gāṃ hṛ gīṃ śi | gūṃ śi | gaiṃ ka | gauṃ ne | gaḥ a |	gāṃ hṛ gīṃ śi gūṃ śi  gaiṃ ka gauṃ ne 
SA_MB_siddhalaksmipujapaddhatiHK-130	ityāṅgāni	iti āṅgāni 
SA_MB_siddhalaksmipujapaddhatiHK-131	sīṃ jñānaśaktaye namaḥ | suṃ kriyāśaktaye namaḥ |	sīṃ jñāna śaktaye namaḥ suṃ kriyā śaktaye namaḥ 
SA_MB_siddhalaksmipujapaddhatiHK-132	tato lokapālāḥ samantrāḥ pūrvoktāḥ |	tatas lokapālāḥ sa mantrāḥ pūrva uktāḥ 
SA_MB_siddhalaksmipujapaddhatiHK-133	spheṃ subhagāyai | sphiṃ lalitāyai | sphuṃ kāpālinyai | spheṃ kāmamālinyai namaḥ | lūṃ indrāyetyādi |	spheṃ subhagāyai sphiṃ lalitāyai sphuṃ kāpālinyai spheṃ kāmamālinyai namaḥ lūṃ indrāya ityādi 
SA_MB_siddhalaksmipujapaddhatiHK-134	iti gaurīpūjanam ||	iti gaurī pūjanam 
SA_MB_siddhalaksmipujapaddhatiHK-135	oṃ namaḥ siddhalakṣmyai ||	om namaḥ siddhalakṣmyai 
SA_MB_siddhalaksmipujapaddhatiHK-136	devīṃ śuddhasphaṭikadhavalāṃ pañcavaktrāṃ trinettrāṃ dorbhiryuktāṃ daśabhirabhitaḥ śobhitāṃ	devīm śuddha sphaṭika dhavalām pañcavaktrām trinettrām dorbhiḥ yuktām daśabhiḥ abhitas śobhitām 
SA_MB_siddhalaksmipujapaddhatiHK-137	ratnahāraiḥ |	ratna hāraiḥ 
SA_MB_siddhalaksmipujapaddhatiHK-138	dakṣiṇa pārśve	dakṣiṇa pārśve 
SA_MB_siddhalaksmipujapaddhatiHK-139	1 kādyaṃ muṇḍaṃ 2 sṛṇimamasṛṇaṃ 3 śūlamacchāccha?dhāraṃ 4 sārātsāraṃ 5	kādyam muṇḍam sṛṇim amasṛṇam śūlam accha accha dhāram sārāt sāram 
SA_MB_siddhalaksmipujapaddhatiHK-140	varamanavaradakṣahastairvahantīm || 1 ||	varam an avara dakṣa hastaiḥ vahantīm 
SA_MB_siddhalaksmipujapaddhatiHK-141	vāmapārśve	vāma pārśve 
SA_MB_siddhalaksmipujapaddhatiHK-142	1 utkhaṭvāṅgaṃ kaṭhinavikaṭāṃ 2 ṭaṅkamūrjasviṭaṅkapāśaṃ 3 jñānāmṛtarasamayaṃ 5 pustakaṃ 6	utkhaṭvā aṅgam kaṭhina vikaṭām ṭaṅkam ūrjasvi ṭaṅka pāśam jñāna amṛta rasa mayam pustakam 
SA_MB_siddhalaksmipujapaddhatiHK-143	cābhayaṃ ca |	ca abhayam ca 
SA_MB_siddhalaksmipujapaddhatiHK-144	kāmaṃ vāmaiḥ śubhakaratalairbibhratīṃ viśvavandyāṃ padmapretoparikṛtapadāṃ siddhalakṣmīṃ namāmi || 2 ||	kāmam vāmaiḥ śubha kara talaiḥ bibhratīm viśva vandyām padma preta upari kṛta padām siddha lakṣmīm namāmi  /
SA_MB_siddhalaksmipujapaddhatiHK-145	icchāśakti prathamalaharīmasurāntaḥ pravāhāṃ garbhībhūtāṃ trividhamuditāṃ pañcadhā prasphurantīm |	icchā śakti prathama laharīm asura antar pravāhām garbhībhūtām trividha muditām pañcadhā prasphurantīm 
SA_MB_siddhalaksmipujapaddhatiHK-146	samyagdevīṃ sphaṭikadhavalāṃ śuddhakundenduvarṇāṃ rudrārūḍhāṃ daśabhujayutāṃ kṣāmagātrīṃ namāmi	samyak devīm sphaṭika dhavalām śuddha kunda indu varṇām rudra ārūḍhām daśa bhuja yutām kṣāma gātrīm namāmi 
SA_MB_siddhalaksmipujapaddhatiHK-147	oṃ hrīṃ śrīṃ kulagaṇapatināthapāda | oṃ kula gaṇapativalyabhāmbāpāda | oṃ vaṭukanāthapāda | oṃ	om hrīṃ śrīṃ kula gaṇapati nātha pāda om kula gaṇapati valī abha ambā pāda om vaṭuka nātha pāda 
SA_MB_siddhalaksmipujapaddhatiHK-148	vaṭukavalyabhāmbāpāda | oṃ gaṅgāmbāpāda | oṃ yamunāmbāpāda | iti dvārapūjā ||	om gaṅgā ambā pāda om yamunā ambā pāda iti dvāra pūjā 
SA_MB_siddhalaksmipujapaddhatiHK-149	atha guru kramaḥ |	atha guru kramaḥ 
SA_MB_siddhalaksmipujapaddhatiHK-150	oṃ hrīṃ śrīṃ paramaśivanāthapāda | oṃ śivanāthapāda | oṃ ekanettranāthapāda | oṃ kālāgni rudranāthapāda	om hrīṃ śrīṃ paramaśiva nātha pāda om śiva nātha pāda om ekanettra nātha pāda om kālāgni rudra nātha pāda 
SA_MB_siddhalaksmipujapaddhatiHK-151	oṃ śrīkaṇṭhanāthapāda | oṃ pārvatī ambāpāda | oṃ daśakaṇṭha(kandara)nāthapāda | oṃ	om śrīkaṇṭha nātha pāda om pārvatī ambā pāda om daśakaṇṭha kandara nātha pāda 
SA_MB_siddhalaksmipujapaddhatiHK-152	dīpikācāryanāthapāda | oṃ andhakāsuranāthapāda | oṃ jayadrathanāthapāda | oṃ caryānandanāthapāda | oṃ	dīpikā ācārya nāthapāda om andhaka asura nāthapāda om jayadratha nāthapāda om caryānanda nāthapāda om 
SA_MB_siddhalaksmipujapaddhatiHK-153	sundaranāthapāda | oṃ gaganabhūtināthapāda | oṃ indrabhūtināthapāda | oṃ bhāskaranāthapāda | oṃ	sundara nātha pāda om gaganabhūti nātha pāda om indrabhūti nātha pāda om bhāskara nātha pāda 
SA_MB_siddhalaksmipujapaddhatiHK-154	padmādevyambāpāda | oṃ svagurunāthapāda | iti gurukramaḥ ||	                                                             
SA_MB_siddhalaksmipujapaddhatiHK-155	athāsanapūjā	atha āsana pūjā 
SA_MB_siddhalaksmipujapaddhatiHK-156	hrīṃ śrīṃ ādhāraśaktyai namaḥ | oṃ anantāya | oṃ dhātryai | oṃ surārṇavāya | oṃ padmāsanāya | oṃ hūṃ	hrīṃ śrīṃ ādhāra śaktyai namaḥ om anantāya om dhātryai om surārṇavāya om padmāsanāya om hūṃ 
SA_MB_siddhalaksmipujapaddhatiHK-157	rudrāsanāya namaḥ | oṃ pretāsanāya ||	rudra āsanāya namaḥ om preta āsanāya 
SA_MB_siddhalaksmipujapaddhatiHK-158	hrīṃ śrīṃ aṃ āṃ iṃ īṃ uṃ ūṃ ṛṃ ṝṃ ḷṃ ḹṃ eṃ aiṃ oṃ auṃ aṃ aḥ kadambavāgīśvaryai namaḥ |	hrīṃ śrīṃ aṃ āṃ iṃ īṃ uṃ ūm ṛṃ ṝṃ ḷṃ ḹṃ eṃ aim om aum aṃ aḥ kadamba vāgīśvaryai namaḥ 
SA_MB_siddhalaksmipujapaddhatiHK-159	hrīṃ śrīṃ kaṃ khaṃ gaṃ ghaṃ ṅaṃ haṃsa vāgīśvaryai namaḥ | hrīṃ śrīṃ caṃ chaṃ jaṃ jhaṃ ñaṃ	hrīṃ śrīṃ kaṃ khaṃ gaṃ ghaṃ ṅaṃ haṃsa vāgīśvaryai namaḥ hrīṃ śrīṃ caṃ chaṃ jaṃ jhaṃ ñaṃ 
SA_MB_siddhalaksmipujapaddhatiHK-160	cittrāvāgīśvaryai namaḥ | oṃ ṭaṃ ṭhaṃ ḍaṃ ḍhaṃ ṇaṃ medhāvāgīśvaryai namaḥ | oṃ taṃ thaṃ daṃ dhaṃ	cittrā vāc īśvaryai namaḥ om ṭaṃ ṭhaṃ ḍaṃ ḍhaṃ ṇaṃ medhā vāc īśvaryai namaḥ om taṃ thaṃ daṃ dhaṃ 
SA_MB_siddhalaksmipujapaddhatiHK-161	naṃ vedyāvāgīśvaryai namaḥ | oṃ paṃ phaṃ baṃ bhaṃ maṃ bhogyāvāgīśvaryai namaḥ |	naṃ vedyā vāc īśvaryai namaḥ om paṃ phaṃ baṃ bhaṃ maṃ bhogyā vāc īśvaryai namaḥ 
SA_MB_siddhalaksmipujapaddhatiHK-162	oṃ yaṃ raṃ laṃ vaṃ subhagāvāgīśvaryai namaḥ | oṃ śaṃ ṣaṃ saṃ haṃ gaurīvāgīśvaryai namaḥ ||	om yaṃ raṃ laṃ vaṃ subhagā vāc īśvaryai namaḥ om śam ṣaṃ saṃ haṃ gaurī vāc īśvaryai namaḥ 
SA_MB_siddhalaksmipujapaddhatiHK-163	vargāṣṭakaṃ dalāṣṭake | tadupari mūlavidyayā | tatrādau tāvadātmano nyāsaṃ kuryāt | vakṣyamāṇakrameṇa	varga aṣṭakam dala aṣṭake tad upari mūlavidyayā tatra ādau tāvat ātmanaḥ nyāsam kuryāt vakṣyamāṇa krameṇa 
SA_MB_siddhalaksmipujapaddhatiHK-164	oṃ namaḥ sarvasiddhiyoginībhyo namaḥ | sarvasiddhimātṛbhyo | namo nityoditānandananditāyai	om namaḥ sarva siddhi yoginībhyaḥ namaḥ sarva siddhi mātṛbhyaḥ namaḥ nityodita ānanda nanditāyai 
SA_MB_siddhalaksmipujapaddhatiHK-165	sakalakulacakranāyikāyai bhagavatyai caṇḍakāpālinyai |	sakala kula cakra nāyikāyai bhagavatyai caṇḍa kāpālinyai 
SA_MB_siddhalaksmipujapaddhatiHK-166	tad yathā	tat yathā 
SA_MB_siddhalaksmipujapaddhatiHK-167	oṃ hrīṃ hrūṃ hāṃ pheṃ kṣoṃ kroṃ namaḥ | oṃ parama haṃsini nirvāṇamārgadeviṣamopaplava praśamani	om hrīṃ   hāṃ pheṃ     namaḥ om parama haṃsini praśamani 
SA_MB_siddhalaksmipujapaddhatiHK-168	sakaladuritāriṣṭa kleśa dalani sarvāpada'mbhodhitaraṇi sakalaśatrupramathini devi āgaccha 2 hasa 2 valga 2	sakala durita ariṣṭa kleśa dalani sarva āpad ambhodhi taraṇi sakala śatru pramathini devi āgaccha hasa valga 
SA_MB_siddhalaksmipujapaddhatiHK-169	nararudhirāntravasābhakṣiṇi mama svaśatrūnmarda 2 khāhi 2 triśūlena bhindi 2 chindi 2 khaḍgena tāḍaya 2	nara rudhira antra vasā bhakṣiṇi mama sva śatru unmarda khāhi triśūlena bhindi chindi khaḍgena tāḍaya 
SA_MB_siddhalaksmipujapaddhatiHK-170	cchedaya 2 tāvadyāvanmama sakalamanorathānsādhaya 2 paramakāruṇike bhagavati |	chedaya tāvat yāvat mama sakala manorathān sādhaya parama kāruṇike bhagavati 
SA_MB_siddhalaksmipujapaddhatiHK-171	mahābhairavarūpadhāriṇi tridaśavaranamite sakalamantramātaḥ praṇatajanavatsale devi mahākāli kālanāśini	mahābhairava rūpa dhāriṇi tridaśa vara namite sakala mantra mātar praṇata jana vatsale devi mahākāli kālanāśini 
SA_MB_siddhalaksmipujapaddhatiHK-172	huṃ huṃ huṃ prasīdamadanāturāṃ kuru kuru surāsura kanyakāṃ hrīṃ śrīṃ hāṃ hūṃ phaṭ phaṭ phaṭ	hum hum hum prasīda madana āturām kuru kuru sura asura kanyakām hrīṃ śrīṃ hāṃ   phaṭ phaṭ phaṭ 
SA_MB_siddhalaksmipujapaddhatiHK-173	svāhā ||	svāhā 
SA_MB_siddhalaksmipujapaddhatiHK-174	varṇāḥ 29	varṇāḥ 
SA_MB_siddhalaksmipujapaddhatiHK-175	iti siddhalakṣmī mūlavidyā |	iti siddhalakṣmī mūlavidyā 
SA_MB_siddhalaksmipujapaddhatiHK-176	athāsya nyāsapaddhati likhyate ||	atha asya nyāsa paddhati likhyate 
SA_MB_siddhalaksmipujapaddhatiHK-177	oṃ namaḥ sarvasiddhiyoginībhyaḥ | pūrvavaktrāya namaḥ | pūrvavaktre nyaset | oṃ namaḥ sarvasiddhimātṛbhyo	om namaḥ sarva siddhi yoginībhyaḥ pūrva vaktrāya namaḥ pūrva vaktre nyaset om namaḥ sarva siddhi mātṛbhyaḥ 
SA_MB_siddhalaksmipujapaddhatiHK-178	dakṣiṇavaktrāya namaḥ | namo nityoditānandananditāyai vāmavaktrāya namaḥ | sakalakulacakranāyikāyai	dakṣiṇa vaktrāya namaḥ namaḥ nityodita ānanda nanditāyai vāma vaktrāya namaḥ sakala kula cakra nāyikāyai 
SA_MB_siddhalaksmipujapaddhatiHK-179	paścimavaktrāya namaḥ | bhagavatyai caṇḍakāpālinyai ūrdhvavaktrāya namaḥ | ta āsye | dya hṛdi | thā nābhau	paścima vaktrāya namaḥ bhagavatyai caṇḍakāpālinyai ūrdhva vaktrāya namaḥ te āsye dya hṛdi thā nābhau 
SA_MB_siddhalaksmipujapaddhatiHK-180	| oṃ āsye | hrīṃ vāmanāsāpuṭe | hūṃ dakṣiṇanāsāpuṭe | hāṃ vāmanettre | pheṃ dakṣiṇanettre | kṣoṃ	om āsye   vāma nāsā puṭe   dakṣiṇa nāsā puṭe   vāma nettre pheṃ dakṣiṇa nettre   
SA_MB_siddhalaksmipujapaddhatiHK-181	vāmakarṇe | kroṃ dakṣiṇakarṇe | na hṛdaye | maḥ dvādaśānte | etanmuṇḍakrameṇa	vāma karṇe   dakṣiṇa karṇe na hṛdaye maḥ dvādaśānte etat muṇḍa krameṇa 
SA_MB_siddhalaksmipujapaddhatiHK-182	sc, 9, p. 61)	se 
SA_MB_siddhalaksmipujapaddhatiHK-183	navadvāreṣu nyaset | oṃ paramahaṃsini hṛdayāya namaḥ | nirvāṇamārgade śira0 | viṣamopaplava praśamani	nava dvāreṣu nyaset  om paramahaṃsini hṛdayāya namaḥ nirvāṇa mārga de śira viṣama upaplava praśamani 
SA_MB_siddhalaksmipujapaddhatiHK-184	śikhā | sakalarduritāriṣṭa kleśadalani kava | sarvāpadambodhitaraṇi nettrā | sakalaśatru pramathini astrā |	śikhā 
SA_MB_siddhalaksmipujapaddhatiHK-185	iti ṣaḍaṅganyāsaḥ |	iti ṣaḍaṅganyāsaḥ 
SA_MB_siddhalaksmipujapaddhatiHK-186	anenaivāstra mantreṇa digbandhanādikaṃ kuryāt |	anena eva astra mantreṇa digbandhana ādikam kuryāt 
SA_MB_siddhalaksmipujapaddhatiHK-187	oṃ devi āgaccha 2 hasa 2 valga 2 nararudhirāntravasā bhakṣiṇikādyāya namaḥ |	om devi āgaccha hasa valga nara rudhira antra vasā bhakṣiṇikā ādyāya namaḥ 
SA_MB_siddhalaksmipujapaddhatiHK-188	dakṣiṇahaste	dakṣiṇa haste 
SA_MB_siddhalaksmipujapaddhatiHK-189	kādyamudrayā nyaset | mama svaśatrūnmarda 2 khāhi 2 khaṭvāṅgāya namaḥ |	kādya mudrayā nyaset mama sva śatru unmarda khāhi khaṭvāṅgāya namaḥ 
SA_MB_siddhalaksmipujapaddhatiHK-190	vāmahaste |	vāma haste 
SA_MB_siddhalaksmipujapaddhatiHK-191	triśūlena bhindi 2 triśūlāya namaḥ | dakṣiṇahaste | cchindi 2 khaḍgena khaḍgāya namaḥ dakṣe |	triśūlena bhindi triśūlāya namaḥ dakṣiṇa haste chindi khaḍgena khaḍgāya namaḥ dakṣe 
SA_MB_siddhalaksmipujapaddhatiHK-192	tāḍaya 2 pāśāya namaḥ vāme |	tāḍaya pāśāya namaḥ vāme 
SA_MB_siddhalaksmipujapaddhatiHK-193	cchedaya 2 aṅkuśāya namaḥ dakṣiṇe |	chedaya aṅkuśāya namaḥ dakṣiṇe 
SA_MB_siddhalaksmipujapaddhatiHK-194	tāvad yāvan mama sakalamanorathānsādhaya 2 varāya namaḥ dakṣiṇe |	tāvat yāvat mama sakala manorathān sādhaya varāya namaḥ dakṣiṇe 
SA_MB_siddhalaksmipujapaddhatiHK-195	parama kāruṇike abhayāya namaḥ vāme |	parama kāruṇike abhayāya namaḥ vāme 
SA_MB_siddhalaksmipujapaddhatiHK-196	bhagavati mahābhairavarūpadhāriṇi | pustakāya namaḥ vāme |	bhagavati mahābhairava rūpa dhāriṇi pustakāya namaḥ vāme 
SA_MB_siddhalaksmipujapaddhatiHK-197	tridaśavaranamite ṭaṅkāya namaḥ vāme |	tridaśa vara namite ṭaṅkāya namaḥ vāme 
SA_MB_siddhalaksmipujapaddhatiHK-198	ityā yudhanyāsaḥ ||	ityāḥ yudhanyāsaḥ 
SA_MB_siddhalaksmipujapaddhatiHK-199	sakalamantramātaḥ mātṛkāyai namaḥ |	sakala mantra mātar mātṛkāyai namaḥ 
SA_MB_siddhalaksmipujapaddhatiHK-200	ityanena	iti anena 
SA_MB_siddhalaksmipujapaddhatiHK-201	a ka ca ṭa ta pa yuśātmikā varṇamātṛkā svarūpajanana śīlayā bhagavatyā'nāhatanādarūpayā	a ka ca ṭa ta pa yuśa ātmakā varṇa mātṛkā sva rūpa janana śīlayā bhagavatyā anāhatanāda rūpayā 
SA_MB_siddhalaksmipujapaddhatiHK-202	śaktisvarūpaṃ prakāśitamiti mūlam |	śakti svarūpam prakāśitam iti mūlam 
SA_MB_siddhalaksmipujapaddhatiHK-203	praṇatajanavatsale rudrāsanāya nama | iti bhairavarūpaṃ vāhanaṃ sañcintya bhagavatyāṃ nyaset |	praṇata jana vatsale rudra āsanāya namaḥ iti bhairava rūpam vāhanam sañcintya bhagavatyām nyaset 
SA_MB_siddhalaksmipujapaddhatiHK-204	devi mahākāli kālanāśini ityāmantraṇaṃ kṛtvā |	devi mahākāli kālanāśini iti āmantraṇam kṛtvā 
SA_MB_siddhalaksmipujapaddhatiHK-205	bhagavatīmāvāhayet |	bhagavatīm āvāhayet 
SA_MB_siddhalaksmipujapaddhatiHK-206	huṃ huṃ huṃ ityanena piṇḍatrayeṇa viṣayapañcaka indriyapañcaka prāṇapañcaka grāhyagrahaṇa grāhaka	hum hum hum iti anena piṇḍa trayeṇa viṣaya pañcaka indriya pañcaka prāṇa pañcaka grāhya grahaṇa grāhaka 
SA_MB_siddhalaksmipujapaddhatiHK-207	rūpasya kālasya vināśinī bhagavatyā kriyā pradarśitā |	rūpasya kālasya vināśinī bhagavatyā kriyā pradarśitā 
SA_MB_siddhalaksmipujapaddhatiHK-208	tacca piṇḍanāthaṃ nādarūpaṃ paramaśaktiravolyāsikayā bhavati |	tat ca piṇḍanātham nāda rūpam parama śakti ravaḥ lyāsikayā bhavati 
SA_MB_siddhalaksmipujapaddhatiHK-209	oṃ prasīdamadanāturāṃ kuru kuru surāsura kanyakāṃ devī rūpaṃ yathābhimataṃ dhyātvā |	om prasīda madana āturām kuru kuru sura asura kanyakām devī rūpam yathā abhimatam dhyātvā 
SA_MB_siddhalaksmipujapaddhatiHK-210	hrīmiti kande nyaset |	hrīm iti kande nyaset 
SA_MB_siddhalaksmipujapaddhatiHK-211	sc 10, p. 61)	se 
SA_MB_siddhalaksmipujapaddhatiHK-212	śrīṃ nābhau | hūṃ hṛdaye | phaṭ kaṇṭhe | phaṭ tāluni | phaṭ bindusthāne | svā iti nādanādānte | hā |	śrīṃ nābhau   hṛdaye phaṭ kaṇṭhe phaṭ tāluni phaṭ bindu sthāne svā iti nāda nāda ante hā 
SA_MB_siddhalaksmipujapaddhatiHK-213	iti dvādaśānte |	iti dvādaśa ante 
SA_MB_siddhalaksmipujapaddhatiHK-214	iti vaktrapañcakam |	iti vaktra pañcakam 
SA_MB_siddhalaksmipujapaddhatiHK-215	yasyā bhagavatyāstribhuvanajananyāḥ pṛthivyaptejo vāyvākāśarūpaṃ yathā saṃkhyaṃ pratinetratrayaṃ	yasyāḥ bhagavatyāḥ tribhuvana jananyāḥ pṛthivī ap tejaḥ vāyu ākāśa rūpam yathā saṃkhyam pratinetra trayam 
SA_MB_siddhalaksmipujapaddhatiHK-216	somasūryavahnyātmakaṃ sṛṣṭisthitisaṃhārarūpaṃ vā vāmadakṣiṇa bhujadaśakaṃ śrotratvakcakṣuḥ	soma sūrya vahni ātmakam sṛṣṭi sthiti saṃhāra rūpam vā vāma dakṣiṇa bhuja daśakam śrotra tvac cakṣuḥ 
SA_MB_siddhalaksmipujapaddhatiHK-217	jihvāghrāṇa vākpāṇipādapāyūpastharūpaṃ tatsaṃlagnaṃ viṣayadaśakamastradaśakaṃ	jihvā ghrāṇa vāc pāṇi pāda pāyu upastha rūpam tat saṃlagnam viṣaya daśakam astra daśakam 
SA_MB_siddhalaksmipujapaddhatiHK-218	śabdasparśarūparasagandhalakṣaṇaṃ vacanādānagamanotsargānandarūpaṃ ca | evaṃ bhagavatī śaktitirāvaraṇā	śabda sparśa rūpa rasa gandha lakṣaṇam vacana ādāna gamana utsarga ānanda rūpam ca  evam bhagavatī śakti tirāvaraṇā 
SA_MB_siddhalaksmipujapaddhatiHK-219	satīsat svātantryolyāsita tatvā sarvadehavyāpinī paramaśivasyā kulavapuṣaḥ taddharmadharmiṇī abhedena	sarva deha vyāpinī paramaśivasya kula vapuṣaḥ tad dharma dharmiṇī abhedena 
SA_MB_siddhalaksmipujapaddhatiHK-220	vartate |	vartate 
SA_MB_siddhalaksmipujapaddhatiHK-221	iti śivam |	iti śivam 
SA_MB_siddhalaksmipujapaddhatiHK-222	oṃ hūṃ mahārādhyāya namaḥ | iti baliḥ |	om   mahārādhyāya namaḥ iti baliḥ 
SA_MB_siddhalaksmipujapaddhatiHK-223	hsvīṃ sphuṭ mahācaṇḍayogīśvari | ṭhstrīṃ sphuṭ thstrīṃ sphuṭ | ṭhstrīṃ sphuṭ | iti samayā ||	hsvīṃ sphuṭ mahācaṇḍayogīśvari ṭhstrīṃ sphuṭ thstrīṃ sphuṭ ṭhstrīṃ sphuṭ iti samayā 
SA_MB_siddhalaksmipujapaddhatiHK-224	iti saṃkṣiptā siddhalakṣmīpūjāpaddhatiḥ samāptā ||	iti saṃkṣiptā siddha lakṣmī pūjā paddhatiḥ samāptā 
SA_MB_siddhalaksmipujapaddhatiHK-225	oṃ śrīśārikābhagavatyai namaḥ ||	om śrī śārikā bhagavatyai namaḥ 
SA_MB_siddhalaksmipujapaddhatiHK-226	oṃ bījaiḥ saptabhirujjvalā kṛtirasau yā saptasapti dyutiḥ saptarṣipraṇatāṅghri pañkajayugāyā saptalokārti	om bījaiḥ saptabhiḥ ujjvalā kṛtiḥ asau yā saptasapti dyutiḥ saptarṣi praṇata aṅghri pañkaja yugāyā sapta loka ārti 
SA_MB_siddhalaksmipujapaddhatiHK-227	hṛt | protaprāyamapañjaraṃ kṛtavatī pradyumnamunmocitaṃ devī saptaka saṃyutā bhagavatī śrīśārikā	hṛd prota prāyam apañjaram kṛtavatī pradyumnam unmocitam devī saptaka saṃyutā bhagavatī śrī śārikā 
SA_MB_siddhalaksmipujapaddhatiHK-228	pātunaḥ ||	pātunaḥ 
SA_MB_siddhalaksmipujapaddhatiHK-229	oṃ hrīṃ śrīṃ gaṇapataye vauṣaṭ | oṃ gaṇapati vallabhāyai vauṣaṭ | oṃ muṇḍarāya vauṣaṭ |	om hrīṃ śrīṃ gaṇapataye vauṣaṭ om gaṇapati vallabhāyai vauṣaṭ om muṇḍarāya vauṣaṭ 
SA_MB_siddhalaksmipujapaddhatiHK-230	iti dvārapālāḥ |	iti dvārapālāḥ 
SA_MB_siddhalaksmipujapaddhatiHK-231	oṃ hrīṃ śrīṃ gurunāthapādukāṃ pūjayāmi namaḥ | evaṃ paramaguruparameṣṭhi paramācāryādi siddhāḥ	om   śrīṃ guru nātha pādukām pūjayāmi namaḥ evam parama guru parameṣṭhi parama ācārya ādi siddhāḥ 
SA_MB_siddhalaksmipujapaddhatiHK-232	pūjyāḥ | vāme |	pūjyāḥ vāme 
SA_MB_siddhalaksmipujapaddhatiHK-233	oṃ padmāsanāya namaḥ |	om padmāsanāya namaḥ 
SA_MB_siddhalaksmipujapaddhatiHK-234	tadupari	tad upari 
SA_MB_siddhalaksmipujapaddhatiHK-235	bhagavatīṃ pūjayet |	bhagavatīm pūjayet 
SA_MB_siddhalaksmipujapaddhatiHK-236	oṃ hrīṃ śrīṃ hūṃ pheṃ āṃ śāṃ śārikāyai namaḥ | mūlam ||	om   śrīṃ   pheṃ āṃ śāṃ śārikāyai namaḥ mūlam 
SA_MB_siddhalaksmipujapaddhatiHK-237	tatoṅgāni |	tatas uṅgāni 
SA_MB_siddhalaksmipujapaddhatiHK-238	śrāṃ hṛ | śrīṃ śi | śrūṃ śi | śraiṃ ka | śrauṃ ne | śraḥ astraṃ ||	śrāṃ hṛ śrīṃ śi śrūṃ śi  śraiṃ ka śrauṃ ne śraḥ astram 
SA_MB_siddhalaksmipujapaddhatiHK-239	atha nyāsaḥ |	atha nyāsaḥ 
SA_MB_siddhalaksmipujapaddhatiHK-240	oṃ āsye |	om āsye 
SA_MB_siddhalaksmipujapaddhatiHK-241	hrīṃ dakṣiṇanāsāpuṭe | śrīṃ vāmanāsāpuṭe | hūṃ dakṣiṇanettre | pheṃ vāmanettre | āṃ	hrīṃ dakṣiṇa nāsā puṭe śrīṃ vāma nāsā puṭe   dakṣiṇa nettre pheṃ vāma nettre āṃ 
SA_MB_siddhalaksmipujapaddhatiHK-242	dakṣiṇakarṇe | śāṃ vāmakarṇe | śā śirasi | ri hṛdaye | kā nābhau | yai kande | na guhye | ma ūrdhoḥ |	dakṣiṇa karṇe śāṃ vāma karṇe śā śirasi ri hṛdaye kā nābhau kande na guhye me ūrdhoḥ 
SA_MB_siddhalaksmipujapaddhatiHK-243	iti nyāsaḥ |	iti nyāsaḥ 
SA_MB_siddhalaksmipujapaddhatiHK-244	oṃ hrīṃ aṃ amāyai namaḥ | oṃ hrīṃ kaṃ kāmāyai namaḥ | oṃ hrīṃ caṃ cārvāṅgyai namaḥ | oṃ hrīṃ ṭaṃ	om hrīṃ aṃ amāyai namaḥ  om hrīṃ kaṃ kāmāyai namaḥ om hrīṃ caṃ cārvāṅgyai namaḥ om hrīṃ ṭaṃ 
SA_MB_siddhalaksmipujapaddhatiHK-245	ṭātvarāyai namaḥ | oṃ hrīṃ taṃ tārāyai namaḥ | oṃ hrīṃ paṃ pārvatyai namaḥ | oṃ hrīṃ yaṃ yakṣinyai	namaḥ  om hrīṃ taṃ tārāyai namaḥ om hrīṃ paṃ pārvatyai namaḥ om hrīṃ yaṃ yakṣinyai 
SA_MB_siddhalaksmipujapaddhatiHK-246	namaḥ | oṃ hrīṃ ruṃ rukminyai | oṃ hrīṃ śaṃ śambharāyai namaḥ |	namaḥ om hrīṃ ruṃ rukminyai om hrīṃ śam śambharāyai namaḥ 
SA_MB_siddhalaksmipujapaddhatiHK-247	iti kalpoddhṛtaḥ ||	iti kalpa uddhṛtaḥ 
SA_MB_siddhalaksmipujapaddhatiHK-248	oṃ hrīṃ hūṃ kāṃ kāṃ kāṃ iti bhedatrayam | oṃ hrīṃ hūṃ amāyai namaḥ |	om     kāṃ kāṃ kāṃ iti bheda trayam om     amāyai namaḥ 
SA_MB_siddhalaksmipujapaddhatiHK-249	ityādi devyaḥ pūjyāḥ |	ityādi devyaḥ pūjyāḥ 
SA_MB_siddhalaksmipujapaddhatiHK-250	oṃ hrīṃ jaṃ jambālajalendrāya namaḥ |	om   jaṃ jambāla jala indrāya namaḥ 
SA_MB_siddhalaksmipujapaddhatiHK-251	iti kṣetreśam ||	iti kṣetra īśam 
SA_MB_siddhalaksmipujapaddhatiHK-252	iti śārikāpūjanam ||	iti śārikā pūjanam 
SA_MB_siddhalaksmipujapaddhatiHK-253	varadābhayahastāṃ ca khaḍgaśūladharāṃ śubhām | śuddhasphaṭikasaṅkāśāṃ padmārūḍhāṃ vicintayet ||	vara da abhaya hastām ca khaḍga śūla dharām śubhām śuddha sphaṭika saṅkāśām padma ārūḍhām vicintayet 
SA_MB_siddhalaksmipujapaddhatiHK-254	oṃ hrīṃ śrīṃ phreṃ ekāntyai namaḥ | iti mūlam ||	om hrīṃ śrīṃ phreṃ ekāntyai namaḥ iti mūlam 
SA_MB_siddhalaksmipujapaddhatiHK-255	karādi dehanyāsaśca ekoccāre bhaviṣyati | ityekāntī ||	kara ādi deha nyāsaḥ ca eka uccāre bhaviṣyati iti ekāntī 
SA_MB_siddhalaksmipujapaddhatiHK-256	oṃ aiṃ hrīṃ śrīṃ khphreṃ hsrauṃ namo bhagavati kubjike ||	om aim   śrīṃ                               
SA_MB_siddhalaksmipujapaddhatiHK-257	ṅa ña ṇa name || aghoramukhi || krāṃ krīṃ kiṇi kiṇi vicche || iti kubjikā ||	ṅa ña ṇa name aghora mukhi krāṃ krīṃ kiṇi kiṇi vicche iti kubjikā 
SA_MB_siddhalaksmipujapaddhatiHK-258	oṃ hrīṃ phreṃ śrīṃ caṇḍayogeśvari bhavabhavāni sarvakāmaprade sarvasaubhāgyadāyini hrīṃ namaḥ svāhā |	om   phreṃ śrīṃ caṇḍayogeśvari bhava bhavāni sarva kāma prade sarva saubhāgya dāyini   namaḥ svāhā 
SA_MB_siddhalaksmipujapaddhatiHK-259	iti kurikā ||	iti kurikā 
SA_MB_siddhalaksmipujapaddhatiHK-260	oṃ dorbhiyuktāṃ caturbhiḥ sphaṭikamaṇimayīmakṣamālāṃ dadhānāṃ hastenaikena padmaṃ sitamapicaṣakaṃ	om dorbhiḥ yuktām caturbhiḥ sphaṭika maṇi mayīm akṣamālām dadhānām hastena ekena padmam sitam api caṣakam 
SA_MB_siddhalaksmipujapaddhatiHK-261	pustakaṃ cāpareṇa | yā sā kundendu śaṅkhasphaṭikamaṇinibhābhāsamānāsamānāsāmevāgdevateyaṃ nivasatu	pustakam ca apareṇa yā sā kunda indu śaṅkha sphaṭika maṇi nibha ābhāsamānā samānā āsām evāgdevatā iyam nivasatu 
SA_MB_siddhalaksmipujapaddhatiHK-262	vadane sarvadā suprasannā || aiṃ vada vada vāgvādini svāhā |	vadane sarvadā su prasannā aim vada vada vāgvādini svāhā 
SA_MB_siddhalaksmipujapaddhatiHK-263	iti mūlam |	iti mūlam 
SA_MB_siddhalaksmipujapaddhatiHK-264	aiṃ hṛ vada vada śi vāgvā śi dini ka svāne | hā astrā | iti vāgvādinī pūjanam ||	aim hṛ vada vada śi vāgvā śi dini ka hā astrā iti vāgvādinī pūjanam 
SA_MB_siddhalaksmipujapaddhatiHK-265	i akṣasūttrāmbujakarāmādarśakalaśāṅkitām | mīnapadmāsanāsīnāṃ vitastāṃ saraṇaṃ śraye ||	akṣa sūttra ambuja karām ādarśa kalaśa aṅkitām mīna padmāsana āsīnām vitastām saraṇam śraye 
SA_MB_siddhalaksmipujapaddhatiHK-266	oṃ śrīṃ gāṃ gīṃ saḥ vitastāyai namaḥ | mūlam ||	om śrīṃ gāṃ gīṃ saḥ vitastāyai namaḥ mūlam 
SA_MB_siddhalaksmipujapaddhatiHK-267	gāṃ hṛ gīṃ śi gūṃ śi gaiṃ ka gauṃ ne gaḥ astrā | hsvyrāṃ gāṃ gīṃ gūṃ gīṃ gaḥ vitastāyai namaḥ	gām hṛ gīṃ śi gūṃ śi gaiṃ ka gauṃ ne gaḥ astrā gām gīṃ gūṃ gīṃ gaḥ vitastāyai namaḥ 
SA_MB_siddhalaksmipujapaddhatiHK-268	| ityaparaḥ | iti vitastā pūjanam ||	iti aparaḥ iti vitastā pūjanam 
SA_MB_siddhalaksmipujapaddhatiHK-269	jvālāmukhe mahājvāleti dhyānaṃ | punaśca |	jvālā mukhe mahā jvālā iti dhyānam punar ca 
SA_MB_siddhalaksmipujapaddhatiHK-270	kalpāntadahanajvālā baddhvāyata śiroruhe | mātaḥ krūrāsuvadanā vaikartane dṛḍhavratā ||	kalpānta dahana jvālā baddhvā āyata śiroruhe mātar krūra asu vadanā vaikartane dṛḍha vratā 
SA_MB_siddhalaksmipujapaddhatiHK-271	ambikāyai vidmahe mahāmāyāyai dhīmaḥ | tannaḥ ambā pracodayāt |	ambikāyai vidmahe mahāmāyāyai dhīmaḥ tat naḥ ambā pracodayāt 
SA_MB_siddhalaksmipujapaddhatiHK-272	ḷ oṃ hrīṃ śrīṃ phuṃ jvālā bhagavatyai namaḥ | oṃ hrīṃ hṛ śrīṃ śi phuṃ śi jvālā	om   śrīṃ phuṃ jvālā bhagavatyai namaḥ om   śrīṃ śi phuṃ śi jvālā 
SA_MB_siddhalaksmipujapaddhatiHK-273	ka bhagavatyai ne namaḥ astrā ||	ka bhagavatyai ne namaḥ astrā 
SA_MB_siddhalaksmipujapaddhatiHK-274	gauryai namaḥ | vāmapāde || gāyatryai dakṣiṇe || sāvitryai vāmajānau || sarasvatyai dakṣiṇe | naralakṣmyai	gauryai namaḥ vāma pāde gāyatryai dakṣiṇe sāvitryai vāma jānau sarasvatyai dakṣiṇe naralakṣmyai 
SA_MB_siddhalaksmipujapaddhatiHK-275	nābhau || ubhāyai vāmaskande || kāmāyai dakṣe || bhavānyai śirasi || lakṣmyai namaḥ || pū ṛddhāyai | ma	nābhau ubhāyai vāma skande kāmāyai dakṣe bhavānyai śirasi lakṣmyai namaḥ pu ṛddhāyai ma 
SA_MB_siddhalaksmipujapaddhatiHK-276	tuṣṭyai | da puṣṭyai | nai sudhāyai | pa svāhāyai | vā dhṛtyai | u matyai namaḥ || ī pūrvādidikṣu pūjayet	tuṣṭyai da puṣṭyai nai sudhāyai pa svāhāyai vā dhṛtyai u matyai namaḥ pūrva ādi dikṣu pūjayet 
SA_MB_siddhalaksmipujapaddhatiHK-277	| madhye | oṃ jvālāmukhyai namaḥ | iti mūrti mantraḥ | tato mūlaṃ sāṅgaṃ paṭhet ||	madhye om jvālāmukhyai namaḥ iti mūrti mantraḥ tatas mūlam sa aṅgam paṭhet 
SA_MB_siddhalaksmipujapaddhatiHK-278	jvālāparvata saṃsthitāṃ trinayanāṃ pīṭhatrayādhiṣṭhitāṃ jvālāḍambarabhūṣitāṃ suvadanāṃ	jvālāparvata saṃsthitām tri nayanām pīṭha traya adhiṣṭhitām jvālā āḍambara bhūṣitām su vadanām 
SA_MB_siddhalaksmipujapaddhatiHK-279	nityamadṛśyāṃjanaiḥ | sanmāhātmya viśeṣa cittravilasat kāntiṃ sitāṃ kāmadāṃ tāṃ vande	nityam adṛśya aṃjanaiḥ sat māhātmya viśeṣa cittra vilasat kāntim sitām kāma dām tām vande 
SA_MB_siddhalaksmipujapaddhatiHK-280	surasiddhavanditapadāṃ jvālāṃ hṛdabja śriyam ||	sura siddha vandita padām jvālām hṛd abja śriyam 
SA_MB_siddhalaksmipujapaddhatiHK-281	dhyānaṃ dhyātvā ||	dhyānam dhyātvā 
SA_MB_siddhalaksmipujapaddhatiHK-282	oṃ hrīṃ śrīṃ (hṛ) jvālā(śiḥ)mukhi mamasarvaśatrun(śikhā)bhakṣaya(bhava)bhakṣaya hūṃ phaṭ (nettre)	om hrīṃ śrīṃ hṛ jvālā āśis mukhi mama sarva śatrun śikhā bhakṣaya bhava bhakṣaya hūm phaṭ nettre 
SA_MB_siddhalaksmipujapaddhatiHK-283	svāhā (astrā) | iti mūlamaparajvālāyāḥ || i ||	svāhā astrā iti mūlam apara jvālāyāḥ 
SA_MB_siddhalaksmipujapaddhatiHK-284	oṃ namonna pūrṇāyai ||	om namaḥ unna pūrṇāyai 
SA_MB_siddhalaksmipujapaddhatiHK-285	ekena cāpa mitareṇa kareṇa bāṇamanyena pāśamitareṇa sṛṇiṃ dadhānā |	ekena cāpam itareṇa kareṇa bāṇam anyena pāśam itareṇa sṛṇim dadhānā 
SA_MB_siddhalaksmipujapaddhatiHK-286	ānandasundaratala pravahatsuśubhrāmācintayat sphurattu kācana devatāmām | raktāṃ	ānanda sundara tala pravahat su śubhrām ācintayat sphurat tu kācana 
SA_MB_siddhalaksmipujapaddhatiHK-287	nṛcarma(vicittra)vasanāṃnavacandraśūtāmanna pradānaniratāṃstanabhāranamrām | bhaktohaminduśakalābharaṇāṃ	nṛ carma vicittra vasanām nava candra śūtām anna pradāna niratām stana bhāra namrām bhaktaḥ ham indu śakala ābharaṇām 
SA_MB_siddhalaksmipujapaddhatiHK-288	vilokya hṛṣṭāṃ bhaje bhagavatīṃ bhavaduḥkhahartrīm ||	vilokya hṛṣṭām bhaje bhagavatīm bhava duḥkha hartrīm 
SA_MB_siddhalaksmipujapaddhatiHK-289	svayaṃ annaṃ ca vidmahe svayaṃ bhuñjīma dhīmahi | tanno ambā pracodayat |	svayam annam ca vidmahe svayam bhuñjīma dhīmahi tat naḥ ambā pracodayat 
SA_MB_siddhalaksmipujapaddhatiHK-290	ḷ oṃ bhagavati māheśvari annapūrṇe namaḥ | oṃ hrīṃ namonnapūrṇeśvaryai | hrāṃ hrīṃ hrūṃ hraiṃ hrauṃ	om bhagavati māheśvari annapūrṇe namaḥ om   nama unnapūrṇa īśvarāyai                                                                                                                                              
SA_MB_siddhalaksmipujapaddhatiHK-291	hraḥ aṅgāni | ityannapūrṇāpūjanam ||	hraḥ aṅgāni iti annapūrṇāpūjanam 
SA_MB_siddhalaksmipujapaddhatiHK-292	oṃ namo lakṣmyai ||	om namaḥ lakṣmyai 
SA_MB_siddhalaksmipujapaddhatiHK-293	āsīnāṃ sarase ruhe smita mukhī hastāmbujairvibhratī dānaṃ padmayugābhayau ca vapuṣā saudāminī sannibhā |	āsīnām sarase ruhe mukhī hasta ambujaiḥ vibhratī dānam padma yuga abhayau ca vapuṣā saudāminī sannibhā 
SA_MB_siddhalaksmipujapaddhatiHK-294	muktābhāsavirājamāna vipulastuṅgastarodbhāsinī | pāyānnaḥ kamalākaṭākṣavibhavairānandayantī harim ||	muktā ābhāsa virājamāna vipulaḥ tuṅgaḥ tara udbhāsinī pāyāt naḥ kamalā kaṭākṣa vibhavaiḥ ānandayantī harim 
SA_MB_siddhalaksmipujapaddhatiHK-295	oṃ hrīṃ śrīṃ lakṣmi mahā(hṛda)lakṣmi sarvakāma(śira)prade sarvasaubhāgyadāyini abhimataṃ prayaccha 2 |	om   śrīṃ lakṣmi mahā hṛda lakṣmi sarva kāma śira prade sarva saubhāgya dāyini abhimatam prayaccha 
SA_MB_siddhalaksmipujapaddhatiHK-296	sarve sarvagate arūpe (kara) sarvaduḥkha(ne)vimocini | hrīṃ saḥ svāhā (astrā) ||	sarve sarva gate arūpe kara sarva duḥkha nevi mocini hrīṃ saḥ svāhā astrā 
SA_MB_siddhalaksmipujapaddhatiHK-297	iti lakṣmīvidyāgavākṣī mantraśca ||	iti lakṣmīvidyā gavākṣī mantraḥ ca 
SA_MB_siddhalaksmipujapaddhatiHK-298	raktānanāṃ kajakapālakarāṃ trinettrāṃ līlāparāṃ bhagatīṃ karirāja gamyām | brahmendra rudranamitāṃ	rakta ānanām kaja kapāla karām tri nettrām līlā parām bhagatīm kari rāja gamyām  brahma indra rudra namitām 
SA_MB_siddhalaksmipujapaddhatiHK-299	surasiddha sevyāṃ lakṣmīṃ namāmi satataṃ parayāpi bhaktyā ||	sura siddha sevyām lakṣmīm namāmi satatam parayā api bhaktyā 
SA_MB_siddhalaksmipujapaddhatiHK-300	oṃ hūṃ (hṛ) sarveṣāṃ (śi) hastān(ni)mama(kā)dhanaṃ dehi (ne) hūṃ vitta(a)lakṣmyai svāhā | iti	om     sarveṣām dehi   vitta alakṣmyai svāhā iti 
SA_MB_siddhalaksmipujapaddhatiHK-301	vittalakṣmīpūjanam ||	vitta lakṣmī pūjanam 
SA_MB_siddhalaksmipujapaddhatiHK-302	namo haṃsavāgīśvaryai ||	namaḥ haṃsa vāc īśvaryai 
SA_MB_siddhalaksmipujapaddhatiHK-303	parāpaśyantī madhyamika kalanāvaikharamayī prakṛṣṭaṃ vā kutvaṃ prabhavati yato deha vibhavāt | yadapyāste	parāpaśyantī madhyamika kalanā vaikhara mayī prakṛṣṭam vā kutvam prabhavati yatas deha vibhavāt 
SA_MB_siddhalaksmipujapaddhatiHK-304	kāsmīrikagirivare veḍa?vapuṣāsvahaṃ sā	kāsmīrika giri vare veḍava puṣāsu aham sā 
SA_MB_siddhalaksmipujapaddhatiHK-305	vāgīśī bhuvanajananī tvāṃstu ma iti | mūlasūttraṃ |	vāgīśī bhuvana jananī tvān tu me iti mūlasūttram 
SA_MB_siddhalaksmipujapaddhatiHK-306	ekānanā bhujataḍinnayanākṣa pakṣma sūkṣmabhramadbhramaravibhrama dṛṣṭi hṛṣṭā |	eka ānanā bhuja taḍit nayana akṣa pakṣma sūkṣma bhramat bhramara vibhrama dṛṣṭi hṛṣṭā 
SA_MB_siddhalaksmipujapaddhatiHK-307	kundenduhārahasitāṅgasitādvihaste vinyasya pustakavarākṣaguṇaṃ vahantī ||	kunda indu hāra hasita aṅga sitā dvi haste vinyasya pustaka vara akṣa guṇam vahantī 
SA_MB_siddhalaksmipujapaddhatiHK-308	satpadmako śavaraviṣṭaraviṣṭabaddhapadmāsanaṃ sakalapuṣṭikarīṃ prahṛṣṭam | haṃsānanāṃ kvacidatho	sat padmakaḥ śavara viṣṭa raviṣṭa baddha padmāsanam sakala puṣṭi karīm prahṛṣṭam haṃsa ānanām kvacid atho 
SA_MB_siddhalaksmipujapaddhatiHK-309	hṛdaye sva haṃsavāgīśvarīṃ bhagavatīṃ praṇataḥ praṇaumi ||	hṛdaye haṃsa vāc īśvarīm bhagavatīm praṇataḥ praṇaumi 
SA_MB_siddhalaksmipujapaddhatiHK-310	oṃ gaṇapatināthapāda | gaṇapati vallabhāmbāpāda | vaṭukanāthapāda | gurunāthapāda | guruvallabhāmbāpāda	om gaṇapati nātha pāda gaṇapati vallabha ambā pāda vaṭuka nātha pāda guru nātha pāda guru vallabha ambā pāda 
SA_MB_siddhalaksmipujapaddhatiHK-311	|| digdevatādvāri nandi mahākāla gaṅgāyamunādehalyaḥ pūjyāḥ || (digdevatābhyo namaḥ | nandine	digdevatā dvāri nandi mahākāla gaṅgā yamunā dehalyaḥ pūjyāḥ digdevatābhyaḥ namaḥ nandine 
SA_MB_siddhalaksmipujapaddhatiHK-312	mahākālāgaṅgāyai yamunāyai dehalyai)	mahākālā gaṅgāyai yamunāyai dehalyai 
SA_MB_siddhalaksmipujapaddhatiHK-313	oṃ hrīṃ hsrūṃ aiṃ kraṃ maṃ veḍābhagavati haṃsarūpiṇi svāhā || hsūṃ viṣṇave namaḥ | oṃ hūṃ hauṃ	om     aim   maṃ veḍā bhagavati haṃsa rūpiṇi svāhā   viṣṇave namaḥ om     
SA_MB_siddhalaksmipujapaddhatiHK-314	phaṭ saṅkarāya namaḥ | jambinyai namaḥ | mohinyai kāntyai lakṣmyai raktāyai śuṣkāyai utpalāyai namaḥ || iti	phaṭ saṅkarāya namaḥ jambinyai namaḥ mohinyai kāntyai lakṣmyai raktāyai śuṣkāyai utpalāyai namaḥ iti 
SA_MB_siddhalaksmipujapaddhatiHK-315	haṃsavāgīśvarī pūjanam ||	haṃsa vāgīśvarī pūjanam 
SA_MB_siddhalaksmipujapaddhatiHK-316	oṃ namo rājñībhagavatyai ||	om namaḥ rājñī bhagavatyai 
SA_MB_siddhalaksmipujapaddhatiHK-317	yā dvādaśārka parimaṇḍita mūrtirekā siṃhāsana sthitavatīmuragāvṛtāṃ ca | devīmanakṣagatimīśvaratāṃ	yā dvādaśa arka parimaṇḍita mūrtiḥ ekā siṃhāsana sthitavatīm uraga āvṛtām ca devīm anakṣa gatim īśvara tām 
SA_MB_siddhalaksmipujapaddhatiHK-318	prapannāṃ tāṃ naumi bhargavapuṣīṃ paramārtharājñīm ||	prapannām tām naumi bharga vapuṣīm parama artha rājñīm 
SA_MB_siddhalaksmipujapaddhatiHK-319	sūryakalāya vidmahe bhānuratnāya dhīmahi | tanno rājñīpracodayāt ||	sūrya kalāya vidmahe bhānu ratnāya dhīmahi tat naḥ rājñī pracodayāt 
SA_MB_siddhalaksmipujapaddhatiHK-320	oṃ gāṃ gaṇapataye namaḥ | oṃ bhīmarājāya namaḥ | kumārāya namaḥ | dvāre |	om gāṃ gaṇapataye namaḥ om bhīmarājāya namaḥ kumārāya namaḥ dvāre 
SA_MB_siddhalaksmipujapaddhatiHK-321	atha nāgamdhye | pūrve vāsukaye namaḥ | nīlanāgarājāya (ā) takṣakāya (da) kārkoṭa (nai) padmanāga (pa)	atha nāga mdhye pūrve vāsukaye namaḥ nīla nāga rājāya ā takṣakāya da kārkoṭa nai padmanāga pa
SA_MB_siddhalaksmipujapaddhatiHK-322	mahāpadma (vā) śaṅkhapāla (ta) kulikanāgarājāya namaḥ (ī) | madhye sahasrarasmiratnabhūṣitāya	mahāpadma vā kulika nāga rājāya namaḥ madhye sahasra rasmi ratna bhūṣitāya 
SA_MB_siddhalaksmipujapaddhatiHK-323	sahasrabhogāya dvisahasralocanāya dvisahasrajihvāya sahasranāgakoṭi parivṛtāya pītāmbarāya musulapāṇaye	sahasra bhogāya dvi sahasra locanāya dvi sahasra jihvāya sahasra nāga koṭi parivṛtāya pīta ambarāya musula pāṇaye 
SA_MB_siddhalaksmipujapaddhatiHK-324	anantanāgarājāya namaḥ |	ananta nāga rājāya namaḥ 
SA_MB_siddhalaksmipujapaddhatiHK-325	tatpṛṣṭhe |	tad pṛṣṭhe 
SA_MB_siddhalaksmipujapaddhatiHK-326	kamalāsanāya namaḥ	kamalāsanāya namaḥ 
SA_MB_siddhalaksmipujapaddhatiHK-327	oṃ hrīṃ śrīṃ rāṃ rājñī bhagavatyai namaḥ || oṃ hrīṃ hṛ śrīṃ śi rāṃ śikhā | rājñī ka |	om hrīṃ śrīṃ rāṃ rājñī bhagavatyai namaḥ om hrīṃ hṛ śrīṃ śi rāṃ śikhā rājñī ka 
SA_MB_siddhalaksmipujapaddhatiHK-328	bhagavatyaine namaḥ astrā | oṃ hrīṃ śrīṃ rāmaśūrāyakṣettreśvarāya vauṣaṭ || ||	namaḥ astrā  om hrīṃ śrīṃ vauṣaṭ 
SA_MB_siddhalaksmipujapaddhatiHK-329	oṃ śītāṃśubālārka kṛṣāṇu nettrāṃ caturbhujāmeṇatvagāsanasthām | śaṅkhābjaśūlāsidharāṃ	om nettrām catur bhujām eṇa tvac āsana sthām 
SA_MB_siddhalaksmipujapaddhatiHK-330	maheśīṃ rājñīṃ bhajehaṃ tu hi nādrirūpām ||	maheśīm rājñīm bhaja iham tu hi na adri rūpām 
SA_MB_siddhalaksmipujapaddhatiHK-331	oṃ hrīṃ śrīṃ rāṃ klīṃ sauḥ bhagavatyai rājñyai hrīṃ svāhā || rāṃ rīṃ rūṃ raiṃ rauṃ raḥ aṅgāni	om hrīṃ śrīṃ rāṃ   sauḥ bhagavatyai rājñyai   svāhā rāṃ rīṃ rūṃ raiṃ rauṃ raḥ aṅgāni 
SA_MB_siddhalaksmipujapaddhatiHK-332	| oṃ hrīṃ vijayāyai namaḥ | hrāṃ jaganmātre namaḥ | hrauṃ jayāyai namaḥ | hraḥ jagaddhātryai namaḥ || saṃ	om hrīṃ vijayāyai namaḥ   jaganmātre namaḥ   jayāyai namaḥ   jagaddhātryai namaḥ saṃ 
SA_MB_siddhalaksmipujapaddhatiHK-333	ekonaviṃśatiśate ṣaḍvarge vahnisaṃyute | abdhe tapaḥ śuklapakṣa ekādaśyāṃ samāpitā || ||	ekonaviṃśati śate ṣaḍvarge vahni saṃyute abdhe tapaḥ śukla pakṣe ekādaśyām samāpitā 
SA_MB_siddhalaksmipujapaddhatiHK-334	śrīsatpaddhatirānanda kaulena muktidāyinī śrīsadguroḥ karuṇayā bhūyācchrīśambhuprītaye || 2 ||	śrī sat paddhatiḥ ānanda kaulena mukti dāyinī śrī sat guroḥ karuṇayā bhūyāt śrī śambhu prītaye 
SA_MB_siddhalaksmipujapaddhatiHK-335	atha śāradāpūjanam ||	atha śāradā pūjanam 
SA_MB_siddhalaksmipujapaddhatiHK-336	siṃhāsanāṃ trinayanāṃ śarasārṅgakuntaghaṇṭhāsudhākalaśa sanmadavāraṇākhyaiḥ | yuktāyudhaiḥ	siṃha āsanām trinayanām śara sārṅga kunta ghaṇṭhā sudhā kalaśa sat mada vāraṇa ākhyaiḥ yukta āyudhaiḥ 
SA_MB_siddhalaksmipujapaddhatiHK-337	kanakagaurarucirvibhūtyai bhūyātsamastaphaladānanuśāradāsau ||	kanaka gaura ruciḥ vibhūtyai bhūyāt samasta phala dān anuśāradā asau 
SA_MB_siddhalaksmipujapaddhatiHK-338	grāṃ caṇḍāya namaḥ | gūṃ pracaṇḍāya namaḥ | iti dvārapālau |	grām caṇḍāya namaḥ gūm pracaṇḍāya namaḥ iti dvārapālau 
SA_MB_siddhalaksmipujapaddhatiHK-339	oṃ krauṃ gauṃ kale vauṣaṭ | oṃ śrauṃ mahāgajakale vauṣaṭ | jrauṃ mahāpadmakale vauṣaṭ | oṃ trauṃ	om krauṃ gauṃ kale vauṣaṭ  om śrauṃ mahāgaja kale vauṣaṭ jrauṃ mahāpadma kale vauṣaṭ om trauṃ 
SA_MB_siddhalaksmipujapaddhatiHK-340	sarasvatyairphaṭ | oṃ prauṃ śveta cūḍāyai vauṣaṭ | vrauṃ mahācandrāyai vauṣaṭ | śrauṃ māhendryai	sarasvatyaiḥ phaṭ om prauṃ śveta cūḍāyai vauṣaṭ vrauṃ mahācandrāyai vauṣaṭ śrauṃ māhendryai 
SA_MB_siddhalaksmipujapaddhatiHK-341	vauṣaṭ | hrauṃ kāmayairphaṭ | śrauṃ mahāśaṅkukarṇāyai namaḥ | brauṃ pāṭalāyai namaḥ | lrauṃ	vauṣaṭ                               
SA_MB_siddhalaksmipujapaddhatiHK-342	vindyavāsinyai namaḥ | rmryauṃ mahāpāśāṇḍinyai namaḥ | oṃ rarmryauṃ mahāśailarūpiṇyai namaḥ | pāyai	vindya vāsinyai namaḥ mahā pāśāṇḍinyai namaḥ om mahā śaila rūpiṇyai namaḥ pāyai 
SA_MB_siddhalaksmipujapaddhatiHK-343	ityapi |	iti api 
SA_MB_siddhalaksmipujapaddhatiHK-344	oṃ trauṃ mahāsiddhi surārcitāyai namaḥ | oṃ śrīṃ (hrīṃ) mahāsarvagurvyairphraṭ |	om trauṃ mahā siddhi sura arcitāyai namaḥ om śrīṃ   mahā sarva gurvyaiḥ phraṭ 
SA_MB_siddhalaksmipujapaddhatiHK-345	(āsanesyāyaḥ kumbhīra uktaḥ sa caiva madhunocate | aprasiddhatvāt sphuṭī kriyate || ūṣṭragrīvogajasakando	kumbhīraḥ uktaḥ sa ca eva madhunā ucate aprasiddha tvāt sphuṭī kriyate 
SA_MB_siddhalaksmipujapaddhatiHK-346	hṛdvakarṇo huḍānanaḥ | vyāḍajaṅghopamākāro vajrāyudhanakhopamaḥ | kūrmapṛṣṭho mīnapucchaḥ kumbhīraḥ	huḍa ānanaḥ vyāḍa jaṅghā upama ākāraḥ vajrāyudha nakha upamaḥ kūrma pṛṣṭhaḥ mīna pucchaḥ kumbhīraḥ 
SA_MB_siddhalaksmipujapaddhatiHK-347	parikīrtitaḥ | huḍasya meṣasye vāsanaṃ yasya vajrākhyenā yudhena nakhopamā yasya ||)	parikīrtitaḥ huḍasya meṣa sye vāsanam yasya vajra ākhyena yudhena nakha upamā yasya 
SA_MB_siddhalaksmipujapaddhatiHK-348	iti mātṛcakram |	iti mātṛcakram 
SA_MB_siddhalaksmipujapaddhatiHK-349	oṃ padmāsanāya namaḥ | oṃ śrīṃ kubhīra hūṃ mūrtiḥ āsanam | ādityādi guravaḥ | oṃ śmrīṃ śāradāyai	om padmāsanāya namaḥ om śrīṃ kubhīra hūm mūrtiḥ āsanam āditya ādi guravaḥ om śmrīṃ śāradāyai 
SA_MB_siddhalaksmipujapaddhatiHK-350	sudhā | iti mūlaṃ |	sudhā iti mūlam 
SA_MB_siddhalaksmipujapaddhatiHK-351	smrīṃ hṛ (oṃ) śāśi(oṃ)rasi(oṃ)dāka(oṃ)yaine(oṃ) sudhā astrā | ādityādi graha viśvakarmaprabhāsa	smrīṃ hṛ om sudhā astrā āditya ādi graha viśvakarma prabhāsa 
SA_MB_siddhalaksmipujapaddhatiHK-352	śrīghananandyādyā guravaḥ | hrīṃ śrīṃ klīṃ śāradābhagavatyai hrīṃ śrīṃ saḥ 2 oṃ	śrīghana nandi ādyāḥ guravaḥ   śrīṃ   śāradā bhagavatyai   śrīṃ saḥ om 
SA_MB_siddhalaksmipujapaddhatiHK-353	śāṃśāradābhagavatyai namaḥ |	śāṃśāradā bhagavatyai namaḥ 
SA_MB_siddhalaksmipujapaddhatiHK-354	oṃ hrīṃ śrīṃ khchrīṃ śāradābhagavatyai namaḥ | caturthaḥ |	om hrīṃ śrīṃ khchrīṃ śāradā bhagavatyai namaḥ caturthaḥ 
SA_MB_siddhalaksmipujapaddhatiHK-355	oṃ hrīṃ saḥ namo bhagavatiśāradāyai hrīṃ svāhā | pañcamaḥ ||	om   saḥ namaḥ bhagavatī śāradāyai   svāhā pañcamaḥ 
SA_MB_siddhalaksmipujapaddhatiHK-356	iti śāradāpūjanam ||	iti śāradā pūjanam 
SA_MB_siddhalaksmipujapaddhatiHK-357	atha jyeṣṭheśvarīpūjanam	atha jyeṣṭheśvarī pūjanam 
SA_MB_siddhalaksmipujapaddhatiHK-358	oṃ hrīṃ rcrīṃ hrīṃ śrīṃ haḥ phaṭ | jyeṣṭhe śvaryai namaḥ | oṃ hrīṃ jñrīṃ yogeśvaryai namaḥ | iti	om       śrīṃ haḥ phaṭ jyeṣṭhe śvaryai namaḥ om     yogeśvaryai namaḥ iti 
SA_MB_siddhalaksmipujapaddhatiHK-359	yogeśvarī ||	yogeśvarī 
SA_MB_siddhalaksmipujapaddhatiHK-360	tanmadhye pūjayed devīmekāntīṃ nāmadaivatām | ekavaktrāṃ cāṣṭabhujāṃ trinettrābharaṇairyutām ||	tad madhye pūjayet devīm ekāntīm nāma daivatām eka vaktrām ca aṣṭa bhujām trinettra ābharaṇaiḥ yutām 
SA_MB_siddhalaksmipujapaddhatiHK-361	kapālakhaṭvāṅgadharāṃ pāśāṅkuśavarārpitām | tataḥ padmanibhāṃ devīṃ vālārkakiraṇāruṇām ||	kapāla khaṭvāṅga dharām pāśa aṅkuśa vara arpitām tatas padma nibhām devīm vāla arka kiraṇa aruṇām 
SA_MB_siddhalaksmipujapaddhatiHK-362	japākusumasaṅkāśāṃ dāḍimīkusumopamām | padmarāgapratīkāśāṃ kuṅkumodakasannibhām ||	japā kusuma saṅkāśām dāḍimī kusuma upamām padmarāga pratīkāśām kuṅkuma udaka sannibhām 
SA_MB_siddhalaksmipujapaddhatiHK-363	sphuraranmukuṭamāṇikya kiṅkiṇī jālamaṇḍitām | puṣpasaugandhimadhura kavarī bhāraśobhitām ||	kiṅkiṇī jāla maṇḍitām 
SA_MB_siddhalaksmipujapaddhatiHK-364	kālālikulasaṅkāśa kuṭilālakapallavām | pratyagrāruṇasaṅkāśavadanāmbhoja maṇḍalām ||	kāla ali kula saṅkāśa kuṭila alaka pallavām pratyagra aruṇa saṅkāśa vadana ambhoja maṇḍalām 
SA_MB_siddhalaksmipujapaddhatiHK-365	kiñcidardhendu kuṭilalalāṭamṛdupaṭṭikām | pinākadhanurākāra subhrūvaṃ parameśvarīm ||	kiñcid ardha indu kuṭila lalāṭa mṛdu paṭṭikām pināka dhanuḥ ākāra su bhrūvam parameśvarīm 
SA_MB_siddhalaksmipujapaddhatiHK-366	ānandamuditollola līlāndolita locanām | sphuranmayūkhasaṅghātavitatasvarṇakuṇḍalām ||	ānanda mudita ullola līlā āndolita locanām sphurat mayūkha saṅghāta vitata svarṇa kuṇḍalām 
SA_MB_siddhalaksmipujapaddhatiHK-367	sugaṇḍamaṇḍalābhoga jitendumṛtamaṇḍalām | viśvakarmādi nirmāṇasūtrasvaspaṣṭanāsikām ||	                            
SA_MB_siddhalaksmipujapaddhatiHK-368	tāmravidrumabimbābharaktauṣṭhīmamṛtopamām | smitamādhuryavijitamādhuryarasasāgarām ||	tāmra vidruma bimba ābha rakta oṣṭhīm amṛta upamām smita mādhurya vijita mādhurya rasa sāgarām 
SA_MB_siddhalaksmipujapaddhatiHK-369	dāḍimībījavajrātadanupaṃktivirājitām | anaupamya guṇopeta civukoddeśaśobhitām ||	                
SA_MB_siddhalaksmipujapaddhatiHK-370	kambugrīvāṃ viśālākṣīṃ mṛṇālalalitairbhujaiḥ | maṇikaṅkaṇakeyūrabhārakhinnaiḥ praśobhitām ||	kambu grīvām viśāla akṣīm mṛṇāla lalitaiḥ bhujaiḥ maṇi kaṅkaṇa keyūra bhāra khinnaiḥ praśobhitām 
SA_MB_siddhalaksmipujapaddhatiHK-371	raktotpalasamākāra sukumārakarāmbujām | karāmbuja nakhadyota vitānitanabhastalām ||	rakta utpala sama ākāra sukumāra kara ambujām kara ambuja nakha dyota vitānita nabhastalām 
SA_MB_siddhalaksmipujapaddhatiHK-372	muktāhāralatopeta samunnata payodharām | trivalīvalanāyukta madhyadeśa suśobhitām ||	muktā hāra latā upeta samunnata payodharām  madhyadeśa su śobhitām 
SA_MB_siddhalaksmipujapaddhatiHK-373	lāvaṇya savidāvartākāranābhivibhūṣitām | anargharatnaghaṭitakāñcīyuktanitambinīm ||	lāvaṇya anargha ratna ghaṭita kāñcī yukta nitambinīm 
SA_MB_siddhalaksmipujapaddhatiHK-374	nitambabimbadviradaromarājīvarāṅkuśām | kadalī lalitastambha sukumārorumīśvarīm ||	nitamba bimba dvirada romarājī vara aṅkuśām kadalī lalita stambha sukumāra ūrum īśvarīm 
SA_MB_siddhalaksmipujapaddhatiHK-375	lāvaṇya kadalī tulya jaṅghāyugalamaṇḍitām | gūḍhagulphapadadvandva prapadājitakacchapām ||	lāvaṇya kadalī tulya jaṅghā yugala maṇḍitām gūḍha gulpha pada dvandva prapada ajita kacchapām 
SA_MB_siddhalaksmipujapaddhatiHK-376	namadbrahmaśiroratna nirghṛṣṭacaraṇāmbujām | tanudirghāṅgulībhāsvannakhacandravirājitām ||	namat brahma śiraḥ ratna nirghṛṣṭa caraṇa ambujām tanu dirgha aṅgulī bhāsvat nakha candra virājitām 
SA_MB_siddhalaksmipujapaddhatiHK-377	śītāṃśuśatasaṅkāśakānti santānahāsinīm | lauhityajitasindūra japādāḍimarāgiṇīm ||	śītāṃśu śata saṅkāśa kānti santāna hāsinīm 
SA_MB_siddhalaksmipujapaddhatiHK-378	raktavastraparīdhānāṃ pāśāṅkuśakarodyatām | raktapadmaniviṣṭāṃ tu raktābharaṇamaṇḍitām ||	rakta vastra parīdhānām pāśa aṅkuśa kara udyatām rakta padma niviṣṭām tu rakta ābharaṇa maṇḍitām 
SA_MB_siddhalaksmipujapaddhatiHK-379	caturbhujāṃ trinetrāṃ tu pañcabāṇadhanurdharām | karpūra śakalonmiśratāmbūla pūritānanām ||	catur bhujām tri netrām tu pañcabāṇa dhanuḥ dharām karpūra śakala unmiśra tāmbūla pūrita ānanām 
SA_MB_siddhalaksmipujapaddhatiHK-380	mahāmṛgamadoddāma kuṅkumāruṇavigrahām | sarvaśṛṅgāraveśāḍhyāṃ savālaṅkāra bhūṣitām ||	mahā mṛgamada uddāma kuṅkuma aruṇa vigrahām sarva śṛṅgāra veśa āḍhyām sava alaṅkāra bhūṣitām 
SA_MB_siddhalaksmipujapaddhatiHK-381	jagadā hlāda jananīṃ jagadāhlādakāriṇīm | jagadākarṣaṇakarīṃ jagatkāraṇarūpiṇīm ||	jagat ā hlāda jananīm jagat āhlāda kāriṇīm jagat ākarṣaṇa karīm jagat kāraṇa rūpiṇīm 
SA_MB_siddhalaksmipujapaddhatiHK-382	sarvamantramayīṃ devīṃ sarvasaubhāgyasundarīm | sarvalakṣmī mayīṃ nityāṃ paramānandananditām ||	sarva mantra mayīm devīm sarva saubhāgya sundarīm sarva lakṣmī mayīm nityām parama ānanda nanditām 
SA_MB_siddhalaksmipujapaddhatiHK-383	mahātripura mudrāṃ tu smṛtvā vāhanarūpayā | vidyayā vāhyasubhage namaskāra niyuktayā ||	mahā tripura mudrām tu smṛtvā vāhana rūpayā vidyayā vāhya subhage namaskāra niyuktayā 
SA_MB_siddhalaksmipujapaddhatiHK-384	pūrvoktayā sādhakendro mahātripurasundarīm | cakramadhye tu sañcintya tataḥ pūjanamārabhet ||	pūrva uktayā sādhaka indraḥ mahā tripurasundarīm  cakra madhye tu sañcintya tatas pūjanam ārabhet 
SA_MB_siddhalaksmipujapaddhatiHK-385	sukhavāsā ca manīyavitanacchatra cāmara nṛttagīta japa samādhi homādibhissantuṣṭaṃ bhāvayet | tato	bhāvayet 
SA_MB_siddhalaksmipujapaddhatiHK-386	bāhyayāgārthaṃ mūlavaktrāṅgaiḥ svavāmergha pātrapūjā | (brahmasthānasya pūrveṇa gurūnpūjya vināyakam |	bāhya yāga artham mūla vaktra aṅgaiḥ sva vāma irgha pātra pūjā brahma sthānasya pūrveṇa gurūn pūjya vināyakam 
SA_MB_siddhalaksmipujapaddhatiHK-387	vāyavye pūjayed devi gandhapuṣpairanukramāt || avighanārthaṃ ādau vāyavye gaṇapatiṃ pūjayet | tataḥ	vāyavye pūjayet devi gandha puṣpaiḥ anukramāt avighana artham ādau vāyavye gaṇapatim pūjayet tatas 
SA_MB_siddhalaksmipujapaddhatiHK-388	pūrvasyāṃ diśi gurvādī nityanu kramārthaḥ) amṛtamudrāṃ baddhvā tadambukaṇaiḥ	pūrvasyām diśi guru ādī nitya nu krama arthaḥ amṛta mudrām baddhvā tad ambu kaṇaiḥ 
SA_MB_siddhalaksmipujapaddhatiHK-389	sarvopacārānsaṃproktyātmānaṃ śivasvarūpaṃ gandhapuṣpādibhiḥ sampūjya | śivahastaṃ kuryāt |	sarva upacārān saṃproktya ātmānam śiva svarūpam gandha puṣpa ādibhiḥ sampūjya śiva hastam kuryāt 
SA_MB_siddhalaksmipujapaddhatiHK-390	tataḥ svavāme ūrdhvordhva paṭhi krameṇa gurupūjā kāryā | atraiva śrīgaṇapati pūjanam |	tatas sva vāme ūrdhva ūrdhva paṭhi krameṇa guru pūjā kāryā atra eva śrī gaṇapati pūjanam 
SA_MB_siddhalaksmipujapaddhatiHK-391	oṃ gūṃ gāṃ gaṇapataye namaḥ | oṃ vāṃ vāgīśvaryai namaḥ | iti vāyau | oṃ gurave namaḥ | oṃ paramagurave	om gūṃ gāṃ gaṇapataye namaḥ om vām vāc īśvaryai namaḥ iti vāyau om gurave namaḥ om parama gurave 
SA_MB_siddhalaksmipujapaddhatiHK-392	namaḥ | oṃ parameṣṭigurave namaḥ | oṃ paramācāryāya namaḥ | oṃ ādisiddhebhyo namaḥ | oṃ kṣāṃ	namaḥ om parameṣṭi gurave namaḥ om parama ācāryāya namaḥ om ādi siddhebhyaḥ namaḥ om kṣāṃ 
SA_MB_siddhalaksmipujapaddhatiHK-393	kṣettrapālāya namaḥ | iti vāme gurupaṅktiḥ | atraiva viśeṣa dineṣu kalaśapūjanam | eteṣāmājñāṃ	kṣettrapālāya namaḥ iti vāme guru paṅktiḥ atra eva viśeṣa dineṣu kalaśa pūjanam eteṣām ājñām 
SA_MB_siddhalaksmipujapaddhatiHK-394	gṛhītvā āsanapūjā | oṃ anantāya namaḥ | oṃ ādhāraśaktaye namaḥ | oṃ kandāya namaḥ | oṃ aṅkurāya namaḥ |	gṛhītvā āsana pūjā om anantāya namaḥ om ādhāra śaktaye namaḥ om kandāya namaḥ om aṅkurāya namaḥ 
SA_MB_siddhalaksmipujapaddhatiHK-395	oṃ nālāya namaḥ | oṃ ṛṃ dharmāya namaḥ | oṃ ṝṃ jñānāya namaḥ | ḷṃ vairāgyāya namaḥ | ḹṃ aiśvaryāya	om nālāya namaḥ om ṛṃ dharmāya namaḥ om ṝṃ jñānāya namaḥ ḷṃ vairāgyāya namaḥ ḹṃ aiśvaryāya 
SA_MB_siddhalaksmipujapaddhatiHK-396	namaḥ | ete pādukāḥ sitaraktapītakṛṣṇāḥ	namaḥ ete pādukāḥ sita rakta pīta kṛṣṇāḥ 
SA_MB_siddhalaksmipujapaddhatiHK-397	agnerīśāntaṃ siṃharūpāstrinettrā dhyātavyā pūjanīyāśca |	agneḥ īśa antam siṃha rūpāḥ trinettrā dhyātavyā pūjanīyāḥ ca 
SA_MB_siddhalaksmipujapaddhatiHK-398	oṃ adharmāya namaḥ | oṃ ajñānāya namaḥ | oṃ avairāgyāya namaḥ | oṃ anaiśvaryāya namaḥ | ete	om adharmāya namaḥ om ajñānāya namaḥ om avairāgyāya namaḥ om anaiśvaryāya namaḥ ete 
SA_MB_siddhalaksmipujapaddhatiHK-399	gātrakāssitavarṇāsmiṃhāsanapaṭṭikārūpāḥ |	gātrakāḥ sita varṇāḥ as miṃhāsana paṭṭikā rūpāḥ 
SA_MB_siddhalaksmipujapaddhatiHK-400	pūrvādyuttarāntam | oṃ bhagvedāya namaḥ | oṃ yajurvedāya namaḥ | oṃ sāmavedāya namaḥ | oṃ atharvavedāya	pūrva ādi uttara antam om bhagvedāya namaḥ om yajurvedāya namaḥ om sāmavedāya namaḥ om atharvavedāya 
SA_MB_siddhalaksmipujapaddhatiHK-401	namaḥ | etadveda catuṣṭayaṃ |	namaḥ etat veda catuṣṭayam 
SA_MB_siddhalaksmipujapaddhatiHK-402	gātrapādukābhyāṃ sahasandhānakīlakarūpaṃ vibhāvya vinyasya ca pūjyam |	gātra pādukābhyām saha sandhāna kīlaka rūpam vibhāvya vinyasya ca pūjyam 
SA_MB_siddhalaksmipujapaddhatiHK-403	oṃ kṛtayugāya namaḥ | tretāyugāya namaḥ | dvāparyugāya namaḥ | oṃ kaliyugāya namaḥ | iti īśānādi koṇeṣu	om kṛta yugāya namaḥ tretā yugāya namaḥ dvāparyugāya namaḥ om kali yugāya namaḥ iti īśāna ādi koṇeṣu 
SA_MB_siddhalaksmipujapaddhatiHK-404	| oṃ adhacchādanāya tamo guṇāya namaḥ | oṃ madhyacchādanāya rajoguṇāya namaḥ | oṃ ūrdhvacchādanāya	om adhas chādanāya tamaḥ guṇāya namaḥ om madhya chādanāya rajaḥ guṇāya namaḥ om ūrdhva chādanāya 
SA_MB_siddhalaksmipujapaddhatiHK-405	satvaguṇāya namaḥ | ityambujakarṇikādhastadāsana yogapīṭhaṃ pretāntamiṣṭvā | oṃ sadāśivāya	sattva guṇāya namaḥ iti ambuja karṇikā adhas tad āsana yogapīṭham preta antam iṣṭvā om sadāśivāya 
SA_MB_siddhalaksmipujapaddhatiHK-406	mahāpretāsanāya namaḥ | iti ca brahmaviṣṇurudrordhvavastinaṃ sadāśivaṃ mahāprete vasantamūrdhvastha	mahāpreta āsanāya namaḥ iti ca brahma viṣṇu rudra ūrdhvavastinam sadāśivam mahāprete 
SA_MB_siddhalaksmipujapaddhatiHK-407	śivāvalokinaṃ vibhāvya sampūjya ca | taduparikarṇikordhve sakalabhaṭṭārakaṃ devī yutaṃ niṣkalaṃ ca	śiva avalokinam vibhāvya sampūjya ca tad upari karṇikā ūrdhve sakala bhaṭṭārakam devī yutam niṣkalam ca 
SA_MB_siddhalaksmipujapaddhatiHK-408	sampūjya	sampūjya 
SA_MB_siddhalaksmipujapaddhatiHK-409	oṃ kṣaṃ īśānavaktrāya namaḥ | īśapatre |	om   īśāna vaktrāya namaḥ īśa pattre 
SA_MB_siddhalaksmipujapaddhatiHK-410	oṃ yaṃ tatpuruṣavaktrāya namaḥ | pūrvadale |	om yaṃ tatpuruṣa vaktrāya namaḥ pūrva dale 
SA_MB_siddhalaksmipujapaddhatiHK-411	oṃ raṃ aghoravaktrāya namaḥ | dakṣadale |	om raṃ aghora vaktrāya namaḥ dakṣa dale 
SA_MB_siddhalaksmipujapaddhatiHK-412	oṃ vaṃ vāmadevavaktrāya namaḥ | vāmadale |	om vaṃ vāmadeva vaktrāya namaḥ vāma dale 
SA_MB_siddhalaksmipujapaddhatiHK-413	oṃ laṃ sadyojātavaktrāya namaḥ | paścimadale |	om laṃ sadyojāta vaktrāya namaḥ paścima dale 
SA_MB_siddhalaksmipujapaddhatiHK-414	oṃ aghorebhyassarvātmane hṛdayāya namaḥ | vahnidale |	om aghorebhyaḥ sarvātmane hṛdayāya namaḥ vahni dale 
SA_MB_siddhalaksmipujapaddhatiHK-415	oṃ tha ghorebhyo brahmaśirase svāhā | īśadale |	om tha ghorebhyaḥ brahmaśirase svāhā īśa dale 
SA_MB_siddhalaksmipujapaddhatiHK-416	ghoraghoratarebhyaśca jvālinyai śikhāyai vauṣaṭ | vakṣasi |	ghora ghoratarebhyaḥ ca jvālinyai śikhāyai vauṣaṭ vakṣasi 
SA_MB_siddhalaksmipujapaddhatiHK-417	sarvataśśarvasarvebhyaḥ piṅgalāya kavacāya huṃ vāyo |	sarvatas śarva sarvebhyaḥ piṅgalāya kavacāya hum vāyo 
SA_MB_siddhalaksmipujapaddhatiHK-418	oṃ juṃ saḥ jyotīrūpāya netrāya vaṣaṭ | karṇikāgre madhye |	om juṃ saḥ jyotīrūpāya netrāya vaṣaṭ karṇikā agre madhye 
SA_MB_siddhalaksmipujapaddhatiHK-419	oṃ namaste rudrarūpebhyo durbhedyāya pāśupatāstrāya phaṭ | prāktaścaturṣudikṣu |	om namaḥ te rudra rūpebhyaḥ durbhedyāya pāśupatāstrāya phaṭ prāktas caturṣu dikṣu 
SA_MB_siddhalaksmipujapaddhatiHK-420	oṃ vāmāyai namaḥ | oṃ jyeṣṭhāyai namaḥ | oṃ raudryai namaḥ | oṃ kālyai namaḥ | oṃ kalavikariṇyai namaḥ | oṃ	om vāmāyai namaḥ  om jyeṣṭhāyai namaḥ om raudryai namaḥ om kālyai namaḥ om kalavikariṇyai namaḥ om 
SA_MB_siddhalaksmipujapaddhatiHK-421	balavikariṇyai namaḥ | oṃ balapramathinyai namaḥ | oṃ sarvabhutadaminyai namaḥ |	namaḥ om balapramathinyai namaḥ om sarva bhuta daminyai namaḥ 
SA_MB_siddhalaksmipujapaddhatiHK-422	etad devatāṣṭakaṃ daleṣu pūjyam |	etat devatā aṣṭakam daleṣu pūjyam 
SA_MB_siddhalaksmipujapaddhatiHK-423	gokṣīradhavalāṃ śaktiṃ karṇikāyāṃ manonmanīm |	go kṣīra dhavalām śaktim karṇikāyām manonmanīm 
SA_MB_siddhalaksmipujapaddhatiHK-424	oṃ manonmanyai namaḥ |	om manonmanyai namaḥ 
SA_MB_siddhalaksmipujapaddhatiHK-425	iti karṇikāpṛṣṭhe |	iti karṇikā pṛṣṭhe 
SA_MB_siddhalaksmipujapaddhatiHK-426	oṃ sūryamaṇḍalāya namaḥ | patreṣu |	om sūrya maṇḍalāya namaḥ pattreṣu 
SA_MB_siddhalaksmipujapaddhatiHK-427	oṃ somamaṇḍalāya namaḥ | kesareṣu |	om soma maṇḍalāya namaḥ kesareṣu 
SA_MB_siddhalaksmipujapaddhatiHK-428	oṃ vahnimaṇḍalāya namaḥ | karṇikāyām |	om vahni maṇḍalāya namaḥ karṇikāyām 
SA_MB_siddhalaksmipujapaddhatiHK-429	eṣveva sthāneṣu |	eṣu eva sthāneṣu 
SA_MB_siddhalaksmipujapaddhatiHK-430	oṃ brahmaṇe namaḥ | oṃ viṣṇave namaḥ |	om brahmaṇe namaḥ om viṣṇave namaḥ 
SA_MB_siddhalaksmipujapaddhatiHK-431	oṃ rudrāya namaḥ | oṃ mahāpretāsanāya namaḥ | ityāsana pakṣaḥ |	om rudrāya namaḥ om mahāpreta āsanāya namaḥ iti āsana pakṣaḥ 
SA_MB_siddhalaksmipujapaddhatiHK-432	taduparimūrtisaṅkalpya ||	tad upari mūrti saṅkalpya 
SA_MB_siddhalaksmipujapaddhatiHK-433	atraiva viṣṇorāsanādi | ṣaḍakṣareṇa devaṃ sampūjya snānārthamājñāṃ prārthayet |	atra eva viṣṇoḥ āsana ādi ṣaḍakṣareṇa devam sampūjya snāna artham ājñām prārthayet 
SA_MB_siddhalaksmipujapaddhatiHK-434	oṃ gaṇanāthāmbike svāmi pāduke māṃ jagadgurum | yajantamanujānī hi yathā sampanna kārakam ||	om gaṇanātha ambike svāmi pāduke mām jagadgurum yajantam anujānī hi yathā 
SA_MB_siddhalaksmipujapaddhatiHK-435	bhagavaṃstyāmanujñāya vibhu mūrtau vyavasthitām | pūjāmapanayāmyasya na vāṃ tu vitarāmya'ham ||	bhagavan tyām anujñāya vibhu mūrtau vyavasthitām pūjām apanayāmi asya na vām tu vitarāmi aham 
SA_MB_siddhalaksmipujapaddhatiHK-436	ityājñāṃ gṛhītvā |	iti ājñām gṛhītvā 
SA_MB_siddhalaksmipujapaddhatiHK-437	bhadrapīṭhe kalpitaivaṃ vidhāsane devaṃ saṃsthāpya | astramantragantukatrayeṇa devaṃ saṃsnāpya pīṭhamekena	bhadrapīṭhe kalpitā evam vidhā āsane devam saṃsthāpya astra mantra gantuka trayeṇa devam saṃsnāpya pīṭham ekena 
SA_MB_siddhalaksmipujapaddhatiHK-438	astrārgha pātraṃ kṣiptvā | pīṭhe āsanapakṣaṃ nyasya | añjalo puṣpaṃ gṛhītvā |	astra argha pātram kṣiptvā pīṭhe āsana pakṣam nyasya añjalo puṣpam gṛhītvā 
SA_MB_siddhalaksmipujapaddhatiHK-439	oṃ bhagavannāgaccha 2 namaḥ || āvāhanamudrayā |	om bhagavan āgaccha namaḥ āvāhana mudrayā 
SA_MB_siddhalaksmipujapaddhatiHK-440	āvāhya | bhagavansantiṣṭha 2 svāhā | sthāpanyāsthāpayet |	āvāhya bhagavan santiṣṭha svāhā sthāpanyā āsthāpayet 
SA_MB_siddhalaksmipujapaddhatiHK-441	bhagavansanniruddho bhava 2 | hūṃ phaṭ | nirodhinyā nirodhayet |	bhagavan sanniruddhaḥ bhava   phaṭ nirodhinyā nirodhayet 
SA_MB_siddhalaksmipujapaddhatiHK-442	oṃ bhagavansannihito bhava bhava vaṣaṭ | iti sannidhimudrayā sannidhāpya | oṃ hūṃ bhagavannava guṇṭhanaṃ karomi	om bhagavan sannihitaḥ bhava bhava vaṣaṭ iti sannidhi mudrayā sannidhāpya om   bhagavan nava guṇṭhanam karomi 
SA_MB_siddhalaksmipujapaddhatiHK-443	namaḥ | ityavaguṇṭhya |	namaḥ iti avaguṇṭhya 
SA_MB_siddhalaksmipujapaddhatiHK-444	oṃ bhagavannamṛtī karomi namaḥ |	om bhagavan amṛtī karomi namaḥ 
SA_MB_siddhalaksmipujapaddhatiHK-445	ityamṛtamudrayā mṛtīkaraṇam |	iti amṛta mudrayā mṛtīkaraṇam 
SA_MB_siddhalaksmipujapaddhatiHK-446	tato mantrārgha pātrāt |	tatas mantra argha pātrāt 
SA_MB_siddhalaksmipujapaddhatiHK-447	oṃ bhagavan pādyaṃ gṛhāṇa namaḥ | oṃ bhagavannācamanīyaṃ gṛhāṇa svadhā | oṃ bhagavannarghaṃ gṛhāṇa	om bhagavan pādyam gṛhāṇa namaḥ om bhagavan ācamanīyam gṛhāṇa svadhā om bhagavan argham gṛhāṇa 
SA_MB_siddhalaksmipujapaddhatiHK-448	svadhā | oṃ bhagavan puṣpaṃ gṛhāṇa vauṣaṭ | oṃ bhagavan dhūpaṃ gṛhāṇa namaḥ | oṃ bhagavan dīpaṃ	svadhā om bhagavan puṣpam gṛhāṇa vauṣaṭ om bhagavan dhūpam gṛhāṇa namaḥ om bhagavan dīpam 
SA_MB_siddhalaksmipujapaddhatiHK-449	gṛhāṇa namaḥ |	gṛhāṇa namaḥ 
SA_MB_siddhalaksmipujapaddhatiHK-450	itthaṃ viṣṇorapi tato mūlena devaṃ sampūjya |	ittham viṣṇoḥ api tatas mūlena devam sampūjya 
SA_MB_siddhalaksmipujapaddhatiHK-451	(snānaṃ palayataṃ jñeyamabhyaṅgaṃ pañcaviṃśatiḥ | palānāṃ tu sahasreṇa mahāsnānaṃ ra?kīrtitam ||)	snānam jñeyam abhyaṅgam pañcaviṃśatiḥ palānām tu sahasreṇa mahāsnānam 
SA_MB_siddhalaksmipujapaddhatiHK-452	aṣṭabhiḥ gaḍukaiḥ snapayet | viśeṣadineṣu mahāsnānāni dadyāt | panīyāntaritaiḥ payodadhi	aṣṭabhiḥ gaḍukaiḥ snapayet viśeṣa dineṣu mahāsnānāni dadyāt panīya antaritaiḥ payaḥ dadhi 
SA_MB_siddhalaksmipujapaddhatiHK-453	ghṛtakṣaudrekṣabhiḥsauṣadhī vrīhyadbhiḥ kusumodakaiḥ phalajalaiḥ siddhārthalājodakaiḥ | gandhādbhiḥ	ghṛta kṣaudra ikṣabhiḥ sa oṣadhī vrīhi adbhiḥ kusuma udakaiḥ phala jalaiḥ siddhārtha lāja udakaiḥ gandha adbhiḥ 
SA_MB_siddhalaksmipujapaddhatiHK-454	śubhahemaratnakalasaiḥ slilai riktaṃ sadāhyuttamaiḥ dadyāt pañcadaśāmbunā saha mahāsnānāniśambhoḥ kramāt	śubha hema ratna kalasaiḥ riktam sadā ahi uttamaiḥ dadyāt pañcadaśa ambunā saha mahā snāna ani śambhoḥ kramāt 
SA_MB_siddhalaksmipujapaddhatiHK-455	tato dīkṣitān pitṝnuddiśya tilodakaṃ śivagotreṇa dadyāt |	tatas dīkṣitān pitṝn uddiśya tila udakam śiva gotreṇa dadyāt 
SA_MB_siddhalaksmipujapaddhatiHK-456	adīkṣitānāṃ tu svagotreṇa pīṭhādhastilodakaṃ dadyāt | tato mantragaḍukaṃ mūlāṅgaissaṃpūjya	a dīkṣitānām tu sva gotreṇa pīṭha adhas tila udakam dadyāt tatas mantra gaḍukam mūla aṅgaiḥ saṃpūjya 
SA_MB_siddhalaksmipujapaddhatiHK-457	mṛtamudrāṃ baddhvāṣṭadhā mūlaṃ japtvā mukhyārgha pātrajalakaṇairmantragaḍukamīśvaraṃ ca saṃprokṣya	mṛta mudrām baddhvā aṣṭadhā mūlam japtvā mukhya argha pātra jala kaṇaiḥ mantra gaḍukam īśvaram ca saṃprokṣya 
SA_MB_siddhalaksmipujapaddhatiHK-458	hastadvayena gṛhītvā |	hasta dvayena gṛhītvā 
SA_MB_siddhalaksmipujapaddhatiHK-459	oṃ juṃ amṛte amṛte amṛteśāya pratimāṃ praviśya ghaṭikāṃ gṛhṇa 2 sānnidhyaṃ kuru 2 pañcabrahmamūrtaye	om juṃ amṛte amṛte amṛta īśāya pratimām praviśya ghaṭikām gṛhṇa sānnidhyam kuru pañca brahma mūrtaye 
SA_MB_siddhalaksmipujapaddhatiHK-460	vauṣaṭ | ityanayā vidyayā mṛtapūrṇaṃ vibhāvya | amṛte parāmṛte pratimāṃ praviśya ghaṭikāṃ	vauṣaṭ iti anayā vidyayā mṛta pūrṇam vibhāvya amṛte para amṛte pratimām praviśya ghaṭikām 
SA_MB_siddhalaksmipujapaddhatiHK-461	gṛhṇavauṣaṭ | svāheti mantreṇāmṛtapūrṇaṃ vibhāvya bhagavantamabhiṣiñcet |	gṛhṇava oṣaṭ svāhā iti mantreṇa amṛta pūrṇam vibhāvya bhagavantam abhiṣiñcet 
SA_MB_siddhalaksmipujapaddhatiHK-462	bhagasya hṛdayaṃ liṅgaṃ liṅgasya hṛdayaṃ bhagaḥ | tasmai te bhagaliṅgāya hyumārudrāya vai namaḥ ||	bhagasya hṛdayam liṅgam liṅgasya hṛdayam bhagaḥ tasmai te bhaga liṅgāya hi umā rudrāya vai namaḥ 
SA_MB_siddhalaksmipujapaddhatiHK-463	ityaṅguṣṭhamuṣṭikābhyāṃ pīṭhaliṅge saṃspṛśya netrasparśaḥ kāyaḥ | tathāṅguṣṭhānāmikābhyāṃ	iti aṅguṣṭha muṣṭikābhyām pīṭha liṅge saṃspṛśya netra sparśaḥ kāyaḥ tathā aṅguṣṭha anāmikābhyām 
SA_MB_siddhalaksmipujapaddhatiHK-464	sāligrāmaṃ spṛṣṭvā netrasparśaḥ kāyaḥ | tato'streṇa nirbhatsanaṃ kuryāt |	sāligrāmam spṛṣṭvā netra sparśaḥ kāyaḥ tatas ustreṇa nirbhatsanam kuryāt 
SA_MB_siddhalaksmipujapaddhatiHK-465	gṛhṇantu śivasaṃbhaktāḥ bhūtāḥ prāsādajāṃ valim | ye ye bhūtāśca ye bhūtāsteṣāmanucarāśca ye ||	gṛhṇantu śiva saṃbhaktāḥ bhūtāḥ prāsāda jām valim ye ye bhūtāḥ ca ye bhūtāḥ teṣām anucarāḥ ca ye 
SA_MB_siddhalaksmipujapaddhatiHK-466	iti |	iti 
SA_MB_siddhalaksmipujapaddhatiHK-467	tato vedyantaḥ prāgvadāsanapakṣaṃ sampūjayet |	tatas vedi antar prāgvat āsana pakṣam sampūjayet 
SA_MB_siddhalaksmipujapaddhatiHK-468	oṃ ādhāraśaktaye namaḥ | oṃ anantāya namaḥ | pṛthivyai namaḥ | surārṇavāya namaḥ | oṃ kandāya namaḥ | oṃ	om ādhāra śaktaye namaḥ om anantāya namaḥ pṛthivyai namaḥ surārṇavāya namaḥ om kandāya namaḥ om 
SA_MB_siddhalaksmipujapaddhatiHK-469	nālāya namaḥ | tatkaṇṭharūpebhyo vidyāvidyeśvarebhyo namaḥ | oṃ vidyāsiṃhāsanāya namaḥ | oṃ dharmāya	nālāya namaḥ tad kaṇṭha rūpebhyaḥ vidyā vidyā īśvarebhyaḥ namaḥ om vidyā siṃhāsanāya namaḥ om dharmāya 
SA_MB_siddhalaksmipujapaddhatiHK-470	namaḥ | jñānāya namaḥ | vairāgyāya namaḥ | aiśvaryāya namaḥ | aiśānyādi dikṣu | adharmāya namaḥ |	namaḥ jñānāya namaḥ vairāgyāya namaḥ aiśvaryāya namaḥ aiśānī ādi dikṣu adharmāya namaḥ 
SA_MB_siddhalaksmipujapaddhatiHK-471	ajñānāya namaḥ | avairāgyāya namaḥ | anaiśvaryāya namaḥ | prāgādi dikṣu | oṃ ṛgvedāya namaḥ |	ajñānāya namaḥ avairāgyāya namaḥ anaiśvaryāya namaḥ prāc ādi dikṣu om ṛgvedāya namaḥ 
SA_MB_siddhalaksmipujapaddhatiHK-472	yajurvedāya namaḥ | sāmavedāya namaḥ | atharvavedāya namaḥ | oṃ kṛtayugāya namaḥ | tretāyugāya namaḥ |	yajurvedāya namaḥ sāmavedāya namaḥ atharvavedāya namaḥ om kṛta yugāya namaḥ tretā yugāya namaḥ 
SA_MB_siddhalaksmipujapaddhatiHK-473	dvāparyugāya namaḥ | kaliyugāya namaḥ | vidikṣu | oṃ adhacchādanāya namaḥ | madhyacchādanāya namaḥ |	dvāparī yugāya namaḥ kali yugāya namaḥ vidikṣu om adha chādanāya namaḥ madhya chādanāya namaḥ 
SA_MB_siddhalaksmipujapaddhatiHK-474	ūrdhvacchādanāya namaḥ | padmāya namaḥ | dalebhyo namaḥ | kesarebhyo namaḥ | oṃ karṇikāyai namaḥ | oṃ	ūrdhva chādanāya namaḥ padmāya namaḥ dalebhyaḥ namaḥ kesarebhyaḥ namaḥ om karṇikāyai namaḥ om 
SA_MB_siddhalaksmipujapaddhatiHK-475	sūryamaṇḍalāya namaḥ |	sūrya maṇḍalāya namaḥ 
SA_MB_siddhalaksmipujapaddhatiHK-476	somamaṇḍalāya namaḥ | vahnimaṇḍalāya namaḥ | sūryamaṇḍalādhipataye brahmaṇe namaḥ |	soma maṇḍalāya namaḥ vahni maṇḍalāya namaḥ sūrya maṇḍala adhipataye brahmaṇe namaḥ 
SA_MB_siddhalaksmipujapaddhatiHK-477	somamaṇḍalādhipataye viṣṇave | vahnimaṇḍalādhipataye rudrāya namaḥ | oṃ satvāya namaḥ | rajase namaḥ |	soma maṇḍala adhipataye viṣṇave vahni maṇḍala adhipataye rudrāya namaḥ om sattvāya namaḥ rajase namaḥ 
SA_MB_siddhalaksmipujapaddhatiHK-478	tamase namaḥ | oṃ vāmāyai namaḥ | jyeṣṭhāyai namaḥ | raudryai kālyai kalavikariṇyai balavikariṇyai	tamase namaḥ om vāmāyai namaḥ jyeṣṭhāyai namaḥ raudryai kālyai kala vikariṇyai bala vikariṇyai 
SA_MB_siddhalaksmipujapaddhatiHK-479	balapramathinyai sarvabhūtadamanyai manonmanyai namaḥ |	balapramathinyai sarva bhūta damanyai manonmanyai namaḥ 
SA_MB_siddhalaksmipujapaddhatiHK-480	iti puṣkaranavake |	iti puṣkaranavake 
SA_MB_siddhalaksmipujapaddhatiHK-481	tataḥ mahāpretāsanāya namaḥ | oṃ hāṃ mūrtaye namaḥ |	tatas mahāpreta āsanāya namaḥ om hāṃ mūrtaye namaḥ 
SA_MB_siddhalaksmipujapaddhatiHK-482	tadupari devaṃ saṃsthāpya | viṣṇorapi pūrvavadāsanaṃ dadyāt ||	tad upari devam saṃsthāpya viṣṇoḥ api pūrvavat āsanam dadyāt 
SA_MB_siddhalaksmipujapaddhatiHK-483	oṃ hūṃ aghorebhya iti mūlam |	om hūm aghorebhyaḥ iti mūlam 
SA_MB_siddhalaksmipujapaddhatiHK-484	oṃ kṣaṃ īśānavaktrāya namaḥ | īśakoṇe | oṃ yaṃ tatpuruṣavaktrāya namaḥ | pūrve | oṃ raṃ aghoravaktrāya	om   īśāna vaktrāya namaḥ īśa koṇe om yaṃ tatpuruṣa vaktrāya namaḥ pūrve om raṃ aghora vaktrāya 
SA_MB_siddhalaksmipujapaddhatiHK-485	namaḥ | dakṣiṇe | oṃ vaṃ vāmadevavaktrāya namaḥ | uttare | oṃ laṃ sadyojātavaktrāya namaḥ | paścime | oṃ	namaḥ dakṣiṇe om vaṃ vāmadeva vaktrāya namaḥ uttare om laṃ sadyojāta vaktrāya namaḥ paścime om 
SA_MB_siddhalaksmipujapaddhatiHK-486	aghorebhyaḥ sarvātmane hṛdayāya namaḥ | āgneye | oṃ tha ghorebhyo brahmaśirase svāhā | aiśe | oṃ	aghorebhyaḥ sarvātmane hṛdayāya namaḥ āgneye om tha ghorebhyaḥ brahmaśirase svāhā aiśe om 
SA_MB_siddhalaksmipujapaddhatiHK-487	ghoraghoratarebhyaśca jvālinyai śikhāyai vauṣaṭ | nair-ṛte | oṃ sarvataśca vasavebhyaḥ piṅgalāya kavacāya	ghora ghoratarebhyaḥ ca jvālinyai śikhāyai vauṣaṭ nairṛte  om sarvatas ca vasavebhyaḥ piṅgalāya kavacāya 
SA_MB_siddhalaksmipujapaddhatiHK-488	hum | vāyau | oṃ juṃ saḥ jyotīrūpāya netrāyavaṣaṭ | karṇikopari | oṃ namaste rudrarūpebhyo durbhedyāya	hum vāyau om juṃ saḥ jyotīrūpāya netrāya vaṣaṭ karṇikā upari om namaḥ te rudra rūpebhyaḥ durbhedyāya 
SA_MB_siddhalaksmipujapaddhatiHK-489	pāśupatāstrāya phaṭ | sarvadikṣu | oṃ hūṃ hrīṃ aghoreśvari hūṃ phaṭ | aghoreśvaryai namaḥ |	pāśupatāstrāya phaṭ sarva dikṣu om     aghora īśvari   phaṭ aghora īśvaryai namaḥ 
SA_MB_siddhalaksmipujapaddhatiHK-490	devī mūlam |	devī mūlam 
SA_MB_siddhalaksmipujapaddhatiHK-491	vaktrāṇi śrīdevavat |	vaktrāṇi śrīdeva vat 
SA_MB_siddhalaksmipujapaddhatiHK-492	oṃ hāmityādi dīrghairaṅgāni | oṃ hūṃ niṣkalasvacchandabhairavāya namaḥ | vaktrāṅgāni śrīdevīvat | tataḥ	om hām ityādi dīrghaiḥ aṅgāni om   niṣkala svacchanda bhairavāya namaḥ vaktra aṅgāni śrī devī vat tatas 
SA_MB_siddhalaksmipujapaddhatiHK-493	āyudharūpāḥ mudrāḥ pūjayet | oṃ khaḍgāya namaḥ (da) | oṃ kheṭāya namaḥ (vā) | pāśāya (vā) aṅkuśāya	āyudha rūpāḥ mudrāḥ pūjayet om khaḍgāya namaḥ om kheṭāya namaḥ vā pāśāya vā aṅkuśāya 
SA_MB_siddhalaksmipujapaddhatiHK-494	(d) śarāya (d) pinākāya (vā) varāya (vā) abhayāya (da) muṇḍāya (da) khaṭvāṅgāya (vā) vīṇāyai (vā)	d śarāya d pinākāya vā varāya vā abhayāya da muṇḍāya da khaṭvāṅgāya vā vīṇāyai vā 
SA_MB_siddhalaksmipujapaddhatiHK-495	ḍamarave (da) ghaṇṭāyai (vā) triśūlāya (da) vajrāya (da) daṇḍāya (vā) paraśave (da) mudgarāya (vā) oṃ	ḍamarave da ghaṇṭāyai vā triśūlāya da vajrāya da daṇḍāya vā paraśave da mudgarāya vā om 
SA_MB_siddhalaksmipujapaddhatiHK-496	kṣmryū& kapāleśabhairavāya namaḥ | pūrve |	kṣmryū kapāla īśa bhairavāya namaḥ pūrve 
SA_MB_siddhalaksmipujapaddhatiHK-497	oṃ hrū& śikhi vāhana bhairavāya namaḥ | āgneye |	om hrū śikhi vāhana bhairavāya namaḥ āgneye 
SA_MB_siddhalaksmipujapaddhatiHK-498	oṃ kṣū& krodharājabhairavāya namaḥ | dakṣe |	om   krodharāja bhairavāya namaḥ dakṣe 
SA_MB_siddhalaksmipujapaddhatiHK-499	oṃ radhrū-au& vikarālabhairavāya namaḥ | nair-ṛte |	om radhrūau vikarāla bhairavāya namaḥ nairṛte 
SA_MB_siddhalaksmipujapaddhatiHK-500	oṃ hvū-au& manmathabhairavāya namaḥ | paścime |	om   manmathabhairavāya namaḥ paścime 
SA_MB_siddhalaksmipujapaddhatiHK-501	oṃ hryū& meghanādabhairavāya namaḥ | vāyau |	om   meghanāda bhairavāya namaḥ vāyau 
SA_MB_siddhalaksmipujapaddhatiHK-502	oṃ hu& somarājabhairavāya namaḥ | uttare |	om hu somarāja bhairavāya namaḥ uttare 
SA_MB_siddhalaksmipujapaddhatiHK-503	oṃ hrkṣmlvyū& vidyārājabhairavāya namaḥ | īśāne |	om              
SA_MB_siddhalaksmipujapaddhatiHK-504	tataḥ saptāvaraṇapūjā | tatrādau vidyeśvarāḥ |	tatas sapta āvaraṇa pūjā tatra ādau vidyeśvarāḥ 
SA_MB_siddhalaksmipujapaddhatiHK-505	oṃ hrīṃ anantāya namaḥ | oṃ jhrūṃ sūkṣmāya namaḥ | oṃ mūṃ śivottamāya namaḥ | oṃ krūṃ ekanetrāya	om hrīṃ anantāya namaḥ om jhrūṃ sūkṣmāya namaḥ om mūm śiva uttamāya namaḥ om krūṃ ekanetrāya 
SA_MB_siddhalaksmipujapaddhatiHK-506	namaḥ | oṃ kṣyāṃ ekarudrāya namaḥ | oṃ ylūṃ trimūrtaye namaḥ | oṃ hjūṃ śrīkaṇṭhāya namaḥ | oṃ śīṃ	namaḥ om kṣyāṃ ekarudrāya namaḥ  om ylūṃ trimūrtaye namaḥ om hjūm śrīkaṇṭhāya namaḥ om śīṃ 
SA_MB_siddhalaksmipujapaddhatiHK-507	śikhaṇḍine namaḥ |	śikhaṇḍine namaḥ 
SA_MB_siddhalaksmipujapaddhatiHK-508	iti vidyeśvarāṣṭakaṃ pūrvādidikṣu |	iti vidyeśvara aṣṭakam pūrva ādi dikṣu 
SA_MB_siddhalaksmipujapaddhatiHK-509	oṃ rāṃ rīṃ nlūṃ nandine namaḥ | oṃ māṃ mīṃ mlūṃ hlauṃ mahākālāya namaḥ | oṃ hsrāṃ bhṛṅgirudrāya	om rāṃ rīṃ nlūṃ nandine namaḥ om mām mīṃ mlūṃ hlauṃ mahākālāya namaḥ om hsrāṃ bhṛṅgirudrāya 
SA_MB_siddhalaksmipujapaddhatiHK-510	namaḥ | oṃ gūṃ gāṃ gaṇapataye namaḥ | oṃ vrāṃ vṛṣabhāya namaḥ | oṃ hsrauṃ kuṃkumārāya namaḥ | oṃ	namaḥ om gūṃ gām gaṇapataye namaḥ om vrām vṛṣabhāya namaḥ om   kuṃkumārāya namaḥ om 
SA_MB_siddhalaksmipujapaddhatiHK-511	hrīṃ saḥ ambikāyai namaḥ | oṃ hsūṃ caṇḍeśvarāya namaḥ |	hrīṃ saḥ ambikāyai namaḥ om   caṇḍeśvarāya namaḥ 
SA_MB_siddhalaksmipujapaddhatiHK-512	iti gaṇeśāṣṭakaṃ prāgādidikṣu |	iti gaṇeśa aṣṭakam prāc ādi dikṣu 
SA_MB_siddhalaksmipujapaddhatiHK-513	evaṃ lokeśāḥ |	evam loka īśāḥ 
SA_MB_siddhalaksmipujapaddhatiHK-514	oṃ lūṃ indrāya vajrahastāya namaḥ | oṃ rūṃ agnaye śaktihastāya namaḥ | oṃ ṅūṃ yamāyadaṇḍahastāya namaḥ	om lūṃ indrāya vajra hastāya namaḥ om rūṃ agnaye śakti hastāya namaḥ om ṅūṃ yamāya daṇḍa hastāya namaḥ 
SA_MB_siddhalaksmipujapaddhatiHK-515	| oṃ kṣūṃ nir-ṛtaye khaḍgahastāya namaḥ | oṃ būṃ varuṇāya pāśahastāya namaḥ | oṃ dhūṃ vāyave	om kṣūṃ nirṛtaye khaḍga hastāya namaḥ om būm varuṇāya pāśa hastāya namaḥ om dhūm vāyave 
SA_MB_siddhalaksmipujapaddhatiHK-516	dhvajahastāya namaḥ | oṃ kuṃkuvīrāya gadāhastāya namaḥ | oṃ mūṃ īśānāya triśūlahastāya namaḥ | oṃ āṃ	dhvaja hastāya namaḥ om kuṃkuvīrāya gadā hastāya namaḥ om mūṃ īśānāya triśūla hastāya namaḥ om āṃ 
SA_MB_siddhalaksmipujapaddhatiHK-517	brāṃ braṃ brahmaṇe padmahastāya namaḥ | oṃ hlāṃ anantāya halahastāya namaḥ |	brāṃ braṃ brahmaṇe padma hastāya namaḥ om hlāṃ anantāya halahastāya namaḥ 
SA_MB_siddhalaksmipujapaddhatiHK-518	iti lokeśāḥ |	iti lokeśāḥ 
SA_MB_siddhalaksmipujapaddhatiHK-519	oṃ jmryūṃ jayāyai namaḥ | oṃ ḍmryūṃ vijayāyai namaḥ | oṃ gaṃ subhagāyai namaḥ | oṃ paṃ durbhagāyai namaḥ	om jmryūṃ jayāyai namaḥ  om ḍmryūṃ vijayāyai namaḥ om gaṃ subhagāyai namaḥ om paṃ durbhagāyai namaḥ 
SA_MB_siddhalaksmipujapaddhatiHK-520	| oṃ msryūṃ japanyai namaḥ | oṃ paṃrthahinyai namaḥ | oṃ hsryūṃ aparājitāyai namaḥ | oṃ rāṃ karālyai namaḥ	om msryūṃ japanyai namaḥ  om paṃrthahinyai namaḥ om hsryūṃ aparājitāyai namaḥ om rāṃ karālyai namaḥ 
SA_MB_siddhalaksmipujapaddhatiHK-521	| iti mātarāḥ	iti mātarāḥ 
SA_MB_siddhalaksmipujapaddhatiHK-522	atha mūlena sūryāya namaḥ |	atha mūlena sūryāya namaḥ 
SA_MB_siddhalaksmipujapaddhatiHK-523	oṃ srūṃ candramase namaḥ | oṃ rhrūṃ aṅgārakāya namaḥ | oṃ shryūṃ budhāya namaḥ | oṃrsūṃ jīvāya namaḥ |	om srūṃ candramase namaḥ om rhrūṃ aṅgārakāya namaḥ om shryūṃ budhāya namaḥ om rsūṃ jīvāya namaḥ 
SA_MB_siddhalaksmipujapaddhatiHK-524	oṃ hrīṃ bhārgavāya namaḥ | oṃ rkṣmryūṃ sanaiścarāya namaḥ | oṃ dhūṃ rāhave namaḥ | oṃ hrīṃ ketave	om hrīṃ bhārgavāya namaḥ om rkṣ mryūṃ sanaiścarāya namaḥ om dhūm rāhave namaḥ om hrīṃ ketave 
SA_MB_siddhalaksmipujapaddhatiHK-525	namaḥ | iti grahāḥ |	namaḥ iti grahāḥ 
SA_MB_siddhalaksmipujapaddhatiHK-526	oṃ anantanāgarājāya namaḥ | oṃ vāsukināgarājāya namaḥ | evaṃ padma | mahāpadma | takṣaka | kārkoṭaka |	om ananta nāga rājāya namaḥ om vāsuki nāga rājāya namaḥ evam padma mahāpadma takṣaka kārkoṭaka 
SA_MB_siddhalaksmipujapaddhatiHK-527	śaṅkhapāla | kulikanāga | iti nāgarājāṣṭakam |	śaṅkhapāla kulika nāga iti nāga rāja aṣṭakam 
SA_MB_siddhalaksmipujapaddhatiHK-528	oṃ vajrāya phaṭ | oṃ śaktaye phaṭ | daṇḍāya | khaḍgāya | pāśāya | dhvajāya | gadāyai | triśūlāya |	om vajrāya phaṭ om śaktaye phaṭ daṇḍāya khaḍgāya pāśāya dhvajāya gadāyai triśūlāya 
SA_MB_siddhalaksmipujapaddhatiHK-529	padmāya | halāpa phaṭ | iti vajradyāvaraṇam |	padmāya halāpa phaṭ iti 
SA_MB_siddhalaksmipujapaddhatiHK-530	iti saptāvaraṇapūjā ||	iti sapta āvaraṇa pūjā 
SA_MB_siddhalaksmipujapaddhatiHK-531	tato nāḍīsandhānam ||	tatas nāḍī sandhānam 
SA_MB_siddhalaksmipujapaddhatiHK-532	ātmanaḥ karmasthānādutthitāṃ śaktiṃ dhyātvā | dvādaśāntaṃ yāvat prasṛtāṃ | tatsthānādamṛtaṃ	ātmanaḥ karmasthānāt utthitām śaktim dhyātvā dvādaśāntam yāvat prasṛtām tad sthānāt amṛtam 
SA_MB_siddhalaksmipujapaddhatiHK-533	gṛhītvā | nāsikya dvādaśāntena vāmanāsāpuṭena nirgatāṃ | devasya dakṣiṇanāsāpuṭena praviṣṭāṃ |	gṛhītvā nāsikya dvādaśāntena vāma nāsā puṭena nirgatām devasya dakṣiṇa nāsā puṭena praviṣṭām 
SA_MB_siddhalaksmipujapaddhatiHK-534	tasya karmasthānaprāptāṃ | tasmādutthitāṃ | taddvādaśāntaṃ prāptāṃ | tasmādamṛtaṃ gṛhitvā	tasya karma sthāna prāptām tasmāt utthitām tad dvādaśāntam prāptām tasmāt amṛtam gṛhitvā 
SA_MB_siddhalaksmipujapaddhatiHK-535	tadvāmanāsāpuṭena nirgatāṃ viṣṭāṃ mitthaṃ sarvāvaraṇeṣvekāmevanāḍīṃ prasṛtāṃ	tad vāma nāsā puṭena nirgatām viṣṭām mittham sarva āvaraṇeṣu ekām eva nāḍīm prasṛtām 
SA_MB_siddhalaksmipujapaddhatiHK-536	punardakṣiṇanāsāpuṭena svātmanaḥ pravi bhāvayet | iti nāḍīsandhānam |	punar dakṣiṇa nāsā puṭena sva ātmanaḥ pravi bhāvayet iti nāḍī sandhānam 
SA_MB_siddhalaksmipujapaddhatiHK-537	tataḥ paramīkaraṇam | ātmanaḥ karmasthānādutthitāṃ śaktiṃ dhyātvā | dvādaśāntena nirgatāṃ |	tatas paramīkaraṇam ātmanaḥ karmasthānāt utthitām śaktim dhyātvā dvādaśāntena nirgatām 
SA_MB_siddhalaksmipujapaddhatiHK-538	yugapatsavāvaraṇānāṃ | dvādaśānte praviṣṭāmavicchinna pravāhena sthitāṃ svātmani līnāṃ bhāvayet |	yugapad sava āvaraṇānām dvādaśānte praviṣṭām avicchinna pravāhena sthitām sva ātmani līnām bhāvayet 
SA_MB_siddhalaksmipujapaddhatiHK-539	itthaṃ pādyācamanīyārghyamantrasandhāna nāḍīsandhāna paramīkaraṇāntaṃ sampūjya | paścād vipulāṃ	ittham pādya ācamanīya arghya mantra sandhāna nāḍī sandhāna paramīkaraṇa antam sampūjya paścāt vipulām 
SA_MB_siddhalaksmipujapaddhatiHK-540	pūjāṃ kṛtvā | yathā śaktijapaṃ mūlasya kuryāt | vaktrāṅgānāṃ daśāṃsāḥ |	pūjām kṛtvā yathā śakti japam mūlasya kuryāt vaktra aṅgānām daśa aṃsāḥ 
SA_MB_siddhalaksmipujapaddhatiHK-541	guhyāti guhyagoptātvaṃ gṛhāṇāsmat kṛtaṃ japam | siddhirbhavatu me deva tvat prasādāt vadhisthite ||	guhya ati guhya goptā tvam gṛhāṇa asmat kṛtam japam siddhiḥ bhavatu me deva tvat prasādāt vadhi sthite 
SA_MB_siddhalaksmipujapaddhatiHK-542	iti japa nivedanam |	iti japa nivedanam 
SA_MB_siddhalaksmipujapaddhatiHK-543	tatorghapātrādabhyukṣyā'mṛta mudrayā'mṛtīkṛtya |	tatas ṛghapātrāt abhyukṣya amṛta mudrayā amṛtīkṛtya 
SA_MB_siddhalaksmipujapaddhatiHK-544	oṃ saḥ amṛtodbhavāya somāyānrāpa vauṣat | dravya svarūpiṇi ṭhaḥ ṭhaḥ	om saḥ amṛta udbhavāya somāya anrāpa vauṣad dravya svarūpiṇi ṭhaḥ ṭhaḥ 
SA_MB_siddhalaksmipujapaddhatiHK-545	utpannamamṛtaṃ divyaṃ prākkṣīrodadhimanthanāt | annamamṛtarūpeṇa naivedyaṃ pratigṛhyatām ||	utpannam amṛtam divyam prāk kṣīrodadhi manthanāt annam amṛta rūpeṇa naivedyam pratigṛhyatām 
SA_MB_siddhalaksmipujapaddhatiHK-546	iti mūlaṃ smṛtvā naivedyaṃ nivedya |	iti mūlam smṛtvā naivedyam nivedya 
SA_MB_siddhalaksmipujapaddhatiHK-547	kṣetreśa pūjāṃ kuryāt ||	kṣetra īśa pūjām kuryāt 
SA_MB_siddhalaksmipujapaddhatiHK-548	oṃ hrāṃ kṣaṃ kṣūṃ herukāya namaḥ | pūrve | oṃ aiṃ hrīṃ lāṃ kṣeṃ kṣīṃ tripurāntakāya namaḥ |	om                                 
SA_MB_siddhalaksmipujapaddhatiHK-549	āgneye | oṃ hrīṃ hūṃ kṣīṃ agnivetālāya namaḥ | dakṣe | aiṃ hrīṃ kṣūṃ hūṃ agnijihvāya namaḥ |	āgneye om       agni vetālāya namaḥ dakṣe aim       agni jihvāya namaḥ 
SA_MB_siddhalaksmipujapaddhatiHK-550	nair-ṛte | oṃ hrīṃ hrīṃ hūṃ kurparāya namaḥ | paścime | kālāya namaḥ | vāyau | oṃ kṣā yūṃ kṣīṃ	nairṛte om hrīṃ hrīṃ hūm kurparāya namaḥ paścime kālāya namaḥ vāyau om kṣā yūm kṣīṃ 
SA_MB_siddhalaksmipujapaddhatiHK-551	karāline namaḥ | uttare | oṃ āṃ yūṃ kṣmīṃ ekapādāya namaḥ | aiśe | oṃ kṣūṃ yūṃ kṣāṃ bhīmarūpāya	karāline namaḥ uttare om ām yūm kṣmīṃ eka pādāya namaḥ aiśe om kṣūṃ yūm kṣāṃ bhīma rūpāya 
SA_MB_siddhalaksmipujapaddhatiHK-552	namaḥ | madhye | ūrdhve ḍāmarāya namaḥ | adhaḥ hāṭakeśvarāya namaḥ ||	namaḥ madhye ūrdhve ḍāmarāya namaḥ adhas hāṭakeśvarāya namaḥ 
SA_MB_siddhalaksmipujapaddhatiHK-553	atha visarjanam |	atha visarjanam 
SA_MB_siddhalaksmipujapaddhatiHK-554	ājñāṃ me dīyatāṃ nātha naivedyasyāsya bhakṣaṇe | śarīrayātrā siddhyarthaṃ kṣamasva parameśvara ||	ājñām me dīyatām nātha naivedyasya asya bhakṣaṇe śarīra yātrā siddhi artham kṣamasva parameśvara 
SA_MB_siddhalaksmipujapaddhatiHK-555	oṃ hūṃ bhagavan kṣamasva hūṃ phaṭ | hūṃ bhagavati kṣamasva hūṃ phaṭ |	om   bhagavan kṣamasva   phaṭ   bhagavati kṣamasva   phaṭ 
SA_MB_siddhalaksmipujapaddhatiHK-556	yat kiñcit kurmahe deva sadāsukṛta duṣkṛtam | tanme śivapadasthasya hūṃ haḥ kṣapaya śaṅkara ||	yat kiñcid kurmahe deva sadā sukṛta duṣkṛtam tat me śiva pada sthasya   haḥ kṣapaya śaṅkara 
SA_MB_siddhalaksmipujapaddhatiHK-557	kṣaḥ kṣaḥ kṣapaya śaṅkaretyapi pāṭhaḥ | etāvatya smadarthe śakṣantavyaṃ kheditosibhoḥ |	kṣaḥ kṣaḥ kṣapaya śaṅkara iti api pāṭhaḥ smad arthe smad arthe 
SA_MB_siddhalaksmipujapaddhatiHK-558	iti kṣāntimantraḥ |	iti kṣānti mantraḥ 
SA_MB_siddhalaksmipujapaddhatiHK-559	jvālārūpaṃ samutthāya praśāntaparamātamaneḥ | dhyāyedarceśca santuṣṭaṃ praṇamedādarāśśivam ||	jvālā rūpam samutthāya dhyāyet arceḥ ca santuṣṭam praṇamet ādarāḥ śivam 
SA_MB_siddhalaksmipujapaddhatiHK-560	kṣamasva nyūnādhika bhāvayuktaṃ mayākṛtaṃ darśaya viśvamūrte | prasīda deveśa namostubhyaṃ prayāhi	kṣamasva nyūna adhika bhāva yuktam mayā akṛtam darśaya viśvamūrte prasīda deveśa namostubhyam prayāhi 
SA_MB_siddhalaksmipujapaddhatiHK-561	tuṣṭaḥ punarāgamāya |	tuṣṭaḥ punarāgamāya 
SA_MB_siddhalaksmipujapaddhatiHK-562	dravyahīnaṃ kriyāhīnaṃ mantrahīnaṃ ca yadgatam | tatsarvaṃ pūrṇatāṃ pātu tvat prasādān maheśvara ||	dravya hīnam kriyā hīnam mantra hīnam ca yat gatam tat sarvam pūrṇa tām pātu tvat prasādāt maheśvara 
SA_MB_siddhalaksmipujapaddhatiHK-563	tataḥ pūjitamantrān sphurad vahnikaṇābhānvibhau līnān dhyātvā | taṃ ca vibhuṃ jvālārūpaṃ hṛtsthaṃ	tatas pūjita mantrān sphurat vahni kaṇā ābhān vibhau līnān dhyātvā tam ca vibhum jvālā rūpam hṛd stham 
SA_MB_siddhalaksmipujapaddhatiHK-564	bhāvayet | iti śivam |	bhāvayet iti śivam 
SA_MB_siddhalaksmipujapaddhatiHK-565	tatassamayā | tatorghapātraṃ svīkuryāt | tataḥ ekapādaṃ | karālini | taṃ kālākhye | tamagni jihve | tamagni	tatas samayā svīkuryāt tatas eka pādam karālini tam kāla ākhye tam agni jihve tam agni 
SA_MB_siddhalaksmipujapaddhatiHK-566	vetāle | taṃtripurāntake | tamāmardake | taṃ mudgare | taṃ paraśau | taṃ daṇḍe | taṃ vajre | tattriśūle |	vetāle tam tripurāntake tam āmardake tam mudgare tam paraśau tam daṇḍe tam vajre tat triśūle 
SA_MB_siddhalaksmipujapaddhatiHK-567	tadghaṇṭāyāṃ | tāṃ ḍamarau | taṃ vīṇāyām | tāṃ khaṭvāṅge | taṃ kapāle | tadabhaye abhayaṃ vare |	tat ghaṇṭāyām tām ḍamarau tam vīṇāyām tām khaṭvāṅge tam kapāle tat abhaye abhayam vare 
SA_MB_siddhalaksmipujapaddhatiHK-568	varaṃ pināke | pinākaṃ śare | śaramaṅkuśe | aṅkuśaṃ pāśe | taṃ kheṭake | taṃ khaḍge | khaḍgamīśāne	varam pināke pinākam śare śaram aṅkuśe aṅkuśam pāśe tam kheṭake tam khaḍge khaḍgam īśāne 
SA_MB_siddhalaksmipujapaddhatiHK-569	| taṃ kuvīre | taṃ vāyau | taṃ varuṇe | taṃ nair-ṛte | taṃ yametaṃ agnau | tamiṃdre | indraṃ	tam ku vīre tam vāyau tam varuṇe tam nairṛte tam yam etam agnau tam indre indram 
SA_MB_siddhalaksmipujapaddhatiHK-570	vidyārājabhairave | taṃ somarājabhairave | taṃ meghanādabhairave | taṃ manmathabhairave | taṃ vikarālabhairave	vidyārājabhairave tam somarājabhairave tam meghanādabhairave tam manmathabhairave tam vikarālabhairave 
SA_MB_siddhalaksmipujapaddhatiHK-571	| taṃ krodharājabhairave | taṃ śikhivāhanabhairave | taṃ kapāleśabhairave līnaṃ bhāvayet |	tam krodharāja bhairave tam śikhivāhana bhairave tam kapāla īśa bhairave līnam bhāvayet 
SA_MB_siddhalaksmipujapaddhatiHK-572	prāgvatkapāleśabhairavaṃ | āmardake līnaṃ bhāvayet | āmardakaṃ śaktau | śakti'mastre | astraṃ netre |	prāgvat kapāla īśa bhairavam āmardake līnam bhāvayet āmardakam śaktau śaktim astre astram netre 
SA_MB_siddhalaksmipujapaddhatiHK-573	netraṃ kavace | kavacaṃ śikhāyāṃ śikhāṃ śivasi | śiro hṛdayadeśe | hṛdayaṃ sadyojāte sadyojātaṃ	netram kavace kavacam śikhāyām śikhām śivasi  śiraḥ hṛdaya deśe hṛdayam sadyojāte sadyojātam 
SA_MB_siddhalaksmipujapaddhatiHK-574	vāmadeve | vāmadevamaghore | taṃ tatpuruṣe | tamīśāne | taṃ sakalabhaṭṭārake | taṃ niṣkalamantreśvare |	vāmadeve vāmadevam aghore tam tatpuruṣe tam īśāne tam sakala bhaṭṭārake tam niṣkala mantreśvare 
SA_MB_siddhalaksmipujapaddhatiHK-575	tamarghapātre | arghapātraṃ svātmani līnaṃ bhāvayet | iṣṭvā śrīmatsvatantrokta kriyayābhairavaṃ budhāḥ |	tam arghapātre arghapātram sva ātmani līnam bhāvayet iṣṭvā śrīmat svatantra ukta kriyayā bhairavam budhāḥ 
SA_MB_siddhalaksmipujapaddhatiHK-576	labhantāṃ	labhantām 
SA_MB_siddhalaksmipujapaddhatiHK-577	tanmayībhāvaṃ sadāsvātantrya siddhaye | vigalati bhavadaurgatyaṃ mokṣa śrīḥ | śrayati hṛtkajaṃ kacati |	tanmayībhāvam sadā svātantrya siddhaye vigalati bhava daurgatyam mokṣa śrīḥ śrayati hṛd kajam kacati 
SA_MB_siddhalaksmipujapaddhatiHK-578	prasarati paramānando | yatra tadīśārcanaṃ jayati | bhavatyapi pāṭhaḥ samāpteyaṃ svacchandapatrikā	prasarati parama ānandaḥ yatra tad īśa arcanam jayati bhavati api pāṭhaḥ samāptā iyam svacchanda patrikā 
SA_MB_siddhalaksmipujapaddhatiHK-579	svātmabhairavabhaṭṭāraka prītaye bhūyāditi śivam ||	sva ātma bhairava bhaṭṭāraka prītaye bhūyāt iti śivam 
SA_MB_siddhalaksmipujapaddhatiHK-580	athasamayā ||	atha samayā 
SA_MB_siddhalaksmipujapaddhatiHK-581	vidhilopanivāraṇārthaṃ samayā pūjyā ||	vidhi lopa nivāraṇa artham samayā pūjyā 
SA_MB_siddhalaksmipujapaddhatiHK-582	oṃ juṃ saḥ amṛteśāya amṛtamūrtaye sarvabhūtāntarātmane mahāvyomaśarīrāya sarvasamayalopānnivāraya	om juṃ saḥ amṛta īśāya amṛta mūrtaye sarva bhūta antarātmane mahā vyoma śarīrāya sarva samaya lopāt nivāraya 
SA_MB_siddhalaksmipujapaddhatiHK-583	samayaṃ prapūraya sarvasādhāraṇa mantraśarīrāya hrīṃ svāhā | oṃ hrīṃ amṛte parāmṛte nitya klīṃ saḥ	samayam prapūraya sarva sādhāraṇa mantra śarīrāya hrīṃ svāhā om hrīṃ amṛte para amṛte nitya klīṃ saḥ 
SA_MB_siddhalaksmipujapaddhatiHK-584	amṛteśvarī sarvabhūtāntarasthe brahmasvarūpe mahāvyomaśarīre sarvasamayalopānnivāraya sarvasamayaṃ	amṛteśvarī sarva bhūta antara sthe brahma sva rūpe mahā vyoma śarīre sarva samaya lopāt nivāraya sarva samayam 
SA_MB_siddhalaksmipujapaddhatiHK-585	prapūraya amṛtalakṣmyai svāhā | oṃ hūṃ śāntajñāna svarūpāya hāṃ hīṃ hūṃ haiṃ hauṃ haḥ	prapūraya amṛta lakṣmyai svāhā om hūm śānta jñāna svarūpāya hāṃ hīṃ hūm haiṃ hauṃ haḥ 
SA_MB_siddhalaksmipujapaddhatiHK-586	sarvasamayalopanivārakāya hrīṃ svāhā | iti svacchandasamayā | oṃ aghore juṃ tha ghore saḥ ghoraghoratare |	sarva samaya lopa nivārakāya hrīṃ svāhā iti svacchanda samayā om aghore juṃ tha ghore saḥ ghora ghoratare 
SA_MB_siddhalaksmipujapaddhatiHK-587	hrīṃ sarvataḥ śarvasarve | hūṃ namaste rudrarūpe astrāya phaṭ | oṃ aghore sarvātmane hṛdayāya namaḥ | oṃ	hrīṃ sarvatas śarva sarve   namaḥ te rudra rūpe astrāya phaṭ om aghore sarvātmane hṛdayāya namaḥ om 
SA_MB_siddhalaksmipujapaddhatiHK-588	juṃ tha ghore brahmaśisare svāhā | saḥ ghoraghoratare jvāliniśikhāyai vauṣaṭ | oṃ hrīṃ sarvataḥ	juṃ tha ghore brahmaśisare svāhā saḥ ghora ghoratare jvāliniśikhāyai vauṣaṭ om hrīṃ sarvatas 
SA_MB_siddhalaksmipujapaddhatiHK-589	śarvasarvepiṅgalāya kavacāya huṃ hūṃ namaste rudrarūpe durbhedyāya pāśupatāstrāya phaṭ | ityut	kavacāya hum   namaḥ te rudra rūpe durbhedyāya pāśupatāstrāya phaṭ iti ud 
SA_MB_siddhalaksmipujapaddhatiHK-590	kīlanavidyā | aghorasyot kīlanam |	kīlana vidyā aghorasya ud kīlanam 
SA_MB_siddhalaksmipujapaddhatiHK-591	oṃ aghore aiṃ tha ghore hrīṃ ghoraghoratare śrīṃ sarvataḥ sarvasarve | phreṃ rudrarūpe hsphreṃ namaste |	om aghore aim tha ghore hrīṃ ghora ghoratare śrīṃ sarvatas sarva sarve phreṃ rudra rūpe hsphreṃ namaḥ te 
SA_MB_siddhalaksmipujapaddhatiHK-592	bhakārasahitaṃ mantraṃ namaste madhya saṃsthitam | aṣṭaukīlāmayādattāstenāsau naiva siddhyati ||	bhakāra sahitam mantram namaḥ te madhya saṃsthitam 
SA_MB_siddhalaksmipujapaddhatiHK-593	eteṣu sarvatantreṣu vīryahīnaṃ prakāśitam | jīvaprāṇavinirmuktaṃ pañcabījavivarjitam ||	eteṣu sarva tantreṣu vīrya hīnam prakāśitam jīva prāṇa vinirmuktam pañca bīja vivarjitam 
SA_MB_siddhalaksmipujapaddhatiHK-594	athāmṛtīsvarapūjanam ||	atha amṛtīsvara pūjanam 
SA_MB_siddhalaksmipujapaddhatiHK-595	oṃ amṛteśāyavidmahe mahādevāyadhimahi | tannorudraḥ pracodayāt 3 ||	om amṛta īśāya vidmahe mahādevāya dhimahi tat naḥ rudraḥ pracodayāt 
SA_MB_siddhalaksmipujapaddhatiHK-596	dravyaśuddhidigbandhana prāṇāyāmādi vidhāya karāṅganyāsaṃ kṛtvā dhyāyet |	                          
SA_MB_siddhalaksmipujapaddhatiHK-597	haṃ mūrtaye namaḥ |	haṃ mūrtaye namaḥ 
SA_MB_siddhalaksmipujapaddhatiHK-598	devaṃ tāmarasāsanaṃ śaśikalālaṅkāramaṅkāramacchaṅkhāmbhojalasadvarābhaya mahālakṣmī samudbhāsitam |	devam tāmarasāsanam samudbhāsitam 
SA_MB_siddhalaksmipujapaddhatiHK-599	savyāsavyakadovarābhaya sudhākumbhendumindūlasatsaumyāsyaṃ ca caturbhujaṃ ca bhagavannetraṃ trinetraṃ numaḥ |	sudhā kumbha indu mindu lasat saumya āsyam ca catur bhujam ca bhagavat netram trinetram numaḥ 
SA_MB_siddhalaksmipujapaddhatiHK-600	mānasaiḥ pādyādibhiḥ pūjanam |	mānasaiḥ pādya ādibhiḥ pūjanam 
SA_MB_siddhalaksmipujapaddhatiHK-601	oṃ juṃ saḥ amṛteśvarabhairavāya namaḥ | oṃ juṃ hṛdayāya | oṃ vyoṃ śira | oṃ īṃ śikhā | oṃ hnūṃ kava |	om juṃ saḥ amṛteśvara bhairavāya namaḥ om juṃ hṛdayāya om vyoṃ śiraḥ om īṃ śikhā om   kava 
SA_MB_siddhalaksmipujapaddhatiHK-602	oṃ jyoṃ netre | oṃ phaṭ astrā | oṃ juṃ saḥ amṛtalakṣmyai namaḥ | śrīdevyaṅgāni śrīdevavat | oṃ	om jyoṃ netre om phaṭ astrā om juṃ saḥ amṛta lakṣmyai namaḥ śrī devī aṅgāni śrīdeva vat om 
SA_MB_siddhalaksmipujapaddhatiHK-603	śivatatvāya namaḥ | oṃ juṃ vidyātatvāya | oṃ saḥ ātmatatvāya namaḥ | indrādi lokapālebhyo namaḥ |	śiva tatvāya namaḥ om juṃ vidyā tatvāya om saḥ ātma tatvāya namaḥ indra ādi lokapālebhyaḥ namaḥ 
SA_MB_siddhalaksmipujapaddhatiHK-604	brāhmyādi mātṛbhyo namaḥ | ityādi ||	brāhmī ādi mātṛbhyaḥ namaḥ ityādi 
SA_MB_siddhalaksmipujapaddhatiHK-605	oṃ vibhraddorbhiḥ kuṭhāraṃ mṛgamabhayavarau suprasannomaheśaḥ sarvālaṅkāradīptassarasijanilayo vyāghracarmā	om vibhrat dorbhiḥ kuṭhāram mṛgam abhaya varau su prasannaḥ maheśaḥ sarva alaṅkāra dīptaḥ sarasija nilayaḥ vyāghra carmā 
SA_MB_siddhalaksmipujapaddhatiHK-606	vāsaḥ | dhyeyo muktāparāgāmṛtarasakalaitādri prabhaḥ pañcavaktrastryakṣaḥ koṭīrakoṭīghaṭita tu	vāsaḥ dhyeyaḥ prabhaḥ pañcavaktraḥ tryakṣaḥ tu 
SA_MB_siddhalaksmipujapaddhatiHK-607	hinarociṣkalātuṅgamauliḥ |	         
SA_MB_siddhalaksmipujapaddhatiHK-608	asyamantrasya |	asya mantrasya 
SA_MB_siddhalaksmipujapaddhatiHK-609	vāmadeva ṛṣiḥ paṅkticchandaḥ | ī śodevatā ātmana iṣṭasiddhyarthaṃ viniyogaḥ |	vāmadevaḥ ṛṣiḥ paṅkti chandaḥ ī śaḥ devatā ātmanaḥ iṣṭa siddhi artham viniyogaḥ 
SA_MB_siddhalaksmipujapaddhatiHK-610	oṃ namaḥ śivāya | oṃ hṛ | na śira | maḥ śikhā | śi kava | vā netre | ya astrāya | na īśānamūrdhne namaḥ	om namaḥ śivāya om hṛ na śira maḥ śikhā śi kava vā netre na astrāya na īśāna mūrdhne namaḥ 
SA_MB_siddhalaksmipujapaddhatiHK-611	| maḥ tatpuruṣavaktrāya namaḥ | śi aghorahṛdayāya namaḥ | vā vāmadevaguhyāya namaḥ | ya sadyojātamūrtaye	maḥ tatpuruṣa vaktrāya namaḥ śi aghora hṛdayāya namaḥ vā vāmadeva guhyāya namaḥ ya sadyojāta mūrtaye 
SA_MB_siddhalaksmipujapaddhatiHK-612	namaḥ | na ūrdhvavaktrāya namaḥ | maḥ pūrvavaktrāya namaḥ | śi dakṣiṇavaktrāya namaḥ | vā uttaravaktrāya	namaḥ naḥ ūrdhva vaktrāya namaḥ maḥ pūrva vaktrāya namaḥ śi dakṣiṇa vaktrāya namaḥ vā uttara vaktrāya 
SA_MB_siddhalaksmipujapaddhatiHK-613	namaḥ | ya paścimavaktrāya namaḥ | āvṛtirādyā mūrtibhiraṅgairanyā parāpyanantādyaiḥ aparomādyaiḥ	namaḥ ya paścima vaktrāya namaḥ āvṛtiḥ ādyā mūrtibhiḥ aṅgaiḥ anyā parā api ananta ādyaiḥ apara umā ādyaiḥ 
SA_MB_siddhalaksmipujapaddhatiHK-614	aparendrādyairaparā tadāyudhaiḥ proktā | oṃ śarvāya devāya kṣitimūrtaye namaḥ | oṃ bhavāya devāya	aparā indra ādyaiḥ aparā tad āyudhaiḥ proktā om śarvāya devāya kṣiti mūrtaye namaḥ om bhavāya devāya 
SA_MB_siddhalaksmipujapaddhatiHK-615	jalamūrtaye namaḥ | oṃ rudrāya devāya agnimūrtaye namaḥ | oṃ ugrāya devāya vāyumūrtaye namaḥ | oṃ bhīmāya	jala mūrtaye namaḥ om rudrāya devāya agni mūrtaye namaḥ om ugrāya devāya vāyu mūrtaye namaḥ om bhīmāya 
SA_MB_siddhalaksmipujapaddhatiHK-616	devāya ākāśamūrtaye namaḥ | oṃ paśupataye devāya yajamānamūrtaye namaḥ |	devāya ākāśa mūrtaye namaḥ om paśupataye devāya yajamāna mūrtaye namaḥ 
SA_MB_siddhalaksmipujapaddhatiHK-617	oṃ mahādevāya somamūrtaye namaḥ | oṃ īśānāya devāya sūryamūrtaye namaḥ | madhye durgāyai namaḥ |	om mahādevāya soma mūrtaye namaḥ om īśānāya devāya sūrya mūrtaye namaḥ madhye durgāyai namaḥ 
SA_MB_siddhalaksmipujapaddhatiHK-618	tatoṅgāni | tataḥ anantāya namaḥ | ityādi |	tatas ṅgāni tatas anantāya namaḥ ityādi 
SA_MB_siddhalaksmipujapaddhatiHK-619	umāyai namaḥ | ityādi |	umāyai namaḥ ityādi 
SA_MB_siddhalaksmipujapaddhatiHK-620	indrāya vajrahastāya nama | ityādi |	indrāya vajrahastāya namaḥ ityādi 
SA_MB_siddhalaksmipujapaddhatiHK-621	vajrāya phaṭityādi | iti pañcākṣara pūjanam |	vajrāya phaṭ ityādi iti pañcākṣara pūjanam 
SA_MB_siddhalaksmipujapaddhatiHK-622	hāṃ nivṛtti kalādhipataye brahmaṇe namaḥ | hīṃ pratiṣṭhākalādhipataye viṣṇave namaḥ | hūṃ	hāṃ nivṛtti kalā adhipataye brahmaṇe namaḥ hīṃ pratiṣṭhā kalā adhipataye viṣṇave namaḥ hūm 
SA_MB_siddhalaksmipujapaddhatiHK-623	vidyakalādhipataye rudrāya namaḥ | haiṃ śāntākalādhipataye īśvarāya namaḥ | haḥ	vidya kalā adhipataye rudrāya namaḥ haiṃ śāntā kalā adhipataye īśvarāya namaḥ haḥ 
SA_MB_siddhalaksmipujapaddhatiHK-624	śāntyatītākalādhipataye sadāśivāya namaḥ | oṃ mantrādhvane namaḥ | oṃ padādhvane namaḥ | varṇādhvane |	śānti atītā kalā adhipataye sadāśivāya namaḥ om mantra adhvane namaḥ om pada adhvane namaḥ varṇa adhvane 
SA_MB_siddhalaksmipujapaddhatiHK-625	bhuvanādhvane namaḥ | tattvādhvane | oṃ kalādhvane namaḥ ||	bhuvana adhvane namaḥ tattva adhvane om kalā adhvane namaḥ 
SA_MB_siddhalaksmipujapaddhatiHK-626	oṃ sakalākalo vimiśraḥ sadasatsarveśvaro mahāmantraḥ | tamihamahāpāpaharaṃ paśupāśajīghāṃsakaṃ vande |	om sakala akalaḥ vimiśraḥ sat asat sarva īśvaraḥ mahā mantraḥ tam iha mahā pāpa haram paśu pāśa jīghāṃsakam vande 
SA_MB_siddhalaksmipujapaddhatiHK-627	tanmaheśāya vidmahe vyomarūpāya dhīmahi | tanno namaḥ śivaḥ pracodayāt 3 |	tat maheśāya vidmahe vyoma rūpāya dhīmahi tat naḥ namaḥ śivaḥ pracodayāt 
SA_MB_siddhalaksmipujapaddhatiHK-628	oṃ vyomavyāpine 5 vyomarūpāya 5 sarvavyāpine 5 śivāya 3 anantāya 4 anāthāya 4 anāśritāya 5	om vyomavyāpine vyoma rūpāya sarva vyāpine śivāya anantāya anāthāya anāśritāya 
SA_MB_siddhalaksmipujapaddhatiHK-629	dhrūvāya 3 śāśvatāya 4 yogapīṭhasaṃsthitāya 2 nityaṃ yogine 5 dhyānāhārāya 5 oṃ namaḥ śivāya 6	dhrūvāya śāśvatāya yogapīṭha saṃsthitāya nityam yogine dhyāna āhārāya om namaḥ śivāya 
SA_MB_siddhalaksmipujapaddhatiHK-630	sarvaprabhave 5 śivāya 3 īśānamūrdhnāya 6 tatpuruṣavaktrāya 7 aghorahṛdayāya 7 vāmadevaguhyāya 7	sarva prabhave śivāya īśāna mūrdhnāya tatpuruṣa vaktrāya aghora hṛdayāya vāmadeva guhyāya 
SA_MB_siddhalaksmipujapaddhatiHK-631	sadyojātamūrtaye 7 oṃ namo namaḥ 5 guhyātiguhyāya 6 goptre 2 nidhanāya 4 sarvavidyādhipāya 7 jyotīrūpāya 7	sadyojāta mūrtaye om namaḥ namaḥ guhya ati guhyāya goptre nidhanāya sarva vidyā adhipāya jyotīrūpāya 
SA_MB_siddhalaksmipujapaddhatiHK-632	parameśvaraparāya 2 acetana 3 vyomanā 4 vyāpin 4 arūpin 6 prathama 6 tejaḥ 4 jyotiḥ 4 arūpa 3 anagne 3 adhūma 3	acetana vyomanā vyāpin arūpin prathama tejaḥ jyotiḥ arūpa anagne adhūma 
SA_MB_siddhalaksmipujapaddhatiHK-633	abhasma 3 anāde 3 nānānā 2 dhū dhū dhū 3 oṃ bhūḥ 2 oṃ bhuvaḥ 3 oṃ svaḥ 3 anidhana 4 nidhana 3 nidhanodbhava 5	a bhasma a nāde dhū dhū dhū om bhūḥ om bhuvaḥ om svar a nidhana nidhana nidhana udbhava 
SA_MB_siddhalaksmipujapaddhatiHK-634	śiva 2 sarva 2 paramātma 4 maheśvara 4 mahādeva 4 sadbhāveśvara 5 mahātejaḥ 4 yogādhipate 5 muñca 4 pramatha 6	śiva sarva paramātma maheśvara mahādeva sadbhāva īśvara mahā tejaḥ yoga adhipate muñca pramatha 
SA_MB_siddhalaksmipujapaddhatiHK-635	śarva 4 bhava 4 bhavodbhava 4 sarvabhūtasukhaprada 8 sarvasānnidhyakara 7 brahmaviṣṇurudrapara 2 anarcita 2	śarvaiḥ bhavaiḥ bhavodbhavaiḥ sarva bhūta sukha pradaiḥ sarva sānnidhya karaiḥ brahma viṣṇu rudra paraiḥ anarcitaiḥ 
SA_MB_siddhalaksmipujapaddhatiHK-636	asaṃstuta 2 pūrvasthita 2 sākṣin 2 uru 4 pataṅga 6 piṅga 4 jñāna 4 śabda 4 sūkṣma 4 śiva 2 śarva 2 sarvada	asaṃstuta pūrva sthita sākṣin uru pataṅga piṅga jñāna śabda sūkṣma śiva śarva sarva da 
SA_MB_siddhalaksmipujapaddhatiHK-637	3 oṃ namo namaḥ 5 oṃ śivāya 4 namo namaḥ 4 hsū-auṃ mūlam |	om namaḥ namaḥ om śivāya namaḥ namaḥ hsū aum mūlam 
SA_MB_siddhalaksmipujapaddhatiHK-638	oṃ namaḥ sarvātmane śarāya parameśvarāya yogāya yogasambhavāya kara 2 kuru 2 sadya 2 bhava 2 bhavodbhava	om namaḥ sarvātmane śarāya parameśvarāya yogāya yogasambhavāya kara kuru sadya bhava bhavodbhava 
SA_MB_siddhalaksmipujapaddhatiHK-639	vāmadeva sarvākāryaprasamana namostute svāhā hṛdayāya namaḥ |	vāmadeva sarva akārya prasamana namostute svāhā hṛdayāya namaḥ 
SA_MB_siddhalaksmipujapaddhatiHK-640	svaśivaśira namaḥ | śirase svāhā | śivahṛdaya jvālinyai svāhā | śikhāyai vauṣaṭ | oṃ śivātmakaṃ	sva śiva śira namaḥ śirase svāhā śiva hṛdaya jvālinyai svāhā śikhāyai vauṣaṭ om śiva ātmakam 
SA_MB_siddhalaksmipujapaddhatiHK-641	mahātejassavajñamaparājitam | āvartaye mahāghoraṃ kavacaṃ piṅgalaṃ śubham | kavacā vāhanam | āyāhi	mahā tejaḥ savajñam aparājitam  āvartaye mahā ghoram kavacam piṅgalam śubham kavaca vāhanam āyāhi 
SA_MB_siddhalaksmipujapaddhatiHK-642	piṅgala mahākavaca śivājñayā hṛdayaṃ bandha 2 ghūrṇa 2 kā ki 2 sūkṣma 2 vajradhara 2 vajrapāśa	piṅgala mahākavaca śiva ājñayā hṛdayam bandha ghūrṇa kā ki sūkṣma vajradhara vajrapāśa 
SA_MB_siddhalaksmipujapaddhatiHK-643	vajrāśani mama śarīramanupraveśa sarvaduṣṭān stambhaya hūṃ phaṭ kavacāya hum | oṃ prasphura 2 sphura 2 ghora	vajra aśani mama śarīram anupraveśa sarva duṣṭān stambhaya hūm phaṭ kavacāya hum om prasphura sphura ghora 
SA_MB_siddhalaksmipujapaddhatiHK-644	ghoratara tanurūpa naṭ 2 pracaṭ 2 karṣa 2 ghātaya 2 hūṃ phaṭ astrāya phaṭ | asya vaktrapañcakaṃ sāṅgam |	ghoratara tanu rūpa naṭ pracaṭ karṣa ghātaya   phaṭ astrāya phaṭ asya vaktra pañcakam sa aṅgam 
SA_MB_siddhalaksmipujapaddhatiHK-645	tatra gāyatrī |	tatra gāyatrī 
SA_MB_siddhalaksmipujapaddhatiHK-646	śivātmakamidaṃ viśvaṃ śivādeva pravartate | śivāya śivagarbhāya śivassarvaṃ pracodayāt 3 ||	śiva ātmakam idam viśvam śivāt eva pravartate  śivāya śiva garbhāya śivaḥ sarvam pracodayāt  /
SA_MB_siddhalaksmipujapaddhatiHK-647	īśānassarvavidyānāmīśvarassarvabhūtānām | brahmādhipatirbrahmaṇodhipatirbrahmāśivomestu sadāśiva oṃ |	īśānaḥ sarva vidyānām īśvaraḥ sarva bhūtānām brahma adhipatiḥ brahmaṇaḥ adhipatiḥ brahmā śivaḥ umeḥ tu sadāśivaḥ om 
SA_MB_siddhalaksmipujapaddhatiHK-648	oṃ hūṃ amogha svāhā phaṭ hṛda pañcamūrti ne namaḥ | śira | īśāne svāhā śikhā | oṃ jvalanti namaḥ phaṭ	om hūm amogha svāhā phaṭ hṛda pañcamūrti ne namaḥ śira īśāne svāhā śikhā om jvalanti namaḥ phaṭ 
SA_MB_siddhalaksmipujapaddhatiHK-649	kavacāya hūṃ sadasadom phaṭ astrāya | tatpuruṣāya vidmahe mahādevāyadhīmahi | tannorudraḥ pracodayāt 3 |	kavacāya hūm phaṭ astrāya tatpuruṣāya vidmahe mahādevāya dhīmahi tat naḥ rudraḥ pracodayāt 
SA_MB_siddhalaksmipujapaddhatiHK-650	tatpuruṣasadasadom hṛda | oṃ bhūssvāhā śira | oṃ bhuvaḥ svāhā śikhā | oṃ svaḥ svāhā kava | tatsadoṃ	om bhūḥ svāhā śira om bhuvaḥ svāhā śikhā om svar svāhā kava tad sad oṃ 
SA_MB_siddhalaksmipujapaddhatiHK-651	astrā | oṃ aghorebhya iti | tatsadom hṛda | bhavadaṇḍa hūṃ phaṭ śira | bhīmabhīṣaṇi sarvavidyā hṛdaya	astrā om aghorebhyaḥ iti tad sadā ūm hṛda bhava daṇḍa   phaṭ śira bhīma bhīṣaṇi sarva vidyā hṛdaya 
SA_MB_siddhalaksmipujapaddhatiHK-652	vicāriṇi hūṃ phaṭ śikhā | amogha hūṃ phaṭ kava | tatsadom astrāya |	vicāriṇi hūm phaṭ śikhā amogha hūm phaṭ kava tad sadā ūm astrāya 
SA_MB_siddhalaksmipujapaddhatiHK-653	vāmadevāya namaḥ | jyeṣṭhāya namaḥ | rudrāya namaḥ | kālāya kalavikaraṇāya bala vikaraṇāya	vāmadevāya namaḥ jyeṣṭhāya namaḥ rudrāya namaḥ kālāya kala vikaraṇāya bala vikaraṇāya 
SA_MB_siddhalaksmipujapaddhatiHK-654	balapramathanāya sarvabhūtadamanāya manonmanāya namaḥ | vāmadeva tatsadom hṛda | vāmadevāya hūṃ phaṭ śira |	bala pramathanāya sarva bhūta damanāya manonmanāya namaḥ vāmadeva tad sadā ūm hṛda vāmadevāya hūm phaṭ śira 
SA_MB_siddhalaksmipujapaddhatiHK-655	sarvapāpapraṇāśini vāmadevaśikhe namaḥ śikhā | vāmācārāya hūṃ phaṭ kavacaṃ tatsadom astrāya phaṭ |	sarva pāpa praṇāśini vāmadeva śikhe namaḥ śikhā vāmācārāya hūm phaṭ kavacam tad sadā ūm astrāya phaṭ 
SA_MB_siddhalaksmipujapaddhatiHK-656	sadyojātaṃ prapadye vai sadyojātāya vai namaḥ | bhave bhave nāḍibhave bhajasvamāṃbhavodbhava sadyaḥ kāmāya	sadyojātam prapadye vai sadyojātāya vai namaḥ bhave bhave nāḍi bhave bhajasva mām bhava udbhava sadyas kāmāya 
SA_MB_siddhalaksmipujapaddhatiHK-657	svāhā hṛda sadyaḥ kāmavaradāyanamo namaḥ svāhā śira | oṃ pannagarūpiṇī svāhā śikhāyai | sadyo mūrti	svāhā sadyas kāma vara dāya namaḥ namaḥ svāhā śira om pannaga rūpiṇī svāhā śikhāyai sadyas mūrti 
SA_MB_siddhalaksmipujapaddhatiHK-658	phaṭ kavacāya huṃ | oṃ hūṃ oṃ phaṭ astrāya phaṭ |	phaṭ kavacāya hum om   om phaṭ astrāya phaṭ 
SA_MB_siddhalaksmipujapaddhatiHK-659	śubhamastu ||	śubham astu 
SA_MB_siddhalaksmipujapaddhatiHK-660	bhagavan śivarātrivratamahaṃ kariṣye nirvighnaṃ sampādaya svāhā | śivarātrivratamidaṃ kariṣyehaṃ mahā pha	bhagavan śivarātri vratam aham kariṣye nirvighnam sampādaya svāhā śivarātri vratam idam kariṣye iham mahā 
SA_MB_siddhalaksmipujapaddhatiHK-661	MUKTABODHA INDOLOGICAL RESEARCH INSTITUTE©2011 Muktabodha Indological Research Institute  All Rights Reserved.E-texts may be viewed only online or downloaded for private study.E-texts may not, under any circumstances, be copied, republished,reproduced, distributed or sold, either in original or altered form, withoutthe express permission of Muktabodha Indological Research Institute in writing.Data-entered by the staff of Muktabodha under the direction of Mark S. G. Dyczkowski.	muktabodha indological research muktabodha indological research institute all rights reserved texts may be viewed only online or downloaded for private studye texts may not under any circumstances be copied republished reproduced distributed or sold either in original or altered form withoutthe express permission of muktabodha indological research institute in writing data entered by the staff of muktabodha under the direction of mark s g dyczkowski 
