segmentnr	original	analyzed
SA_MB_taaraatantramHK-0	Muktabodha E-text in UTF-8	muktabodha etext in utf
SA_MB_taaraatantramHK-1	###########################################################################MUKTABODHA INDOLOGICAL RESEARCH INSTITUTEwww.muktabodha.org©2011 Muktabodha Indological Research Institute  All Rights Reserved.E-texts may be viewed only online or downloaded for private study.E-texts may not, under any circumstances, be copied, republished,reproduced, distributed or sold, either in original or altered form, withoutthe express permission of Muktabodha Indological Research Institute in writing.Data-entered by the staff of Muktabodha under the direction of Mark S. G. Dyczkowski.Catalog number : M00094	muktabodha indological research muktabodha indological research institute all rights reserved texts may be viewed only online or downloaded for private studye texts may not under any circumstances be copied republished reproduced distributed or sold either in original or altered form withoutthe express permission of muktabodha indological research institute in writing data entered by the staff of muktabodha under the direction of mark s g dyczkowskicatalog number  /
SA_MB_taaraatantramHK-2	Uniform title: tāratantra	uniform title tāratantra 
SA_MB_taaraatantramHK-3	Notes: Transcribed by the staff of Muktabodha under the supervision of mark S. G. Dyczkowski.	notes transcribed by the staff muktabodha under the supervision of mark s g dyczkowski 
SA_MB_taaraatantramHK-4	Revision 0:  May 11, 2006	revision 
SA_MB_taaraatantramHK-5	Publisher : Reprinted by Bani Prakashan 1983 of original edition prior t	publisher reprinted by bani prakashan or original edition 
SA_MB_taaraatantramHK-6	Publication year : 1940	publication year 
SA_MB_taaraatantramHK-7	Publication country : India	publication country india 
SA_MB_taaraatantramHK-8	|| tārātantram ||	tārātantram 
SA_MB_taaraatantramHK-9	prathamaḥ paṭalaḥ |	prathamaḥ paṭalaḥ 
SA_MB_taaraatantramHK-10	oṃ nama stārinyai * ||	om namaḥ stārinyai 
SA_MB_taaraatantramHK-11	kailāsaśikhare ramye devadevaṃ maheśvaram |	kailāsa śikhare ramye devadevam maheśvaram 
SA_MB_taaraatantramHK-12	papraccha bhairavī devī śayanīye sukhoṣitā || 1/1 ||	papraccha bhairavī devī śayanīye sukha uṣitā 
SA_MB_taaraatantramHK-13	purā yau kathitau buddhavaśiṣṭhau kulabhairavau |	purā yau kathitau buddha vaśiṣṭhau kula bhairavau 
SA_MB_taaraatantramHK-14	tena mantreṇa deveśa ! siddhau tau vada me prabho ! || 1/2 ||	tena mantreṇa deveśa siddhau tau vada me prabho     
SA_MB_taaraatantramHK-15	bhairava uvāca |	bhairavaḥ uvāca 
SA_MB_taaraatantramHK-16	kṣa eva paramo devo buddharūpī janārddanaḥ |	kṣaḥ eva paramaḥ devaḥ buddha rūpī janārddanaḥ 
SA_MB_taaraatantramHK-17	ugratārā - mahāmantraṃ pañcārṇaṃ parijapya ca || 1/3 ||	ugratārā mahā mantram pañca arṇam parijapya ca 
SA_MB_taaraatantramHK-18	sṛṣṭyādikarmakartā ca ajarāmaratāṃ yayau |	sṛṣṭi ādi karma kartā ca ajara amara tām yayau 
SA_MB_taaraatantramHK-19	vaśiṣṭhopyena mārādhya nakṣatralokamāgataḥ || 1/4 ||	vasiṣṭhaḥ upyena mā ārādhya nakṣatra lokam āgataḥ 
SA_MB_taaraatantramHK-20	p. 2) yogasiddhīśvaro bhūtvā dyotate'dyāpi vallabhe ! |	yoga siddhi īśvaraḥ bhūtvā vallabhe 
SA_MB_taaraatantramHK-21	taduddhāramataṃ vakṣye yataḥ sarveśvaro bhavet || 1/5 ||	tad uddhāra matam vakṣye yatas sarveśvaraḥ bhavet 
SA_MB_taaraatantramHK-22	praṇavaṃ pūrvvamuddhṛtya hṛllekhā kulakāminī |	praṇavam pūrvvam uddhṛtya hṛllekhā kulakāminī 
SA_MB_taaraatantramHK-23	kūrcamastraṃ mantrarājo devadruma ivāparaḥ || 1/6 ||	kūrcam astram mantrarājaḥ deva drumaḥ iva aparaḥ 
SA_MB_taaraatantramHK-24	anenaiva samārādhya sarvveśo'bhūt sadāśivaḥ |	anena eva samārādhya sarvva īśaḥ bhūt sadāśivaḥ 
SA_MB_taaraatantramHK-25	durvvāsāḥ - vyāsa - vālmīki - bhāradvājādikaḥ kaviḥ || 1/7 ||	          
SA_MB_taaraatantramHK-26	bhīmasenārjjunādyāste kṣatriyā jayino'bhavan |	bhīmasena arjjuna ādyāḥ te kṣatriyāḥ jayinaḥ abhavan 
SA_MB_taaraatantramHK-27	iti te kathitaṃ devi ! rahasyaṃ paramottamam || 1/8 ||	iti te kathitam devi rahasyam parama uttamam 
SA_MB_taaraatantramHK-28	gopanīyaṃ prayatnena yadi sneho'sti māṃ prati || 1/9 ||	gopanīyam prayatnena yadi snehaḥ usti mām prati 
SA_MB_taaraatantramHK-29	bhairavyuvāca |	bhairavī uvāca 
SA_MB_taaraatantramHK-30	tvatprasādādahaṃ deva ! śruto mantraḥ suradrumaḥ |	tvad prasādāt aham deva śrutaḥ mantraḥ suradrumaḥ 
SA_MB_taaraatantramHK-31	bauddhadevena yaccīrṇaṃ prātaḥ kṛtyaṃ vadasva me || 1/10 ||	bauddhadevena yat cīrṇam prātar kṛtyam vadasva me  
SA_MB_taaraatantramHK-32	bhairava uvāca |	bhairavaḥ uvāca 
SA_MB_taaraatantramHK-33	prātaḥkṛtyaṃ pravakṣyāmi yena siddho bhavennaraḥ |	prātar kṛtyam pravakṣyāmi yena siddhaḥ bhavet naraḥ 
SA_MB_taaraatantramHK-34	uttaraprahare mantrī sahasradalapaṅkaje || 1/11 ||	uttara prahare mantrī sahasra dala paṅkaje  /
SA_MB_taaraatantramHK-35	karṇikāntargate pīṭhe candramaṇḍalasannidhau |	karṇikā antargate pīṭhe candra maṇḍala sannidhau 
SA_MB_taaraatantramHK-36	śuddhasphaṭikasaṅkāśaṃ śuddhakṣaumavirājitam || 1/12 ||	śuddha sphaṭika saṅkāśam śuddha kṣauma virājitam 
SA_MB_taaraatantramHK-37	varābhayakaraṃ śāntaṃ prasannavadanekṣaṇam |	              
SA_MB_taaraatantramHK-38	gandhapuṣpādibhūṣāḍhyaṃ dayitāśakta mānasam || 1/13 ||	gandha puṣpa ādi bhūṣā āḍhyam dayitā aśakta mānasam 
SA_MB_taaraatantramHK-39	p. 3) iti dhyātvā tu gurave pādyādyai rmmānasai ryajet |	iti dhyātvā tu gurave pādya ādyaiḥ mmānasaiḥ yajet 
SA_MB_taaraatantramHK-40	tridhā vā saptadhā vāpi daśadhā prajapenmanum || 1/14 ||	tridhā vā saptadhā vā api daśadhā prajapet manum 
SA_MB_taaraatantramHK-41	vāgbhavaṃ pūrvvamuccāryya guruṃ taddayitābhidhām |	vāc bhavam pūrvvam uccāryya gurum tad dayitā abhidhām 
SA_MB_taaraatantramHK-42	śrīpādukāṃ pūjayāmi namo mantro gurupriyaḥ || 1/15 ||	śrī pādukām pūjayāmi namaḥ mantraḥ guru priyaḥ 
SA_MB_taaraatantramHK-43	guhyātimantrato mantrī samarpya stavamācaret || 1/16 ||	mantrī samarpya stavam ācaret 
SA_MB_taaraatantramHK-44	oṃ namaste bhagavannātha ! śivāya gururūpiṇe |	om namaḥ te bhagavan nātha śivāya guru rūpiṇe 
SA_MB_taaraatantramHK-45	vidyāvatārasaṃsiddhau svīkṛtānekavigraha ! || 1/17 ||	          
SA_MB_taaraatantramHK-46	bhavāya bhavarūpāya paramātmasvarūpiṇe |	bhavāya bhava rūpāya paramātma svarūpiṇe 
SA_MB_taaraatantramHK-47	sarvājñānatamobheda bhānave cinmayāya te || 1/18 ||	sarva ajñāna tamaḥ bheda bhānave cit mayāya te 
SA_MB_taaraatantramHK-48	svatantrāya dayālipta vigrahāya śivātmane |	svatantrāya dayā lipta vigrahāya śiva ātmane 
SA_MB_taaraatantramHK-49	paratantrāya bhaktānāṃ bhavyānāṃ bhavadāyine || 1/19 ||	paratantrāya bhaktānām bhavyānām bhava dāyine  /
SA_MB_taaraatantramHK-50	vivekināṃ vivekāya vimarṣāya vimarṣiṇām |	vivekinām vivekāya vimarṣāya vimarṣiṇām 
SA_MB_taaraatantramHK-51	prakāśināṃ prakāśāya jñānināṃ jñānarūpiṇe || 1/20 ||	prakāśinām prakāśāya jñāninām jñāna rūpiṇe 
SA_MB_taaraatantramHK-52	stutvā'jñāneti - mantreṇa namaskāraṃ samācaret |	stutvā ajñāna iti mantreṇa namaskāram samācaret 
SA_MB_taaraatantramHK-53	mūlādhāre mūlavidyā - svarūpāṃ kulakuṇḍalīm || 1/21 ||	mūlādhāre mūlavidyā svarūpām kulakuṇḍalīm 
SA_MB_taaraatantramHK-54	sūryyakoṭi pratīkāśāṃ viṣatantutanīyamīm || 1/22 ||	pratīkāśām 
SA_MB_taaraatantramHK-55	prasuptabhujagākārāṃ sārddhatribalayānvitām |	prasupta bhujaga ākārām sārddha tri balayā anvitām 
SA_MB_taaraatantramHK-56	haṃso - mantreṇa tasyāśca caitanyaṃ yojayettataḥ || 1/23 ||	haṃsaḥ mantreṇa tasyāḥ ca caitanyam yojayet tatas 
SA_MB_taaraatantramHK-57	p.4) padmaṣaṭkaṃ bhedayitvā karṇikādhaḥ samānayet |	              
SA_MB_taaraatantramHK-58	tataśca saṃsmaret kaulān gurūnetān kuleśvari ! || 1/24 ||	tatas ca saṃsmaret kaulān gurūn etān kuleśvari 
SA_MB_taaraatantramHK-59	prahlādānandanāthākhyaḥ sanakānanda eva ca |	                     
SA_MB_taaraatantramHK-60	kumārānandanāthaśca vaśiṣṭhānandanāthakaḥ || 1/25 ||	kumārānandanāthaḥ ca vaśiṣṭhānandanāthakaḥ 
SA_MB_taaraatantramHK-61	krodhānanda sukhānandau jñānānanda stataḥparam |	krodhānanda sukhānandau jñānānandaḥ tatas param 
SA_MB_taaraatantramHK-62	bodhānandastato nityaṃ kāraṇānandananditāḥ || 1/26 ||	bodha ānandaḥ tatas nityam kāraṇa ānanda nanditāḥ 
SA_MB_taaraatantramHK-63	vighūrṇanayanā stādṛkśaktisaṅgavirājitāḥ |	vighūrṇa nayanāḥ stādṛś śakti saṅga virājitāḥ 
SA_MB_taaraatantramHK-64	tato vindusphuranmādhvī - dhārayā tān pratarpayet || 1/27 ||	            
SA_MB_taaraatantramHK-65	tasmāttenaiva mārgeṇa svasthānaṃ prāpayet parām |	tasmāt tena eva mārgeṇa sva sthānam prāpayet parām 
SA_MB_taaraatantramHK-66	tatprabhāpaṭalai rdevi ! pāṭalaṃ svaṃ vicintayet || 1/28 ||	tad prabhā paṭalaiḥ devi pāṭalam svam vicintayet  /
SA_MB_taaraatantramHK-67	iti te kathitaṃ devi ! prātaḥkṛtyamanuttamam |	iti te kathitam devi prātar kṛtyam anuttamam 
SA_MB_taaraatantramHK-68	gopanīyaṃ mamaprītikṛte'vaśyaṃ sureśvari || 1/29 ||	gopanīyam mama prīti kṛta ivaśyam sureśvari 
SA_MB_taaraatantramHK-69	|| iti śrītārātantre prathamaḥ paṭalaḥ ||	iti śrī tārātantre prathamaḥ paṭalaḥ 
SA_MB_taaraatantramHK-70	dvitīyaḥ paṭalaḥ |	dvitīyaḥ paṭalaḥ 
SA_MB_taaraatantramHK-71	śrībhairavyuvāca |	śrī bhairavī uvāca 
SA_MB_taaraatantramHK-72	śrutametanmahābhāga ! prātaḥkṛtyamaho mahat |	śrutam etat mahābhāga prātar kṛtyam aho mahat 
SA_MB_taaraatantramHK-73	mahācīnākhyatantre ca trividhaṃ pūjanaṃ hi yat || 2/1 ||	mahācīna ākhya tantre ca trividham pūjanam hi yat 
SA_MB_taaraatantramHK-74	uktavān buddhadeveśa statra yonyarccanaṃ śrutam |	uktavān buddha deva īśaḥ tatra yoni arccanam śrutam 
SA_MB_taaraatantramHK-75	mānasaṃ yāntrikañcaiva śrotumicchāmi māmpratam || 2/2 ||	mānasam yāntrikam ca eva śrotum icchāmi māmpratam 
SA_MB_taaraatantramHK-76	p. 5) śrībhairava uvāca |	        
SA_MB_taaraatantramHK-77	manaḥ pūjā vidhiṃ vakṣye nyāsaṃ pūrvvaṃ śṛṇu priye ||	manaḥ pūjā vidhim vakṣye nyāsam pūrvvam śṛṇu priye 
SA_MB_taaraatantramHK-78	akṛte nyāsajāle hi adhikāro na vidyate || 2/3 ||	akṛte nyāsa jāle hi adhikāraḥ na vidyate 
SA_MB_taaraatantramHK-79	ṛṣyādinyāsakañcaiva karāṅganyāsa eva ca |	ṛṣi ādi nyāsakaḥ ca eva kara aṅga nyāsaḥ eva ca 
SA_MB_taaraatantramHK-80	varṇa vyāpakavinyāsau pīṭhanyāsa stataḥ param || 2/4 ||	           
SA_MB_taaraatantramHK-81	akṣobhyaśca ṛṣiḥ prokto vṛhatī cchanda īritam |	akṣobhyaḥ ca ṛṣiḥ proktaḥ vṛhatī chandaḥ īritam 
SA_MB_taaraatantramHK-82	ugratārā devatoktā kūrccavījasudāhṛtam || 2/5 ||	ugratārā devatā uktā 
SA_MB_taaraatantramHK-83	śaktirastraṃ śeṣavarṇāḥ kīlakāni bhavantyuta |	śaktiḥ astram śeṣa varṇāḥ kīlakāni bhavanti uta 
SA_MB_taaraatantramHK-84	akhilavāgrūpiṇīmuktvā hṛdayāya namo vadet || 2/6 ||	akhila vāc rūpiṇīm uktvā hṛdayāya namaḥ vadet  /
SA_MB_taaraatantramHK-85	akhaṇḍavāgrūpiṇīmuktvā śirase vahnivallabhā |	akhaṇḍa vāc rūpiṇīm uktvā śirase vahni vallabhā 
SA_MB_taaraatantramHK-86	brahmavāgrūpiṇīmuktvā śikhāyai vaṣaḍityapi || 2/7 ||	brahma vāc rūpiṇīm uktvā śikhāyai vaṣaṭ iti api 
SA_MB_taaraatantramHK-87	viṣṇuvāgrūpiṇīmuktvā kavacāya imīritam |	viṣṇu vāc rūpiṇīm uktvā kavacāya 
SA_MB_taaraatantramHK-88	viṣṇuvāgrūpiṇī netratrayāya vauṣaḍityapi || 2/8 ||	viṣṇu vāc rūpiṇī netratrayāya vauṣaṭ iti api 
SA_MB_taaraatantramHK-89	sarvvavāgrūpiṇīmuktvā astrāya phaḍiti smaret |	sarvva vāgrūpiṇīm uktvā astrāya phaṭ iti smaret 
SA_MB_taaraatantramHK-90	ṣaḍdīrghamāyayā caiva vījānāmeva coccaret || 2/9 ||	ṣaṣ dīrgha māyayā ca eva vījānām eva ca uccaret  /
SA_MB_taaraatantramHK-91	aṅgasthāne'ṅgulīnāntu pāṇito yojanañcaret |	aṅgasthāna iṅgulīnām tu pāṇitaḥ yojanam caret 
SA_MB_taaraatantramHK-92	ādiḹvarṇaparyyantān hṛdaye vinyaset priye || 2/10 ||	ādiḥ varṇa paryyantān hṛdaye vinyaset priye 
SA_MB_taaraatantramHK-93	ekārādyān ṅādiḍhāntān krameṇa bāhuyugmake |	ekāra ādyān ṅādi ḍha antān krameṇa bāhu yugmake 
SA_MB_taaraatantramHK-94	ṇādibhāntān makārādikṣāntān jaṅghādvaye priye ! || 2/11 ||	ṇa ādi bha antān makāra ādi kṣa antān jaṅghā dvaye priye 
SA_MB_taaraatantramHK-95	p. 6) mūlena vyāpakaṃ nyasya pīṭhanyāsaṃ samācaret |	              
SA_MB_taaraatantramHK-96	hṛtsaroje sudhāsindhuṃ madhye dvīpaṃ suvarṇajam || 2/12 ||	hṛd saroje sudhā sindhum madhye dvīpam suvarṇa jam 
SA_MB_taaraatantramHK-97	paritaḥ pārijātāṃśca madhye kalpataruṃ tataḥ |	paritas pārijātān ca madhye kalpatarum tatas 
SA_MB_taaraatantramHK-98	tanmūle hemanirmmāṇaṃ dvāścatuṣṭaya bhūṣitam || 2/13 ||	tad mūle hema nirmmāṇam bhūṣitam 
SA_MB_taaraatantramHK-99	maṇḍapaṃ mandavātena parākrāntaṃ sudhūpitam |	maṇḍapam manda vātena parākrāntam su dhūpitam 
SA_MB_taaraatantramHK-100	tatra yantraṃ pratiṣṭhāpya tatra pūjāṃ samācaret || 2/14 ||	tatra yantram pratiṣṭhāpya tatra pūjām samācaret  /
SA_MB_taaraatantramHK-101	evaṃ pīṭhamaye dehe cintayedugratāriṇīm |	evam pīṭha maye dehe cintayet ugra tāriṇīm 
SA_MB_taaraatantramHK-102	hṛdipāṇyagramādāya jīvanyāsaṃ samācaret || 2/15 ||	hṛdi pāṇi agram ādāya jīva nyāsam samācaret  /
SA_MB_taaraatantramHK-103	iti te kathitaṃ kānte ! nyāsajālamanuttamam |	iti te kathitam kānte nyāsa jālam anuttamam 
SA_MB_taaraatantramHK-104	paripāṭī gurorjñeyā nyāsānāṃ racanaṃ priye || 2/16 ||	paripāṭī guroḥ jñeyā nyāsānām racanam priye 
SA_MB_taaraatantramHK-105	tataḥ pūjāṃ prakurvvīta yena tanmayatāmiyāt |	tatas pūjām prakurvvīta yena tad maya tām iyāt 
SA_MB_taaraatantramHK-106	snāyācca vimale tīrthe puṣkare hṛdayāśrite || 2/17 ||	snāyāt ca vimale tīrthe puṣkare hṛdaya āśrite 
SA_MB_taaraatantramHK-107	śivaśakti samāyogaḥ sandhyā proktā ca tāntrikaiḥ |	śiva śakti samāyogaḥ sandhyā proktā ca tāntrikaiḥ 
SA_MB_taaraatantramHK-108	vinducyutasudhābhi stāṃ tarpayet prāṇavallabhe ! || 2/18 ||	vindu cyuta sudhābhiḥ stām tarpayet prāṇa vallabhe 
SA_MB_taaraatantramHK-109	tata statpaparivārādīn tatśarīre vilāpya ca |	tatas tad pa parivāra ādīn tad śarīre vilāpya ca 
SA_MB_taaraatantramHK-110	udvarttanādikaṃ dattvā snāpayeddivyavāriṇā || 2/19 ||	udvarttana ādikam dattvā snāpayet divya vāriṇā 
SA_MB_taaraatantramHK-111	mṛduvastreṇa saṃmārjya nayane kajjalaṃ dadet |	mṛdu vastreṇa saṃmārjya nayane kajjalam dadet 
SA_MB_taaraatantramHK-112	lalāṭe caiva sindūraṃ alaktaṃ caraṇāmbuje || 2/20 ||	lalāṭe ca eva sindūram alaktam caraṇa ambuje 
SA_MB_taaraatantramHK-113	p. 7) cintayenmanasā mūrtiṃ sarvālaṅkārabhūṣitām |	cintayet manasā mūrtim sarva alaṅkāra bhūṣitām 
SA_MB_taaraatantramHK-114	tataḥ so'hamiti dhyātvā pādyaṃ dadyāt padoḥ priye || 2/21 ||	tatas saḥ ham iti dhyātvā pādyam dadyāt padoḥ priye 
SA_MB_taaraatantramHK-115	maulāvarghyaṃ mukhe toyaṃ gandho'ṅge sarvataḥ kṣipet |	maulau arghyam mukhe toyam gandha uṅge sarvatas kṣipet 
SA_MB_taaraatantramHK-116	sugandhi - śvetalauhityaṃ javāṃ kṛṣṇāparājitām || 2/22 ||	sugandhi śvetalauhityam javām kṛṣṇa aparājitām 
SA_MB_taaraatantramHK-117	pade śīrṣe tathā karṇe kaṇṭhe mālāṃ nidhāpayet |	pade śīrṣe tathā karṇe kaṇṭhe mālām nidhāpayet 
SA_MB_taaraatantramHK-118	sammukhe dhūpadīpau ca naivedyaṃ bhojayedatha || 2/23 ||	sammukhe dhūpa dīpau ca naivedyam bhojayet atha 
SA_MB_taaraatantramHK-119	kāraṇaṃ palalaṃ bhūyaḥ kāraṇaṃ mīnamuttamam |	kāraṇam palalam bhūyas kāraṇam mīnam uttamam 
SA_MB_taaraatantramHK-120	punaśca kāraṇaṃ deyaṃ tato bharjjitaśālijam || 2/24 ||	punar ca kāraṇam deyam tatas bharjita śāli jam 
SA_MB_taaraatantramHK-121	punarmadyaṃ tato'pūpaśaṣkulīṃ devi ! dāpayet |	punar madyam tata upūpa śaṣkulīm devi dāpayet 
SA_MB_taaraatantramHK-122	tato madyaṃ pradāyaiva nānā - temana - saṃyutam * || 2/25 ||	tatas madyam pradāya eva nānā    
SA_MB_taaraatantramHK-123	dadhikṣīrājyasahitaṃ dāpayedodanaṃ priye ! |	dadhi kṣīra ājya sahitam dāpayet odanam priye 
SA_MB_taaraatantramHK-124	ācamanaṃ tato dadyāttāmbūlaṃ vinivedayet || 2/26 ||	ācamanam tatas dadyāt tāmbūlam vinivedayet 
SA_MB_taaraatantramHK-125	tato vai mānasaṃ jāpaṃ kṛtvā tarpaṇa mācaret |	tatas vai mānasam jāpam kṛtvā tarpaṇa mācaret 
SA_MB_taaraatantramHK-126	stutvā natvā tattadaṅgadevatā [:] prāpayedatha || 2/27 ||	stutvā natvā tad tad aṅga devatāḥ prāpayet atha 
SA_MB_taaraatantramHK-127	sva sva sthānaṃ tataḥ śeṣaṃ śaktibhirbhojayet svayam |	sva sva sthānam tatas śeṣam śaktibhiḥ bhojayet svayam 
SA_MB_taaraatantramHK-128	tataḥ sohamiti dhyāyedātmānaṃ tāriṇīmayam || 2/28 ||	tatas saḥ ham iti dhyāyet ātmānam tāriṇī mayam 
SA_MB_taaraatantramHK-129	idaṃ mānasamākhyātam pūjanaṃ devi ! durlabham |	idam mānasam ākhyātam pūjanam devi durlabham 
SA_MB_taaraatantramHK-130	ekāntanirmalaṃ cittaṃ hṛdambhojārccanāt priye || 2/29 ||	ekānta nirmalam cittam hṛd ambhoja arccanāt priye 
SA_MB_taaraatantramHK-131	p. 8) gurvarccocita kāle ca prātarmadhyāhnato'pi vā |	kāle ca vā 
SA_MB_taaraatantramHK-132	karttavya metadvidhivadgurupādaprasādataḥ || 2/30 ||	karttavyam etat vidhivat guru pāda prasādataḥ 
SA_MB_taaraatantramHK-133	athātaḥ saṃpravakṣyāmi pūjāṃ yantrasamīritām |	atha atas saṃpravakṣyāmi pūjām yantra samīritām 
SA_MB_taaraatantramHK-134	atha yāgagṛhaṃ gatvā puṣpāharaṇamācaret || 2/31 ||	atha yāga gṛham gatvā puṣpa āharaṇam ācaret 
SA_MB_taaraatantramHK-135	śatābhiṣeketi padaṃ dviruccārya tato vadet |	śata abhiṣeka iti padam dvis uccārya tatas vadet 
SA_MB_taaraatantramHK-136	kūrcāstravahnilalanā tārādyaḥ puṣpakarṣaṇe || 2/32 ||	            
SA_MB_taaraatantramHK-137	māyāṃ pūrvaṃ samucārya ādhāraśaktisaṃvadet |	māyām pūrvam samucārya ādhāra śakti saṃvadet 
SA_MB_taaraatantramHK-138	kamalāsanaṃ ṅentañca hṛnmanuścāsanārcane || 2/33 ||	kamalāsanam hṛd manuḥ ca āsana arcane   
SA_MB_taaraatantramHK-139	arghyapātraṃ sthāpayitvā pañcānāṃ śodhanañcaret |	arghya pātram sthāpayitvā pañcānām śodhanam caret 
SA_MB_taaraatantramHK-140	ādau śodhanamevoktaṃ nīlatantre tava priye || 2/34 ||	ādau śodhanam eva uktam nīlatantre tava priye 
SA_MB_taaraatantramHK-141	dvitīyaśodhane devi ! prataddhiṣṇu - manuṃ japet |	dvitīya śodhane devi manum japet 
SA_MB_taaraatantramHK-142	tṛtīyaśodhane devi ! tryambakenaiva mantravit || 2/35 ||	tṛtīya śodhane devi tryambakena eva mantra vid   
SA_MB_taaraatantramHK-143	tadviṣṇoriti mantreṇa caturthaśodhanañcaret |	tat viṣṇoḥ iti mantreṇa caturtha śodhanam caret 
SA_MB_taaraatantramHK-144	pratadviṣṇuriti mantreṇa svayambhvādiviśodhanam || 2/36 ||	pratat viṣṇuḥ iti mantreṇa svayambhu ādi viśodhanam 
SA_MB_taaraatantramHK-145	śaktestu śodhanenaiva maithunaṃ śudhyati priye ! |	śakteḥ tu śodhanena eva maithunam śudhyati priye 
SA_MB_taaraatantramHK-146	tato devi ! mahāyantraṃ kathayāmi tava priye || 2/37 ||	tatas devi mahāyantram kathayāmi tava priye   
SA_MB_taaraatantramHK-147	sayoniṃ candanenāṣṭapatramabjaṃ likhettataḥ |	sa yonim candanena aṣṭa patram abjam likhet tatas 
SA_MB_taaraatantramHK-148	caturasraṃ caturdvāraṃ yantraṃ devi ! samālikhet || 2/38 ||	catur asram catur dvāram yantram devi samālikhet 
SA_MB_taaraatantramHK-149	gaṇeśaṃ prāci saṃpūjya dakṣiṇe vaṭukaṃ yajet |	gaṇeśam prāci saṃpūjya dakṣiṇe vaṭukam yajet 
SA_MB_taaraatantramHK-150	paścime kṣetrapālañca yoginīmuttare yajet || 2/39 ||	paścime kṣetrapālam ca yoginīm uttare yajet  /
SA_MB_taaraatantramHK-151	p. 9) śmāśānaṃ tatra saṃpūjyaṃ tatra kalpadrumaṃ yajet |	śmāśānam tatra saṃpūjyam tatra kalpadrumam yajet 
SA_MB_taaraatantramHK-152	tanmūle maṇipīṭhañca nānāmaṇivibhūṣitam || 2/40 ||	tad mūle maṇi pīṭham ca nānā maṇi vibhūṣitam 
SA_MB_taaraatantramHK-153	nānālaṅkāra - bhūṣāḍhyaṃ munidevaiśca maṇḍitam |	nānā alaṅkāra bhūṣā āḍhyam muni devaiḥ ca maṇḍitam 
SA_MB_taaraatantramHK-154	śivābhirvahumāṃsāsthi - modamānābhirantataḥ || 2/41 ||	śivābhiḥ vahu māṃsa asthi modamānābhiḥ antatas 
SA_MB_taaraatantramHK-155	caturddikṣu śavān muṇḍāṃścitāṅgārāsthibhūṣitān |	catur dikṣu śavān muṇḍān citā aṅgāra asthi bhūṣitān 
SA_MB_taaraatantramHK-156	(caturdikṣu śavamuṇḍacitāṅgārāsthi - bhūṣitam)	catur dikṣu śava muṇḍa cita aṅgāra asthi bhūṣitam 
SA_MB_taaraatantramHK-157	hasauḥ sadāśivetyuktvā mahāpreta tataḥ param || 2/42 ||	hasauḥ sadāśiva iti uktvā mahā preta tatas param 
SA_MB_taaraatantramHK-158	padmāsanāya hṛdayaṃ pīṭhanyāsamanurmataḥ |	padmāsanāya hṛdayam pīṭhanyāsa manuḥ mataḥ 
SA_MB_taaraatantramHK-159	lakṣmīḥ sarasvatī caiva ratiḥ prīti stathaiva ca || 2/43 ||	lakṣmīḥ sarasvatī ca eva ratiḥ prītiḥ tathā eva ca 
SA_MB_taaraatantramHK-160	kīrttiḥ śāntiśca puṣṭhiśca tuṣṭi rityaṣṭaśaktayaḥ |	kīrttiḥ śāntiḥ ca puṣṭhiḥ ca tuṣṭiḥ iti aṣṭa śaktayaḥ 
SA_MB_taaraatantramHK-161	etāḥ pūjyāḥ patradeśe krameṇa prāṇaballabhe || 2/44 ||	etāḥ pūjyāḥ patra deśe krameṇa prāṇa ballabhe  /
SA_MB_taaraatantramHK-162	tataḥ puṣpāñjaliṃ nītvā kūrmatattvena kaulikaḥ |	tatas puṣpa añjalim nītvā kūrma tattvena kaulikaḥ 
SA_MB_taaraatantramHK-163	hṛdaye dyautanaṃ tejaḥ parivārasamanvitam || 2/45 ||	hṛdaye dyautanam tejaḥ parivāra samanvitam 
SA_MB_taaraatantramHK-164	yaṃkārāditayā devi ! śavopari nidhāpayet |	yaṃkāra āditayā devi śava upari nidhāpayet 
SA_MB_taaraatantramHK-165	āṃ sohamiti mantreṇa jīvanyāsaṃ samācaret || 2/46 ||	ām soham iti mantreṇa jīva nyāsam samācaret 
SA_MB_taaraatantramHK-166	tataḥ pādyādinā devi ! pūjayedugratāriṇīm |	tatas pādya ādinā devi pūjayet ugratāriṇīm 
SA_MB_taaraatantramHK-167	namaḥ svāhā svadhāñcaiva namo vauṣaṭ tathā kramāt || 2/47 ||	namaḥ svāhā svadhām ca eva namaḥ vauṣaṭ tathā kramāt 
SA_MB_taaraatantramHK-168	tato nivedayāmīti sarvaṃ dadyānmaheśvari !	tatas nivedayāmi iti sarvam dadyāt maheśvari 
SA_MB_taaraatantramHK-169	idaṃ dravyaṃ tataḥ procya devatābodhanaṃ tataḥ || 2/48 ||	idam dravyam tatas procya devatā bodhanam tatas 
SA_MB_taaraatantramHK-170	p. 10) vajrapuṣpaṃ praticchedaṃ hū/ - phaṭ - svāhā tato vadet |	vajrapuṣpam praticchedam hū phaṭ svāhā tatas vadet 
SA_MB_taaraatantramHK-171	mūlamantraṃ samuccārya ṅentaṃ nāma niyojayet || 2/49 ||	mūlamantram samuccārya ṅentam nāma niyojayet  /
SA_MB_taaraatantramHK-172	tataśca parivārāṇi pūjayeddevi ! kauntikaḥ |	tatas ca parivārāṇi pūjayet devi kauntikaḥ 
SA_MB_taaraatantramHK-173	idaṃ dravyaṃ samucārya parivārebhyo namo'ntataḥ || 2/50 ||	idam dravyam samucārya parivārebhyaḥ namontataḥ 
SA_MB_taaraatantramHK-174	praṇavādyena manunā kulīnaḥ pūjanañcaret |	praṇava ādyena manunā kulīnaḥ pūjanam caret 
SA_MB_taaraatantramHK-175	akṣobhyaṃ * maulideśe tu prāgādyaṣṭadaleṣu ca || 2/51 ||	akṣobhyam mauli deśe tu prāc ādi aṣṭadaleṣu ca 
SA_MB_taaraatantramHK-176	śaktayo'ṣṭau bhairavāṃśca dvāreṣu caturaḥ surān |	śaktayā uṣṭau bhairavān ca dvāreṣu caturaḥ surān 
SA_MB_taaraatantramHK-177	vāyavyādīśaparyantaṃ gurupaṅktirvyavasthitā || 2/52 ||	vāyavya ādi īśa paryantam guru paṅktiḥ vyavasthitā 
SA_MB_taaraatantramHK-178	tato japtvā stavaiḥ stutvā natvā ca visṛjeddhṛdi |	tatas japtvā stavaiḥ stutvā natvā ca visṛjet hṛdi 
SA_MB_taaraatantramHK-179	naivedyaṃ sādhakebhyaśca strībhyo dadyānna kutracit || 2/53 ||	naivedyam sādhakebhyaḥ ca strībhyaḥ dadyāt na kutracid 
SA_MB_taaraatantramHK-180	iti te kathitaṃ bhadre ! tārāyāḥ pūjanaṃ mahat |	iti te kathitam bhadre tārāyāḥ pūjanam mahat 
SA_MB_taaraatantramHK-181	mānasaṃ yāntrikañcaiva nityaṃ nṛṇāmiti smṛtam || 2/54 ||	mānasam yāntrikam ca eva nityam nṛṇām iti smṛtam 
SA_MB_taaraatantramHK-182	nādhikāro yaunike ca strīṇāṃ mānasa - yantrayoḥ |	na adhikāraḥ yaunike ca strīṇām mānasa yantrayoḥ 
SA_MB_taaraatantramHK-183	vidheyaṃ pūjanaṃ devi ! na kuryādvā nijecchayā || 2/55 ||	vidheyam pūjanam devi na kuryāt vā nija icchayā 
SA_MB_taaraatantramHK-184	|| iti śrītārātantre dvitīyaḥ paṭalaḥ ||	iti śrī tārātantre dvitīyaḥ paṭalaḥ 
SA_MB_taaraatantramHK-185	tṛtīyaḥ paṭalaḥ	tṛtīyaḥ paṭalaḥ 
SA_MB_taaraatantramHK-186	śrībhairava uvāca |	śrī bhairavaḥ uvāca 
SA_MB_taaraatantramHK-187	athātaḥ saṃpravakṣyāmi śṛṇu tvaṃ parvatātmaje |	atha atas saṃpravakṣyāmi śṛṇu tvam parvatātmaje 
SA_MB_taaraatantramHK-188	pātramekaṃ dvayaṃ vāpi trayaṃ vā pañca vā priye || 3/1 ||	pātram ekam dvayam vā api trayam vā pañca vā priye  /
SA_MB_taaraatantramHK-189	pivedvīravaraśreṣṭho yaḥ sa rudra itīritam |	pivet vīra vara śreṣṭhaḥ yaḥ sa rudraḥ iti īritam 
SA_MB_taaraatantramHK-190	sambidānandayogena yaḥ kāraṇamado bhavet || 3/2 ||	sambid ānanda yogena yaḥ kāraṇa madaḥ bhavet 
SA_MB_taaraatantramHK-191	sa eva paramānando brahmasāyujyadāyakaḥ |	             
SA_MB_taaraatantramHK-192	tasmādbhuktvā siddhimūlaṃ sādhakaḥ kāraṇaṃ pivet || 3/3 ||	tasmāt bhuktvā siddhi mūlam sādhakaḥ kāraṇam pivet 
SA_MB_taaraatantramHK-193	vinānandaṃ sambidāyāḥ pānaṃ yatkāraṇasya ca |	vinā ānandam sambidāyāḥ pānam yad kāraṇasya ca 
SA_MB_taaraatantramHK-194	tanna cānanda - janakaṃ bauddhadeva - vaco yathā || 3/4 ||	tat na ca ānanda janakam bauddhadeva vacaḥ yathā 
SA_MB_taaraatantramHK-195	pūjyoḥ guruḥ sadā cātra tadvattattanayopi ca |	guruḥ sadā ca atra tadvat tad tanayaḥ api ca 
SA_MB_taaraatantramHK-196	tatpatnī sarvabhāvena sadā kaulikapūruṣaiḥ || 3/5 ||	tad patnī sarva bhāvena sadā kaulika pūruṣaiḥ 
SA_MB_taaraatantramHK-197	tasyāḥ santoṣamātrena devī tuṣṭā bhavet priye ! |	tasyāḥ santoṣa mātrena devī tuṣṭā bhavet priye 
SA_MB_taaraatantramHK-198	tasmāt stotrairdhanairvākyai stoṣayet brahmadāyakam || 3/6 ||	tasmāt stotraiḥ dhanaiḥ vākyaiḥ stoṣayet brahma dāyakam 
SA_MB_taaraatantramHK-199	naktaṃ japavidhānañca śṛṇuṣvaikamanāḥ priye ! |	naktam japa vidhānam ca śṛṇuṣva ekamanāḥ priye 
SA_MB_taaraatantramHK-200	ādau ṣaṅaṅgaṃ vinyasya gurordhyānaṃ tataḥparam || 3/7 ||	ādau ṣaṅ aṅgam vinyasya guroḥ dhyānam tatas param 
SA_MB_taaraatantramHK-201	mantradhyānaṃ * tataḥpaścāt devaudhyānaṃ tataścaret |	mantra dhyānam tatas paścāt devaudhyānam tatas caret 
SA_MB_taaraatantramHK-202	seturūpaṃ tata stāraṃ japtvā japamathācaret || 3/8 ||	setu rūpam tatas tāram japtvā japam atha ācaret  /
SA_MB_taaraatantramHK-203	p. 12) punastāraṃ tato devīdhyānaṃ kṛtvā samarpayet |	punar tāram tatas devī dhyānam kṛtvā samarpayet 
SA_MB_taaraatantramHK-204	śivo'haṃ tāriṇīrūpamātmānamiti cintayet || 3/9 ||	śivaḥ ūham tāriṇī rūpam ātmānam iti cintayet 
SA_MB_taaraatantramHK-205	parivāramayaścāhamiti dhyāyedanāratam |	parivāra mayaḥ ca aham iti dhyāyet anāratam 
SA_MB_taaraatantramHK-206	iti te kathitaṃ devi ! rahasyaṃ tāriṇīmayam || 3/10 ||	iti te kathitam devi rahasyam tāriṇī mayam   /
SA_MB_taaraatantramHK-207	na deyaṃ paśave tasmāt śapatho me tvayi priye ! || 3/11 ||	na deyam paśave tasmāt śapathaḥ me tvayi priye 
SA_MB_taaraatantramHK-208	|| iti śrītārātantre tṛtīyaḥ paṭalaḥ ||	iti śrī tārātantre tṛtīyaḥ paṭalaḥ 
SA_MB_taaraatantramHK-209	caturthaḥ paṭalaḥ	caturthaḥ paṭalaḥ 
SA_MB_taaraatantramHK-210	śrībhairavyuvāca |	śrī bhairavī uvāca 
SA_MB_taaraatantramHK-211	yat prasādādidaṃ sarvaṃ kulācāravidhānakam |	yat prasādāt idam sarvam kula ācāra vidhānakam 
SA_MB_taaraatantramHK-212	tasyaivādyantamāhātmyaṃ śrotumicchāmi sāmpratam || 4/1 ||	tasya eva ādi anta māhātmyam śrotum icchāmi sāmpratam 
SA_MB_taaraatantramHK-213	śrībhairava uvāca |	śrī bhairavaḥ uvāca 
SA_MB_taaraatantramHK-214	guruḥ paramaguruścaiva parāparagurustathā |	guruḥ parama guruḥ ca eva para apara guruḥ tathā 
SA_MB_taaraatantramHK-215	parameṣṭiguruścaiva catvāro guravaḥ smṛtāḥ || 4/2 ||	parama iṣṭi guruḥ ca eva catvāraḥ guravaḥ smṛtāḥ 
SA_MB_taaraatantramHK-216	ṛṣiratra guruḥ prokto mantradaḥ paramo guruḥ |	ṛṣiḥ atra guruḥ proktaḥ mantra daḥ paramaḥ guruḥ 
SA_MB_taaraatantramHK-217	parāparaguruścāhaṃ tvameva parameṣṭikā || 4/3 ||	para apara guruḥ ca aham tvam eva parama iṣṭikā 
SA_MB_taaraatantramHK-218	sarveṣāmeva madhye tu pradhānaṃ paramo guruḥ |	sarveṣām eva madhye tu pradhānam paramaḥ guruḥ 
SA_MB_taaraatantramHK-219	gurorvinā mahāmokṣaṃ na kāśī na ca gaṅgayā (?) || 4/4 ||	guroḥ vinā mahāmokṣam na kāśī na ca gaṅgayā  /
SA_MB_taaraatantramHK-220	māhātmyaṃ tasya vakṣyāmi yena tuṣṭā ca śāmbhavī |	māhātmyam tasya vakṣyāmi yena tuṣṭā ca śāmbhavī 
SA_MB_taaraatantramHK-221	gurumantreṣṭadevīnāmekatvaṃ parikathyate || 4/5 ||	guru mantra iṣṭa devīnām eka tvam parikathyate 
SA_MB_taaraatantramHK-222	tatpatnī ca viśeṣeṇa paradevīviśeṣabhāk |	tad patnī ca viśeṣeṇa para devī viśeṣa bhāj 
SA_MB_taaraatantramHK-223	saralyā'saralā vāpi niṣṭhurā vā priyoditā || 4/6 ||	saralī a saralā vā api niṣṭhurā vā priya uditā 
SA_MB_taaraatantramHK-224	p. 14) kutsitā vyādhitā vāpi mūḍhā'mūḍhāpi vā priye |	kutsitā vyādhitā vā api mūḍha amūḍhā api vā priye 
SA_MB_taaraatantramHK-225	sadeṣṭadevobhāvena bhāvanīyā kulottamaiḥ || 4/7 ||	sadā iṣṭa devaḥ bhāvena bhāvanīyā kula uttamaiḥ 
SA_MB_taaraatantramHK-226	tattanujoditañcaiva yadvā sādhakabhāṣitam |	tat tanuja uditam ca eva yat vā sādhaka bhāṣitam 
SA_MB_taaraatantramHK-227	yatnenaiva vidhātavyamaśakye yatnavān bhavet || 4/8 ||	yatnena eva vidhātavyam aśakye yatnavān bhavet 
SA_MB_taaraatantramHK-228	vīrocchiṣṭaṃ vināmadyaṃ śaktyucchiṣṭaṃ tadapyuta |	vīra ucchiṣṭam vinā amadyam śakti ucchiṣṭam tat api uta 
SA_MB_taaraatantramHK-229	bhojayennirvikalpena manasā vīravallabhaḥ || 4/9 ||	bhojayet nirvikalpena manasā vīra vallabhaḥ 
SA_MB_taaraatantramHK-230	purā proktāni pañcaiva ekaṃ vā śṛṇu bhairavi ! |	purā proktāni pañca eva ekam vā śṛṇu bhairavi 
SA_MB_taaraatantramHK-231	śodhayitvā nivedyaiva yo'śnīyāt sa ca bhairavaḥ || 4/10 ||	śodhayitvā nivedya eva yaḥ ūśnīyāt sa ca bhairavaḥ 
SA_MB_taaraatantramHK-232	susiddhāḥ pīṭhasaṃsthā ye sādhakā ste'rcanāśrayāḥ |	su siddhāḥ pīṭha saṃsthāḥ ye sādhakāḥ 
SA_MB_taaraatantramHK-233	guru taddayitāputraputrī - sādhakayoṣitāṃ || 4/11 ||	guru tad dayitā putra putrī sādhaka yoṣitām 
SA_MB_taaraatantramHK-234	yatnecchā vartate tattu samarpyaṃ parameśvari ! |	yatna icchā vartate tat tu samarpyam parameśvari 
SA_MB_taaraatantramHK-235	avaśyaṃ tāriṇīmantre śaktipūjā vidhīyate || 4/12 ||	avaśyam tāriṇī mantre śakti pūjā vidhīyate 
SA_MB_taaraatantramHK-236	nijakānteṣṭhadevī tu pūjanīyā viśeṣataḥ |	nija kānteṣṭha devī tu pūjanīyā viśeṣataḥ 
SA_MB_taaraatantramHK-237	samānadevatāmantraṃ nijakrāntā japedyadi || 4/13 ||	samāna devatā mantram nija krāntā japet yadi 
SA_MB_taaraatantramHK-238	tadā sarvārthasiddhiḥ syāt tuṣṭā bhavati tāriṇo |	tadā sarva artha siddhiḥ syāt tuṣṭā bhavati 
SA_MB_taaraatantramHK-239	śarīrārdhaṃ smṛtā kāntā yasmāttadyatnavān bhavet || 4/14 ||	śarīra ardham smṛtā kāntā yasmāt tat yatnavān bhavet 
SA_MB_taaraatantramHK-240	tasyāḥ kiñcicca māhātmyaṃ cīnatantre mayoditam |	tasyāḥ kiñcid ca māhātmyam cīna tantre mayā uditam 
SA_MB_taaraatantramHK-241	maithune varjanīyā yā stāsāṃ vidhi rihocyate || 4/15 ||	maithune varjanīyāḥ yāḥ stāsām vidhiḥ riha ucyate 
SA_MB_taaraatantramHK-242	p. 15) gurupatnī gurusutā guruputrabadhū stathā |	guru patnī guru sutā guru putra badhūḥ stathā 
SA_MB_taaraatantramHK-243	satīrthasya tu vīrasya sādhakasya tathā priye ! || 4/16 ||	sa tīrthasya tu vīrasya sādhakasya tathā priye    
SA_MB_taaraatantramHK-244	kāntāyā mantraputryāśca ramaṇānnārakī bhavet |	kāntāyāḥ mantraputryāḥ ca ramaṇāt nārakī bhavet 
SA_MB_taaraatantramHK-245	maithunasya vidhānantu kathyate śṛṇu bhairavi ! || 4/17 ||	maithunasya vidhānam tu kathyate śṛṇu bhairavi 
SA_MB_taaraatantramHK-246	adhaḥ kṛtvā mahādevīṃ svayaṃ bhairavarūpadhṛk |	adhas kṛtvā mahādevīm svayam bhairava rūpadhṛk 
SA_MB_taaraatantramHK-247	purato mūlamuccārya dharmādharmādikaṃ paṭhan || 4/18 ||	puratas mūlam uccārya dharma adharma ādikam paṭhan 
SA_MB_taaraatantramHK-248	gajatuṇḍākhyatattvena yojayelliṅgabhairavam |	            
SA_MB_taaraatantramHK-249	tasmāt śataṃ viṃśatiṃ vā japtvā tejastu pātayet || 4/19 ||	tasmāt śatam viṃśatim vā japtvā tejaḥ tu pātayet  /
SA_MB_taaraatantramHK-250	mūlānte tu prakāśeti vacanaṃ paripaṭhya ca |	mūla ante tu prakāśa iti vacanam paripaṭhya ca 
SA_MB_taaraatantramHK-251	iti taṃ kathitaṃ devi ! yathoktaṃ buddharūpiṇā || 4/20 ||	iti tam kathitam devi yathā uktam buddha rūpiṇā 
SA_MB_taaraatantramHK-252	siddhipradaṃ samācārād gopanīyaṃ svayonivat || 4/21 ||	siddhi pradam samācārāt gopanīyam sva yoni vat 
SA_MB_taaraatantramHK-253	|| iti tārātantre caturthaḥ paṭalaḥ ||	iti tārātantre caturthaḥ paṭalaḥ 
SA_MB_taaraatantramHK-254	pañcamaḥ paṭalaḥ	pañcamaḥ paṭalaḥ 
SA_MB_taaraatantramHK-255	śrībhairavyuvāca |	śrī bhairavī uvāca 
SA_MB_taaraatantramHK-256	tvatprasādānmahādeva ! jñātametanmayākhilam |	tvad prasādāt mahādeva jñātam etat mayā akhilam 
SA_MB_taaraatantramHK-257	puraścaraṇahīnena mantreṇa na phalaṃ bhavet || 5/1 ||	puraścaraṇa hīnena mantreṇa na phalam bhavet 
SA_MB_taaraatantramHK-258	tasmācca phaladānantu puraścaraṇamucyatām * |	tasmāt ca phala dānam tu puraścaraṇam ucyatām 
SA_MB_taaraatantramHK-259	p. 16) śrībhairava ucāca |	        
SA_MB_taaraatantramHK-260	athātaḥ saṃpravakṣyāmi puraścaraṇamuttamam |	atha atas saṃpravakṣyāmi puraścaraṇam uttamam 
SA_MB_taaraatantramHK-261	kuje vā śanivāre vā naramuṇḍaṃ samāharet || 5/2 ||	kuje vā śanivāre vā nara muṇḍam samāharet 
SA_MB_taaraatantramHK-262	vitastimātre khāte tu nikhanet saṅgavarjitaḥ |	vitasti mātre khāte tu nikhanet saṅga varjitaḥ 
SA_MB_taaraatantramHK-263	tatra naktaṃ daśaśataṃ prajapenmantrasiddhaye || 5/3 ||	tatra naktam daśa śatam prajapet mantra siddhaye 
SA_MB_taaraatantramHK-264	anenaiva vidhānena puraścaryā vidhīyate |	anena eva vidhānena puraścaryā vidhīyate 
SA_MB_taaraatantramHK-265	athavānyaprakāreṇa puraścaraṇamucyate || 5/4 ||	athavā anya prakāreṇa puraścaraṇam ucyate 
SA_MB_taaraatantramHK-266	guruṃ taddayitāṃ vāpi tatsutaṃ tatsutāñca vā |	gurum tad dayitām vā api tad sutam tad sutān ca vā 
SA_MB_taaraatantramHK-267	devavat pūjanaṃ kṛtvā japettāvad varānane ! || 5/5 ||	deva vat pūjanam kṛtvā japet tāvat varānane  /
SA_MB_taaraatantramHK-268	aṣṭādhikaṃ śataṃ vāpi puraścaraṇamucyate |	aṣṭa adhikam śatam vā api puraścaraṇam ucyate 
SA_MB_taaraatantramHK-269	athavā mūrddhnipadme tu dhyātvā pūjāṃ vidhyāya ca || 5/6 ||	athavā mūrddhni padme tu dhyātvā pūjām vidhyāya ca 
SA_MB_taaraatantramHK-270	aṣṭādhika sahasrañca japedbhairavarūpadhṛk |	japet bhairava rūpadhṛk 
SA_MB_taaraatantramHK-271	anenaiva vidhānena puraścaraṇamucyate || 5/7 ||	anena eva vidhānena puraścaraṇam ucyate 
SA_MB_taaraatantramHK-272	athavānyaprakāreṇa puraścaraṇamucyate |	athavā anya prakāreṇa puraścaraṇam ucyate 
SA_MB_taaraatantramHK-273	caturdaśīṃ samārabhya yāvadanyā caturdaśī || 5/8 ||	caturdaśīm samārabhya yāvat anyā caturdaśī 
SA_MB_taaraatantramHK-274	sahasraṃ pratyahaṃ sāṣṭaṃ japet siddhīśvaro bhavet |	sahasram pratyaham sāṣṭam japet siddhīśvaraḥ bhavet 
SA_MB_taaraatantramHK-275	etat sarvaṃ śmaśāne ca rātrau vīrairvidhīyate || 5/9 ||	etat sarvam śmaśāne ca rātrau vīraiḥ vidhīyate 
SA_MB_taaraatantramHK-276	iti te kathitaṃ bhadre ! puraścaraṇamuttamam |	iti te kathitam bhadre puraścaraṇam uttamam 
SA_MB_taaraatantramHK-277	gopanīyaṃ prayatnena jananyā jāravat priye ! || 5/10 ||	gopanīyam prayatnena jananyā jāra vat priye 
SA_MB_taaraatantramHK-278	jīvahīno yathā dehī sarvakarmasu na kṣamaḥ |	jīva hīnaḥ yathā dehī sarva karmasu na kṣamaḥ 
SA_MB_taaraatantramHK-279	puraścaraṇahīno'pi tathā mantraḥ prakīrtitaḥ || 5/11 ||	puraścaraṇa hīnaḥ api tathā mantraḥ prakīrtitaḥ 
SA_MB_taaraatantramHK-280	sakṛt dvidhā tridhā vāpi caturddhā yugabhedataḥ |	sakṛt dvidhā tridhā vā api caturddhā yuga bhedataḥ 
SA_MB_taaraatantramHK-281	kartavyañca prayatnena puraścaraṇamuttamam || 5/12 ||	kartavyam ca prayatnena puraścaraṇam uttamam 
SA_MB_taaraatantramHK-282	idānīṃ raktadānasya vidhānaṃ varavarṇini ! |	idānīm rakta dānasya vidhānam varavarṇini 
SA_MB_taaraatantramHK-283	grāmyāraṇyajalasthānāṃ rudhiraṃ prītibarddhanam || 5/13 ||	grāmya āraṇya jala sthānām rudhiram prīti barddhanam 
SA_MB_taaraatantramHK-284	ghṛtāktaṃ madhunāktañca viśeṣāt prāṇaballabhe ! |	ghṛta aktam madhunā aktam ca viśeṣāt prāṇa ballabhe 
SA_MB_taaraatantramHK-285	janturaktena sampūrṇa - kalasāt parvatātmaje ! || 5/14 ||	jantu raktena sampūrṇa kalasāt parvatātmaje     
SA_MB_taaraatantramHK-286	tilapramāṇaṃ rudhiraṃ nijadehasya śasyate |	tila pramāṇam rudhiram nija dehasya śasyate 
SA_MB_taaraatantramHK-287	lalāṭa - hasta - hṛdaya śirobhrūmadhya deśataḥ || 5/15 ||	lalāṭa hasta hṛdaya śiras bhrū madhya deśataḥ  /
SA_MB_taaraatantramHK-288	svadeharudhire datte rudradeha ivāparaḥ |	sva deha rudhire datte rudra dehaḥ iva aparaḥ 
SA_MB_taaraatantramHK-289	brāhmaṇo yadi vā kṣatro vaiśyaḥ śūdraśca eva vā || 5/16 ||	brāhmaṇaḥ yadi vā kṣatraḥ vaiśyaḥ śūdraḥ ca eva vā 
SA_MB_taaraatantramHK-290	pradadyānnijaraktañca mantrayitvā prayatnataḥ |	pradadyāt nija raktam ca mantrayitvā prayatnataḥ 
SA_MB_taaraatantramHK-291	śaktīnāṃ nādhikāro'sti svadeharudhirārpaṇe || 5/17 ||	śaktīnām na adhikāraḥ usti sva deha rudhira arpaṇe 
SA_MB_taaraatantramHK-292	mantrāntaraṃ pravakṣyāmi śṛṇu bhairavi ! sādaram |	mantra antaram pravakṣyāmi śṛṇu bhairavi sādaram 
SA_MB_taaraatantramHK-293	pūrvoktamantrarājasya madhyavījatrayaṃ priye ! || 5/18 ||	            
SA_MB_taaraatantramHK-294	kulvukā nāma devī ca mahānīlasarasvatī |	kulvukā nāma devī ca mahā nīla sarasvatī 
SA_MB_taaraatantramHK-295	ekaiva hi mahādevī nāmamātraṃ tridhā bhavet || 5/19 ||	ekā eva hi mahādevī nāma mātram tridhā bhavet 
SA_MB_taaraatantramHK-296	praṇavavyatirekena tṛtīyaikajaṭā bhavet |	praṇava vyatirekena tṛtīya eka jaṭā bhavet 
SA_MB_taaraatantramHK-297	yathā pañcākṣarī tryarṇā tathā varṇacatuṣṭayam || 5/20 ||	yathā pañca akṣarī tri arṇā tathā varṇa catuṣṭayam 
SA_MB_taaraatantramHK-298	p. 18) māhātmyaṃ na ca bhedaḥ syāt sāmyamityabhidhīyate |	māhātmyam na ca bhedaḥ syāt sāmyam iti abhidhīyate 
SA_MB_taaraatantramHK-299	iti te kathitaṃ tattvaṃ durlabhaṃ mayakā priye || 5/21 ||	iti te kathitam tattvam durlabham priye 
SA_MB_taaraatantramHK-300	gopanīyaṃ prayatnena yoniḥ paranare yathā || 5/22 ||	gopanīyam prayatnena yoniḥ para nare yathā 
SA_MB_taaraatantramHK-301	iti śrītārātantre pañcamaḥ paṭalaḥ ||	iti śrī tārātantre pañcamaḥ paṭalaḥ 
SA_MB_taaraatantramHK-302	ṣaṣṭhaḥ paṭalaḥ	ṣaṣṭhaḥ paṭalaḥ 
SA_MB_taaraatantramHK-303	śrībhairava uvāca |	śrī bhairavaḥ uvāca 
SA_MB_taaraatantramHK-304	athānyat saṃpravakṣyāmi rahasyaṃ tāriṇīmayam |	atha anyat saṃpravakṣyāmi rahasyam tāriṇī mayam 
SA_MB_taaraatantramHK-305	ugrāditrayamantrasya māhātmyaṃ varṇayāmyaham || 6/1 ||	ugra ādi traya mantrasya māhātmyam varṇayāmi aham 
SA_MB_taaraatantramHK-306	saṃkṣepata stathāpīha varṇayāmi maheśvari ! |	saṃkṣepataḥ tathā api iha varṇayāmi maheśvari 
SA_MB_taaraatantramHK-307	tārāmantravido mantrī kālīmantravida stathā || 6/2 ||	tārā mantra vidaḥ mantrī kālī mantra vidaḥ tathā 
SA_MB_taaraatantramHK-308	śivādapyadhiko devi ! nātra kāryaśca saṃśayaḥ |	śivāt api adhikaḥ devi na atra kāryaḥ ca saṃśayaḥ 
SA_MB_taaraatantramHK-309	tārāmantraṃ vinā devi ! kālikāmantrameva ca || 6/3 ||	tārāmantram vinā devi kālikāmantram eva ca 
SA_MB_taaraatantramHK-310	nāpnuyāt parameśāni ! bhogamokṣau yaśaḥśriyau |	na āpnuyāt parameśāni bhoga mokṣau yaśaḥ śriyau 
SA_MB_taaraatantramHK-311	tāriṇīhṛdayajñānī latāsādhana - tatparaḥ || 6/4 ||	          
SA_MB_taaraatantramHK-312	pañcamaprāśanaprājño devairapi namasyate |	pañcama prāśana prājñaḥ devaiḥ api namasyate 
SA_MB_taaraatantramHK-313	nijakāntā - svarūpeṇa nijabandhusvarūpataḥ || 6/5 ||	nija kāntā sva rūpeṇa nija bandhu sva rūpataḥ 
SA_MB_taaraatantramHK-314	p. 19) dāridryeṇa virodhena nyakkārādiprayogataḥ |	dāridryeṇa virodhena nyakkāra ādi prayogataḥ 
SA_MB_taaraatantramHK-315	pīḍādinā vidhīyeta devairbhaṅgo'tra sādhane || 6/6 ||	pīḍā ādinā vidhīyeta devaiḥ bhaṅgā utra sādhane 
SA_MB_taaraatantramHK-316	tasmādyatnena vīrendro gurave vinivedayet |	tasmāt yatnena vīra indraḥ gurave vinivedayet 
SA_MB_taaraatantramHK-317	sarvathā sarvayatnena sarvopāsyā ca tāriṇī || 6/7 ||	sarvathā sarva yatnena sarva upāsyā ca tāriṇī 
SA_MB_taaraatantramHK-318	bhadrābhadravicārañca yaḥ karoti sa durmatiḥ |	bhadra abhadra vicārañca yaḥ karoti sa durmatiḥ 
SA_MB_taaraatantramHK-319	iti te kathitaṃ tattvamanuṣṭheśca samāsataḥ || 6/8 ||	iti te kathitam tattvam anuṣṭheḥ ca samāsatas 
SA_MB_taaraatantramHK-320	darśanādbhaktaśāktā ye sukhante paribhuñjate |	darśanāt bhakta śāktāḥ ye sukhante paribhuñjate 
SA_MB_taaraatantramHK-321	tārātantraṃ cīnatantraṃ kālītantraṃ guruditam || 6/9 ||	tārā tantram cīna tantram kālī tantram guru ditam 
SA_MB_taaraatantramHK-322	sarvathā gopanāyaiva śaktiṃ vakṣaḥsthale'rpayet |	sarvathā gopanāya eva śaktim vakṣaḥ sthala īrpayet 
SA_MB_taaraatantramHK-323	deyaṃ viṣyāya śāntāya sādhakāya mahātmane || 6/10 ||	deyam viṣyāya śāntāya sādhakāya mahātmane 
SA_MB_taaraatantramHK-324	vilāsine svantrāya gurutantrāya suvrate ! |	vilāsine svantrāya guru tantrāya suvrate 
SA_MB_taaraatantramHK-325	anyadyannoktamatrāpi tatsarvaṃ guruvaktrataḥ || 6/11 ||	anyat yat na uktam atra api tat sarvam guru vaktrataḥ 
SA_MB_taaraatantramHK-326	viruddhaṃ vedavāde'pi śrotavyaṃ nātra saṃśayaḥ || 6/12 ||	viruddham veda vāde api śrotavyam na atra saṃśayaḥ 
SA_MB_taaraatantramHK-327	|| iti śrībhairavabhairavīsaṃvāde tārātantre ṣaṣṭhaḥ paṭalaḥ ||	iti śrī bhairava bhairavī saṃvāde tārātantre ṣaṣṭhaḥ paṭalaḥ 
SA_MB_taaraatantramHK-328	[ samāpto'yaṃ granthaḥ ]	samāptaḥ ayam granthaḥ 
SA_MB_taaraatantramHK-329	buddhavaśiṣṭhavṛttāntaḥ	buddha vaśiṣṭha vṛttāntaḥ 
SA_MB_taaraatantramHK-330	[ rudrayāmale saptadaśapaṭalaḥ ]	rudrayāmale saptadaśa paṭalaḥ 
SA_MB_taaraatantramHK-331	vaśiṣṭho brahmaputro'pi cirakālaṃ susādhanam |	vaśiṣṭhaḥ brahma putraḥ api cira kālam susādhanam 
SA_MB_taaraatantramHK-332	cakāra nirjane deśe kṛcchreṇa tapasā vaśī || 7/1 ||	cakāra nirjane deśe kṛcchreṇa tapasā vaśī 
SA_MB_taaraatantramHK-333	ṣaṭsahasraṃ vatsarañca vyāpya yogādisādhanam |	ṣaṣ sahasram vatsaram ca vyāpya yoga ādi sādhanam 
SA_MB_taaraatantramHK-334	tathāpi sākṣād girijā na babhūva mahītale || 7/2 ||	tathā api sākṣāt girijā na babhūva mahī tale 
SA_MB_taaraatantramHK-335	tato jagāma kruddho'sau tātasya nikaṭe prabhuḥ |	tatas jagāma kruddhaḥ asau tātasya nikaṭe prabhuḥ 
SA_MB_taaraatantramHK-336	sarvaṃ tatkathayāmāsa svīyācārakramaṃ prabho ! || 7/3 ||	sarvam tat kathayāmāsa svīya ācāra kramam prabho 
SA_MB_taaraatantramHK-337	anyamantraṃ dehi nātha ! eṣā vidyā na siddhidā |	anya mantram dehi nātha eṣā vidyā na siddhi dā 
SA_MB_taaraatantramHK-338	anyathā sudṛḍhaṃ śāpaṃ tadāgra (tvadagre) pradadāmi hi || 7/4 ||	anyathā su dṛḍham śāpam tadā agra tvad agre pradadāmi hi 
SA_MB_taaraatantramHK-339	tatastaṃ vārayāmāsa evaṃ na kuru bho ! suta ! |	tatas tam vārayāmāsa evam na kuru bho suta 
SA_MB_taaraatantramHK-340	punastāṃ bhaja bhāvena yogamārgeṇa paṇḍitaḥ || 7/5 ||	punar tām bhaja bhāvena yoga mārgeṇa paṇḍitaḥ 
SA_MB_taaraatantramHK-341	tataḥ sā varadā bhūtvā āgamiṣyati te'grataḥ |	tatas sā vara dā bhūtvā āgamiṣyati tegrataḥ 
SA_MB_taaraatantramHK-342	sā devo paramā śaktiḥ sarvasaṅkaṭatāriṇī || 7/6 ||	sā paramā śaktiḥ sarva saṅkaṭa tāriṇī  /
SA_MB_taaraatantramHK-343	koṭisūryaprabhā nīlā candrakoṭisuśītalā |	              
SA_MB_taaraatantramHK-344	sthiravidyullatākoṭisadṛśī kālakāminī || 7/7 ||	sthira vidyut latā koṭi sadṛśī kāla kāminī 
SA_MB_taaraatantramHK-345	p. 22) sarvasvarūpā sarvādyā dharmādharmavivarjitā |	               
SA_MB_taaraatantramHK-346	śuddhacīnācāraratā śakticakrapravartikā || 7/8 ||	          
SA_MB_taaraatantramHK-347	anantānantamahimā saṃsārāṇavatāriṇī |	                
SA_MB_taaraatantramHK-348	buddheśvarī buddhirūpā atharvavedaśākhinī || 7/9 ||	            
SA_MB_taaraatantramHK-349	sā pāti jagatāṃ lokāṃ stasyā karma carācaram |	sā pāti jagatām lokān stasyā karma carācaram 
SA_MB_taaraatantramHK-350	bhaja putra ! sthirānandaḥ kathaṃ śaptuṃ samudyataḥ || 7/10 ||	bhaja putra sthira ānandaḥ katham śaptum samudyataḥ  /
SA_MB_taaraatantramHK-351	ekāntacetasā nityaṃ bhaja putra dayānidhe |	ekānta cetasā nityam bhaja putra dayā nidhe 
SA_MB_taaraatantramHK-352	tasya (syā) darśanamevaṃ hi avaśyaṃ samavāpsyasi || 7/11 ||	tasya syāḥ darśanam evam hi avaśyam samavāpsyasi 
SA_MB_taaraatantramHK-353	etacchrutvā gurorvākyaṃ praṇamya ca punaḥ punaḥ |	etat śrutvā guroḥ vākyam praṇamya ca punar punar 
SA_MB_taaraatantramHK-354	jagāma udadhe stīre vaśī vedāntavit śuciḥ || 7/12 ||	jagāma udadhe stīre vaśī vedānta vid śuciḥ  
SA_MB_taaraatantramHK-355	sahasravatsaraṃ samyak jajāpa paramaṃ japam |	sahasra vatsaram samyak jajāpa paramam japam 
SA_MB_taaraatantramHK-356	ādeśopi na babhūva tataḥ krodhaparo muniḥ || 7/13 ||	ādeśaḥ upi na babhūva tatas krodha paraḥ muniḥ 
SA_MB_taaraatantramHK-357	vyākulātmā mahāvidyāṃ vaśiṣṭhaḥ śaptumudyataḥ |	vyākula ātmā mahā vidyām vasiṣṭhaḥ śaptum udyataḥ 
SA_MB_taaraatantramHK-358	dvirācamya mahāśāpaḥ pradattaśca sudāruṇaḥ || 7/14 ||	dvis ācamya mahā śāpaḥ pradattaḥ ca su dāruṇaḥ 
SA_MB_taaraatantramHK-359	tenaiva muninā nātha ! muneragre kuleśvarī |	tena eva muninā nātha muneḥ agre kula īśvarī 
SA_MB_taaraatantramHK-360	ājagāma mahāvidyā yogināmabhayapradā || 7/15 ||	ājagāma mahā vidyā yoginām abhaya pradā 
SA_MB_taaraatantramHK-361	akāraṇamare vipra ! śāpo dattaḥ sudāruṇaḥ |	akāraṇam are vipra śāpaḥ dattaḥ su dāruṇaḥ 
SA_MB_taaraatantramHK-362	mama pūjāṃ na jānāsi matkulāgamacintanam || 7/16 ||	mama pūjām na jānāsi mad kula āgama cintanam 
SA_MB_taaraatantramHK-363	kathaṃ yogāabhyāsavaśāt matpādāmbhojadarśanam |	katham yoga a abhyāsa vaśāt mad pāda ambhoja darśanam 
SA_MB_taaraatantramHK-364	prāpnoti mānuṣo devo mama dhyānamaduḥkhadam || 7/17 ||	prāpnoti mānuṣaḥ devaḥ mama dhyānam aduḥkha dam 
SA_MB_taaraatantramHK-365	yaḥ kulārthī siddhamantrī mahedācāranirmalam |	yaḥ kula arthī siddha mantrī mahet ācāra nirmalam 
SA_MB_taaraatantramHK-366	mamaiva sādhanaṃ puṇyaṃ vedānāmapyagocaram || 7/18 ||	mama eva sādhanam puṇyam vedānām api agocaram 
SA_MB_taaraatantramHK-367	bauddhadeśe'tharvavede mahācīne sadā braja |	bauddha deśe tharvavede mahācīne sadā braja 
SA_MB_taaraatantramHK-368	tatra gatvā mahābhāvaṃ vilokya matpadāmbujam || 7/19 ||	tatra gatvā mahā bhāvam vilokya mad pada ambujam 
SA_MB_taaraatantramHK-369	matkulajño maharṣe ! tvaṃ mahāsiddho bhaviṣyasi |	mad kula jñaḥ mahā ṛṣe tvam mahā siddhaḥ bhaviṣyasi 
SA_MB_taaraatantramHK-370	etadvākyaṃ kathitvā sā vāyavyākāśagāminī || 7/20 ||	etat vākyam kathitvā sā vāyavya ākāśa gāminī 
SA_MB_taaraatantramHK-371	nirākārā'bhavat śīghraṃ tataḥ sākāśavāhinī |	nirākārā bhavat śīghram tatas sā ākāśa vāhinī 
SA_MB_taaraatantramHK-372	tato munivaraḥ śrutvā mahāvidyāsarasvatīm || 7/21 ||	tatas muni varaḥ śrutvā mahā vidyā sarasvatīm 
SA_MB_taaraatantramHK-373	jagāma cīnabhūmau ca yatra buddhaḥ pratiṣṭhitaḥ |	jagāma cīna bhūmau ca yatra buddhaḥ pratiṣṭhitaḥ 
SA_MB_taaraatantramHK-374	punaḥ punaḥ praṇamyāsau vaśiṣṭhaḥ kṣitimaṇḍale || 7/22 ||	punar punar praṇamya asau vasiṣṭhaḥ kṣiti maṇḍale   
SA_MB_taaraatantramHK-375	rakṣa rakṣa mahādeva ! buddharūpadharāvyayaḥ (ya !) |	rakṣa rakṣa mahādeva buddha rūpa dhara avyayaḥ 
SA_MB_taaraatantramHK-376	ati dīnaṃ vaśiṣṭhaṃ māṃ sadāvyākulacetasam || 7/23 ||	ati dīnam vaśiṣṭham mām sadā a vyākula cetasam 
SA_MB_taaraatantramHK-377	brahmaputraṃ mahādevīsādhanāyājagāma ca (yaḥ) |	brahma putram mahādevī sādhanāya ājagāma ca yaḥ 
SA_MB_taaraatantramHK-378	siddhimārgaṃ na jānāmi devamārgaparoharaḥ |	siddhi mārgam na jānāmi devamārga paroharaḥ 
SA_MB_taaraatantramHK-379	tavācāraṃ samālokya bhayāni santi me hṛdi || 7/24 ||	tava ācāram samālokya bhayāni santi me hṛdi 
SA_MB_taaraatantramHK-380	tannāśaya mama kṣipraṃ durvuddhi vedagāminīm |	tat nāśaya mama kṣipram durvuddhi veda gāminīm 
SA_MB_taaraatantramHK-381	vedavahiṣkṛtaṃ karma sadā te cālaye prabho ! || 7/25 ||	veda vahiṣkṛtam karma sadā te ca ālaye prabho 
SA_MB_taaraatantramHK-382	kathametatprakārañca madyaṃ māṃsaṃ tathāṅganāṃ (nā)	katham etad prakāram ca madyam māṃsam tathā aṅganām nā 
SA_MB_taaraatantramHK-383	sarve digambarāḥ siddhāḥ raktapānodyatā varāḥ |	sarve digambarāḥ siddhāḥ rakta pāna udyatāḥ varāḥ 
SA_MB_taaraatantramHK-384	muhurmuhuḥ prapivanti ramayanti varāṅganām || 7/26 ||	muhur muhur prapivanti ramayanti vara aṅganām 
SA_MB_taaraatantramHK-385	sadā māṃsāsavaiḥ pūrṇā mattā raktavilocanāḥ |	sadā māṃsa āsavaiḥ pūrṇāḥ mattāḥ rakta vilocanāḥ 
SA_MB_taaraatantramHK-386	nigrahānugrahe śaktāḥ pūrṇāntaḥkaraṇodyatāḥ || 7/27 ||	nigraha anugrahe śaktāḥ pūrṇa antaḥkaraṇa udyatāḥ 
SA_MB_taaraatantramHK-387	vedasyāgocarāḥ sarve madyastrī - sevane ratāḥ |	vedasya agocarāḥ sarve madya strī sevane ratāḥ 
SA_MB_taaraatantramHK-388	ityuvāca mahāyogī dṛṣṭvā vedavahiṣkṛtam || 7/28 ||	iti uvāca mahā yogī dṛṣṭvā veda vahiṣkṛtam 
SA_MB_taaraatantramHK-389	prāñjalirvinayāviṣṭo vada caitatkulaprabho ! |	prāñjaliḥ vinaya āviṣṭaḥ vada ca etat kula prabho 
SA_MB_taaraatantramHK-390	manaḥ pravṛttireteṣāṃ kathaṃ bhavati pāvana (nī) || 7/29 ||	manaḥ pravṛttiḥ eteṣām katham bhavati pāvana 
SA_MB_taaraatantramHK-391	p. 24) kathaṃ vā jāyate siddhirvedakāryaṃ vinā prabho ! |	katham vā jāyate siddhiḥ veda kāryam vinā prabho 
SA_MB_taaraatantramHK-392	buddha uvāca |	buddhaḥ uvāca 
SA_MB_taaraatantramHK-393	vaśiṣṭha ! śṛṇu vakṣyāmi kulamārgamanuttamam |	vaśiṣṭha śṛṇu vakṣyāmi kula mārgam anuttamam 
SA_MB_taaraatantramHK-394	yena vijñānamātrena rudrarūpī bhavet kṣaṇāt || 7/30 ||	yena vijñāna mātrena rudra rūpī bhavet kṣaṇāt 
SA_MB_taaraatantramHK-395	saṅkṣepeṇa sarvasāraṃ kulasiddhyarthamāgamam |	saṅkṣepeṇa sarva sāram kula siddhi artham āgamam 
SA_MB_taaraatantramHK-396	ādau śucirbhavedvīro vivekākrāntamānasaḥ |	ādau śuciḥ bhavet vīraḥ viveka ākrānta mānasaḥ 
SA_MB_taaraatantramHK-397	paśubhāvasthira cetāḥ paśusaṅgavivarjitaḥ || 7/31 ||	cetāḥ paśu saṅga vivarjitaḥ 
SA_MB_taaraatantramHK-398	ekākī nirjane sthitvā kāmakrodhādivarjitaḥ |	ekākī nirjane sthitvā kāma krodha ādi varjitaḥ 
SA_MB_taaraatantramHK-399	sadā yogābhyāsarato yogaśikṣādṛḍhabrataḥ || 7/32 ||	sadā yoga abhyāsa rataḥ yoga śikṣā dṛḍha brataḥ 
SA_MB_taaraatantramHK-400	vedamārgāśrayo nityaṃ vedārthanipuṇo mahān |	veda mārga āśrayaḥ nityam veda artha nipuṇaḥ mahān 
SA_MB_taaraatantramHK-401	evaṃ krameṇa dharmātmā śīlaudāryaguṇānvitaḥ || 7/33 ||	evam krameṇa dharma ātmā śīla audārya guṇa anvitaḥ 
SA_MB_taaraatantramHK-402	dhārayenmārutaṃ nityaṃ śvāsamārge manolayam |	dhārayet mārutam nityam śvāsa mārge manaḥ layam 
SA_MB_taaraatantramHK-403	evamabhyāsayogena vaśī yogī dine dine || 7/34 ||	evam abhyāsa yogena vaśī yogī dine dine 
SA_MB_taaraatantramHK-404	śanaiḥ śanaiḥ kṛtābhyāsāddehe svedodgamo'dhamaḥ |	śanais śanais kṛta abhyāsāt dehe sveda udgamaḥ udhamaḥ 
SA_MB_taaraatantramHK-405	madhyamaḥ svalpasaṃyukto bhūmityāgaḥ paro mataḥ || 7/35 ||	madhyamaḥ su alpa saṃyuktaḥ bhūmityāgaḥ paraḥ mataḥ 
SA_MB_taaraatantramHK-406	prāṇāyāmena siddhiḥ (ddhaḥ) syānnaro yogeśvaro bhavet |	prāṇāyāmena siddhiḥ syāt naraḥ yogeśvaraḥ bhavet 
SA_MB_taaraatantramHK-407	yogī bhūtvā kumbhakajño maunī bhakto divāniśam || 7/36 ||	yogī bhūtvā kumbhaka jñaḥ maunī bhaktaḥ divāniśam 
SA_MB_taaraatantramHK-408	śive kṛṣṇe brahmapade ekāntabhaktisaṃyutaḥ |	śive kṛṣṇe brahma pade ekānta bhakti saṃyutaḥ 
SA_MB_taaraatantramHK-409	brahma - viṣṇu - śivā ete vāyavīgaticañcalā || 7/37 ||	brahma viṣṇu śivāḥ ete vāyavī gati cañcalā  /
SA_MB_taaraatantramHK-410	evaṃ vibhāvya manasā karmaṇā vacasā śuciḥ |	evam vibhāvya manasā karmaṇā vacasā śuciḥ 
SA_MB_taaraatantramHK-411	śaktau cittaṃ samādhāya cidrūpāyāṃ sthirāśayaḥ || 7/38 ||	śaktau cittam samādhāya cit rūpāyām sthira āśayaḥ 
SA_MB_taaraatantramHK-412	tato mahāvīrabhāvaṃ kulamārgamahodayam |	tatas mahā vīra bhāvam kula mārga mahā udayam 
SA_MB_taaraatantramHK-413	śakticakraṃ satvacakraṃ vaiṣṇavaṃ navavigraham || 7/39 ||	śakti cakram satva cakram vaiṣṇavam nava vigraham 
SA_MB_taaraatantramHK-414	p. 25) samāśritya bhajenmantrī kulakātyāyanīṃ parām |	samāśritya bhajet mantrī kulakātyāyanīm parām 
SA_MB_taaraatantramHK-415	pratyakṣadevatāṃ śrīdāṃ caṇḍo devagā (?) nikṛntanīm || 7/40 ||	pratyakṣa devatām śrī dām caṇḍaḥ deva gāḥ nikṛntanīm  /
SA_MB_taaraatantramHK-416	cidrūpāṃ jñānanilayāṃ caitanyānandavigrahām |	cit rūpām jñāna nilayām caitanya ānanda vigrahām 
SA_MB_taaraatantramHK-417	koṭisaudāminībhāsāṃ sarvatattvasvarūpiṇīm || 7/41 ||	koṭi saudāminī bhāsām sarva tattva svarūpiṇīm 
SA_MB_taaraatantramHK-418	aṣṭādaśabhujāṃ raudrīṃ śivamāṃsācalapriyām |	aṣṭādaśa bhujām raudrīm śiva māṃsa acala priyām 
SA_MB_taaraatantramHK-419	āśritya prajapenmantraṃ kulamārgāśrayo naraḥ |	āśritya prajapet mantram kula mārga āśrayaḥ naraḥ 
SA_MB_taaraatantramHK-420	kulamārgāt paraṃ mārgaṃ ko jānāti jagattraye |	kula mārgāt param mārgam kaḥ jānāti jagattraye 
SA_MB_taaraatantramHK-421	etanmārgaprasādena brahmā sraṣṭā svayaṃ mahān || 7/42 ||	etad mārga prasādena brahmā sraṣṭā svayam mahān 
SA_MB_taaraatantramHK-422	viṣṇuśca pālane śakto nirmalaḥ satvarūpadhṛk |	viṣṇuḥ ca pālane śaktaḥ nirmalaḥ sattva rūpadhṛk 
SA_MB_taaraatantramHK-423	sarvasevyo mahāpūjyo yajurvedādhipo mahān || 7/43 ||	sarva sevyaḥ mahā pūjyaḥ yajurveda adhipaḥ mahān 
SA_MB_taaraatantramHK-424	haraḥ saṃhārakartā ca vīreśottamamānasaḥ |	haraḥ saṃhāra kartā ca vīreśa uttama mānasaḥ 
SA_MB_taaraatantramHK-425	sarveṣāmantakaḥ krodhī krodharājo mahābalau || 7/44 ||	sarveṣām antakaḥ krodhī krodha rājaḥ mahā balau 
SA_MB_taaraatantramHK-426	vīrabhāvaprasādena dikpālā rudrarupiṇaḥ |	vīra bhāva prasādena dikpālāḥ rudra rupiṇaḥ 
SA_MB_taaraatantramHK-427	māsenākarṣaṇaṃ siddhirdvimāse vākpatirbhavet || 7/45 ||	māsena ākarṣaṇam siddhiḥ dvi māse vākpatiḥ bhavet 
SA_MB_taaraatantramHK-428	māsatrayeṇa saṃyoge jāyate suravallabhaḥ |	            
SA_MB_taaraatantramHK-429	evaṃ catuṣṭaye māsi bhaveddikpālagocaraḥ || 7/46 ||	evam catuṣṭaye māsi bhavet dikpāla gocaraḥ 
SA_MB_taaraatantramHK-430	pañcame pañcavāṇaḥ syāt ṣaṣṭhe rudro bhaveddhruvam |	pañcame pañcavāṇaḥ syāt ṣaṣṭhe rudraḥ bhavet dhruvam 
SA_MB_taaraatantramHK-431	etadācārasāraṃ hi sarveṣāmapyagocaram || 7/47 ||	etat ācāra sāram hi sarveṣām api agocaram 
SA_MB_taaraatantramHK-432	etanmārgaṃ kaulamārgaṃ kaulamārgāt paraṃ na hi |	etat mārgam kaula mārgam kaula mārgāt param na hi 
SA_MB_taaraatantramHK-433	yogināṃ dṛḍhacittānaṃ bhaktānāmekamāsataḥ || 7/48 ||	yoginām bhaktānām eka māsatas 
SA_MB_taaraatantramHK-434	kāryasiddhirbhavennārī kulamārgaprasādataḥ |	kārya siddhiḥ bhavet nārī kula mārga prasādataḥ 
SA_MB_taaraatantramHK-435	pūrṇayogī bhavedvipraḥ ṣaṇmāsābhyāsayogataḥ || 7/49 ||	pūrṇa yogī bhavet vipraḥ ṣaṣ māsa abhyāsa yogataḥ 
SA_MB_taaraatantramHK-436	p. 26) śaktiṃ vinā śivo'śaktaḥ kimanye jaḍabuddhayaḥ |	śaktim vinā kim anye jaḍa buddhayaḥ 
SA_MB_taaraatantramHK-437	ityuktvāṃ buddharūpī ca kārayāmāsa sādhanam || 7/50 ||	iti uktvām buddha rūpī ca kārayāmāsa sādhanam 
SA_MB_taaraatantramHK-438	kuru vipra ! mahāśaktisevanaṃ madyasādhanam |	kuru vipra mahā śakti sevanam madya sādhanam 
SA_MB_taaraatantramHK-439	mahāvidyāpadāmbhojanadarśanaṃ samavārupasi || 7/51 ||	mahāvidyā pada ambhojana darśanam 
SA_MB_taaraatantramHK-440	etat śrutvā gurorvākyaṃ smṛtvā devīṃ sarasvatīm |	etat śrutvā guroḥ vākyam smṛtvā devīm sarasvatīm 
SA_MB_taaraatantramHK-441	madirāsādhanaṃ kartuṃ jagāma kulamaṇḍape || 7/52 ||	madirā sādhanam kartum jagāma kula maṇḍape 
SA_MB_taaraatantramHK-442	madyaṃ māṃsaṃ tathā matsyaṃ mudrā maithunameva ca |	madyam māṃsam tathā matsyam mudrā maithunam eva ca 
SA_MB_taaraatantramHK-443	punaḥ punaḥ sādhayitvā pūrṇayogī babhūva saḥ || 7/53 ||	punar punar sādhayitvā pūrṇa yogī babhūva saḥ 
SA_MB_taaraatantramHK-444	[ brahmayāmale devīśvarasaṃvāde prathamapaṭale |]	brahmayāmale devīśvara saṃvāde prathama paṭale 
SA_MB_taaraatantramHK-445	brahmaṇo mānasaḥ putro vaśiṣṭhaḥ sthirasaṃyamī |	brahmaṇaḥ mānasaḥ putraḥ vaśiṣṭhaḥ sthira saṃyamī 
SA_MB_taaraatantramHK-446	tārāmārādhayāmāsa purā nīlācale muniḥ || 7/13 ||	tārām ārādhayāmāsa purā nīla acale muniḥ 
SA_MB_taaraatantramHK-447	japan sa tāriṇīṃ vidyāṃ kāmākhyāyonimaṇḍale |	japan sa tāriṇīm vidyām kāma ākhyā yoni maṇḍale 
SA_MB_taaraatantramHK-448	gamayāmāsa varṣāṇāmayutaṃ dhyānatatparaḥ || 7/14 ||	gamayāmāsa varṣāṇām ayutam dhyāna tatparaḥ 
SA_MB_taaraatantramHK-449	varṣāyutena tasyaivaṃ ciramārādhitā satī |	varṣa ayutena tasya evam ciram ārādhitā satī 
SA_MB_taaraatantramHK-450	nānugrahaṃ cakārāsau tārā saṃsāratāriṇī || 7/15 ||	na anugraham cakāra asau tārā saṃsāra tāriṇī 
SA_MB_taaraatantramHK-451	athāsau pitaraṃ gatvā brahmāṇaṃ parameṣṭhinam |	atha asau pitaram gatvā brahmāṇam parameṣṭhinam 
SA_MB_taaraatantramHK-452	kopena jvalito vidyāṃ tatyāja piturantike || 7/16 ||	kopena jvalitaḥ vidyām tatyāja pituḥ antike 
SA_MB_taaraatantramHK-453	dvādaśādityasaṅkāśaṃ tapobhirjvalitaṃ munim |	dvādaśa āditya saṅkāśam tapobhiḥ jvalitam munim 
SA_MB_taaraatantramHK-454	brahmā hi sa muniṃ prāha śṛṇu putra ! vaco mama || 7/17 ||	brahmā hi sa munim prāha śṛṇu putra vacaḥ mama  
SA_MB_taaraatantramHK-455	tattvajñāmayī vidyā tārā bhuvanatāriṇī |	             
SA_MB_taaraatantramHK-456	ārādhaya śrīcaraṇamanudvignena cetasā || 7/18 ||	ārādhaya śrī caraṇam anudvignena cetasā 
SA_MB_taaraatantramHK-457	asyāḥ prasādādevāhaṃ bhuvanāni caturdaśa |	asyāḥ prasādāt eva aham bhuvanāni caturdaśa 
SA_MB_taaraatantramHK-458	sṛjāmi caturo vedān kalpayāmi sma līlayā || 7/19 ||	sṛjāmi caturaḥ vedān kalpayāmi sma līlayā 
SA_MB_taaraatantramHK-459	enāmeva samārādhya vidyāṃ bhuvanatāriṇīm |	enām eva samārādhya vidyām bhuvana tāriṇīm 
SA_MB_taaraatantramHK-460	tattvajñānamayo viṣṇurbhuvanaṃ pālayatyasau || 7/20 ||	tattva jñāna mayaḥ viṣṇuḥ bhuvanam pālayati asau 
SA_MB_taaraatantramHK-461	saṃhārakāle ca haro rudramūrtidharaḥ paraḥ (.) |	saṃhāra kāle ca haraḥ rudra mūrti dharaḥ paraḥ 
SA_MB_taaraatantramHK-462	tārāmeva samārādhya saṃharatyakhilaṃ jatat || 7/21 ||	tārām eva samārādhya saṃharati akhilam 
SA_MB_taaraatantramHK-463	vaśiṣṭha uvāca |	vaśiṣṭhaḥ uvāca 
SA_MB_taaraatantramHK-464	devānāmādibhūtastvaṃ sarvavidyāmayaḥ prabho ! |	devānām ādi bhūtaḥ tvam sarva vidyā mayaḥ prabho 
SA_MB_taaraatantramHK-465	kathaṃ dattā durārādhyā vidyā mahyamiyaṃ tvayā || 7/23 ||	katham dattā durārādhyā vidyā mahyam iyam tvayā  /
SA_MB_taaraatantramHK-466	sahasravatsarān pūrva miyamāradhitā purā |	sahasra vatsarān pūrvam miyam āradhitā purā 
SA_MB_taaraatantramHK-467	nīlācale nivasatā haviṣyaṃ bhuñjatā mayā || 7/24 ||	nīlācale nivasatā haviṣyam bhuñjatā mayā  /
SA_MB_taaraatantramHK-468	tathāpi tāta ! tāriṇyāḥ karuṇā mayi nābhavat |	tathā api tāta tāriṇyāḥ karuṇā mayi nā abhavat 
SA_MB_taaraatantramHK-469	tato gaṇḍūṣamātrantu kāle kāle pivan jalam || 7/25 ||	tatas kāle kāle pivan jalam 
SA_MB_taaraatantramHK-470	ārādhayāmi tāṃ devīṃ vatsarāṇāṃ sahasrakam |	ārādhayāmi tām devīm vatsarāṇām sahasrakam 
SA_MB_taaraatantramHK-471	tathāpi yadi naivābhūttāriṇyāḥ karuṇā mayi || 7/26 ||	tathā api yadi nā evā abhūt tāriṇyāḥ karuṇā mayi 
SA_MB_taaraatantramHK-472	tathā (dā) hameka - pādena tiṣṭhannīlācalopari |	pādena tiṣṭhan nīla acala upari 
SA_MB_taaraatantramHK-473	paraṃ samādhimāsādya nirāhāro dṛḍhavrataḥ || 7/27 ||	param samādhim āsādya nirāhāraḥ dṛḍha vrataḥ 
SA_MB_taaraatantramHK-474	tāmevākaruṇāṃ dhyāyan japaṃstāmeva sarvadā |	tām eva akaruṇām dhyāyan japan tām eva sarvadā 
SA_MB_taaraatantramHK-475	ativāhitavān varṣaṃ sahasrāṣṭakamuttamam || 7/28 ||	ativāhitavān varṣam sahasra aṣṭakam uttamam 
SA_MB_taaraatantramHK-476	evaṃ daśasahasrantu varṣāṇāmahamīśvarīm |	evam varṣāṇām aham īśvarīm 
SA_MB_taaraatantramHK-477	kāmākhyāyonimāśriya samārādhitavān prabho ! || 7/29 ||	kāma ākhyā yonim āśriya samārādhitavān prabho 
SA_MB_taaraatantramHK-478	adyāpyanugraha stasyā stathāpi na hi dṛśyate |	adyā api anugrahaḥ stasyāḥ tathā api na hi dṛśyate 
SA_MB_taaraatantramHK-479	ata styajāmi duḥsādhyāṃ vidyāmetāṃ suduḥkhitaḥ || 7/30 ||	atas tyajāmi duḥsādhyām vidyām etām su duḥkhitaḥ 
SA_MB_taaraatantramHK-480	iti tadvacanaṃ śrutvā brahmā lokapitāmahaḥ |	iti tat vacanam śrutvā brahmā lokapitāmahaḥ 
SA_MB_taaraatantramHK-481	uvāca śāntayan putraṃ vaśiṣṭhaṃ munīnāṃ varam || 7/31 ||	uvāca śāntayan putram vasiṣṭham munīnām varam 
SA_MB_taaraatantramHK-482	brahmovāca |	brahmā uvāca 
SA_MB_taaraatantramHK-483	vaśiṣṭha ! vatsa ! gacchatvaṃ punarnīlācalaṃ prati |	vaśiṣṭha vatsa gacchatvam punar nīlācalam prati 
SA_MB_taaraatantramHK-484	tatrasthito mahādevī mārādhaya dṛḍhavrataḥ || 7/32 ||	tatra sthitaḥ mahādevī mā ārādhaya dṛḍha vrataḥ 
SA_MB_taaraatantramHK-485	kāmākhyā - yonimāśritya jagataḥ parameśvarīm |	kāma ākhyā yonim āśritya jagataḥ parameśvarīm 
SA_MB_taaraatantramHK-486	acirādeva te siddhirbhaviṣyati na saṃśayaḥ || 7/33 ||	acirāt eva te siddhiḥ bhaviṣyati na saṃśayaḥ 
SA_MB_taaraatantramHK-487	etasyāḥ sadṛśī vidyā kācinna hi jagattraye |	etasyāḥ sadṛśī vidyā kācid na hi jagattraye 
SA_MB_taaraatantramHK-488	imāṃ tyaktvā punarvidyāṃ anyāṃ kāṃ tvaṃ grahauṣyasi || 7/34 ||	imām tyaktvā punar vidyām anyām kām tvam grahauṣyasi  /
SA_MB_taaraatantramHK-489	iti tasya vacaḥ śrutvā praṇamya pitaraṃ muniḥ |	iti tasya vacaḥ śrutvā praṇamya pitaram muniḥ 
SA_MB_taaraatantramHK-490	punarjagāma kāmākhyā - yonimaṇḍalasannidhim || 7/35 ||	punar jagāma kāmākhyā yoni maṇḍala sannidhim 
SA_MB_taaraatantramHK-491	tatra gatvā munivaraḥ pūjāsambhāratatparaḥ |	tatra gatvā muni varaḥ pūjā sambhāra tatparaḥ 
SA_MB_taaraatantramHK-492	ārādhayan mahāmāyāṃ vaśiṣṭho'pi jitendriyaḥ || 7/36 ||	ārādhayat mahā māyām vasiṣṭhaḥ api jita indriyaḥ 
SA_MB_taaraatantramHK-493	athārādhayata stasya sahasraṃ parivatsarān |	atha ārādhayataḥ tasya sahasram parivatsarān 
SA_MB_taaraatantramHK-494	jagmustārā - mahādevī - pādāmbhojā - nuvartiṇaḥ || 7/37 ||	jagmuḥ tārā mahā devī pāda ambhojāḥ anuvartiṇaḥ  
SA_MB_taaraatantramHK-495	tathāpi tāṃ prati prītā yadā nābhūnmaheśvarī |	tathā api tām prati prītā yadā nā abhūt maheśvarī 
SA_MB_taaraatantramHK-496	tadā roṣeṇa mahatā jajvāla sa munīśvaraḥ || 7/38 ||	tadā roṣeṇa mahatā jajvāla sa muni īśvaraḥ 
SA_MB_taaraatantramHK-497	tadā jalaṃ samādāya tāṃ śaptumupacakrame |	tadā jalam samādāya tām śaptum upacakrame 
SA_MB_taaraatantramHK-498	etasminneva kāle tu ruṣṭamālokya taṃ munim || 7/39 ||	etasmin eva kāle tu ruṣṭam ālokya tam munim 
SA_MB_taaraatantramHK-499	cacāla vasudhā sarvā saśaila - vanakānanā |	cacāla vasudhā sarvā sa śaila vana kānanā 
SA_MB_taaraatantramHK-500	hāhākāro mahānāsīddevi ! deveṣu sarvataḥ || 7/40 ||	hāhākāraḥ mahān āsīt devi deveṣu sarvatas 
SA_MB_taaraatantramHK-501	tato babhūva purata stārā saṃsāra - tāriṇī |	tatas babhūva puratas stārā saṃsāra tāriṇī 
SA_MB_taaraatantramHK-502	vaśiṣṭha stāṃ samālokya śaśapātovadāruṇam || 7/41 ||	vasiṣṭhaḥ stām samālokya 
SA_MB_taaraatantramHK-503	p. 29) tato devī vaśiṣṭhena śaptā na phaladā bhavet |	tatas devī vasiṣṭhena śaptā na phala dā bhavet 
SA_MB_taaraatantramHK-504	cīnācāraṃ vinā naiva prasīdāmi kadācana || 7/42 ||	cīna ācāram vinā nā eva prasīdāmi kadācana 
SA_MB_taaraatantramHK-505	uvāca sādhakaśreṣṭhaṃ vaśiṣṭhamanunīya sā |	uvāca sādhaka śreṣṭham vasiṣṭham anunīya sā 
SA_MB_taaraatantramHK-506	roṣeṇa dāruṇamanāḥ kathaṃ mā manuśaptavān || 7/43 ||	roṣeṇa dāruṇa manāḥ katham mā manuśaptavān 
SA_MB_taaraatantramHK-507	mayi ārādhanācāraṃ buddharūpī janārdanaḥ |	mayi ārādhana ācāram buddha rūpī janārdanaḥ 
SA_MB_taaraatantramHK-508	eka eva vijānāti nānyaḥ kaścana tatvataḥ || 7/44 ||	ekaḥ eva vijānāti na anyaḥ kaścana tatvataḥ 
SA_MB_taaraatantramHK-509	vṛthaivāyāsa bahula (laṃ) kāloyaṃ gamita stvayā |	vṛthā eva āyāsa bahula lam kālaḥ yam gamitaḥ stvayā 
SA_MB_taaraatantramHK-510	viruddhācāraśīlena mama tattvamajānatā || 7/45 ||	viruddha ācāra śīlena mama tattvam a jānatā 
SA_MB_taaraatantramHK-511	udbodharūpiṇo viṣṇoḥ sānnidhyaṃ yāhi sāmpratam |	udbodha rūpiṇaḥ viṣṇoḥ sānnidhyam yāhi sāmpratam 
SA_MB_taaraatantramHK-512	tenopadiṣṭācāreṇa māmārādhaya suvrata ! || 7/46 ||	tena upadiṣṭa ācāreṇa mām ārādhaya suvrata 
SA_MB_taaraatantramHK-513	tadaivāśu prasannāsmi tvayi yasyā (vipra) na saṃśayaḥ ||	tadā eva āśu prasannā asmi tvayi yasyāḥ vipra na saṃśayaḥ 
SA_MB_taaraatantramHK-514	[dvitīya paṭale]	dvitīya paṭale 
SA_MB_taaraatantramHK-515	śrībhairva uvāca |	śrī bhairvaḥ uvāca 
SA_MB_taaraatantramHK-516	tataḥ praṇamya tāṃ devīṃ vaśiṣṭho'sau mahāmuniḥ |	tatas praṇamya tām devīm vasiṣṭhaḥ asau mahā muniḥ 
SA_MB_taaraatantramHK-517	jagāmācāravijñānavāñchayā buddharūpiṇam || 7/1 ||	jagāma ācāra vijñāna vāñchayā buddha rūpiṇam 
SA_MB_taaraatantramHK-518	tato gatvā mahācīnadeśe jñānamayo muniḥ |	tatas gatvā mahācīna deśe jñāna mayaḥ muniḥ 
SA_MB_taaraatantramHK-519	dadarśa himavatpārśve sādhakeśvarasevite || 7/2 ||	dadarśa himavat pārśve sādhaka īśvara sevite  /
SA_MB_taaraatantramHK-520	raṇajjaghanarāveṇa rūpayauvanaśālinā |	raṇat jaghana rāveṇa rūpa yauvana śālinā 
SA_MB_taaraatantramHK-521	madirāmodacittena vilāsollasitena ca || 7/3 ||	madirā āmoda cittena vilāsa ullasitena ca 
SA_MB_taaraatantramHK-522	śṛṅgārasāraveśena jaganmohanakāriṇā |	śṛṅgāra sāra veśena jagat mohana kāriṇā 
SA_MB_taaraatantramHK-523	bhayalajjāvihīnena devyā dhyānapareṇa ca || 7/4 ||	bhaya lajjā vihīnena devyāḥ dhyāna pareṇa ca 
SA_MB_taaraatantramHK-524	p. 30) kāminīnāṃ sahasreṇa parivāritamīśvaram |	kāminīnām sahasreṇa parivāritam īśvaram 
SA_MB_taaraatantramHK-525	madirāpānasañjāta - mandamandavilocana || 7/5 ||	madirā pāna sañjāta manda manda vilocana 
SA_MB_taaraatantramHK-526	dūrādeva vilokyainaṃ vaśiṣṭho buddharūpiṇam |	dūrāt eva vilokya enam vasiṣṭhaḥ buddha rūpiṇam 
SA_MB_taaraatantramHK-527	vismayena samāviṣṭaḥ smaran saṃsāratāriṇīm || 7/6 ||	vismayena samāviṣṭaḥ smaran saṃsāra tāriṇīm 
SA_MB_taaraatantramHK-528	kimidaṃ kriyate karmaṃ viṣṇunā buddharūpiṇā |	kim idam kriyate karmam viṣṇunā buddha rūpiṇā 
SA_MB_taaraatantramHK-529	vedavādaviruddhoyamācāro'sammato mama || 7/7 ||	veda vāda viruddhaḥ ayam ācāraḥ sammataḥ mama 
SA_MB_taaraatantramHK-530	iti cintayata stasya vaśiṣṭhasya mahātmanaḥ |	iti cintayataḥ tasya vaśiṣṭhasya mahātmanaḥ 
SA_MB_taaraatantramHK-531	ākāśavāṇī prāhāśu maivaṃ cintaya suvrata ! || 7/8 ||	ākāśa vāṇī prāha āśu mā evam cintaya suvrata 
SA_MB_taaraatantramHK-532	ācāraḥ paramārtho'yaṃ tāriṇīsādhane mune ! |	ācāraḥ parama arthaḥ yam tāriṇī sādhane mune 
SA_MB_taaraatantramHK-533	etadviruddhabhāvasya mate nāsau prasīdati || 7/9 ||	etad viruddha bhāvasya mate na asau prasīdati 
SA_MB_taaraatantramHK-534	yadi tasyāḥ prasādaṃ tvamacireṇābhivāñchasi |	yadi tasyāḥ prasādam tvam acireṇa abhivāñchasi 
SA_MB_taaraatantramHK-535	etena cīnācāreṇa tadā tāṃ bhaja suvrata ! || 7/10 ||	etena cīna ācāreṇa tadā tām bhaja suvrata 
SA_MB_taaraatantramHK-536	ākāśavāṇīmākarṇya romāñcitakalevaraḥ |	ākāśa vāṇīm ākarṇya romāñcita kalevaraḥ 
SA_MB_taaraatantramHK-537	vaśiṣṭho daṇḍavadbhūmau papātātīvaharṣitaḥ || 7/11 ||	vasiṣṭhaḥ daṇḍa vat bhūmau papāta atīva harṣitaḥ 
SA_MB_taaraatantramHK-538	athotthāyācireṇāsau kṛtāñjalipuṭo muniḥ |	atha utthāya acireṇa asau kṛta añjali puṭaḥ muniḥ 
SA_MB_taaraatantramHK-539	jagāma viṣṇoḥ śaraṇaṃ buddharūpasya pārvati ! || 7/12 ||	jagāma viṣṇoḥ śaraṇam buddha rūpasya pārvati 
SA_MB_taaraatantramHK-540	athāsau taṃ samālokya madirāmadavihvalaḥ |	atha asau tam samālokya madirā mada vihvalaḥ 
SA_MB_taaraatantramHK-541	prāha buddhaḥ prasannātmā kimarthaṃ tvamihāgataḥ || 7/13 ||	prāha buddhaḥ prasanna ātmā kimartham tvam iha āgataḥ  
SA_MB_taaraatantramHK-542	atha buddhaṃ praṇamyāha bhaktinasro mahāmuniḥ |	atha buddham praṇamya āha bhakti nasraḥ mahā muniḥ 
SA_MB_taaraatantramHK-543	yaduktaṃ tāriṇīdevyā nijārādhanakarmaṇi || 7/14 ||	yat uktam tāriṇī devyāḥ nija ārādhana karmaṇi 
SA_MB_taaraatantramHK-544	tat śrutvā bhagavān buddha stattvajñānamayo hariḥ |	tat śrutvā bhagavān buddhaḥ stattva jñāna mayaḥ hariḥ 
SA_MB_taaraatantramHK-545	vaśiṣṭhaṃ prāhamajñānaṃ cīnācārādhikāraṇān (ṇam) || 7/15 ||	vasiṣṭham cīna ācāra adhikāraṇāt ṇam  /
SA_MB_taaraatantramHK-546	na prakāśyoyamācāra stāriṇyāḥ sarvadā mune ! |	na prakāśyaḥ ayam ācāraḥ stāriṇyāḥ sarvadā mune 
SA_MB_taaraatantramHK-547	tava bhaktivaśenāsmi prakāśyamiha tatparaḥ || 7/16 ||	tava bhakti vaśena asmi prakāśyam iha tad paraḥ 
SA_MB_taaraatantramHK-548	buddha uvāca	buddhaḥ uvāca 
SA_MB_taaraatantramHK-549	prathācāravidhiṃ vakṣye tārādevyāḥ samṛddhidam |	             
SA_MB_taaraatantramHK-550	yasyānuṣṭhānamātreṇa bhavābdhau na nimajjasi || 7/17 ||	yasya anuṣṭhāna mātreṇa bhava abdhau na nimajjasi 
SA_MB_taaraatantramHK-551	samastaśokaśamana - mānandādivibhūtidam |	                      
SA_MB_taaraatantramHK-552	tattvajñānamayaṃ sākṣādvimuktiphaladāyakam || 7/18 ||	tattva jñāna mayam sākṣāt vimukti phala dāyakam 
SA_MB_taaraatantramHK-553	snānādi mānasaḥ śauco mānasaḥ pravaro japaḥ |	snāna ādi mānasaḥ śaucaḥ mānasaḥ pravaraḥ japaḥ 
SA_MB_taaraatantramHK-554	pūjanaṃ mānasaṃ divyaṃ mānasaṃ tarpaṇādikam || 7/19 ||	pūjanam mānasam divyam mānasam tarpaṇa ādikam 
SA_MB_taaraatantramHK-555	sarva eva śubhaḥ kālo nāśubho vidyate kvacit |	sarvaḥ eva śubhaḥ kālaḥ na aśubhaḥ vidyate kvacid 
SA_MB_taaraatantramHK-556	na viśeṣo divārātrau na sandhyāyāṃ mahāniśi || 7/20 ||	na viśeṣaḥ divārātrau na sandhyāyām mahāniśi 
SA_MB_taaraatantramHK-557	vastrāsana - sthānageha - dehasparśādivāriṇaḥ |	             
SA_MB_taaraatantramHK-558	śuddhiṃ na cācarettatra nirvikalpaṃ manaścaret || 7/21 ||	śuddhim na ca ācaret tatra nirvikalpam manaḥ caret 
SA_MB_taaraatantramHK-559	nātra śuddhyādyapekṣāsti na cāmedhyādidūṣaṇam |	na atra śuddhi ādi apekṣā asti na ca amedhya ādi dūṣaṇam 
SA_MB_taaraatantramHK-560	sarvadā pūjayeddevīmasnātaḥ kṛtabhojanaḥ || 7/22 ||	sarvadā pūjayet devīm asnātaḥ kṛta bhojanaḥ 
SA_MB_taaraatantramHK-561	mahāniśyaśucau deśe baliṃ mantreṇa dāpayet |	mahā niśi aśucau deśe balim mantreṇa dāpayet 
SA_MB_taaraatantramHK-562	strīdveṣo naiva kartavyo viśeṣāt pūjanaṃ striyāṃ || 7/23 ||	strī dveṣaḥ nā eva kartavyaḥ viśeṣāt pūjanam striyām 
SA_MB_taaraatantramHK-563	[ ataḥ paraṃ yaduktañca tadanyatra prapañcitam |]	atas param yat uktam ca tat anyatra prapañcitam 
SA_MB_taaraatantramHK-564	[tṛtīya paṭale ]	tṛtīya paṭale 
SA_MB_taaraatantramHK-565	pūjākālaṃ vinā naiva paśyecchaktiṃ digambarām |	pūjā kālam vinā nā eva paśyet śaktim digambarām 
SA_MB_taaraatantramHK-566	pūjākālaṃ vinā naiva surā peyā ca sādhakaiḥ |	pūjā kālam vinā nā eva surā peyā ca sādhakaiḥ 
SA_MB_taaraatantramHK-567	āyuṣā hīyate dṛṣṭvā pītvā ca narakaṃ brajet ||	āyuṣā hīyate dṛṣṭvā pītvā ca narakam brajet 
SA_MB_taaraatantramHK-568	[ayameva vṛttānto mahācīnācārakrame'pi savistaraṃ varṇitaḥ |]	ayam eva vṛttāntaḥ mahā cīna ācāra krame pi sa vistaram varṇitaḥ 
SA_MB_taaraatantramHK-569	[buddhasya kāmaśāstrācāryatvaṃ spaṣṭamuktaṃ	buddhasya kāmaśāstra ācārya tvam spaṣṭam uktam 
SA_MB_taaraatantramHK-570	mīnanāthakṛtasmaradīpikāyām |]	mīnanātha kṛta smaradīpikāyām 
SA_MB_taaraatantramHK-571	sāraṃ niṣkramya buddhādimunīnāṃ pramukhāt śrutam |	sāram niṣkramya buddha ādi munīnām pramukhāt śrutam 
SA_MB_taaraatantramHK-572	śrīmatā mīnanāthena kriyate smaradīpikā ||	śrīmatā mīnanāthena kriyate smaradīpikā 
SA_MB_taaraatantramHK-573	kāmaśāstrasya tattvajñā bhavanti yoṣitaḥ sadāḥ |	kāmaśāstrasya tattva jñāḥ bhavanti yoṣitaḥ sadā 
SA_MB_taaraatantramHK-574	ye vai śāstraṃ jānanti ramante vṛṣabhā yathā ||	ye vai śāstram jānanti ramante vṛṣabhāḥ yathā 
SA_MB_taaraatantramHK-575	[mahācīnakramo gāndharve'pi varṇitaḥ |]	mahā cīna kramaḥ gāndharve api varṇitaḥ 
SA_MB_taaraatantramHK-576	MUKTABODHA INDOLOGICAL RESEARCH INSTITUTE©2011 Muktabodha Indological Research Institute  All Rights Reserved.E-texts may be viewed only online or downloaded for private study.E-texts may not, under any circumstances, be copied, republished,reproduced, distributed or sold, either in original or altered form, withoutthe express permission of Muktabodha Indological Research Institute in writing.Data-entered by the staff of Muktabodha under the direction of Mark S. G. Dyczkowski.	muktabodha indological research muktabodha indological research institute all rights reserved texts may be viewed only online or downloaded for private studye texts may not under any circumstances be copied republished reproduced distributed or sold either in original or altered form withoutthe express permission of muktabodha indological research institute in writing data entered by the staff of muktabodha under the direction of mark s g dyczkowski 
