segmentnr	original	analyzed
SA_MB_moksakarikaHK-0	Muktabodha E-text in UTF-8	muktabodha etext in utf
SA_MB_moksakarikaHK-1	###########################################################################MUKTABODHA INDOLOGICAL RESEARCH INSTITUTEwww.muktabodha.org©2011 Muktabodha Indological Research Institute  All Rights Reserved.E-texts may be viewed only online or downloaded for private study.E-texts may not, under any circumstances, be copied, republished,reproduced, distributed or sold, either in original or altered form, withoutthe express permission of Muktabodha Indological Research Institute in writing.Data-entered by the staff of Muktabodha under the direction of Mark S. G. Dyczkowski.Catalog number : M00006	muktabodha indological research muktabodha indological research institute all rights reserved texts may be viewed only online or downloaded for private studye texts may not under any circumstances be copied republished reproduced distributed or sold either in original or altered form withoutthe express permission of muktabodha indological research institute in writing data entered by the staff of muktabodha under the direction of mark s g dyczkowskicatalog number  /
SA_MB_moksakarikaHK-2	Uniform title: āṣṭaprakaraṇa mokṣakārikā	uniform title mokṣa kārikā 
SA_MB_moksakarikaHK-3	Main title: āṣṭaprakaraṇam mokṣakārikā	main title āṣṭa prakaraṇam mokṣakārikā 
SA_MB_moksakarikaHK-4	Secondary title: ratnatraya bhogakārikā nādakārikā mokṣakārikā paramokṣanirasakārikāḥ	bhoga kārikā nāda kārikā mokṣa kārikā para mokṣa nirasa kārikāḥ 
SA_MB_moksakarikaHK-5	Author : sadyojyoti	authoḥ sadyojyoti 
SA_MB_moksakarikaHK-6	Commentator : rāmakaṇṭha	commentatoḥ rāmakaṇṭha 
SA_MB_moksakarikaHK-7	Editor : kṛṣṇa śāstrī	e ditoḥ kṛṣṇa śāstrī 
SA_MB_moksakarikaHK-8	Description: E-text of the mokṣakārikā from ratnatraya bhogakārikā nādakārikā mokṣakārikā paramokṣanirasakārikāḥ in the devakottai series. .	description etext of the mokṣa kārikā from ratnatraya bhoga kārikā nāda kārikā mokṣa kārikā para mokṣa nirasa kārikāḥ in the devakottai series 
SA_MB_moksakarikaHK-9	Notes: Data-entered by the staff of Muktabodha under the supervision of Mark Dyczkowski.      Revision 0: December 12, 2007	notes data entered by the staff muktabodha under the supervision of mark dyczkowski 
SA_MB_moksakarikaHK-10	Publisher : śivāgama siddhānta paripalana saṅgham	publisher śiva āgama siddhānta paripalana saṅgham 
SA_MB_moksakarikaHK-11	Publication year : 1925	publication year 
SA_MB_moksakarikaHK-12	Publication city : devakottai	publication citi 
SA_MB_moksakarikaHK-13	Publication country : India	publication country india 
SA_MB_moksakarikaHK-14	mokṣakārikā	      
SA_MB_moksakarikaHK-15	sadyojyotiḥśivācāryapraṇītā	            
SA_MB_moksakarikaHK-16	bhaṭṭarāmakaṇṭhakṛtavyākhyāsahitā	          
SA_MB_moksakarikaHK-17	yābhyāṃ prakāśitaṃ vartma siddhānte siddhabhāvataḥ |	yābhyām prakāśitam vartma siddhānte siddha bhāvataḥ 
SA_MB_moksakarikaHK-18	gurūṇāmapi tau vandyau sadyojyotirbṛhaspatī ||	gurūṇām api tau vandyau sadyojyotiḥ bṛhaspatī 
SA_MB_moksakarikaHK-19	bhogamokṣapradaṃ natvā bhogamokṣāya śaṅkaram |	bhoga mokṣa pradam natvā bhoga mokṣāya śaṅkaram 
SA_MB_moksakarikaHK-20	bhogamokṣeṣu saṃkṣepād vyākhyāsye mokṣakārikām ||	bhoga mokṣeṣu saṃkṣepāt vyākhyāsye mokṣa kārikām 
SA_MB_moksakarikaHK-21	iha hi  rurusiddhāntasaṃsiddhau bhogamokṣau sasādhanau | vacmi (bho0 kā0 2) iti	iha hi ruru siddhānta saṃsiddhau bhoga mokṣau sa sādhanau vacmi bho kā iti 
SA_MB_moksakarikaHK-22	pratijñāyāṃ pūrvam bhokturbhogaścitervyaktiḥ (bho0 kā0 73) ityādinā bhogo bhoktāraśca	pratijñāyām pūrvam bhoktuḥ bhogaḥ citeḥ vyaktiḥ bho kā ityādinā bhogaḥ bhoktāraḥ ca 
SA_MB_moksakarikaHK-23	paśavo'svatantrāḥ, teṣāṃ ca bhogasādhanaṃ kāryakaraṇādirūpaṃ kṣityādikalāntaṃ	paśavaḥ svatantrāḥ teṣām ca bhoga sādhanam kārya karaṇa ādi rūpam kṣiti ādi kalā antam 
SA_MB_moksakarikaHK-24	viśvaṃ viśvopādānakāraṇaṃ ca māyārthaṃ pratipāditam, adhunā tu bhogasiddhaye	viśvam viśva upādānakāraṇam ca māyā artham pratipāditam adhunā tu bhoga siddhaye 
SA_MB_moksakarikaHK-25	bhoktṛṇāṃ kiṃ tatsvata eva pravartate, uta kartṛpreritamityatra sādhanāntaraṃ	bhoktṛṇām kim tat svatas eva pravartate uta kartṛ preritam iti atra sādhana antaram 
SA_MB_moksakarikaHK-26	kartṛlakṣaṇamucyate-	kartṛ lakṣaṇam ucyate 
SA_MB_moksakarikaHK-27	ajātamalasaṃbandhaḥ sarvajñaḥ sarvakṛd vibhuḥ |	            
SA_MB_moksakarikaHK-28	sakalo niṣkalo'nantaḥ svecchānantarakāryakṛt || 1 ||	             
SA_MB_moksakarikaHK-29	nirmuktātiśayaiśvaryo māyāṃ vikṣobhya śaktibhiḥ |	nirmukta atiśaya aiśvaryaḥ māyām vikṣobhya śaktibhiḥ 
SA_MB_moksakarikaHK-30	bhogināṃ bhuktaye viśvaṃ vicitraṃ kurute śivaḥ || 2 ||	bhoginām bhuktaye viśvam vicitram kurute śivaḥ 
SA_MB_moksakarikaHK-31	viśvaṃ māyopādānatvena pūrvoktaṃ bhogasādhanamadṛṣṭa-kartṛkam | tasmin	viśvam māyā upādāna tvena pūrva uktam bhoga sādhanam adṛṣṭa kartṛkam tasmin 
SA_MB_moksakarikaHK-32	viśiṣṭakāryatvād viśiṣṭajñānakriyākartṛtvaṃ kumbhakārādijanyavanniścitamiti viśvasya	viśiṣṭa kārya tvāt viśiṣṭa jñāna kriyā kartṛ tvam kumbhakāra ādi janya vat niścitam iti viśvasya 
SA_MB_moksakarikaHK-33	sāvayavatvānnāsiddhaḥ, nāpyanaikāntikaḥ, sarvasyādṛṣṭakartṛkasya vanakusumāderapi	sāvayava tvāt na asiddhaḥ na api anaikāntikaḥ sarvasya adṛṣṭa kartṛkasya vana kusuma ādeḥ api 
SA_MB_moksakarikaHK-34	pakṣīkṛtatvāt | ata eva na viruddhaḥ, viparyayavyāptyabhāvāt | na ca	pakṣīkṛta tvāt atas eva na viruddhaḥ viparyaya vyāpti abhāvāt na ca 
SA_MB_moksakarikaHK-35	trairūpyāddhetulakṣaṇaṃ saṃbhavatītyuktamanyatra | nanvajñena kartrā saha dṛṣṭānte	trairūpyāt hetu lakṣaṇam saṃbhavati iti uktam anyatra nanu ajñena kartrā saha dṛṣṭānte 
SA_MB_moksakarikaHK-36	siddhavyāptikādasmāddhetorajña eva viśvakartā sambhavatīti iṣṭavyāghātaḥ ? na,	siddha vyāptikāt asmāt hetoḥ ajñaḥ eva viśva kartā sambhavati iti iṣṭa vyāghātaḥ na 
SA_MB_moksakarikaHK-37	yenāsāvapyajātamalasaṃbandha eva | kumbhakārasyāpi svakāryaniṣpattau malenājñānenā-	yena asau api ajāta mala saṃbandhaḥ eva kumbhakārasya api sva kārya niṣpattau malena ajñānena 
SA_MB_moksakarikaHK-38	nutpannasambandhatvāt | yadi hi tatrājñānaṃ bhrāntirvā bhavennaivāsau kumbhaṃ kuryāt,	an utpanna sambandha tvāt yadi hi tatra ajñānam bhrāntiḥ vā bhavet na eva asau kumbham kuryāt 
SA_MB_moksakarikaHK-39	api tviṣṭakāṃ ghaṭādikaṃ vikalāvayavaṃ kāryānupayoginaṃ kumbhakāraḥ kuryāt |	api tu iṣṭakām ghaṭa ādikam vikala avayavam kārya anupayoginam kumbhakāraḥ kuryāt 
SA_MB_moksakarikaHK-40	tadyathā sakalāvayavaṃ kumbhaṃ dṛṣṭvā kumbhakāro buddhisauṣṭhavayukto'numīyate, na	tat yathā sakala avayavam kumbham dṛṣṭvā kumbhakāraḥ buddhi sauṣṭhava yuktaḥ anumīyate na 
SA_MB_moksakarikaHK-41	tvajño bhrānto vā, tathaiveśvaro'pi svakāryād	tu ajñaḥ bhrāntaḥ vā tathā evā īśvaraḥ api sva kāryāt 
SA_MB_moksakarikaHK-42	viśvalakṣaṇādanumīyamāno'jātamalasambandha evānumīyata iti neṣṭavighātaḥ kaścit |	viśva lakṣaṇāt anumīyamānaḥ jāta mala sambandhaḥ eva anumīyate iti na iṣṭa vighātaḥ kaścid 
SA_MB_moksakarikaHK-43	nanu kumbhakārasya svakāryādanyatrājñānamastyeva | bhavatu, prakṛte'sya	nanu kumbhakārasya sva kāryāt anyatra ajñānam asti eva bhavatu 
SA_MB_moksakarikaHK-44	kumbhaviṣaye nāstītyatra dṛṣṭāntatā | nanvevamīśvarasya	kumbha viṣaye na asti iti atra dṛṣṭānta tā nanu evam īśvarasya 
SA_MB_moksakarikaHK-45	svakāryādanyatrājñānaprasaṅgaḥ ? na, tatkāryabhogamokṣasādhana-	sva kāryāt anyatra ajñāna prasaṅgaḥ na tad kārya bhoga mokṣa sādhana 
SA_MB_moksakarikaHK-46	viśvavyatirekeṇānyasyābhāvāt |	viśva vyatirekeṇa anyasya abhāvāt 
SA_MB_moksakarikaHK-47	nanvanyannāstīti kutaḥ,  astu tadbhogasādhanaṃ cetkāryakaraṇādivat kāryameva |	nanu anyat na asti iti kutas astu tat bhoga sādhanam ced kārya karaṇa ādi vat kāryam eva 
SA_MB_moksakarikaHK-48	tadasādhane tu tasmin niṣprayojane tasyājñānaṃ śaśaviṣāṇādāviva bhūṣaṇameva |	tad asādhane tu tasmin niṣprayojane tasya ajñānam śaśaviṣāṇa ādau iva bhūṣaṇam eva 
SA_MB_moksakarikaHK-49	tadāhuḥ- heyopādeyatattvasya sābhupeyasya vedakaḥ | yaḥ pramāṇamasāviṣṭaḥ na tu	tat āhuḥ heya upādeya tattvasya vedakaḥ yaḥ pramāṇam asau īṣṭaḥ na tu 
SA_MB_moksakarikaHK-50	sarvasya vedakaḥ || iti | ata eva viśvavyatirekeṇānyasyābhāvāt sarvajñaḥ sarvakartā ca	sarvasya vedakaḥ iti atas eva viśva vyatirekeṇa anyasya abhāvāt sarvajñaḥ sarva kartā ca 
SA_MB_moksakarikaHK-51	viśvakṛt | kumbhakārasyāpi svakārye svarjñatāsarvakartṛtāsiddheḥ | nahi tasya	viśvakṛt kumbhakārasya api sva kārye svar jña tā sarva kartṛ tā siddheḥ nahi tasya 
SA_MB_moksakarikaHK-52	tatrāṃśenāpyajñatve śaktivaikalye vā kumbhastato bhavedityuktam | ata eva kumbhakāravat	tatra aṃśena api ajña tve śakti vaikalye vā kumbhaḥ tatas bhavet iti uktam atas eva kumbhakāra vat 
SA_MB_moksakarikaHK-53	svakārya vyāpakatvād vibhuḥ kāryasya vibhutvāt | kumbhakārasyāpi hi	sva kārya vyāpaka tvāt vibhuḥ kāryasya vibhu tvāt kumbhakārasya api hi 
SA_MB_moksakarikaHK-54	svakāryapṛthubudhnodarabhogeṣvavyāpnuvatastatra parvatādāviva  kartṛtvā'siddheḥ |	sva kārya pṛthu budhna udara bhogeṣu avyāpnuvataḥ tatra parvata ādau iva kartṛ tva asiddheḥ 
SA_MB_moksakarikaHK-55	nanu kāryasattāvaccharīramapi viśvakartuḥ prāptam ? na kumbhakārādīnāmapi	nanu kārya sattāvat śarīram api viśvakartuḥ prāptam na kumbhakāra ādīnām api 
SA_MB_moksakarikaHK-56	svadehaspandādikārya na śarīrāntarapūrvakaṃ dṛṣṭaṃ yataḥ | nanu tadapīcchājanyameva ?	sva deha spanda ādi kārya na śarīra antara pūrvakam dṛṣṭam yatas nanu tat api icchā janyam eva 
SA_MB_moksakarikaHK-57	satyam | ata eva sarvaṃ kāryajātaṃ tameva kāraṇatvena na vyabhicaratīti	satyam atas eva sarvam kārya jātam tam eva kāraṇa tvena na vyabhicarati iti 
SA_MB_moksakarikaHK-58	viśvakartā'pīcchānantarakāryakṛdanumīyata ityadoṣaḥ | nanvicchāpi manovṛttiḥ, kathaṃ	viśvakartā api icchā anantara kārya kṛt anumīyate iti adoṣaḥ nanu icchā api manaḥ vṛttiḥ katham 
SA_MB_moksakarikaHK-59	viśvakartuḥ sā saṃbhavati | icchā na manovṛttirasmadādīnāmapi, kintu buddhyabhivyaṅgyā	viśvakartuḥ sā saṃbhavati icchā na manaḥ vṛttiḥ asmat ādīnām api kintu buddhi abhivyaṅgyā 
SA_MB_moksakarikaHK-60	jñānaśaktiriva manobhivyaṅgyā kriyāśaktirevetyuktamasmābhirmantravārttikaṭī-kāyām-	jñānaśaktiḥ iva manaḥ abhivyaṅgyā kriyāśaktiḥ eva iti uktam asmābhiḥ mantravārttikaṭīkāyām 
SA_MB_moksakarikaHK-61	śāktasya hi tanmanasastvicchā hyeṣā kriyāśaktiḥ iti | ato bhagavatastvanāvṛtaśaktitvānna	śāktasya hi tanmanasaḥ tu icchā hi eṣā kriyāśaktiḥ iti atas bhagavataḥ tu anāvṛta śakti tvāt na 
SA_MB_moksakarikaHK-62	vyañjakopayogaḥ | nanvicchāyāḥ śarīrāntaranairapekṣyeṇa	vyañjaka upayogaḥ nanu icchāyāḥ śarīra antara nairapekṣyeṇa 
SA_MB_moksakarikaHK-63	tadadhiṣṭhitaśarīraspandādikartṛtvaṃ dṛṣṭam, na bāhye syānmṛdādijanye ghaṭādau | satyam	tad adhiṣṭhita śarīra spanda ādi kartṛ tvam dṛṣṭam na bāhye syāt mṛd ādi janye ghaṭa ādau satyam 
SA_MB_moksakarikaHK-64	| ata eva sarvadā'dhiṣṭheyatvena viśvaṃ tasya śarīramivānumīyata iti | ata eva ca	atas eva sarvadā adhiṣṭheya tvena viśvam tasya śarīram iva anumīyate iti atas eva ca 
SA_MB_moksakarikaHK-65	kāryadarśanājjñānakriyecchāśaktisākalyamevānumīyate, na kalārāgavidyādiśarīrayogaḥ,	kārya darśanāt jñāna kriyā icchā śakti sākalyam eva anumīyate na kalā rāga vidyā ādi śarīra yogaḥ 
SA_MB_moksakarikaHK-66	vyabhicārāditi |	vyabhicārāt iti 
SA_MB_moksakarikaHK-67	sakalo niṣkalaśca  viśvakartetyagre bhaviṣyati | kiñci, ananto jñatvādiśaktiyogād	sakalaḥ niṣkalaḥ ca viśvakartā iti agre bhaviṣyati anantaḥ jña tva ādi śakti yogāt 
SA_MB_moksakarikaHK-68	ātmavat | sādhitaṃ cātmanāmanantatvaṃ vibhutā ca bhogaprakaraṇe, ityato'pi vibhuḥ |	ātma vat sādhitam ca ātmanām ananta tvam vibhu tā ca bhoga prakaraṇe iti atas api vibhuḥ 
SA_MB_moksakarikaHK-69	nanu ghaṭapaṭādikāryabahutvaṃ kartṛbahutvāvinābhāvasiddhamityatrāpi kṣityādijalāntāni	nanu ghaṭa paṭa ādi kārya bahutvam kartṛ bahutva avinābhāva siddham iti atra api kṣiti ādi jala antāni 
SA_MB_moksakarikaHK-70	viśvaśabda-vācyāni bahūni, kāryatvena hi bahavo viśvakartāro'numeyāḥ ? satyam | yadi	viśva śabda vācyāni bahūni kārya tvena hi bahavaḥ viśva kartāraḥ numeyāḥ satyam yadi 
SA_MB_moksakarikaHK-71	hyeṣāmekabhogaprayojanatā na syāt | pratipāditā ca kalodvalita-caitanyo vidyādarśitagocaraḥ	hi eṣām eka bhoga prayojana tā na syāt pratipāditā ca kalā udvalita caitanyaḥ vidyā darśita gocaraḥ 
SA_MB_moksakarikaHK-72	(svā0 32|10) ityādau | yacca bhinnamapyeka-prayojanaṃ tadekabuddhimatkartṛjanyaṃ prāsādādi	svāḥ ityādau yat ca bhinnam api eka prayojanam tat eka buddhimat kartṛ janyam prāsāda ādi 
SA_MB_moksakarikaHK-73	niścitamiti nirmuktātiśayaiśvaryaḥ, tasyaiva samastaviśvakaraṇāt; sa ca śivaḥ paropakārāyaiva	niścitam iti nirmukta atiśaya aiśvaryaḥ tasya eva samasta viśva karaṇāt sa ca śivaḥ para upakārāya eva 
SA_MB_moksakarikaHK-74	pravṛtteḥ sarvatra taddharmayuktaḥ pramāṇasiddha iti || 1-2 ||	pravṛtteḥ sarvatra tad dharma yuktaḥ pramāṇa siddhaḥ iti 
SA_MB_moksakarikaHK-75	atra sāṃkhyacchāyayā paraḥ-	atra sāṃkhya chāyayā paraḥ 
SA_MB_moksakarikaHK-76	citrāt tantuguṇāccitraḥ paṭo dṛṣṭo na śaṅkarāt |	citrāt tantu guṇāt citraḥ paṭaḥ dṛṣṭaḥ na śaṅkarāt 
SA_MB_moksakarikaHK-77	yathā tadvajjagaccitraṃ citrādbījānna śaṅkarāt || 3 ||	yathā tadvat jagat citram citrāt bījāt na śaṅkarāt  /
SA_MB_moksakarikaHK-78	na paṭopakārakaṃ kuvindamapahnutyedaṃ yujyate vaktum, bhūyo virodhāt | kintu	na paṭa upakārakam kuvindam apahnutya idam yujyate vaktum bhūyas virodhāt kintu 
SA_MB_moksakarikaHK-79	satyapi tasmin viśvakartrā śivenāsya hetordṛṣṭānte vyāptirasiddhetyanaikāntikatā |	sati api tasmin viśvakartrā śivena asya hetoḥ dṛṣṭānte vyāptiḥ asiddhā iti anaikāntika tā 
SA_MB_moksakarikaHK-80	jagadvidhāturmāyākhyasya gamakatvameva | na kāryamupādānakāraṇaṃ vyabhicarati yataḥ ||	jagat vidhātuḥ māyā ākhyasya gamaka tvam eva na kāryam upādānakāraṇam vyabhicarati yatas 
SA_MB_moksakarikaHK-81	naiṣa doṣaḥ 	na eṣa doṣaḥ 
SA_MB_moksakarikaHK-82	kuvindabuddhikarmabhyāṃ na vinā paṭakāraṇam |	kuvinda buddhi karmabhyām na vinā paṭa kāraṇam 
SA_MB_moksakarikaHK-83	dṛṣṭaṃ tantusamākhyātamupādānamacetanam || 4 ||	dṛṣṭam tantu samākhyātam upādānam acetanam 
SA_MB_moksakarikaHK-84	yadvat tadvajjagadbījamupādānamacetanam |	yadvat tadvat jagat bījam upādānam acetanam 
SA_MB_moksakarikaHK-85	jñānakriye maheśasya parityajya na kāraṇam || 5 ||	jñāna kriye maheśasya parityajya na kāraṇam 
SA_MB_moksakarikaHK-86	upādānakāraṇamapi tantvādikaṃ viśiṣṭajñānakriyāyuktapaṭādikartāraṃ vinā na	upādānakāraṇam api tantu ādikam viśiṣṭa jñāna kriyā yukta paṭa ādi kartāram vinā na 
SA_MB_moksakarikaHK-87	svakāryaṃ kurvad dṛṣṭamiti kāryamātramupādānakāraṇavat kartṛmātreṇa vyāptaṃ	sva kāryam kurvat dṛṣṭam iti kārya mātram upādānakāraṇavat kartṛ mātreṇa vyāptam 
SA_MB_moksakarikaHK-88	siddhameveti viśvasyāpyupādānakāraṇavattvena pratyuta kāryapūrvatvavat kartā sādhyata iti	siddham eva iti viśvasya api upādānakāraṇavat tvena pratyuta kārya pūrva tva vat kartā sādhyate iti 
SA_MB_moksakarikaHK-89	nānaikāntikatā || 4 5 ||	na anaikāntika tā   /
SA_MB_moksakarikaHK-90	adhunā mīmāṃsakadṛṣṭyā siddhasādhanam 	adhunā mīmāṃsaka dṛṣṭyā siddhasādhanam 
SA_MB_moksakarikaHK-91	āhāparo jagaccitraṃ vaicitryāt karmaṇo bhavet |	āha aparaḥ jagat citram vaicitryāt karmaṇaḥ bhavet 
SA_MB_moksakarikaHK-92	phalaṃ ca karmataḥ puṃsāṃ kimatreśvarakāritā || 6 ||	phalam ca karmataḥ puṃsām kim atra īśvara kāri tā 
SA_MB_moksakarikaHK-93	kāryatvāt tatra kartṛmātramanusandheyam | bhavadbhiśca dharmādharmātmakaṃ	kārya tvāt tatra kartṛ mātram anusandheyam bhavadbhiḥ ca dharma adharma ātmakam 
SA_MB_moksakarikaHK-94	karmaiva kṛṣyādikarmavat kāryajanakamaṅgīkṛtamiti kimanyadanumīyate || 6 ||	karma eva kṛṣi ādi karma vat kārya janakam aṅgīkṛtam iti kim anyat anumīyate  /
SA_MB_moksakarikaHK-95	satyametat tathāpīdaṃ karmadṛṣṭamacetanam |	satyam etat tathā api idam karma dṛṣṭam acetanam 
SA_MB_moksakarikaHK-96	kṛṣyādivat tu kartāraṃ prajñāvantamapekṣate || 7 ||	kṛṣi ādi vat tu kartāram prajñāvantam apekṣate 
SA_MB_moksakarikaHK-97	dṛṣṭamapi kṛṣyādikaṃ karma na tu buddhimatkartrā vinā phalajanakaṃ puṃbhyo	dṛṣṭam api kṛṣi ādikam karma na tu buddhimat kartrā vinā phala janakam puṃbhyaḥ 
SA_MB_moksakarikaHK-98	bhogānāhṛtya dātuṃ samarthaṃ dṛṣṭamiti dharmādharmātmakamapi karmatvāt	bhogān āhṛtya dātum samartham dṛṣṭam iti dharma adharma ātmakam api karma tvāt 
SA_MB_moksakarikaHK-99	svaphaladānāya jñānātiśaya-yuktaṃ pratyuta tameva viśvakartāramasiddhaṃ sādhayatīti na	sva phala dānāya jñāna atiśaya yuktam pratyuta tam eva viśvakartāram asiddham sādhayati iti na 
SA_MB_moksakarikaHK-100	siddhasādhyatā | tatra dṛṣṭe sati nādṛṣṭakalpanā yukteti || 7 ||	siddha sādhya tā tatra dṛṣṭe sati na adṛṣṭa kalpanā yuktā iti 
SA_MB_moksakarikaHK-101	apare bruvate kartṛ bahudhā cetanairyutam |	apare bruvate kartṛ bahudhā cetanaiḥ yutam 
SA_MB_moksakarikaHK-102	pumbhireva bhaved bījaṃ kiṃ hareṇeti tannahi || 8 ||	pumbhiḥ eva bhavet bījam kim hareṇa iti tat na hi 
SA_MB_moksakarikaHK-103	kāyikavyāpārādau kṛṣyādāviva bahudhā cetanairdṛṣṭaireva puruṣairyuktaṃ	kāyika vyāpāra ādau kṛṣi ādau iva bahudhā cetanaiḥ dṛṣṭaiḥ eva puruṣaiḥ yuktam 
SA_MB_moksakarikaHK-104	jagadbījaṃ sarvaṃ kalādikāryaṃ bahukartṛtayā kariṣyatīti	jagat bījam sarvam kalā ādi kāryam bahu kartṛtayā kariṣyati iti 
SA_MB_moksakarikaHK-105	dṛṣṭahānyadṛṣṭaparikalpanābhyāṃ na kartrantarasiddhiḥ | tannahīti tanna yuktamityarthaḥ || 8	dṛṣṭa hāni adṛṣṭa parikalpanābhyām na kartṛ antara siddhiḥ tat nahi iti tat na yuktam iti arthaḥ 
SA_MB_moksakarikaHK-106	yasmāt tayoḥ prakṛtipuruṣayoḥ saṃbandhamātraṃ vā puṃsāṃ	yasmāt tayoḥ prakṛti puruṣayoḥ saṃbandha mātram vā puṃsām 
SA_MB_moksakarikaHK-107	kalādikāryakaraṇahetuḥ, viśiṣṭo vā bhogyabhoktṛlakṣaṇaḥ saṃbandhaḥ ? tatra 	kalā ādi kārya karaṇa hetuḥ viśiṣṭaḥ vā bhogya bhoktṛ lakṣaṇaḥ saṃbandhaḥ tatra 
SA_MB_moksakarikaHK-108	sāmānyo yadi saṃbandha utpattau kāraṇaṃ tayoḥ |	sāmānyaḥ yadi saṃbandhaḥ utpattau kāraṇam tayoḥ 
SA_MB_moksakarikaHK-109	tataḥ kalādikāryasya nityotpādaḥ prasajyate || 9 ||	tatas kalā ādi kāryasya nitya utpādaḥ prasajyate 
SA_MB_moksakarikaHK-110	vyāpakatvāt prakṛtipuruṣayoḥ kaivalyāvasthāyāmapi saṃyuktatayā	vyāpaka tvāt prakṛti puruṣayoḥ kaivalya avasthāyām api saṃyukta tayā 
SA_MB_moksakarikaHK-111	saṃbandhamātrasya bhāvāt | kalādikāryakaraṇotpāde satyanirmokṣaprasaṅgaḥ || 9 ||	saṃbandha mātrasya bhāvāt kalā ādi kārya karaṇa utpāde satya nirmokṣa prasaṅgaḥ 
SA_MB_moksakarikaHK-112	atha dvitīyaḥ pakṣaḥ 	atha dvitīyaḥ pakṣaḥ 
SA_MB_moksakarikaHK-113	viśiṣṭaścet tayoryogo vaktavyaṃ tasya kāraṇam |	viśiṣṭaḥ ced tayoḥ yogaḥ vaktavyam tasya kāraṇam 
SA_MB_moksakarikaHK-114	yena nākasmikaṃ kāryaṃ dṛṣṭaṃ kvacana kiñcana || 10 ||	yena na ākasmikam kāryam dṛṣṭam kvacana kiñcana 
SA_MB_moksakarikaHK-115	prakṛtirhi na prakṛtisvarūpatayā bhogyā, nāpi puruṣaḥ svarūpeṇa bhoktā,	prakṛtiḥ hi na prakṛti sva rūpa tayā bhogyā nā api puruṣaḥ sva rūpeṇa bhoktā 
SA_MB_moksakarikaHK-116	mokṣābhāvaprasaṅgāt | api tu kalādikāryadvāreṇa, tatsaṃbandhasya hi kalādijananāt |	mokṣa abhāva prasaṅgāt api tu kalā ādi kārya dvāreṇa tad saṃbandhasya hi kalā ādi jananāt 
SA_MB_moksakarikaHK-117	janyasya saṃyogātmakasya tayorbhogyabhoktṛrūpasya saṃbandhaviśeṣasya kartā vācyaḥ |	janyasya saṃyoga ātmakasya tayoḥ bhogya bhoktṛ rūpasya saṃbandha viśeṣasya kartā vācyaḥ 
SA_MB_moksakarikaHK-118	yena nākartṛkaṃ kāryaṃ saṃbhavatītyuktam || 10 ||	yena na akartṛkam kāryam saṃbhavati iti uktam 
SA_MB_moksakarikaHK-119	nanu tayorevātra kartṛtvam, kimanyena? tanna, yataḥ 	nanu tayoḥ eva atra kartṛ tvam kim anyena tat na yatas 
SA_MB_moksakarikaHK-120	puruṣo na svatastāvad bījaṃ no yāti taṃ prati |	puruṣaḥ na svatas tāvat bījam no yāti tam prati 
SA_MB_moksakarikaHK-121	puruṣasyāśaktatayā prakṛteḥ svataḥ kāryakaraṇakalādinirmāṇe sāmarthyādṛṣṭeḥ,	puruṣasya aśakta tayā prakṛteḥ svatas kārya karaṇa kalā ādi nirmāṇe sāmarthya adṛṣṭeḥ 
SA_MB_moksakarikaHK-122	prakṛteścādṛṣṭatayā viśiṣṭamevaṃvidhaṃ karmanimittaṃ puruṣāya kāryakaraṇaṃ syāditi	prakṛteḥ ca adṛṣṭa tayā viśiṣṭam evaṃvidham karma nimittam puruṣāya kārya karaṇam syāt iti 
SA_MB_moksakarikaHK-123	jñānābhāvād bhohyabhoktṛsaṃbandhe na kartṛkatā, kintu saṃbandhamātra iti ||	jñāna abhāvāt bhohya bhoktṛ saṃbandhe na kartṛkatā kintu saṃbandha mātre iti 
SA_MB_moksakarikaHK-124	tasmād yoge viyoge vā maheśaḥ kāraṇaṃ tayoḥ || 11 ||	tasmāt yoge viyoge vā maheśaḥ kāraṇam tayoḥ  /
SA_MB_moksakarikaHK-125	tasmād bhogamokṣasādhanadarśanānyathānupapattyā sarvajñaḥ sarvakartā	tasmāt bhoga mokṣa sādhana darśana anyathā anupapattyā sarvajñaḥ sarva kartā 
SA_MB_moksakarikaHK-126	parameśvara eva, nānyaḥ || 11 ||	parameśvaraḥ eva na anyaḥ 
SA_MB_moksakarikaHK-127	tatra lokāyatabhūmikayā paraḥ 	tatra lokāyata bhūmikayā paraḥ 
SA_MB_moksakarikaHK-128	svabhāvato jagadbījaṃ jagatkartṛ hareṇa kim |	svabhāvataḥ jagat bījam jagat kartṛ hareṇa kim 
SA_MB_moksakarikaHK-129	svabhāva eva vaktavyo gatvā dūramapi tvayā || 12 ||	svabhāvaḥ eva vaktavyaḥ gatvā dūram api tvayā 
SA_MB_moksakarikaHK-130	parameśvaramapi kalpayitvā tasya jagatkartṛtvasvabhāvo bhavadbhiḥ kalpanīyaḥ |	parameśvaram api kalpayitvā tasya jagatkartṛ tva svabhāvaḥ bhavadbhiḥ kalpanīyaḥ 
SA_MB_moksakarikaHK-131	tadvaraṃ prakṛterevobhayavādisiddhāyā tajatkartṛtvasvabhāvaḥ kalpyatām | evaṃ ca na	tat varam prakṛteḥ eva ubhaya vādi siddhāyā kalpyatām evam ca na 
SA_MB_moksakarikaHK-132	bahvadṛṣṭaṃ kalpitaṃ bhaviṣyatīti || 12 ||	bahu adṛṣṭam kalpitam bhaviṣyati iti 
SA_MB_moksakarikaHK-133	tadayuktataram, tayastasya prakṛtilakṣaṇasya jagatkartuḥ-	tat ayuktataram tayaḥ tasya prakṛti lakṣaṇasya jagatkartuḥ 
SA_MB_moksakarikaHK-134	svabhāvaḥ pratipattavyaḥ kiṃviśiṣṭo jagatkṛtaḥ |	svabhāvaḥ pratipattavyaḥ kiṃviśiṣṭaḥ jagat kṛtaḥ 
SA_MB_moksakarikaHK-135	nanu ko'yaṃ praśno jagatkartṛlakṣaṇa eva svabhāvastasya? satyam, kintu-	nanu kaḥ ayam praśnaḥ jagat kartṛ lakṣaṇaḥ eva svabhāvaḥ tasya satyam kintu 
SA_MB_moksakarikaHK-136	vyāpāraḥ paranunnasya svatantrasyāthavā budhāḥ || 13 ||	vyāpāraḥ para nunnasya svatantrasya athavā budhāḥ 
SA_MB_moksakarikaHK-137	jagatkāraṇātmā tasya svabhāvaḥ kiṃ buddhimatkartṛpreritasya kevalasya vā ? tatra 	jagat kāraṇa ātmā tasya svabhāvaḥ kim buddhimat kartṛ preritasya kevalasya vā tatra 
SA_MB_moksakarikaHK-138	svatantrasyeti pakṣe'smin na mānamiti sādhitam |	svatantrasya iti pakṣe ismin na mānam iti sādhitam 
SA_MB_moksakarikaHK-139	acetanasya kartṛtvapakṣe na pramāṇamastīti sādhitaṃ pūrvameva ||	acetanasya kartṛ tva pakṣe na pramāṇam asti iti sādhitam pūrvam eva 
SA_MB_moksakarikaHK-140	kathaṃ sādhitam 	katham sādhitam 
SA_MB_moksakarikaHK-141	svatantraṃ kāryakṛd yasmānnopādānamacit kvacit || 14 ||	svatantram kārya kṛt yasmāt na upādānam acit kvacid 
SA_MB_moksakarikaHK-142	atha dvitīyaḥ, sa ca yukta eva-	atha dvitīyaḥ sa ca yuktaḥ eva 
SA_MB_moksakarikaHK-143	prajñāvacchaktinunnasya vyāpāro mānasādhitaḥ |	              
SA_MB_moksakarikaHK-144	prajñāvataḥ kriyāśaktyā preritasya jagatkaraṇe vyāpāraḥ, tasya	prajñāvataḥ kriyāśaktyā preritasya jagat karaṇe vyāpāraḥ tasya 
SA_MB_moksakarikaHK-145	pramāṇasiddhatvādiṣyata eva ||	pramāṇa siddha tvāt iṣyate eva 
SA_MB_moksakarikaHK-146	tataśca 	tatas ca 
SA_MB_moksakarikaHK-147	prajñāvān prerakastasya yaḥ sa vijñeya īśvaraḥ || 15 ||	prajñāvān prerakaḥ tasya yaḥ sa vijñeyaḥ īśvaraḥ 
SA_MB_moksakarikaHK-148	yaścetanaḥ svaśaktyā tat prerayati sa eva īśvaraḥ siddha iti na svabhāvavādaḥ |	yaḥ cetanaḥ sva śaktyā tat prerayati saḥ eva īśvaraḥ siddhaḥ iti na svabhāva vādaḥ 
SA_MB_moksakarikaHK-149	yadyevaṃ kriyāśaktimātramevātra tatprerakamastu, kimīśvareṇa? tasyāpi tayā vinā	yadi evam kriyāśakti mātram eva atra tat prerakam astu kim īśvareṇa tasya api tayā vinā 
SA_MB_moksakarikaHK-150	kartṛtvāsiddheḥ | yadāhuḥ-	kartṛ tva asiddheḥ yat āhuḥ 
SA_MB_moksakarikaHK-151	yā tvaṃ kartuḥ kriyāśaktirīśvarasya yayā vinā |	yā tvam kartuḥ kriyā śaktiḥ īśvarasya yayā vinā 
SA_MB_moksakarikaHK-152	tasyāpi kartṛtā naiva caṇḍi tasyai namo'stu te || 15 || iti |	tasya api kartṛ tā nā eva caṇḍi tasyai namaḥ astu te        
SA_MB_moksakarikaHK-153	icchāśaktiḥ parāśaktiḥ prakḷptā nānya īśvaraḥ |	icchā śaktiḥ parā śaktiḥ prakḷptā na anyaḥ īśvaraḥ 
SA_MB_moksakarikaHK-154	pravartate yadudrekād divākāle niśānvite || 16 ||	pravartate yad udrekāt divākāle niśā anvite 
SA_MB_moksakarikaHK-155	suptā kāla ihānte sā nirvyāpārājjagannidhau |	suptā kāle iha ante sā nirvyāpārāt jagannidhau 
SA_MB_moksakarikaHK-156	yadyasmāt saiva śaktiḥ prakṛtyadhikaraṇā preraṇottaraṃ sodrekāt	yadi yasmāt sā eva śaktiḥ prakṛti adhikaraṇā preraṇa uttaram sa udrekāt 
SA_MB_moksakarikaHK-157	sāmarthyalakṣaṇānmāyāto jagatkaraṇāya pravartate, iti neśvaro'nyaḥ || 16 ||	sāmarthya lakṣaṇāt māyātaḥ jagat karaṇāya pravartate iti na īśvaraḥ nyaḥ  /
SA_MB_moksakarikaHK-158	tadayuktam 	tat ayuktam 
SA_MB_moksakarikaHK-159	udreke kāraṇaṃ tasya nānyadasti maheśvarāt || 17 ||	udreke kāraṇam tasya na anyat asti maheśvarāt  
SA_MB_moksakarikaHK-160	jaḍasya svayaṃ pravṛttāvapravṛttau vā sāmarthyaṃ nāstītyuktam,	jaḍasya svayam pravṛttau apravṛttau vā sāmarthyam na asti iti uktam 
SA_MB_moksakarikaHK-161	ato'nyathānupapattyā jñānātiśayayuktaḥ parameśvara evodrede tasyāḥ kāraṇam || 17 ||	atonyathā anupapattyā jñāna atiśaya yuktaḥ parameśvaraḥ eva udrede tasyāḥ kāraṇam  /
SA_MB_moksakarikaHK-162	nanu saiva sarvajñā bhaviṣyati 	nanu sā eva sarvajñā bhaviṣyati 
SA_MB_moksakarikaHK-163	sarvajñā saiva cennāmni vivādo na ca vastuni |	sarvajñā sā eva ced nāmni vivādaḥ na ca vastuni 
SA_MB_moksakarikaHK-164	yadyevaṃ nāmni vivādaḥ, na ca nāmabhedād vastubheda iti tato vyatirekastasyāḥ	yadi evam nāmni vivādaḥ na ca nāma bhedāt vastu bhedaḥ iti tatas vyatirekaḥ tasyāḥ 
SA_MB_moksakarikaHK-165	prakalpita evāstu | tarhi sarvajñatvādidharmikā prakṛtireveśvara iti vedāntavidaḥ ||	prakalpitaḥ evā astu tarhi sarvajña tva ādi dharmikā prakṛtiḥ evā īśvaraḥ iti vedānta vidaḥ 
SA_MB_moksakarikaHK-166	parātmano maheśāttu dṛkkriyāśaktiśālinaḥ || 18 ||	parātmanaḥ maheśāt tu dṛkkriyā śakti śālinaḥ 
SA_MB_moksakarikaHK-167	cetanācetanaṃ viśvaṃ bhoktṛbhogyavibhāgataḥ |	cetana acetanam viśvam bhoktṛ bhogya vibhāgataḥ 
SA_MB_moksakarikaHK-168	utpatsyate tato'nyena jagadīśena kiṃ phalam || 19 ||	utpatsyate tatas anyena jagadīśena kim phalam 
SA_MB_moksakarikaHK-169	bhoktā cāpi sa evaiko varamaṅgīkṛto vibhuḥ |	bhoktā ca api saḥ evā ekaḥ varam aṅgīkṛtaḥ vibhuḥ 
SA_MB_moksakarikaHK-170	bhoktṛbhogyādibhedabhinnāccetanācetanād viśvalakṣaṇāt kāryādanumīyamānaṃ	bhoktṛ bhogya ādi bheda bhinnāt cetana acetanāt viśva lakṣaṇāt kāryāt anumīyamānam 
SA_MB_moksakarikaHK-171	sarvajñānakriyāyuktaṃ kāryadvāreṇa bhoktṛbhogyādisvabhāvamekamevādvitīyaṃ	sarva jñāna kriyā yuktam kārya dvāreṇa bhoktṛ bhogya ādi svabhāvam ekam eva advitīyam 
SA_MB_moksakarikaHK-172	paramātmasaṃjñamī-śvaralakṣaṇamupādānamanumeyamityadvaitasiddherna bhinneśvarakalpanā	paramātma saṃjñam īśvara lakṣaṇam upādānam anumeyam iti advaita siddheḥ na bhinna īśvara kalpanā 
SA_MB_moksakarikaHK-173	yukteti || 18-19 ||	yuktā iti 
SA_MB_moksakarikaHK-174	nanu cetanānāṃ nityatvena prāg bhogaprakaraṇe pratipāditatvāt kāryatvamasiddham ?	nanu cetanānām nitya tvena prāk bhoga prakaraṇe pratipādita tvāt kārya tvam asiddham 
SA_MB_moksakarikaHK-175	na, anekānvitatvena kāryatvasaṃbhavāt | acetanānāmiva cetanānāmapi	na aneka anvita tvena kāryatva saṃbhavāt acetanānām iva cetanānām api 
SA_MB_moksakarikaHK-176	cidanvayādupādānakāraṇaṃ cetanaṃ siddhyatyeva | tadapyanupapannam, yataḥ 	cit anvayāt upādānakāraṇam cetanam siddhyati eva tat api anupapannam yatas 
SA_MB_moksakarikaHK-177	cidacidviśvasaṃbhūtirātmano yadi so'pi hi || 20 ||	cit acit viśva saṃbhūtiḥ ātmanaḥ yadi saḥ api hi 
SA_MB_moksakarikaHK-178	cidacijjāyate yasmāt kāryaṃ kāraṇadharmagam |	cit acit jāyate yasmāt kāryam kāraṇa dharma gam 
SA_MB_moksakarikaHK-179	paramātmanaḥ sakāśād yadi cetanācetanaṃ viśvamutpadyate, tataḥ so'pi	paramātmanaḥ sakāśāt yadi cetana acetanam viśvam utpadyate tatas saḥ api 
SA_MB_moksakarikaHK-180	paramātmā cetanācetanasvabhāvo bhavet | upādānakāraṇasvarūpānugatā eva	paramātmā cetana acetana svabhāvaḥ bhavet upādāna kāraṇa svarūpa anugatāḥ eva 
SA_MB_moksakarikaHK-181	kāryāṇāṃ mūrtiviśeṣā hemamṛdādijanyaghaṭādīnāṃ siddhā yataḥ || 20 ||	kāryāṇām mūrti viśeṣāḥ hema mṛd ādi janya ghaṭa ādīnām siddhāḥ yatas 
SA_MB_moksakarikaHK-182	tataśca 	tatas ca 
SA_MB_moksakarikaHK-183	viruddhāvekakālasthau dharmāvekāśrayaṃ gatau || 21 ||	viruddhau eka kāla sthau dharmau eka āśrayam gatau 
SA_MB_moksakarikaHK-184	itaretaranāśāt tau kuruto lopamātmanaḥ |	itaretara nāśāt tau kurutaḥ lopam ātmanaḥ 
SA_MB_moksakarikaHK-185	viruddhayoḥ parasparopamardenaivātmalābhād ghaṭatadabhāvayo-riva	viruddhayoḥ paraspara upamardena eva ātmalābhāt ghaṭa tad abhāvayoḥ iva 
SA_MB_moksakarikaHK-186	cetanācetanayorekatraikasmin kāle na saṃbhavaḥ | atha kenacid bhāgena cetano'sau	cetana acetanayoḥ ekatra ekasmin kāle na saṃbhavaḥ atha kenacid bhāgena cetanā usau 
SA_MB_moksakarikaHK-187	kenacinnetyucyate, yadyevaṃ sabhāgatve sati ghaṭādivat kāryatvāt paramakāraṇatvāyogaḥ ||	kenacid na iti ucyate yadi evam sa bhāga tve sati ghaṭa ādi vat kāryatvāt parama kāraṇatva ayogaḥ 
SA_MB_moksakarikaHK-188	api ca 	api ca 
SA_MB_moksakarikaHK-189	upādānatvato mṛdvat paramātmā na cetanaḥ || 22 ||	upādāna tvataḥ mṛd vat paramātmā na cetanaḥ 
SA_MB_moksakarikaHK-190	upādānakāraṇamacetanaṃ mṛdādi niścitamiti paramātmano'pyacetanatvam, upādāna	upādānakāraṇam acetanam mṛd ādi niścitam iti paramātmanā upi acetana tvam upādāna 
SA_MB_moksakarikaHK-191	kāraṇatvāt | cetanatve vā nopādānakāraṇatvamiti || 22 ||	kāraṇa tvāt cetana tve vā na upādānakāraṇa tvam iti 
SA_MB_moksakarikaHK-192	kiñca 	kiñca 
SA_MB_moksakarikaHK-193	tadutthāścāpi bhoktāra utpādyatvād ghaṭādivat |	tad utthāḥ ca api bhoktāraḥ utpādya tvāt ghaṭa ādi vat 
SA_MB_moksakarikaHK-194	upādānakāraṇādutpadyamānaṃ ghaṭādyacetanameva siddhamiti	upādānakāraṇāt utpadyamānam ghaṭa ādi acetanam eva siddham iti 
SA_MB_moksakarikaHK-195	paramātmalakṣaṇādupādānakāraṇādutpadyamānā bhoktāra ātmāno'pyacetanāḥ	paramātma lakṣaṇāt upādānakāraṇāt utpadyamānāḥ bhoktāraḥ ātmānaḥ api acetanāḥ 
SA_MB_moksakarikaHK-196	prasajyante bhavatām | cetanāścaite yathā svaparagrāhakatvena svasaṃvedanasiddhā iti na	prasajyante bhavatām cetanāḥ ca ete yathā sva para grāhaka tvena sva saṃvedana siddhāḥ iti na 
SA_MB_moksakarikaHK-197	tatrotpannāḥ, tat paramātmavannityā iti | nanvanvayādeṣāmacetanānāmiva kāryatvamuktam,	tatra utpannāḥ tat paramātma vat nityāḥ iti nanu anvayāt eṣām acetanānām iva kārya tvam uktam 
SA_MB_moksakarikaHK-198	tanna yuktam,  ananvayāditi | na cātmana evātmā grāhyo bhavati, tatra tasya	tat na yuktam ananvayāt iti na ca ātmanaḥ eva ātmā grāhyaḥ bhavati tatra tasya 
SA_MB_moksakarikaHK-199	vyāpāravirodhāt | api tu grāhakatvenaiva pratyagrūpatayā sarvadā bhāsata	vyāpāra virodhāt api tu grāhaka tvena eva pratyagrūpa tayā sarvadā bhāsata 
SA_MB_moksakarikaHK-200	ityuktamasmābhiḥ paramokṣanirāsakārikāvṛttau vistareṇa | tatraivāvadhāryam ||	iti uktam asmābhiḥ paramokṣanirāsakārikā vṛttau vistareṇa tatra eva avadhāryam 
SA_MB_moksakarikaHK-201	tataśca 	tatas ca 
SA_MB_moksakarikaHK-202	acitprasavadharmī yat paramātmā mṛdādivat || 23 ||	acit prasava dharmī yat paramātmā mṛd ādi vat 
SA_MB_moksakarikaHK-203	prajñāvat kṣobhakāpekṣaḥ svajanyajananāya tat |	prajñā vat kṣobhaka apekṣaḥ sva janya jananāya tat 
SA_MB_moksakarikaHK-204	yadyasmāt paramātmana upādānakāraṇatvenācetanatvamuktam, tattasmādeva	yat yasmāt paramātmanaḥ upādānakāraṇa tvena acetana tvam uktam tat tasmāt eva 
SA_MB_moksakarikaHK-205	svakāryaniṣpattaye mṛdādivad buddhimatkartṛpreritatvamasyābhyupagantavyam || 23 ||	sva kārya niṣpattaye mṛd ādi vat buddhimat kartṛ prerita tvam asya abhyupagantavyam 
SA_MB_moksakarikaHK-206	evamadvaitānupapattiḥ 	evam advaita anupapattiḥ 
SA_MB_moksakarikaHK-207	tasmād bhoktā jagadbījaṃ maheśaścāpi śaktimān || 24 ||	tasmāt bhoktā jagadbījam maheśaḥ ca api śaktimān 
SA_MB_moksakarikaHK-208	pṛthak pṛthag viniśceyāḥ proktadoṣopaśāntaye |	pṛthak pṛthak viniśceyāḥ prokta doṣa upaśāntaye 
SA_MB_moksakarikaHK-209	tasmādbhoktāro'nutpannā eva, jagannidhiśca jaḍaḥ, jagatkartā	tasmāt bhoktāraḥ anutpannāḥ eva jagat nidhiḥ ca jaḍaḥ jagat kartā 
SA_MB_moksakarikaHK-210	sarvajñatvādidharmayukto maheśvaraśca parasparaṃ bhinnā eva nityā abhyupagantavyāḥ |	sarvajña tva ādi dharma yuktaḥ maheśvaraḥ ca parasparam bhinnāḥ eva nityāḥ abhyupagantavyāḥ 
SA_MB_moksakarikaHK-211	taduktaṃ tattvatrayanirṇaye  śambhuḥ puruṣo māyā nityaṃ vibhu kartṛśaktiyuktaṃ ca |	tat uktam tattvatrayanirṇaye 
SA_MB_moksakarikaHK-212	supte'pi vikṛtijāte tritayaṃ jāgarti tattvānām || (ślo0 3) ityupādānakāraṇādanyaḥ	supte api vikṛti jāte tritayam jāgarti tattvānām iti upādānakāraṇāt anyaḥ 
SA_MB_moksakarikaHK-213	parameśvaraḥ siddha iti na doṣaḥ kaścit |	parameśvaraḥ siddhaḥ iti na doṣaḥ kaścid 
SA_MB_moksakarikaHK-214	nanvapariṇāminī śaktiḥ, tatkathaṃ śivaśakterjñānakriyābheda upapadyate? so'pi na	nanu apariṇāminī śaktiḥ tat katham śiva śakteḥ jñāna kriyā bhedaḥ upapadyate saḥ api na 
SA_MB_moksakarikaHK-215	vāstava eva | tathā hi 	vāstavaḥ eva tathā hi 
SA_MB_moksakarikaHK-216	sarvajñānakriyārūpā śaktirekaiva śūlinaḥ || 25 ||	sarva jñāna kriyā rūpā śaktiḥ ekā eva śūlinaḥ 
SA_MB_moksakarikaHK-217	yadi tu jñānaśakteranyā kriyāśaktiḥ syāt, jaḍatvādvāmādi-	yadi tu jñānaśakteḥ anyā kriyāśaktiḥ syāt jaḍa tvāt vāma ādi 
SA_MB_moksakarikaHK-218	bhedapariṇāmataścāsyā māyāyā iveśvarasamavāyo na bhavet, apariṇāmitvāt tasyāḥ,	bheda pariṇāmataḥ ca asyāḥ māyāyāḥ iva īśvara samavāyaḥ na bhavet apariṇāmi tvāt tasyāḥ 
SA_MB_moksakarikaHK-219	ityakartā kriyāśaktivikalatvādīśvaraḥ prasajyate | na ca kartrā binā viśvakaraṇamupapadyata	iti akartā kriyā śakti vikala tvāt īśvaraḥ prasajyate na ca kartrā binā viśva karaṇam upapadyata 
SA_MB_moksakarikaHK-220	ityavaśyaṃ sarvajñānakriyāśaktyoraikyamabhypagantavyam | nanu jñeyakāryayor-bhedāt	iti avaśyam sarva jñāna kriyā śaktyoḥ aikyam abhypagantavyam nanu jñeya kāryayoḥ bhedāt 
SA_MB_moksakarikaHK-221	kathaṃ na śaktibhedaḥ ? na, tayorapyabhedāt | nahi jñeyatvaṃ kāryatāmativartate,	katham na śakti bhedaḥ na tayoḥ api abhedāt nahi jñeya tvam kārya tām ativartate 
SA_MB_moksakarikaHK-222	vastusvabhāvatve hi tasya sarveṣāṃ sarvajñatāprasaṅgaḥ | na ca kāryatvaṃ jñeyatāmiti	vastu svabhāva tve hi tasya sarveṣām sarvajña tā prasaṅgaḥ na ca kārya tvam jñeya tām iti 
SA_MB_moksakarikaHK-223	na vāstavo jñānakriyāśaktyorbhedaḥ, api tu kalpita eva || 25 ||	na vāstavaḥ jñāna kriyā śaktyoḥ bhedaḥ api tu kalpitaḥ eva 
SA_MB_moksakarikaHK-224	tathaiva ca kriyā 	tathā eva ca kriyā 
SA_MB_moksakarikaHK-225	tridhaiva śaktirvāmādyā gītā vyāpārabhedataḥ |	tridhā eva śaktiḥ vāma ādyā gītā vyāpāra bhedataḥ 
SA_MB_moksakarikaHK-226	vāmādyāpi kriyāśaktirvyāpārabhedenaiva tridhā bhinnā gītā na vastutaḥ  vāmā	vāmā ādyā api kriyāśaktiḥ vyāpāra bhedena eva tridhā bhinnā gītā na vastutas vāmā 
SA_MB_moksakarikaHK-227	jyeṣṭhā ca raudrī ca śaktitrayamataḥ param iti | anyathā hi jñeyabhedena bhedāt	jyeṣṭhā ca raudrī ca śakti trayam atas param iti anyathā hi jñeya bhedena bhedāt 
SA_MB_moksakarikaHK-228	pratyarthaṃ pratyāyakabhedakalpanayā pratiparamāṇu jñānabhedaprasaṅgena tāsāṃ	pratyartham pratyāyaka bheda kalpanayā prati paramāṇu jñāna bheda prasaṅgena tāsām 
SA_MB_moksakarikaHK-229	nairātmyaprasaṅgaḥ | tadyathaivānekapadārthāvalokanamekayaiva	nairātmya prasaṅgaḥ tat yathā eva aneka padārtha avalokanam ekayā eva 
SA_MB_moksakarikaHK-230	jñānaśaktyā'nubhavasiddhaṃ prakāśayituṃ śakyam, evamudyuktarūpāyāḥ	jñāna śaktyā anubhava siddham prakāśayitum śakyam evam udyukta rūpāyāḥ 
SA_MB_moksakarikaHK-231	kriyāśakteranekakāryakaraṇaṃ siddhamabādhitamiti tadbhedo'pi vyāpārabhedāt kalpitaḥ ||	kriyāśakteḥ aneka kārya karaṇam siddham abādhitam iti tad bhedaḥ api vyāpāra bhedāt kalpitaḥ 
SA_MB_moksakarikaHK-232	vyāpārāṇāṃ tarhi kathaṃ bhedaḥ ? ityucyate 	vyāpārāṇām tarhi katham bhedaḥ iti ucyate 
SA_MB_moksakarikaHK-233	kriyayā malinān puṃso niruṇaddhi maheśvaraḥ || 26 ||	kriyayā malinān puṃsaḥ niruṇaddhi maheśvaraḥ 
SA_MB_moksakarikaHK-234	anādimalaruddhāṃstān karmayuktān nudatyataḥ |	anādi mala ruddhān tān karma yuktān nudati atas 
SA_MB_moksakarikaHK-235	kriyāśaktyā tāvat pūrvameveśvaro'nādimalayuktān paśūn niruṇaddhi niyamayati, ato	kriyāśaktyā tāvat pūrvam eva īśvaraḥ ūna ādi mala yuktān paśūn niruṇaddhi niyamayati 
SA_MB_moksakarikaHK-236	niyamitāṃśca karmavipākānusāreṇa prerayati || 26 ||	niyamitān ca karma vipāka anusāreṇa prerayati 
SA_MB_moksakarikaHK-237	nanu vyāpakatvāt teṣāṃ kutaḥ preraṇā ? satyam, kintu 	nanu vyāpaka tvāt teṣām kutas preraṇā satyam kintu 
SA_MB_moksakarikaHK-238	tatasteṣāṃ ca nunnānāṃ patyā saṃjāyate bhṛśam || 27 ||	tatas teṣām ca nunnānām patyā saṃjāyate bhṛśam 
SA_MB_moksakarikaHK-239	bhogasādhanasambandhayogyatā bhogalolikā |	          
SA_MB_moksakarikaHK-240	vijñānakevalivailakṣaṇyena teṣāṃ karmānusāreṇa teṣāṃ	vijñāna kevali vailakṣaṇyena teṣām karma anusāreṇa teṣām 
SA_MB_moksakarikaHK-241	kāryakāraṇasaṃbandhayogyatotpādanameveśvarapreraṇamucyate || 27 ||	kārya kāraṇa saṃbandha yogyatā utpādanam eva īśvara preraṇam ucyate 
SA_MB_moksakarikaHK-242	tatastu 	tatas tu 
SA_MB_moksakarikaHK-243	śuddhāśuddhādhikārasthe vidyeśe'nanta ātmani || 28 ||	śuddha aśuddha adhikāra sthe vidyeśena ante ātmani 
SA_MB_moksakarikaHK-244	abhivyakto jagadbījaṃ vikṣobhya krurute jagat |	abhivyaktaḥ jagat bījam vikṣobhya krurute jagat 
SA_MB_moksakarikaHK-245	śuddhāśuddhādhikāriṇaṃ mantreśanāyakamanantaṃ preryaṃ kṛtvā māyāto	śuddha aśuddha adhikāriṇam mantreśa nāyakam anantam preryam kṛtvā 
SA_MB_moksakarikaHK-246	jagatkaroti patiḥ | yacchūyate  vidyārājādhirājeśo jagad bhrāmayatīcchayā iti || 28 ||	jagat karoti patiḥ yat śūyate vidyārāja adhirāja īśaḥ jagat bhrāmayati icchayā iti 
SA_MB_moksakarikaHK-247	tadanu ca 	tadanu ca 
SA_MB_moksakarikaHK-248	jagatānena saṃyojya tān puṃso lolikāvataḥ || 29 ||	jagatā anena saṃyojya tān puṃsaḥ lolikāvataḥ 
SA_MB_moksakarikaHK-249	bhogārthaṃ sādhanākārāṃ karoti sthitimīśvaraḥ |	bhoga artham sādhana ākārām karoti sthitim īśvaraḥ 
SA_MB_moksakarikaHK-250	karmānurūpaṃ kāryakaraṇaistān paśūn saṃyojya teṣāṃ bhogārthaṃ	karma anurūpam kārya karaṇaiḥ tān paśūn saṃyojya teṣām bhoga artham 
SA_MB_moksakarikaHK-251	sādhanākārāṃ sthitiṃ karotīśvaraḥ || 29 ||	sādhana ākārām sthitim karoti īśvaraḥ 
SA_MB_moksakarikaHK-252	tataśca 	tatas ca 
SA_MB_moksakarikaHK-253	sthityante so'pi saṃsāre viśramārthaṃ pradhāvatām || 30 ||	sthiti ante saḥ api saṃsāre viśrama artham pradhāvatām 
SA_MB_moksakarikaHK-254	paśūnāṃ prakṛtīnāṃ ca kṣamatvotpādanāya ca |	paśūnām prakṛtīnām ca kṣama tva utpādanāya ca 
SA_MB_moksakarikaHK-255	tataḥ sarvopasaṃhāraṃ vidhatte bhagavāniti || 31 ||	tatas sarva upasaṃhāram vidhatte bhagavān iti 
SA_MB_moksakarikaHK-256	sthitisaṃrakṣaṇādānabhāvalakṣaṇā vyāpārā bhinnāḥ kathitāḥ || 30-31 ||	sthiti saṃrakṣaṇa ādāna bhāva lakṣaṇāḥ vyāpārāḥ bhinnāḥ kathitāḥ 
SA_MB_moksakarikaHK-257	anugrahamapi vidhatte 	anugraham api vidhatte 
SA_MB_moksakarikaHK-258	malasvaśaktirodhānte dīkṣāśaktyaiva muñcati |	mala sva śakti rodha ante dīkṣā śaktyā eva muñcati 
SA_MB_moksakarikaHK-259	vakṣyamāṇavad yadaiva malasyeśvaraśakteśca rodhādhikāro nivartate, tadā	vakṣyamāṇa vat yadā eva malasya īśvara śakteḥ ca rodha adhikāraḥ nivartate tadā 
SA_MB_moksakarikaHK-260	dīkṣayaiva paśūn mocayati ||	dīkṣayā eva paśūn mocayati 
SA_MB_moksakarikaHK-261	vāmā jyeṣṭhā ca raudrī ca svato'bhinnāpi sā tridhā || 32 ||	vāmā jyeṣṭhā ca raudrī ca svatas bhinnā api sā tridhā 
SA_MB_moksakarikaHK-262	rodhaviśleṣaharaṇairvibhinnā karmabhiḥ kriyā |	rodha viśleṣa haraṇaiḥ vibhinnā karmabhiḥ kriyā 
SA_MB_moksakarikaHK-263	atha sthitisaṃrakṣaṇabhāvalakṣaṇānāṃ vyāpārāṇāṃ saṃsārarodhaphalatvād	atha sthiti saṃrakṣaṇa bhāva lakṣaṇānām vyāpārāṇām saṃsāra rodha phala tvāt 
SA_MB_moksakarikaHK-264	rodho vāmāvyāpāraḥ, ādānarūpaḥ saṃhāro jyeṣṭhāyā, pāśaharaṇātmako'nugraho	rodhaḥ vāmā vyāpāraḥ ādāna rūpaḥ saṃhāraḥ jyeṣṭhāyāḥ pāśa haraṇa ātmakaḥ anugrahaḥ 
SA_MB_moksakarikaHK-265	raudryāḥ  ityetaiḥ karmabhirabhinnāpi svataḥ kriyāśaktirvibhinnā kathyate, na paramārthata iti	raudryāḥ iti etaiḥ karmabhiḥ abhinnā api svatas kriyāśaktiḥ vibhinnā kathyate na paramārthataḥ iti 
SA_MB_moksakarikaHK-266	sarvajñānakriyārūpā śaktirekaiva śūlinaḥ (mo0 25 ) iti na doṣaḥ kaścit || 32 ||	sarva jñāna kriyā rūpā śaktiḥ ekā eva śūlinaḥ mo iti na doṣaḥ kaścid  /
SA_MB_moksakarikaHK-267	ityevaṃ devadevasya sarvakartṛtvamīritam || 33 ||	iti evam devadevasya sarva kartṛ tvam īritam 
SA_MB_moksakarikaHK-268	etena sarvakṛttvena sarvajño'vāpyate patiḥ |	etena sarva kṛt tvena sarvajñaḥ uvāpyate patiḥ 
SA_MB_moksakarikaHK-269	jñānaṃ vinā kuvindādīnāṃ kartṛtvādṛṣṭerbhagavataḥ sarvakṛttvataḥ	jñānam vinā kuvinda ādīnām kartṛ tva adṛṣṭeḥ bhagavataḥ sarva kṛt tvataḥ 
SA_MB_moksakarikaHK-270	sarvajñatvasiddhirityuktaṃ prāk || 33 ||	sarvajña tva siddhiḥ iti uktam prāk 
SA_MB_moksakarikaHK-271	tathā hi 	tathā hi 
SA_MB_moksakarikaHK-272	upādānanimittaistu phalena ca samanvitam || 34 ||	upādāna nimittaiḥ tu phalena ca samanvitam 
SA_MB_moksakarikaHK-273	yathā paṭaṃ vijānāti paṭakārastathā bhavaḥ |	yathā paṭam vijānāti paṭa kāraḥ tathā bhavaḥ 
SA_MB_moksakarikaHK-274	upādānanimittaistu phalena ca samanvitaḥ || 35 ||	upādāna nimittaiḥ tu phalena ca samanvitaḥ 
SA_MB_moksakarikaHK-275	sarvakartā'pi tatsarvaṃ vijānāti yathā sthitam |	sarvakartā api tat sarvam vijānāti yathā sthitam 
SA_MB_moksakarikaHK-276	yathaiva paṭakārastantubhyo devadattāya mūlyasaṃsiddhaye turīvemādibhiḥ paṭaṃ	yathā eva paṭakāraḥ tantubhyaḥ devadattāya mūlya saṃsiddhaye turī vema ādibhiḥ paṭam 
SA_MB_moksakarikaHK-277	kurvāṇastrikālāmalajñānayuktaḥ svakārye siddhaḥ, tathaiva viśvakartā māyāto	kurvāṇaḥ tri kāla amala jñāna yuktaḥ sva kārye siddhaḥ tathā eva viśvakartā māyātaḥ 
SA_MB_moksakarikaHK-278	vicitrakarmanimittaṃ paśūnāṃ bhogamokṣārthaṃ viśvamutpādayan svakārye	vicitra karma nimittam paśūnām bhoga mokṣa artham viśvam utpādayan sva kārye 
SA_MB_moksakarikaHK-279	trikālāmalajñānayukta evā'numīyata iti sarvajñatvasiddhaḥ || 34 35 ||	tri kāla amala jñāna yuktaḥ eva anumīyate iti sarvajña tva siddhaḥ    
SA_MB_moksakarikaHK-280	itthaṃ sarvārthakāritvād dvirūpā śaktirātmani || 36 ||	ittham sarva artha kāri tvāt dvi rūpā śaktiḥ ātmani 
SA_MB_moksakarikaHK-281	kalāpiṇḍa ivābhāti śaktiḥ sā nityasaṃsthitā |	kalā piṇḍaḥ iva ābhāti śaktiḥ sā nitya saṃsthitā 
SA_MB_moksakarikaHK-282	yayā yukto maheśānaḥ sarvaṃ vetti karoti ca || 37 ||	yayā yuktaḥ maheśānaḥ sarvam vetti karoti ca 
SA_MB_moksakarikaHK-283	kalāvāniti tattvajñaiḥ sakalastena gīyate |	kalāvān iti tattva jñaiḥ sakalaḥ tena gīyate 
SA_MB_moksakarikaHK-284	uktavat sarvajñānakriyārūpā saiva śaktirnityā'nekarūpeva lakṣyamāṇā bhagavataḥ	ukta vat sarva jñāna kriyā rūpā sā eva śaktiḥ nitya aneka rūpā iva lakṣyamāṇā bhagavataḥ 
SA_MB_moksakarikaHK-285	śarīramupacaryata iti sakalaḥ kathyate śivaḥ || 36 37 ||	śarīram upacaryate iti sakalaḥ kathyate śivaḥ   
SA_MB_moksakarikaHK-286	sa eva tu 	saḥ eva tu 
SA_MB_moksakarikaHK-287	na kalāpiṇḍasaṃbaddhaḥ  saṃbaddho'sau yathā paśuḥ || 38 ||	na kalā piṇḍa saṃbaddhaḥ saṃbaddhaḥ asau yathā paśuḥ 
SA_MB_moksakarikaHK-288	kadācidapi deveśastasmād gītastu niṣkalaḥ |	kadācid api deveśaḥ tasmāt gītaḥ tu niṣkalaḥ 
SA_MB_moksakarikaHK-289	paśuvat kalādyātmakaśarīrābhāvānniṣkalo bhagavānityuktaṃ prāk || 38 ||	paśu vat kalā ādi ātmaka śarīra abhāvāt niṣkalaḥ bhagavān iti uktam prāk 
SA_MB_moksakarikaHK-290	atra paraḥ 	atra paraḥ 
SA_MB_moksakarikaHK-291	nanvasya niṣkalatve tu na jñānaṃ nāpi kartṛtā || 39 ||	nanu asya niṣkala tve tu na jñānam nā api kartṛ tā 
SA_MB_moksakarikaHK-292	kalākalāpayuktānāṃ dṛśyate cidvatāṃ yataḥ |	kalā kalāpa yuktānām dṛśyate cidvatām yatas 
SA_MB_moksakarikaHK-293	kalādiyoga eva paśūnāṃ jñānādikaṃ dṛṣṭamiti kalādyabhāvādīśvarasya	kalā ādi yoge eva paśūnām jñāna ādikam dṛṣṭam iti kalā ādi abhāvāt īśvarasya 
SA_MB_moksakarikaHK-294	jñānādyabhāvaḥ || 39 ||	jñāna ādi abhāvaḥ 
SA_MB_moksakarikaHK-295	naiṣa doṣaḥ 	na eṣa doṣaḥ 
SA_MB_moksakarikaHK-296	cidvyaktyarthaṃ kalāyogamapekṣete susaṃsthite || 40 ||	cit vyakti artham kalā yogam apekṣete su saṃsthite 
SA_MB_moksakarikaHK-297	dṛkkriye malasaṃruddhe neśvare rodhavarjanāt |	dṛkkriye mala saṃruddhe na īśvare rodha varjanāt 
SA_MB_moksakarikaHK-298	uktaṃ hi bhogaprakaraṇe  paśūnāṃ jñānakriye malaruddhatvāt	uktam hi bhogaprakaraṇe paśūnām jñāna kriye mala ruddha tvāt 
SA_MB_moksakarikaHK-299	kalādivyañjakāpekṣe viṣayeṣu pravartete iti | parameśvarasya tvanādyanāvṛtatvānna te	kalā ādi vyañjaka apekṣe viṣayeṣu pravartete iti parameśvarasya tu anādi anāvṛta tvāt na te 
SA_MB_moksakarikaHK-300	vyañjakāpekṣe iti sarvadā sarvārthe || 40 ||	vyañjaka apekṣe iti sarvadā sarva arthe 
SA_MB_moksakarikaHK-301	atheśasyāpi sāpekṣe	atha īśasya api sa apekṣe 
SA_MB_moksakarikaHK-302	athājñatvāt paśuvadīśvarasyāpi dṛkkriye kalādivyañjakāpekṣe ||	atha ajña tvāt paśu vat īśvarasya api dṛkkriye kalā ādi vyañjaka apekṣe 
SA_MB_moksakarikaHK-303	yadyevam 	yadi evam 
SA_MB_moksakarikaHK-304	tadā'sau jāyate paśuḥ || 41 ||	tadā asau jāyate paśuḥ 
SA_MB_moksakarikaHK-305	kalādiyogād devadattādivadīśvaraḥ paśuḥ prasajyate || 41 ||	kalā ādi yogāt devadatta ādi vat īśvaraḥ paśuḥ prasajyate  /
SA_MB_moksakarikaHK-306	bhavatu vā ? kā naḥ kṣatiḥ 	bhavatu vā kā naḥ kṣatiḥ 
SA_MB_moksakarikaHK-307	na ceśvaraṃ vinā kāryamato'nyo vācya īśvaraḥ |	na ca īśvaram vinā kāryam atas anyaḥ vācyaḥ īśvaraḥ 
SA_MB_moksakarikaHK-308	īśvaraṃ vinā na viśvalakṣaṇaṃ kāryamutpadyata iti tato'nya īśvaro vācya	īśvaram vinā na viśva lakṣaṇam kāryam utpadyate iti tatonyaḥ īśvaraḥ vācya 
SA_MB_moksakarikaHK-309	ityanavasthā ||	iti anavasthā 
SA_MB_moksakarikaHK-310	kalāḥ sṛṣṭvāpi tadyuktaḥ kāryakṛd yadyasau tataḥ || 42 ||	kalāḥ sṛṣṭvā api tad yuktaḥ kārya kṛt yadi asau tatas 
SA_MB_moksakarikaHK-311	ata eva kalādisvakāryakaraṇāni sṛṣṭvā tatastairyukto bhagavān sarvaṃ kārya	atas eva kalā ādi sva kārya karaṇāni sṛṣṭvā tatas taiḥ yuktaḥ bhagavān sarvam kārya 
SA_MB_moksakarikaHK-312	karotītyucyate || 42 ||	karoti iti ucyate 
SA_MB_moksakarikaHK-313	yadyevam 	yadi evam 
SA_MB_moksakarikaHK-314	dṛkkriye niṣkalasyeṣṭe kalābhiḥ kiṃ prayojanam |	dṛkkriye niṣkalasya iṣṭe kalābhiḥ kim prayojanam 
SA_MB_moksakarikaHK-315	yathaiva kalādibhiranapekṣo niṣkala eva svātmanaḥ kāryakaraṇāni, tathaiva viśvamapi	yathā eva kalā ādibhiḥ anapekṣaḥ niṣkalaḥ eva svātmanaḥ kārya karaṇāni tathā eva viśvam api 
SA_MB_moksakarikaHK-316	karotīti kiṃ tasya kalādiśarīra-kalpanayetyevamādivistareṇa nareśvaraparīkṣāyāṃ varṇitamiti ||	karoti iti kim tasya kalā ādi śarīra kalpanayā iti evamādi vistareṇa nareśvara parīkṣāyām varṇitam iti 
SA_MB_moksakarikaHK-317	tasmādalaṃ prasaṅgena bhogamokṣaprasādhakaḥ || 43 ||	tasmāt alam prasaṅgena bhoga mokṣa prasādhakaḥ 
SA_MB_moksakarikaHK-318	uktalakṣmā maheśāna upāsyo'yaṃ mumukṣubhiḥ |	ukta lakṣmā maheśānaḥ upāsyaḥ iyam mumukṣubhiḥ 
SA_MB_moksakarikaHK-319	tatsarvajñatvādilakṣaṇaḥ parameśvara eva paśubhyo mokṣaprada iti śreyo'rthibhiḥ	tad sarvajña tva ādi lakṣaṇaḥ parameśvaraḥ eva paśubhyaḥ mokṣa pradaḥ iti śreyaḥ orthibhiḥ 
SA_MB_moksakarikaHK-320	sadaivārādhyo nānyaḥ, ityuktaḥ sasādhano bhogaḥ || 43 ||	sadā eva ārādhyaḥ na anyaḥ iti uktaḥ sa sādhanaḥ bhogaḥ 
SA_MB_moksakarikaHK-321	atha mokṣaḥ sasādhana ucyate-	atha mokṣaḥ sa sādhanaḥ ucyate 
SA_MB_moksakarikaHK-322	malādipāśavicchittiḥ sarvajñānakriyodbhavaḥ || 44 ||	            
SA_MB_moksakarikaHK-323	mokṣastatkāraṇaṃ śambhuḥ svaśaktiḥ karaṇaṃ prabhoḥ |	mokṣaḥ tad kāraṇam śambhuḥ sva śaktiḥ karaṇam prabhoḥ 
SA_MB_moksakarikaHK-324	paścātmā mocyamānatvāt karmakārakamiṣyate || 45 ||	paśca ātmā mocyamāna tvāt karma kārakam iṣyate  /
SA_MB_moksakarikaHK-325	nityamuktatayā kartuṃ mokṣākhyā karmagākṛtiḥ |	nitya mukta tayā kartum mokṣa ākhyā karma ga ākṛtiḥ 
SA_MB_moksakarikaHK-326	prāg bhogaprakaraṇe vijñānakevalināṃ mala eva, pralayakevali-nāṃ malakarmaṇī,	prāk bhoga prakaraṇe vijñāna kevalinām male eva pralaya kevalinām mala karmaṇī 
SA_MB_moksakarikaHK-327	sakalānāṃ tu malakarmamāyālakṣaṇāḥ paśūnāṃ pāśāḥ pratipāditāḥ | teṣu	sakalānām tu mala karma māyā lakṣaṇāḥ paśūnām pāśāḥ pratipāditāḥ teṣu 
SA_MB_moksakarikaHK-328	pāśānāṃ yathā saṃbhavaṃ sarveṣaṃ vicchittiḥ	pāśānām yathā saṃbhavam vicchittiḥ 
SA_MB_moksakarikaHK-329	sarvajñatvasarvakartṛtvābhivyaktiścātmanāṃ mokṣo nā'nyeṣāmivānyatamapāśavicchittiḥ,	sarvajña tva sarva kartṛ tva abhivyaktiḥ ca ātmanām mokṣaḥ na anyeṣām iva anyatama pāśa vicchittiḥ 
SA_MB_moksakarikaHK-330	ajñatvam, akṛtṛtvam, saṃkrāntirveti vakṣyāmaḥ | na ca tasya mokṣasya ātmā jñātavyaḥ	ajña tvam akṛtṛ tvam saṃkrāntiḥ vā iti vakṣyāmaḥ na ca tasya mokṣasya ātmā jñātavyaḥ 
SA_MB_moksakarikaHK-331	ityādāvivāyaṃ paśuḥ kartā, paśorīśvarasaṃskāryatvena sarvadā karmatvāt |	ityādau iva ayam paśuḥ kartā paśoḥ īśvara saṃskārya tvena sarvadā karma tvāt 
SA_MB_moksakarikaHK-332	nāpiprakṛtyādikaḥ pāśaḥ, kintu īśvara eva | tasya ca karaṇaṃ svaśaktirdīkṣākhyaiva |	na api prakṛti ādikaḥ pāśaḥ kintu īśvaraḥ eva tasya ca karaṇam sva śaktiḥ dīkṣā ākhyā eva 
SA_MB_moksakarikaHK-333	muktistāvatpāśavicchittiḥ sarvajñatvādyabhivyaktiśceti mocyagata eva viśeṣo mokṣaḥ, na	muktiḥ tāvat pāśa vicchittiḥ sarvajña tva ādi abhivyaktiḥ ca iti mocya gataḥ eva viśeṣaḥ mokṣaḥ na 
SA_MB_moksakarikaHK-334	sāṃkhyānāmiva mocakagataḥ, tasya nityamuktatayā muktyamuktyora-viśeṣaprasaṅgāt |	sāṃkhyānām iva mocaka gataḥ tasya nitya mukta tayā mukti amuktyoḥ aviśeṣa prasaṅgāt 
SA_MB_moksakarikaHK-335	yadāguḥ  saṃsarati bhogyabhāvāt tadvinivṛttyā tu mokṣadā prakṛtiḥ | svātmana eva na	yat āguḥ saṃsarati bhogya bhāvāt tad vinivṛttyā tu mokṣa dā prakṛtiḥ sva ātmanaḥ eva na 
SA_MB_moksakarikaHK-336	puṃso lopo'sau na svayaṃ veda || yata ityevaṃ viśiṣṭo'viśiṣṭo vā sarvaścātra mokṣaḥ	puṃsaḥ lopaḥ asau na svayam veda yatas iti evam viśiṣṭaḥ viśiṣṭaḥ vā sarvaḥ ca atra mokṣaḥ 
SA_MB_moksakarikaHK-337	pratijñātaḥ, tasya sādhanamuttaraṃ prakaraṇam || 44  45 ||	pratijñātaḥ tasya sādhanam uttaram prakaraṇam     
SA_MB_moksakarikaHK-338	tatra tāvat puruṣakartṛka eva mokṣa iti jñānamokṣavādinaḥ svayūthyāḥ 	tatra tāvat puruṣa kartṛkaḥ eva mokṣaḥ iti jñāna mokṣa vādinaḥ sva yūthyāḥ 
SA_MB_moksakarikaHK-339	astvātmanīno mokṣo hi bhogavat pudgalastataḥ || 46 ||	astu ātmanīnaḥ mokṣaḥ hi bhoga vat pudgalaḥ tatas 
SA_MB_moksakarikaHK-340	mokṣakartā vivekādiḥ sādhanaḥ sa prasiddhyati |	              
SA_MB_moksakarikaHK-341	astvīśo viśvakartā, puruṣāstu svakṛtairdharmādharmaiḥ śubhā-śubhaṃ bhogaṃ	astu īśaḥ viśvakartā puruṣa astu sva kṛtaiḥ dharma adharmaiḥ śubha aśubham bhogam 
SA_MB_moksakarikaHK-342	bhuñjate neśvarakṛtaiḥ | nanu tatrāpi parameśvarasyā-dhiṣṭhātṛtvamastyeva | bhavatu, na	bhuñjate na īśvara kṛtaiḥ nanu tatra api parameśvarasya adhiṣṭhātṛ tvam asti eva bhavatu na 
SA_MB_moksakarikaHK-343	punaḥ kartṛtetyevaṃ ta evājñāna-malasaṃbaddhā bhrāntitaḥ saṃsārabhājaḥ	punar kartṛ tā iti evam te eva ajñāna mala saṃbaddhāḥ bhrāntitaḥ saṃsāra bhājaḥ 
SA_MB_moksakarikaHK-344	santastatpratipakṣābhyāsa-viviktajñānodayādajñānanivṛttau teṣāṃ	santaḥ tad pratipakṣa abhyāsa vivikta jñāna udayāt ajñāna nivṛttau teṣām 
SA_MB_moksakarikaHK-345	sarvajñatādirūpāvāptitaḥ svātmakartṛka eva mokṣo neśvarakartṛkaḥ || 46 ||	sarvajña tā ādi rūpa avāptitaḥ sva ātma kartṛkaḥ eva mokṣaḥ na īśvara kartṛkaḥ  /
SA_MB_moksakarikaHK-346	tadayuktam 	tat ayuktam 
SA_MB_moksakarikaHK-347	avive(ko? kā)'vasāyotthamajñānaṃ vinivartate || 47 ||	vinivartate 
SA_MB_moksakarikaHK-348	vivekajñānato nānyat kācādidravyahetukam |	viveka jñānataḥ na anyat kāca ādi dravya hetukam 
SA_MB_moksakarikaHK-349	svakāraṇanivṛttyaiva tannivarteta nānyathā || 48 ||	sva kāraṇa nivṛttyā eva tat nivarteta na anyathā 
SA_MB_moksakarikaHK-350	malaścājñānahetuḥ syādajñānatve'sya tucchatā |	malaḥ ca ajñāna hetuḥ syāt ajñāna tve sya tuccha tā 
SA_MB_moksakarikaHK-351	athātmadharmo bhāvaḥ syāt tucchatve tannivartate || 49 ||	atha ātma dharmaḥ bhāvaḥ syāt tuccha tve tat nivartate 
SA_MB_moksakarikaHK-352	jñānādiraphalaḥ puṃso dharmatvena nivartyate |	jñāna ādiḥ aphalaḥ puṃsaḥ dharma tvena nivartyate 
SA_MB_moksakarikaHK-353	nivartyatve nātmadharmaḥ(syāt?) tadanādinirodhakam || 50 ||	nivartya tve na ātma dharmaḥ syāt tat anādi nirodhakam 
SA_MB_moksakarikaHK-354	caitanyasyātmanastena nivṛttirdīkṣayā tataḥ |	caitanyasya ātmanaḥ tena nivṛttiḥ dīkṣayā tatas 
SA_MB_moksakarikaHK-355	maheśamalamāyādivaśago'ṇuḥ sa cātmanā || 50 ||	maheśa mala māyā ādi vaśa goṇuḥ sa ca ātmanā 
SA_MB_moksakarikaHK-356	kathaṃ tebhyastadāyattamātmānaṃ mocayiṣyati |	katham tebhyaḥ tad āyattam ātmānam mocayiṣyati 
SA_MB_moksakarikaHK-357	asyātmamocane śaktirvidyate na yataḥ svayam || 52 ||	asya ātma mocane śaktiḥ vidyate na yatas svayam 
SA_MB_moksakarikaHK-358	pāśānāṃ vaśyatāmeti teneśo mokṣakṛd vaśī |	pāśānām vaśya tām eti tena īśaḥ mokṣa kṛt vaśī 
SA_MB_moksakarikaHK-359	yuktaṃ dharmādharmakartṛtvaṃ puṃsām, kalādibhirīṣanmala-vyudāsena	yuktam dharma adharma kartṛ tvam puṃsām kalā ādibhiḥ īṣat mala vyudāsena 
SA_MB_moksakarikaHK-360	tatsaṃbandhād uttejitadṛkkriyatvāt | malādinivṛttau tu satyāṃ tāvad jñatvamapi tadā	tad saṃbandhāt uttejita dṛkkriya tvāt mala ādi nivṛttau tu satyām tāvat jñatvam api tadā 
SA_MB_moksakarikaHK-361	yeṣāṃ na samarthaṃ dṛṣṭam, īśvaratvaṃ teṣāṃ muktau bhaviṣyatītyucyamānamatisāhasam	yeṣām na samartham dṛṣṭam īśvara tvam teṣām muktau bhaviṣyati iti ucyamānam ati sāhasam 
SA_MB_moksakarikaHK-362	| nanu pramāṇasiddhaiva śuktikārajatādibhrameṣu jñānādajñānanivṛttiḥ | malaṃ	                    
SA_MB_moksakarikaHK-363	cājñānamicchanti cātmanāmanādibhavam, tadayuktam, ajñānatvāyogāt tasya | na	ca ajñānam icchanti ca ātmanām anādi bhavam tat ayuktam ajñāna tva ayogāt tasya na 
SA_MB_moksakarikaHK-364	hyajñānaṃ malaḥ, api tvajñānahetuḥ | ajñānatve tu tasya ātmadharmatvaṃ tucchatā vā	hi ajñānam malaḥ api tu ajñāna hetuḥ ajñāna tve tu tasya ātma dharma tvam tuccha tā vā 
SA_MB_moksakarikaHK-365	syāt, tucchatve tu tasyā'kiñcitkaratvāt tannivartako jñānādiraphalaḥ, ātmadharmatve tu tasya	syāt tuccha tve tu tasya akiñcitkara tvāt tad nivartakaḥ jñāna ādiḥ aphalaḥ ātma dharma tve tu tasya 
SA_MB_moksakarikaHK-366	nityatvavyāpakatvāderiva nivartayitumaśakyatvenānirmokṣaḥ | nivartyatve nātmadharmateti	nitya tva vyāpaka tva ādeḥ iva nivartayitum aśakya tvena anirmokṣaḥ nivartya tve na ātma dharma tā iti 
SA_MB_moksakarikaHK-367	vastvantarameva | ātmano'nādyuparodha-hetutvādajñānahetuścakṣuṣa iva paṭalādirmalo	vastu antaram eva ātmanaḥ nādi uparodha hetu tvāt ajñāna hetuḥ cakṣuṣaḥ iva paṭala ādiḥ malaḥ 
SA_MB_moksakarikaHK-368	vācyaḥ | na ca dravyasyājñānahetoḥ paṭalāderanyasya vā jñānānnivṛttirdṛṣṭā,	vācyaḥ na ca dravyasya ajñāna hetoḥ paṭala ādeḥ anyasya vā jñānāt nivṛttiḥ dṛṣṭā 
SA_MB_moksakarikaHK-369	pratipakṣatvābhāvāt | kathaṃ tarhi śuktikārajatādau jñānānnivṛttiḥ ? ucyate | dvividhaṃ	pratipakṣa tva abhāvāt katham tarhi śuktikā rajata ādau jñānāt nivṛttiḥ ucyate dvividham 
SA_MB_moksakarikaHK-370	hyajñānam prāganubhūtasādṛśyasya buddhyavivekādhyavasāyātmakaṃ śuktikādau	hi ajñānam prāk anubhūta sādṛśyasya buddhi aviveka adhyavasāya ātmakam śuktikā ādau 
SA_MB_moksakarikaHK-371	rajatādijñānam, kācakāmalādidravyajanyadvicandrādiviṣayaṃ vikalpajñānaṃ ca | tatra	rajata ādi jñānam kāca kāmalā ādi dravya janya dvi candra ādi viṣayam vikalpa jñānam ca tatra 
SA_MB_moksakarikaHK-372	pūrvaṃ nedaṃ rajatamiti vivekādhyavasāyajñānānnivartate | yatpunardravyajanyam, tasya	pūrvam na idam rajatam iti viveka adhyavasāya jñānāt nivartate yat punar dravya janyam tasya 
SA_MB_moksakarikaHK-373	svakāraṇadravyanivṛttyaiva nivṛttiḥ,  na jñānāt | pratipāditaṃ tu	sva kāraṇa dravya nivṛttyā eva nivṛttiḥ na jñānāt pratipāditam tu 
SA_MB_moksakarikaHK-374	dravyahetukamevā'jñānamātmanām, netarat, abauddhatvāt tasyeti na jñānāt	dravya hetukam eva ajñānam ātmanām na itarat abauddha tvāt tasya iti na jñānāt 
SA_MB_moksakarikaHK-375	tannivṛttisaṃbhavaḥ | paṭalādeścakṣurvaidyādivadīśvarādeva tannivṛttiritīśvarakartṛka eva	tad nivṛtti saṃbhavaḥ paṭala ādeḥ cakṣuḥ vaidya ādi vat īśvarāt eva tad nivṛttiḥ iti īśvara kartṛkaḥ eva 
SA_MB_moksakarikaHK-376	mokṣo nātmakartṛkaḥ | tathā coktaṃ śākhāntare śivādevātmanāṃ mokṣaḥ iti | śrutirapi	mokṣaḥ na ātma kartṛkaḥ tathā ca uktam śākhā antare śivāt eva ātmanām mokṣaḥ iti śrutiḥ api 
SA_MB_moksakarikaHK-377	 yamevaiṣa vṛṇute tena labhyaḥ (kaṇṭho0 2 | 23; muṇḍako 0 3 | 2 | 3) iti | ata eva	yam eva eṣa vṛṇute tena labhyaḥ kaṇṭhaḥ            iti atas eva 
SA_MB_moksakarikaHK-378	kriyānivartyatvād dravyasyeśvarakriyayaiva mokṣa ityuktam  dīkṣaiva mocayatyūrdhvaṃ śaivaṃ	kriyā nivartya tvāt dravyasya īśvara kriyayā eva mokṣaḥ iti uktam dīkṣā eva mocayati ūrdhvam śaivam 
SA_MB_moksakarikaHK-379	dhāma nayatyapi iti, vakṣyāmaśca || 47  52 ||	dhāma nayati api iti vakṣyāmaḥ ca 
SA_MB_moksakarikaHK-380	nanvīśvarasya mokṣakartṛtvamapi kalpayitvā pāśānāṃ nivartanasvabhāvastadā	nanu īśvarasya mokṣa kartṛ tvam api kalpayitvā pāśānām nivartana svabhāvaḥ tadā 
SA_MB_moksakarikaHK-381	kalpanīyaḥ, tena vinā tasyāpyasiddheḥ | tatasta eva tatsvabhāvānnivartamānāḥ puṃso	kalpanīyaḥ tena vinā tasya api asiddheḥ tatas te eva tad svabhāvāt nivartamānāḥ puṃsaḥ 
SA_MB_moksakarikaHK-382	mokṣahetavo bhaviṣyanti, kimīśvarasya kartṛtvakalpanayā ? tadayuktam, yataḥ 	mokṣa hetavaḥ bhaviṣyanti kim īśvarasya kartṛ tva kalpanayā tat ayuktam yatas 
SA_MB_moksakarikaHK-383	na puṃsāṃ mocane śaktiḥ pāśānāmapi vidyate || 53 ||	na puṃsām mocane śaktiḥ pāśānām api vidyate  /
SA_MB_moksakarikaHK-384	rajjvādinā svayaṃ baddhvā vimuñcad dṛśyate yataḥ |	rajju ādinā svayam baddhvā vimuñcat dṛśyate yatas 
SA_MB_moksakarikaHK-385	jīvasya svataḥ pravṛttau nivṛttau vā sāmarthyaṃ nāstītyuktam | ataḥ pāśānāmapi	jīvasya svatas pravṛttau nivṛttau vā sāmarthyam na asti iti uktam atas pāśānām api 
SA_MB_moksakarikaHK-386	śiva eva tadā'pi nivartakatvāt puṃbhyo mokṣada iti dṛṣṭe sati nādṛṣṭakalpaneti || 53 ||	śivaḥ eva tadā api nivartaka tvāt puṃbhyaḥ mokṣa daḥ iti dṛṣṭe sati na adṛṣṭa kalpanā iti 
SA_MB_moksakarikaHK-387	atra paraḥ 	atra paraḥ 
SA_MB_moksakarikaHK-388	jñatvakartṛtvayorvyaktiṃ pāśāḥ kurvantyanekadhā || 54 ||	jña tva kartṛ tvayoḥ vyaktim pāśāḥ kurvanti anekadhā 
SA_MB_moksakarikaHK-389	mokṣo vyaktistayoreva mokṣo'taḥ pāśakāritaḥ |	mokṣaḥ vyaktiḥ tayoḥ eva mokṣotaḥ pāśa kāritaḥ 
SA_MB_moksakarikaHK-390	dṛṣṭā hi pāśāḥ kāryakaraṇalakṣaṇā eva bhavāvasthāyāmāt--	dṛṣṭāḥ hi pāśāḥ kārya karaṇa lakṣaṇāḥ eva bhava avasthā āyāmāt 
SA_MB_moksakarikaHK-391	manāmanekaprakārāṃ jñatvakarṭṛtvayorvyaktiṃ kurvanti | mokṣaśca jñānakriyayorvyaktiḥ	manām aneka prakārām jña tva karṭṛ tvayoḥ vyaktim kurvanti mokṣaḥ ca jñāna kriyayoḥ vyaktiḥ 
SA_MB_moksakarikaHK-392	tatastāmapi ta eva dṛṣṭasāmarthyāḥ kariṣyantīti kiṃ tatreśvarasyādṛṣṭasya kalpanayā || 54	tatas tām api te eva dṛṣṭa sāmarthyāḥ kariṣyanti iti kim tatra īśvarasya adṛṣṭasya kalpanayā 
SA_MB_moksakarikaHK-393	tadayuktam 	tat ayuktam 
SA_MB_moksakarikaHK-394	svākārarañjitāṃ pāśāḥ pāśavṛttyanurāgiṇīm || 55 ||	su ākāra rañjitām pāśāḥ pāśa vṛtti anurāgiṇīm 
SA_MB_moksakarikaHK-395	kramānvitāṃ vināśārthāṃ vyāhatāamalpagocarām |	krama anvitām vināśa arthām 
SA_MB_moksakarikaHK-396	tayorvyaktiṃ prakurvanti niḥsaṃjñatvād bhaveritāḥ || 56 ||	tayoḥ vyaktim prakurvanti niḥsaṃjña tvāt bhava īritāḥ 
SA_MB_moksakarikaHK-397	śaknuvanti na mokṣākhyāṃ yenāsyāḥ sā vilakṣaṇā |	śaknuvanti na mokṣa ākhyām yena asyāḥ sā vilakṣaṇā 
SA_MB_moksakarikaHK-398	yo hi yathābhūtavyañjakaśaktiyuktaḥ pradīpādirvyañjakaḥ siddhaḥ	yaḥ hi yathā bhūta vyañjaka śakti yuktaḥ pradīpa ādiḥ vyañjakaḥ siddhaḥ 
SA_MB_moksakarikaHK-399	so'pyanyatrāpyadṛṣṭe viṣaye tathābhūtaśaktireva pratīyate | kāryakaraṇādilakṣaṇaśca	saḥ upi anyatra api adṛṣṭe viṣaye tathābhūta śaktiḥ eva pratīyate kārya karaṇa ādi lakṣaṇaḥ ca 
SA_MB_moksakarikaHK-400	vyañjakaḥ proktavadīśvaraprerito'pi śarīrādāvātmagrahahetutvāt svākāreṇānurañjitāṃ	vyañjakaḥ prokta vat īśvara preritaḥ api śarīra ādau ātma graha hetu tvāt sva ākāreṇa anurañjitām 
SA_MB_moksakarikaHK-401	stryādiviṣayānurāgiṇīṃ kvacit kadācit kiñcidviṣayāṃ rāgadveṣādibhiñca vyāhatāṃ	strī ādi viṣaya anurāgiṇīm kvacid kadācid kiñcid viṣayām rāga dveṣa ādibhiḥ ca vyāhatām 
SA_MB_moksakarikaHK-402	kāryatvāccharīrādīnāṃ nāśe sati vinaśvarīṃ bhavināṃ jñānakriyayorvyaktiṃ kurvan	kārya tvāt śarīra ādīnām nāśe sati vinaśvarīm bhavinām jñāna kriyayoḥ vyaktim kurvan 
SA_MB_moksakarikaHK-403	dṛṣṭa iti tathābhūta eva viṣaye tasya vyañjakatvaṃ siddhyati | na tato'tyantavilakṣaṇatvād	dṛṣṭaḥ iti tathābhūte eva viṣaye tasya vyañjaka tvam siddhi ati na 
SA_MB_moksakarikaHK-404	jñānakriyayormuktāvapi dīpasyeva brahmāṇḍa iti na pāśavyaṅgyo mokṣa iti tadvaiśiṣṭyaṃ	jñāna kriyayoḥ muktau api dīpasya iva brahmāṇḍe iti na pāśa vyaṅgyaḥ mokṣaḥ iti tad vaiśiṣṭyam 
SA_MB_moksakarikaHK-405	mokṣe jñānakriyayorityucyate || 55 56 ||	mokṣe jñāna kriyayoḥ iti ucyate    
SA_MB_moksakarikaHK-406	pāśābhibhāvikā śaktiḥ siddhānāṃ dṛkkriyābhidhā || 57 ||	           
SA_MB_moksakarikaHK-407	tasmānna pāśajālotthaṃ jāyārāgaṃ bhajatyasau |	tasmāt na pāśa jāla uttham jāyā rāgam bhajati asau 
SA_MB_moksakarikaHK-408	sarvapāśanivṛttyā siddhasyeśvaravad jñānakriyātmikā śaktiḥ pāśavidhvaṃsiketi na	sarva pāśa nivṛttyā siddhasya īśvara vat jñāna kriyā ātmikā śaktiḥ pāśa vidhvaṃsikā iti na 
SA_MB_moksakarikaHK-409	paśoriva pāśavyaṅgyā śarīrādāvātmagrahānurāgaṃ bhajate || 57 ||	paśoḥ iva pāśa vyaṅgyā śarīra ādau ātma graha anurāgam bhajate 
SA_MB_moksakarikaHK-410	kiñci 	kiñci 
SA_MB_moksakarikaHK-411	na cotpannairvinaṣṭairvā pāśaiḥ sā bhidyate yataḥ || 58 ||	na ca utpannaiḥ vinaṣṭaiḥ vā pāśaiḥ sā bhidyate yatas 
SA_MB_moksakarikaHK-412	tatastu pāśaceṣṭābhiḥ śaktirnaivā'nuruddhyate |	tatas tu pāśa ceṣṭābhiḥ śaktiḥ nā eva anuruddhyate 
SA_MB_moksakarikaHK-413	nāpi paśoriva rāgādipāśaceṣṭābhiranurudhyamānā stryādiviṣayānurāgiṇī sā	nā api paśoḥ iva rāga ādi pāśa ceṣṭābhiḥ anurudhyamānā strī ādi viṣaya anurāgiṇī sā 
SA_MB_moksakarikaHK-414	siddhaśaktiḥ, pāśapralaye'pyavikṛtenaiva svarūpeṇeśvaraśaktivadavasthānāt || 58 ||	siddha śaktiḥ pāśa pralaye api avikṛtena eva sva rūpeṇa īśvara śakti vat avasthānāt 
SA_MB_moksakarikaHK-415	api ca 	api ca 
SA_MB_moksakarikaHK-416	śaktiḥ sā sarvaviṣayā na tenaivā'lpagocarā || 59 ||	śaktiḥ sā sarva viṣayā na tena eva alpa gocarā 
SA_MB_moksakarikaHK-417	jñeyakṛtyeṣu yugapad bhāvitvāanna kramānvitā |	jñeya kṛtyeṣu yugapad krama anvitā 
SA_MB_moksakarikaHK-418	āvaraṇābhāvācca sā sarvadā sarvatra sarvajñeyajñaptikarī sarvakāryakarī ca, na	āvaraṇa abhāvāt ca sā sarvadā sarvatra sarva jñeya jñapti karī sarva kārya karī ca na 
SA_MB_moksakarikaHK-419	paśuśaktivat kadācit kvacit kiñcidviṣayā || 59 ||	paśu śakti vat kadācid kvacid kiñcid viṣayā 
SA_MB_moksakarikaHK-420	sā ca vyaktyantarābhānna vyaktyantarabādhitā || 60 ||	sā ca vyakti antara ābhāt na vyakti antara bādhitā 
SA_MB_moksakarikaHK-421	nā'pi vidyeśvarāṇāṃ śaktivyaktiriva paramuktilakṣaṇena vyaktyantareṇa sā	nā api vidyeśvarāṇām śakti vyaktiḥ iva para mukti lakṣaṇena vyakti antareṇa sā 
SA_MB_moksakarikaHK-422	siddhaśaktirbādhyate, śivasamatvena tasyāḥ prakarṣāntarābhāvāt || 60 ||	siddha śaktiḥ bādhyate śiva sama tvena tasyāḥ prakarṣa antara abhāvāt 
SA_MB_moksakarikaHK-423	kiñca	kiñca 
SA_MB_moksakarikaHK-424	pravṛttā sā na sāmyena jñeye kṛtye ca bādhate |	pravṛttā sā na sāmyena jñeye kṛtye ca bādhate 
SA_MB_moksakarikaHK-425	na cāpīśvarecchayā vidyeśvaraśaktivat kārye pravartate nivartate vā, śivasamatvāt	na ca api īśvara icchayā vidyeśvara śakti vat kārye pravartate nivartate vā śiva sama tvāt 
SA_MB_moksakarikaHK-426	siddhaśakterīśvarapreryatvasya sarvathā nivṛtteḥ svataḥ śaktatvāt ||	siddha śakteḥ īśvara prerya tvasya sarvathā nivṛtteḥ svatas śakta tvāt 
SA_MB_moksakarikaHK-427	vyañjayanti na tāṃ pāśāḥ na ca bhūyo'bhibhūyate || 61 ||	vyañjayanti na tām pāśāḥ na ca bhūyas abhibhūyate 
SA_MB_moksakarikaHK-428	śivecchāpluṣṭabījaistaiḥ śaktistenāvinaśvarī |	śiva icchā pluṣṭa bījaiḥ taiḥ śaktiḥ tena a vinaśvarī 
SA_MB_moksakarikaHK-429	yena na vakṣyamāṇavat pāśaiḥ kāryakaraṇaiḥ paśuśaktivad vyajyate,	yena na vakṣyamāṇa vat pāśaiḥ kārya karaṇaiḥ paśu śakti vat vyajyate 
SA_MB_moksakarikaHK-430	śivaśaktyābhivyaktāṃ tāṃ prati dagdhabījaiśca pāśairna punarabhibhūyate,	śiva śaktyā abhivyaktām tām prati dagdha bījaiḥ ca pāśaiḥ na punar abhibhūyate 
SA_MB_moksakarikaHK-431	siddhaśaktyabhivyaktistato na vinaśvarī paśuśaktivyaktiriveti prakārāntareṇa naśvaratāparihāraḥ	siddha śakti abhivyaktiḥ tatas na vinaśvarī paśu śakti vyaktiḥ iva iti prakāra antareṇa naśvara tā parihāraḥ 
SA_MB_moksakarikaHK-432	vyaṅgyavyaktirbhavet tāvad yāvad vyañjakasaṃnidhiḥ || 62 ||	vyaṅgya vyaktiḥ bhavet tāvat yāvat vyañjaka saṃnidhiḥ 
SA_MB_moksakarikaHK-433	siddhaśaktāvayaṃ nyāyo vidyate neti cocyate |	siddha śaktau ayam nyāyaḥ vidyate na iti ca ucyate 
SA_MB_moksakarikaHK-434	abhivyaktikarī śaivī śaktistatsannidhānatām || 63 ||	abhivyakti karī śaivī śaktiḥ tad sannidhāna tām 
SA_MB_moksakarikaHK-435	dhātā satatamityasmādapi saiddhī na  paśyati |	dhātā satatam iti asmāt api sā aiddhī na paśyati 
SA_MB_moksakarikaHK-436	yaduktaṃ prāk siddhānāṃ sarvathā īśvarādhiṣṭhānaṃ nivartata iti tato	yat uktam prāk siddhānām sarvathā īśvara adhiṣṭhānam nivartate iti 
SA_MB_moksakarikaHK-437	vyañjakenānadhiṣṭhitatvād dīpenānadhiṣṭhānād ghaṭāderivābhivyaktirnivartamānā	vyañjakena anadhiṣṭhita tvāt dīpena anadhiṣṭhānāt ghaṭa ādeḥ iva abhivyaktiḥ nivartamānā 
SA_MB_moksakarikaHK-438	vināśinyeva | nā'yaṃ doṣaḥ | yato na dīpavad vyaṅgyasyā''varaṇanivṛttimanātyantikīṃ	vināśinī eva na ayam doṣaḥ yatas na dīpa vat vyaṅgyasya āvaraṇa nivṛttim anātyantikīm 
SA_MB_moksakarikaHK-439	kurvan parameśvaraḥ śaktivyañjaka iṣṭaḥ, yenaiṣa doṣaḥ syāt | sa	kurvan parameśvaraḥ śakti vyañjakaḥ iṣṭaḥ yena eṣa doṣaḥ syāt sa 
SA_MB_moksakarikaHK-440	tvātyantikīmāvaraṇanivṛttiṃ paṭalānāmiva cakṣurvaidyaḥ kurvan siddhānāmātmasadṛśīṃ	tu ātyantikīm āvaraṇa nivṛttim paṭalānām iva cakṣuḥ vaidyaḥ kurvan siddhānām ātma sadṛśīm 
SA_MB_moksakarikaHK-441	siddhāntaśaktivyaktikarīṃ siddhaśivasamavāyācchaivīṃ dṛkkriyāśaktimabhivyaktitaḥ	siddhānta śakti vyakti karīm siddhaśiva samavāyāt śaivīm dṛkkriyā śaktim abhivyaktitaḥ 
SA_MB_moksakarikaHK-442	sannidhāpayatīti kutaḥ parastasyā vyañjakāpekṣā, śivaśakteriva svataḥ	sannidhāpayati iti kutas paraḥ tasyāḥ vyañjaka apekṣā śiva śakteḥ iva svatas 
SA_MB_moksakarikaHK-443	sarvajñasvarūpatvāditi | na kevalaṃ pāśairavyaṅgyatvāt, asmādapi kāraṇānna vinaśvarīti |	sarvajña sva rūpa tvāt iti na kevalam pāśaiḥ avyaṅgya tvāt asmāt api kāraṇāt na vinaśvarī iti 
SA_MB_moksakarikaHK-444	ata eva na kāryatvenānityatvam, muktervyaṅgyatvāt | pūrvavyavasthitāyā eva	atas eva na kārya tvena anitya tvam mukteḥ vyaṅgya tvāt pūrva vyavasthitāyāḥ eva 
SA_MB_moksakarikaHK-445	jñānādiśakterāvaraṇavyudāsenābhivyaktitaḥ sarvaviṣayatā na svarūpapratiṣṭhitirevetyuktaḥ	jñāna ādi śakteḥ āvaraṇa vyudāsena abhivyaktitaḥ sarva viṣaya tā na svarūpa pratiṣṭhitiḥ eva iti uktaḥ 
SA_MB_moksakarikaHK-446	sarvavilakṣaṇo mokṣaḥ || 62  63 ||	sarva vilakṣaṇaḥ mokṣaḥ 
SA_MB_moksakarikaHK-447	itthaṃ vilakṣaṇāyāste siddhaśakterna pāśakāḥ || 64 ||	ittham vilakṣaṇāyāḥ te siddha śakteḥ na pāśakāḥ 
SA_MB_moksakarikaHK-448	vyaktiṃ kartuṃ samarthāstu nivṛttaistairyato bhavet |	vyaktim kartum samarthāḥ tu nivṛttaiḥ taiḥ yatas bhavet 
SA_MB_moksakarikaHK-449	uktaṃ tāvat pāśavyaṅgyāyāḥ paśuśaktito'tyantavilakṣaṇatvāt pāśābhāve'pi	uktam tāvat pāśa vyaṅgyāyāḥ paśu śakti tā utyanta vilakṣaṇa tvāt pāśa abhāve pi 
SA_MB_moksakarikaHK-450	bhāvācca muktau siddhaśivaśakterna pāśavyaṅgya-tvaṃ siddhyatīti īśvara eva tadvyañjako	bhāvāt ca muktau siddha śiva śakteḥ na pāśa vyaṅgya tvam siddhi ati iti īśvaraḥ eva tad vyañjakaḥ 
SA_MB_moksakarikaHK-451	mokṣahetuḥ || 64 ||	mokṣa hetuḥ 
SA_MB_moksakarikaHK-452	nanu yogaścittavṛttinirodhaḥ (yo0 sū0 1|2) iti yogādisaṃskṛta-mantaḥkaraṇameva	nanu yogaḥ citta vṛtti nirodhaḥ iti yoga ādi saṃskṛtam antaḥkaraṇam eva 
SA_MB_moksakarikaHK-453	mokṣaheturātmanām, neśvara iti sāṃkhyaḥ, tadayuktam 	mokṣa hetuḥ ātmanām na īśvaraḥ iti sāṃkhyaḥ tat ayuktam 
SA_MB_moksakarikaHK-454	yogo jñānaṃ tapaḥpūrvaṃ bhogasādhanaceṣṭitam || 65 ||	yogaḥ jñānam tapaḥ pūrvam bhoga sādhana ceṣṭitam 
SA_MB_moksakarikaHK-455	proktanyāyena pāśatvānna tanmokṣasya sādhanam |	prokta nyāyena pāśa tvāt na tat mokṣasya sādhanam 
SA_MB_moksakarikaHK-456	cittasyoktavajjaḍatvādvāyoriva yogādisaṃskṛtenaiva svapravṛttirūpatayā ātmano māyā	cittasya ukta vat jaḍa tvāt vāyoḥ iva yoga ādi saṃskṛtena eva sva pravṛtti rūpatayā ātmanaḥ māyā 
SA_MB_moksakarikaHK-457	vivartayitavyā, nānyatheti | vivekābhāvānnivṛttau sarvadaiva nivarteta, na vā	vivartayitavyāḥ na anyathā iti viveka abhāvāt nivṛttau sarvadā eva nivarteta na vā 
SA_MB_moksakarikaHK-458	kadācidityanirmokṣaḥ sarvadā vā mokṣa evātmano bhavet | kaścātra yogāderanuṣṭhātā	kadācid iti anirmokṣaḥ sarvadā vā mokṣaḥ eva ātmanaḥ bhavet kaḥ ca atra yoga ādeḥ anuṣṭhātā 
SA_MB_moksakarikaHK-459	yasya śāstropadeśaḥ | na tāvadātmā, niṣkriyo bhavadbhirasāvabhyupagato yataḥ | nāpi	yasya śāstra upadeśaḥ na tāvat ātmā niṣkriyaḥ bhavadbhiḥ asau abhyupagataḥ yatas na api 
SA_MB_moksakarikaHK-460	cittam, jaḍatvāt || 65 ||	cittam jaḍa tvāt 
SA_MB_moksakarikaHK-461	api ca 	api ca 
SA_MB_moksakarikaHK-462	sutīvrā api nopāyāḥ svātmavicchedakārakāḥ || 66 ||	su tīvrāḥ api na upāyāḥ sva ātma viccheda kārakāḥ 
SA_MB_moksakarikaHK-463	asidhārā sutīkṣṇāpi na svātmacchedikā yataḥ |	asi dhārā su tīkṣṇā api na sva ātma chedikā yatas 
SA_MB_moksakarikaHK-464	na ca cittasya svavṛttinirodhārthaṃ yogādyanuṣṭhānaṃ svata evopapadyate, svātmani	na ca cittasya sva vṛtti nirodha artham yoga ādi anuṣṭhānam svatas eva upapadyate sva ātmani 
SA_MB_moksakarikaHK-465	kriyāvirodhāditi | tasmādapi pravṛttinivṛttihetu-rīśvara eva sarvatra mokṣakāraṇamiti |	kriyā virodhāt iti tasmāt api pravṛtti nivṛtti hetuḥ īśvaraḥ eva sarvatra mokṣa kāraṇam iti 
SA_MB_moksakarikaHK-466	nanvīśvaro'pi kathaṃ na sarveṣāṃ yugapanmokṣahetuḥ ? apekṣyābhāvāt | na	nanu īśvaraḥ api katham na sarveṣām yugapad mokṣa hetuḥ apekṣya abhāvāt na 
SA_MB_moksakarikaHK-467	malaparipākā-pekṣyatvāt, anyathā yathādṛṣṭaniyamānupapatteḥ | taduktam  kṣīṇe tasmin	mala paripāka apekṣya tvāt anyathā yathā dṛṣṭa niyama anupapatteḥ tat uktam kṣīṇe tasmin 
SA_MB_moksakarikaHK-468	yiyāsā syāt paraṃ niḥśreyasaṃ prati (svā0 32 | 17 ) iti |  malastu tathāsvabhāvaḥ	yiyāsā syāt param niḥśreyasam prati svā              tu   
SA_MB_moksakarikaHK-469	kalpyamāno jaḍatvāt kasyacit kadācicca tathā pariṇaman nopālambhamarhati | yaduktaṃ	kalpyamānaḥ jaḍa tvāt kasyacid kadācid ca tathā pariṇaman na upālambham arhati yat uktam 
SA_MB_moksakarikaHK-470	tattvatrayanirṇaye  vinivartate nirodhāt puṃbalataḥ pariṇaman malaḥ kālāt |	                   
SA_MB_moksakarikaHK-471	pariṇativiśeṣayogāt sa kadācit kasyacit kathañcicca || (ślo0 12 ) iti || 66 ||	pariṇati viśeṣa yogāt sa kadācid kasyacid kathañcid ca      
SA_MB_moksakarikaHK-472	yadyevam 	yadi evam 
SA_MB_moksakarikaHK-473	rodhaśaktyadhikārasya kāle yāte svayaṃ tvaṇoḥ || 67 ||	rodha śakti adhikārasya kāle yāte svayam tu aṇoḥ 
SA_MB_moksakarikaHK-474	nivṛtte tu male śeṣaḥ pāśavrāto nivartate |	nivṛtte tu male śeṣaḥ pāśa vrātaḥ nivartate 
SA_MB_moksakarikaHK-475	tannivṛttau svayaṃ śuddhā dṛkkriyāśaktirātmani || 68 ||	tad nivṛttau svayam śuddhā dṛkkriyā śaktiḥ ātmani 
SA_MB_moksakarikaHK-476	vyajyate sarvaviṣayā naivā'to mokṣakṛd bhavaḥ |	vyajyate sarva viṣayāḥ na eva atas mokṣa kṛt bhavaḥ 
SA_MB_moksakarikaHK-477	puṃsāṃ jñānādibalād rodhaśaktermalasya paripākāt	puṃsām jñāna ādi balāt rodha śakteḥ malasya paripākāt 
SA_MB_moksakarikaHK-478	tadrodhādhikārakālopakṣayataḥ svayameva nivṛtte tasminnimitte'nya-pāśanivṛttau	tad rodha adhikāra kāla upakṣayataḥ svayam eva nivṛtte tasmin nimittenya pāśa nivṛttau 
SA_MB_moksakarikaHK-479	jñānakriyāśaktisteṣāṃ śuddhatvāt svayameva muktau vyaktimeṣyatīti kimīśvarasya kartṛtvena	jñāna kriyā śaktiḥ teṣām śuddha tvāt svayam eva muktau vyaktim eṣyati iti kim īśvarasya kartṛ tvena 
SA_MB_moksakarikaHK-480	| astu tarhi svatantra eva parameśvaro mokṣahetuḥ | tato naiṣa doṣaḥ, nāpyatiprasaṅgaḥ,	astu tarhi svatantraḥ eva parameśvaraḥ mokṣa hetuḥ tatas na eṣa doṣaḥ na api atiprasaṅgaḥ 
SA_MB_moksakarikaHK-481	svecchayā niyamitatvāt | yadāha vidyādhipatiḥ  svatantraḥ śaktipāto'sau śaivaḥ	sva icchayā niyamita tvāt yat āha vidyādhipatiḥ svatantraḥ śaktipātaḥ asau śaivaḥ 
SA_MB_moksakarikaHK-482	paśuvimokṣakṛt | sāpekṣatve hi tasya syādaśaktaḥ parameśvaraḥ | iti | na,	paśu vimokṣa kṛt sāpekṣa tve hi tasya syāt aśaktaḥ parameśvaraḥ iti na 
SA_MB_moksakarikaHK-483	tasyāsaṃbhavāt || 67  68 ||	tasya asaṃbhavāt 
SA_MB_moksakarikaHK-484	satyāṃ sthitau na saṃhāraṃ saṃhāre vā na ca sthitim || 69 ||	satyām sthitau na saṃhāram saṃhāre vā na ca sthitim 
SA_MB_moksakarikaHK-485	bhogaṃ ca karmahīnasya kurute na sadeśvaraḥ |	bhogam ca karma hīnasya kurute na sadā īśvaraḥ 
SA_MB_moksakarikaHK-486	svātantrye hi karmādyanapekṣaṇādakasmāt sadaiva jagataḥ sṛṣṭisaṃhārau,	svātantrye hi karma ādi anapekṣaṇāt akasmāt sadā eva jagataḥ sṛṣṭi saṃhārau 
SA_MB_moksakarikaHK-487	karmahīnasyāpi bhogam, duṣkṛtairapi mokṣam, muktasyāpi saṃhāramīśvaraḥ	karma hīnasya api bhogam duṣkṛtaiḥ api mokṣam muktasya api saṃhāram īśvaraḥ 
SA_MB_moksakarikaHK-488	kuryādityunmattaceṣṭāvadasmañjasaṃ jagad bhavet | tataśca na kaścidbhogāya mokṣāya	kuryāt iti unmatta ceṣṭāvat asmañjasam jagat bhavet tatas ca na kaścid bhogāya mokṣāya 
SA_MB_moksakarikaHK-489	duṣkṛtaparihārāya pravartateti tadupadeśaśāstrāṇāṃ sarveṣāmānarthakyāllokāyata	duṣkṛta parihārāya pravartata iti tad upadeśa śāstrāṇām sarveṣām ānarthakyāt lokāyata 
SA_MB_moksakarikaHK-490	evopāsyo bhavatām | tasmādasamañjasaparihārāya karmādipākasāpekṣaḥ	eva upāsyaḥ bhavatām tasmāt asamañjasa parihārāya karma ādi pāka sāpekṣaḥ 
SA_MB_moksakarikaHK-491	sarvakartā'bhypagantavyaḥ | na ca tadapekṣitvamasvātantryam, api tvīśvarāntarāyattatā | sā	sarva kartā abhypagantavyaḥ na ca tad apekṣi tvam asvātantryam api tu īśvara antara āyatta tā sā 
SA_MB_moksakarikaHK-492	ca tasya parameśvarānnāstīti sa eva svatantraḥ | satyāṃ sthitau na saṃhārādyakasmād	ca tasya parameśvarāt na asti iti saḥ eva svatantraḥ satyām sthitau na saṃhāra ādi akasmāt 
SA_MB_moksakarikaHK-493	bhogādikaṃ ca karmahīnāderna kadācit karotīti sāpekṣa eva śaktipāta iti |	bhoga ādikam ca karma hīna ādeḥ na kadācid karoti iti sāpekṣaḥ eva śaktipātaḥ iti 
SA_MB_moksakarikaHK-494	yadyevaṃ karmasāmyāpekṣo bhaviṣyatīti | na | yathā bhogaṃ karmahīnasya kurute	yadi evam karma sāmya apekṣaḥ bhaviṣyati iti na yathā bhogam karma hīnasya kurute 
SA_MB_moksakarikaHK-495	na sadeśvaraḥ, tathā malapariṇatihīnasya na ca mokṣam, malapariṇatyapekṣitvānmokṣasya,	na sadā īśvaraḥ tathā mala pariṇati hīnasya na ca mokṣam mala pariṇati apekṣi tvāt mokṣasya 
SA_MB_moksakarikaHK-496	anyathā malakalpanānarthakyāt | sādhitaṃ cātmanāṃ karmavyatirekeṇa malo'stīti prāg	anyathā mala kalpanā ānarthakyāt sādhitam ca ātmanām karma vyatirekeṇa malaḥ usti iti prāk 
SA_MB_moksakarikaHK-497	bhogaprakaraṇe- malāpariṇateḥ karmakṣayācca vijñānakevalitaiva teṣām iti |	bhoga prakaraṇe mala apariṇateḥ karma kṣayāt ca vijñāna kevali tā eva teṣām iti 
SA_MB_moksakarikaHK-498	tasmādavaśyaṃ malaparipāka eva śaktipāte karaṇaṃ vācyam || 69 ||	tasmāt avaśyam mala paripākaḥ eva śaktipāte karaṇam vācyam  /
SA_MB_moksakarikaHK-499	nanu sa ca malaḥ paripākāt svayameva nivartamānaḥ puṃsāṃ mokṣakāraṇaṃ	nanu sa ca malaḥ paripākāt svayam eva nivartamānaḥ puṃsām mokṣa kāraṇam 
SA_MB_moksakarikaHK-500	bhaviṣyatīti nārthastatra śivaśaktinipātakalpanayetyuktameva, tadayuktam, yataḥ 	bhaviṣyati iti nā arthaḥ tatra śiva śakti nipāta kalpanayā iti uktam eva tat ayuktam yatas 
SA_MB_moksakarikaHK-501	cetanācetanāḥ sarve vaśyāstasyeti niścitam || 70 ||	cetana acetanāḥ sarve vaśyāḥ tasya iti niścitam 
SA_MB_moksakarikaHK-502	pravṛttau vā nivṛttau vā teṣāṃ heturato hi saḥ |	pravṛttau vā nivṛttau vā teṣām hetuḥ atas hi saḥ 
SA_MB_moksakarikaHK-503	vidārya śaktiśūlena pāśajālamaṇoḥ śivaḥ || 71 ||	vidārya śakti śūlena pāśa jālam aṇoḥ śivaḥ 
SA_MB_moksakarikaHK-504	sarvajñānakriyārūpaṃ vyanakti dvividhaṃ malam |	              
SA_MB_moksakarikaHK-505	jaḍasya svataḥ pravṛttau nivṛttau vā sāmarthyaṃ nāstītyuktam | ataḥ paripakvo'pi	jaḍasya svatas pravṛttau nivṛttau vā sāmarthyam na asti iti uktam atas paripakvaḥ api 
SA_MB_moksakarikaHK-506	malo dravyatvāt paṭalādivad buddhimatkartṛnivartya eveti īśvara eva tannivṛttipūrvaṃ puṃsāṃ	malaḥ dravya tvāt paṭala ādi vat buddhimat kartṛ nivartyaḥ eva iti īśvaraḥ eva tad nivṛtti pūrvam puṃsām 
SA_MB_moksakarikaHK-507	sarvajñatvādirūpaṃ vyañjayan mokṣaheturnāpara iti || 70-71 ||	sarvajña tva ādi rūpam vyañjayan mokṣa hetuḥ na aparaḥ iti 
SA_MB_moksakarikaHK-508	adhunā tu teṣāmīśvaraḥ sarveṣāṃ kiṃ sākṣānmokṣaheturuta keṣāñcid	adhunā tu teṣām īśvaraḥ sarveṣām kim sākṣāt mokṣa hetuḥ uta keṣāñcid 
SA_MB_moksakarikaHK-509	vyavadhāneneti rurusiddhāntasaṃsiddhaḥ kramo'tra kathyate 	vyavadhānena iti ruru siddhānta saṃsiddhaḥ kathyate 
SA_MB_moksakarikaHK-510	niṣkalān sakalānaṣṭau sargādāvicchayā patiḥ || 72 ||	niṣkalān sakalān aṣṭau sarga ādau icchayā patiḥ 
SA_MB_moksakarikaHK-511	mantreśvarānanantādīnanugṛhṇāti pudgalān |	mantreśvarān ananta ādīn anugṛhṇāti pudgalān 
SA_MB_moksakarikaHK-512	sargārambha evāṣṭāvaṇūnakalān paripakvamalaviccheda-pūrvakaṃ	sarga ārambhe eva aṣṭau aṇūn akalān paripakva mala viccheda pūrvakam 
SA_MB_moksakarikaHK-513	sarvajñānakriyābhivyaktilakṣaṇena mokṣeṇānugṛhya sākṣād bhavānanantādisaṃjñakān	sarva jñāna kriyā abhivyakti lakṣaṇena mokṣeṇa anugṛhya sākṣāt bhavān ananta ādi saṃjñakān 
SA_MB_moksakarikaHK-514	vidyeśvarān karotītyaṇupakṣa eva vidyeśvarādiviṣayo na śaktiśambhyupakṣāviti boddhavyam ||	vidyeśvarān karoti iti aṇu pakṣaḥ eva vidyeśvara ādi viṣayaḥ na śakti śambhyu pakṣau iti boddhavyam 
SA_MB_moksakarikaHK-515	ato'nantaram 	atas nantaram 
SA_MB_moksakarikaHK-516	koṭisaptakasaṃkhyākān niṣkalān sakalānaṇūn || 73 ||	koṭi saptaka saṃkhyākān niṣkalān sakalān aṇūn 
SA_MB_moksakarikaHK-517	sarvajñānakriyāvyaktyā mantrānīśaḥ karotyataḥ |	sarva jñāna kriyā vyaktyā mantra anīśaḥ karoti atas 
SA_MB_moksakarikaHK-518	tathābhūtānevāṇūn saptakoṭisaṃkhyāyuktān tathaiva sākṣādanugṛhya bhagavān	tathābhūtān eva aṇūn sapta koṭi saṃkhyā yuktān tathā eva sākṣāt anugṛhya bhagavān 
SA_MB_moksakarikaHK-519	mantrān vidadhāti || 73 ||	mantrān vidadhāti 
SA_MB_moksakarikaHK-520	mantramantreśvarāṇāṃ muktatvāt kiṃ śivasamatvameva, netyāha 	mantra mantreśvarāṇām mukta tvāt kim śiva samatvam eva na iti āha 
SA_MB_moksakarikaHK-521	rudraśaktestu janyatvāt preryatvāccāpyadhastvidam || 74 ||	rudra śakteḥ tu janya tvāt prerya tvāt ca api adhas tu idam 
SA_MB_moksakarikaHK-522	mantramantreśvarākhyānamākhyātaṃ tattvayordvayam |	mantra mantreśvara ākhyānam ākhyātam tattvayoḥ dvayam 
SA_MB_moksakarikaHK-523	rudrasya bhavataḥ śaktirvāmā jyeṣṭhā ca raudrī ceti | tasyāḥ śakteradho	rudrasya bhavataḥ śaktiḥ vāmā jyeṣṭhā ca raudrī ca iti tasyāḥ śakteḥ adhas 
SA_MB_moksakarikaHK-524	vidyāvidyeśvaralakṣaṇametat tattvayordvayaṃ veditavyam | yatastayotpādya svādhikāre preryata	vidyā avidyeśvara lakṣaṇam etat tattvayoḥ dvayam veditavyam yatas tayā utpādya sva adhikāre preryata 
SA_MB_moksakarikaHK-525	ityākhyātaṃ śāstre  śivecchā-vidhicoditam iti | preryatvāccaiṣāṃ	iti ākhyātam śāstre śiva icchā vidhi coditam iti prerya tvāt ca eṣām 
SA_MB_moksakarikaHK-526	sarvajñatve'pyadhikāramalayogataḥ parameśvarāpekṣayā kriyāśaktiḥ krameṇāṃśena	sarvajña tve pi adhikāra mala yogataḥ parameśvara apekṣayā kriyāśaktiḥ krameṇa aṃśena 
SA_MB_moksakarikaHK-527	nyūneti  vidyāvidyeśatvaṃ cāparamuktiḥ pareha śivasamatā (ślo0 51) iti	nyūnā iti vidyā avidyā īśa tvam ca apara muktiḥ parā iha śiva sama tā iti 
SA_MB_moksakarikaHK-528	tattvasaṃgrahādāvuktam | asmācca nyūnatvādeṣāṃ śaktitattvādadhobhāvaḥ, na tu	tattvasaṃgraha ādau uktam asmāt ca nyūna tvāt eṣām śakti tattvāt adhobhāvaḥ na tu 
SA_MB_moksakarikaHK-529	deśakṛtaḥ, vyāpakatvādātmanām || 74 ||	deśa kṛtaḥ vyāpaka tvāt ātmanām 
SA_MB_moksakarikaHK-530	ata eva 	atas eva 
SA_MB_moksakarikaHK-531	māyordhvaṃ niṣkalatvādyaṃ māyoparyadhikārataḥ || 75 ||	māyā ūrdhvam niṣkala tva ādyam māyā upari adhikārataḥ 
SA_MB_moksakarikaHK-532	tadeva prakriyāśāstre dīkṣārthaṃ cintyate budhaiḥ |	tat eva prakriyā śāstre dīkṣā artham cintyate budhaiḥ 
SA_MB_moksakarikaHK-533	vyāpakametat tattvadvayaṃ māyoparyadhikārataḥ kalādikārya-	vyāpakam etat tattva dvayam māyā upari adhikārataḥ kalā ādi kārya 
SA_MB_moksakarikaHK-534	karaṇavarjitatvāccādhvaśāstre māyopari cintyatvena paṭhyate || 75 ||	karaṇa varjita tvāt ca adhva śāstre māyā upari cintya tvena paṭhyate 
SA_MB_moksakarikaHK-535	tathaiva 	tathā eva 
SA_MB_moksakarikaHK-536	sarve cāvarajāḥ preryāḥ prerakā hyagrajāśca ye || 76 ||	sarve ca avara jāḥ preryāḥ prerakāḥ hi agra jāḥ ca ye 
SA_MB_moksakarikaHK-537	patayo'patayo mantrā ūrdhvaṃ mantreśvarā matāḥ |	patayopatayaḥ mantrāḥ ūrdhvam mantreśvarāḥ matāḥ 
SA_MB_moksakarikaHK-538	mantrapatitvānmantrebhyaḥ pūrvamutpannatvāccānantādi-vidyeśānāṃ tebhya	mantra pati tvāt mantrebhyaḥ pūrvam utpanna tvāt ca ananta ādi vidyeśānām 
SA_MB_moksakarikaHK-539	ūrdhvamuparibhāvo mantavyaḥ | tatpreryatvena tataḥ kriyāśakternyūnatvaṃ	ūrdhvam upari bhāvaḥ mantavyaḥ tad prerya tvena tatas kriyāśakteḥ nyūna tvam 
SA_MB_moksakarikaHK-540	tvadhobhāvānmantrāṇām || 76 ||	tu adhobhāvāt mantrāṇām 
SA_MB_moksakarikaHK-541	tato'nantaram 	tatonantaram 
SA_MB_moksakarikaHK-542	kalāḥ sṛṣṭvā maheśānastābhiḥ saṃyojya pudgalān || 77 ||	kalāḥ sṛṣṭvā maheśānaḥ tābhiḥ saṃyojya pudgalān 
SA_MB_moksakarikaHK-543	anugṛhṇāti mantreśān māyāgarbhādhikāriṇaḥ |	anugṛhṇāti mantreśān māyā garbha adhikāriṇaḥ 
SA_MB_moksakarikaHK-544	vidyeśvarāṇāmadhiṣthānena māyātaḥ kalāditattvabhuvana-piṇḍabhāvasṛṣṭiṃ	vidyeśvarāṇām adhiṣthānena māyātaḥ kalā ādi tattva bhuvana piṇḍa bhāva sṛṣṭim 
SA_MB_moksakarikaHK-545	sarvāṃ kṛtvā tābhiḥ pudgalān karmānusāreṇa saṃyojya teṣāṃ madhyāt	sarvām kṛtvā tābhiḥ pudgalān karma anusāreṇa saṃyojya teṣām madhyāt 
SA_MB_moksakarikaHK-546	pariṇatamalānaṇūn māyāgarbhādhikāri-vidyeśvaratvena sākṣād bhagavānanugṛhṇāti || 77	pariṇata malān aṇūn māyā garbha adhikāri vidyeśvara tvena sākṣāt bhagavān anugṛhṇāti 
SA_MB_moksakarikaHK-547	kimabhidhānān kiṃsaṃkhyātān tānityāha 	kimabhidhānān kiṃsaṃkhyātān tān iti āha 
SA_MB_moksakarikaHK-548	maṇḍalādhipatīnaṣṭau krodheśādyaṣṭakaṃ tathā || 78 ||	maṇḍala adhipatīn aṣṭau krodha īśa ādi aṣṭakam tathā 
SA_MB_moksakarikaHK-549	icchayā śatarudrāṃśca vīrabhadrapurassarān |	icchayā śata rudrān ca vīrabhadra purassarān 
SA_MB_moksakarikaHK-550	krodheśa ādau yasyāṣṭakasya śrīkaṇṭhasahitasya | tathā tattvasaṃgrahe 	krodha īśaḥ ādau yasya aṣṭakasya śrīkaṇṭha sahitasya tathā tattvasaṃgrahe 
SA_MB_moksakarikaHK-551	maṇḍalinaḥ śrīkaṇṭhāḥ krodhādyāḥ (ślo0 30) ityuktam | evamaṣṭādaśādhikaśatameṣāṃ	maṇḍalinaḥ śrīkaṇṭhāḥ krodha ādyāḥ iti uktam evam aṣṭādaśa adhika śatam eṣām 
SA_MB_moksakarikaHK-552	rudrāṇāmanugṛhṇāti || 78 ||	rudrāṇām anugṛhṇāti 
SA_MB_moksakarikaHK-553	anugrahāya jantūnāṃ mantrāṇāṃ hi prayojakāḥ || 79 ||	anugrahāya jantūnām mantrāṇām hi prayojakāḥ 
SA_MB_moksakarikaHK-554	ete mantreśvarāstasmānna mantrordhvavyavasthite |	ete mantreśvarāḥ tasmāt na mantra ūrdhva vyavasthite 
SA_MB_moksakarikaHK-555	itthaṃ mantramantreśvarayoḥ paścādutpattermāyāgarbhādhi-	ittham mantra mantreśvarayoḥ paścāt utpatteḥ māyā garbha adhi 
SA_MB_moksakarikaHK-556	kāritvādadhobhāve'pyeṣāmācāryādivat paśvanugrahāya mantraprayojakatvānmantreśvaratvam	kāri tvāt adhobhāve pi eṣām ācārya ādi vat paśu anugrahāya mantra prayojaka tvāt mantreśvara tvam 
SA_MB_moksakarikaHK-557	| na tvanantādīnāmiva mantrebhya ūrdhvaṃ sthitatvāt || 79 ||	na tu ananta ādīnām iva mantrebhyaḥ ūrdhvam sthita tvāt 
SA_MB_moksakarikaHK-558	kiñca 	kiñca 
SA_MB_moksakarikaHK-559	agrajā niṣkalā mantrā ete caitadvilakṣaṇāḥ || 80 ||	agra jāḥ niṣkalāḥ mantrāḥ ete ca etad vilakṣaṇāḥ 
SA_MB_moksakarikaHK-560	mantratattvādadhastasmānmāyāgarbhādhikāriṇaḥ |	mantra tattvāt adhas tasmāt māyā garbha adhikāriṇaḥ 
SA_MB_moksakarikaHK-561	mantrāṇāṃ niṣkalatvenoktatvādeṣāṃ tu sakalatvāt tebhyo'pi nyūnaśaktitvenādho	mantrāṇām niṣkala tvena ukta tvāt eṣām tu sakala tvāt tebhyaḥ api nyūna śakti tvena adhas 
SA_MB_moksakarikaHK-562	māyāgarbha evādhikāra ityadhikārabhedādevaṃ mantramantreśvaravargāḥ parasparaṃ	māyā garbhaḥ eva adhikāraḥ iti adhikāra bhedāt evam mantra mantreśvara vargāḥ parasparam 
SA_MB_moksakarikaHK-563	śaktito bhinnā eva, na tvāvārakāḥ | yathā vārttikakāra āha  pareṇa rūpeṇa	śaktitaḥ bhinnāḥ eva na tu āvārakāḥ yathā vārttikakāraḥ āha pareṇa rūpeṇa 
SA_MB_moksakarikaHK-564	nirviśeṣās-trayo'pyamī | mahālpayoniyogitvād viśiṣyante parasparam || iti || 80 ||	nirviśeṣāḥ trayaḥ api amī mahā alpa yoni yogi tvāt viśiṣyante parasparam iti 
SA_MB_moksakarikaHK-565	kutraiṣāṃ vīrabhadrādīnāmadhvani sthitirityucyate 	kutra eṣām vīrabhadra ādīnām adhvani sthitiḥ iti ucyate 
SA_MB_moksakarikaHK-566	māyāgarbhādhikāritvāt sakalatvācca śāsane || 81 ||	māyā garbha adhikāri tvāt sakala tvāt ca śāsane 
SA_MB_moksakarikaHK-567	māyātattvādadhastasmācchivaśaktisamanvitāḥ |	māyā tattvāt adhas tasmāt śiva śakti samanvitāḥ 
SA_MB_moksakarikaHK-568	yatteṣāṃ māyāgarbhādhikāraḥ sakalatvaṃ coktam, tato	yat teṣām māyā garbha adhikāraḥ sakala tvam ca uktam 
SA_MB_moksakarikaHK-569	brahmādivanmāyātattvādadhaḥ kalādibhuvaneṣvavasthitiḥ || 81 ||	brahma ādi vat māyā tattvāt adhas kalā ādi bhuvaneṣu avasthitiḥ 
SA_MB_moksakarikaHK-570	nanu sakalatvādeṣāṃ kalādisaṃkocitadṛkkriyatvāt paśuvat kathaṃ	nanu sakala tvāt eṣām kalā ādi saṃkocita dṛkkriya tvāt paśu vat katham 
SA_MB_moksakarikaHK-571	māyāgarbhādhikāre śivaśaktisamanvitatvamiti ? ucyate 	māyā garbha adhikāre śiva śakti samanvita tvam iti ucyate 
SA_MB_moksakarikaHK-572	kalāyoge'pi no vaśyāḥ kalānāṃ paśusaṃghavat || 82 ||	kalā yoge api no vaśyāḥ kalānām paśu saṃgha vat 
SA_MB_moksakarikaHK-573	vaśyāstāḥ paśubhiḥ sārdhaṃ teṣāṃ te taduparyataḥ |	vaśyāḥ tāḥ paśubhiḥ sārdham teṣām te tad upari atas 
SA_MB_moksakarikaHK-574	yatasteṣāṃ kālādīnāṃ krameṇoparyavasthitāḥ || 83 ||	yatas teṣām kāla ādīnām krameṇa upari avasthitāḥ 
SA_MB_moksakarikaHK-575	yatasteṣāṃ paśubhiḥ sārdhaṃ tāḥ kalāḥ preryatvādvaśyāḥ, tasmānna	yatas teṣām paśubhiḥ sārdham tāḥ kalāḥ prerya tvāt vaśyāḥ tasmāt na 
SA_MB_moksakarikaHK-576	kalādiyoge'pi kalāvaśyatvameṣāmiti sarvajñatā māyāgarbhādhikāraścāviruddha iti || 82 	kalā ādi yoge api kalā vaśya tvam eṣām iti sarvajña tā māyā garbha adhikāraḥ ca aviruddhaḥ iti 
SA_MB_moksakarikaHK-577	mantraiḥ sārdhaṃ tadīśānāṃ pareṣāmaparaiḥ saha |	mantraiḥ sārdham tad īśānām pareṣām aparaiḥ saha 
SA_MB_moksakarikaHK-578	āvirbhavatyadhīkāraḥ svaśaktivyaktyanantaram || 84 ||	āvirbhavati adhīkāraḥ sva śakti vyakti anantaram 
SA_MB_moksakarikaHK-579	mantreśvarāṇāṃ cānantādīnāṃ pareṣāṃ krodhādīnāma-pareṣāṃ	mantreśvarāṇām ca ananta ādīnām pareṣām krodha ādīnām apareṣām 
SA_MB_moksakarikaHK-580	vīrabhadrādīnāṃ ca yadaiveśvaraṇa pāśavicchedapūrvaṃ	vīrabhadra ādīnām ca yadā evā īśvaraṇa pāśa viccheda pūrvam 
SA_MB_moksakarikaHK-581	jñānakriyāśaktiranurūpā'bhivyañjitā''sīt, tadaivānurūpamadhikāraṃ karoti na	jñāna kriyā śaktiḥ anurūpā abhivyañjitā āsīt tadā eva anurūpam adhikāram karoti na 
SA_MB_moksakarikaHK-582	kālāntaraṃ pratīkṣate || 84 ||	kāla antaram pratīkṣate 
SA_MB_moksakarikaHK-583	mantrāṇāṃ tu 	mantrāṇām tu 
SA_MB_moksakarikaHK-584	māyābandhavimokṣāya kāraṇādātmano vyadhāt |	māyā bandha vimokṣāya kāraṇāt ātmanaḥ vyadhāt 
SA_MB_moksakarikaHK-585	mantrakoṭyo'bhavan sapta sapteti niyamaḥ śruteḥ || 85 ||	mantra koṭyaḥ bhavan sapta sapta iti niyamaḥ śruteḥ 
SA_MB_moksakarikaHK-586	kālāntareṇa teṣāṃ kāryakaraṇamiti bhedaḥ, sa teṣāmadhikāraḥ kiṃ nitya eva ?	kāla antareṇa teṣām kārya karaṇam iti bhedaḥ sa teṣām adhikāraḥ kim nityaḥ eva 
SA_MB_moksakarikaHK-587	netyucyate 	na iti ucyate 
SA_MB_moksakarikaHK-588	mantrāṇāṃ mantranāthānāṃ kṛtārthānāmapīdṛśām |	mantrāṇām mantranāthānām kṛtārthānām api īdṛśām 
SA_MB_moksakarikaHK-589	vyāpāraparatantrāṇāmadhikārastu sāvadhiḥ || 86 ||	vyāpāra paratantrāṇām adhikāraḥ tu sa avadhiḥ 
SA_MB_moksakarikaHK-590	kṛtārthānāṃ muktānāmapyeṣāṃ paśuvad vyāpāraparatantratvād	kṛtārthānām muktānām api eṣām paśu vat vyāpāra paratantra tvāt 
SA_MB_moksakarikaHK-591	vakṣyamāṇā'vadhyanto'dhikāraḥ || 86 ||	vakṣyamāṇa avadhi antaḥ adhikāraḥ 
SA_MB_moksakarikaHK-592	adhunā'nantādīnāmapi parasparaṃ pradhānāpradhānabhāvaḥ kathyate 	adhunā ananta ādīnām api parasparam pradhāna apradhāna bhāvaḥ kathyate 
SA_MB_moksakarikaHK-593	sūkṣmādināyako'nantaḥ sa tadyuktaḥ śiveritaḥ |	sūkṣma ādi nāyakaḥ ūna antaḥ sa tad yuktaḥ śiva īritaḥ 
SA_MB_moksakarikaHK-594	utpatisthitisaṃhārasaṃrodhānugrahārthakṛt || 87 ||	utpati sthiti saṃhāra saṃrodha anugraha artha kṛt 
SA_MB_moksakarikaHK-595	yathā kilānantaḥ śivāt kalayā kriyāśaktyā nyūnaḥ sthityādīni karmāṇi	yathā kila anantaḥ śivāt kalayā kriyāśaktyā nyūnaḥ sthiti ādīni karmāṇi 
SA_MB_moksakarikaHK-596	śivādhiṣṭhitaḥ karoti, evamanantāt sūkṣmaḥ  teṣāmanantaḥ parameśvaraḥ (rau0 saṃ0 2 |	śiva dhiṣṭhitaḥ karoti evam anantāt sūkṣmaḥ teṣām anantaḥ parameśvaraḥ rau saṃ 
SA_MB_moksakarikaHK-597	12 ) iti śruteḥ | tathā sūkṣmācchivottama ityādi sarveṣāṃ pūrvapūrvāpekṣayā	iti śruteḥ tathā sūkṣmāt śiva uttamaḥ ityādi sarveṣām pūrva pūrva apekṣayā 
SA_MB_moksakarikaHK-598	nyūnatvaṃ boddhavyam || 87 ||	nyūna tvam boddhavyam  /
SA_MB_moksakarikaHK-599	adhunā mantrāṇāmadhikārakālaḥ parasparaṃ vailakṣaṇyaṃ cocyate 	adhunā mantrāṇām adhikāra kālaḥ parasparam vailakṣaṇyam ca ucyate 
SA_MB_moksakarikaHK-600	mantrāṇāṃ pūrvamardhaṃ tu kṛtāt sargādanantaram |	mantrāṇām pūrvam ardham tu kṛtāt sargāt anantaram 
SA_MB_moksakarikaHK-601	adhikārasya vaicitryādanugṛhya bhaveritam || 88 ||	adhikārasya vaicitryāt anugṛhya bhava īritam 
SA_MB_moksakarikaHK-602	tatkālamādṛtān puṃsaḥ kāraṇānugrahecchayā |	tad kālam ādṛtān puṃsaḥ kāraṇa anugraha icchayā 
SA_MB_moksakarikaHK-603	kṛtvādhikāramāyāti śivasāyujyamacyutam || 89 ||	kṛtvā adhikāram āyāti śiva sāyujyam acyutam 
SA_MB_moksakarikaHK-604	saptakoṭisaṃkhyātānāṃ mantrāṇāṃ pūrvaṃ prakṛṣṭamardhamatīva	sapta koṭi saṃkhyātānām mantrāṇām pūrvam prakṛṣṭam ardham atīva 
SA_MB_moksakarikaHK-605	paripakvamalatvājjanmavyādhyādyupahataṃ saṃsāramavalokya tatsaṃsargaṃ paśuprayojyatāṃ	paripakva mala tvāt janma vyādhi ādi upahatam saṃsāram avalokya tad saṃsargam paśu prayojya tām 
SA_MB_moksakarikaHK-606	cātmanaḥ soḍhumakṣamā vayamitīśvaraṃ vijñāpya tatpreraṇayaiva	ca ātmanaḥ soḍhum akṣamāḥ vayam iti īśvaram vijñāpya tad preraṇayā eva 
SA_MB_moksakarikaHK-607	vidyaśvaraniyogamapyanapekṣya śivaśaktyā samāhṛtānaṇuṃstatkālameva sākṣāt	vidyaśvara niyogam api an apekṣya śiva śaktyā samāhṛtān aṇun tad kālam eva sākṣāt 
SA_MB_moksakarikaHK-608	tattaktkartṛtayaiva taddhiyā ca tatkaraṇatayā cānugṛhya vicitramadhikāraṃ kṛtvā	tad tad tkartṛ tayā eva tad dhiyā ca tad karaṇa tayā ca anugṛhya vicitram adhikāram kṛtvā 
SA_MB_moksakarikaHK-609	parāṃmuktiṃ śivasamatvaṃ gatam || 88 89 ||	parām muktim śiva sama tvam gatam 
SA_MB_moksakarikaHK-610	dvitīyārdhasya kā vārtetyucyate 	dvitīya ardhasya kā vārttā iti ucyate 
SA_MB_moksakarikaHK-611	śivo'vaśiṣṭamantrāṇāṃ parivārāṅgaśambarān |	śiva uvaśiṣṭa mantrāṇām parivāra aṅga śambarān 
SA_MB_moksakarikaHK-612	siddhimuktiprasiddhyarthaṃ maṇḍalāni ca sṛṣṭavān || 90 ||	siddhi mukti prasiddhi artham maṇḍalāni ca sṛṣṭavān 
SA_MB_moksakarikaHK-613	atha śiṣṭasyārdhasya pravṛttyarthaṃ parameśvaro'ṇuparivārakamaṇvantaraṃ	atha śiṣṭasya ardhasya pravṛtti artham parameśvara uṇu parivārakam aṇvantaram 
SA_MB_moksakarikaHK-614	hṛdayādyaṅgaṃ śaktiyogaṃ ca śambarāṃśca tadvācakān śabdān maṇḍalāni ca	hṛdaya ādi aṅgam śakti yogam ca śambarān ca tad vācakān śabdān maṇḍalāni ca 
SA_MB_moksakarikaHK-615	pūjāsthānāni navanābhādīni lokānāṃ hitārthamakārṣīt || 90 ||	pūjā sthānāni nava nābha ādīni lokānām hita artham akārṣīt  /
SA_MB_moksakarikaHK-616	athaiṣāṃ mantrāṇāṃ pūrveṣāmiva kimanugrahe kartṛtvameva, netyucyate 	atha eṣām mantrāṇām pūrveṣām iva kim anugrahe kartṛ tvam eva na iti ucyate 
SA_MB_moksakarikaHK-617	te mantrāḥ sahitāstaistu parivārāṅgaśambaraiḥ |	te mantrāḥ sahitāḥ taiḥ tu parivāra aṅga śambaraiḥ 
SA_MB_moksakarikaHK-618	vimuñcantītarān nunnā deśikasthena śambhunā || 91 ||	vimuñcanti itarān nunnāḥ deśika sthena śambhunā 
SA_MB_moksakarikaHK-619	eteṣāṃ parivārādiyuktānāṃ dīkṣādāvācāryādhikaraṇe-	eteṣām parivāra ādi yuktānām dīkṣā ādau ācārya adhikaraṇe 
SA_MB_moksakarikaHK-620	śvaraprayojyatvādanugrahakaraṇatvaṃ sadaiva na kartṛtā || 91 ||	śvara prayojya tvāt anugraha karaṇa tvam sadā eva na kartṛ tā 
SA_MB_moksakarikaHK-621	adhaḥ svabhuvanāccaiṣāṃ mantreśā bhogamokṣadāḥ |	adhas sva bhuvanāt ca eṣām mantreśāḥ bhoga mokṣa dāḥ 
SA_MB_moksakarikaHK-622	svaṃ svaṃ dadati jantūnāmīśaśaktipracoditāḥ || 92 ||	svam svam dadati jantūnām īśa śakti pracoditāḥ 
SA_MB_moksakarikaHK-623	śeṣāstvapradhānā vidyeśā vīrabhadrarudrādayaḥ | bhuvanebhya ūrdhvaṃ	śeṣāḥ tu apradhānāḥ vidyeśāḥ vīrabhadra rudra ādayaḥ bhuvanebhyaḥ ūrdhvam 
SA_MB_moksakarikaHK-624	śāstravihitebhyo yajjantūnāṃ svabhuvane ca keṣāñcid brahmaviṣṇvādīnāmanugrahaṃ ca	śāstra vihitebhyaḥ yat jantūnām sva bhuvane ca keṣāñcid brahma viṣṇu ādīnām anugraham ca 
SA_MB_moksakarikaHK-625	kurvantīti tatkartāro nānantādivadbhuvanasargādikartāraḥ || 92 ||	kurvanti iti tad kartāraḥ na ananta ādi vat bhuvana sarga ādi kartāraḥ 
SA_MB_moksakarikaHK-626	mantramantreśvarāṇāmadhikārāvadhiḥ pratijñāta ucyate 	mantra mantreśvarāṇām adhikāra avadhiḥ pratijñātaḥ ucyate 
SA_MB_moksakarikaHK-627	amī rudrāstu sūkṣmādyā mantrāśca śivatulyatām |	amī rudrāḥ tu sūkṣma ādyāḥ mantrāḥ ca śiva tulya tām 
SA_MB_moksakarikaHK-628	sānantāḥ svādhikārānte yānti muktiṃ hareraṇāt || 93 ||	sa anantāḥ sva adhikāra ante yānti muktim 
SA_MB_moksakarikaHK-629	atra sūkṣmādīnāṃ ca mantrāṇāṃ ca tadīśānāmapi	atra sūkṣma ādīnām ca mantrāṇām ca tad īśānām api 
SA_MB_moksakarikaHK-630	vīrabhadrādīnāmanantoparamakāla eva sarveṣāṃ yugapacchivasamatā parā muktiḥ |	vīrabhadra ādīnām ananta uparama kālaḥ eva sarveṣām yugapad śiva samatā parā muktiḥ 
SA_MB_moksakarikaHK-631	yacchrayate  ananto parame teṣāṃ mahatāṃ cakravartinām | vihitaṃ sarvakartṛtvakāraṇaṃ	yat śrayate parame teṣām mahatām cakravartinām vihitam sarva kartṛ tva kāraṇam 
SA_MB_moksakarikaHK-632	paramaṃ padam || (rau0 sū0 2 |13 ) iti | ata eva na tu krameṇa | yathā vārttikakāra āha	paramam padam rau sū     iti atas eva na tu krameṇa yathā vārttikakāraḥ āha 
SA_MB_moksakarikaHK-633	 ananto parame sthāne tattu sūkṣmo'dhitiṣṭhati | padātpadaṃ vicarato hyekaikasya	parame sthāne tat tu sūkṣmā udhitiṣṭhati padāt padam vicarataḥ hi ekaikasya 
SA_MB_moksakarikaHK-634	mahātmanaḥ || sthāne śikhaṇḍinastvanyaṃ rudrāṇāṃ kurute śivaḥ || iti || 93 ||	mahātmanaḥ sthāne śikhaṇḍinaḥ tu anyam rudrāṇām kurute śivaḥ iti 
SA_MB_moksakarikaHK-635	athānantasya kadoparam ityucyate 	atha anantasya kadā uparam iti ucyate 
SA_MB_moksakarikaHK-636	sṛṣṭyādipañcakarmāṇi kṛtvānanteśvarastataḥ |	sṛṣṭi ādi pañca karmāṇi kṛtvā ananta īśvaraḥ tatas 
SA_MB_moksakarikaHK-637	pāratantryād vinirmuktaḥ prāpnoti patitulyatām || 94 ||	pāratantryāt vinirmuktaḥ prāpnoti pati tulya tām 
SA_MB_moksakarikaHK-638	yadā'nantenaikasmin māyāsarge pañcakarmāṇi māyāsambandhi	yadā anantena ekasmin māyā sarge pañcakarmāṇi māyā sambandhi 
SA_MB_moksakarikaHK-639	sṛṣṭyādipañcakarma nirvartitaṃ bhavati, tadā māyākāryasyākhilasyopasaṃhṛtatvāt	sṛṣṭi ādi pañcakarma nirvartitam bhavati tadā māyā kāryasya akhilasya upasaṃhṛta tvāt 
SA_MB_moksakarikaHK-640	kṛtaprayojano'nanto mahā pralayopakrama eva patisamatvaṃ parāmuktiṃ gacchatīti || 94 ||	kṛta prayojana ūnantaḥ mahā pralaya upakramaḥ eva pati sama tvam parāmuktim gacchati iti 
SA_MB_moksakarikaHK-641	yadyevamanantādīnāmupasaṃhṛtatvānmāyātaḥ sargāntarāṇi kathaṃ bhagavān	yadi evam ananta ādīnām upasaṃhṛta tvāt māyātaḥ sarga antarāṇi katham bhagavān 
SA_MB_moksakarikaHK-642	karotītyucyate 	karoti iti ucyate 
SA_MB_moksakarikaHK-643	evaṃ sargeṣvatīteṣu bhaviṣyatsu ca śaṅkaraḥ |	evam sargeṣu atīteṣu bhaviṣyatsu ca śaṅkaraḥ 
SA_MB_moksakarikaHK-644	puṃso mocitavānanyān mocayiṣyati cāparān || 95 ||	puṃsaḥ mocitavān anyān mocayiṣyati ca aparān 
SA_MB_moksakarikaHK-645	pratisargaṃ pūrvānevānantādīn kṛtvā puṃsāṃ bhogaṃ nirvartya bhagavān	pratisargam pūrvān eva ananta ādīn kṛtvā puṃsām bhogam nirvartya bhagavān 
SA_MB_moksakarikaHK-646	mokṣaṃ karotītyarthaḥ || 95 ||	mokṣam karoti iti arthaḥ 
SA_MB_moksakarikaHK-647	tadevam 	tat evam 
SA_MB_moksakarikaHK-648	ācāryasaṃsthito devo dīkṣāśaktyaiva muñcati |	ācārya saṃsthitaḥ devaḥ dīkṣā śaktyā eva muñcati 
SA_MB_moksakarikaHK-649	svaśaktyopahṛtān puṃso mantrasādhanasādhyayā || 96 ||	sva śaktyā upahṛtān puṃsaḥ mantra sādhana sādhyayā 
SA_MB_moksakarikaHK-650	parameśa eva ācāryastho mantramantreśavyatiriktān dīkṣayaiva mantrasādhyayā	parameśaḥ eva ācārya sthaḥ mantra mantreśa vyatiriktān dīkṣayā eva mantra sādhyayā 
SA_MB_moksakarikaHK-651	paripakvamalān puṃso mocayatītyuktam || 96 ||	paripakva malān puṃsaḥ mocayati iti uktam 
SA_MB_moksakarikaHK-652	na jñānādineti pūrvapratijñātaḥ sarvo'rtho nirṇītaḥ | yadyevaṃ	na jñāna ādinā iti pūrva pratijñātaḥ sarvaḥ arthaḥ nirṇītaḥ yadi evam 
SA_MB_moksakarikaHK-653	māyāñjanottarakālaṃ hṛtānāṃ kathaṃ mokṣaḥ ? teṣāmapyācāryā'dhikaraṇo	māyā añjana uttara kālam hṛtānām katham mokṣaḥ teṣām api ācārya adhikaraṇaḥ 
SA_MB_moksakarikaHK-654	bhagavāneva dīkṣāṃ karoti, pratibhuvanaṃ guruṇāṃ sambhavāt | tathāhi 	bhagavān eva dīkṣām karoti pratibhuvanam guruṇām sambhavāt tathā hi 
SA_MB_moksakarikaHK-655	mantreśā guravaḥ pūrve rudrā devā munīśvarāḥ |	mantreśāḥ guravaḥ pūrve rudrāḥ devāḥ muni īśvarāḥ 
SA_MB_moksakarikaHK-656	mantreśaiḥ śāsitā rudrā rudrairdevāḥ suśāsitāḥ || 97 ||	mantra īśaiḥ śāsitāḥ rudrāḥ rudraiḥ devāḥ su śāsitāḥ 
SA_MB_moksakarikaHK-657	devairmunīśvarāścātra munimartyā munīśvaraiḥ |	devaiḥ muni īśvarāḥ ca atra muni martyāḥ muni īśvaraiḥ 
SA_MB_moksakarikaHK-658	manuṣyairmānuṣāstadvad varṇasaṃsthā dvijottamaiḥ || 98 ||	manuṣyaiḥ mānuṣāḥ tadvat varṇa saṃsthāḥ dvijottamaiḥ 
SA_MB_moksakarikaHK-659	rudrāḥ śrīkaṇṭhādayo'tra | evaṃ gurūṇāṃ saṃbhavāt tattatkartṛtayaiva sarvatra	rudrāḥ śrīkaṇṭha ādayaḥ atra evam gurūṇām saṃbhavāt tad tad kartṛtayā eva sarvatra 
SA_MB_moksakarikaHK-660	dīkṣayā mokṣaḥ || 97 98 ||	dīkṣayā mokṣaḥ 
SA_MB_moksakarikaHK-661	varṇasaṃsthā dvijottamairityuktaṃ sādhyate 	varṇa saṃsthā dvijottamaiḥ iti uktam sādhyate 
SA_MB_moksakarikaHK-662	dīkṣāyāṃ sādhakatve ca caturṇāṃ varṇināmiha |	dīkṣāyām sādhaka tve ca caturṇām varṇinām iha 
SA_MB_moksakarikaHK-663	adhikāro gurutvena brāhmaṇasyaiva kīrtitaḥ || 99 ||	adhikāraḥ guru tvena brāhmaṇasya eva kīrtitaḥ 
SA_MB_moksakarikaHK-664	sādhakadīkṣādau brāhmaṇān (raurave iti mataṅgapārameśvaravṛttau (kri0 5|93)	sādhaka dīkṣā ādau brāhmaṇān raurave iti mataṅga pārameśvara vṛttau kri 
SA_MB_moksakarikaHK-665	dṛśyate | mudrite raurave nopalabhyata iti tatratyā ṭippaṇī (pṛ0 113, ṭi0 6) |) kṣatriyān	dṛśyate mudrite raurave na upalabhyate iti tatratyā ṭippaṇī pṛ ṭi   kṣatriyān 
SA_MB_moksakarikaHK-666	vaiśyān śūdrāṃścaiva iti śrūyate | ataścaturṇāmapyatrādhikāraḥ | gurutve tu	vaiśyān śūdrān ca eva iti śrūyate atas caturṇām api atra adhikāraḥ guru tve tu 
SA_MB_moksakarikaHK-667	athācāryavaraḥ śrīmānagrajanmā supeśalaḥ (svā0 15|1) iti śruterbrāhmaṇasyaiva || 99 ||	atha ācārya varaḥ śrīmān agrajanmā supeśalaḥ iti śruteḥ brāhmaṇasya eva 
SA_MB_moksakarikaHK-668	brāhmaṇo'pi na sarvo guruḥ, kintu 	brāhmaṇaḥ api na sarvaḥ guruḥ kintu 
SA_MB_moksakarikaHK-669	śaktyadhiṣṭheyaniṣpādyasahitaṃ dīkṣitaḥ śivam |	śakti adhiṣṭheya niṣpādya sahitam dīkṣitaḥ śivam 
SA_MB_moksakarikaHK-670	yo vettyeva niyuktaḥ san guruṇā gaurave guruḥ || 100 ||	yaḥ vetti eva niyuktaḥ san guruṇā gaurave guruḥ 
SA_MB_moksakarikaHK-671	yo dīkṣitaḥ parameśvarasyaitā jñānādayaḥ śaktayo'nāśritā-dyaṃ	yaḥ dīkṣitaḥ parameśvarasya etāḥ jñāna ādayaḥ śaktayaḥ na āśrita ādyam 
SA_MB_moksakarikaHK-672	kālāgnirudrabhuvanāntaṃ sarvaṃ tattvabhuvanabhūtabhāvā-dyametadadhiṣṭheyametacca	kālāgni rudra bhuvana antam sarvam tattva bhuvana bhūta bhāva ādyam etat adhiṣṭheyam etat ca 
SA_MB_moksakarikaHK-673	niṣpādyaṃ paśūnāṃ bhogamokṣāvityevaṃ parameśvaraṃ saṃhitābhyo'vagatya	niṣpādyam paśūnām bhoga mokṣau iti evam parameśvaram saṃhitābhyaḥ uvagatya 
SA_MB_moksakarikaHK-674	padavākyapramāṇaistadviṣayamithyājñānavyudāsena niścitaṃ vetti,	pada vākya pramāṇaiḥ tad viṣaya mithyājñāna vyudāsena niścitam vetti 
SA_MB_moksakarikaHK-675	tamevātmāntaraparigrahāya	tam eva ātmā antara parigrahāya 
SA_MB_moksakarikaHK-676	dīkṣāyāmarcākaraṇopayogāya ca bhāvayati, sa jñānaniṣṭho guruṇā gurutve	dīkṣāyām arcā karaṇa upayogāya ca bhāvayati sa jñāna niṣṭhaḥ guruṇā guru tve 
SA_MB_moksakarikaHK-677	niyuktaḥ san gururnānyaḥ | yaduktam  nājño bhrāntaḥ sasandeho gururbhāvavivarjitaḥ |	niyuktaḥ san guruḥ na anyaḥ yat uktam na ajñaḥ bhrāntaḥ sa sandehaḥ guruḥ bhāva vivarjitaḥ 
SA_MB_moksakarikaHK-678	nātattvavidanabhyastakarmamārgo'pi no mataḥ || iti || 100 ||	na a tattva vid anabhyasta karma mārgaḥ upi naḥ mataḥ iti 
SA_MB_moksakarikaHK-679	atha dīkṣitaiḥ kiṃ buddhyupārūḍhaḥ sarveśvaro jñātavyastadanupārūḍho vā ?	atha dīkṣitaiḥ kim buddhyupārūḍhaḥ sarveśvaraḥ jñātavyaḥ tad anupārūḍhaḥ vā 
SA_MB_moksakarikaHK-680	tatra 	tatra 
SA_MB_moksakarikaHK-681	buddhibodhaprakāśyatvaṃ śivasyānyaiḥ samīhitam |	buddhi bodha prakāśya tvam śivasya anyaiḥ samīhitam 
SA_MB_moksakarikaHK-682	śaivamānamavindadbhiḥ paśumānānuvāsitaiḥ || 101 ||	śaiva mānam a vindadbhiḥ paśu māna anuvāsitaiḥ 
SA_MB_moksakarikaHK-683	buddhyupārūḍhā evārthāḥ sarvadā puruṣeṇa cetyante, na tadanupārūḍhāḥ,	buddhi upārūḍhāḥ eva arthāḥ sarvadā puruṣeṇa cetyante na tad anupārūḍhāḥ 
SA_MB_moksakarikaHK-684	buddhyādīnāmānarthakyaprasaṅgāt | parameśvaro'pi bhinna eva tasyāścetyata iti	buddhi ādīnām ānarthakya prasaṅgāt parameśvaraḥ api bhinnaḥ eva tasyāḥ cetyate iti 
SA_MB_moksakarikaHK-685	buddhyupārūḍha eva cetyo nānyathā kevalaḥ | tathā hi  dharmādīśvaraprasādataḥ	buddhi upārūḍhaḥ eva cetyaḥ na anyathā kevalaḥ tathā hi dharmāt īśvara prasādataḥ 
SA_MB_moksakarikaHK-686	kasyacid rajastamomalaṃ parihṛtya nirmalatarasattvavṛttireva buddhirbhavati | tatra parameśvaraḥ	kasyacid rajaḥ tamaḥ malam parihṛtya nirmalatara sattva vṛttiḥ eva buddhiḥ bhavati tatra parameśvaraḥ 
SA_MB_moksakarikaHK-687	pratibimbavad vartata iti tenaiva cetyo nānyeneti kecit sāṃkhyadṛṣṭyanuvāsitāḥ, tanna,	pratibimba vat vartate iti tena eva cetyaḥ na anyena iti kecid sāṃkhya dṛṣṭi anuvāsitāḥ tat na 
SA_MB_moksakarikaHK-688	anaikāntikatvāt || 101 ||	anaikāntika tvāt 
SA_MB_moksakarikaHK-689	tathāhi 	tathā hi 
SA_MB_moksakarikaHK-690	ātmā'pyaviṣayo yasyā bhoktā bhogyatvataḥ katham |	ātmā api aviṣayaḥ yasyāḥ bhoktā bhogya tvataḥ katham 
SA_MB_moksakarikaHK-691	svaprakāśamasau devaṃ prakāśayati śaṅkaram || 102 ||	sva prakāśam asau devam prakāśayati śaṅkaram  /
SA_MB_moksakarikaHK-692	nahi yo yaścetyate sa sarvo buddhyupārūḍha eva,	nahi yaḥ yaḥ cetyate sa sarvaḥ buddhi upārūḍhaḥ eva 
SA_MB_moksakarikaHK-693	buddhibhoktṛtvādevātmanastadanupārūḍhasyāpi cetyatābhāvāditi vyāptyasiddheḥ kathaṃ	buddhi bhoktṛ tvāt evā ātmanaḥ tad anupārūḍhasya api cetya tā bhāvāt iti vyāpti asiddheḥ katham 
SA_MB_moksakarikaHK-694	vakṣyamāṇavat svaprakāśasyeśvarasya buddhyupārohaḥ siddhyet || 102 ||	vakṣyamāṇa vat sva prakāśasya īśvarasya buddhi upārohaḥ siddhyet  /
SA_MB_moksakarikaHK-695	nanu puruṣo buddhyupārūḍha eva cetyat iti sāṃkhyāḥ, tathāhi 	nanu puruṣaḥ buddhi upārūḍhaḥ eva cetyat iti sāṃkhyāḥ tathā hi 
SA_MB_moksakarikaHK-696	kapilabrahmaṇo'pyapratyakṣaḥ puruṣa iti darpaṇasthānīyāyāṃ buddhau	kapila brahmaṇā upi apratyakṣaḥ puruṣaḥ iti darpaṇa sthānīyāyām buddhau 
SA_MB_moksakarikaHK-697	viṣayiviṣayayordvayorapi pratibimbakamelanaṃ bhoga iti buddhyadhyavasita eva sarvaścetyata iti,	viṣayi viṣayayoḥ dvayoḥ api pratibimbaka melanam bhogaḥ iti buddhi adhyavasitaḥ eva sarvaḥ ca iti atas iti 
SA_MB_moksakarikaHK-698	tadapyayuktam 	tat api ayuktam 
SA_MB_moksakarikaHK-699	sarvadotpannamāno'sau puruṣo nānubhūyate |	sarvadā utpanna mānaḥ asau puruṣaḥ na anubhūyate 
SA_MB_moksakarikaHK-700	na so'sthi kālo yatrāyamatrasthenānubhūyate || 103 ||	na saḥ usthi kālaḥ yatra ayam atra sthena anubhūyate  /
SA_MB_moksakarikaHK-701	buddhisthenāpi puruṣapratibimbena puruṣo nāvaitīti tatpratibimbakalpanaṃ niṣphalameva ||	buddhi sthena api puruṣa pratibimbena puruṣaḥ na avaiti iti tad pratibimba kalpanam niṣphalam eva 
SA_MB_moksakarikaHK-702	kiñca 	kiñca 
SA_MB_moksakarikaHK-703	pūrvāparatvato yuktamātmabodhasya tasya ca |	pūrva apara tvataḥ yuktam ātma bodhasya tasya ca 
SA_MB_moksakarikaHK-704	upalabhyopalabdhṛtdaṃ tadabhāvādidaṃ tvasat || 104 ||	tad abhāvāt idam tu asat 
SA_MB_moksakarikaHK-705	pratibimbātmakatvādātmano viṣayatvaṃ bhogyatā ca, tadviṣayatvācca buddhibodhasya	pratibimba ātmaka tvāt ātmanaḥ viṣaya tvam bhogyatā ca tad viṣaya tvāt ca buddhi bodhasya 
SA_MB_moksakarikaHK-706	bhoktṛtvaprasaṅgaḥ | na caitadbhavadbhirabhyupagantavyamityasadetat  (pūrvatanī 78	bhoktṛtva prasaṅgaḥ na ca etat bhavadbhiḥ abhyupagantavyam iti asat etat pūrvatanī 
SA_MB_moksakarikaHK-707	pṛṣṭhasthā dvitīyā ṭippaṇī draṣṭavyā) buddhyadhyavasitatvāt puruṣo'pi cetyate iti || 104 ||	pṛṣṭha sthā dvitīyā ṭippaṇī draṣṭavyā buddhi adhyavasita tvāt puruṣaḥ api cetyate iti 
SA_MB_moksakarikaHK-708	api ca 	api ca 
SA_MB_moksakarikaHK-709	pariṇāmī pumān bhogyaḥ prāptastadgocaro yadi |	pariṇāmī pumān bhogyaḥ prāptaḥ tad gocaraḥ yadi 
SA_MB_moksakarikaHK-710	viparītā ca buddhiḥ syād virodhaścāpi darśane || 105 ||	viparītā ca buddhiḥ syāt virodhaḥ ca api darśane 
SA_MB_moksakarikaHK-711	itthaṃ buddhiviṣayatvena bhogyatvād viṣayavat puṃsaḥ pariṇāmitayā buddheśca	ittham buddhi viṣaya tvena bhogya tvāt viṣaya vat puṃsaḥ pariṇāmi tayā buddheḥ ca 
SA_MB_moksakarikaHK-712	bhoktṛtvānnityatvaṃ prasajyate bhavatāmiti darśanavirodhaḥ | tasmād	bhoktṛ tvāt nitya tvam prasajyate bhavatām iti darśana virodhaḥ tasmāt 
SA_MB_moksakarikaHK-713	bhoktṛbhogānyathā'nupapattyā puruṣo buddhyanupārūḍha eva	bhoktṛ bhoga anyathā anupapattyā puruṣaḥ buddhi anupārūḍhaḥ eva 
SA_MB_moksakarikaHK-714	svasaṃvedanasiddho'bhyupagantavyaḥ | kathaṃ tarhi  vyaktāvyaktajñasaṃbuddhiḥ (bho0 kā0	sva saṃvedana siddhaḥ abhyupagantavyaḥ katham tarhi vyakta avyakta jña saṃbuddhiḥ bho kā 
SA_MB_moksakarikaHK-715	60) ityādinā prāg bhogaprakaraṇe siddhyādibuddhibodhaprakāśyaḥ pumānuktaḥ ? na	ityādinā prāk bhoga prakaraṇe siddhi ādi buddhi bodha prakāśyaḥ pumān uktaḥ na 
SA_MB_moksakarikaHK-716	prakāśyatayā, kintu kārakatvenetyavirodhaḥ | vyaktyāvyaktaviṣaye hi buddhibodhe	prakāśya tayā kintu kāraka tvena iti avirodhaḥ vyaktyā avyakta viṣaye hi buddhi bodhe 
SA_MB_moksakarikaHK-717	tatprakāśakatayā'tyantaviviktaḥ puruṣaḥ svayamavabhāsat ityuktam  tadā draṣṭuḥ	tad prakāśaka tayā atyanta viviktaḥ puruṣaḥ svayam avabhāsat iti uktam tadā draṣṭuḥ 
SA_MB_moksakarikaHK-718	svarūpe'vasthānam (yo0 sū0 1| 3) iti || 105 ||	iti 
SA_MB_moksakarikaHK-719	astvetat, īśvarastu vedyatvādādityādivad buddhyupārūḍha eva vedyaḥ | na,	astu etat īśvaraḥ tu vedya tvāt āditya ādi vat buddhi upārūḍhaḥ eva vedyaḥ na 
SA_MB_moksakarikaHK-720	asaṃbhavāt | tathāhi 	asaṃbhavāt tathā hi 
SA_MB_moksakarikaHK-721	antaḥkaraṇavṛttiryā bodhākhyā sā maheśvaram |	antaḥkaraṇa vṛttiḥ yā bodha ākhyā sā maheśvaram 
SA_MB_moksakarikaHK-722	na prakāśayituṃ śaktā pāśatvānnigaḍādivat || 106 ||	na prakāśayitum śaktā pāśa tvāt nigaḍa ādi vat 
SA_MB_moksakarikaHK-723	pāśatvaṃ hi śreyodūrapratirodhakatvaṃ buddhyādīnāmiti kathaṃ vā	pāśa tvam hi śreyaḥ dūra pratirodhaka tvam buddhi ādīnām iti katham vā 
SA_MB_moksakarikaHK-724	śivātmakaparaśreyaḥ prakāśakatvaṃ syāt | pāśatve vā parimitatvaṃ buddheriti kathaṃ	                               
SA_MB_moksakarikaHK-725	tatra dikkālādyaparimitasya parameśvarasya khaṅgādāvabhīśumadāderiva pratibimba upapadyate	tatra diś kāla ādi aparimitasya parameśvarasya khaṅga ādau abhīśumat ādeḥ iva pratibimbaḥ upapadyate 
SA_MB_moksakarikaHK-726	| tadekadeśasya tu tatra pratibimbo bhrāntireva, bhagavato'navayatvenaika-	tad eka deśasya tu tatra pratibimbaḥ bhrāntiḥ eva 
SA_MB_moksakarikaHK-727	deśābhāvādityuktamasmābhiranyatra buddhau mitāyāṃ neśasya pratibimbo'mitatvataḥ |	deśa abhāvāt iti uktam asmābhiḥ anyatra buddhau mitāyām na īśasya pratibimba umita tvataḥ 
SA_MB_moksakarikaHK-728	khaḍge'bhīśumato yadvat tadaṃśasya tvasau bhramaḥ || iti || 106 ||	yadvat tad aṃśasya tu asau bhramaḥ iti 
SA_MB_moksakarikaHK-729	kiñca	kiñca 
SA_MB_moksakarikaHK-730	dāhyābhibhāvyadharmāṇaḥ pāśāste'to na śūlinaḥ |	dāhya abhibhāvya dharmāṇaḥ pāśāḥ te itas na śūlinaḥ 
SA_MB_moksakarikaHK-731	dāhābhibhavayoḥ kartuḥ prakāśāyābhivāñchitāḥ || 107 ||	dāha abhibhavayoḥ kartuḥ prakāśāya abhivāñchitāḥ 
SA_MB_moksakarikaHK-732	kāṣṭhairdāhyairna dāhasya kartā vahniḥ prakāśyate |	kāṣṭhaiḥ dāhyaiḥ na dāhasya kartā vahniḥ prakāśyate 
SA_MB_moksakarikaHK-733	nābhibhāvyābhirulkābhirdinakṛccābhibhāvakaḥ || 108 ||	na abhibhāvyābhiḥ ulkābhiḥ dinakṛt ca abhibhāvakaḥ 
SA_MB_moksakarikaHK-734	dāhyo'bhibhāvyo vā kāṣṭhādiragnyādervā dāhābhibhava-kartuḥ	dāhyaḥ abhibhāvyaḥ vā kāṣṭha ādiḥ agni ādeḥ vā dāha abhibhava kartuḥ 
SA_MB_moksakarikaHK-735	pratibimbagrahaṇena na prakāśako dṛṣṭaḥ | buddhiśca bhagavataścetyā'bhibhāvyā ceti	pratibimba grahaṇena na prakāśakaḥ dṛṣṭaḥ buddhiḥ ca bhagavataḥ cetyā abhibhāvyā ca iti 
SA_MB_moksakarikaHK-736	tasya sā na prakāśikā || 107-108 ||	tasya sā na prakāśikā 
SA_MB_moksakarikaHK-737	nanu darpaṇādibhirdāhyairanaikāntikatā ? atra bhavato mūlayuktestatra na doṣaḥ |	nanu darpaṇa ādibhiḥ dāhyaiḥ anaikāntika tā atra bhavataḥ mūla yukteḥ tatra na doṣaḥ 
SA_MB_moksakarikaHK-738	kiñcāgamavirodhaścātra pakṣe | tathāhi 	kiñca āgama virodhaḥ ca atra pakṣe tathā hi 
SA_MB_moksakarikaHK-739	viśuddhenātmatattvena caitanyākhyena sūtrakṛt |	viśuddhena ātma tattvena caitanya ākhyena sūtra kṛt 
SA_MB_moksakarikaHK-740	śivaśaktikale śuddhe śivo dhyeya iti bruvan || 109 ||	śiva śakti kale śuddhe śivaḥ dhyeyaḥ iti bruvan 
SA_MB_moksakarikaHK-741	pāśāgamyo maheśāna iti khyāpayati sma naḥ |	pāśa āgamyaḥ maheśānaḥ iti khyāpayati sma naḥ 
SA_MB_moksakarikaHK-742	dīkṣitairjñānaśaktyaiva nirmalayā śivaśaktyā dīpitayā śivo dhyeya iti	dīkṣitaiḥ jñāna śaktyā eva nirmalayā śiva śaktyā dīpitayā śivaḥ dhyeyaḥ iti 
SA_MB_moksakarikaHK-743	rauravasūtrakāro'bravīt | na buddherdhyātavyo bhagavānityāha- (tatstho līnaḥ, sarvāñjana,	rauravasūtra kāraḥ bravīt na buddheḥ dhyātavyaḥ bhagavān iti āha tad sthaḥ līnaḥ sarvāñjana 
SA_MB_moksakarikaHK-744	ātmatattvamiti paṅktikramastatra dṛśyate |) sarvāñjanavinirmuktaṃ śivaśaktikalotthitam |	ātma tattvam iti paṅkti kramaḥ tatra dṛśyate sarva añjana vinirmuktam śiva śakti kalā utthitam 
SA_MB_moksakarikaHK-745	ātmatattvamidaṃ śuddhaṃ sādhakānāṃ prakīrtitam | tatastho līnasvatattvena tāṃ kalāṃ	ātma tattvam idam śuddham sādhakānām prakīrtitam tatasthaḥ līna sva tattvena tām kalām 
SA_MB_moksakarikaHK-746	cintayed budhaḥ (rau0 sū0 4 | 42-43) iti || 109 ||	cintayet budhaḥ rau sū        
SA_MB_moksakarikaHK-747	tadevam 	tat evam 
SA_MB_moksakarikaHK-748	na dhyeyo nāpi ca jñeyastasmādīśo'ṇubandhanaiḥ || 110 ||	na dhyeyaḥ nā api ca jñeyaḥ tasmāt īśa uṇu bandhanaiḥ 
SA_MB_moksakarikaHK-749	tasmād buddhyādibhirna jñātuṃ nāpi tadaikaniṣṭhatayā dhyātuṃ śivo dīkṣitaiḥ	tasmāt buddhi ādibhiḥ na jñātum nā api tad aika niṣṭha tayā dhyātum śivaḥ dīkṣitaiḥ 
SA_MB_moksakarikaHK-750	śakyate || 110 ||	śakyate    
SA_MB_moksakarikaHK-751	kathaṃ tarhi śivo jñāyata ityucyate 	katham tarhi śivaḥ jñāyate iti ucyate 
SA_MB_moksakarikaHK-752	śivārkaśaktidīdhityā samarthīkṛtaciddṛśā |	                
SA_MB_moksakarikaHK-753	śivaṃ śaktyādibhiḥ sārdhaṃ paśyatyātmā gatāvṛtiḥ || 111 ||	śivam śakti ādibhiḥ sārdham paśyati ātmā gata āvṛtiḥ 
SA_MB_moksakarikaHK-754	yathā'rkopakṛtena cakṣuṣā loko'rkaṃ paśyati, evaṃ	yathā arka upakṛtena cakṣuṣā loka ūrkam paśyati evam 
SA_MB_moksakarikaHK-755	parameśvarānugrahānnivṛttāvaraṇayopacitasāmarthyayā ca jñānaśaktyaiva	parameśvara anugrahāt nivṛtta āvaraṇayā upacita sāmarthyayā ca jñānaśaktyā eva 
SA_MB_moksakarikaHK-756	tadanugṛhītairbhaktaistattvajñānaniṣṭhaiḥ parameśvaro dṛśyate | kiṃ ghaṭādivat karmatayā ?	tad anugṛhītaiḥ bhaktaiḥ tattva jñāna niṣṭhaiḥ parameśvaraḥ dṛśyate kim ghaṭa ādi vat karmatayā 
SA_MB_moksakarikaHK-757	na, draṣṭṛdraṣṭavyayordvayorapi vyāpakatvena tathā darśanāsaṃbhavāt || 111 ||	na draṣṭṛ draṣṭavyayoḥ dvayoḥ api vyāpaka tvena tathā darśana asaṃbhavāt 
SA_MB_moksakarikaHK-758	ittham 	ittham 
SA_MB_moksakarikaHK-759	pāśānāpye śive śabdād yogasādhanaceṣṭitāt |	pāśa anāpye śive śabdāt yoga sādhana ceṣṭitāt 
SA_MB_moksakarikaHK-760	sakalāṇoḥ śivajñānaṃ dṛśyate tatkathaṃ bhavet || 112 ||	sakala aṇoḥ śiva jñānam dṛśyate tat katham bhavet 
SA_MB_moksakarikaHK-761	pāśāgamyatve bhavataḥ kathaṃ śāstrāt pratipattirdīkṣitātmanāṃ	pāśa a gamya tve bhavataḥ katham śāstrāt pratipattiḥ dīkṣita ātmanām 
SA_MB_moksakarikaHK-762	śabdasyākāśavāyuhetutvena pāśatvāt kathaṃ tatastatpratipattiḥ || 112 ||	śabdasya ākāśa vāyu hetu tvena pāśa tvāt katham tatas tad pratipattiḥ 
SA_MB_moksakarikaHK-763	atrocyate 	atra ucyate 
SA_MB_moksakarikaHK-764	mantratantrātmake śabde śivo vyaktaḥ kalāsu ca |	mantra tantra ātmake śabde śivaḥ vyaktaḥ kalāsu ca 
SA_MB_moksakarikaHK-765	samarthayati ciccakṣurnātaḥ kiñcid virudhyate || 113 ||	samarthayati cit cakṣuḥ na atas kiñcid virudhyate  /
SA_MB_moksakarikaHK-766	sarvatra sarvadā'dhiṣṭhānād bhagavān sarvaiḥ sahita eveti yathā kvacilliṅge	sarvatra sarvadā adhiṣṭhānāt bhagavān sarvaiḥ sahitaḥ eva iti yathā kvacid liṅge 
SA_MB_moksakarikaHK-767	maṇḍale ācāryādau cānugrāhakatvena viśeṣasannidhānādabhivyakta ucyate | ata eva	maṇḍale ācārya ādau ca anugrāhaka tvena viśeṣa sannidhānāt abhivyaktaḥ ucyate atas eva 
SA_MB_moksakarikaHK-768	pūjānamaskārādayastatra kriyamāṇāḥ kartṝṇāṃ phalahetavo bhavanti nānyatra | tadvat	pūjā namaskāra ādayaḥ tatra kriyamāṇāḥ kartṝṇām phala hetavaḥ bhavanti na anyatra tadvat 
SA_MB_moksakarikaHK-769	sthūle'pi pāśarūpe mantratantraśabde tatkalāsu nādabindvādyāsu	sthūle pi pāśa rūpe mantra tantra śabde tad kalāsu nādabindu ādyāsu 
SA_MB_moksakarikaHK-770	bhagavānabhivyaktaścaitanyaṃ samarthayan svātmānaṃ puṃsāṃ darśayatītyapūrvamidaṃ	bhagavān abhivyaktaḥ caitanyam samarthayan sva ātmānam puṃsām darśayati iti apūrvam idam 
SA_MB_moksakarikaHK-771	mantrāṇāmabhidhāyakatvaṃ ghaṭādyabhidhāyakebhya ityuktamasmābhirmantravārttikaṭīkāyām	mantrāṇām abhidhāyaka tvam ghaṭa ādi abhidhāyakebhyaḥ iti uktam asmābhiḥ mantravārttikaṭīkāyām 
SA_MB_moksakarikaHK-772	tathāhi 	tathā hi 
SA_MB_moksakarikaHK-773	vyaktaḥ śivo'ṇubandheṣu bandhakāryavilakṣaṇāt |	vyaktaḥ śiva uṇubandheṣu bandha kārya vilakṣaṇāt 
SA_MB_moksakarikaHK-774	gamyate kāryataḥ khyātād vyakto dehe graho yathā || 114 ||	gamyate kāryataḥ khyātāt vyaktaḥ dehe grahaḥ yathā 
SA_MB_moksakarikaHK-775	yathāhi manuṣyāṇāṃ keṣāñciccharīraṃ devatā'dhiṣṭhitamavisaṃvādi	yathā hi manuṣyāṇām keṣāṃcid śarīram devatā dhiṣṭhitam avisaṃvādi 
SA_MB_moksakarikaHK-776	trikālavastūpadeśājjñāyate, tathaiva mantraśabdoccāraṇāt tallipyakṣaravinyāsācca	tri kāla vastu upadeśāt jñāyate tathā eva mantra śabda uccāraṇāt tad lipi akṣara vinyāsāt ca 
SA_MB_moksakarikaHK-777	śabdamātrāsaṃbhavino vaśyādervilakṣaṇasya kāryasya darśanāt tatrabhavānabhivyaktaḥ	śabda mātra asaṃbhavinaḥ vaśyā ādeḥ vilakṣaṇasya kāryasya darśanāt tatrabhavān abhivyaktaḥ 
SA_MB_moksakarikaHK-778	pratimādāviva gamyate || 114 ||	pratimā ādau iva gamyate  /
SA_MB_moksakarikaHK-779	atra-	atra 
SA_MB_moksakarikaHK-780	aṇubandheṣu sarveṣu svaparātmaprakāśakaḥ |	aṇu bandheṣu sarveṣu sva para ātma prakāśakaḥ 
SA_MB_moksakarikaHK-781	bhavaḥ prakāśaśūnyeṣu vyajyate kathamucyate || 115 ||	bhavaḥ prakāśa śūnyeṣu vyajyate katham ucyate 
SA_MB_moksakarikaHK-782	na jaḍe cidrūpasyābhivyaktirupapadyata ityarthaḥ || 115 ||	na jaḍe cit rūpasya abhivyaktiḥ upapadyate iti arthaḥ 
SA_MB_moksakarikaHK-783	naiṣa doṣaḥ 	na eṣa doṣaḥ 
SA_MB_moksakarikaHK-784	dīpastailādike dāhye dāhako vyajyate yathā |	dīpaḥ taila ādike dāhye dāhakaḥ vyajyate yathā 
SA_MB_moksakarikaHK-785	svaparātmaprakāśo'yaṃ niṣprakāśeṣu cidvatām || 116 ||	sva para ātma prakāśaḥ yam niṣprakāśeṣu cidvatām 
SA_MB_moksakarikaHK-786	dīpasyopalakṣaṇatvād yathā jaḍe'pi manuṣyādiśarīre svaparātmaprakāśako	dīpasya upalakṣaṇa tvāt yathā jaḍe api manuṣya ādi śarīre sva para ātma prakāśakaḥ 
SA_MB_moksakarikaHK-787	vyāpakaścātmā cidvatāmapyeṣāṃ manuṣyādīnāmupakārāya karmānurūpamabhivyajyate,	vyāpakaḥ ca ātmā cidvatām api eṣām manuṣya ādīnām upakārāya karma anurūpam abhivyajyate 
SA_MB_moksakarikaHK-788	tathaiva parameśvaraḥ pratimādiṣu citrādiṣu mantraśabdeṣu ca paśūpakārāya	tathā eva parameśvaraḥ pratimā ādiṣu citra ādiṣu mantra śabdeṣu ca paśu upakārāya 
SA_MB_moksakarikaHK-789	viśeṣasannidhāno'bhivyajyata ityadoṣaḥ || 116 ||	viśeṣa sannidhānaḥ abhivyajyate iti adoṣaḥ 
SA_MB_moksakarikaHK-790	dīkṣitānāmitthaṃ jñānādasya pāśasya nāśaḥ, kadā śivatulyatvamityucyate 	dīkṣitānām ittham jñānāt asya pāśasya nāśaḥ kadā śiva tulya tvam iti ucyate 
SA_MB_moksakarikaHK-791	prāpnutaḥ śivatulyatvaṃ tanvante gurudīkṣitau |	prāpnutaḥ śiva tulya tvam tanvante guru dīkṣitau 
SA_MB_moksakarikaHK-792	anārabdhakāryāṇāmeva karmaṇāṃ dīkṣayā kṣayaḥ, nārabdhakāryāṇām |	an ārabdha kāryāṇām eva karmaṇām dīkṣayā kṣayaḥ na ārabdha kāryāṇām 
SA_MB_moksakarikaHK-793	yacchrūyate  dīkṣitāḥ paramaṃ śāntaṃ praviśanti tanukṣaye iti | teṣāṃ tu	yat śrūyate dīkṣitāḥ paramam śāntam praviśanti tanu kṣaye iti teṣām tu 
SA_MB_moksakarikaHK-794	sadyonirvāṇadīkṣayaiva kṣayaḥ, na bhogāt ||	sadyas nirvāṇa dīkṣayā eva kṣayaḥ na bhogāt 
SA_MB_moksakarikaHK-795	tathaiva 	tathā eva 
SA_MB_moksakarikaHK-796	bogānte sādhakaḥ siddhiṃ tathaiva prāpnuyād dhruvam || 117 ||	sādhakaḥ siddhim tathā eva prāpnuyāt dhruvam 
SA_MB_moksakarikaHK-797	yacchrūyate  bhuktvā bhogān suciramamarastrīnikāyairupetāḥ srastotkaṇṭhāḥ	yat śrūyate bhuktvā bhogān su ciram amara strī nikāyaiḥ upetāḥ srasta utkaṇṭhāḥ 
SA_MB_moksakarikaHK-798	śivapadaparaiśvaryabhājo bhavanti iti || 117 ||	            
SA_MB_moksakarikaHK-799	uktaḥ sasādhano mokṣa iti | adhunā tvetannirṇaye paramuktinirāsaḥ | tatra	uktaḥ sa sādhanaḥ mokṣaḥ iti adhunā tu etad nirṇaye para mukti nirāsaḥ tatra 
SA_MB_moksakarikaHK-800	mahāvrataḥ 	mahāvrataḥ 
SA_MB_moksakarikaHK-801	siddhānāṃ śivatulyatve kāraṇānekatā bhavet |	siddhānām śiva tulya tve kāraṇa anekatā bhavet 
SA_MB_moksakarikaHK-802	teṣāmatulyabuddhitvāt kāryaṃ notpattumarhati || 118 ||	teṣām atulya buddhi tvāt kāryam na utpattum arhati  /
SA_MB_moksakarikaHK-803	muktānāmapīśvaravat sarvakartṛtve navamidamastu purāṇamastviti vibhinnamatitvāt	muktānām api īśvara vat sarva kartṛ tve navam idam astu purāṇam astu iti vibhinna mati tvāt 
SA_MB_moksakarikaHK-804	sarvakāryānutpādaprasaṅga iti muktānāṃ sarvajñataiva, sarvakartṛtā ca	sarva kārya anutpāda prasaṅgaḥ iti muktānām sarvajña tā eva sarva kartṛ tā ca 
SA_MB_moksakarikaHK-805	parameśvarasyaivetyabhyupagantavyamiti || 118 ||	parameśvarasya eva iti abhyupagantavyam iti 
SA_MB_moksakarikaHK-806	naiṣa doṣaḥ 	na eṣa doṣaḥ 
SA_MB_moksakarikaHK-807	rāgadveṣādiyuktatvādatulyajñānatā nṛṇām |	rāga dveṣa ādi yukta tvāt atulya jñāna tā nṛṇām 
SA_MB_moksakarikaHK-808	teṣāmatulyabuddhitvāt kāmabhedo na durlabhaḥ || 119 ||	teṣām atulya buddhi tvāt kāma bhedaḥ na durlabhaḥ 
SA_MB_moksakarikaHK-809	yukta eva paśūnāṃ rāgādiyogena pakṣagrahādabhiprāyabhedaḥ, siddhāstu 	yuktaḥ eva paśūnām rāga ādi yogena pakṣa grahāt abhiprāya bhedaḥ siddhāḥ tu 
SA_MB_moksakarikaHK-810	rāgādidoṣanirmuktāḥ sarvagocarabuddhayaḥ |	rāga ādi doṣa nirmuktāḥ sarva gocara buddhayaḥ 
SA_MB_moksakarikaHK-811	siddhāste'to na kāmaistu bhedavadbhiḥ samanvitāḥ || 120 ||	siddhāḥ te itas na kāmaiḥ tu bhedavadbhiḥ samanvitāḥ 
SA_MB_moksakarikaHK-812	avibhinnādhikārāste śivenoktāstu sūribhiḥ |	a vibhinna adhikārāḥ te śivena uktāḥ tu sūribhiḥ 
SA_MB_moksakarikaHK-813	teneha sarvakāryāṇāmutpattirna virudhyate || 121 ||	tena iha sarva kāryāṇām utpattiḥ na virudhyate  /
SA_MB_moksakarikaHK-814	yataste siddhatvādeva rāgādirahitā yathāvat sarvaviṣayajñātāraḥ śivena	yatas te siddha tvāt eva rāga ādi rahitāḥ yathāvat sarva viṣaya jñātāraḥ śivena 
SA_MB_moksakarikaHK-815	sahā'vibhinnādhikārāḥ sarvakartṛtvācca, tatasteṣāṃ	saha a vibhinna adhikārāḥ sarva kartṛ tvāt ca tatas teṣām 
SA_MB_moksakarikaHK-816	pakṣagrahāsaṃbhavānnābhiprāyabheda iti na kāryānutpādadoṣaprasaṅgo'tra || 121 ||	pakṣa graha asaṃbhavāt na abhiprāya bhedaḥ iti na kārya anutpāda doṣa prasaṅgā utra 
SA_MB_moksakarikaHK-817	mahāvratapakṣe tvamuktireva, yataḥ 	mahāvrata pakṣe tu a muktiḥ eva yatas 
SA_MB_moksakarikaHK-818	asarvakartṛbhāvena sarvajño mukta ityasat |	a sarva kartṛ bhāvena sarvajñaḥ muktaḥ iti asat 
SA_MB_moksakarikaHK-819	nyūnatvānna ca sārvajñamakartṛtvāt paśuryathā || 122 ||	nyūna tvāt na ca sārvajñam akartṛ tvāt paśuḥ yathā 
SA_MB_moksakarikaHK-820	parā paripūrṇatā hi muktiḥ | asarvajñabhāvaśca prāptaḥ | sarvakartṛtvābhāvāt	parā paripūrṇa tā hi muktiḥ asarvajña bhāvaḥ ca prāptaḥ sarva kartṛ tva abhāvāt 
SA_MB_moksakarikaHK-821	paśuvad bhavenmukta iti || 122 ||	paśu vat bhavet muktaḥ iti 
SA_MB_moksakarikaHK-822	cidvyaktyā sarvakartṛtvaṃ siddhānāmīśvaro yathā |	cit vyaktyā sarva kartṛ tvam siddhānām īśvaraḥ yathā 
SA_MB_moksakarikaHK-823	anyathā kartṛtā na syādīśvarasyā'pi siddhavat || 123 ||	anyathā kartṛtā na syāt īśvarasya api siddha vat 
SA_MB_moksakarikaHK-824	cidvyaktyā sarvakartṛtvamastyeva | tathā siddhānāṃ sarvakartṛtvaṃ yathā siddhyati,	cit vyaktyā sarva kartṛ tvam asti eva tathā siddhānām sarva kartṛ tvam yathā siddhi ati 
SA_MB_moksakarikaHK-825	īśvaro'pi sarvajñatvādasya sarvakartṛtā'nyathā na syāditi viśvānutpādaprasaṅgaḥ || 123 ||	īśvaraḥ api sarvajña tvāt asya sarva kartṛ tā anyathā na syāt iti viśva anutpāda prasaṅgaḥ 
SA_MB_moksakarikaHK-826	api ca 	api ca 
SA_MB_moksakarikaHK-827	na kartṛśakteścidvyaktirekanāśe sayuktikā |	na kartṛ śakteḥ cit vyaktiḥ eka nāśe sa yuktikā 
SA_MB_moksakarikaHK-828	sā śaktirekaiva jñānakriyetyuktaṃ prāk | na ca tasyāścidaṃśena vyaktiḥ	sā śaktiḥ ekā eva jñāna kriyā iti uktam prāk na ca tasyāḥ cit aṃśena vyaktiḥ 
SA_MB_moksakarikaHK-829	kriyāṃśenāvyaktiryujyate, niraṃśatvāt | na ca vidyeśvaraśaktivyaktibhirvyabhicāraḥ, sarvadā	kriyā aṃśena avyaktiḥ yujyate niraṃśa tvāt na ca vidyeśvara śakti vyaktibhiḥ vyabhicāraḥ sarvadā 
SA_MB_moksakarikaHK-830	tāsāṃ vyaktyabhāvāt ||	tāsām vyakti abhāvāt 
SA_MB_moksakarikaHK-831	atha sāṃkhyavat puruṣāṇāṃ kartṛtvaṃ prāgapi nāstītyucyate, tadapyayuktam 	atha sāṃkhya vat puruṣāṇām kartṛ tvam prāk api na asti iti ucyate tat api ayuktam 
SA_MB_moksakarikaHK-832	kartṛtvasya na cābhāvaḥ sādhitatvāt tatastvasau || 124 ||	kartṛ tvasya na ca abhāvaḥ sādhita tvāt tatas tu asau 
SA_MB_moksakarikaHK-833	sarvajñānakriyāhīno niṣkalaḥ kevalī paśuḥ |	           
SA_MB_moksakarikaHK-834	kartṛtvaṃ prāg bhogaprakaraṇe sādhitamiti	kartṛ tvam prāk bhoga prakaraṇe sādhitam iti 
SA_MB_moksakarikaHK-835	tadanabhivyaktāvekatvācchakterjñatvasyāpyanabhivyaktiriti sarvajñānakriyāvaikalyena paśureva	tad anabhivyaktau ekatvāt śakteḥ jña tvasya api anabhivyaktiḥ iti sarva jñāna kriyā vaikalyena paśuḥ eva 
SA_MB_moksakarikaHK-836	bhavenmukta iti || 124 ||	bhavet muktaḥ iti 
SA_MB_moksakarikaHK-837	atra punaḥ paraḥ 	atra punar paraḥ 
SA_MB_moksakarikaHK-838	vyajyate kartṛtā siddhe sarvatra jñānavanna ca || 125 ||	vyajyate kartṛ tā siddhe sarvatra jñāna vat na ca 
SA_MB_moksakarikaHK-839	astīśaḥ sarvakarteti saṃcintya karaṇīyakṛt |	asti īśaḥ sarva kartā iti saṃcintya karaṇīya kṛt 
SA_MB_moksakarikaHK-840	siddhe yatkartṛtvaṃ tanna jñānavat sarvatra sarvakartā'stīti kimadhikaṃ mayā	siddhe yat kartṛ tvam tat na jñāna vat sarvatra sarva kartā asti iti kim adhikam mayā 
SA_MB_moksakarikaHK-841	kartavyamiti saṃcintya siddho na karaṇīyaṃ karotīti || 125 ||	kartavyam iti saṃcintya siddhaḥ na karaṇīyam karoti iti 
SA_MB_moksakarikaHK-842	yadyevam 	yadi evam 
SA_MB_moksakarikaHK-843	siddhe vyaktā paśau neti viśeṣaḥ kastayoryadi || 126 ||	siddhe vyaktā paśau nā iti viśeṣaḥ kaḥ tayoḥ yadi 
SA_MB_moksakarikaHK-844	sarvakāryāṇi no kuryāt siddhasthā sarvakartṛtā |	sarva kāryāṇi no kuryāt siddha sthā sarva kartṛ tā 
SA_MB_moksakarikaHK-845	yadi vyaktamapi siddhasya kartṛtvaṃ na kāryakaram, tarhyavyaktāt paśukartṛtvāt tasya	yadi vyaktam api siddhasya kartṛ tvam na kārya karam tarhi avyaktāt paśu kartṛ tvāt tasya 
SA_MB_moksakarikaHK-846	ko viśeṣaḥ || 126 ||	kaḥ viśeṣaḥ 
SA_MB_moksakarikaHK-847	tathāhi 	tathā hi 
SA_MB_moksakarikaHK-848	pravṛttiḥ sarvaniṣpattau vyaktirnānyā tu tadgatā || 127 ||	pravṛttiḥ sarva niṣpattau vyaktiḥ na anyā tu tadgatā 
SA_MB_moksakarikaHK-849	jñānaṃ sarvaprakāśāya pravṛttaṃ vyaktamucyate |	jñānam sarva prakāśāya pravṛttam vyaktam ucyate 
SA_MB_moksakarikaHK-850	iyameva tvasya kartṛtvasya paśuvilakṣaṇā vyaktiḥ, yā jñānavat tasya sarvapravṛttiḥ ||	iyam eva tu asya kartṛ tvasya paśu vilakṣaṇā vyaktiḥ yā jñāna vat tasya sarva pravṛttiḥ 
SA_MB_moksakarikaHK-851	tadevam 	tat evam 
SA_MB_moksakarikaHK-852	sarvakṛtyapravṛttau vā nāsāvastīti varṇyatām || 128 ||	sarva kṛtya pravṛttau vā na asau asti iti varṇyatām 
SA_MB_moksakarikaHK-853	gṛhyatāṃ dṛṅnirodho vā doṣo vā pūrvamokṣagaḥ |	gṛhyatām dṛś nirodhaḥ vā doṣaḥ vā pūrva mokṣa gaḥ 
SA_MB_moksakarikaHK-854	vyaktā cet siddhasya kriyāśaktiḥ sarvakāryakṣamaivābhyupagan-tavyā | atha	vyaktā ced siddhasya kriyāśaktiḥ sarva kārya kṣamā eva abhyupagantavyā atha 
SA_MB_moksakarikaHK-855	vyaktā'pi kāryaṃ na karoti, yadyevaṃ pratibimbagarbhāṇu-śaktivannāstyeva sā tasyeti	vyaktā api kāryam na karoti yadi evam pratibimba garbha aṇu śakti vat na asti eva sā tasya iti 
SA_MB_moksakarikaHK-856	vācyam | athāvyaktā vidyata ityucyate, tarhyekatvājjñānakriyayoḥ śaktyordṛṅnirodho	vācyam atha avyaktā vidyate iti ucyate tarhi ekatvāt jñāna kriyayoḥ śaktyoḥ 
SA_MB_moksakarikaHK-857	jñānasyā'nabhi-vyaktirmokṣo vācyaḥ | athāvyaktayāpi tayā jñānaśaktirvyakteṣyate,	jñānasya anabhivyaktiḥ mokṣaḥ vācyaḥ atha avyaktayā api tayā jñānaśaktiḥ vyaktā iṣyate 
SA_MB_moksakarikaHK-858	yadyevamavidyamānapūrvo mokṣo yasya paramaśivasya tasmin	yadi evam avidyamāna pūrvaḥ mokṣaḥ yasya paramaśivasya tasmin 
SA_MB_moksakarikaHK-859	sarvajñatvānmuktavadakartṛtvadoṣaḥ prokto'bhyupagantavya iti pakṣāṇāṃ catuṣṭayādasmād	sarvajña tvāt mukta vat akartṛ tva doṣaḥ proktaḥ abhyupagantavyaḥ iti pakṣāṇām catuṣṭayāt asmāt 
SA_MB_moksakarikaHK-860	bhavadbhireko grāhyaḥ | na ca prathamapakṣasyātra kaścid doṣa iti śivasamatvaṃ	bhavadbhiḥ ekaḥ grāhyaḥ na ca prathama pakṣasya atra kaścid doṣaḥ iti śiva sama tvam 
SA_MB_moksakarikaHK-861	sarvajñatvasarvakartṛtvalakṣaṇataiva muktirabhyupagantavyā || 118 ||	sarvajñatva sarva kartṛ tva lakṣaṇa tā eva muktiḥ abhyupagantavyā 
SA_MB_moksakarikaHK-862	pāśupatāstu muktāvīśvaraguṇānāṃ saṃkrāntitaḥ siddhānāṃ	pāśupatāḥ tu muktau īśvara guṇānām saṃkrāntitaḥ siddhānām 
SA_MB_moksakarikaHK-863	śivasamatāmācakṣīran, tadayuktam 	śiva samatām ācakṣīran tat ayuktam 
SA_MB_moksakarikaHK-864	vimokṣe guṇasaṃkrāntāvīśo'nīśvaratāṃ vrajet || 129 ||	vimokṣe guṇa saṃkrāntau īśaḥ nīśvara tām vrajet 
SA_MB_moksakarikaHK-865	guṇakhaṇḍasya saṃkrāntau guṇaḥ sāvayavo bhavet |	guṇa khaṇḍasya saṃkrāntau guṇaḥ sa avayavaḥ bhavet 
SA_MB_moksakarikaHK-866	siddha eveśvaraguṇānāṃ saṃkrāntāviṣyamāṇāyāmīśvaraḥ	siddhaḥ eva īśvara guṇānām saṃkrāntau iṣyamāṇāyām īśvaraḥ 
SA_MB_moksakarikaHK-867	sarvajñatvādiguṇarahitaḥ syāt, guṇānāmanaṃśatvādekadeśena guṇasaṃkrāntyasaṃbhavāt	sarvajñatva ādi guṇa rahitaḥ syāt guṇānām anaṃśa tvāt eka deśena guṇa saṃkrānti asaṃbhavāt 
SA_MB_moksakarikaHK-868	kiñca 	kiñca 
SA_MB_moksakarikaHK-869	tyaktvā svaguṇinaṃ yānti na ca guṇyantaraṃ guṇāḥ || 130 ||	tyaktvā sva guṇinam yānti na ca guṇi antaram guṇāḥ 
SA_MB_moksakarikaHK-870	gacchatāṃ ca vyavastheyaṃ padārthānāṃ virudhyate |	gacchatām ca vyavastheyam padārthānām virudhyate 
SA_MB_moksakarikaHK-871	yadi ca svaguṇityāgena guṇyantare guṇānāṃ vṛttiriṣyeta, tadā sarvaḥ sarvaguṇī	yadi ca sva guṇi tyāgena guṇi antare guṇānām vṛttiḥ iṣyeta tadā sarvaḥ sarva guṇī 
SA_MB_moksakarikaHK-872	syāditi dṛṣṭaniyamānupapattermukto'muktaśca muktaḥ prasajyata iti	syāt iti dṛṣṭa niyama anupapatteḥ muktaḥ muktaḥ ca muktaḥ prasajyate iti 
SA_MB_moksakarikaHK-873	guṇasaṃkrāntyanupapatterna tayā śivasamatvamabhyupagantavyamiti || 130 ||	guṇa saṃkrānti anupapatteḥ na tayā śiva samatvam abhyupagantavyam iti 
SA_MB_moksakarikaHK-874	vedāntavidastu tallayāt tatsamatvaṃ muktiṃ pratipannāḥ, tadapyayuktam, yataḥ 	vedānta vidaḥ tu tad layāt tad samatvam muktim pratipannāḥ tat api ayuktam yatas 
SA_MB_moksakarikaHK-875	prāguktadoṣaduṣṭātmā paramātmā yathā tathā || 131 ||	prāc ukta doṣa duṣṭa ātmā paramātmā yathā tathā 
SA_MB_moksakarikaHK-876	siddhastallayasaṃprāptastadabhinno yatastvasau |	siddhaḥ tad laya saṃprāptaḥ tad abhinnaḥ yatas tu asau 
SA_MB_moksakarikaHK-877	upādānakāraṇatvāt paramātmano'cetanatvādidoṣaduṣṭatvaṃ yat prāk pratipāditaṃ	upādānakāraṇa tvāt paramātmanā ucetana tva ādi doṣa duṣṭa tvam yat prāk pratipāditam 
SA_MB_moksakarikaHK-878	tatsiddhasyā'pi tadabhedāt prasajyata ityadvaitameva mokṣo bhavatām || 131 ||	tad siddhasya api tad abhedāt prasajyate iti advaitam eva mokṣaḥ bhavatām 
SA_MB_moksakarikaHK-879	api ca 	api ca 
SA_MB_moksakarikaHK-880	ekatvadarśanaṃ mukteḥ sādhanaṃ svātmabādhitam || 132 ||	eka tva darśanam mukteḥ sādhanam sva ātma bādhitam 
SA_MB_moksakarikaHK-881	mocyamocanakartṛṇāṃ nābhede sā yato bhavet |	mocya mocana kartṛṇām na abhede sā yatas bhavet 
SA_MB_moksakarikaHK-882	ekamevādvitīyaṃ brahmaiva satyam, tatastajjñānameva mukteḥ	ekam eva advitīyam brahma eva satyam tatas tad jñānam eva mukteḥ 
SA_MB_moksakarikaHK-883	sādhanamitīdamucyamānaṃ mātā me vandhyetivat svoktyaiva bādhitam | yata ekatve sati na	sādhanam iti idam ucyamānam mātā me vandhyā iti vat sva uktyā eva bādhitam yatas ekatve sati na 
SA_MB_moksakarikaHK-884	sādhyasādhanabhāvaḥ, sādhyasādhanabhāve vā'nekatvamiti || 132 ||	sādhya sādhana bhāvaḥ sādhya sādhana bhāve vā aneka tvam iti 
SA_MB_moksakarikaHK-885	kiñca 	kiñca 
SA_MB_moksakarikaHK-886	bhede sati pramāṇānāṃ pravṛttirnānyathā matā || 133 ||	bhede sati pramāṇānām pravṛttiḥ na anyathā matā 
SA_MB_moksakarikaHK-887	kḷptaḥ kimiti vidvadbhirabhedo niṣpramāṇakaḥ |	kḷptaḥ kim iti vidvadbhiḥ abhedaḥ niṣpramāṇakaḥ 
SA_MB_moksakarikaHK-888	brahmaiva satyamiti yena pramāṇena siddhaṃ bhavatām, tad yadyasatyameva, kathaṃ	brahma eva satyam iti yena pramāṇena siddham bhavatām tat yadi asatyam eva katham 
SA_MB_moksakarikaHK-889	tasmāt svapnadṛṣṭādivat satyabrahmasiddhiḥ | atha satyam, tarhi	tasmāt svapna dṛṣṭa ādi vat satya brahma siddhiḥ atha satyam tarhi 
SA_MB_moksakarikaHK-890	pramāṇapramātṛprameyapramitisatyatvādadvaita-masatyamiti kathaṃ tatprāptirapi mokṣaḥ || 133	pramāṇa pramātṛ prameya pramiti satya tvāt advaitam asatyam iti katham tad prāptiḥ api mokṣaḥ 
SA_MB_moksakarikaHK-891	sāṃkhyāstu 	sāṃkhyāḥ tu 
SA_MB_moksakarikaHK-892	muktvā yogaphalaṃ ramyaṃ bhogān sāṃsārikānapi || 134 ||	muktvā yoga phalam ramyam bhogān sāṃsārikān api 
SA_MB_moksakarikaHK-893	ācaitanyaṃ kathaṃ cānye kaivalyaṃ mokṣamūcire |	ācaitanyam katham ca anye kaivalyam mokṣam ūcire 
SA_MB_moksakarikaHK-894	yogaḥ sādāśivo dehaḥ, tallakṣaṇaṃ phalaṃ sarvajñatādirūpaṃ mokṣaṃ parityajya	yogaḥ sādāśivaḥ dehaḥ tad lakṣaṇam phalam sarvajña tā ādi rūpam mokṣam parityajya 
SA_MB_moksakarikaHK-895	saṃsārabhogāṃśca nānāvidhaviṣayasaṃvedana-phalānaṇimādisādhyāṃstyaktvā	saṃsāra bhogān ca nānāvidha viṣaya saṃvedana phalān aṇima ādi sādhyān tyaktvā 
SA_MB_moksakarikaHK-896	kaivalyalobhena prakṛtiviyogādātma-nāśasamaṃ jñatvameva sveṣāṃ mokṣaṃ kalpitavantaḥ |	kaivalya lobhena prakṛti viyogāt ātma nāśa samam jña tvam eva sveṣām mokṣam kalpitavantaḥ 
SA_MB_moksakarikaHK-897	na ca tasmin apuruṣārthabhūte kasyacit pravṛttirupapadyate || 134 ||	na ca tasmin a puruṣa artha bhūte kasyacid pravṛttiḥ upapadyate 
SA_MB_moksakarikaHK-898	tathā hi 	tathā hi 
SA_MB_moksakarikaHK-899	svacaitanyavināśāya santaḥ santaḥ kathaṃ ca te || 135 ||	sva caitanya vināśāya santaḥ santaḥ katham ca te 
SA_MB_moksakarikaHK-900	vivekadarśanābhyāsaprayāsaṃ kurvate'nvaham |	viveka darśana abhyāsa prayāsam kurvate nu aham 
SA_MB_moksakarikaHK-901	ke hi paṇḍitāḥ svātmano jñānanāśāya pratyahaṃ	ke hi paṇḍitāḥ sva ātmanaḥ jñāna nāśāya pratyaham 
SA_MB_moksakarikaHK-902	jñānayogābhyāsādiprayāsaṃ kuryuḥ || 135 ||	jñāna yoga abhyāsa ādi prayāsam kuryuḥ 
SA_MB_moksakarikaHK-903	kiñca 	kiñca 
SA_MB_moksakarikaHK-904	viveko nāma vaidharmyād guṇānāṃ puruṣasya ca || 136 ||	vivekaḥ nāma vaidharmyāt guṇānām puruṣasya ca 
SA_MB_moksakarikaHK-905	tatra yaddarśanaṃ tattu vicāre nopapadyate |	tatra yat darśanam tat tu vicāre nā upapadyate 
SA_MB_moksakarikaHK-906	na ca guṇapuruṣaviṣayaṃ jñānaṃ vicāre kriyamāṇe sāṃkhyānāmupapadyate ||	na ca guṇa puruṣa viṣayam jñānam vicāre kriyamāṇe sāṃkhyānām upapadyate 
SA_MB_moksakarikaHK-907	tathāhi guṇā vā puruṣavivekaṃ darśayanti svayameva vā puruṣaḥ paśyati ? tatra 	tathā hi guṇāḥ vā puruṣa vivekam darśayanti svayam eva vā puruṣaḥ paśyati tatra 
SA_MB_moksakarikaHK-908	kartṛprasavasaṃkīrṇadharmakā hi guṇā vayam || 137 ||	kartṛ prasava saṃkīrṇa dharmakāḥ hi guṇāḥ vayam 
SA_MB_moksakarikaHK-909	tvaṃ neti puruṣasyārthaṃ buddhisthā darśayanti te |	tvam na iti puruṣasya artham buddhi sthāḥ darśayanti te 
SA_MB_moksakarikaHK-910	cicchaktirapariṇāminī apratisaṃkramā darśitaviṣayā śuddhā cānantā ceti	cit śaktiḥ apariṇāminī apratisaṃkramā darśita viṣayā śuddhā ca anantā ca iti 
SA_MB_moksakarikaHK-911	buddhidarśitaviṣayatvenaiva puruṣasyābhyupagamād buddhyupārūḍhaireva guṇairvayaṃ	buddhi darśita viṣaya tvena eva puruṣasya abhyupagamāt buddhi upārūḍhaiḥ eva guṇaiḥ vayam 
SA_MB_moksakarikaHK-912	kartṛtvādidharmayuktāḥ parasparaṃ saṃkīrṇāḥ, tvaṃ tu neti tasya viveko darśanīyaḥ || 137	kartṛ tva ādi dharma yuktāḥ parasparam saṃkīrṇāḥ tvam tu na iti tasya vivekaḥ darśanīyaḥ 
SA_MB_moksakarikaHK-913	kimataḥ ? ataśca 	kim atas atas ca 
SA_MB_moksakarikaHK-914	tathā darśitadarśitve mithyādarśī pumān bhavet || 138 ||	tathā darśita darśi tve mithyā darśī pumān bhavet  /
SA_MB_moksakarikaHK-915	mithyādarśanasādhyatvaṃ mokṣasyeti sudurghaṭam |	mithyā darśana sādhya tvam mokṣasya iti su durghaṭam 
SA_MB_moksakarikaHK-916	evaṃ buddhyupārūḍhaguṇadarśitve puruṣasya buddheḥ	evam buddhi upārūḍha guṇa darśi tve puruṣasya buddheḥ 
SA_MB_moksakarikaHK-917	parimitatvenāparimitaguṇaviṣayatvāsaṃbhavāt | yaduktam  kapilabrahmaṇo'pyapratyakṣā guṇā	parimita tvena aparimita guṇa viṣaya tva asaṃbhavāt yat uktam kapilabrahmaṇā upi apratyakṣāḥ guṇāḥ 
SA_MB_moksakarikaHK-918	ityekadeśena tairbuddhāvupārohaṇīyam | ekadeśena tattvapratipatīrapratipattiḥ nīlagiririti	iti eka deśena taiḥ buddhau upārohaṇīyam eka deśena tattva pratipatīḥ apratipattiḥ nīlagiriḥ iti 
SA_MB_moksakarikaHK-919	nīlopādhau himavati tatpratipattirmithyaiva | na ca mithyājñānānmokṣaḥ, ayuktatvāt || 138 ||	nīla upādhau himavati tad pratipattiḥ mithyā eva na ca mithyājñānāt mokṣaḥ ayukta tvāt 
SA_MB_moksakarikaHK-920	kartṛtvādi guṇā hyete guṇā nāhamitīdṛśī || 139 ||	kartṛ tva ādi guṇāḥ hi ete guṇāḥ na aham iti īdṛśī 
SA_MB_moksakarikaHK-921	darśane puruṣasyeṣṭe hatā darśitadarśitā |	darśane puruṣasya iṣṭe hatā darśita darśitā 
SA_MB_moksakarikaHK-922	buddhipradarśita evārthaḥ puruṣeṇa dṛśyata it bhavadbhiryaduktaṃ tatsākṣāt	buddhi pradarśitaḥ eva arthaḥ puruṣeṇa dṛśyate bhavadbhiḥ yat uktam tat sākṣāt 
SA_MB_moksakarikaHK-923	svātmaviviktaguṇadraṣṭṛtve puruṣasya kalpyamāne vyāhatam || 139 ||	sva ātma vivikta guṇa draṣṭṛ tve puruṣasya kalpyamāne vyāhatam  /
SA_MB_moksakarikaHK-924	athocyate  na sākṣātpuruṣo guṇān paśyati, nāpi te buddhyupāroheṇa tasya	atha ucyate na sākṣāt puruṣaḥ guṇān paśyati na api te buddhi upāroheṇa tasya 
SA_MB_moksakarikaHK-925	svātmānaṃ darśayanti, proktavirodhāt | api tu guṇapuruṣayoranyatvamātraṃ darśayanti |	sva ātmānam darśayanti prokta virodhāt api tu guṇa puruṣayoḥ anya tva mātram darśayanti 
SA_MB_moksakarikaHK-926	tadapi na, yataḥ 	tat api na yatas 
SA_MB_moksakarikaHK-927	anye guṇāḥ pumānanya iti no darśayanti te || 140 ||	anye guṇāḥ pumān anyaḥ iti naḥ darśayanti te 
SA_MB_moksakarikaHK-928	guṇebhyo na guṇā yena bhinnāḥ santi dhiyāṃnidheḥ |	guṇebhyaḥ na guṇāḥ yena bhinnāḥ santi dhiyāṃnidheḥ 
SA_MB_moksakarikaHK-929	na cā'pi viṣayasteṣāmaṇurityuditaṃ purā || 141 ||	na ca api viṣayaḥ teṣām aṇuḥ iti uditam purā 
SA_MB_moksakarikaHK-930	yadi hi na svātmānaṃ darśayanti, tarhi guṇāntarāṇāmanyatvaṃ darśayantīti	yadi hi na sva ātmānam darśayanti tarhi guṇa antarāṇām anya tvam darśayanti iti 
SA_MB_moksakarikaHK-931	prāptam | na ca dhiyāṃnidherbuddhinidhānād guṇalakṣaṇādanye guṇāḥ saṃbhavanti | na	prāptam na ca dhiyāṃnidheḥ buddhi nidhānāt guṇa lakṣaṇāt anye guṇāḥ saṃbhavanti na 
SA_MB_moksakarikaHK-932	cāpyātmā teṣāṃ viṣaya ityuktaṃ prāk  pariṇāmī pumān bhogyaḥ prāptastadgocaro yadi	ca api ātmā teṣām viṣayaḥ iti uktam prāk pariṇāmī pumān bhogyaḥ prāptaḥ tad gocaraḥ yadi 
SA_MB_moksakarikaHK-933	(ślo0 105), iti kathamaviṣaye tadanyatvaṃ darśayeyuḥ || 140-141 ||	iti katham aviṣaye tad anya tvam darśayeyuḥ  /
SA_MB_moksakarikaHK-934	vivekaviṣayaṃ tasmād darśanaṃ nopapadyate |	viveka viṣayam tasmāt darśanam na upapadyate 
SA_MB_moksakarikaHK-935	itthaṃ vivekadarśanānupapatteḥ kutaḥ kaivalyāvāptirmokṣa iti sarvajñatādirūpastava	ittham viveka darśana anupapatteḥ kutas kaivalya avāptiḥ mokṣaḥ iti sarvajña tā ādi rūpaḥ tava 
SA_MB_moksakarikaHK-936	mokṣo'bhyupagantavyaḥ ||	mokṣaḥ abhyupagantavyaḥ 
SA_MB_moksakarikaHK-937	śāktādidṛṣṭīnāṃ kā vārtetyucyate 	śākta ādi dṛṣṭīnām kā vārttā iti ucyate 
SA_MB_moksakarikaHK-938	yathoktapaśupāśeṣu sādhyasādhanavarjanāt || 142 ||	yathā ukta paśu pāśeṣu sādhya sādhana varjanāt 
SA_MB_moksakarikaHK-939	pāśātmikāstato heyā dṛṣṭayo vādināṃ budhaiḥ |	pāśa ātmikāḥ tatas heyāḥ dṛṣṭayaḥ vādinām budhaiḥ 
SA_MB_moksakarikaHK-940	yato yathokte paśuviṣaye pāśaviṣaye ca pramāṇataḥ siddhe yat sādhyaṃ	yatas yathā ukte paśu viṣaye pāśa viṣaye ca pramāṇataḥ siddhe yat sādhyam 
SA_MB_moksakarikaHK-941	muktistadvicchedadarśanaṃ ca sādhanam, tanna sādhayantyaviṣayatvāt |	muktiḥ tad viccheda darśanam ca sādhanam tat na sādhayanti aviṣaya tvāt 
SA_MB_moksakarikaHK-942	ato'nyavādidṛṣṭayo'śreyaḥphalāḥ śreyo'rthibhiḥ parihāryāḥ || 142 ||	atonyavādi dṛṣṭayoḥ śreyaḥ phalāḥ śreyaḥ ṛthibhiḥ parihāryāḥ 
SA_MB_moksakarikaHK-943	ata eva ca 	atas eva ca 
SA_MB_moksakarikaHK-944	paśupāśādivaiśiṣṭyaprakāśakamabādhitam || 143 ||	paśu pāśa ādi vaiśiṣṭya prakāśakam abādhitam 
SA_MB_moksakarikaHK-945	śaivaṃ tadadhikārthatvād viduṣaḥ kasya na priyam |	śaivam tad adhika artha tvāt viduṣaḥ kasya na priyam 
SA_MB_moksakarikaHK-946	nahi darśanāntaraiḥ paśupāśādyadṛṣṭameva, kintu yathābhūtaṃ tathā viśiṣṭaṃ	nahi darśana antaraiḥ paśu pāśa ādi adṛṣṭam eva kintu yathābhūtam tathā viśiṣṭam 
SA_MB_moksakarikaHK-947	dṛṣṭamiti tadvaiśiṣṭyaprakāśakam | ata evāgṛhītagrāhi proktavat pratyakṣānumānābhyāṃ	dṛṣṭam iti tad vaiśiṣṭya prakāśakam atas eva agṛhīta grāhi prokta vat pratyakṣa anumānābhyām 
SA_MB_moksakarikaHK-948	susaṃvādaṃ śaivāgamākhyaṃ pramāṇaṃ pratyakṣādivat kasya nābhimatam || 143 ||	su saṃvādam śaiva āgama ākhyam pramāṇam pratyakṣa ādi vat kasya nā abhimatam 
SA_MB_moksakarikaHK-949	nānvāgamāntarāṇāmapi pramāṇatvāt tadvirodhe'sya kathaṃ pramāṇateti, atrocyate	na anvāgama antarāṇām api pramāṇa tvāt tad virodha isya katham pramāṇa tā iti atrā ucyate 
SA_MB_moksakarikaHK-950	pāśadṛṣṭivirodhāya pravṛttamapi mānatām || 144 |	pāśa dṛṣṭi virodhāya pravṛttam api māna tām 
SA_MB_moksakarikaHK-951	na jahāti yataśchedyāḥ pāśāstasyeha sarvataḥ |	na jahāti yatas chedyāḥ pāśāḥ tasya iha sarvatas 
SA_MB_moksakarikaHK-952	nānena dṛṣṭyantarāṇyapodyante, kintu dṛṣṭyā naitadevamiti	na anena dṛṣṭi antarāṇi apodyante kintu dṛṣṭyā na etat evam iti 
SA_MB_moksakarikaHK-953	pāśātmakatadarthabādhakatvenaivāsyotpattestadvirodhānnedaṃ rajataṃ śuktikaiveyamiti	pāśa ātmaka tad artha bādhaka tvena eva asya utpatteḥ tad virodhāt na idam rajatam śuktikā eva iyam iti 
SA_MB_moksakarikaHK-954	jñānasyeva na prāmāṇyaṃ vihantuṃ kṣamam, nāpi dṛṣṭyantaraiḥ sahāsya virodhaḥ yataḥ	jñānasya iva na prāmāṇyam vihantum kṣamam nā api dṛṣṭi antaraiḥ saha asya virodhaḥ yatas 
SA_MB_moksakarikaHK-955	na ca svagocare tāsāṃ bādhate tatpramāṇatām || 145 ||	na ca sva gocare tāsām bādhate tad pramāṇa tām 
SA_MB_moksakarikaHK-956	na ca tacchaivākhyaṃ pramāṇaṃ dṛṣṭyantarāṇāmasatyārtha-tvaṃ pratipādayati,	na ca tat śaiva ākhyam pramāṇam dṛṣṭi antarāṇām asatya artha tvam pratipādayati 
SA_MB_moksakarikaHK-957	yena taiḥ sahāsya virodhaḥ syāt | api tu pratyakṣādīnāmivālpārthadarśitve'pi yathāsvaṃ	yena taiḥ saha asya virodhaḥ syāt api tu pratyakṣa ādīnām iva alpa artha darśi tve pi yathāsvam 
SA_MB_moksakarikaHK-958	prāpyaprāpakatvena prāmāṇyameveti | etaccoktamasmābhiḥ sarvāgamaprāmāṇye || 145 ||	prāpya prāpaka tvena prāmāṇyam eva iti etat ca uktam asmābhiḥ sarva āgama prāmāṇye 
SA_MB_moksakarikaHK-959	api ca 	api ca 
SA_MB_moksakarikaHK-960	tāsu varṇāśramācārānabhyanujñātavacca tat |	tāsu varṇa āśrama ācāra an abhyanujñāta vat ca tat 
SA_MB_moksakarikaHK-961	yadāhuḥ  iti (pūrvatanī 129 pṛṣṭhasthā tṛtīyā ṭippaṇī draṣṭavyā |)	yat āhuḥ iti pūrvatanī pṛṣṭha sthā tṛtīyā ṭippaṇī draṣṭavyā 
SA_MB_moksakarikaHK-962	varṇāśramācārānmanasā'pi na laṅghayet || yo yasminnāśrame tiṣṭhan dīkṣitaḥ	varṇa āśrama ācārān manasā api na laṅghayet yaḥ yasmin āśrame tiṣṭhan dīkṣitaḥ 
SA_MB_moksakarikaHK-963	śivaśāsane | sa tasminneva saṃtiṣṭhan śivadharmaṃ ca pālayet || iti | ata eva	śiva śāsane sa tasmin eva saṃtiṣṭhan śiva dharmam ca pālayet iti atas eva 
SA_MB_moksakarikaHK-964	yuṣmaddṛṣṭyā'pyasya na pāṣaṇḍatvam, vedāvirodhāt | vedavitparigrahaśca śrūyate yataḥ	yuṣmad dṛṣṭyā api asya na pāṣaṇḍa tvam veda avirodhāt veda vid parigrahaḥ ca śrūyate yatas 
SA_MB_moksakarikaHK-965	| purāṇetihāsādau śvetopamanyuprabhṛtīnāṃ maharṣīṇāmatrā-nuṣṭhānam, bhārate ca	purāṇa itihāsa ādau śveta upamanyu prabhṛtīnām mahā ṛṣīṇām atra anuṣṭhānam bhārate ca 
SA_MB_moksakarikaHK-966	naranārāyaṇayoraścatthāmnaśca | ābhyāṃ liṅge'rcito devastvayārcāyāṃ yuge yuge iti	nara nārāyaṇayā uraścatthāmnaḥ ca ābhyām liṅga īrcitaḥ devaḥ tvayā arcāyām yuge yuge iti 
SA_MB_moksakarikaHK-967	suvarṇākṣe ca bhagavato parameśvarārādhanāt siddhiḥ | api cānyat priyatamo loke kṛṣṇa	suvarṇākṣe ca parameśvara ārādhanāt siddhiḥ api ca anyat priyatamaḥ loke kṛṣṇa 
SA_MB_moksakarikaHK-968	bhaviṣyati | tvanmukhe ca jagatsarvaṃ bhaviṣyati na saṃśayaḥ || iti rāmāyaṇe |	bhaviṣyati tvad mukhe ca jagat sarvam bhaviṣyati na saṃśayaḥ iti rāmāyaṇe 
SA_MB_moksakarikaHK-969	kārtavoryādeḥ smṛtiṣu ca pratiṣṭhādipūrvo dharmaḥ  pakveṣṭakācitaṃ samyag yaḥ karoti	smṛtiṣu ca pratiṣṭhā ādi pūrvaḥ dharmaḥ pakva iṣṭakā citam samyak yaḥ karoti 
SA_MB_moksakarikaHK-970	śivālayam iti | sūtre  tatra mokṣaṃ vinirdiśet iti | dṛśyante ca	śivālayam iti sūtre tatra mokṣam vinirdiśet iti dṛśyante ca 
SA_MB_moksakarikaHK-971	pṛthukeśvararāmeśvarādayaḥ pratiṣṭhā-pitāḥ | vede'pi	pṛthukeśvara rāmeśvara ādayaḥ pratiṣṭhāpitāḥ vede api 
SA_MB_moksakarikaHK-972	śvetāśvatarādiśākhāsvatharvaśiraḥprabhṛtiṣu ca mantreṣu śaivasaṃpratyayaḥ | tato na	śvetāśvatara ādi śākhāsu atharvaśiraḥ prabhṛtiṣu ca mantreṣu śaiva saṃpratyayaḥ tatas na 
SA_MB_moksakarikaHK-973	vigānam, nāpi vicchinnamūlatā, na ca kaiścideva parigrahaḥ, yena	vigānam na api vicchinna mūla tā na ca kaiścid eva parigrahaḥ yena 
SA_MB_moksakarikaHK-974	yuṣmaddṛṣṭyā'pyaprāmāṇyaṃ syāt ||	yuṣmad dṛṣṭyā api aprāmāṇyam syāt 
SA_MB_moksakarikaHK-975	kiñca 	kiñca 
SA_MB_moksakarikaHK-976	na cānyena pramāṇena saṃruddhastasya gocaraḥ || 146 ||	na ca anyena pramāṇena saṃruddhaḥ tasya gocaraḥ 
SA_MB_moksakarikaHK-977	śrotriyairapyato grāhyaṃ tatphalā'dhikasādhanam |	śrotriyaiḥ api atas grāhyam tad phala adhika sādhanam 
SA_MB_moksakarikaHK-978	na ca pratyakṣena vā'numānena vā'sya bādha ityuktaṃ prāg bhogaprakaraṇe,	na ca pratyakṣena vā anumānena vā asya bādhaḥ iti uktam prāk bhoga prakaraṇe 
SA_MB_moksakarikaHK-979	yenāgninā siñcedityāderivāprāmāṇyaṃ syāditi sarvamaviruddham |	yena agninā siñcet ityādeḥ iva aprāmāṇyam syāt iti sarvam aviruddham 
SA_MB_moksakarikaHK-980	paraśreyoheturvedavidbhiranyaiśca pramāṇametad grāhyam || 146 ||	para śreyaḥ hetuḥ veda vidbhiḥ anyaiḥ ca pramāṇam etat grāhyam 
SA_MB_moksakarikaHK-981	na ca dṛṣṭyantarairapyasya bādhaḥ, yataḥ 	na ca dṛṣṭi antaraiḥ api asya bādhaḥ yatas 
SA_MB_moksakarikaHK-982	na tābhirabhibhāṣyābhiḥ sāmānyābhiśca bādhyate || 147 ||	na tābhiḥ abhibhāṣyābhiḥ sāmānyābhiḥ ca bādhyate  /
SA_MB_moksakarikaHK-983	tābhyo vilakṣaṇatvāttu tayā cāviṣayatvataḥ |	tābhyaḥ vilakṣaṇa tvāt tu tayā ca aviṣaya tvataḥ 
SA_MB_moksakarikaHK-984	vedādīnāmapi racanā kartāraṃ na vyabhicarati | hiraṇyagarbha-prabhṛtayaḥ	veda ādīnām api racanā kartāram na vyabhicarati hiraṇyagarbha prabhṛtayaḥ 
SA_MB_moksakarikaHK-985	kartāro'bhiyuktaiḥ smaryante | gītāsu ca  vedāntakṛd vedavideva cāham (15 | 15) iti |	kartāraḥ abhiyuktaiḥ smaryante gītāsu ca vedānta kṛt veda vid eva ca aham         
SA_MB_moksakarikaHK-986	teṣāṃ ca parasparaviruddhārthaśāstropa-deśādasarvajñatvam | yadāhuḥ sugato (pūrvatanī	teṣām ca paraspara viruddha artha śāstra upadeśāt asarvajña tvam yat āhuḥ pūrvatanī 
SA_MB_moksakarikaHK-987	135 pṛṣṭhasthā ṭippaṇī draṣṭavyā |) yadi sarvajñaḥ kapilo neti kā pramā | athobhāvapi	pṛṣṭha sthā ṭippaṇī draṣṭavyā yadi sarvajñaḥ kapilaḥ na iti kā pramā atha ubhau api 
SA_MB_moksakarikaHK-988	sarvajñau matibhedastayoḥ katham || iti | asarvajñasāmānyakartṛpraṇīta-	sarvajñau mati bhedaḥ tayoḥ katham iti asarvajña sāmānya kartṛ praṇīta 
SA_MB_moksakarikaHK-989	dṛṣṭayo'pyasarvaviṣayāḥ sarvajñapraṇītaśāstrābhibhāvyāstāḥ kathaṃ	dṛṣṭayā upi a sarva viṣayāḥ sarvajña praṇīta śāstra abhibhāvyāḥ tāḥ katham 
SA_MB_moksakarikaHK-990	tadevābhibhāvakaṃ sarvajñapraṇītatvādvakṣyamāṇavat-sarvānyāgamārthaparicchedakatvena	tat eva abhibhāvakam sarvajña praṇīta tvāt vakṣyamāṇa vat sarvān yāgama artha paricchedaka tvena 
SA_MB_moksakarikaHK-991	tābhyo vilakṣaṇaṃ viṣayīkṛtaṃ ca bādhyate | yathā tena viṣayīkṛtāstathā na tābhistaditi	tābhyaḥ vilakṣaṇam viṣayīkṛtam ca bādhyate yathā tena viṣayīkṛtāḥ tathā na tābhiḥ tat iti 
SA_MB_moksakarikaHK-992	yathā meyaphale tāsāṃ tadanūdya prakāśate || 148 ||	yathā meya phale tāsām tat anūdya prakāśate 
SA_MB_moksakarikaHK-993	svaprameyaphalārūḍhaṃ vaiśiṣṭyaṃ na tathā kṛtāḥ |	sva prameya phala ārūḍham vaiśiṣṭyam na tathā kṛtāḥ 
SA_MB_moksakarikaHK-994	tasya meyaphalaṃ coktvā svaprameyaphalāśritam || 149 ||	tasya meya phalam ca uktvā sva prameya phala āśritam 
SA_MB_moksakarikaHK-995	vaiśiṣṭyamavabhāsante tasmāt tāsāṃ na gocaraḥ |	vaiśiṣṭyam avabhāsante tasmāt tāsām na gocaraḥ 
SA_MB_moksakarikaHK-996	yathāhi tacchaivaṃ tāsāṃ dṛṣṭīnāṃ meyaphalaviṣayaṃ vaiśiṣṭyaṃ	yathā hi tat śaivam tāsām dṛṣṭīnām meya phala viṣayam vaiśiṣṭyam 
SA_MB_moksakarikaHK-997	svaprameyaphalārūḍham  buddhitattve sthitā bauddhā guṇeṣu tvārhatāḥ sthitāḥ	sva prameya phala ārūḍham buddhi tattve sthitāḥ bauddhāḥ guṇeṣu tu ārhatāḥ sthitāḥ 
SA_MB_moksakarikaHK-998	ityādyanūdya sarvaviṣayatvena prakāśate, na tathā tatphalaviṣayaṃ tābhiḥ	ityādi anūdya sarva viṣaya tvena prakāśate na tathā tad phala viṣayam tābhiḥ 
SA_MB_moksakarikaHK-999	sarvābhirgocarīkartumaśakyam | ataḥ kathamaviṣaye bādhakatvaṃ tāsāṃ syāt || 149 ||	sarvābhiḥ gocarīkartum aśakyam atas katham aviṣaye bādhaka tvam tāsām syāt  /
SA_MB_moksakarikaHK-1000	ata eva 	atas eva 
SA_MB_moksakarikaHK-1001	abhyanujñā viṣedho vā tena tāsu viniścitam || 150 ||	abhyanujñā viṣedhaḥ vā tena tāsu viniścitam 
SA_MB_moksakarikaHK-1002	tattulyajātidṛg vyāpyo na śivajñānagocaraḥ |	tad tulya jāti dṛś vyāpyaḥ na śiva jñāna gocaraḥ 
SA_MB_moksakarikaHK-1003	yato'sarvajñapraṇītatvena durbalatvaṃ tāsām, tataḥ śaivāgamā-virodhena	yatas sarvajña praṇīta tvena durbala tvam tāsām tatas śaiva āgama avirodhena 
SA_MB_moksakarikaHK-1004	svaviṣayānuṣṭhāne'bhyupagama eva, iti (pūrvatanī 129 pṛṣṭhasthā tṛtīyā ṭippaṇī	sva viṣaya anuṣṭhāna abhyupagamaḥ eva iti pūrvatanī pṛṣṭha sthā tṛtīyā ṭippaṇī 
SA_MB_moksakarikaHK-1005	draṣṭavyā |) varṇāśramācārān manasā'pi na laṅghayet iti tadvirodhe tu niṣedhaḥ kuryād	draṣṭavyā varṇa āśrama ācārān manasā api na laṅghayet iti tad virodhe tu niṣedhaḥ kuryāt 
SA_MB_moksakarikaHK-1006	brāhmīṃ na vā kuryācchaivīmeva niyogataḥ iti || 150 ||	brāhmīm na vā kuryāt śaivīm eva niyogataḥ iti 
SA_MB_moksakarikaHK-1007	na tu tābhirasarvajñapraṇītābhistulyajanmajñānaṃ tena vyāpyo bhavati kadācidapi	na tu tābhiḥ asarvajña praṇītābhiḥ tulya janma jñānam tena vyāpyaḥ bhavati kadācid api 
SA_MB_moksakarikaHK-1008	śaivajñānagocaro'rthaḥ | na ca kāryatvādanityatvamasya | yataḥ 	śaiva jñāna gocaraḥ ṛthaḥ na ca kārya tvāt anitya tvam asya yatas 
SA_MB_moksakarikaHK-1009	anādikālasaṃsiddhaṃ tadguṇatve'pi śāṅkare || 151 ||	anādi kāla saṃsiddham tad guṇa tve pi śāṅkare 
SA_MB_moksakarikaHK-1010	tacca samyak paricchedi śāṅkaraṃ jñānamīritam |	tat ca samyak paricchedi śāṅkaram jñānam īritam 
SA_MB_moksakarikaHK-1011	śabdārtharūpo hyāgamaḥ | tatra tantrarūpasyeśvarakṛtatve'pi tadarthasya	śabda artha rūpaḥ hi āgamaḥ tatra tantra rūpasya īśvara kṛta tve pi tad arthasya 
SA_MB_moksakarikaHK-1012	parameśvarasamavetasya samyag jñānāderguṇasya nityatvānnityatvam | ata eva tatpramāṇam	parameśvara samavetasya samyak jñāna ādeḥ guṇasya nitya tvāt nitya tvam atas eva tat pramāṇam 
SA_MB_moksakarikaHK-1013	ata eva 	atas eva 
SA_MB_moksakarikaHK-1014	na cāvihataśaktitvāt patyurbādhaṃ tadaśnute || 152 ||	na ca avihata śakti tvāt patyuḥ bādham tat aśnute 
SA_MB_moksakarikaHK-1015	na tulyaphalatā'pyasmāt kuto niṣphalatā bhavet |	na tulya phala tā api asmāt kutas niṣphala tā bhavet 
SA_MB_moksakarikaHK-1016	na tanniṣphalam, nāpi dṛṣṭyantaraiḥ samānaphalaṃ bādhyamāna-phalaṃ vā,	na tat niṣphalam na api dṛṣṭi antaraiḥ samāna phalam bādhyamāna phalam vā 
SA_MB_moksakarikaHK-1017	kintūktameva tatpramāṇyaṃ bhagavato'pratihataśaktitvena sarvottamatvāt || 152 ||	kintu uktam eva tat pramāṇyam bhagavatā apratihata śakti tvena sarva uttama tvāt 
SA_MB_moksakarikaHK-1018	astu vā dṛṣṭyantaraiḥ saha samānatvam, tathāpi na pākṣikamupādānam, yataḥ 	astu vā dṛṣṭi antaraiḥ saha samāna tvam tathā api na pākṣikam upādānam yatas 
SA_MB_moksakarikaHK-1019	grāhyaṃ tulyaphalatve'pi vimuktirdīkṣayaiva tat || 153 ||	grāhyam tulya phala tve pi vimuktiḥ dīkṣayā eva tat 
SA_MB_moksakarikaHK-1020	siddhidaṃ tu yataḥ puṃsāṃ sādhanena laghīyasā |	siddhi dam tu yatas puṃsām sādhanena laghīyasā 
SA_MB_moksakarikaHK-1021	ko hyabhipretasādhanaṃ laghutaraṃ parityajya kleśahetāvati-vistīrṇe pravartate |	kaḥ hi abhipreta sādhanam laghutaram parityajya kleśa hetau ati vistīrṇe pravartate 
SA_MB_moksakarikaHK-1022	taduktam  atraiva madhu vindeta kimarthaṃ parvataṃ vrajet | iṣṭasyārthasya saṃprāptau ko	tat uktam atra eva madhu vindeta kimartham parvatam vrajet iṣṭasya arthasya saṃprāptau kaḥ 
SA_MB_moksakarikaHK-1023	vidbān yatnamācaret | iti || 153 ||	vid bān yatnam ācaret iti 
SA_MB_moksakarikaHK-1024	kiñca 	kiñca 
SA_MB_moksakarikaHK-1025	siddhirvyāpāranirmuktā muktirapyatiśāyinī || 154 ||	siddhiḥ vyāpāra nirmuktā muktiḥ api atiśāyinī 
SA_MB_moksakarikaHK-1026	yatra tatko na gṛhṇāti sādhanaṃ śrutibhūṣaṇam |	yatra tat kaḥ na gṛhṇāti sādhanam śruti bhūṣaṇam 
SA_MB_moksakarikaHK-1027	yasmin śāstre sarvotkṛṣṭaṃ phalaṃ śrūyate, tatrānyaparityāgena ko na pravartata iti	yasmin śāstre sarva utkṛṣṭam phalam śrūyate tatra anya parityāgena kaḥ na pravartate iti 
SA_MB_moksakarikaHK-1028	dṛṣṭyantaraistulyaphalatve'pi na vikalpitā pravṛttiratreti || 154 ||	dṛṣṭi antaraiḥ tulya phala tve pi na vikalpitā pravṛttiḥ atra iti 
SA_MB_moksakarikaHK-1029	nanu parameśvarapraṇītaṃ taditi kutastaducyate 	nanu parameśvara praṇītam tat iti kutas tat ucyate 
SA_MB_moksakarikaHK-1030	śivāt paramparāyātau bhogamokṣau sasādhanau |	śivāt paramparā yātau bhoga mokṣau sa sādhanau 
SA_MB_moksakarikaHK-1031	ātreyāya munīndreṇa ruruṇā saṃprakāśitau || 155 ||	ātreyāya muni indreṇa ruruṇā saṃprakāśitau 
SA_MB_moksakarikaHK-1032	mandabuddhiprabodhāya karuṇāviṣṭadhīḥ sphuṭam |	manda buddhi prabodhāya karuṇā āviṣṭa dhīḥ sphuṭam 
SA_MB_moksakarikaHK-1033	sadyojyotistu saṃkṣepāt tāvetau paribaddhavān || 156 ||	sadyojyotiḥ tu saṃkṣepāt tau etau paribaddhavān 
SA_MB_moksakarikaHK-1034	yaṃ cānuśāsayāmāsa bhagavānīśasaṃmataḥ |	yam ca anuśāsayāmāsa bhagavān īśa saṃmataḥ 
SA_MB_moksakarikaHK-1035	ugrajyotirguruḥ śrīmān sarvavidyāsaritpatiḥ || 157 ||	           
SA_MB_moksakarikaHK-1036	iti mokṣakārikā samāptā ||	iti mokṣa kārikā samāptā 
SA_MB_moksakarikaHK-1037	gurvāmnāyato'vicchinnasmaraṇasantatereva pārameśvaratvenaitat pratīyate	guru āmnāyataḥ vicchinna smaraṇa santateḥ eva pārameśvara tvena etat pratīyate 
SA_MB_moksakarikaHK-1038	sarvaśreyoheturiti || 155  157 ||	sarva śreyaḥ hetuḥ iti 
SA_MB_moksakarikaHK-1039	iti mokṣakārikāyāṃ nārāyaṇakaṇṭhasūnunā racitā |	iti mokṣakārikāyām nārāyaṇa kaṇṭha sūnunā racitā 
SA_MB_moksakarikaHK-1040	saṃkṣepād vṛttiriyaṃ śiṣyahitā bhaṭṭarāmakaṇṭhena ||	saṃkṣepāt vṛttiḥ iyam śiṣya hitā bhaṭṭa rāmakaṇṭhena 
SA_MB_moksakarikaHK-1041	iti śrīnārāyaṇakaṇṭhātmajabhaṭṭarāmakaṇṭhakṛta-	iti śrī nārāyaṇakaṇṭha ātmaja bhaṭṭa rāmakaṇṭha kṛta 
SA_MB_moksakarikaHK-1042	mokṣakārikāvṛttiḥ samāptā ||	        
SA_MB_moksakarikaHK-1043	MUKTABODHA INDOLOGICAL RESEARCH INSTITUTE©2011 Muktabodha Indological Research Institute  All Rights Reserved.E-texts may be viewed only online or downloaded for private study.E-texts may not, under any circumstances, be copied, republished,reproduced, distributed or sold, either in original or altered form, withoutthe express permission of Muktabodha Indological Research Institute in writing.Data-entered by the staff of Muktabodha under the direction of Mark S. G. Dyczkowski.	muktabodha indological research muktabodha indological research institute all rights reserved texts may be viewed only online or downloaded for private studye texts may not under any circumstances be copied republished reproduced distributed or sold either in original or altered form withoutthe express permission of muktabodha indological research institute in writing data entered by the staff of muktabodha under the direction of mark s g dyczkowski 
