segmentnr	original	analyzed
SA_T07_vabhdiku-0	yo duḥkhahetuvyupaśāntimārgaṃ pradarśayāmāsa narāmarebhyaḥ /	yaḥ duḥkha hetu vyupaśānti mārgam pradarśayāmāsa nara amarebhyaḥ 
SA_T07_vabhdiku-1	taṃ satpathajñaṃ praṇipatya buddhaṃ śāstraṃ kariṣyāmyabhidharmadīpam // Abhidh-d_1 //	tam sat patha jñam praṇipatya buddham śāstram kariṣyāmi abhidharma dīpam 
SA_T07_vabhdiku-2	sattvādyananyathābhāve vyaktābhāvaḥ prasajyate /	sattva ādi ananyathābhāve vyakta abhāvaḥ prasajyate 
SA_T07_vabhdiku-3	tadvikārādvikāritvaṃ prakṛtestadabhedataḥ // Abhidh-d_2 //	tad vikārāt vikāri tvam prakṛteḥ tad abhedataḥ 
SA_T07_vabhdiku-4	na karma svakatotsargāt jñavyaktātmakatā malāḥ /	na karma svaka tā utsargāt jña vyakta ātmaka tā malāḥ 
SA_T07_vabhdiku-5	prākpakṣe muktyabhāvaśca dvitīye 'nye 'pyupaplavāḥ // Abhidh-d_3 //	prākpakṣe mukti abhāvaḥ ca dvitīye nye pi upaplavāḥ 
SA_T07_vabhdiku-6	rūpaskandho hi netrādyā daśāyatanadhātavaḥ /	rūpa skandhaḥ hi netra ādyāḥ daśa āyatana dhātavaḥ 
SA_T07_vabhdiku-7	dharmasaṃjñe trayaskandhāḥ sāvijñaptirdhruvatrayāḥ // Abhidh-d_4 //	dharma saṃjñe traya skandhāḥ sa a vijñaptiḥ dhruva trayāḥ 
SA_T07_vabhdiku-8	manaḥsaṃjñakamanyo 'pi saptavijñānadhātavaḥ /	sapta vijñānadhātavaḥ 
SA_T07_vabhdiku-9	āyadvāraṃ hyāyatanaṃ dhāturgotraṃ nirucyate // Abhidh-d_5 //	āya dvāram hi āyatanam dhātuḥ gotram nirucyate 
SA_T07_vabhdiku-10	yogarūpyānukūlyāderdvādaśāyatanīṃ muniḥ /	yoga rūpya ānukūlya ādeḥ dvādaśāyatanīm muniḥ 
SA_T07_vabhdiku-11	buddhyādyekatvadhīhānyai dhātūṃścāṣṭādaśoktavān // Abhidh-d_6 //	buddhi ādi ekatva dhī hānyai dhātūn ca aṣṭādaśa uktavān 
SA_T07_vabhdiku-12	ṣaṇṇāmanyo nyatantratvātkāraṇaṃ yaddhi tanmanaḥ /	ṣaṇṇām anyaḥ nya tantra tvāt kāraṇam yat hi tat manaḥ 
SA_T07_vabhdiku-13	rūpyarūpāśrayāstitvātpañcānāṃ rūpyudāhṛtaḥ // Abhidh-d_7 //	rūpya rūpa āśraya astitvāt pañcānām rūpī udāhṛtaḥ 
SA_T07_vabhdiku-14	skandhāyatanadhātūnāṃ svātmanā saṃgrahaḥ smṛtaḥ /	skandha āyatana dhātūnām sva ātmanā saṃgrahaḥ smṛtaḥ 
SA_T07_vabhdiku-15	svātmanā nityamaviyogāt samatvaṃ cittacaitasām // Abhidh-d_8 //	sva ātmanā nityam aviyogāt samatvam citta caitasām 
SA_T07_vabhdiku-16	tadākhyā ye 'nyasūtroktāsteṣāmeṣveva saṃgraham /	tad ākhyāḥ ye teṣām eṣu eva saṃgraham 
SA_T07_vabhdiku-17	brūyācchāstranayābhijño buddhyāpekṣya svalakṣaṇam // Abhidh-d_9 //	brūyāt śāstra naya abhijñaḥ buddhyā apekṣya sva lakṣaṇam 
SA_T07_vabhdiku-18	anyonyasaṃgraho jñeyaḥ skandhādīnāṃ yathāyatham /	anyonya saṃgrahaḥ jñeyaḥ skandha ādīnām yathāyatham 
SA_T07_vabhdiku-19	nādhvasvapatanādibhyo nityānāṃ skandhasaṃgrahaḥ // Abhidh-d_10 //	na adhva sva patana ādibhyaḥ nityānām skandha saṃgrahaḥ 
SA_T07_vabhdiku-20	dharmaskandhasahastrāṇāmaśīterapi saṃgrahaḥ /	dharma skandha sahastrāṇām aśīteḥ api saṃgrahaḥ 
SA_T07_vabhdiku-21	jñeyo 'vataraṇeṣveva taiḥ sanmārgāvatāraṇāt // Abhidh-d_11 //	jñeyaḥ vataraṇeṣu eva taiḥ sat mārga avatāraṇāt 
SA_T07_vabhdiku-22	dharmaskandhapramāṇaṃ tu satyāderekaśaḥ kathā /	dharma skandha pramāṇam tu satya ādeḥ ekaśas kathā 
SA_T07_vabhdiku-23	tatsatattvaṃ tu keṣāñcidvāṅnāmāpīṣyate paraiḥ // Abhidh-d_12 //	tat sa tattvam tu keṣāñcid vāc nāmā api iṣyate paraiḥ 
SA_T07_vabhdiku-24	sattvaprajñaptyupādānaṃ maulaṃ ṣaḍdhātavo matāḥ /	sattva prajñapti upādānam maulam ṣaṣ dhātavaḥ matāḥ 
SA_T07_vabhdiku-25	proktāstadbhedato yasmādasmimāno nivartate // Abhidh-d_13 //	proktāḥ tad bhedataḥ yasmāt asmimānaḥ nivartate 
SA_T07_vabhdiku-26	kliṣṭameva hi vijñānaṃ draṣṭavyaṃ janmani śrayāt /	kliṣṭam eva hi vijñānam draṣṭavyam janmani śrayāt 
SA_T07_vabhdiku-27	khadhātuḥ pṛthagākāśādrūpāyatanasaṃgrahāt // Abhidh-d_14 //	kha dhātuḥ pṛthak ākāśāt rūpa āyatana saṃgrahāt 
SA_T07_vabhdiku-28	nabhaḥ khalu nabho dhātorāsanno hetureṣa tu /	nabhaḥ khalu nabhaḥ dhātoḥ āsannaḥ hetuḥ eṣa tu 
SA_T07_vabhdiku-29	bhūtānāṃ tāni tajjasya rūpasyaitattu cetasaḥ // Abhidh-d_15 //	bhūtānām tāni tad jasya rūpasya etat tu cetasaḥ 
SA_T07_vabhdiku-30	pratyakṣavṛttiryattatprāgaprāptagrāhyato 'pi yat /	pratyakṣa vṛttiḥ yat tat prāk aprāpta grāhyataḥ pi yat 
SA_T07_vabhdiku-31	tato 'pi yaddavīyo 'rthaṃ paṭiṣṭhamitarādapi // Abhidh-d_16 //	yat davīyaḥ ṛtham paṭiṣṭham itarāt api 
SA_T07_vabhdiku-32	sanidarśana ādyārthaḥ mūrtāḥ sapratighā daśa /	            
SA_T07_vabhdiku-33	anyatra rūpaśabdābhyāṃ ta evāvyākṛtā matāḥ // Abhidh-d_17 //	anyatra rūpa śabdābhyām te eva avyākṛtāḥ matāḥ 
SA_T07_vabhdiku-34	śeṣāstridhā iha sarve 'pi rūpadhātau caturdaśa /	śeṣāḥ tridhā iha sarve rūpadhātau caturdaśa 
SA_T07_vabhdiku-35	rasagandhau savijñānau dhātū hitvā trayontimāḥ // Abhidh-d_18 //	rasa gandhau sa vijñānau dhātū hitvā trayaḥ antimāḥ 
SA_T07_vabhdiku-36	sāsravānāstravā antyāstrayaḥ śeṣāstu sāsravāḥ /	sa āsrava anāstravāḥ antyāḥ trayaḥ śeṣāḥ tu sa āsravāḥ 
SA_T07_vabhdiku-37	sālambaprathamāḥ pañca sopacārāstrayastridhā // Abhidh-d_19 //	sa ālamba prathamāḥ pañca sa upacārāḥ trayaḥ tridhā 
SA_T07_vabhdiku-38	nirvikalpaguṇasvārthāḥ asmārādanirūpaṇāt /	nirvikalpa guṇa sva arthāḥ asmārāt anirūpaṇāt 
SA_T07_vabhdiku-39	manobhaumī smṛtiḥ pūrvo dvitīyo dhīrnirūpikā // Abhidh-d_20 //	manaḥ bhaumī smṛtiḥ pūrvaḥ dvitīyaḥ dhīḥ nirūpikā 
SA_T07_vabhdiku-40	vijñānapañcakaṃ kāmeṣvekena savikalpakam /	vijñāna pañcakam kāmeṣu ekena sa vikalpakam 
SA_T07_vabhdiku-41	tasmādanyat tribhiḥ dhyāne prathame cāsamāhitam // Abhidh-d_21 //	tasmāt anyat tribhiḥ dhyāne prathame ca asamāhitam 
SA_T07_vabhdiku-42	dvābhyāmavyagraṃ ekena cakṣuḥśrotratvagāśrayam /	dvābhyām avyagram ekena cakṣuḥ śrotra tvac āśrayam 
SA_T07_vabhdiku-43	dvābhyāṃ taduparivyagraṃ ekenaiva samāhitam // Abhidh-d_22 //	dvābhyām tad upari vyagram ekena eva samāhitam 
SA_T07_vabhdiku-44	ucchinnaśubhabījasya darśanaṃ savikalpakam /	ucchinna śubha bījasya darśanam sa vikalpakam 
SA_T07_vabhdiku-45	kuśalaṃ nāsti vijñānamanyatra pratisandhitaḥ // Abhidh-d_23 //	kuśalam na asti vijñānam anyatra pratisandhitaḥ 
SA_T07_vabhdiku-46	kāmebhyo vītarāgasya bālasyāhānidharmiṇaḥ /	kāmebhyaḥ vīta rāgasya bālasya a hāni dharmiṇaḥ 
SA_T07_vabhdiku-47	dvidhāpyakuśalaṃ nāsti kliṣṭaṃ cāryasya nottamam // Abhidh-d_24 //	dvidhā api akuśalam nā asti kliṣṭam ca āryasya nā uttamam 
SA_T07_vabhdiku-48	nākliṣṭāvyākṛtaṃ kiñcidūrdhvabhūmivikalpakam /	na akliṣṭa avyākṛtam kiñcid ūrdhva bhūmi vikalpakam 
SA_T07_vabhdiku-49	kliṣṭaṃ vikalpakaṃ cāpi nāstyadhobhūmigocaram // Abhidh-d_25 //	kliṣṭam vikalpakam ca api na asti adhas bhūmi gocaram 
SA_T07_vabhdiku-50	tridheha dvayamāryasya rāgiṇaḥ saśubhasya ca /	tridhā iha dvayam āryasya rāgiṇaḥ sa śubhasya ca 
SA_T07_vabhdiku-51	na śubhaṃ nāpi ca kliṣṭaṃ dvitīyādiṣu darśakam // Abhidh-d_26 //	na śubham na api ca kliṣṭam dvitīya ādiṣu darśakam 
SA_T07_vabhdiku-52	prayogādaṅgasānnidhyātsabhāgatvācca santateḥ /	prayogāt aṅga sānnidhyāt sabhāga tvāt ca santateḥ 
SA_T07_vabhdiku-53	prāgvijñānānubhūte 'rthe cetasyutpadyate smṛtiḥ // Abhidh-d_27 //	prāk vijñāna anubhūte rthe cetasi utpadyate smṛtiḥ 
SA_T07_vabhdiku-54	etadviparyayāt māndyātkleśarogābhibhūtitaḥ /	etad viparyayāt māndyāt kleśa roga abhibhūtitaḥ 
SA_T07_vabhdiku-55	jñātapūrveṣu vismṛtiḥ saṃprajāyate // Abhidh-d_28 //	jñāta pūrveṣu vismṛtiḥ saṃprajāyate 
SA_T07_vabhdiku-56	dṛṣṭaṃ dvitricatuḥpañcaprakāreṇāpi cetasā /	dṛṣṭam dvi tri catur pañca prakāreṇa api cetasā 
SA_T07_vabhdiku-57	smaryate sattadanyaiśca nānyo 'nyaṃ vyoghadṛkkṣaye // Abhidh-d_29 //	smaryate sat tad anyaiḥ ca na anyaḥ vyogha dṛś kṣaye 
SA_T07_vabhdiku-58	vijñānānāṃ tu pañcānāṃ yadekenānubhūyate /	vijñānānām tu pañcānām yat ekena anubhūyate 
SA_T07_vabhdiku-59	tatsmaryate 'pi cānyena tena khalvitarairapi // Abhidh-d_30 //	tat smaryate ca anyena tena khalu itaraiḥ api 
SA_T07_vabhdiku-60	dvyavyākṛtānubhūtaṃ yaccittaṃ dvādaśakādiha /	dvi avyākṛta anubhūtam yat cittam dvādaśakāt iha 
SA_T07_vabhdiku-61	vyārūpyarūpanivṛteḥ smaryate 'ṣṭābhireva tat // Abhidh-d_31 //	vyārūpya rūpa nivṛteḥ smaryate ṣṭābhiḥ eva tat 
SA_T07_vabhdiku-62	rūpārūpyāptanivṛtaśubhābhyāṃ tu krameṇa yat /	rūpa ārūpya āpta nivṛta śubhābhyām tu krameṇa yat 
SA_T07_vabhdiku-63	kāmāptāvyākṛte hitvā smaryate daśakena tat // Abhidh-d_32 //	kāma āpta avyākṛte hitvā smaryate daśakena tat 
SA_T07_vabhdiku-64	rūpe tvanivṛtākhyena dṛṣṭamavyākṛtena yat /	rūpe tu anivṛta ākhyena dṛṣṭam avyākṛtena yat 
SA_T07_vabhdiku-65	ārūpyāvyākṛte hitvā tadanyaiḥ smaryate punaḥ // Abhidh-d_33 //	ārūpya avyākṛte hitvā tad anyaiḥ smaryate punar 
SA_T07_vabhdiku-66	ārūpyāvyākṛtajñātaṃ yaśceto navakena tat /	ārūpya avyākṛta jñātam yaḥ cetaḥ navakena tat 
SA_T07_vabhdiku-67	kāmāptāvyākṛte hitvā rūpāptānivṛtaṃ tathā // Abhidh-d_34 //	kāma āpta avyākṛte hitvā rūpa āpta anivṛtam tathā 
SA_T07_vabhdiku-68	cittākhyāḥ sapta sālambā dharmākhyaḥ saṃprayuktakaḥ /	citta ākhyāḥ sapta sa ālambāḥ dharma ākhyaḥ saṃprayuktakaḥ 
SA_T07_vabhdiku-69	amūrtā dhvaninā sārdhamanupāttāḥ nava dvidhā // Abhidh-d_35 //	amūrtāḥ dhvaninā sārdham anupāttāḥ nava dvidhā 
SA_T07_vabhdiku-70	spṛśyaṃ dvidhā sadharmāṃśāḥ saha tā nava bhautikāḥ /	spṛśyam dvidhā sadharma aṃśāḥ saha tāḥ nava bhautikāḥ 
SA_T07_vabhdiku-71	daśa sāvayavā mūrtāḥ ta eva daśa saṃcitāḥ // Abhidh-d_36 //	daśa sāvayavāḥ mūrtāḥ te eva daśa saṃcitāḥ 
SA_T07_vabhdiku-72	rūpagandharasasparśāścchetṛcchedyātmakā matāḥ /	rūpa gandha rasa sparśāḥ chetṛ chedya ātmakāḥ matāḥ 
SA_T07_vabhdiku-73	dāhakāstolakāścaite dāhyāstolyāsta eva vā // Abhidh-d_37 //	dāhakāḥ tolakāḥ ca ete dāhyāḥ tolyāḥ te eva vā 
SA_T07_vabhdiku-74	pañca rūpīndriyātmāno vipākopacayātmakāḥ /	pañca rūpi indriya ātmānaḥ vipāka upacaya ātmakāḥ 
SA_T07_vabhdiku-75	amūrtā naupacayikāḥ tridhā śeṣāḥ dhvanirdvidhā // Abhidh-d_38 //	amūrtāḥ na aupacayikāḥ tridhā śeṣāḥ dhvaniḥ dvidhā 
SA_T07_vabhdiku-76	cakṣustadupalabdhiśca pṛthagvā saha vāpnuyāt /	cakṣuḥ tad upalabdhiḥ ca pṛthak vā saha vā āpnuyāt 
SA_T07_vabhdiku-77	dvādaśādhyātmikā jñeyāḥ bāhyāṣṣaḍviṣayātmakāḥ // Abhidh-d_39 //	dvādaśa ādhyātmikāḥ jñeyāḥ bāhya aṣṣaṣ viṣaya ātmakāḥ 
SA_T07_vabhdiku-78	trayo 'ntyāstrividhāḥ śeṣā bhāvanāpathasaṃkṣayāḥ /	trayaḥ ntyāḥ trividhāḥ śeṣāḥ bhāvanā patha saṃkṣayāḥ 
SA_T07_vabhdiku-79	na rūpamasti dṛggheyaṃ nākliṣṭaṃ nāvikalpakam // Abhidh-d_40 //	na rūpam asti dṛś heyam na akliṣṭam na avikalpakam 
SA_T07_vabhdiku-80	sabhāga eva dharmākhyaḥ śeṣāstūbhayathā smṛtāḥ /	sa bhāgaḥ eva dharma ākhyaḥ śeṣāḥ tu ubhayathā smṛtāḥ 
SA_T07_vabhdiku-81	sabhāgastatsabhāgatve svakriyābhāktu tulyate // Abhidh-d_41 //	sa bhāgaḥ tad sa bhāga tve sva kriyā bhāj tu tulyate 
SA_T07_vabhdiku-82	cakṣuḥ sadharmadhātvaṃśaṃ navadhā dṛṣṭirūcyate /	cakṣuḥ sa dharmadhātu aṃśam navadhā dṛṣṭiḥ ūcyate 
SA_T07_vabhdiku-83	pāñcavijñānakī prajñā na dṛṣṭiranitīraṇāt // Abhidh-d_42 //	pāñcavijñānakī prajñā na dṛṣṭiḥ an iti īraṇāt 
SA_T07_vabhdiku-84	sameghāmegharātryahnordṛśyaṃ cakṣuryathekṣate /	sa meghā megha rātri ahnoḥ dṛśyam cakṣuḥ yathā īkṣate 
SA_T07_vabhdiku-85	kliṣṭākliṣṭadṛśau tadvacchaikṣāśaiṃkṣe ca paśyataḥ // Abhidh-d_43 //	kliṣṭa akliṣṭa dṛśau tadvat śaikṣa aśaiṃkṣe ca paśyataḥ 
SA_T07_vabhdiku-86	cakṣuḥ paśyati vijñānaṃ vijānāti svagocaram /	cakṣuḥ paśyati vijñānam vijānāti sva gocaram 
SA_T07_vabhdiku-87	ālocanopalabdhitvādviśeṣaḥ sumahāṃstayoḥ // Abhidh-d_44 //	ālocanā upalabdhi tvāt viśeṣaḥ su mahān tayoḥ 
SA_T07_vabhdiku-88	ekasya cakṣuṣaḥ kāryaṃ vijñānamathavā dvayoḥ /	ekasya cakṣuṣaḥ kāryam vijñānam athavā dvayoḥ 
SA_T07_vabhdiku-89	aprāpyārthaṃ manaścakṣuḥ śrotraṃ ca trīṇyato 'nyathā // Abhidh-d_45 //	a prāpya artham manaḥ cakṣuḥ śrotram ca trīṇi atas nyathā 
SA_T07_vabhdiku-90	aprāptagrāhiṇaḥ siddhā dūrāsannasamagrahāt /	aprāpta grāhiṇaḥ siddhāḥ dūra āsanna sama grahāt 
SA_T07_vabhdiku-91	pradīpādiprabhāvaścet na samaṃ tatsamudbhavāt // Abhidh-d_46 //	pradīpa ādi prabhāvaḥ ced na samam tad samudbhavāt 
SA_T07_vabhdiku-92	sarvagrahaprasaṃgaścennāyaskāntādidarśanāt /	sarva graha prasaṃgaḥ ced na ayaskānta ādi darśanāt 
SA_T07_vabhdiku-93	sarvagatvādadoṣaścennāyogāttilatailavat // Abhidh-d_47 //	sarvaga tvāt adoṣaḥ ced na ayogāt tila taila vat 
SA_T07_vabhdiku-94	na hyūrdhvaṃ cakṣuṣaḥ kāyo na rūpaṃ nākṣijaṃ manaḥ /	na hi ūrdhvam cakṣuṣaḥ kāyaḥ na rūpam na akṣi jam manaḥ 
SA_T07_vabhdiku-95	vijñānasya tu netrārthastau ca kāyasya savaṃtaḥ // Abhidh-d_48 //	vijñānasya tu netra arthaḥ tau ca kāyasya 
SA_T07_vabhdiku-96	nopariṣṭācchru teḥ kāyo na śabdo na svakaṃ manaḥ /	na upariṣṭāt śru teḥ kāyaḥ na śabdaḥ na svakam manaḥ 
SA_T07_vabhdiku-97	vijñānasya tu nihrādastau ca kāyasya sarvataḥ // Abhidh-d_49 //	vijñānasya tu nihrādaḥ tau ca kāyasya sarvatas 
SA_T07_vabhdiku-98	trayāṇāṃ trīṇyapi svāni tanorvijñānamapyadhaḥ /	trayāṇām trīṇi api svāni tanoḥ vijñānam api adhas 
SA_T07_vabhdiku-99	manastvaniyataṃ yogivaiśvarūpyaṃ pradarśitam // Abhidh-d_50 //	manaḥ tu aniyatam yogi vaiśvarūpyam pradarśitam 
SA_T07_vabhdiku-100	sāsravānāsrāḥ skandhā ye tūpādānasaṃjñitāḥ /	sa āsrava anāsrāḥ skandhāḥ ye tu upādāna saṃjñitāḥ 
SA_T07_vabhdiku-101	sāsravā eva te jñeyāstatsācivyakriyādibhiḥ // Abhidh-d_51 //	sa āsravāḥ eva te jñeyāḥ tad sācivya kriyā ādibhiḥ 
SA_T07_vabhdiku-102	adhvādyāḥ skandhaparyāyāḥ dharmādyā vastunaḥ sataḥ /	adhva ādyāḥ skandha paryāyāḥ dharma ādyāḥ vastunaḥ sataḥ 
SA_T07_vabhdiku-103	ye tu sāsravasaṃjñāste proktā duḥkhādināmabhiḥ // Abhidh-d_52 //	ye tu sa āsrava saṃjñāḥ te proktāḥ duḥkha ādi nāmabhiḥ 
SA_T07_vabhdiku-104	svātmyagocarakāryāṇāmekatvādekadhātutā /	svātmya gocara kāryāṇām eka tvāt eka dhātu tā 
SA_T07_vabhdiku-105	cakṣurādidvibhāve 'pi dvyutpattiḥ karmatritvaśāt // Abhidh-d_53 //	cakṣuḥ ādi dvi bhāve pi dvi utpattiḥ karma tri tva śāt 
SA_T07_vabhdiku-106	asādhāraṇavaiśiṣṭyādaiśvaryādāntaraṅgayataḥ /	a sādhāraṇa vaiśiṣṭyāt aiśvaryāt ā antaraṅgayataḥ 
SA_T07_vabhdiku-107	satyapyanekahetutve vijñānaṃ tairviśeṣyate // Abhidh-d_54 //	sati api aneka hetu tve vijñānam taiḥ viśeṣyate 
SA_T07_vabhdiku-108	nityatvātkuśalatvācca nirvāṇaṃ dravyamañjasā /	nitya tvāt kuśala tvāt ca nirvāṇam dravyam añjasā 
SA_T07_vabhdiku-109	sāradravyena tenaiko dharmākhyo dravyavānmataḥ // Abhidh-d_55 //	sāra dravyena tena ekaḥ dharma ākhyaḥ dravyavān mataḥ 
SA_T07_vabhdiku-110	prathamaṃ nirmalaṃ cittamasābhāgyātkṣaṇaḥ smṛtaḥ /	prathamam nirmalam cittam asābhāgyāt kṣaṇaḥ smṛtaḥ 
SA_T07_vabhdiku-111	tenādbhutakṣaṇenaite kṣaṇikāḥ paścimāstrayaḥ // Abhidh-d_56 //	tena adbhuta kṣaṇena ete kṣaṇikāḥ paścimāḥ trayaḥ 
SA_T07_vabhdiku-112	ghrāṇaṃ jihvā ca kāyaśca tulyārthagrāhyadastrayam /	ghrāṇam jihvā ca kāyaḥ ca tulya artha grāhya daḥ trayam 
SA_T07_vabhdiku-113	paścimasyāśrayo 'tītaḥ pañcānāṃ taiḥ sahāpi ca // Abhidh-d_57 //	paścimasya utītaḥ pañcānām taiḥ saha api ca 
SA_T07_vabhdiku-114	niśritya khalvanāgamyaṃ niśrayāṃścaturo 'tha vā /	niśritya khalu anāgamyam niśrayān caturaḥ vā 
SA_T07_vabhdiku-115	anāsraveṇa mārgeṃṇa cakṣurdhāturnirudhyate // Abhidh-d_58 //	anāsraveṇa mārgeṃṇa cakṣuḥ dhātuḥ nirudhyate 
SA_T07_vabhdiku-116	anāgamyaṃ tu niśritya gandhadhāturnirudhyate /	anāgamyam tu niśritya gandhadhātuḥ nirudhyate 
SA_T07_vabhdiku-117	manodhāturanāgamyaṃ yadi vā saptaniśrayāt // Abhidh-d_59 //	manaḥ dhātuḥ anāgamyam yadi vā sapta niśrayāt 
SA_T07_vabhdiku-118	anāgamyaṃ tathaivādyaṃ cakṣurvijñānasaṃjñakaḥ /	anāgamyam tathā eva ādyam cakṣuḥ vijñāna saṃjñakaḥ 
SA_T07_vabhdiku-119	dharmadhātorvicitratvādyathāyogaṃ vinirdiśet // Abhidh-d_60 //	dharmadhātoḥ vicitra tvāt yathāyogam vinirdiśet 
SA_T07_vabhdiku-120	cakṣurdhātuṃ hi rūpāptaṃ parijānan pṛthagjanaḥ /	cakṣuḥ dhātum hi rūpa āptam parijānan pṛthagjanaḥ 
SA_T07_vabhdiku-121	kṛtsnādrūpamayāddhātorvairāgyamadhigacchati // Abhidh-d_61 //	kṛtsnāt rūpa mayāt dhātoḥ vairāgyam adhigacchati 
SA_T07_vabhdiku-122	tasmādanuśayāndhātorekatriṃśajjahāti ca /	tasmāt anuśayān dhātoḥ ekatriṃśat jahāti ca 
SA_T07_vabhdiku-123	paryādatte na kiñcittu saṃyojanamasau tadā // Abhidh-d_62 //	paryādatte na kiñcid tu saṃyojanam asau tadā 
SA_T07_vabhdiku-124	rūpavairāgyamāpnoti jahātyanuśayatrayam /	rūpa vairāgyam āpnoti jahāti anuśaya trayam 
SA_T07_vabhdiku-125	tadā saṃyojanaṃ tvāryaḥ paryādatte na kiñcana // Abhidh-d_63 //	tadā saṃyojanam tu āryaḥ paryādatte na kiñcana 
SA_T07_vabhdiku-126	cakṣurvijñānadhātuṃ tu parijānaṃstameva ca /	cakṣuḥ vijñāna dhātum tu parijānan tam eva ca 
SA_T07_vabhdiku-127	parijānātyavaśyaṃ ca brahmalokādvirajyate // Abhidh-d_64 //	parijānāti avaśyam ca brahma lokāt virajyate 
SA_T07_vabhdiku-128	na tu saṃyojanaṃ kiñcitparyādatte tadā hyasau /	na tu saṃyojanam kiñcid paryādatte tadā hi asau 
SA_T07_vabhdiku-129	gandhadhātuṃ rasākhyaṃ ca parijānan pṛthagjanaḥ // Abhidh-d_65 //	gandha dhātum rasa ākhyam ca parijānan pṛthagjanaḥ 
SA_T07_vabhdiku-130	kāmavairāgyamāpnoti dhruvaṃ hyanuśayānapi /	kāma vairāgyam āpnoti dhruvam hi anuśayān api 
SA_T07_vabhdiku-131	tadā jahāti ṣaṭtriṃśadvartisaṃyojanatrayam // Abhidh-d_66 //	tadā jahāti ṣaṭtriṃśat varti saṃyojana trayam 
SA_T07_vabhdiku-132	āryastu kāmavairāgyaṃ karotyanuśayānapi /	āryaḥ tu kāma vairāgyam karoti anuśayān api 
SA_T07_vabhdiku-133	caturaḥ parijānāti paryādatte 'pi ca trayam // Abhidh-d_67 //	caturaḥ parijānāti paryādatte ca trayam 
SA_T07_vabhdiku-134	parijānanmanodhātumārūpyebhyo virajyate /	parijānan manaḥ dhātum ārūpyebhyaḥ virajyate 
SA_T07_vabhdiku-135	jahātyanuśayāṃstrīṃśca paryādatte trayaṃ tathā // Abhidh-d_68 //	jahāti anuśayān trīn ca paryādatte trayam tathā 
SA_T07_vabhdiku-136	parijānankhalu prīrti tāmeva prajahātyasau /	parijānan khalu tām eva prajahāti asau 
SA_T07_vabhdiku-137	ābhāsvarācca vairāgyaṃ yāti hanti tu nāsravān // Abhidh-d_69 //	ābhāsvarāt ca vairāgyam yāti hanti tu na āsravān 
SA_T07_vabhdiku-138	parijānansukhaṃ yogī prajahāti tadeha ca /	parijānan sukham yogī prajahāti tat eha ca 
SA_T07_vabhdiku-139	śubhakṛtsnācca vairāgyaṃ yāti kleśānna hanti tu // Abhidh-d_70 //	śubhakṛtsnāt ca vairāgyam yāti kleśān na hanti tu 
SA_T07_vabhdiku-140	dvivijñeyāḥ guṇāḥ pañca hetuḥ sarve kṣarākṣarāḥ /	dvivijñeyāḥ guṇāḥ pañca hetuḥ sarve kṣarākṣarāḥ 
SA_T07_vabhdiku-141	anyatra dharmadhātvardhācchaḍbāhyā nendriyātmakāḥ // Abhidh-d_71 //	anyatra dharmadhātu ardhāt śaṃ bāhyāḥ na indriya ātmakāḥ 
SA_T07_vabhdiku-142	dvāviṃśatiprakārasya kṛtsnasyendriyaparvaṇaḥ /	dvāviṃśati prakārasya kṛtsnasya indriya parvaṇaḥ 
SA_T07_vabhdiku-143	saṃkṣepeṇābhidhāsyante dharmā nirvacanādayaḥ // Abhidh-d_72 //	saṃkṣepeṇa abhidhāsyante dharmāḥ nirvacana ādayaḥ 
SA_T07_vabhdiku-144	nāmnā dvāviṃśatistāni dravyato daśa sapta ca /	nāmnā dvāviṃśatiḥ tāni dravyataḥ daśa sapta ca 
SA_T07_vabhdiku-145	yasmānnānyaddvayaṃ kāryātsukhādinavakatrayam // Abhidh-d_73 //	yasmāt na anyat dvayam kāryāt sukha ādi navaka trayam 
SA_T07_vabhdiku-146	nāmasallakṣaṇābhāvāttannāmnaḥ sārthakatvataḥ /	nāma sat lakṣaṇa abhāvāt tad nāmnaḥ sārthaka tvataḥ 
SA_T07_vabhdiku-147	trayāṇāṃ vargavṛttitve 'pyarthamabhyeṣyate paraiḥ // Abhidh-d_74 //	trayāṇām varga vṛtti tve pi artham abhyeṣyate paraiḥ 
SA_T07_vabhdiku-148	viśiṣṭabuddhihetutvādādhipatyaviśeṣataḥ /	viśiṣṭa buddhi hetu tvāt ādhipatya viśeṣataḥ 
SA_T07_vabhdiku-149	kāyendriyādviśiṣṭatvaṃ dvayornetrendriyādivat // Abhidh-d_75 //	kāya indriyāt viśiṣṭa tvam dvayoḥ netra indriya ādi vat 
SA_T07_vabhdiku-150	aiśvaryārtho vipaścidbhirindriyārtho 'bhidhīyate /	aiśvarya arthaḥ vipaścidbhiḥ indriya arthaḥ bhidhīyate 
SA_T07_vabhdiku-151	svārthavyaktiṣu pañcānāṃ caturṇāṃ tvarthayordvayoḥ // Abhidh-d_76 //	sva artha vyaktiṣu pañcānām caturṇām tu arthayoḥ dvayoḥ 
SA_T07_vabhdiku-152	svagocaropalabdhyādāvīśitvamapare viduḥ /	sva gocara upalabdhi ādau īśitvam apare viduḥ 
SA_T07_vabhdiku-153	svārthavijñāna evānya āhuḥ paṇḍitamāninaḥ // Abhidh-d_77 //	sva artha vijñāne eva anye āhuḥ paṇḍita māninaḥ 
SA_T07_vabhdiku-154	kleśotpattau sukhādīnāṃ śraddhādīnāṃ guṇāptiṣu /	kleśa utpattau sukha ādīnām śraddhā ādīnām guṇa āptiṣu 
SA_T07_vabhdiku-155	phalasaṃkleśasaṃbhāraviśuddhitvādanukramaḥ // Abhidh-d_78 //	phala saṃkleśa saṃbhāra viśuddhi tvāt anukramaḥ 
SA_T07_vabhdiku-156	sattvākhyā sattvavaicitryaṃ dhṛtiḥ kleśodbhavaśca yaiḥ /	sattva ākhyā sattva vaicitryam dhṛtiḥ kleśa udbhavaḥ ca yaiḥ 
SA_T07_vabhdiku-157	mārgopāyaḥ phalaprāptisteṣāmindriyatā matā // Abhidh-d_79 //	mārga upāyaḥ phala prāptiḥ teṣām indriya tā matā 
SA_T07_vabhdiku-158	sparśāśrayodbhavādhārasaṃbhogatvāccaturdaśa /	sparśa āśraya udbhava ādhāra saṃbhoga tvāt caturdaśa 
SA_T07_vabhdiku-159	svargāpavargahetutvāt tadanyadvendriyāṣṭakam // Abhidh-d_80 //	svarga apavarga hetu tvāt tad anyat vā indriya aṣṭakam 
SA_T07_vabhdiku-160	chandaṃ vīryāṅgabhūtatvāt sparśo vittyanubṛṃhaṇāt /	chandam vīrya aṅga bhūta tvāt sparśaḥ vitti anubṛṃhaṇāt 
SA_T07_vabhdiku-161	saṃjñā prajñābhibhūtatvānnendriyaṃ munirabhyadhāt // Abhidh-d_81 //	saṃjñā prajñā abhibhūta tvāt na indriyam muniḥ abhyadhāt 
SA_T07_vabhdiku-162	śraddhādīnāṃ vidāṃ caiva doṣaḥ śuddhau malodaye /	śraddhā ādīnām vidām ca eva doṣaḥ śuddhau mala udaye 
SA_T07_vabhdiku-163	pradhānatvānmanaskāro nendriyaṃ samudāhṛtam // Abhidh-d_82 //	pradhāna tvāt manaskāraḥ na indriyam samudāhṛtam 
SA_T07_vabhdiku-164	saṃbhāvanānukūlatvādadhimokṣo 'pi nendriyam /	saṃbhāvanā anukūla tvāt adhimokṣaḥ na indriyam 
SA_T07_vabhdiku-165	kālāntaraphalotpādasaṃdehābhyāṃ na cetanā // Abhidh-d_83 //	kāla antara phala utpāda saṃdehābhyām na cetanā 
SA_T07_vabhdiku-166	nāpramādo 'pyasau vīryāt,	na apramādaḥ pi asau vīryāt 
SA_T07_vabhdiku-167	na hrīḥ prāgalbhanigrahāt /	na hrīḥ prāgalbha nigrahāt 
SA_T07_vabhdiku-168	nopekṣā nāpi cālobho vīryaśraddhābhibhūtitaḥ // Abhidh-d_84 //	na upekṣā nā api ca alobhaḥ vīrya śraddhā abhibhūtitaḥ 
SA_T07_vabhdiku-169	na prasrabdhirvidautkaṭyādvinindyatvācca nāsravāḥ /	na prasrabdhiḥ vid autkaṭyāt vinindya tvāt ca na āsravāḥ 
SA_T07_vabhdiku-170	jātyādayo na pārārthyāt niṣkriyatvānna nirvṛtiḥ // Abhidh-d_85 //	jāti ādayaḥ na pārārthyāt niṣkriya tvāt na nirvṛtiḥ 
SA_T07_vabhdiku-171	kāyasya bādhanaṃ duḥkhaṃ daurmanasyaṃ tu cetasaḥ /	kāyasya bādhanam duḥkham daurmanasyam tu cetasaḥ 
SA_T07_vabhdiku-172	sukhaṃ ca sumanastā ca sātaṃ śārīramānasam // Abhidh-d_86 //	sukham ca sumanastā ca sātam śārīra mānasam 
SA_T07_vabhdiku-173	vaiśiṣṭyānmānasaṃ sātaṃ sukhaṃ kvacidudāhṛtam // Abhidh-d_87 //	vaiśiṣṭyāt mānasam sātam sukham kvacid udāhṛtam 
SA_T07_vabhdiku-174	ṣaṭsu bhūmiṣu vijñeyaṃ nīrajaskādyamindriyam /	ṣaṭsu bhūmiṣu vijñeyam nīrajaska ādyam indriyam 
SA_T07_vabhdiku-175	tadanye nirmale tvakṣe draṣṭavye navabhūmike // Abhidh-d_88 //	tad anye nirmale tu akṣe draṣṭavye nava bhūmike 
SA_T07_vabhdiku-176	daurmanasyaṃ dvihātavyaṃ manovittitrayaṃ tridhā /	daurmanasyam dvi hātavyam manaḥ vitti trayam tridhā 
SA_T07_vabhdiku-177	navābhyāsapraheyāṇi dvidhā pañca na tu trayam // Abhidh-d_89 //	nava abhyāsa praheyāṇi dvidhā pañca na tu trayam 
SA_T07_vabhdiku-178	pūrvaṃ kramodbhavaiḥ kāme vipāko labhyate dvayam /	pūrvam krama udbhavaiḥ kāme vipākaḥ labhyate dvayam 
SA_T07_vabhdiku-179	anyaiḥ ṣaṭ sapta vāṣṭau vā ṣaḍ rūpe antye tu jīvitam // Abhidh-d_90 //	anyaiḥ ṣaṭ sapta vā aṣṭau vā ṣaṣ rūpe antye tu jīvitam 
SA_T07_vabhdiku-180	mriyamāṇairnirodhyante trīṇyante aṣṭau tu madhyame /	mriyamāṇaiḥ nirodhyante trīṇi ante aṣṭau tu madhyame 
SA_T07_vabhdiku-181	daśāṣṭau nava catvāri kāme pañca śubhāni vā // Abhidh-d_91 //	daśa aṣṭau nava catvāri kāme pañca śubhāni vā 
SA_T07_vabhdiku-182	ādyantalābho navabhiḥ saptāṣṭābhiśca madhyayoḥ /	ādi anta lābhaḥ navabhiḥ sapta aṣṭābhiḥ ca madhyayoḥ 
SA_T07_vabhdiku-183	ekādaśabhirāptistu phalasyāntyasya hānitaḥ // Abhidh-d_92 //	ekādaśabhiḥ āptiḥ tu phalasya antyasya hānitaḥ 
SA_T07_vabhdiku-184	svasya dhātoḥ parijñānaṃ svavipakṣadṛśā pathā // Abhidh-d_93 //	svasya dhātoḥ parijñānam sva vipakṣa dṛśā pathā 
SA_T07_vabhdiku-185	kāmadhātuparijñānaṃ prāyaḥ saptabhiriṣyate /	kāmadhātu parijñānam prāyas saptabhiḥ iṣyate 
SA_T07_vabhdiku-186	samalairnirmalaistvarthairaṣṭābhirabhidhīyate // Abhidh-d_94 //	sa malaiḥ nirmalaiḥ tu arthaiḥ aṣṭābhiḥ abhidhīyate 
SA_T07_vabhdiku-187	rūpadhātuparijñānamiṣṭaṃ daśabhirindriyaiḥ /	rūpa dhātu parijñānam iṣṭam daśabhiḥ indriyaiḥ 
SA_T07_vabhdiku-188	antyadhātuparijñānamekādaśabhirucyate // Abhidh-d_95 //	antya dhātu parijñānam ekādaśabhiḥ ucyate 
SA_T07_vabhdiku-189	sarvasattvāstridhātusthā upekṣāyurmano 'nvitāḥ /	sarva sattvāḥ tri dhātu sthāḥ upekṣā āyuḥ manaḥ nvitāḥ 
SA_T07_vabhdiku-190	tvakstrītvavyañjanaiḥ kāme rūpiṇaścakṣurādibhiḥ // Abhidh-d_96 //	tvak strī tva vyañjanaiḥ kāme rūpiṇaḥ cakṣuḥ ādibhiḥ 
SA_T07_vabhdiku-191	kāminaḥ khalu duḥkhena tadrāgī durmanastayā /	kāminaḥ khalu duḥkhena tad rāgī durmanaḥ tayā 
SA_T07_vabhdiku-192	ūrdhvajastu sukhenāryaḥ śubhāhvādharajau tathā // Abhidh-d_97 //	ūrdhvajaḥ tu sukhena āryaḥ śubha āhvā adhara jau tathā 
SA_T07_vabhdiku-193	prītyābhāhvādharodbhūtau śubhaiḥ sa śubhamūlakaḥ /	śubhaiḥ sa śubha mūlakaḥ 
SA_T07_vabhdiku-194	śaikṣābhyāṃ mokṣamārgasthau aśaikṣo 'rhan svamārgagaḥ // Abhidh-d_98 //	śaikṣābhyām mokṣa mārga sthau aśaikṣaḥ rhan sva mārga gaḥ 
SA_T07_vabhdiku-195	upekṣāyurmanoyukto 'vaśyaṃ trayasamanvitaḥ /	upekṣā āyuḥ manaḥ yuktaḥ vaśyam traya samanvitaḥ 
SA_T07_vabhdiku-196	caturbhiḥ kāyasukhavān cakṣuṣmānapi pañcabhiḥ // Abhidh-d_99 //	caturbhiḥ kāya sukhavān cakṣuṣmān api pañcabhiḥ 
SA_T07_vabhdiku-197	strīndriyādyanvito 'ṣṭābhiḥ duḥkhī yuktastu saptabhiḥ /	strī indriya ādi anvitaḥ ṣṭābhiḥ duḥkhī yuktaḥ tu saptabhiḥ 
SA_T07_vabhdiku-198	ekādaśabhirantyābhyāṃ sapta ṣaḍbhistadādyavān // Abhidh-d_100 //	ekādaśabhiḥ antyābhyām sapta ṣaḍbhiḥ tad ādya vān 
SA_T07_vabhdiku-199	tridvīpanarakotpannā mithyātvaniyatā api /	tri dvīpa naraka utpannāḥ mithyātva niyatāḥ api 
SA_T07_vabhdiku-200	bahubhiḥ hyekānnaviṃśatyā svalpairaṣṭābhiranvitāḥ // Abhidh-d_101 //	bahubhiḥ hi eka anna viṃśatyā su alpaiḥ aṣṭābhiḥ anvitāḥ 
SA_T07_vabhdiku-201	antarābhavikapretatiryakśraddhānusāriṇaḥ /	            
SA_T07_vabhdiku-202	tryadhikairdaśabhiryuktā daśabhirvā navādhikaiḥ // Abhidh-d_102 //	tri adhikaiḥ daśabhiḥ yuktāḥ daśabhiḥ vā nava adhikaiḥ 
SA_T07_vabhdiku-203	samyaktvaniyatā ye tu ye ca śraddhādhimuktikāḥ /	samyaktva niyatāḥ ye tu ye ca śraddhā adhimuktikāḥ 
SA_T07_vabhdiku-204	ta ekādaśabhiryuktā daśabhirvā navādhikaiḥ // Abhidh-d_103 //	te ekādaśabhiḥ yuktāḥ daśabhiḥ vā nava adhikaiḥ 
SA_T07_vabhdiku-205	prajñāvimuktanāmārhat kāyasākṣyubhayāhvayāḥ /	              
SA_T07_vabhdiku-206	akṣaikādaśakopetā yadi vāṣṭādaśānvitāḥ // Abhidh-d_104 //	akṣa ekādaśaka upetāḥ yadi vā aṣṭādaśa anvitāḥ 
SA_T07_vabhdiku-207	kāmadevā mṛtāḥ svalpairdaśabhiḥ saptakādhikaiḥ /	kāmadevāḥ mṛtāḥ su alpaiḥ daśabhiḥ saptaka adhikaiḥ 
SA_T07_vabhdiku-208	ta evaikonaviṃśatyā yuktā bahubhirindriyaiḥ // Abhidh-d_105 //	te eva ekonaviṃśatyā yuktāḥ bahubhiḥ indriyaiḥ 
SA_T07_vabhdiku-209	dvirdhyāna jāstu sarvālpairdaśabhiḥ pañcakādhikaiḥ /	dvis dhyāna jāḥ tu sarva alpaiḥ daśabhiḥ pañcaka adhikaiḥ 
SA_T07_vabhdiku-210	daśabhiḥ sacatuṣkaistu śubhakṛtsnāḥ samanvitāḥ // Abhidh-d_106 //	daśabhiḥ sa catuṣkaiḥ tu śubhakṛtsnāḥ samanvitāḥ 
SA_T07_vabhdiku-211	bṛhatphalā hi atyalpaistrayodaśabhiranvitāḥ /	bṛhat phalāḥ hi ati alpaiḥ trayodaśabhiḥ anvitāḥ 
SA_T07_vabhdiku-212	yuktāḥ ṣoḍaśabhistvete sarvabhūribhindriyaiḥ // Abhidh-d_107 //	yuktāḥ ṣoḍaśabhiḥ tu ete sarva bhūribhiḥ indriyaiḥ 
SA_T07_vabhdiku-213	aṣṭābhirdaśabhiḥ saikairārūpyāḥ svalpabhūribhiḥ /	aṣṭābhiḥ daśabhiḥ sa ekaiḥ ārūpyāḥ su alpa bhūribhiḥ 
SA_T07_vabhdiku-214	sadevakauravāḥ sattvāstrayodaśabhiranvitāḥ // Abhidh-d_108 //	sa deva kauravāḥ sattvāḥ trayodaśabhiḥ anvitāḥ 
SA_T07_vabhdiku-215	aṣṭābhirniḥśubho yukto daśabhirvā trayādhikaiḥ /	aṣṭābhiḥ niḥśubhaḥ yuktaḥ daśabhiḥ vā traya adhikaiḥ 
SA_T07_vabhdiku-216	dviliṅgāḥ paścimaiḥ svalpairviśatyāpyekayā param // Abhidh-d_109 //	dvi liṅgāḥ paścimaiḥ su alpaiḥ viśati ā api ekayā param 
SA_T07_vabhdiku-217	saptadravyāvinirbhāgī paramāṇurbahirgataḥ /	sapta dravya avinirbhāgī paramāṇuḥ bahis gataḥ 
SA_T07_vabhdiku-218	kāmeṣvekādhikaḥ kāye dvyadhikaścakṣurādiṣu // Abhidh-d_110 //	kāmeṣu eka adhikaḥ kāye dvi adhikaḥ cakṣuḥ ādiṣu 
SA_T07_vabhdiku-219	evaṃ rūpe 'pi vijñeyo hitvā gandharasadvayam /	evam rūpe vijñeyaḥ hitvā gandha rasa dvayam 
SA_T07_vabhdiku-220	cittaṃ caitasikaiḥ sārdhaṃ saṃskṛtaṃ tu svalakṣaṇaiḥ // Abhidh-d_111 //	cittam caitasikaiḥ sārdham saṃskṛtam tu sva lakṣaṇaiḥ 
SA_T07_vabhdiku-221	daśadharmā mahābhaumā vitsaṃjñācetanāsmṛtiḥ /	daśa dharmāḥ mahābhaumāḥ vid saṃjñā cetanā smṛtiḥ 
SA_T07_vabhdiku-222	chandaḥ sparśo 'dhimokṣaśca dhīḥ samādhirmanaskṛtiḥ // Abhidh-d_112 //	chandaḥ sparśaḥ dhi mokṣaḥ ca dhīḥ samādhiḥ manaskṛtiḥ 
SA_T07_vabhdiku-223	śraddhāpekṣāpramādaśca prasrabdhirhrīrapatrapā /	śraddhā apekṣā apramādaḥ ca prasrabdhiḥ hrīḥ apatrapā 
SA_T07_vabhdiku-224	mūlavīryamahiṃsā ca śubhabhūkā daśasmṛtāḥ // Abhidh-d_113 //	mūlavīryam ahiṃsā ca śubhabhūkāḥ daśa smṛtāḥ 
SA_T07_vabhdiku-225	styānaṃ pramattirāśraddhyamālasyaṃ mūḍhiruddhatiḥ /	styānam pramattiḥ āśraddhyam ālasyam mūḍhiḥ uddhatiḥ 
SA_T07_vabhdiku-226	kliṣṭe ṣaṭ aśubhe tu dve āhrīkyamanapatrapā // Abhidh-d_114 //	kliṣṭe ṣaṣ aśubhe tu dve āhrīkyam anapatrapā 
SA_T07_vabhdiku-227	māyāśāṭhyamadakrodhavihiṃserṣyāpradaṣṭayaḥ /	māyā śāṭhya mada krodha vihiṃsā īrṣyā pradaṣṭayaḥ 
SA_T07_vabhdiku-228	sūkṣmopanāhamātsaryāṇyalpakleśabhuvo daśa // Abhidh-d_115 //	sūkṣma upanāha mātsaryāṇi alpa kleśa bhuvaḥ daśa 
SA_T07_vabhdiku-229	pṛthivyādi yathā dravyaṃ nīlādiguṇayogataḥ /	pṛthivī ādi yathā dravyam nīla ādi guṇa yogataḥ 
SA_T07_vabhdiku-230	taistairviśeṣyate śabdaiścaittayogānmanastathā // Abhidh-d_116 //	taiḥ taiḥ viśeṣyate śabdaiḥ caitta yogāt manaḥ tathā 
SA_T07_vabhdiku-231	bhūtabhautikanānātvaṃ svarūpehākṛtaṃ yathā /	bhūta bhautika nānātvam svarūpa iha ākṛtam yathā 
SA_T07_vabhdiku-232	tathaiva cittacaittānāṃ pṛthaktvamupadhāryatām // Abhidh-d_117 //	tathā eva citta caittānām pṛthaktvam upadhāryatām 
SA_T07_vabhdiku-233	yathā saṃbandhisaṃbandhādvikāro 'mbhasi lakṣyate /	yathā saṃbandhi saṃbandhāt vikāraḥ mbhasi lakṣyate 
SA_T07_vabhdiku-234	tathā saṃsargisaṃsargāccetovikṛtirīkṣyatām // Abhidh-d_118 //	tathā saṃsargi saṃsargāt cetaḥ vikṛtiḥ īkṣyatām 
SA_T07_vabhdiku-235	guṇo viśeṣaṇaṃ dharmo mātrāvṛttistathāśrayī /	guṇaḥ viśeṣaṇam dharmaḥ mātrā vṛttiḥ tathā āśrayī 
SA_T07_vabhdiku-236	ityevamādayaḥ śabdāḥ pradhānāpekṣavṛttayaḥ // Abhidh-d_119 //	iti evamādayaḥ śabdāḥ pradhāna apekṣa vṛttayaḥ 
SA_T07_vabhdiku-237	cittaṃ pradhānameteṣāṃ vastumātragrahādibhiḥ /	cittam pradhānam eteṣām vastu mātra graha ādibhiḥ 
SA_T07_vabhdiku-238	bījaṃ caitatpravṛttīnāṃ śuddhisaṃkarayorapi // Abhidh-d_120 //	bījam ca etat pravṛttīnām śuddhi saṃkarayoḥ api 
SA_T07_vabhdiku-239	abhyudgacchati kāmāptaṃ dharmairdvādaśabhiḥ saha /	abhyudgacchati kāma āptam dharmaiḥ dvādaśabhiḥ saha 
SA_T07_vabhdiku-240	akliṣṭāvyākṛtaṃ cittaṃ raśmivāniva raśmibhiḥ // Abhidh-d_121 //	akliṣṭa avyākṛtam cittam raśmivān iva raśmibhiḥ 
SA_T07_vabhdiku-241	tathāṣṭādaśabhiścittairnivṛtaṃ jāyate manaḥ /	tathā aṣṭādaśabhiḥ cittaiḥ nivṛtam jāyate manaḥ 
SA_T07_vabhdiku-242	dvāviṃśatyā sahāvaśyaṃ śubhaṃ bhavati mānasam // Abhidh-d_122 //	dvāviṃśatyā saha avaśyam śubham bhavati mānasam 
SA_T07_vabhdiku-243	cetasossaha viṃśatyā cittamutpadyate 'śubham /	cetasoḥ saha viṃśatyā cittam utpadyate śubham 
SA_T07_vabhdiku-244	dṛṅmohamātrayuktaṃ yat krodhādyaistvadhikaṃ vadet // Abhidh-d_123 //	dṛś moha mātra yuktam yat krodha ādyaiḥ tu adhikam vadet 
SA_T07_vabhdiku-245	sarvatra saṃbhavānmiddhaṃ yatra syāttatra nirdiśet /	sarvatra saṃbhavāt middham yatra syāt tatra nirdiśet 
SA_T07_vabhdiku-246	tadvadeva ca kaukṛtyamadhikaṃ gaṇayetkvacit // Abhidh-d_124 //	tadvat eva ca kaukṛtyam adhikam gaṇayet kvacid 
SA_T07_vabhdiku-247	sāśubhaṃ middhakaukṛtyaṃ rūpadhātau na vidyate /	sa aśubham middha kaukṛtyam rūpadhātau na vidyate 
SA_T07_vabhdiku-248	dhyānāntare vitarkaśca vicāraścāpi nopari // Abhidh-d_125 //	dhyāna antare vitarkaḥ ca vicāraḥ ca api na upari 
SA_T07_vabhdiku-249	saṃprayuktaḥ saṃskāraḥ samatā yasya pañcadhā /	saṃprayuktaḥ saṃskāraḥ sama tā yasya pañcadhā 
SA_T07_vabhdiku-250	viprayuktaśca boddhavyaḥ samatā yasya nāstyasau // Abhidh-d_126 //	viprayuktaḥ ca boddhavyaḥ sama tā yasya na asti asau 
SA_T07_vabhdiku-251	viśiṣṭānāmasadbhāvātprasaṃgo nāsti rūpiṇām /	viśiṣṭānām asadbhāvāt prasaṃgaḥ nā asti rūpiṇām 
SA_T07_vabhdiku-252	saṃskāragrahaṇāccaiva khādīnāṃ na prasajyate // Abhidh-d_127 //	saṃskāra grahaṇāt ca eva kha ādīnām na prasajyate 
SA_T07_vabhdiku-253	prāptyādayastu saṃskārā viprayuktāstrayodaśa /	prāpti ādayaḥ tu saṃskārāḥ viprayuktāḥ trayodaśa 
SA_T07_vabhdiku-254	āptoktisvakriyāliṅgā liṅgameṣāṃ gadiṣyate // Abhidh-d_128 //	āpta ukti sva kriyā liṅgāḥ liṅgam eṣām gadiṣyate 
SA_T07_vabhdiku-255	rāptiḥ samanvitirlabdhirdharmavattā vyavasthitiḥ // Abhidh-d_129 //	rāptiḥ samanvitiḥ labdhiḥ dharmavat tā vyavasthitiḥ 
SA_T07_vabhdiku-256	śrutacintāmayānāṃ ca samāpattidvayasya ca // Abhidh-d_130 //	śruta cintā mayānām ca samāpatti dvayasya ca 
SA_T07_vabhdiku-257	niḥkleśasaṃskṛtāpūrvaṃ śubhānāṃ tu rajasvatām /	niḥkleśa saṃskṛta apūrvam śubhānām tu rajasvatām 
SA_T07_vabhdiku-258	ādilābhe saha prākca tadūrdhvaṃ vā tridheṣyate // Abhidh-d_131 //	ādi lābhe saha prāk ca tad ūrdhvam vā tridhā iṣyate 
SA_T07_vabhdiku-259	kliṣṭāṇāṃ kuśalānāṃ ca tadanyeṣāṃ tridhā matā /	kliṣṭāṇām kuśalānām ca tad anyeṣām tridhā matā 
SA_T07_vabhdiku-260	nivṛtāvyākṛtā jñānanirmāṇamanasāṃ tathā // Abhidh-d_132 //	nivṛta avyākṛtāḥ jñāna nirmāṇa manasām tathā 
SA_T07_vabhdiku-261	nirvāṇasyādito lābhe nityasyānyasya sarvadā /	nirvāṇasya āditas lābhe nityasya anyasya sarvadā 
SA_T07_vabhdiku-262	ajā tavartamānā ca kadācittu tridheṣyate // Abhidh-d_133 //	ajā ta vartamānā ca kadācid tu tridhā iṣyate 
SA_T07_vabhdiku-263	ekārtharuciheturyaḥ sattvānāṃ sa sabhāgatā /	eka artha ruci hetuḥ yaḥ sattvānām sa sabhāgatā 
SA_T07_vabhdiku-264	āsaṃjñikaṃ vipāko yaccittopacchedyasaṃjñiṣu // Abhidh-d_134 //	āsaṃjñikam vipākaḥ yat citta upacchedya saṃjñiṣu 
SA_T07_vabhdiku-265	śubhāsaṃjñisamāpattirdhyāne 'ntye cittarodhinī /	śubha asaṃjñi samāpattiḥ dhyāne ntye citta rodhinī 
SA_T07_vabhdiku-266	niḥsṛtīcchāpravṛttitvāt nāryasya āpyā prayogataḥ // Abhidh-d_135 //	niḥsṛti icchā pravṛtti tvāt na āryasya āpyā prayogataḥ 
SA_T07_vabhdiku-267	nirodhākhyā tu vijñeyā vijihīrṣorbhavāgrajā /	nirodha ākhyā tu vijñeyā vijihīrṣoḥ bhava agra jā 
SA_T07_vabhdiku-268	śubhāryasya prayogāpyā dvivedyāniyatā matā // Abhidh-d_136 //	śubha āryasya prayogāpyā dvi vedyā niyatā matā 
SA_T07_vabhdiku-269	cetaścatuṣṭayāyogādāgamādupapattitaḥ /	cetaḥ catuṣṭaya ayogāt āgamāt upapattitaḥ 
SA_T07_vabhdiku-270	nirveditamanobhāvātsiddhyatīyamacittikā // Abhidh-d_137 //	nirvedita manaḥ bhāvāt siddhyati iyam acittikā 
SA_T07_vabhdiku-271	gatiprajñaptyupādānamāyuścittoṣmaṇoḥ sthitiḥ /	gati prajñapti upādānam āyuḥ citta ūṣmaṇoḥ sthitiḥ 
SA_T07_vabhdiku-272	āgamādyuktitaścaiva dravyatastatsadiṣyate // Abhidh-d_138 //	āgama ādi uktitaḥ ca eva dravyataḥ tat sat iṣyate 
SA_T07_vabhdiku-273	jātiḥ sthitirjarānāśaḥ saṃskṛtāṅkacaṣṭatuyī /	jātiḥ sthitiḥ jarā nāśaḥ 
SA_T07_vabhdiku-274	catvāri sthitināstitve hetutvādyaprasiddhitaḥ // Abhidh-d_139 //	catvāri sthiti nāstitve hetu tva ādi aprasiddhitaḥ 
SA_T07_vabhdiku-275	śaktihānerjarāsiddhiḥ nānyatvāt pariṇāmitā /	śakti hāneḥ jarā siddhiḥ na anya tvāt pariṇāmi tā 
SA_T07_vabhdiku-276	ekakāritranāśābhyāṃ śaktihāniḥ prasiddhyati // Abhidh-d_140 //	eka kāritra nāśābhyām śakti hāniḥ 
SA_T07_vabhdiku-277	sati janmani tadbhāvād dravyakāritranāśataḥ /	sati janmani tad bhāvāt dravya kāritra nāśataḥ 
SA_T07_vabhdiku-278	āgamādupapatteśca vināśo 'pi sahetukaḥ // Abhidh-d_141 //	āgamāt upapatteḥ ca vināśaḥ api sa hetukaḥ 
SA_T07_vabhdiku-279	vākchabdādhīnajanmānaḥ svārthapratyāyanakriyāḥ /	vāc śabda adhīna janmānaḥ sva artha pratyāyana kriyāḥ 
SA_T07_vabhdiku-280	saṃjñādyaparanāmānastrayo nāmādayaḥ smṛtāḥ // Abhidh-d_142 //	saṃjñā ādi apara nāmānaḥ trayaḥ nāma ādayaḥ smṛtāḥ 
SA_T07_vabhdiku-281	anye nāmādayaḥ śabdādaprāptārthaprakāśanāt /	anye nāma ādayaḥ śabdāt aprāpta artha prakāśanāt 
SA_T07_vabhdiku-282	anityāste tu vijñeyāḥ sāpekṣārthavibhāvanāt // Abhidh-d_143 //	anityāḥ te tu vijñeyāḥ sa apekṣā artha vibhāvanāt 
SA_T07_vabhdiku-283	svarūpaṃ vedayaṃścchabdo vyañjanādīni ca dhruvam /	svarūpam vedayan śabdaḥ vyañjana ādīni ca dhruvam 
SA_T07_vabhdiku-284	arthapratyāyakaḥ prājñarbhaktikalpanayocyate // Abhidh-d_144 //	artha pratyāyakaḥ 
SA_T07_vabhdiku-285	paramāṇusvabhāvatvād ghoṣaikatvaṃ na yujyate /	paramāṇu svabhāva tvāt ghoṣa eka tvam na yujyate 
SA_T07_vabhdiku-286	tādātmyaṃ pratighātitvāt tatsiddhirvaraṇādibhiḥ // Abhidh-d_145 //	tādātmyam pratighāti tvāt tad siddhiḥ varaṇa ādibhiḥ 
SA_T07_vabhdiku-287	sphoṭākhyo nāparo ghoṣācchabdo nityaḥ prasiddhyati /	sphoṭa ākhyaḥ nā aparaḥ ghoṣāt śabdaḥ nityaḥ prasiddhi ati 
SA_T07_vabhdiku-288	kramavṛtterna śabdena kaścidartho 'bhidhīyate // Abhidh-d_146 //	krama vṛtteḥ na śabdena kaścid arthaḥ bhidhīyate 
SA_T07_vabhdiku-289	na śrutyā śrūyate śabdastadanyā ca gatiḥ śruteḥ /	na śrutyā śrūyate śabdaḥ tad anyā ca gatiḥ śruteḥ 
SA_T07_vabhdiku-290	yo brūyātsa svamātmānaṃ vidvadbhirapahāsayet // Abhidh-d_147 //	yaḥ brūyāt sa svam ātmānam vidvadbhiḥ apahāsayet 
SA_T07_vabhdiku-291	pratidyotyaṃ yathāyogaṃ niyatāniyatāśca te /	pratidyotyam yathāyogam niyata a niyatāḥ ca te 
SA_T07_vabhdiku-292	niyatodbhāvanād buddhaḥ sarvajña iti gamyate // Abhidh-d_148 //	niyata udbhāvanāt buddhaḥ sarvajñaḥ iti gamyate 
SA_T07_vabhdiku-293	sattvākhyāḥ kāmarūpāptā niṣyandāvyākṛtāstathā /	sattva ākhyāḥ kāmarūpa āptāḥ nisyanda avyākṛtāḥ tathā 
SA_T07_vabhdiku-294	tathaiva ca vipākaśca sābhāgyaṃ prāptayo dvidhā // Abhidh-d_149 //	tathā eva ca vipākaḥ ca sābhāgyam prāptayaḥ dvidhā 
SA_T07_vabhdiku-295	sattvākhyopadravābhāvānna caturthe 'sti sūtrataḥ /	sattva ākhya upadrava abhāvāt na caturthe sti sūtrataḥ 
SA_T07_vabhdiku-296	vimānasya samatvasya pradhvaṃsānnityatā kutaḥ // Abhidh-d_150 //	vimānasya sama tvasya pradhvaṃsāt nitya tā kutas 
SA_T07_vabhdiku-297	sapta tejobhirekādbhirgate 'dbhiḥ saptake punaḥ /	sapta tejobhiḥ eka adbhiḥ gate dbhiḥ saptake punar 
SA_T07_vabhdiku-298	tejasā saptakāntyaikā vāyusaṃvartanī tataḥ // Abhidh-d_151 //	tejasā sapta kāntyā ekā vāyu saṃvartanī tatas 
SA_T07_vabhdiku-299	āgneyātsaptakādekaḥ pāvanīkimanantaram /	āgneyāt saptakāt ekaḥ 
SA_T07_vabhdiku-300	āyuṣparigrahādevaṃ śubhakṛtsnāyuredhanam // Abhidh-d_152 //	āyuṣparigrahāt evam śubhakṛtsna āyuḥ edhanam 
SA_T07_vabhdiku-301	vātādidoṣasādharmyātsattvānāṃ tadvināśakāḥ /	vāta ādi doṣa sādharmyāt sattvānām tad vināśakāḥ 
SA_T07_vabhdiku-302	ādhyātmiketi sārūpyānna bhūsaṃvartanī matā // Abhidh-d_153 //	ādhyātmikā iti sārūpyāt na bhū saṃvartanī matā 
SA_T07_vabhdiku-303	sattvopapattihetūnāṃ vipatsaṃpadvidhāyinām /	sattva upapatti hetūnām vipad saṃpad vidhāyinām 
SA_T07_vabhdiku-304	lokavacitryakartṛṇāṃ karma heturitīṣyate // Abhidh-d_154 //	karma hetuḥ iti iṣyate 
SA_T07_vabhdiku-305	kāyikaṃ vāṅmayaṃ caiva cetanākhyaṃ ca mānasam /	kāyikam vāc mayam ca eva cetanā ākhyam ca mānasam 
SA_T07_vabhdiku-306	karmāṇyetāni lokasya kāraṇaṃ neśvarādayaḥ // Abhidh-d_155 //	karmāṇi etāni lokasya kāraṇam na īśvara ādayaḥ 
SA_T07_vabhdiku-307	vaiśvarūpyātkramotpādāttadvadanyatprasaṅgataḥ /	vaiśvarūpyāt krama utpādāt tadvat anyat prasaṅgataḥ 
SA_T07_vabhdiku-308	nānyāpekṣā tapoyogo pakṣahānyādidoṣataḥ // Abhidh-d_156 //	na anya apekṣā pakṣa hāni ādi doṣataḥ 
SA_T07_vabhdiku-309	karmaṇāṃ bodhyate śaktirvidhikālagrahādibhiḥ /	karmaṇām bodhyate śaktiḥ vidhi kāla graha ādibhiḥ 
SA_T07_vabhdiku-310	yato 'tasteṣu tācchabdyaṃ gauṇyā vṛttyā prayujyate // Abhidh-d_157 //	yatas taḥ teṣu tācchabdyam gauṇyā vṛttyā prayujyate 
SA_T07_vabhdiku-311	pūrve vijñaptyavijñaptī cetanā mānasī kriyā // Abhidh-d_158 //	pūrve vijñapti avijñaptī cetanā mānasī kriyā 
SA_T07_vabhdiku-312	annamatyagninirdagdhaṃ yathā sthālī ca saṃskṛtā /	annam atyagni nirdagdham yathā sthālī ca saṃskṛtā 
SA_T07_vabhdiku-313	pāpadṛṣṭestathā śīlaṃ śāṭhyerṣyādikṣatātmanaḥ // Abhidh-d_159 //	pāpa dṛṣṭeḥ tathā śīlam śāṭhya īrṣyā ādi kṣata ātmanaḥ 
SA_T07_vabhdiku-314	saṃvṛtsaddṛṣṭyupetāto bhikṣutvaṃ paramārthataḥ /	saṃvṛt sat dṛṣṭi upetā atas bhikṣu tvam paramārthataḥ 
SA_T07_vabhdiku-315	ekasampattu saṃvṛtyā dvayābhāve dvidhāpi na // Abhidh-d_160 //	eka sampad tu saṃvṛtyā dvaya abhāve dvidhā api na 
SA_T07_vabhdiku-316	vigatāvaṇe jñāne buddhoktermukhyakalpanā /	vigata avaṇe jñāne buddha ukteḥ mukhya kalpanā 
SA_T07_vabhdiku-317	tadāśraye phale cāpi vijñeyā guṇakalpanā // Abhidh-d_161 //	tad āśraye phale ca api vijñeyā guṇa kalpanā 
SA_T07_vabhdiku-318	śāśvatatvaśubhatvābhyāṃ sarvānarthanivṛttitaḥ /	śāśvata tva śubha tvābhyām sarva anartha nivṛttitaḥ 
SA_T07_vabhdiku-319	mukhyakalpanayā tadvaddharmo nirvāṇamucyate // Abhidh-d_162 //	mukhya kalpanayā tadvat dharmaḥ nirvāṇam ucyate 
SA_T07_vabhdiku-320	āryāḥ śiṣyaguṇāḥ saṃghastathaiva paramārthataḥ /	āryāḥ śiṣya guṇāḥ saṃghaḥ tathā eva paramārthataḥ 
SA_T07_vabhdiku-321	etānyo yāti śaraṇaṃ sa yāti śaraṇatrayam // Abhidh-d_163 //	etān yaḥ yāti śaraṇam sa yāti śaraṇa trayam 
SA_T07_vabhdiku-322	mithyācāraḥ satāṃ garhyātparatrākaraṇāptitaḥ /	mithyā ācāraḥ satām garhyāt paratra akaraṇa āptitaḥ 
SA_T07_vabhdiku-323	pāpiṣṭhatvānmṛṣāvādo madyapānaṃ smṛtikṣayātū // Abhidh-d_164 //	pāpiṣṭha tvāt mṛṣāvādaḥ madya pānam smṛti kṣayātū 
SA_T07_vabhdiku-324	sarvebhyo vartamānebhyo dvividhebhyo 'pi kāmajaḥ /	sarvebhyaḥ vartamānebhyaḥ dvividhebhyaḥ kāma jaḥ 
SA_T07_vabhdiku-325	trikālebhyastu maulebhyo labhyete bhāvanāmayau // Abhidh-d_165 //	tri kālebhyaḥ tu maulebhyaḥ labhyete bhāvanā mayau 
SA_T07_vabhdiku-326	sarvebhyaḥ sattvajātibhyaḥ saṃvaro vāṅgakāraṇaiḥ /	sarvebhyaḥ sattva jātibhyaḥ saṃvaraḥ vā aṅga kāraṇaiḥ 
SA_T07_vabhdiku-327	sarvebhyo saṃvarāṅgebhyaḥ sattvebhyaśca na kāraṇaiḥ // Abhidh-d_166 //	sarvebhyaḥ saṃvara aṅgebhyaḥ sattvebhyaḥ ca na kāraṇaiḥ 
SA_T07_vabhdiku-328	kriyayāsaṃvarapraptiḥ sa hābhyupagamena vā /	kriyayā a saṃvara praptiḥ sa ha abhyupagamena vā 
SA_T07_vabhdiku-329	avijñaptirato 'nyasyāḥ kṣetrāṅgādiviśeṣataḥ // Abhidh-d_167 //	avijñaptiḥ atas nyasyāḥ kṣetra aṅga ādi viśeṣataḥ 
SA_T07_vabhdiku-330	kāmāptasaṃvaratyāgaḥ śikṣānikṣepaṇādibhiḥ /	kāma āpta saṃvara tyāgaḥ śikṣā nikṣepaṇa ādibhiḥ 
SA_T07_vabhdiku-331	patanīyarapītyeke tannetyanye tvayogataḥ // Abhidh-d_168 //	tat na iti anye tu ayogataḥ 
SA_T07_vabhdiku-332	ayogo nāṃśuvidhvaṃsātpaṭadravyaṃ vinaśyati /	ayogaḥ na aṃśu vidhvaṃsāt paṭa dravyam vinaśyati 
SA_T07_vabhdiku-333	sūtre dhvaṃsoktiranyārthā yatherṣyāśaṭhanādiṣu // Abhidh-d_169 //	sūtre dhvaṃsa uktiḥ anya arthā yathā īrṣyā śaṭhana ādiṣu 
SA_T07_vabhdiku-334	saddharmāntarddhito 'nye 'nye nāpūrvāpratilambhataḥ /	saddharma antarddhitaḥ nye nye na apūrva apratilambhataḥ 
SA_T07_vabhdiku-335	bhūsaṃcāreṇa hānyā ca tyajyate dhyānajaṃ śubham // Abhidh-d_170 //	bhū saṃcāreṇa hānyā ca tyajyate dhyāna jam śubham 
SA_T07_vabhdiku-336	tathārūpyāptamāryantu phalāptyakṣavihānibhiḥ /	phala āpti akṣa vihānibhiḥ 
SA_T07_vabhdiku-337	asaṃvaro damaprāptirjīvitotsarjanā dibhiḥ // Abhidh-d_171 //	asaṃvaraḥ dama prāptiḥ jīvita utsarjanā ā dibhiḥ 
SA_T07_vabhdiku-338	cittavegādivicchedairavijñaptistu madhyamā /	citta vega ādi vicchedaiḥ avijñaptiḥ tu madhyamā 
SA_T07_vabhdiku-339	kāmāptaṃ kuśalaṃ nāma tribhirmūlacchidādibhiḥ // Abhidh-d_172 //	kāmāptam kuśalam nāma tribhiḥ mūlacchid ādibhiḥ 
SA_T07_vabhdiku-340	pratipakṣodayātkliṣṭaṃ tridhātvāptaṃ vihīyate /	pratipakṣa udayāt kliṣṭam tridhātu āptam vihīyate 
SA_T07_vabhdiku-341	sarve kāmeṣu rūpe dvāveko 'rūpiṣu lābhataḥ // Abhidh-d_173 //	sarve kāmeṣu rūpe dvau ekaḥ rūpiṣu lābhataḥ 
SA_T07_vabhdiku-342	yadiṣṭaphaladaṃ karma kuśalaṃ tadudāhṛtam /	yat iṣṭa phala dam karma kuśalam tat udāhṛtam 
SA_T07_vabhdiku-343	viparyayeṇākuśalamavyākṛtamato 'nyathā // Abhidh-d_174 //	viparyayeṇa akuśalam avyākṛtam atas nyathā 
SA_T07_vabhdiku-344	kāmāptaṃ prathamaṃ puṇyamapuṇyamaśubhātmakam /	kāma āptam prathamam puṇyam apuṇyam aśubha ātmakam 
SA_T07_vabhdiku-345	ūrdhvabhūmikamānejyaṃ vipākaṃ pratyanejanāt // Abhidh-d_175 //	ūrdhvabhūmikam ānejyam vipākam pratyanejanāt 
SA_T07_vabhdiku-346	sukhavedyaṃ śubhaṃ karma dhyānādarvākturīyakāt /	sukha vedyam śubham karma dhyānāt arvāk turīyakāt 
SA_T07_vabhdiku-347	upekṣāvedyamanyatra duḥkhavedyantu pāpakam // Abhidh-d_176 //	upekṣā vedyam anyatra duḥkha vedyan tu pāpakam 
SA_T07_vabhdiku-348	adho 'pi madhyamaṃ karma dhyānenāntyepi nirvṛteḥ /	madhyamam karma dhyānena antye pi nirvṛteḥ 
SA_T07_vabhdiku-349	yugapattrivipākeṣṭerdhyānāntaravipākataḥ // Abhidh-d_177 //	yugapad tri vipāka iṣṭeḥ dhyāna antara vipākataḥ 
SA_T07_vabhdiku-350	punaścaturvidhaṃ karma dṛṣṭavedyādibhedataḥ /	punar caturvidham karma dṛṣṭa vedya ādi bhedataḥ 
SA_T07_vabhdiku-351	janmanastribhirākṣepo dṛṣṭadharmāhvayādṛte // Abhidh-d_178 //	janmanaḥ tribhiḥ ākṣepaḥ dṛṣṭa dharma āhvayāt ṛte 
SA_T07_vabhdiku-352	caturṇāmapi cākṣepaḥ sarvatra narakādṛte /	caturṇām api ca ākṣepaḥ sarvatra narakāt ṛte 
SA_T07_vabhdiku-353	na tatreṣṭaphalābhāvācchubhaṃ yasmādvipacyate // Abhidh-d_179 //	na tatra iṣṭa phala abhāvāt śubham yasmāt vipacyate 
SA_T07_vabhdiku-354	notpadyavedyakṛttatra yadviraktaḥ pṛthagjanaḥ /	na utpadya vedya kṛt tatra yat viraktaḥ pṛthagjanaḥ 
SA_T07_vabhdiku-355	sthiro nāparakṛccāryaścalo 'pi bhavamūlayoḥ // Abhidh-d_180 //	sthiraḥ bhava mūlayoḥ 
SA_T07_vabhdiku-356	yadārtraraudracittena karmābhīkṣṇaṃ niṣevyate /	yadā ārtra raudra cittena karma abhīkṣṇam niṣevyate 
SA_T07_vabhdiku-357	satkṣetre kriyate yacca phalaṃ tasya niyamyate // Abhidh-d_181 //	sat kṣetre kriyate yat ca phalam tasya niyamyate 
SA_T07_vabhdiku-358	kṣetrāśayaviśeṣācca phalaṃ sadyo vipacyate /	kṣetra āśaya viśeṣāt ca phalam sadyas vipacyate 
SA_T07_vabhdiku-359	nirodhavyutthitādau ca sadyaḥ kālaphalakriyā // Abhidh-d_182 //	nirodha vyutthita ādau ca sadyas kāla phala kriyā 
SA_T07_vabhdiku-360	tadbhūmyapunarutpatteḥ vipākaniyataṃ ca yat /	tad bhūmi apunarutpatteḥ vipāka niyatam ca yat 
SA_T07_vabhdiku-361	tacca dṛṣṭaphalaṃ vidyāt karmādaḥ paripūrakam // Abhidh-d_183 //	tat ca dṛṣṭa phalam vidyāt karma adaḥ paripūrakam 
SA_T07_vabhdiku-362	kuśalasyāvicārasya caitasikyeva vedanā /	kuśalasya avicārasya caitasikī eva vedanā 
SA_T07_vabhdiku-363	vipākaḥ kāyikī tviṣṭā duḥkhavedyasya karmaṇaḥ // Abhidh-d_184 //	vipākaḥ kāyikī tu iṣṭā duḥkha vedyasya karmaṇaḥ 
SA_T07_vabhdiku-364	sapākamaśubhaṃ kṛṣṇaṃ sapākaṃ rūpajaṃ sitam /	sa pākam aśubham kṛṣṇam sa pākam rūpa jam sitam 
SA_T07_vabhdiku-365	śubhāśubhaṃ dvidhā kāme nirmalaṃ tatprahāṇakṛt // Abhidh-d_185 //	śubha aśubham dvidhā kāme nirmalam tad prahāṇa kṛt 
SA_T07_vabhdiku-366	casasro dṛkpathā dṛṣṭau cetanābhāvanāpathāt /	ca sasraḥ dṛkpathāḥ dṛṣṭau cetanā bhāvanā pathāt 
SA_T07_vabhdiku-367	ānantaryapathāḥ kāme karmaitatkṛṣṇanāśakṛt // Abhidh-d_186 //	ānantarya pathāḥ kāme karma etat kṛṣṇa nāśa kṛt 
SA_T07_vabhdiku-368	navame cetanā yā tu sā kṛṣṇākṛṣṇayāghātinī /	navame cetanā yā tu sā kṛṣṇa akṛṣṇayā āghātinī 
SA_T07_vabhdiku-369	antānantaryamārgasthā dhyāne dhyāne sitasya tu // Abhidh-d_187 //	anta ānantarya mārga sthāḥ dhyāne dhyāne sitasya tu 
SA_T07_vabhdiku-370	kāyādyakuśalaṃ karma sarvaṃ duścaritaṃ matam /	kāya ādi akuśalam karma sarvam duścaritam matam 
SA_T07_vabhdiku-371	abhidhyādīnyapi trīṇi manoduścaritatrayam // Abhidh-d_188 //	abhidhyā ādīni api trīṇi manaḥ duścarita trayam 
SA_T07_vabhdiku-372	śubhaṃ tatsānabhidhyādi proktaṃ sucaritatrayam /	śubham tat sa anabhidhyā ādi proktam su carita trayam 
SA_T07_vabhdiku-373	dvayaṃmaulamadaḥ karma mārgā daśa śubhāśubhāḥ // Abhidh-d_189 //	dvayam maula madaḥ karma mārgāḥ daśa śubha aśubhāḥ 
SA_T07_vabhdiku-374	kāritāḥ ṣaḍavijñaptirdvyātmaikaste 'pi ṣaṭ kṛtāḥ /	kāritāḥ ṣaṣ avijñaptiḥ dvi ātmā ekaḥ te pi ṣaṭ kṛtāḥ 
SA_T07_vabhdiku-375	śubhāḥ sapta dvidhā jñeyā ekadhaite samāhitāḥ // Abhidh-d_190 //	śubhāḥ sapta dvidhā jñeyāḥ ekadhā ete samāhitāḥ 
SA_T07_vabhdiku-376	yā sāmanteṣvavijñaptiḥ pṛṣṭheṣu tu viparyayaḥ /	yā sāmanteṣu avijñaptiḥ pṛṣṭheṣu tu viparyayaḥ 
SA_T07_vabhdiku-377	prayogastu trimūlotthaḥ abhidhyādyāstrimūlajāḥ // Abhidh-d_191 //	prayogaḥ tu tri mūla utthaḥ abhidhyā ādyāḥ tri mūla jāḥ 
SA_T07_vabhdiku-378	kuśalāḥ prayogapṛṣṭhāśca kuśalatrayamūlajāḥ /	kuśalāḥ prayoga pṛṣṭhāḥ ca kuśala traya mūla jāḥ 
SA_T07_vabhdiku-379	dveṣeṇa vadhapāruṣyavyāpattīnāṃ samāpanam // Abhidh-d_192 //	dveṣeṇa vadha pāruṣya vyāpattīnām samāpanam 
SA_T07_vabhdiku-380	steyasyānyāṅganāyāterabhidhyāyāśca lobhataḥ /	steyasya anya aṅganā āyāteḥ abhidhyāyāḥ ca lobhataḥ 
SA_T07_vabhdiku-381	mithyādṛśastu mohena tadanyeṣāṃ tribhirmatam // Abhidh-d_193 //	mithyādṛśaḥ tu mohena tad anyeṣām tribhiḥ matam 
SA_T07_vabhdiku-382	caturṇāmapyadhiṣṭhānaṃ jñeyameṣāṃ yathākramam /	caturṇām api adhiṣṭhānam jñeyam eṣām yathākramam 
SA_T07_vabhdiku-383	prāṇinaścātha bhogāśca nāmarūpaṃ ca nāma ca // Abhidh-d_194 //	prāṇinaḥ ca atha bhogāḥ ca nāma rūpam ca nāma ca 
SA_T07_vabhdiku-384	prāṇātipāto dhīpūrvamabhrāntyā paramāraṇam /	prāṇa atipātaḥ dhī pūrvam abhrāntyā para māraṇam 
SA_T07_vabhdiku-385	atyaktānyadhanādānamadattādānamucyate // Abhidh-d_195 //	a tyakta anya dhana ādānam adatta ādānam ucyate 
SA_T07_vabhdiku-386	parastrīgamanaṃ kāmamithyācāro vikalpavān /	para strī gamanam kāma mithyā ācāraḥ vikalpavān 
SA_T07_vabhdiku-387	arthajñāyānyathāvādo drohabuddhyā mṛṣāvacaḥ // Abhidh-d_196 //	artha jñāya anyathāvādaḥ droha buddhyā mṛṣāvacaḥ 
SA_T07_vabhdiku-388	dṛṣṭayā śrutyādibhiścākṣairmanasā yacca gṛhyate /	dṛṣṭayā śruti ādibhiḥ ca akṣaiḥ manasā yat ca gṛhyate 
SA_T07_vabhdiku-389	dṛṣṭaṃ śrutaṃ mataṃ jñātamityuktaṃ tadyathākramam // Abhidh-d_197 //	dṛṣṭam śrutam matam jñātam iti uktam tat yathākramam 
SA_T07_vabhdiku-390	paiśunyaṃ bhedakṛdvākyaṃ pāruṣyaṃ tu yadapriyam /	paiśunyam bheda kṛt vākyam pāruṣyam tu yat apriyam 
SA_T07_vabhdiku-391	kliṣṭaṃ saṃbhinnalāpitvamanye gītakathādivat // Abhidh-d_198 //	kliṣṭam saṃbhinna lāpi tvam anye gīta kathā ādi vat 
SA_T07_vabhdiku-392	parasvāsatspṛhābhidhyā vyāpādaḥ sattvagocaraḥ /	para sva asat spṛhā abhidhyā vyāpādaḥ sattva gocaraḥ 
SA_T07_vabhdiku-393	vidveṣānānantadṛṣṭistu mithyādṛṣṭirahetukā // Abhidh-d_199 //	vidveṣa an ananta dṛṣṭiḥ tu mithyādṛṣṭiḥ ahetukā 
SA_T07_vabhdiku-394	cetanā na kriyāmārgastaistu sattā pravartate /	cetanā na kriyā mārgaḥ taiḥ tu sattā pravartate 
SA_T07_vabhdiku-395	yugapadyāvadaṣṭābhiraśubhaiścetanaiḥ saha // Abhidh-d_200 //	yugapad yāvat aṣṭābhiḥ aśubhaiḥ cetanaiḥ saha 
SA_T07_vabhdiku-396	śubhaistu daśabhiryāvatsārdhaṃ naikāṣṭapañcabhiḥ /	śubhaiḥ tu daśabhiḥ yāvat sārdham na eka aṣṭa pañcabhiḥ 
SA_T07_vabhdiku-397	vilāpadveṣapāruṣyāṇyuṣanti narake dvidhā // Abhidh-d_201 //	vilāpa dveṣa pāruṣyāṇi uṣanti narake dvidhā 
SA_T07_vabhdiku-398	tadvadeva matābhidhyā mithyādṛṣṭistathaiva ca /	tadvat eva mata abhidhyā mithyādṛṣṭiḥ tathā eva ca 
SA_T07_vabhdiku-399	abhidhyāditrayaṃ tadvatkurau pralapanaṃ dvidhā // Abhidh-d_202 //	abhidhyā ādi trayam tadvat kurau pralapanam dvidhā 
SA_T07_vabhdiku-400	aśubhāstu daśānyatra sarvatra kuśalāstrayaḥ /	aśubhāḥ tu daśa anyatra sarvatra kuśalāḥ trayaḥ 
SA_T07_vabhdiku-401	ārūpyāryāsaṃjñināṃ ca rūpiṇaḥ sapta lābhataḥ // Abhidh-d_203 //	ārūpya ārya asaṃjñinām ca rūpiṇaḥ sapta lābhataḥ 
SA_T07_vabhdiku-402	kurūnsanarakānhitvā sarvatrānyatra te dvidhā /	kurūn sa narakān hitvā sarvatra anyatra te dvidhā 
SA_T07_vabhdiku-403	sarve vipākaniṣyandādhipatyaphaladā daśa // Abhidh-d_204 //	sarve vipāka nisyanda ādhipatya phala dāḥ daśa 
SA_T07_vabhdiku-404	duḥkhopasaṃhṛterduḥkhamalpāyuṣṭvantu māraṇāt /	duḥkha upasaṃhṛteḥ duḥkham alpa āyuḥ tvam tu māraṇāt 
SA_T07_vabhdiku-405	tejonāśātkṛśaujastvamidaṃ tattrividhaṃ phalam // Abhidh-d_205 //	tejaḥ nāśāt kṛśa ojaḥ tvam idam tat trividham phalam 
SA_T07_vabhdiku-406	ānantaryapathe karma phalavatpañcabhiḥ phalaiḥ /	ānantarya pathe karma phalavat pañcabhiḥ phalaiḥ 
SA_T07_vabhdiku-407	caturbhistvamalenāryaṃ tadvadanyacchabhāśubham // Abhidh-d_206 //	caturbhiḥ tu amalena āryam tadvat anyat śabhāśubham 
SA_T07_vabhdiku-408	tato 'nyannirmalaṃ jñeyaṃ tribhiravyākṛtaṃ tathā /	tatas jñeyam tribhiḥ avyākṛtam tathā 
SA_T07_vabhdiku-409	phalaṃ śubhasya catvāri dve trīṇi ca śubhādayaḥ // Abhidh-d_207 //	phalam śubhasya catvāri dve trīṇi ca śubha ādayaḥ 
SA_T07_vabhdiku-410	śubhādyāstvaśubhasya dve trīṇi catvāri ca kramāt /	śubha ādyāḥ tu aśubhasya dve trīṇi catvāri ca kramāt 
SA_T07_vabhdiku-411	avyākṛtasya te tu dve trīṇi trīṇi śubhādayaḥ // Abhidh-d_208 //	avyākṛtasya te tu dve trīṇi trīṇi śubha ādayaḥ 
SA_T07_vabhdiku-412	sarve catvāryatītasya madhyamasya ca bhāvinaḥ /	sarve catvāri atītasya madhyamasya ca bhāvinaḥ 
SA_T07_vabhdiku-413	madhyamā dve svakasyaiva trīṇyanāgāmijanmanaḥ // Abhidh-d_209 //	madhyamā dve svakasya eva trīṇi anāgāmi janmanaḥ 
SA_T07_vabhdiku-414	catvāryekabhuvo dve vā trīṇi cāparabhūmikāḥ /	catvāri eka bhuvaḥ dve vā trīṇi ca apara bhūmikāḥ 
SA_T07_vabhdiku-415	śaikṣādyāstrīṇi śaikṣasya ta evāśaikṣakarmaṇaḥ // Abhidh-d_210 //	śaikṣa ādyāḥ trīṇi śaikṣasya te eva aśaikṣa karmaṇaḥ 
SA_T07_vabhdiku-416	ekaṃ trīṇi dvayaṃ caiva śaikṣādyāḥ paścimasya tu /	ekam trīṇi dvayam ca eva śaikṣa ādyāḥ paścimasya tu 
SA_T07_vabhdiku-417	dve dve pañca yathāsaṃkhyaṃ dṛggheyasya tu karmaṇaḥ // Abhidh-d_211 //	dve dve pañca yathāsaṃkhyam dṛś heyasya tu karmaṇaḥ 
SA_T07_vabhdiku-418	trīṇi catvāri caikaṃ ca dṛṣṭiheyādayaḥ smṛtāḥ /	trīṇi catvāri ca ekam ca dṛṣṭi heya ādayaḥ smṛtāḥ 
SA_T07_vabhdiku-419	te tvabhyāsapraheyasya dve catvāri tridhā matāḥ // Abhidh-d_212 //	te tu abhyāsa praheyasya dve catvāri tridhā matāḥ 
SA_T07_vabhdiku-420	kramādekadvicatvāri te tvaheyasya karmaṇaḥ /	kramāt eka dvi catvāri te tu aheyasya karmaṇaḥ 
SA_T07_vabhdiku-421	ekenākṣipyatejanma bhūribhiḥ paripūryate // Abhidh-d_213 //	ekena ākṣipyate janma bhūribhiḥ paripūryate 
SA_T07_vabhdiku-422	kuśalaṃ vāthavā pāpaṃ yadatītaṃ dadatphalam /	kuśalam vā athavā pāpam yat atītam dadat phalam 
SA_T07_vabhdiku-423	svaṃ kāyavāṅmanaskarma sā karmasvakatā matā // Abhidh-d_214 //	svam kāya vāc manaḥ karma sā karma svaka tā matā 
SA_T07_vabhdiku-424	saṃvṛtyā skandhasantāne tatkriyāphaladarśanāt /	saṃvṛtyā skandha santāne tad kriyā phala darśanāt 
SA_T07_vabhdiku-425	kartṛtā bhoktṛtā coktā niṣiddhā śāśvatasya tu // Abhidh-d_215 //	kartṛ tā bhoktṛ tā ca uktā niṣiddhā śāśvatasya tu 
SA_T07_vabhdiku-426	syātkarmasvakatā nāsti tasya ceti catuṣkikā /	syāt karma svaka tā na asti tasya ca iti catuṣkikā 
SA_T07_vabhdiku-427	prathamā tatphalasthasya vihānāttasya karmaṇaḥ // Abhidh-d_216 //	prathamā tad phala sthasya vihānāt tasya karmaṇaḥ 
SA_T07_vabhdiku-428	dvitīyā tatphalasthasya karmaṇā tena cānvayāt /	dvitīyā tad phala sthasya karmaṇā tena ca anvayāt 
SA_T07_vabhdiku-429	tṛtīyobhayayuktasya caturthyanubhayasya tu // Abhidh-d_217 //	tṛtīyā ubhaya yuktasya caturthī anubhayasya tu 
SA_T07_vabhdiku-430	syātkarmasvakatā nāpi tatphalaṃ vedayiṣyati /	syāt karma svaka tā nā api tad phalam vedayiṣyati 
SA_T07_vabhdiku-431	tatphalāvasthitasyādyā jñeyā taccarame phale // Abhidh-d_218 //	tad phala avasthitasya ādyā jñeyā tad carame phale 
SA_T07_vabhdiku-432	dvitīyā dhruvapākasya tadvipākānavasthite /	dvitīyā dhruva pākasya tad vipāka anavasthite 
SA_T07_vabhdiku-433	tṛtīyā dvayasadbhāvā caturthī tūbhayaṃ vinā // Abhidh-d_219 //	tṛtīyā dvaya sadbhāvā caturthī tu ubhayam vinā 
SA_T07_vabhdiku-434	syātkarmaṇānvitaścaiva no ca tatphalavedanam /	syāt karmaṇā anvitaḥ ca eva no ca tad phala vedanam 
SA_T07_vabhdiku-435	ādyā dattavipākena niruddhānāgatādinā // Abhidh-d_220 //	ādyāḥ datta vipākena niruddha anāgata ādinā 
SA_T07_vabhdiku-436	dvitīyā tu vihīnena dhruvapākena karmaṇā /	dvitīyā tu vihīnena dhruva pākena karmaṇā 
SA_T07_vabhdiku-437	tṛtīyā dvayamuktasya caturthī tu dvayādṛte // Abhidh-d_221 //	tṛtīyā dvaya muktasya caturthī tu dvayāt ṛte 
SA_T07_vabhdiku-438	ayuktavihitaṃ karma kleśopakleśadūṣitam /	ayukta vihitam karma kleśa upakleśa dūṣitam 
SA_T07_vabhdiku-439	śikṣāliṅgādyapetaṃ ca kecidāhurvipaścitaḥ // Abhidh-d_222 //	śikṣā liṅga ādi apetam ca kecid āhuḥ vipaścitaḥ 
SA_T07_vabhdiku-440	bodhisattvaḥ kuto yāvadavivartyamanā yataḥ /	bodhisattvaḥ kutas yāvat a vivartya manāḥ yatas 
SA_T07_vabhdiku-441	badhnāti bodhisannāhamaṅgīkṛtvā jagaddhitam // Abhidh-d_223 //	badhnāti bodhi sannāham aṅgīkṛtvā jagat hitam 
SA_T07_vabhdiku-442	yadā lākṣaṇikaṃ karma prakarotyanapāyagaḥ /	yadā lākṣaṇikam karma prakaroti anapāya gaḥ 
SA_T07_vabhdiku-443	mahākulaḥ samagrākṣaḥ svaparṣatsaṃgrahe rataḥ // Abhidh-d_224 //	mahā kulaḥ samagra akṣaḥ sva parṣad saṃgrahe rataḥ 
SA_T07_vabhdiku-444	pumāñjātismaro vāgmī prajñāvīryakriyānvitaḥ /	pumān jātismaraḥ vāgmī prajñā vīrya kriyā anvitaḥ 
SA_T07_vabhdiku-445	tadā devamanuṣyāṇāmabhivyaktiṃ nigacchati // Abhidh-d_225 //	tadā deva manuṣyāṇām abhivyaktim nigacchati 
SA_T07_vabhdiku-446	sa hi tribhirasaṃkhyeyairdharmakāyaguṇārṇavam /	sa hi tribhiḥ asaṃkhyeyaiḥ dharmakāya guṇa arṇavam 
SA_T07_vabhdiku-447	pracinoti tadādhāraṃ kāyaṃ kalpaśatena tu // Abhidh-d_226 //	pracinoti tad ādhāram kāyam kalpa śatena tu 
SA_T07_vabhdiku-448	dvātriṃśallakṣaṇopetamaśītivyañja nojjvalam /	dvātriṃśat lakṣaṇa upetam aśīti vyañja na ujjvalam 
SA_T07_vabhdiku-449	dviṣatāmapi yaṃ dṛṣṭvā manaḥ sadyaḥ prasīdati // Abhidh-d_227 //	dviṣatām api yam dṛṣṭvā manaḥ sadyas prasīdati 
SA_T07_vabhdiku-450	yugāntavāyunā meruḥ vahninā varuṇālayaḥ /	yugānta vāyunā meruḥ vahninā varuṇālayaḥ 
SA_T07_vabhdiku-451	vajreṇa dhvasyate vajramavikāri tu tanmanaḥ // Abhidh-d_228 //	vajreṇa dhvasyate vajram avikāri tu tat manaḥ 
SA_T07_vabhdiku-452	kāmāptaṃ ṣaṣṭhajaṃ tredhā kṛpāśraddhāparamparam /	kāma āptam ṣaṣṭha jam tredhā kṛpā śraddhā paramparam 
SA_T07_vabhdiku-453	buddhotpāde naraḥ strī vā tadādyaṃ cittamaśnute // Abhidh-d_229 //	buddha utpāde naraḥ strī vā tad ādyam cittam aśnute 
SA_T07_vabhdiku-454	sarvebhyaḥ sarvadā sarvaṃ vadato dānapūraṇam /	sarvebhyaḥ sarvadā sarvam vadataḥ dāna pūraṇam 
SA_T07_vabhdiku-455	maraṇe 'pi damātyāgaḥ śīlasyotkṛṣṭirucyate // Abhidh-d_230 //	maraṇe dama atyāgaḥ śīlasya utkṛṣṭiḥ ucyate 
SA_T07_vabhdiku-456	vīryasya tiṣyasaṃstutyā dhiyo vajropamātparam /	vīryasya tiṣya saṃstutyā dhiyaḥ vajra upamāt param 
SA_T07_vabhdiku-457	'sarvāsāṃ tu kṣayajñāne paripūrirvidhīyate' // Abhidh-d_231 //	sarvāsām tu kṣaya jñāne paripūriḥ vidhīyate 
SA_T07_vabhdiku-458	tripuṇyakṛtivastvādyāstallābhopāyadeśanāḥ /	tri puṇya kṛti vastu ādyāḥ tad lābha upāya deśanāḥ 
SA_T07_vabhdiku-459	tathā caturadhiṣṭhānaṃ saptasaddharmaśāsanam // Abhidh-d_232 //	tathā catur adhiṣṭhānam sapta saddharma śāsanam 
SA_T07_vabhdiku-460	saptayogāstrayaḥskandhāstriśikṣādyāśca deśitāḥ /	sapta yogāḥ trayaḥ skandhāḥ tri śikṣā ādyāḥ ca deśitāḥ 
SA_T07_vabhdiku-461	tathā pāramitāścāpi catasro vinayoditāḥ // Abhidh-d_233 //	tathā pāramitāḥ ca api catasraḥ vinaya uditāḥ 
SA_T07_vabhdiku-462	bodhipakṣyāśca kaṇṭhoktāḥ saptatriṃśatsvayaṃbhuvā /	bodhi pakṣyāḥ ca kaṇṭha uktāḥ saptatriṃśat svayaṃbhuvā 
SA_T07_vabhdiku-463	hetavaḥ sarvabodhināṃ trividhā mṛdutādibhiḥ // Abhidh-d_234 //	hetavaḥ sarva bodhinām trividhāḥ mṛdu tā ādibhiḥ 
SA_T07_vabhdiku-464	tasmānna bodhimārgo 'nyaḥ sūtrādipiṭakatrayāt /	tasmāt na bodhi mārgaḥ nyaḥ sūtra ādi piṭaka trayāt 
SA_T07_vabhdiku-465	ato 'nyamiha yo brūyātsa bhavenmārabhāṣitaḥ // Abhidh-d_235 //	atas yaḥ brūyāt sa bhavet māra bhāṣitaḥ 
SA_T07_vabhdiku-466	kalpānāṃ mahatāmetadasaṃkhyeyatrayaṃ matam /	kalpānām mahatām etat asaṃkhyeya trayam matam 
SA_T07_vabhdiku-467	sthānāntaramasaṃkhyākhyamadaḥsaṃkhyopari sthitam // Abhidh-d_236 //	sthāna antaram asaṃkhya ākhyam adaḥ saṃkhyā upari sthitam 
SA_T07_vabhdiku-468	apakarṣe jinotpattiryāvacchatasamāyuṣaḥ /	apakarṣe jina utpattiḥ yāvat śata sama āyuṣaḥ 
SA_T07_vabhdiku-469	dvayoḥ pratyekabuddhānāmutkarṣe cakravartinām // Abhidh-d_237 //	dvayoḥ pratyekabuddhānām utkarṣe cakravartinām 
SA_T07_vabhdiku-470	nādho 'śītisahasrāyostatsamutpattiriṣyate /	na adho śīti sahasra āyoḥ tad samutpattiḥ iṣyate 
SA_T07_vabhdiku-471	te hemarūpyatāmrāyaścakrāḥ puṇyaprabhāvataḥ // Abhidh-d_238 //	te hema rūpya tāmra ayaḥ cakrāḥ puṇya prabhāvataḥ 
SA_T07_vabhdiku-472	tulye 'pi sādhanopāye tadbhedo 'kṣādibhedataḥ /	tulye sādhana upāye kṣā ādi bhedataḥ 
SA_T07_vabhdiku-473	bhavamokṣārthinormātroḥ pradānaphalabhedavat // Abhidh-d_239 //	bhava mokṣa arthinoḥ mātroḥ pradāna phala bheda vat 
SA_T07_vabhdiku-474	karuṇābhāvanodrekātsvasaṃviccittayostathā /	karuṇā bhāvanā udrekāt sva saṃvid cittayoḥ tathā 
SA_T07_vabhdiku-475	parasaṃvidgurostadvattadviśeṣo vidhīyate // Abhidh-d_240 //	para saṃvid guroḥ tadvat tad viśeṣaḥ vidhīyate 
SA_T07_vabhdiku-476	hetutattvaphalodbhūtaṃ mahattvaṃ śāsitustridhā /	hetu tattva phala udbhūtam mahattvam śāsituḥ tridhā 
SA_T07_vabhdiku-477	vimuktāvapi tulyāyāṃ trayāṇāṃ bodhilambhanāt // Abhidh-d_241 //	vimuktau api tulyāyām trayāṇām bodhi lambhanāt 
SA_T07_vabhdiku-478	buddhasya saṃmukhīnasya bauddhamākṣipyate vapuḥ /	buddhasya saṃmukhīnasya bauddham ākṣipyate vapuḥ 
SA_T07_vabhdiku-479	saikapuṇyaśatodbhūtamekaikaṃ lakṣaṇaṃ muneḥ // Abhidh-d_242 //	sa eka puṇya śata udbhūtam ekaikam lakṣaṇam muneḥ 
SA_T07_vabhdiku-480	yathākarmapathāstadvatpuṇyāditrayamiṣyate /	yathā karma pathāḥ tadvat puṇya ādi trayam iṣyate 
SA_T07_vabhdiku-481	dānaṃ hi dīyate yena svaparārthādyapekṣayā // Abhidh-d_243 //	dānam hi dīyate yena sva para artha ādi apekṣayā 
SA_T07_vabhdiku-482	kāyādikarma tattattvamavijñaptiḥ kvacitpunaḥ /	kāya ādi karma tat tattvam avijñaptiḥ kvacid punar 
SA_T07_vabhdiku-483	prādhānyānmuninā proktaṃ mahābhogaphalaṃ hi tat // Abhidh-d_244 //	prādhānyāt muninā proktam mahā bhoga phalam hi tat 
SA_T07_vabhdiku-484	svānyobhayārthasiddhyarthaṃ dānaṃ dadati kecana /	sva anya ubhaya artha siddhi artham dānam dadati kecana 
SA_T07_vabhdiku-485	sādhuvṛttyanuvṛtyarthaṃ nobhayārthāya cāpare // Abhidh-d_245 //	sādhu vṛtti anuvṛti artham na ubhaya arthāya ca apare 
SA_T07_vabhdiku-486	dātṛvastvādivaiśiṣṭyāttatphalātiśayaḥ smṛtaḥ /	dātṛ vastu ādi vaiśiṣṭyāt tad phala atiśayaḥ smṛtaḥ 
SA_T07_vabhdiku-487	śraddhādibhirguṇairdātā datte 'taḥ satkriyādibhiḥ // Abhidh-d_246 //	śraddhā ādibhiḥ guṇaiḥ dātā datte satkriyā ādibhiḥ 
SA_T07_vabhdiku-488	satkārādiguṇopetaṃ phalaṃ tasmādavāpnute /	satkāra ādi guṇa upetam phalam tasmāt avāpnute 
SA_T07_vabhdiku-489	vastu varṇādisaṃpannaṃ saurūpyādi phalapradam // Abhidh-d_247 //	vastu varṇa ādi saṃpannam saurūpya ādi phala pradam 
SA_T07_vabhdiku-490	guṇaduḥkhopakārākhyardharmaiḥ kṣetraṃ viśiṣyate /	guṇa duḥkha upakāra ākhyaḥ dharmaiḥ kṣetram viśiṣyate 
SA_T07_vabhdiku-491	āśayādi mṛdutvādermṛdutvādīni karmaṇaḥ // Abhidh-d_248 //	āśaya ādi mṛdu tva ādeḥ mṛdu tva ādīni karmaṇaḥ 
SA_T07_vabhdiku-492	dharmadātre 'pi bālāya pitre mātre 'tha rogiṇe /	dharma dātre pi bālāya pitre mātre tha rogiṇe 
SA_T07_vabhdiku-493	ameyaṃ bodhisattvāya dānamanyabhavāya ca // Abhidh-d_249 //	ameyam bodhisattvāya dānam anya bhavāya ca 
SA_T07_vabhdiku-494	bodhisattvasya yaddānamanyasyāpi yadaṣṭamam /	bodhisattvasya yat dānam anyasya api yat aṣṭamam 
SA_T07_vabhdiku-495	vipaścidbhistadākhyātaṃ śreṣṭhaṃ yaccārhato 'rhate // Abhidh-d_250 //	vipaścidbhiḥ tat ākhyātam śreṣṭham yat ca arhataḥ rhate 
SA_T07_vabhdiku-496	saṃpradhārya yadākṣiptaṃ pūraṇādidṛḍhīkṛtam /	saṃpradhārya yat ākṣiptam pūraṇa ādi dṛḍhīkṛtam 
SA_T07_vabhdiku-497	vigatapratipakṣaṃ ca tatkarmopacitaṃ matam // Abhidh-d_251 //	vigata pratipakṣam ca tat karma upacitam matam 
SA_T07_vabhdiku-498	svasmāttyāgaguṇāpekṣāścaittāścaityārcatādiṣu /	svasmāt tyāga guṇa apekṣāḥ caittāḥ caityārcatā ādiṣu 
SA_T07_vabhdiku-499	vinā pratigṛhītrāpi phalaṃ maitrīvihāravat // Abhidh-d_252 //	vinā pratigṛhītrā api phalam maitrī vihāra vat 
SA_T07_vabhdiku-500	dharmadānasvabhāvo vāktattvanāmādigocaraḥ /	              
SA_T07_vabhdiku-501	avyākṛtasvabhāvatvānna nāmādyannadānavat // Abhidh-d_253 //	avyākṛta svabhāva tvāt na nāma ādi anna dāna vat 
SA_T07_vabhdiku-502	śīlaṃ śubhamayaṃ rūpaṃ vyākhyātaṃ tatprabhedataḥ /	śīlam śubha mayam rūpam vyākhyātam tad prabhedataḥ 
SA_T07_vabhdiku-503	śāstre tu tappradhānatvātproktaṃ svargopapattaye // Abhidh-d_254 //	śāstre tu tad pradhāna tvāt proktam svarga upapattaye 
SA_T07_vabhdiku-504	dauḥśīlyāśubhamūlādyairdoṣairyanna vidūṣitam /	dauḥśīlya aśubha mūla ādyaiḥ doṣaiḥ yat na vidūṣitam 
SA_T07_vabhdiku-505	tadvipakṣaśamāṅgaṃ ca yattacchadvamihocyate // Abhidh-d_255 //	tad vipakṣa śama aṅgam ca yat tat chadvam iha ucyate 
SA_T07_vabhdiku-506	puṇyaṃ samāhitaṃ tvatra bhāvanā cittabhāvanāt /	puṇyam samāhitam tu atra bhāvanā citta bhāvanāt 
SA_T07_vabhdiku-507	pradhānyādapavargāya taduktaṃ sarvadarśinā // Abhidh-d_256 //	pradhānyāt apavargāya tat uktam sarvadarśinā 
SA_T07_vabhdiku-508	puṇyanirvāṇabhāgīyaṃ nirvedhānuguṇaṃ tathā /	puṇya nirvāṇa bhāgīyam nirvedha anuguṇam tathā 
SA_T07_vabhdiku-509	śāsane 'sminsamāsena śubhamūlaṃ tridheṣyate // Abhidh-d_257 //	śāsane smin samāsena śubha mūlam tridhā iṣyate 
SA_T07_vabhdiku-510	lipimudrātha gaṇanā kāyavākkarmalakṣaṇā /	             
SA_T07_vabhdiku-511	saṃkhyā khalvapi vijñeyā manaskarmasvabhāvikā // Abhidh-d_258 //	saṃkhyā khalu api vijñeyā manaḥ karma svabhāvikā 
SA_T07_vabhdiku-512	akāryapravaṇo loko duḥkhabhāgī ca yadvaśāt /	akārya pravaṇaḥ lokaḥ duḥkha bhāgī ca yad vaśāt 
SA_T07_vabhdiku-513	rāgādīn bhavasaṃbandhānkleśānvakṣyāmi tānaham // Abhidh-d_259 //	rāga ādīn bhava saṃbandhān kleśān vakṣyāmi tān aham 
SA_T07_vabhdiku-514	svaśaktijakriyodbhūtairviśeṣaiste tu nāmabhiḥ /	sva śakti ja kriyā udbhūtaiḥ viśeṣaiḥ te tu nāmabhiḥ 
SA_T07_vabhdiku-515	āttasāmānyasaṃjñākāścodyante 'nuśayādibhiḥ // Abhidh-d_260 //	ātta sāmānya saṃjñākāḥ codyante nu śaya ādibhiḥ 
SA_T07_vabhdiku-516	rāgapratighasaṃmohamānakāṅkṣākudṛṣṭayaḥ /	rāga pratigha saṃmoha māna kāṅkṣā kudṛṣṭayaḥ 
SA_T07_vabhdiku-517	ṣaḍete 'nuśayāḥ proktāḥ śreyodvāravibandhinaḥ // Abhidh-d_261 //	ṣaṭ ete nuśayāḥ proktāḥ śreyaḥ dvāra vibandhinaḥ 
SA_T07_vabhdiku-518	rāgadvedhāt matāḥ sapta dṛṣṭibhedāddaśa smṛtāḥ /	rāga dvedhāt matāḥ sapta dṛṣṭi bhedāt daśa smṛtāḥ 
SA_T07_vabhdiku-519	bhūyo 'ṣṭānavatirjñeyā dhātvākārādibhedataḥ // Abhidh-d_262 //	bhūyas ṣṭānavatiḥ jñeyā dhātu ākāra ādi bhedataḥ 
SA_T07_vabhdiku-520	kāmarāgo bhavākhyaśca dvidhāḥ rāgaḥ prabhidyate /	kāma rāgaḥ bhava ākhyaḥ ca dvidhāḥ rāgaḥ prabhidyate 
SA_T07_vabhdiku-521	prāyo bahiṣpravṛttatvādantarvattyādibhedataḥ // Abhidh-d_263 //	prāyas bahiṣpravṛtta tvāt antarvatti ādi bhedataḥ 
SA_T07_vabhdiku-522	satkāyāntadvayagrāhau mithyādarśanameva ca /	sat kāya anta dvaya grāhau mithyā darśanam eva ca 
SA_T07_vabhdiku-523	dṛṣṭiśīlavratāmarśāvityetāḥ pañca dṛṣṭayaḥ // Abhidh-d_264 //	dṛṣṭi śīla vrata āmarśau iti etāḥ pañca dṛṣṭayaḥ 
SA_T07_vabhdiku-524	daśeha duḥkhadṛggheyāḥ sapta hetvīkṣaṇakṣayāḥ /	daśā iha duḥkha dṛś heyāḥ sapta hetu īkṣaṇa kṣayāḥ 
SA_T07_vabhdiku-525	saptāpavargadṛggheyāḥ aṣṭau mārgekṣaṇakṣayāḥ // Abhidh-d_265 //	sapta apavarga dṛś heyāḥ aṣṭau mārga īkṣaṇa kṣayāḥ 
SA_T07_vabhdiku-526	dṛṣṭiheyāvalambitvātsadākāraparigrahāt /	dṛṣṭi heya avalambi tvāt sat ākāra parigrahāt 
SA_T07_vabhdiku-527	rāgādayastu catvāro jñeyā mārgadvayakṣayāḥ // Abhidh-d_266 //	rāga ādayaḥ tu catvāraḥ jñeyāḥ mārga dvaya kṣayāḥ 
SA_T07_vabhdiku-528	pratikalpavaśotpatterdṛṣṭikāṅkṣe tu dṛkkṣaye /	pratikalpa vaśa utpatteḥ dṛṣṭi kāṅkṣe tu dṛkkṣaye 
SA_T07_vabhdiku-529	rūpepyevaṃ tathārūpye pratighānuśayādṛte // Abhidh-d_267 //	rūpe ipi evam tathā ārūpye pratigha anuśayāt ṛte 
SA_T07_vabhdiku-530	bhavāgre kṣāntiheyā ye dṛggheyā eva te matāḥ /	bhava agre kṣānti heyāḥ ye dṛś heyāḥ eva te matāḥ 
SA_T07_vabhdiku-531	jñānavadhyāstu ye tasminnabhyāsenaiva tatkṣayaḥ // Abhidh-d_268 //	jñāna vadhyāḥ tu ye tasmin abhyāsena eva tad kṣayaḥ 
SA_T07_vabhdiku-532	ahaṃ mameti yā dṛṣṭirasau satkāyadṛk smṛtā /	aham mama iti yā dṛṣṭiḥ asau sat kāya dṛś smṛtā 
SA_T07_vabhdiku-533	taducchedadhruvagrāhau yau sāntargrāhadṛṅmatā // Abhidh-d_269 //	tad uccheda dhruva grāhau yau sā antar grāha dṛś matā 
SA_T07_vabhdiku-534	phalahetvapavādo yaḥ sā mithyādṛṣṭirucyate /	phala hetu apavādaḥ yaḥ sā mithyādṛṣṭiḥ ucyate 
SA_T07_vabhdiku-535	jñeyo dṛṣṭiparāmarśaḥ hīnavastūttamagrahaḥ // Abhidh-d_270 //	jñeyaḥ dṛṣṭi parāmarśaḥ hīna vastu uttama grahaḥ 
SA_T07_vabhdiku-536	ahetāvapathe caiva taddhi śīlavratāhvayaḥ /	ahetau apathe ca eva tat hi śīla vrata āhvayaḥ 
SA_T07_vabhdiku-537	duḥkhabhrāntyapathādānāttadṛṣṭyutsārya eva saḥ // Abhidh-d_271 //	duḥkha bhrānti apatha ādānāt tad dṛṣṭi utsāryaḥ eva saḥ 
SA_T07_vabhdiku-538	satkāyadṛṣṭyavacchedo dharmamātrekṣaṇādyataḥ /	sat kāya dṛṣṭi avacchedaḥ dharma mātra īkṣaṇa ādi atas 
SA_T07_vabhdiku-539	duḥkhābhisamaye tacca taddṛggheyaiva so 'pyataḥ // Abhidh-d_272 //	duḥkha abhisamaye tat ca tad dṛś heyā eva saḥ u pi atas 
SA_T07_vabhdiku-540	dvayaṃ dṛṣṭiparāmarśādekaḥ satkāyadṛṣṭitaḥ /	dvayam dṛṣṭi parāmarśāt ekaḥ sat kāya dṛṣṭitaḥ 
SA_T07_vabhdiku-541	antargrāhārdhamanyastu viparyāsaḥ prakalpyate // Abhidh-d_273 //	antar grāha ardham anyaḥ tu viparyāsaḥ prakalpyate 
SA_T07_vabhdiku-542	nitīraṇasamāropaviparītapravṛttitaḥ /	nitīraṇa samāropa viparīta pravṛttitaḥ 
SA_T07_vabhdiku-543	viparyāsoktireṣveva dṛgvaśāt cittasaṃjñayoḥ // Abhidh-d_274 //	viparyāsa uktiḥ eṣu eva dṛś vaśāt citta saṃjñayoḥ 
SA_T07_vabhdiku-544	sapta mānavidhāstribhyo nava mānavidhāstridhā /	sapta māna vidhāḥ tribhyaḥ nava māna vidhāḥ tridhā 
SA_T07_vabhdiku-545	tridhātyunnamanādibhyaḥ svotkarṣādyasti nāstitā // Abhidh-d_275 //	tridhā ati unnamana ādibhyaḥ sva utkarṣa ādi asti nāstitā 
SA_T07_vabhdiku-546	vadhādiparyavasthānaṃ kaukṛtyamaśubhaṃ vidhāḥ /	vadha ādi paryavasthānam kaukṛtyam aśubham vidhāḥ 
SA_T07_vabhdiku-547	vibhavecchā ca nāryasya jāyante hetvabhāvataḥ // Abhidh-d_276 //	vibhava icchā ca nārī asya jāyante hetu abhāvataḥ 
SA_T07_vabhdiku-548	duḥkhātsamudayāccaiva sarvagānāṃ vyavasthitiḥ /	duḥkhāt samudayāt ca eva sarvagānām vyavasthitiḥ 
SA_T07_vabhdiku-549	taddṛṣṭiheyajātīnāṃ sarvāsāṃ dvipadasthiteḥ // Abhidh-d_277 //	tad dṛṣṭi heya jātīnām sarvāsām dvipada sthiteḥ 
SA_T07_vabhdiku-550	kāṅkṣā pañca dṛśo 'vidyā tadvyāmiśrātha kevalāḥ /	kāṅkṣā pañca dṛśaḥ vidyā tad vyāmiśrā atha kevalāḥ 
SA_T07_vabhdiku-551	sapta sarvatragā duḥkhāddhenorebhyaścatuṣṭayam // Abhidh-d_278 //	sapta sarvatragāḥ duḥkhāt henoḥ ebhyaḥ catuṣṭayam 
SA_T07_vabhdiku-552	dravyato daśa caikaśca nāmnā sapta tu te matāḥ /	dravyataḥ daśa ca ekaḥ ca nāmnā sapta tu te matāḥ 
SA_T07_vabhdiku-553	rāgapratighamānāstu paricchedapravartinaḥ // Abhidh-d_279 //	rāga pratigha mānāḥ tu pariccheda pravartinaḥ 
SA_T07_vabhdiku-554	prakārāntaravartitvātsakṛtsarvasvabhūgatiḥ /	prakāra antara varti tvāt sakṛt sarva sva bhū gatiḥ 
SA_T07_vabhdiku-555	dhātvantarāvalambitvātpūrvoktā eva sarvagāḥ // Abhidh-d_280 //	dhātu antara avalambi tvāt pūrva uktāḥ eva sarva gāḥ 
SA_T07_vabhdiku-556	navordhvadhātukāsteṣāmādyā dṛṣṭidvayādṛte /	nava ūrdhvadhātukāḥ teṣām ādyāḥ dṛṣṭi dvayāt ṛte 
SA_T07_vabhdiku-557	teṣāṃ sahabhuvo dharmāḥ prāptivarjyāśca sarvagāḥ // Abhidh-d_281 //	teṣām saha bhuvaḥ dharmāḥ prāpti varjyāḥ ca sarva gāḥ 
SA_T07_vabhdiku-558	kāṅkṣāmithyādṛgābhyāṃ ca miśrāvidyātha kevalā /	kāṅkṣā mithyā dṛgābhyām ca miśrā avidyā atha kevalā 
SA_T07_vabhdiku-559	nirodhamārgadṛggheyāḥ ṣaḍete nirmalekṣiṇaḥ // Abhidh-d_282 //	nirodha mārga dṛś heyāḥ ṣaṭ ete nirmala īkṣiṇaḥ 
SA_T07_vabhdiku-560	svabhūmereva nirvāṇaṃ mārgasthannavabhūmikaḥ /	sva bhūmeḥ eva nirvāṇam mārga sthan nava bhūmikaḥ 
SA_T07_vabhdiku-561	taddṛśyaviṣayo 'nyo 'nyo hetutvāddhetubhāvataḥ // Abhidh-d_283 //	tad dṛśya viṣayaḥ nyaḥ nyaḥ hetu tvāt hetu bhāvataḥ 
SA_T07_vabhdiku-562	na rāgaḥ śaktyahetutvānna dveṣo 'naparādhataḥ /	na rāgaḥ śakti ahetu tvāt na dveṣaḥ na aparādhataḥ 
SA_T07_vabhdiku-563	namāno 'tipraśāntatvānna bhāvatvād dṛśo 'parāḥ // Abhidh-d_284 //	ti praśānta tvāt na bhāva tvāt parāḥ 
SA_T07_vabhdiku-564	sarvago 'nuśayaḥ kṛtsnāmanuśete svadhātugaḥ /	sarvagaḥ nuśayaḥ kṛtsnām anuśete sva dhātu gaḥ 
SA_T07_vabhdiku-565	svāmālambanato bhūmiṃ svanikāyaṃ tvasarvagaḥ // Abhidh-d_285 //	svām ālambanataḥ bhūmim sva nikāyam tu asarvagaḥ 
SA_T07_vabhdiku-566	asvīkārādvipakṣatvānnordhvabhūmārgagocaraḥ /	asvīkārāt vipakṣa tvāt na ūrdhva bhū mārga gocaraḥ 
SA_T07_vabhdiku-567	saṃprayogiṇi tu svasminnahīne saṃprayogataḥ // Abhidh-d_286 //	saṃprayogiṇi tu svasmin ahīne saṃprayogataḥ 
SA_T07_vabhdiku-568	dhātrīvastramalanyāyaiḥ khacarāmbucarakramaiḥ /	                        
SA_T07_vabhdiku-569	ete 'nuśerate yasmāttasmādanuśayāḥ smṛtāḥ // Abhidh-d_287 //	ete nuśerate yasmāt tasmāt anuśayāḥ smṛtāḥ 
SA_T07_vabhdiku-570	svairiṣṭādibhirākāraiḥ paramāṇukṣaṇeṣvapi /	svaiḥ iṣṭa ādibhiḥ ākāraiḥ paramāṇu kṣaṇeṣu api 
SA_T07_vabhdiku-571	yato 'nuśerate caite tataścānuśayā matāḥ // Abhidh-d_288 //	yatas nuśerate ca ete tatas ca anuśayāḥ matāḥ 
SA_T07_vabhdiku-572	ādyaṃ dṛṣṭidvayaṃ kāme nivṛtāvyākṛtaṃ matam /	ādyam dṛṣṭi dvayam kāme nivṛta avyākṛtam matam 
SA_T07_vabhdiku-573	dhātudvaye tu sarve 'pi nivṛtāvyākṛtā malāḥ // Abhidh-d_289 //	dhātu dvaye tu sarve nivṛta avyākṛtāḥ malāḥ 
SA_T07_vabhdiku-574	kāmeṣvakuśalāḥ śeṣāḥ rāgadveṣatamāṃsyataḥ /	kāmeṣu akuśalāḥ śeṣāḥ rāga dveṣa tamāṃsi atas 
SA_T07_vabhdiku-575	trīṇyevāśubhamūlāni pañcakāraṇayogataḥ // Abhidh-d_290 //	trīṇi eva aśubha mūlāni pañca kāraṇa yogataḥ 
SA_T07_vabhdiku-576	avyākṛtadvayasyāpi trīṇi mūlāni tatsamāḥ /	avyākṛta dvayasya api trīṇi mūlāni tad samāḥ 
SA_T07_vabhdiku-577	avidyā dhīśca tṛṣṇā ca na kāṅkṣāmānadṛṣṭayaḥ // Abhidh-d_291 //	avidyā dhīḥ ca tṛṣṇā ca na kāṅkṣā māna dṛṣṭayaḥ 
SA_T07_vabhdiku-578	calatvādūrdhvavṛttitvādavyāpitvādyathākramam /	cala tvāt ūrdhva vṛtti tvāt avyāpi tvāt yathākramam 
SA_T07_vabhdiku-579	sūtrasyārthāparijñānādaheturdhyāyicodanāt // Abhidh-d_292 //	sūtrasya artha aparijñānāt ahetuḥ dhyāyi codanāt 
SA_T07_vabhdiku-580	praśnavyākaraṇānyākhyaccatvāri vadatāṃ varaḥ /	praśna vyākaraṇāni ākhyat catvāri vadatām varaḥ 
SA_T07_vabhdiku-581	śiṣyāṇāṃ vādaśikṣārthaṃ sthitīnāṃ ca catuṣṭayīm // Abhidh-d_293 //	śiṣyāṇām vāda śikṣā artham sthitīnām ca catuṣṭayīm 
SA_T07_vabhdiku-582	ekāṃśākhyaṃ vibhajyākhyaṃ pṛcchākhyaṃ sthāpyameva ca /	eka aṃśa ākhyam vibhajya ākhyam pṛccha ākhyam sthāpyam eva ca 
SA_T07_vabhdiku-583	maraṇaprasavotkarṣajīvadravyānyatādivat // Abhidh-d_294 //	              
SA_T07_vabhdiku-584	sthānavāditvasaṃjñaikā parikalpāhvayā parā /	sthānavādi tva saṃjñā ekā parikalpa āhvayā parā 
SA_T07_vabhdiku-585	anyā pratipadākhyānyā jñānavāditvasaṃjñitā // Abhidh-d_295 //	anyā pratipad ākhyā anyā jñāna vādi tva saṃjñitā 
SA_T07_vabhdiku-586	mānapratighasaṃrāgairvartamāno 'jjhitakriyaiḥ /	māna pratigha saṃrāgaiḥ vartamānaḥ jjhita kriyaiḥ 
SA_T07_vabhdiku-587	jātā yatrāprahīṇāśca saṃyuktastatra vastuni // Abhidh-d_296 //	jātāḥ yatra aprahīṇāḥ ca saṃyuktaḥ tatra vastuni 
SA_T07_vabhdiku-588	ajātairmānasairetaiḥ sarvatrānyaiḥ svakādhvikaiḥ /	ajātaiḥ mānasaiḥ etaiḥ sarvatra anyaiḥ svaka ādhvikaiḥ 
SA_T07_vabhdiku-589	sarvatrājaistathā śeṣaiḥ saṃyuktā skandhasantatiḥ // Abhidh-d_297 //	sarvatra ajaiḥ tathā śeṣaiḥ saṃyuktā skandha santatiḥ 
SA_T07_vabhdiku-590	dvayamevātra niṣpannaṃ tṛtīyaṃ tūpacārataḥ /	dvayam eva atra niṣpannam tṛtīyam tu upacārataḥ 
SA_T07_vabhdiku-591	sadasaddhetutā yasmānmadhyasthaiśca parigrahāt // Abhidh-d_298 //	sat asat hetutā yasmāt madhyasthaiḥ ca parigrahāt 
SA_T07_vabhdiku-592	sarvamasti pradeśo 'sti sarvaṃ nāstīti cāparaḥ /	sarvam asti pradeśaḥ sti sarvam na asti iti ca aparaḥ 
SA_T07_vabhdiku-593	avyākṛtāstivādīti catvāro vādinaḥ smṛtāḥ // Abhidh-d_299 //	avyākṛta astivādī iti catvāraḥ vādinaḥ smṛtāḥ 
SA_T07_vabhdiku-594	ebhyo yaḥ prathamo vādī bhajate sādhutāmasau /	ebhyaḥ yaḥ prathamaḥ vādī bhajate sādhu tām asau 
SA_T07_vabhdiku-595	tarkābhimāninastvanyeyuktyāgamabahiṣkṛtāḥ // Abhidh-d_300 //	tarka abhimāninaḥ tu anye yukti āgama bahiṣkṛtāḥ 
SA_T07_vabhdiku-596	icchatyadhvatrayaṃ yasmāt kṛtyataśca dhruvatrayam /	icchati adhva trayam yasmāt kṛtyataḥ ca dhruva trayam 
SA_T07_vabhdiku-597	sarvāstivāda ityuktastasmādādyaścaturvidhaḥ // Abhidh-d_301 //	sarvāstivādaḥ iti uktaḥ tasmāt ādyaḥ caturvidhaḥ 
SA_T07_vabhdiku-598	bhāvāṅkānyathikākhyau dvāvavasthānyathiko paraḥ /	bhāva aṅka anyathika ākhyau paraḥ 
SA_T07_vabhdiku-599	anyathānyathikaścānyaḥ,	anyathā anyathikaḥ ca anyaḥ 
SA_T07_vabhdiku-600	tṛtīyo yuktivādyataḥ // Abhidh-d_302 //	tṛtīyaḥ yuktivādyataḥ 
SA_T07_vabhdiku-601	kāritreṇādhvanāmepa vyavasthāmabhivāñchati /	kāritreṇa adhvanām epa vyavasthām abhivāñchati 
SA_T07_vabhdiku-602	tatkurvanvartamāno 'dhvā kṛte 'tīto 'kṛte paraḥ // Abhidh-d_303 //	tat kurvan vartamānaḥ dhvā kṛte kṛte paraḥ 
SA_T07_vabhdiku-603	buddhyā yasyekṣyate cihnaṃ tatsaṃjñeyaṃ caturvidham /	buddhyā yasya īkṣyate cihnam tat saṃjñā iyam caturvidham 
SA_T07_vabhdiku-604	paramārthena saṃvṛtyā dvayenāpekṣayāpi ca // Abhidh-d_304 //	paramārthena saṃvṛtyā dvayena apekṣayā api ca 
SA_T07_vabhdiku-605	sadatītāsamutpannaṃ buddhoktervartamānavat /	sat atīta asamutpannam buddha ukteḥ vartamāna vat 
SA_T07_vabhdiku-606	dhīnāmagocaratvacca tatsattvaṃ vartamānavat // Abhidh-d_305 //	dhīnām agocara tvat ca tat sattvam vartamāna vat 
SA_T07_vabhdiku-607	nāsadālambanā buddhirāgamādupapattitaḥ /	na asat ālambanā buddhiḥ āgamāt upapattitaḥ 
SA_T07_vabhdiku-608	anyāpekṣye 'tha saṃbandhaprtiṣedho 'śvaśṛṅgayoḥ // Abhidh-d_306 //	anya apekṣye tha saṃbandha prtiṣedhaḥ śva śṛṅgayoḥ 
SA_T07_vabhdiku-609	rūpādau vastuni kṣīṇe satyevotpadyate matiḥ /	rūpa ādau vastuni kṣīṇe sati eva utpadyate matiḥ 
SA_T07_vabhdiku-610	sā jñānasyāsanākārā śāstustathānyacittavat // Abhidh-d_307 //	sā jñānasya āsana ākārā śāstuḥ tathā anya citta vat 
SA_T07_vabhdiku-611	harṣotpādabhayodvegasmṛtyutpattyaṅgabhāvataḥ /	harṣa utpāda bhaya udvega smṛti utpatti aṅga bhāvataḥ 
SA_T07_vabhdiku-612	sāṅgasya śaktyabhivyakteḥ sadīpaghaṭarūpavat // Abhidh-d_308 //	sa aṅgasya śakti abhivyakteḥ sa dīpa ghaṭa rūpa vat 
SA_T07_vabhdiku-613	janīhākartṛ sādhyatvātpañcabhāvavikāravat /	janī hā kartṛ sādhya tvāt pañca bhāva vikāra vat 
SA_T07_vabhdiku-614	sataḥ kriyāṅgatādṛṣṭervikāryaprāpyakarmavat // Abhidh-d_309 //	sataḥ kriyā aṅga tā dṛṣṭeḥ vikārya prāpya karma vat 
SA_T07_vabhdiku-615	dvitīyaṃ janma jātasya vastuno nopapadyate /	dvitīyam janma jātasya vastunaḥ na upapadyate 
SA_T07_vabhdiku-616	mukhyasattā guṇābhāvādgauṇī sattā na vidyate // Abhidh-d_310 //	mukhya sattā guṇa abhāvāt gauṇī sattā na vidyate 
SA_T07_vabhdiku-617	sādharmye sati tadvṛttervyāhāraṃ madhuroktivat /	sādharmye sati tad vṛtteḥ vyāhāram madhura ukti vat 
SA_T07_vabhdiku-618	āviṣṭaliṅgamukhyasya janmeṣṭaṃ dārakādivat // Abhidh-d_311 //	āviṣṭa liṅga mukhyasya janma iṣṭam dāraka ādi vat 
SA_T07_vabhdiku-619	syātkhapuṣpaiḥ khamutphullaṃ syāñjaṭālaśca darduraḥ /	syāt khapuṣpaiḥ kham utphullam syāt jaṭālaḥ ca darduraḥ 
SA_T07_vabhdiku-620	svabhāvo yadi bhāvanāṃ prāgabhūtvā samudbhavet // Abhidh-d_312 //	svabhāvaḥ yadi bhāvanām prāk a bhūtvā samudbhavet 
SA_T07_vabhdiku-621	sthitiśaktiparityaktāndharmānnāśānvitodayān /	sthiti śakti parityaktān dharmān nāśa anvita udayān 
SA_T07_vabhdiku-622	vada somya kathaṃ yāti pratītyā vastu vastutām // Abhidh-d_313 //	vada somya katham yāti pratītyā vastu vastu tām 
SA_T07_vabhdiku-623	loke dṛṣṭaḥ satoreva parasparamanugrahaḥ /	loke dṛṣṭaḥ satoḥ eva parasparam anugrahaḥ 
SA_T07_vabhdiku-624	tadvadevopaghāto 'pi nāśvaśṛṅgāhipādayoḥ // Abhidh-d_314 //	tadvat eva upaghātaḥ na aśva śṛṅga ahi pādayoḥ 
SA_T07_vabhdiku-625	yatpratītyasamutpannaṃ tatsvabhāvānna vidyate /	yat pratītyasamutpannam tad svabhāvāt na vidyate 
SA_T07_vabhdiku-626	na vidyate svabhāvādyadvidyate tattato 'nyathā // Abhidh-d_315 //	na vidyate svabhāvāt yat vidyate tat tatas nyathā 
SA_T07_vabhdiku-627	prakurvanti daśāmātraṃ hetavo vastunaḥ sataḥ /	prakurvanti daśā mātram hetavaḥ vastunaḥ sataḥ 
SA_T07_vabhdiku-628	rājatvaṃ rājaputrasya sātmakasyaiva mantriṇaḥ // Abhidh-d_316 //	rāja tvam rāja putrasya sātmakasya eva mantriṇaḥ 
SA_T07_vabhdiku-629	dharmāṇāṃ sati sāmagrye sāmarthyamupajāyate /	dharmāṇām sati sāmagrye sāmarthyam upajāyate 
SA_T07_vabhdiku-630	citānāṃ paramāṇūnāṃ yadvadātmopalambhane // Abhidh-d_317 //	citānām paramāṇūnām yadvat ātma upalambhane 
SA_T07_vabhdiku-631	karmātītamasadyasya phalaṃ bhāvi karotyasat /	karma atītam asat yasya phalam bhāvi karoti asat 
SA_T07_vabhdiku-632	vyaktaṃ vandhyāsutastasya jāyate vyantarātmajāt // Abhidh-d_318 //	vyaktam vandhyā sutaḥ tasya jāyate vyantara ātmajāt 
SA_T07_vabhdiku-633	nāmasallakṣaṇābhāvād dravyasatyāṅkasiddhitaḥ /	nāma sat lakṣaṇa abhāvāt dravya satya aṅka siddhitaḥ 
SA_T07_vabhdiku-634	anāgatābhyatītasya nāsti prajñaptisatyatā // Abhidh-d_319 //	anāgata abhyatītasya na asti prajñapti satya tā 
SA_T07_vabhdiku-635	ko vighnaḥ aṅgavaikalyam na tatsarvāstitā sadā /	kaḥ vighnaḥ aṅga vaikalyam na tad sarva astitā sadā 
SA_T07_vabhdiku-636	tatkathaṃ śrūyatāṃ sadbhyaḥ durbodhā khalu dharmatā // Abhidh-d_320 //	tat katham śrūyatām sadbhyaḥ durbodhā khalu dharmatā 
SA_T07_vabhdiku-637	vartamānādhvasaṃpātāt sāmagryāṅgaparigrahāt /	vartamāna adhva saṃpātāt sāmagrya aṅga parigrahāt 
SA_T07_vabhdiku-638	labdhaśakteḥ phalākṣepaḥ kāritramabhidhīyate // Abhidh-d_321 //	labdha śakteḥ phala ākṣepaḥ kāritram abhidhīyate 
SA_T07_vabhdiku-639	na vartamānatā rūpamatītājātatā na ca /	na vartamāna tā rūpam atīta ajāta tā na ca 
SA_T07_vabhdiku-640	yato 'to nādhvasaṃcārād rūpātmānyathateṣyate // Abhidh-d_322 //	na adhva saṃcārāt rūpa ātma anyathatā iṣyate 
SA_T07_vabhdiku-641	avasthā jāyate kācidvidyamānasya vastunaḥ /	avasthā jāyate kācid vidyamānasya vastunaḥ 
SA_T07_vabhdiku-642	tathā śaktistathā velā tathā sattā tathā kriyā // Abhidh-d_323 //	tathā śaktiḥ tathā velā tathā sattā tathā kriyā 
SA_T07_vabhdiku-643	parikalpairjagadvyāptaṃ mūrkhacittānurañjibhiḥ /	parikalpaiḥ jagat vyāptam mūrkha citta anurañjibhiḥ 
SA_T07_vabhdiku-644	yastu vidvanmanogrāhī parikalpaḥ sa durlabhaḥ // Abhidh-d_324 //	yaḥ tu vidvat manaḥ grāhī parikalpaḥ sa durlabhaḥ 
SA_T07_vabhdiku-645	anyasarvatragairbaddhaḥ prahīṇe duḥkhadṛkkṣaye /	anya sarvatragaiḥ baddhaḥ prahīṇe duḥkha dṛś kṣaye 
SA_T07_vabhdiku-646	prahīṇe prākprakāre 'pi śeṣaistadavalambibhiḥ // Abhidh-d_325 //	prahīṇe prāc prakāre śeṣaiḥ tad avalambibhiḥ 
SA_T07_vabhdiku-647	dharmāḥ ṣoḍaśa vijñeyāḥ pratyekaṃ tribhavātmakāḥ /	dharmāḥ ṣoḍaśa vijñeyāḥ pratyekam tri bhava ātmakāḥ 
SA_T07_vabhdiku-648	pañcadhā nirmalāścaiva vijñānāni tathaiva ca // Abhidh-d_326 //	pañcadhā nirmalāḥ ca eva vijñānāni tathā eva ca 
SA_T07_vabhdiku-649	dhātvāyatanasatyeṣu prakāreṣu ca lakṣayet /	dhātu āyatana satyeṣu prakāreṣu ca lakṣayet 
SA_T07_vabhdiku-650	dharmasaṃgrahavijñānajñānānuśayacoditaḥ // Abhidh-d_327 //	            
SA_T07_vabhdiku-651	saduḥkhahetudṛggheyāḥ kāmāptā bhāvanākṣayāḥ /	sa duḥkha hetu dṛś heyāḥ kāma āptāḥ bhāvanā kṣayāḥ 
SA_T07_vabhdiku-652	svakatrayaikarūpāptivirajāścittagocarāḥ // Abhidh-d_328 //	svaka traya eka rūpa āpti virajāḥ citta gocarāḥ 
SA_T07_vabhdiku-653	ātmīyādhastrayaikordhvanirmalānāṃ tu rūpajāḥ /	ātmīya adhas traya eka ūrdhva nirmalānām tu rūpa jāḥ 
SA_T07_vabhdiku-654	ārūpyāptāstridhātvāptatrikanirmalagocarāḥ // Abhidh-d_329 //	ārūpya āptāḥ tri dhātu āpta trika nirmala gocarāḥ 
SA_T07_vabhdiku-655	sarve svādhikavijñeyāḥ samaniryāṇadṛkkṣayāḥ /	sarve sva adhika vijñeyāḥ sama niryāṇa dṛkkṣayāḥ 
SA_T07_vabhdiku-656	niṣkleśāstribhavāptāntyatrayanirmalagocarāḥ // Abhidh-d_330 //	niṣkleśāḥ tri bhava āpta antya traya nirmala gocarāḥ 
SA_T07_vabhdiku-657	kāmāptaṃ pañcaviṣayo rūpāptaṃ tvaṣṭagocaraḥ /	kāma āptam pañca viṣayaḥ rūpa āptam tu aṣṭa gocaraḥ 
SA_T07_vabhdiku-658	ārupyāptaṃ daśānāṃ tu daśānāmeva cāmalam // Abhidh-d_331 //	ārupya āptam daśānām tu daśānām eva ca amalam 
SA_T07_vabhdiku-659	kāmāptamūrdhvadharmārthe vijñāne svabhuvastrayaḥ /	kāma āptam ūrdhva dharma arthe vijñāne sva bhuvaḥ trayaḥ 
SA_T07_vabhdiku-660	rūpāptā bhāvanāheyāḥ sarvagāścānuśerate // Abhidh-d_332 //	rūpa āptāḥ bhāvanā heyāḥ sarvagāḥ ca anuśerate 
SA_T07_vabhdiku-661	catvāraḥ parivṛtte sve rūpāptāḥ khalvapi trayaḥ /	catvāraḥ parivṛtte sve rūpa āptāḥ khalu api trayaḥ 
SA_T07_vabhdiku-662	ārūpyāvacarāḥ sārdhaṃ sarvagairbhāvanākṣayāḥ // Abhidh-d_333 //	ārūpyāvacarāḥ sārdham sarvagaiḥ bhāvanā kṣayāḥ 
SA_T07_vabhdiku-663	tadvadeva dvitīye 'pi pañcame 'pi tathaiva ca /	tadvat eva dvitīye pi pañcame pi tathā eva ca 
SA_T07_vabhdiku-664	sāsravālambanāḥ sve ca tṛtīye 'pyanuśerate // Abhidh-d_334 //	sa āsrava ālambanāḥ sve ca tṛtīye pi anuśerate 
SA_T07_vabhdiku-665	parivṛtte tu kāmāptāḥ saṃskṛtārthāvalambinaḥ /	parivṛtte tu kāma āptāḥ saṃskṛta artha avalambinaḥ 
SA_T07_vabhdiku-666	śeṣaṃ pūrvavadākhyeyam caturthe 'pi tṛtīyavat // Abhidh-d_335 //	śeṣam pūrva vat ākhyeyam caturthe tṛtīya vat 
SA_T07_vabhdiku-667	parivṛtte tu kāmāptāścatvāro 'nyatra pūrvavat /	parivṛtte tu kāma āptāḥ catvāraḥ nyatra pūrvavat 
SA_T07_vabhdiku-668	rūpāpte prathame 'dhastāt trayaḥ sve khalvapi trayaḥ // Abhidh-d_336 //	rūpa āpte prathame trayaḥ sve khalu api trayaḥ 
SA_T07_vabhdiku-669	ārūpyāḥ sarvagāḥ sārdhaṃ bhāvanāpathasaṃkṣayaiḥ /	ārūpyāḥ sarvagāḥ sārdham bhāvanāpatha saṃkṣayaiḥ 
SA_T07_vabhdiku-670	parivṛtte trayo 'dhastāt catvāraśca svadhātutaḥ // Abhidh-d_337 //	parivṛtte trayaḥ dhastāt catvāraḥ ca sva dhātutaḥ 
SA_T07_vabhdiku-671	ārūpyāptāśca catvāro nikāyā anuśerate /	ārūpya āptāḥ ca catvāraḥ nikāyāḥ anuśerate 
SA_T07_vabhdiku-672	tadvadeva dvitīye 'pi pañcame 'pi tathaiva ca // Abhidh-d_338 //	tadvat eva dvitīye pi pañcame pi tathā eva ca 
SA_T07_vabhdiku-673	sāsravālambanāḥ sve ca tṛtīye 'pyanuśerate /	sa āsrava ālambanāḥ sve ca tṛtīye pi anuśerate 
SA_T07_vabhdiku-674	parivṛtte tu rūpāptāḥ saṃskṛtārthāvalambinaḥ // Abhidh-d_339 //	parivṛtte tu rūpa āptāḥ saṃskṛta artha avalambinaḥ 
SA_T07_vabhdiku-675	anyattu pūrvavajjñeyaṃ caturthe 'pi tṛtīyavat /	anyat tu pūrva vat jñeyam caturthe tṛtīya vat 
SA_T07_vabhdiku-676	tṛtīyavatparāvṛtte ārūpyādye nibodhayet // Abhidh-d_340 //	tṛtīya vat parāvṛtte ārūpya ādye nibodhayet 
SA_T07_vabhdiku-677	sve trayaḥ kāmadhātvāptā rūpāptāśca trayastrayaḥ /	sve trayaḥ kāmadhātu āptāḥ rūpa āptāḥ ca trayaḥ trayaḥ 
SA_T07_vabhdiku-678	rūpāptavatparāvṛtte dvitīye pañcame tathā // Abhidh-d_341 //	rūpa āpta vat parāvṛtte dvitīye pañcame tathā 
SA_T07_vabhdiku-679	tṛtīye khalvapi sve ca sāsravārthāvalambinaḥ /	tṛtīye khalu api sve ca sa āsrava artha avalambinaḥ 
SA_T07_vabhdiku-680	parāvṛtte svadhātvāptāḥ saṃskṛtārthāvalambinaḥ // Abhidh-d_342 //	parāvṛtte sva dhātu āptāḥ saṃskṛta artha avalambinaḥ 
SA_T07_vabhdiku-681	anyattvādyavadākhyeyaṃ caturthe 'pi tṛtīyavat /	anyat tu ādyavat ākhyeyam caturthe tṛtīya vat 
SA_T07_vabhdiku-682	ādyavattu parāvṛtte vijñāne nirdiśed budhaḥ // Abhidh-d_343 //	ādya vat tu parāvṛtte vijñāne nirdiśet budhaḥ 
SA_T07_vabhdiku-683	bhāvanāpathahātavyo nikāyaḥ sarvagaiḥ saha /	bhāvanāpatha hātavyaḥ nikāyaḥ sarvagaiḥ saha 
SA_T07_vabhdiku-684	anuśete dvidhātvāpto vyārūpyāścakṣurindriye // Abhidh-d_344 //	anuśete dvi dhātu āptaḥ 
SA_T07_vabhdiku-685	nikāyāḥ kāmarūpāptāścakṣurindriyagocare /	nikāyāḥ kāma rūpa āptāḥ cakṣuḥ indriya gocare 
SA_T07_vabhdiku-686	duḥkhahetudṛgabhyāsaprahātavyāstrayastrayaḥ // Abhidh-d_345 //	duḥkha hetu dṛś abhyāsa prahātavyāḥ trayaḥ trayaḥ 
SA_T07_vabhdiku-687	ārūpyā bhāvanāheyāḥ sarvagāścānuśerate /	ārūpyāḥ bhāvanā heyāḥ sarvagāḥ ca anuśerate 
SA_T07_vabhdiku-688	parivṛtte tu catvāraḥ samadṛkkṣayavarjitāḥ // Abhidh-d_346 //	parivṛtte tu catvāraḥ samadṛś kṣaya varjitāḥ 
SA_T07_vabhdiku-689	duḥkhendriye tu kāmāptaḥ svaireva saha sarvagaiḥ /	duḥkha indriye tu kāma āptaḥ svaiḥ eva saha sarvagaiḥ 
SA_T07_vabhdiku-690	tadgocare tu vijñāne nikāyā anuśerate // Abhidh-d_347 //	tad gocare tu vijñāne nikāyāḥ anuśerate 
SA_T07_vabhdiku-691	kāmāpannāstrayo rūpāḥ sarvagābhyāsasaṃkṣayāḥ /	kāma āpannāḥ trayaḥ rūpāḥ sarvaga abhyāsa saṃkṣayāḥ 
SA_T07_vabhdiku-692	paravṛtte tu catvāraḥ kāmāptā anuśerate // Abhidh-d_348 //	paravṛtte tu catvāraḥ kāma āptāḥ anuśerate 
SA_T07_vabhdiku-693	trayo rūpabhavādantyādbhāvanāheyasarvagāḥ /	trayaḥ rūpa bhavāt antyāt bhāvanā heya sarva gāḥ 
SA_T07_vabhdiku-694	sakalā dviṣparāvṛtteścatvāraścānuśerate // Abhidh-d_349 //	sakalāḥ dviṣparāvṛtteḥ catvāraḥ ca anuśerate 
SA_T07_vabhdiku-695	sukhendriye tadālambe citte tadgocare 'pi ca /	sukha indriye tad ālambe citte tad gocare ca 
SA_T07_vabhdiku-696	kāmādyāptāḥ yathāyogaṃ sarvagāścānuśerate // Abhidh-d_350 //	kāma ādi āptāḥ yathāyogam sarva gāḥ ca anuśerate 
SA_T07_vabhdiku-697	tridhātusaṃgṛhītāstu sakalā manaindriye /	tri dhātu saṃgṛhītāḥ tu sakalāḥ mana aindriye 
SA_T07_vabhdiku-698	tadālambini vijñāne sarvasaṃskṛtagocarāḥ // Abhidh-d_351 //	tad ālambini vijñāne sarva saṃskṛta gocarāḥ 
SA_T07_vabhdiku-699	saṃskṛtālambanā eva parivṛtte 'nuśerate /	saṃskṛta ālambanāḥ eva parivṛtte nuśerate 
SA_T07_vabhdiku-700	viśeṣo dviḥparāvṛttau vidyate 'tra na kaścana // Abhidh-d_352 //	viśeṣaḥ dvis parāvṛttau vidyate na kaścana 
SA_T07_vabhdiku-701	duḥkhaṃ darśanaheyādeścittāccittāni kāminaḥ /	duḥkham darśana heya ādeḥ cittāt cittāni kāminaḥ 
SA_T07_vabhdiku-702	bhavatyanantaraṃ ṣaḍ vā tasyorddhvaṃ pañca pañca vā // Abhidh-d_353 //	bhavati anantaram ṣaṣ vā tasya ūrddhvam pañca pañca vā 
SA_T07_vabhdiku-703	rūpadhātūpapannasya cittāni tu vinirdiśet /	rūpa dhātu upapannasya cittāni tu vinirdiśet 
SA_T07_vabhdiku-704	ekaṃ vā pañca vā ṣaḍ vā sapta vā yadi vā daśa // Abhidh-d_354 //	ekam vā pañca vā ṣaṣ vā sapta vā yadi vā daśa 
SA_T07_vabhdiku-705	ārūpyadhātujātasya cittānīmāni lakṣayet /	ārūpya dhātu jātasya cittāni imāni lakṣayet 
SA_T07_vabhdiku-706	svadhātukāni pañcaiva cyutikāle daśānyataḥ // Abhidh-d_355 //	svadhātukāni pañca eva cyuti kāle daśāni atas 
SA_T07_vabhdiku-707	sācivyādanuśāyitvāccittaṃ sānuśayaṃ matam /	sācivyāt anuśāyi tvāt cittam sa anuśayam matam 
SA_T07_vabhdiku-708	dvidhā vā kliṣṭamakliṣṭamekadhaivāpadiśyate // Abhidh-d_356 //	dvidhā vā kliṣṭam akliṣṭam ekadhā eva apadiśyate 
SA_T07_vabhdiku-709	mohātsatkāyadṛktasyā antagrāhekṣaṇaṃ tataḥ /	mohāt sat kāya dṛś tasyāḥ anta grāha īkṣaṇam tatas 
SA_T07_vabhdiku-710	kāṅkṣāmithyekṣaṇaṃ tasyāḥ śīlāmarśastato dṛśaḥ // Abhidh-d_357 //	kāṅkṣā mithyā īkṣaṇam tasyāḥ śīla āmarśaḥ tatas dṛśaḥ 
SA_T07_vabhdiku-711	rāgaḥ svadṛśi mānaśva dveṣo 'nyatra pratāyate /	rāgaḥ sva dṛśi dveṣaḥ nyatra 
SA_T07_vabhdiku-712	jñeyaḥ pravṛttibāhulyādevameṣāmanukramaḥ // Abhidh-d_358 //	jñeyaḥ pravṛtti bāhulyāt evam eṣām anukramaḥ 
SA_T07_vabhdiku-713	sadasanmitrayogāttu tadvṛttyaniyamo mataḥ /	sat asat mitra yogāt tu tad vṛtti aniyamaḥ mataḥ 
SA_T07_vabhdiku-714	kleśa utpadyate kaścitsaṃpūrṇaiḥ kāraṇaistribhiḥ // Abhidh-d_359 //	kleśaḥ utpadyate kaścid saṃpūrṇaiḥ kāraṇaiḥ tribhiḥ 
SA_T07_vabhdiku-715	vyavidyāḥ sakalāḥ kleśāḥ kāme kāmāsravo mataḥ /	sakalāḥ kleśāḥ kāme kāma āsravaḥ mataḥ 
SA_T07_vabhdiku-716	styānauddhatye ca hitvordhvaṃ samānatvādbhavāstravaḥ // Abhidh-d_360 //	styāna auddhatye ca hitvā ūrdhvam samāna tvāt bhava astravaḥ 
SA_T07_vabhdiku-717	avidyākhyastu mūlatvādavidyā sārvadhātukī /	avidyā ākhyaḥ tu mūla tvāt avidyā sārvadhātukī 
SA_T07_vabhdiku-718	tathaughayogā dṛgvarjjaṃ tatpṛthaktvantu pāṭavāt // Abhidh-d_361 //	tathā ogha yogāḥ dṛś varjjam tad pṛthaktvam tu pāṭavāt 
SA_T07_vabhdiku-719	sāvidyā dve upādāne yathāktau dve tu dṛṅmaye /	sā avidyā dve upādāne yathā aktau dve tu dṛś maye 
SA_T07_vabhdiku-720	catasro 'pyekamantyaikaṃ kumārgādisamāśrayāt // Abhidh-d_362 //	catasraḥ pi ekam antya ekam kumārga ādi samāśrayāt 
SA_T07_vabhdiku-721	śeṣāstraidhātukāstvantye sātmabhāvapravṛttitaḥ /	śeṣāḥ traidhātukāḥ tu antye sa ātma bhāva pravṛttitaḥ 
SA_T07_vabhdiku-722	saṃyojanādibhiḥ śabdairdarśitāḥ pañcadhā punaḥ // Abhidh-d_363 //	saṃyojana ādibhiḥ śabdaiḥ darśitāḥ pañcadhā punar 
SA_T07_vabhdiku-723	nava saṃyojanānyasminnīrṣyāmātsaryameva ca /	nava saṃyojanāni asmin īrṣyā mātsaryam eva ca 
SA_T07_vabhdiku-724	dravyāmarṣaṇasāmānyād dṛśaḥ saṃyojanadvayam // Abhidh-d_364 //	dravya āmarṣaṇa sāmānyāt dṛśaḥ saṃyojana dvayam 
SA_T07_vabhdiku-725	śeṣāṇyanuśayāḥ pañca pañcadhā pañcadhā punaḥ /	śeṣāṇi anuśayāḥ pañca pañcadhā pañcadhā punar 
SA_T07_vabhdiku-726	jagādāvarabhāgīyamūrdhvabhāgīyameva ca // Abhidh-d_365 //	jagāda avara bhāgīyam ūrdhva bhāgīyam eva ca 
SA_T07_vabhdiku-727	ādyantye dve dṛśau kāṅkṣākāmacchando dvireva yaḥ /	ādi antye dve dṛśau kāṅkṣā kāma chandaḥ dvis eva yaḥ 
SA_T07_vabhdiku-728	dvābhyāṃ kāmānatikrāntiḥ punarānayanaṃ tribhiḥ // Abhidh-d_366 //	dvābhyām kāma anatikrāntiḥ punar ānayanam tribhiḥ 
SA_T07_vabhdiku-729	dvyekadṛggheyakāryokterdṛṣṭiheyamukhagrahāt /	                
SA_T07_vabhdiku-730	sarvadṛggheyabhāktve 'pi trayametadudāhṛtam // Abhidh-d_367 //	sarva dṛś heya bhāktve trayam etat udāhṛtam 
SA_T07_vabhdiku-731	sarvānarthanidānatvānmārgapratyarthibhāvataḥ /	sarva anartha nidāna tvāt mārga pratyarthi bhāvataḥ 
SA_T07_vabhdiku-732	tathyohāvidhuratvācca trisaṃyojanadeśanā // Abhidh-d_368 //	tathya ūhā vidhura tvāt ca tri saṃyojana deśanā 
SA_T07_vabhdiku-733	dvau rūpārūpajau rāgau mānamohoddhavāstrayaḥ /	dvau rūpa arūpa jau rāgau māna moha uddhavāḥ trayaḥ 
SA_T07_vabhdiku-734	trivedanānuśāyitvād dṛḍhatvādbandhanatrayam // Abhidh-d_369 //	tri vedanā anuśāyi tvāt dṛḍha tvāt bandhana trayam 
SA_T07_vabhdiku-735	dvipakṣagranthanād granthāścatvāraḥ samudāhṛtāḥ /	dvi pakṣa granthanāt granthāḥ catvāraḥ samudāhṛtāḥ 
SA_T07_vabhdiku-736	abhidhyākhyāstathā dveṣaḥ parāmarśadvayaṃ tathā // Abhidh-d_370 //	abhidhyā ākhyāḥ tathā dveṣaḥ parāmarśa dvayam tathā 
SA_T07_vabhdiku-737	upakleśāstu vijñeyāḥ saṃrambhādyā yathoditāḥ /	upakleśāḥ tu vijñeyāḥ saṃrambha ādyāḥ yathā uditāḥ 
SA_T07_vabhdiku-738	sarve vā caitasāḥ kliṣṭāḥ saṃskāraskandhasaṃjñitāḥ // Abhidh-d_371 //	sarve vā caitasāḥ kliṣṭāḥ saṃskāra skandha saṃjñitāḥ 
SA_T07_vabhdiku-739	mūlakleśamalāstvanye ṣaḍupakleśasaṃjñitāḥ /	mūlakleśa malāḥ tu anye ṣaṣ upakleśa saṃjñitāḥ 
SA_T07_vabhdiku-740	śāṭhyopanāhapradāśamāyāmadaviheṭhanāḥ // Abhidh-d_372 //	śāṭhya upanāha pradāśa māyā mada viheṭhanāḥ 
SA_T07_vabhdiku-741	mrarkṣyerṣyāhryanapatrāpyastyānamiddhoddhavakrudhaḥ /	mrarkṣya īrṣyā hrī anapatrāpya styānam iddha uddhava krudhaḥ 
SA_T07_vabhdiku-742	mātsaryaṃ kukṛtatvaṃ ca daśadhā paryavasthitiḥ // Abhidh-d_373 //	mātsaryam kukṛta tvam ca daśadhā paryavasthitiḥ 
SA_T07_vabhdiku-743	ebhyo 'nunayaniṣyandā āhrīkyauddhatatādayaḥ /	ebhyaḥ nu naya nisyandāḥ āhrīkya auddhata ta ādayaḥ 
SA_T07_vabhdiku-744	mrakṣānapatrapāstyānamiddhādyā mohasaṃbhavāḥ // Abhidh-d_374 //	mrakṣa anapatrapāḥ tyānamiddha ādyāḥ moha saṃbhavāḥ 
SA_T07_vabhdiku-745	kaukṛtyaṃ vicikitsotthaṃ krodhādyā dveṣasambhavāḥ /	kaukṛtyam vicikitsā uttham krodha ādyāḥ dveṣa sambhavāḥ 
SA_T07_vabhdiku-746	pramādastambhamārdva(?)	        
SA_T07_vabhdiku-747	kṣya māyāśāṭhyavijṛmbhikāḥ // Abhidh-d_375 //	māyā śāṭhya vijṛmbhikāḥ 
SA_T07_vabhdiku-748	kāyaduṣṭhūlatādyāśca jñeyā vyāmiśrasambhavāḥ /	kāya duṣṭhūla tā ādyāḥ ca jñeyāḥ vyāmiśra sambhavāḥ 
SA_T07_vabhdiku-749	pradāśo dṛkparāmarśaniṣyandaḥ śaṭhatā dṛśaḥ // Abhidh-d_376 //	            
SA_T07_vabhdiku-750	saumanasyena rāgasya saṃprayogaḥ sukhena ca /	saumanasyena rāgasya saṃprayogaḥ sukhena ca 
SA_T07_vabhdiku-751	dveṣasya daurmanasyena duḥkhena ca nigadyate // Abhidh-d_377 //	dveṣasya daurmanasyena duḥkhena ca nigadyate 
SA_T07_vabhdiku-752	sarvairmohasya vittibhyāṃ caitasībhyāmasaddṛśaḥ /	sarvaiḥ mohasya vittibhyām caitasībhyām asat dṛśaḥ 
SA_T07_vabhdiku-753	kāṅkṣā ca daurmanasyena śeṣāṇāṃ sumanastayā // Abhidh-d_378 //	kāṅkṣā ca daurmanasyena śeṣāṇām sumanaḥ tayā 
SA_T07_vabhdiku-754	upekṣayā tu sarveṣām kāmāptānāmayaṃ vidhiḥ /	upekṣayā tu sarveṣām kāma āptānām ayam vidhiḥ 
SA_T07_vabhdiku-755	ito 'nyadhātujānāṃ tu pratibhūmyantaraṃ svakaiḥ // Abhidh-d_379 //	itas nya dhātu jānām tu prati bhūmi antaram svakaiḥ 
SA_T07_vabhdiku-756	īrṣyayā daurmanasyena kaukṛtyasya tathā krudhaḥ /	īrṣyayā daurmanasyena kaukṛtyasya tathā krudhaḥ 
SA_T07_vabhdiku-757	pradaṣṭeścopanaddheśca vihiṃsāyāstathaiva ca // Abhidh-d_380 //	pradaṣṭeḥ ca upanaddheḥ ca vihiṃsāyāḥ tathā eva ca 
SA_T07_vabhdiku-758	mātsaryaṃ daurmanasyena saumanasyena kasyacit /	mātsaryam daurmanasyena saumanasyena kasyacid 
SA_T07_vabhdiku-759	dvābhyāṃ māyā tathā śāṭhyaṃ mrakṣo middhaṃ tathaiva ca // Abhidh-d_381 //	dvābhyām māyā tathā śāṭhyam mrakṣaḥ middham tathā eva ca 
SA_T07_vabhdiku-760	madastu sumanaḥskandhasukhābhyāṃ saṃprayujyate /	madaḥ tu sumanaḥ skandha sukhābhyām saṃprayujyate 
SA_T07_vabhdiku-761	āhrīkyamanapatrāpyaṃ styānauddhatye ca pañcabhiḥ // Abhidh-d_382 //	āhrīkyam anapatrāpyam styāna auddhatye ca pañcabhiḥ 
SA_T07_vabhdiku-762	āhrīkyamanapatrāpyaṃ styānamiddhaṃ tathoddhavaḥ // Abhidh-d_383 //	āhrīkyam anapatrāpyam styānam iddham tathā uddhavaḥ 
SA_T07_vabhdiku-763	samastālambināntyena tānvettyadhruvatādibhiḥ /	samasta ālambinā antyena tān vetti adhruva tā ādibhiḥ 
SA_T07_vabhdiku-764	kleśātyantakṣayo 'ntyena saṃbhinnālambanena vā // Abhidh-d_384 //	kleśa atyanta kṣayaḥ ntyena saṃbhinna ālambanena vā 
SA_T07_vabhdiku-765	asaṃbhinnārtha viṣayaṃ trayametad dvidheṣyate /	viṣayam trayam etat dvidhā iṣyate 
SA_T07_vabhdiku-766	tasyaivaṃ paśyataḥ sākṣādudayavyayadarśanam // Abhidh-d_385 //	tasya evam paśyataḥ sākṣāt udaya vyaya darśanam 
SA_T07_vabhdiku-767	skandheṣu jāyate paścāccakrabhramarikādivat /	skandheṣu jāyate paścāt cakra bhramarikā ādi vat 
SA_T07_vabhdiku-768	sa pratītyasamutpādaṃ skandhānāṃ pratyavekṣate // Abhidh-d_386 //	sa pratītyasamutpādam skandhānām pratyavekṣate 
SA_T07_vabhdiku-769	satyeṣu pātayitvataṃ tadā kaścitparīkṣate /	satyeṣu tadā kaścid parīkṣate 
SA_T07_vabhdiku-770	tadanityatvaduḥkhatve samavetya tataḥ punaḥ // Abhidh-d_387 //	tad anitya tva duḥkha tve samavetya tatas punar 
SA_T07_vabhdiku-771	akartṛkānnirīhāṃśca pratyayādhīnasaṃbhavān /	akartṛkān nirīhān ca pratyaya adhīna saṃbhavān 
SA_T07_vabhdiku-772	dṛṣṭvā sarveṣvanātmeti tattvākāraṃ niṣevate // Abhidh-d_388 //	dṛṣṭvā sarveṣu anātmā iti tattva ākāram niṣevate 
SA_T07_vabhdiku-773	anadhiṣṭhātṛkatvaṃ ca pāratantryaṃ ca paśyataḥ /	an adhiṣṭhātṛka tvam ca pāratantryam ca paśyataḥ 
SA_T07_vabhdiku-774	sarvadharmeṣu nairātmye sthirā buddhiḥ pravartate // Abhidh-d_389 //	sarva dharmeṣu nairātmye sthirā buddhiḥ pravartate 
SA_T07_vabhdiku-775	svabhāvenāviśūnyatvād dharmamudrā udāhṛtā /	svabhāvena avi śūnya tvāt dharmamudrā udāhṛtā 
SA_T07_vabhdiku-776	taduktyā ca taduktatvācchūnyākāro na deśitaḥ // Abhidh-d_390 //	tad uktyā ca tad ukta tvāt śūnya ākāraḥ na deśitaḥ 
SA_T07_vabhdiku-777	gotradvārasamūhādīn dhātvādīnāṃ yathāyatham /	gotra dvāra samūha ādīn dhātu ādīnām yathāyatham 
SA_T07_vabhdiku-778	svasādhāraṇacihnābhyāṃ sadatopaparīkṣate // Abhidh-d_391 //	sva sādhāraṇa cihnābhyām sadatā upaparīkṣate 
SA_T07_vabhdiku-779	pratiskandhaṃ tatastasya svābhāvyādiṣu tattvataḥ /	pratiskandham tatas tasya svābhāvya ādiṣu tattvataḥ 
SA_T07_vabhdiku-780	krameṇa jāyate paścātkauśalaṃ sthānasaptake // Abhidh-d_392 //	krameṇa jāyate paścāt kauśalam sthāna saptake 
SA_T07_vabhdiku-781	nirmathnataḥ krameṇāsya duḥkhasatyabhavāraṇim /	nirmathnataḥ krameṇa asya duḥkha satya bhava araṇim 
SA_T07_vabhdiku-782	śraddhāvīryasahāyasya tattvajñānānalārthinaḥ // Abhidh-d_393 //	śraddhā vīrya sahāyasya tattva jñāna anala arthinaḥ 
SA_T07_vabhdiku-783	ākārapatitaṃ jñānaṃ tataḥ śamaniyāmakam /	ākāra patitam jñānam tatas śama niyāmakam 
SA_T07_vabhdiku-784	bhāvanāmayamūṣmākhyaṃ jāyate sānuvartakam // Abhidh-d_394 //	bhāvanā mayam ūṣma ākhyam jāyate sa anuvartakam 
SA_T07_vabhdiku-785	tatastathaiva mūrdhāno mithyādṛṣṭyupaghātinaḥ /	tatas tathā eva mūrdhānaḥ mithyādṛṣṭi upaghātinaḥ 
SA_T07_vabhdiku-786	ūṣmabhyo 'dhikasāmarthyādratnaśraddhāvivardhinaḥ // Abhidh-d_395 //	ūṣmabhyaḥ dhika sāmarthyāt ratna śraddhā vivardhinaḥ 
SA_T07_vabhdiku-787	........netvasminnubhayatrāpi paścimā // Abhidh-d_396 //	na itu asmin ubhayatra api paścimā 
SA_T07_vabhdiku-788	bhāvyate skandhadṛktvādau na tannirvāṇadarśinaḥ /	bhāvyate skandha dṛś tva ādau na tat nirvāṇa darśinaḥ 
SA_T07_vabhdiku-789	ākārāṃstulyajātīyān sarvatrātra tu nirdiśet // Abhidh-d_397 //	ākārān tulya jātīyān sarvatra atra tu nirdiśet 
SA_T07_vabhdiku-790	draṣṭavyānyatarā tābhyaḥ pratyutpannā vivardhane /	draṣṭavyā anyatarā tābhyaḥ pratyutpannā vivardhane 
SA_T07_vabhdiku-791	catasṛbhyastvanyatamā pratyutpannā vivardhane // Abhidh-d_398 //	catasṛbhyaḥ tu anyatamā pratyutpannā vivardhane 
SA_T07_vabhdiku-792	anāgatāstu bhāvyante catasro 'pyatra niścayāt /	anāgatāḥ tu bhāvyante catasraḥ pi atra niścayāt 
SA_T07_vabhdiku-793	mokṣe 'ntye saṃmukhībhūtāḥ samagrāḥ khalvanāgatāḥ // Abhidh-d_399 //	mokṣe ntye saṃmukhībhūtāḥ samagrāḥ khalu anāgatāḥ 
SA_T07_vabhdiku-794	ākārāḥ khalu sarvepi bhāvyante gotralābhataḥ /	ākārāḥ khalu sarve api bhāvyante gotra lābhataḥ 
SA_T07_vabhdiku-795	gotralābhe tu vijñeyā sabhāgākārabhāvanā // Abhidh-d_400 //	gotra lābhe tu vijñeyā sa bhāga ākāra bhāvanā 
SA_T07_vabhdiku-796	sarvatrākiraṇe mūrdhno nirodhākiraṇaidhane /	sarvatra a kiraṇe mūrdhnaḥ nirodha a kiraṇa edhane 
SA_T07_vabhdiku-797	dharmākhyāḥ saṃmukhībhūtāścatasraḥ khalvanāgatāḥ // Abhidh-d_401 //	dharma ākhyāḥ saṃmukhībhūtāḥ catasraḥ khalu anāgatāḥ 
SA_T07_vabhdiku-798	ākārāḥ sakalāstatra bhāvyante gotralābhataḥ /	ākārāḥ sakalāḥ tatra bhāvyante gotra lābhataḥ 
SA_T07_vabhdiku-799	sarvābhyo 'nyatarotpannāḥ satyatrayavivardhane // Abhidh-d_402 //	sarvābhyaḥ nyatara utpannāḥ satya traya vivardhane 
SA_T07_vabhdiku-800	anāgatāścatasrastu bhāvyante tatra niścayāt /	anāgatāḥ catasraḥ tu bhāvyante tatra niścayāt 
SA_T07_vabhdiku-801	ākārāḥ sakalā jñeyāḥ kṣāntivinyasane śṛṇu // Abhidh-d_403 //	ākārāḥ sakalāḥ jñeyāḥ kṣānti vinyasane śṛṇu 
SA_T07_vabhdiku-802	sarvatrāntyāḥ samutpannāścatasraḥ khalvanāgatāḥ /	sarvatra antyāḥ samutpannāḥ catasraḥ khalu anāgatāḥ 
SA_T07_vabhdiku-803	ākārāḥ sakalāstatra bhāvyante cāpyanāgatāḥ // Abhidh-d_404 //	ākārāḥ sakalāḥ tatra bhāvyante ca api anāgatāḥ 
SA_T07_vabhdiku-804	pratyutpannāgryadharmeṣu dharmākhyā smṛtyupasthitiḥ /	pratyutpanna agrya dharmeṣu dharma ākhyā smṛti upasthitiḥ 
SA_T07_vabhdiku-805	anāgatāstu bhāvyante catastrasteṣu niścayāt // Abhidh-d_405 //	anāgatāḥ tu bhāvyante catastraḥ teṣu niścayāt 
SA_T07_vabhdiku-806	ākārāḥ khaluḥ catvāro dṛṅmārgasadṛśatvataḥ /	ākārāḥ khalu catvāraḥ dṛś mārga sadṛśa tvataḥ 
SA_T07_vabhdiku-807	yathoṣmakiraṇe tadvad draṣṭavyaṃ dṛṣṭivartmani // Abhidh-d_406 //	yathā ūṣma kiraṇe tadvat draṣṭavyam dṛṣṭi vartmani 
SA_T07_vabhdiku-808	antyāṃ mārgānvayajñāne pratyutpannāṃ vinirdiśet /	antyām mārga anvaya jñāne pratyutpannām vinirdiśet 
SA_T07_vabhdiku-809	catasro 'nāgatāstadvat ṣoḍaśākārabhāvanāḥ // Abhidh-d_407 //	catasraḥ nāgatāḥ tadvat ṣoḍaśa ākāra bhāvanāḥ 
SA_T07_vabhdiku-810	tadūrdhvamapi cāryasya sarvāpūrvaguṇodaye /	tad ūrdhvam api ca āryasya sarva apūrva guṇa udaye 
SA_T07_vabhdiku-811	śrutacintāmayaṃ hitvā sūkṣmasūkṣmaṃ vyapohya ca // Abhidh-d_408 //	śruta cintā mayam hitvā sūkṣma sūkṣmam vyapohya ca 
SA_T07_vabhdiku-812	bālasyārambhamārge tu caturbhūmivinirjayaiḥ /	bālasya ārambha mārge tu catur bhūmi vinirjayaiḥ 
SA_T07_vabhdiku-813	bhūtāmanyatarāṃ tābhyaścatasraḥ khalvanāgatāḥ // Abhidh-d_409 //	bhūtām anyatarām tābhyaḥ catasraḥ khalu anāgatāḥ 
SA_T07_vabhdiku-814	ānantaryapathe muktāvantyāṃ sarvāstvanāgatāḥ /	ānantarya pathe muktā avantyām sarvāḥ tu anāgatāḥ 
SA_T07_vabhdiku-815	antye dhyāne prayogādimārgeṣvaṣṭāsu pūrvavat // Abhidh-d_410 //	antye dhyāne prayoga ādi mārgeṣu aṣṭāsu pūrvavat 
SA_T07_vabhdiku-816	tisrastu navame vidyāt maulabhūmipraveśataḥ /	tisraḥ tu navame vidyāt maula bhūmi praveśataḥ 
SA_T07_vabhdiku-817	sāmantakaprayoge tu catasro 'ntyāthavā bhavet // Abhidh-d_411 //	sāmantaka prayoge tu catasraḥ ntyā athavā bhavet 
SA_T07_vabhdiku-818	divyākṣiśrutyabhijñāyāṃ vimokṣādau tathaiva ca /	divyākṣiśrutyabhijñāyām vimokṣa ādau tathā eva ca 
SA_T07_vabhdiku-819	prathamāṃ saṃmukhībhūtāṃ catasraḥ khalvanāgatāḥ // Abhidh-d_412 //	prathamām saṃmukhībhūtām catasraḥ khalu anāgatāḥ 
SA_T07_vabhdiku-820	paracitte tṛtīyā tu catasraścāpyanāgatāḥ /	para citte tṛtīyā tu catasraḥ ca api anāgatāḥ 
SA_T07_vabhdiku-821	prāṅnivāsāpramāṇānāmantyāṃ sarvāstvanāgatāḥ // Abhidh-d_413 //	prāṅnivāsāpramāṇānām antyām sarvāḥ tu anāgatāḥ 
SA_T07_vabhdiku-822	ārūpyāṇāṃ vimokṣāṇāṃ tisṛbhyo 'nyatamāṃ vadet /	ārūpyāṇām vimokṣāṇām tisṛbhyaḥ nyatamām vadet 
SA_T07_vabhdiku-823	saṃmukhe nāma jātāstu tisra eva vinirdiśet // Abhidh-d_414 //	saṃmukhe nāma jātāḥ tu tisraḥ eva vinirdiśet 
SA_T07_vabhdiku-824	ārūpyakṛtsnayostvantyāṃ pratyupannāmudāharet /	ārūpya kṛtsnayoḥ tu antyām pratyupannām udāharet 
SA_T07_vabhdiku-825	tisraḥ khalvasamutpannāḥ kathayanniyamena tu // Abhidh-d_415 //	tisraḥ khalu asamutpannāḥ kathayan niyamena tu 
SA_T07_vabhdiku-826	āryasya khalu vairāgyaprayoge kṣepaṇe pi ca /	āryasya khalu vairāgya prayoge kṣepaṇe ca 
SA_T07_vabhdiku-827	sarvebhyo 'nyatarābhūtāścatasraścāpyanāgatāḥ // Abhidh-d_416 //	sarvebhyaḥ nyatara abhūtāḥ catasraḥ ca api anāgatāḥ 
SA_T07_vabhdiku-828	ānantaryapathe muktāvantyāḥ sarvāstvanāgatāḥ /	ānantarya pathe mukta avantyāḥ sarvāḥ tu anāgatāḥ 
SA_T07_vabhdiku-829	ṛdhyādau tu guṇāḥ sarvamanāryasyaiva nirdiśet // Abhidh-d_417 //	ṛdhi ādau tu guṇāḥ sarvam anāryasya eva nirdiśet 
SA_T07_vabhdiku-830	antyapūrvanivāsādau ca dharmapratisaṃvidi /	antya pūrva nivāsa ādau ca dharma pratisaṃvidi 
SA_T07_vabhdiku-831	tathāparasamādhyādāvaraṇāyāṃ tathaiva ca // Abhidh-d_418 //	tathā apara samādhyāt āvaraṇāyām tathā eva ca 
SA_T07_vabhdiku-832	ārūpyākhyavimokṣādau saṃjñāsūkṣmodaye tathā /	ārūpya ākhya vimokṣa ādau saṃjñā sūkṣma udaye tathā 
SA_T07_vabhdiku-833	sarvābhyo 'nyatarābhūtāścatasraḥ khalvanāgatāḥ // Abhidh-d_419 //	sarvābhyaḥ nyatara abhūtāḥ catasraḥ khalu anāgatāḥ 
SA_T07_vabhdiku-834	brūyāttu sūkṣmasūkṣme 'ntyāṃ bhūtāṃ tisrastvanāgatāḥ /	brūyāt tu sūkṣma sūkṣme ntyām bhūtām tisraḥ tu anāgatāḥ 
SA_T07_vabhdiku-835	samāseneyamākhyātā smṛtyupasthānabhāvanā // Abhidh-d_420 //	samāsena iyam ākhyātā smṛti upasthāna bhāvanā 
SA_T07_vabhdiku-836	etannirvedhabhāgīyaṃ caturdhā bhāvanāmayam /	etat nirvedha bhāgīyam caturdhā bhāvanā mayam 
SA_T07_vabhdiku-837	ṣaḍbhaumaṃ ṣoḍaśākāraṃ pañcaskandhā vināptibhiḥ // Abhidh-d_421 //	ṣaṣ bhaumam ṣoḍaśa ākāram pañca skandhāḥ vinā āptibhiḥ 
SA_T07_vabhdiku-838	paścāttu khalunirvedha āryamārgāhvayastataḥ /	paścāt tu khalu nirvedhaḥ ārya mārga āhvayaḥ tatas 
SA_T07_vabhdiku-839	sa yasmānniścito vedhastasmānnirvedha ucyate // Abhidh-d_422 //	sa yasmāt niścitaḥ vedhaḥ tasmāt nirvedhaḥ ucyate 
SA_T07_vabhdiku-840	dharmajñānarucirduḥkhe nirmalaṃ dharmadarśanam /	dharma jñāna ruciḥ duḥkhe nirmalam dharma darśanam 
SA_T07_vabhdiku-841	tatastatraivāvadhṛtiḥ dharmajñānamanantaram // Abhidh-d_423 //	tatas tatra eva avadhṛtiḥ dharma jñānam anantaram 
SA_T07_vabhdiku-842	evaṃ triṣvapi satyeṣu tathaivānvayadhīrdvidhā /	evam triṣu api satyeṣu tathā evā anvaya dhīḥ dvidhā 
SA_T07_vabhdiku-843	anantyāstatra dṛṅmārgāḥ jñeyāḥ pañcadaśakṣaṇāḥ // Abhidh-d_424 //	anantyāḥ tatra dṛś mārgāḥ jñeyāḥ pañcadaśa kṣaṇāḥ 
SA_T07_vabhdiku-844	kṣaṇo 'ntyo bhāvanāmārgāt phalameṣo 'rthasiddhitaḥ // Abhidh-d_425 //	kṣaṇaḥ ntyaḥ bhāvanā mārgāt phalam eṣaḥ rtha siddhitaḥ 
SA_T07_vabhdiku-845	dhyānāni vyavakīryātaḥ pañcamastvakaniṣṭhagaḥ /	dhyānāni vyavakīrya atas pañcamaḥ tu akaniṣṭha gaḥ 
SA_T07_vabhdiku-846	caturdhārūpyagāmyanyo dṛṣṭanirvāyako 'paraḥ // Abhidh-d_426 //	caturdhā ārūpya gāmī anyaḥ paraḥ 
SA_T07_vabhdiku-847	punastridhā tridhā kṛtvā trīnato rūpagā nava /	punar tridhā tridhā kṛtvā trīn atas rūpa gāḥ nava 
SA_T07_vabhdiku-848	tadviśeṣaḥ punarjñeyaḥ karmakleśākṣabhedataḥ // Abhidh-d_427 //	tad viśeṣaḥ punar jñeyaḥ karma kleśa akṣa bhedataḥ 
SA_T07_vabhdiku-849	ṣaḍdhordhvastrotasā sārdhaṃ saptadhā sadgatirmatā /	ṣaḍdhā ūrdhvaḥ trotasā sārdham saptadhā sat gatiḥ matā 
SA_T07_vabhdiku-850	sati vṛtteranairyāṇāduktaiṣāmeva sadgatiḥ // Abhidh-d_428 //	sati vṛtteḥ anairyāṇāt uktā eṣām eva sat gatiḥ 
SA_T07_vabhdiku-851	parāvṛttabhavo hyāryo neha dhātvantaropagaḥ /	parāvṛtta bhavaḥ hi āryaḥ na iha dhātu antara upagaḥ 
SA_T07_vabhdiku-852	eṣa cordhvagatiścaiva nākṣamaṃ cārahānibhāk // Abhidh-d_429 //	eṣa ca ūrdhva gatiḥ ca eva na akṣamam cāra hāni bhāj 
SA_T07_vabhdiku-853	antyakāmīryate pūrvaṃ siddhirdvikṣaṇamiśraṇāt /	antyakām īryate pūrvam siddhiḥ dvi kṣaṇa miśraṇāt 
SA_T07_vabhdiku-854	udbhavārthaṃ sukhārthaṃ ca kleśāśaṅkārthameva ca // Abhidh-d_430 //	udbhava artham sukha artham ca kleśa āśaṅkā artham eva ca 
SA_T07_vabhdiku-855	tatpāñcavidhyataḥ pañca śuddhāvāsabhuvaḥ smṛtāḥ /	tad pāñcavidhyataḥ pañca śuddhāvāsa bhuvaḥ smṛtāḥ 
SA_T07_vabhdiku-856	na jātu dṛṣṭapūrvāstāḥ sarvairapi pṛthagjanaiḥ // Abhidh-d_431 //	na jātu dṛṣṭa pūrvāḥ tāḥ sarvaiḥ api pṛthagjanaiḥ 
SA_T07_vabhdiku-857	yo nirodhasamāpattimaśnute kāyasākṣyasau /	yaḥ nirodha samāpattim aśnute kāya sākṣī asau 
SA_T07_vabhdiku-858	bhavāgrāṣṭāṃśahā yāvadarhattvapratipannakaḥ // Abhidh-d_432 //	               
SA_T07_vabhdiku-859	yaścānantaryamārge 'ntye vajraupamyāhvayesthitaḥ /	yaḥ ca ānantarya mārge ntye vajra aupamya āhvaye sthitaḥ 
SA_T07_vabhdiku-860	tatphalārthaṃ kṣayajñānaṃ tadekālambanaṃ na vā // Abhidh-d_433 //	tad phala artham kṣaya jñānam tad eka ālambanam na vā 
SA_T07_vabhdiku-861	tadavāpteraśaikṣo 'sāvarhaṃstrailokyasatkṛtaḥ /	tad avāpteḥ aśaikṣaḥ saḥ arhan trailokya satkṛtaḥ 
SA_T07_vabhdiku-862	sarvakleśavisaṃyuktaḥ śikṣātritayapāragaḥ // Abhidh-d_434 //	sarva kleśa visaṃyuktaḥ śikṣā tritaya pāragaḥ 
SA_T07_vabhdiku-863	bhāvanākhyo dvidhā mārgaḥ samalāmalabhedataḥ /	bhāvanā ākhyaḥ dvidhā mārgaḥ sa mala amala bhedataḥ 
SA_T07_vabhdiku-864	darśanākhyastu vijñeyaḥ sarvasyaiva nirāsravaḥ // Abhidh-d_435 //	darśana ākhyaḥ tu vijñeyaḥ sarvasya eva nirāsravaḥ 
SA_T07_vabhdiku-865	ānupūrvikayadbhūyovītarāgāvītāvītarāgiṇām /	ānupūrvika yad bhūyas vīta rāga avīta avīta rāgiṇām 
SA_T07_vabhdiku-866	aśaikṣākhyopi boddhavyo nityamevāmalīmasaḥ // Abhidh-d_436 //	aśaikṣa ākhyaḥ api boddhavyaḥ nityam eva amalīmasaḥ 
SA_T07_vabhdiku-867	bhavāgraṃ nirmalo 'tyeti........ // Abhidh-d_437 //	bhavāgram nirmalaḥ tyeti 
SA_T07_vabhdiku-868	saviśeṣaṃ yatastyaktvā phalaṃ paramupāśnute /	sa viśeṣam yatas tyaktvā phalam param upāśnute 
SA_T07_vabhdiku-869	śaikṣasya tribhirakṣādyairdvābhyāṃ saṃpūrṇaṃtārhataḥ // Abhidh-d_438 //	śaikṣasya tribhiḥ akṣa ādyaiḥ dvābhyām 
SA_T07_vabhdiku-870	vijñātavyaḥ samāsena punamārgaścaturvidhaḥ /	vijñātavyaḥ samāsena punar mārgaḥ caturvidhaḥ 
SA_T07_vabhdiku-871	ānantaryavimuktyākhyau prārambhotkarṣalakṣaṇau // Abhidh-d_439 //	ānantarya vimukti ākhyau prārambha utkarṣa lakṣaṇau 
SA_T07_vabhdiku-872	tīkṣṇendriyasya mauleṣu dhyāneṣu pratipatsukhā /	tīkṣṇa indriyasya mauleṣu dhyāneṣu pratipad sukhā 
SA_T07_vabhdiku-873	kṣiprābhijñālpabuddhestu dhandhānyatra viparyayāt // Abhidh-d_440 //	kṣipra abhijñā alpa buddheḥ tu viparyayāt 
SA_T07_vabhdiku-874	kṣayajñānaṃ matā bodhistathānutpādadhīrapi /	kṣaya jñānam matā bodhiḥ tathā anutpāda dhīḥ api 
SA_T07_vabhdiku-875	daśa caikaśca tatpakṣyāḥ saptatriṃśattu nāmataḥ // Abhidh-d_441 //	daśa ca ekaḥ ca tad pakṣyāḥ saptatriṃśat tu nāmataḥ 
SA_T07_vabhdiku-876	sopekṣāprītisaṃkalpaṃ śraddhādīndriyapañcakam /	sa upekṣā prīti saṃkalpam śraddhā ādi indriya pañcakam 
SA_T07_vabhdiku-877	saprasrabdhirdvirūpotthaṃ nāmabhedastvapekṣayā // Abhidh-d_442 //	sa prasrabdhiḥ dvi rūpa uttham nāma bhedaḥ tu apekṣayā 
SA_T07_vabhdiku-878	balānyatrendriyāṇyeva prajñaiva smṛtyupasthitiḥ /	balāni atrā indriyāṇi eva prajñā eva smṛti upasthitiḥ 
SA_T07_vabhdiku-879	vīryaṃ samyakpradhānākhyaṃ ṛddhipādā manasthitiḥ // Abhidh-d_443 //	vīryam samyakpradhāna ākhyam ṛddhipādā mana sthitiḥ 
SA_T07_vabhdiku-880	doṣahāṇamanutpādaṃ guṇotpādaṃ vivardhanam /	doṣa hāṇam anutpādam guṇa utpādam vivardhanam 
SA_T07_vabhdiku-881	sakṛtkaroti yattaddhi sa prahāṇacatuṣṭayam // Abhidh-d_444 //	sakṛt karoti yat tat hi sa prahāṇa catuṣṭayam 
SA_T07_vabhdiku-882	chandavyāyāmamīmāṃsā cittākṛṣṭāḥ samādhayaḥ /	chanda vyāyāma mīmāṃsā citta ākṛṣṭāḥ samādhayaḥ 
SA_T07_vabhdiku-883	ṛddhipādāstu catvāro guṇasampattiyonayaḥ // Abhidh-d_445 //	ṛddhipādāḥ tu catvāraḥ guṇa sampatti yonayaḥ 
SA_T07_vabhdiku-884	proktaṃ bodhitrayeśitvācchraddhādīndriyapañcakam /	proktam bodhi traya īśi tvāt śraddhā ādi indriya pañcakam 
SA_T07_vabhdiku-885	kathitaṃ balaśabdena tadevānabhibhūtitaḥ // Abhidh-d_446 //	kathitam bala śabdena tat eva anabhibhūtitaḥ 
SA_T07_vabhdiku-886	bodhanārthena nirdiṣṭaṃ śāstrā bodhyaṅgasaptakam /	bodhana arthena nirdiṣṭam śāstrā bodhyaṅga saptakam 
SA_T07_vabhdiku-887	pratītyā paramārthena prajñetyantamanugrahāt // Abhidh-d_447 //	pratītyā paramārthena prajñā ityantam anugrahāt 
SA_T07_vabhdiku-888	prītiprasrabdhyupekṣāṇāmuktāddhetostadaṅgatā /	prīti prasrabdhi upekṣāṇām uktāt hetoḥ tad aṅga tā 
SA_T07_vabhdiku-889	saṃkalpādeścatuṣkasya patho jñeyānukūlyataḥ // Abhidh-d_448 //	saṃkalpa ādeḥ catuṣkasya pathaḥ jñeya ānukūlyataḥ 
SA_T07_vabhdiku-890	vidyāprabhaḥ ślakṣṇavikalpabhūmiḥ śīlānuyātraḥ smṛtivīryamitraḥ /	               
SA_T07_vabhdiku-891	samādhisarvādhisukhopabhogo mārgo vimuktidvayadhiṣṇyago 'yam // Abhidh-d_449 //	                 
SA_T07_vabhdiku-892	prādhānyaṃ saptavargasya prārambhoṣmagatādiṣu /	prādhānyam saptavargasya prārambha ūṣma gata ādiṣu 
SA_T07_vabhdiku-893	yathākramaṃ viboddhavyaṃ bhāvanādṛṣṭimārgayoḥ // Abhidh-d_450 //	yathākramam viboddhavyam bhāvanā dṛṣṭi mārgayoḥ 
SA_T07_vabhdiku-894	na cittaṃ rājakalpatvād guṇadoṣānuvartanāt /	na cittam rāja kalpa tvāt guṇa doṣa anuvartanāt 
SA_T07_vabhdiku-895	vyavahārānukūlyatvāt saṃjñā hyeteṣu neṣyate // Abhidh-d_451 //	vyavahāra ānukūlya tvāt saṃjñā hi eteṣu na iṣyate 
SA_T07_vabhdiku-896	vipākaphalanimnatvānmārgokteśca na cetanā /	vipāka phala nimna tvāt mārga ukteḥ ca na cetanā 
SA_T07_vabhdiku-897	nāprādhānyānmanaskāro vidyāvidyāpravartanāt // Abhidh-d_452 //	na a prādhānyāt manaskāraḥ vidyā avidyā pravartanāt 
SA_T07_vabhdiku-898	kriyārambhapradhānatvānna cchando vīryabṛṃhaṇāt /	kriyā ārambha pradhāna tvāt na chandaḥ vīrya bṛṃhaṇāt 
SA_T07_vabhdiku-899	nādhimokṣaḥ samāropānna sparśo daurvibhāvyataḥ // Abhidh-d_453 //	na adhimokṣaḥ samāropāt na sparśaḥ daurvibhāvyataḥ 
SA_T07_vabhdiku-900	nāryavaṃśa hryapatrāpyā aviśāradavṛttitaḥ /	a viśārada vṛttitaḥ 
SA_T07_vabhdiku-901	nāpramādaḥ parāṅgatvānnāvihiṃsāviheṭhanāt // Abhidh-d_454 //	na apramādaḥ para aṅga tvāt na avihiṃsā viheṭhanāt 
SA_T07_vabhdiku-902	sattvādhiṣṭhānavṛttitvānna maitrīkaruṇādayaḥ /	sattva adhiṣṭhāna vṛtti tvāt na maitrī karuṇā ādayaḥ 
SA_T07_vabhdiku-903	mārgāṅgākṣaikadeśatvānnāpyavetyaprasattayaḥ // Abhidh-d_455 //	mārga aṅga akṣa eka deśa tvāt na api avetya prasattayaḥ 
SA_T07_vabhdiku-904	nādveṣaḥ śubhamūlebhyaḥ sattvagocarabhāvataḥ /	na a dveṣaḥ śubha mūlebhyaḥ sattva gocara bhāvataḥ 
SA_T07_vabhdiku-905	audāsīnyānna nirvāṇaṃ daviṣṭhyānna paradhvaniḥ // Abhidh-d_456 //	audāsīnyāt na nirvāṇam daviṣṭhyāt na para dhvaniḥ 
SA_T07_vabhdiku-906	bodhyaṅgānyarajaskāni bodhernediṣṭabhāvataḥ /	bodhi aṅgāni arajaskāni bodheḥ nediṣṭa bhāvataḥ 
SA_T07_vabhdiku-907	tadanyānyavabodhyāni samalānyamalānyapi // Abhidh-d_457 //	tad anyāni avabodhyāni sa malāni amalāni api 
SA_T07_vabhdiku-908	ādye dhyāne 'khilā maule 'nāgamye prītyapākṛtāḥ /	ādye dhyāne khilāḥ maule na agamye prīti apākṛtāḥ 
SA_T07_vabhdiku-909	dvitīye 'pyapasaṃkalpā dvayoścāsmāt dvayādṛte // Abhidh-d_458 //	dvitīye pi apasaṃkalpāḥ dvayoḥ ca asmāt dvayāt ṛte 
SA_T07_vabhdiku-910	śīlāṅgebhyaśca tābhyāṃ ca draṣṭavyā triṣvarūpiṣu /	śīla aṅgebhyaḥ ca tābhyām ca draṣṭavyā triṣu arūpiṣu 
SA_T07_vabhdiku-911	bodhyaṅgebhyaśca sarvebhyo kāme bodhyaṅgavarjitāḥ // Abhidh-d_459 //	bodhyaṅgebhyaḥ ca sarvebhyaḥ kāme bodhyaṅga varjitāḥ 
SA_T07_vabhdiku-912	yastatprathamatāḥ proktāścatasrastatra kovidaiḥ /	yaḥ tad prathamatas proktāḥ catasraḥ tatra kovidaiḥ 
SA_T07_vabhdiku-913	nyāmāvakrāntivairāgyaphalāptyakṣavivṛddhiṣu // Abhidh-d_460 //	           
SA_T07_vabhdiku-914	aṣṭānāṃ nīrajaskānāṃ mārgāṅgānāṃ yathāyatham /	aṣṭānām nīrajaskānām mārga aṅgānām yathāyatham 
SA_T07_vabhdiku-915	tāsvekasyādhvasu jñeyau lābhālābhau navāśrayau // Abhidh-d_461 //	tāsu ekasya adhvasu jñeyau lābha alābhau nava āśrayau 
SA_T07_vabhdiku-916	trisatyādhigame lābhaḥ śīladharmaprasādayoḥ /	tri satya adhigame lābhaḥ śīla dharma prasādayoḥ 
SA_T07_vabhdiku-917	mārgasatyekṣaṇe buddhasaṅghagocarayorapi // Abhidh-d_462 //	mārga satya īkṣaṇe buddha saṅgha gocarayoḥ api 
SA_T07_vabhdiku-918	bauddhātsaṅghādṛte mārgādyā śraddhā satyagocarā /	bauddhāt saṅghāt ṛte mārga ādyā śraddhā satya gocarā 
SA_T07_vabhdiku-919	dharmāvetyaprasādosau saṃpratītyaprabhāvataḥ // Abhidh-d_463 //	saṃprati itya prabhāvataḥ 
SA_T07_vabhdiku-920	mohanidrātamonāśāddhīnetronmīlanāt svayam /	              
SA_T07_vabhdiku-921	buddho yastadguṇe śraddhā prasādaḥ sa jine mataḥ // Abhidh-d_464 //	buddhaḥ yaḥ tad guṇe śraddhā prasādaḥ sa jine mataḥ 
SA_T07_vabhdiku-922	śaikṣāśaikṣaguṇāḍhyānāṃ pudgalānāṃ ya ākaraḥ /	śaikṣa aśaikṣa guṇa āḍhyānām pudgalānām yaḥ ākaraḥ 
SA_T07_vabhdiku-923	tadguṇālambanā śraddhā prasādaḥ saṅkhagocaraḥ // Abhidh-d_465 //	tad guṇa ālambanā śraddhā prasādaḥ 
SA_T07_vabhdiku-924	śīlānāṃ yattu vaimalyaṃ tatprasādastathaiva tu /	śīlānām yat tu vaimalyam tad prasādaḥ tathā eva tu 
SA_T07_vabhdiku-925	dravyato dvayamevaitannāmatastu catuṣṭayam // Abhidh-d_466 //	dravyataḥ dvayam eva etat nāmataḥ tu catuṣṭayam 
SA_T07_vabhdiku-926	śaikṣasya bandhaśeṣatvādvimuktirnāṅgamiṣyate /	śaikṣasya bandha śeṣa tvāt vimuktiḥ nā aṅgam iṣyate 
SA_T07_vabhdiku-927	mokṣādhimokṣarūpatvānnityānityatvato dvidhā // Abhidh-d_467 //	mokṣa adhimokṣa rūpa tvāt nitya anitya tvataḥ dvidhā 
SA_T07_vabhdiku-928	pūrvoktaiva hi yā bodhiḥ sā samyagjñānamucyate /	pūrva uktā eva hi yā bodhiḥ sā samyak jñānam ucyate 
SA_T07_vabhdiku-929	mucyate 'nāgataṃ cittamaśaikṣaṃ kleśarodhataḥ // Abhidh-d_468 //	mucyate na āgatam cittam aśaikṣam kleśa rodhataḥ 
SA_T07_vabhdiku-930	dharmavyāpārato loke dharmyapi vyāpṛto mataḥ /	dharma vyāpārataḥ loke dharmī api vyāpṛtaḥ mataḥ 
SA_T07_vabhdiku-931	mārgastūpāttakāritro nirasyati tadāvṛtim // Abhidh-d_469 //	mārgaḥ tu upātta kāritraḥ nirasyati tad āvṛtim 
SA_T07_vabhdiku-932	vimuktiḥ śāśvatī yaiva sā virāgādayastrayaḥ /	vimuktiḥ śāśvatī yā eva sā virāga ādayaḥ trayaḥ 
SA_T07_vabhdiku-933	ākhyātā dhātavaḥ sūtre tridhā bhedo hyapekṣayā // Abhidh-d_470 //	ākhyātāḥ dhātavaḥ sūtre tridhā bhedaḥ hi apekṣayā 
SA_T07_vabhdiku-934	virāgo rāganirmokṣaḥ prahāṇākhyo 'nyasaṃkṣayaḥ /	           
SA_T07_vabhdiku-935	nirodhadhāturanyasya sopādānasya vastunaḥ // Abhidh-d_471 //	nirodha dhātuḥ anyasya sa upādānasya vastunaḥ 
SA_T07_vabhdiku-936	duḥkhahetvavalambinyā yogī nirvidyate dhiyā /	duḥkha hetu avalambinyā yogī nirvidyate dhiyā 
SA_T07_vabhdiku-937	virajyate tu saṃraktastataḥ koṭicatuṣṭayī // Abhidh-d_472 //	virajyate tu saṃraktaḥ tatas koṭi catuṣṭayī 
SA_T07_vabhdiku-938	saṃjñā anityasaṃjñādyā daśa tābhyo 'śubhādayaḥ /	saṃjñāḥ anitya saṃjñā ādyāḥ daśa śubha ādayaḥ 
SA_T07_vabhdiku-939	tisro mārgavidhirmārgaścatastro 'ntyāstrayī phalam // Abhidh-d_473 //	tisraḥ mārga vidhiḥ mārgaḥ catastraḥ ntyāḥ trayī phalam 
SA_T07_vabhdiku-940	tritayyaśubhasaṃjñādyā jñeyā tatkhalu sāsravāḥ /	tritayī aśubha saṃjñā ādyāḥ jñeyā tat khalu sa āsravāḥ 
SA_T07_vabhdiku-941	samalā nirmalāstvanyā bodhyā nava bhuvo 'malāḥ // Abhidh-d_474 //	sa malāḥ nirmalāḥ tu anyāḥ bodhyāḥ nava bhuvaḥ malāḥ 
SA_T07_vabhdiku-942	bhūmiṣvekādaśasvantyā dhyānādyāsūpalakṣayet /	bhūmiṣu ekādaśasu antyāḥ dhyāna ādyāsu upalakṣayet 
SA_T07_vabhdiku-943	caturthī pañcamī ṣaṣṭhī vidyāt saptasu bhūmiṣu // Abhidh-d_475 //	caturthī pañcamī ṣaṣṭhī vidyāt saptasu bhūmiṣu 
SA_T07_vabhdiku-944	loko 'yaṃ tattvasaṃmugdho jñeyatattve pramuhyati /	lokaḥ yam tattva saṃmugdhaḥ jñeya tattve pramuhyati 
SA_T07_vabhdiku-945	tāni jñānāni vakṣyāmi svarūpādiprapañcataḥ // Abhidh-d_476 //	tāni jñānāni vakṣyāmi sva rūpa ādi prapañcataḥ 
SA_T07_vabhdiku-946	jātidravye nirākṛtya pratipakṣādyapekṣayā /	jāti dravye nirākṛtya pratipakṣa ādi apekṣayā 
SA_T07_vabhdiku-947	tadbhedo daśadhā prokto dharmajñānādināmabhiḥ // Abhidh-d_477 //	tad bhedaḥ daśadhā proktaḥ dharma jñāna ādi nāmabhiḥ 
SA_T07_vabhdiku-948	dharmānvayaviśeṣye dve duḥkhādyaiśca catuṣṭayam /	dharma anvaya viśeṣye dve duḥkha ādyaiḥ ca catuṣṭayam 
SA_T07_vabhdiku-949	dve saṃvṛtyanyacittābhyāṃ kṣayeṇājanmanā dvayam // Abhidh-d_478 //	dve saṃvṛti anya cittābhyām kṣayeṇa ajanmanā dvayam 
SA_T07_vabhdiku-950	pratipakṣaprayogābhyāṃ svabhāvākāragocaraiḥ /	pratipakṣa prayogābhyām svabhāva ākāra gocaraiḥ 
SA_T07_vabhdiku-951	tadvyavasthā niboddhavyā kṛtyenopacayena vā // Abhidh-d_479 //	tad vyavasthā niboddhavyā kṛtyena upacayena vā 
SA_T07_vabhdiku-952	dhātusatyārthacitteṣu jātidhvaṃsāprajanmanoḥ /	dhātu satya artha citteṣu jāti dhvaṃsa aprajanmanoḥ 
SA_T07_vabhdiku-953	saṃmohasya nivṛttyarthaṃ tadbhedo daśadhaiva vā // Abhidh-d_480 //	saṃmohasya nivṛtti artham tad bhedaḥ daśadhā eva vā 
SA_T07_vabhdiku-954	parijñātādyavagamaḥ duḥkhādau kṣayadhī phalam // Abhidh-d_481 //	            
SA_T07_vabhdiku-955	dhīrākāraḥ sadākāryaṃ sākārāstvavalambinaḥ // Abhidh-d_482 //	dhīra ākāraḥ sadā kāryam sa ākārāḥ tu avalambinaḥ 
SA_T07_vabhdiku-956	paricittamatistrīṇi dharmasaṃjñaṃ nirodhadhīḥ /	pari citta matiḥ trīṇi dharma saṃjñam nirodha dhīḥ 
SA_T07_vabhdiku-957	catvāri smṛtyupasthānānyato 'nyajjñānamiṣyate // Abhidh-d_483 //	catvāri smṛti upasthānāni atas nyat jñānam iṣyate 
SA_T07_vabhdiku-958	mārgadharmānvayajñānagocaro navaśo dhiyaḥ // Abhidh-d_484 //	mārga dharma anvaya jñāna gocaraḥ navaśas dhiyaḥ 
SA_T07_vabhdiku-959	pañcadharmāstridhātvāptān mārgarūpān sanātanān /	pañca dharmāḥ tri dhātu āptān mārga rūpān sanātanān 
SA_T07_vabhdiku-960	vyutpattyarthaṃ dvidhā kṛtvā darśayejjñānagocaram // Abhidh-d_485 //	vyutpatti artham dvidhā kṛtvā darśayet jñāna gocaram 
SA_T07_vabhdiku-961	dṛṅmārge prathame jñāne tribhirjñānaiḥ samanvitaḥ /	dṛś mārge prathame jñāne tribhiḥ jñānaiḥ samanvitaḥ 
SA_T07_vabhdiku-962	caturṣvekaikavṛddhyordhvaṃ virakto 'nyamano dhiyā // Abhidh-d_486 //	caturṣu eka eka vṛddhyā ūrdhvam viraktaḥ nyamanaḥ dhiyā 
SA_T07_vabhdiku-963	tridhyānakāmavairāgye paścime muktivartmani /	tri dhyāna kāma vairāgye paścime mukti vartmani 
SA_T07_vabhdiku-964	mauladhyānaprayoge ca jñeyānāgatabhāvanā // Abhidh-d_487 //	maula dhyāna prayoge ca jñeyā anāgata bhāvanā 
SA_T07_vabhdiku-965	bālasya smṛtyupasthānadhyānādyutpādane tathā /	bālasya smṛti upasthāna dhyāna ādi utpādane tathā 
SA_T07_vabhdiku-966	prayogamuktimārgeṣu saṃvṛtyānyamanodhiyaḥ // Abhidh-d_488 //	prayoga mukti mārgeṣu saṃvṛtya anya manaḥ dhiyaḥ 
SA_T07_vabhdiku-967	kṣāntijñānāni bhāvyante svajātīyāni dṛkpathe /	kṣānti jñānāni bhāvyante sva jātīyāni dṛkpathe 
SA_T07_vabhdiku-968	sāṃvṛtaṃ cānvayajñāne duḥkhahetusamāhvaye // Abhidh-d_489 //	sāṃvṛtam ca anvaya jñāne duḥkha hetu samāhvaye 
SA_T07_vabhdiku-969	samānapratipakṣatvātteṣu mārgāyitatvataḥ /	samāna pratipakṣa tvāt teṣu mārgāyita tvataḥ 
SA_T07_vabhdiku-970	ato 'bhisamayātyākhyaṃ tattrisatyāntalābhataḥ // Abhidh-d_490 //	atas bhi samayāti ākhyam tat tri satya anta lābhataḥ 
SA_T07_vabhdiku-971	mārgākhye tvanvayajñāne ṣaḍ bhāvyante 'tha sapta vā /	mārga ākhye tu anvaya jñāne ṣaṭ bhāvyante sapta vā 
SA_T07_vabhdiku-972	ānantaryapathe corddhvaṃ bhāvyate nānyacittadhīḥ // Abhidh-d_491 //	ānantarya pathe ca ūrddhvam bhāvyate na anya citta dhīḥ 
SA_T07_vabhdiku-973	prahāṇamuktimārgeṣu vināntyāyā vimuktitaḥ /	prahāṇa mukti mārgeṣu vinā antyāyāḥ vimuktitaḥ 
SA_T07_vabhdiku-974	bhavāgrapratipakṣatvātsaṃvṛtasya na bhāvanā // Abhidh-d_492 //	bhava agra pratipakṣa tvāt saṃvṛtasya na bhāvanā 
SA_T07_vabhdiku-975	dhyānādīnāṃ svabhāvādāvavyāghātavisāri yat /	dhyāna ādīnām svabhāva ādau avyāghāta visāri yat 
SA_T07_vabhdiku-976	dhyānādijñānasaṃjñaṃ tannavajñānamayaṃ balam // Abhidh-d_493 //	dhyāna ādi jñāna saṃjñam tat nava jñāna mayam balam 
SA_T07_vabhdiku-977	yatsattvākṣamṛdutvādau paricchede pravartate /	yat sattva akṣa mṛdu tva ādau paricchede pravartate 
SA_T07_vabhdiku-978	akṣottamāvarajñānabalaṃ tannavadhīmayam // Abhidh-d_494 //	akṣa uttama avara jñāna balam tat nava dhī mayam 
SA_T07_vabhdiku-979	yatsattvādhirucitraidhe hīnādau sampravartate /	yat sattva adhiruci traidhe hīna ādau sampravartate 
SA_T07_vabhdiku-980	nānādhimuktidhīsaṃjñe balaṃ tacca navātmakam // Abhidh-d_495 //	nānā adhimukti dhī saṃjñe balam tat ca nava ātmakam 
SA_T07_vabhdiku-981	yannānādhātvapekṣākhyaṃ sattvārthāya pravartate /	yat nānā dhātu apekṣā ākhyam sattva arthāya pravartate 
SA_T07_vabhdiku-982	navajñānamayaṃ tadvattannānādhātudhībalam // Abhidh-d_496 //	nava jñāna mayam tadvat tat nānā dhātu dhī balam 
SA_T07_vabhdiku-983	gatidharmāryabhedaṃ yadvetti pratyayabhedataḥ /	gati dharma ārya bhedam yat vetti pratyaya bhedataḥ 
SA_T07_vabhdiku-984	taddhiyo daśa sarvatragāminīpratipadbalam // Abhidh-d_497 //	tad dhiyaḥ daśa sarvatragāminī pratipad balam 
SA_T07_vabhdiku-985	yat svānyātītajanmekṣisaṃvṛtijñānasaṃjñakam /	                 
SA_T07_vabhdiku-986	prāgjātyānusmṛtijñānabalaṃ tatsaphalaṃ matam // Abhidh-d_498 //	prāc jātya anusmṛti jñāna balam tat saphalam matam 
SA_T07_vabhdiku-987	sattvānāṃ cyutisambhūtyorjñānamanyādhvavṛtti yat /	sattvānām cyuti sambhūtyoḥ jñānam anya adhva vṛtti yat 
SA_T07_vabhdiku-988	taccyutyutpattibuddhyākhyaṃ balaṃ pūrvavaducyate // Abhidh-d_499 //	tad cyuti utpatti buddhi ākhyam balam pūrvavat ucyate 
SA_T07_vabhdiku-989	āsravakṣayadhīsaṃjñaṃ ṣaḍjñānānyathavā daśa /	āsrava kṣaya dhī saṃjñam ṣaḍ jñānāni athavā daśa 
SA_T07_vabhdiku-990	ṣoḍaśākāramatrādyamanyaiścāpyuttaraṃ bhuvā // Abhidh-d_500 //	ṣoḍaśa ākāram atra ādyam anyaiḥ ca api uttaram bhuvā 
SA_T07_vabhdiku-991	saptamaṃ ṣoḍaśākāramavibhaktākṛtidvayam /	saptamam ṣoḍaśa ākāram avibhakta ākṛti dvayam 
SA_T07_vabhdiku-992	aṣṭākāraṃ dvitīyaṃ tu navajñānamayaṃ tu yat // Abhidh-d_501 //	aṣṭa ākāram dvitīyam tu nava jñāna mayam tu yat 
SA_T07_vabhdiku-993	tathāgatabalaṃ proktaṃ tajjñeyaṃ dvādaśākṛti /	tathāgata balam proktam tat jñeyam dvādaśa ākṛti 
SA_T07_vabhdiku-994	sarvagocaramatrādyamantyaṃ śāntyavalambi vā // Abhidh-d_502 //	sarva gocaram atra ādyam antyam śānti avalambi vā 
SA_T07_vabhdiku-995	dvidhā hetubhavālambaṃ saptamaṃ satyagocaram /	dvidhā hetu bhava ālambam saptamam satya gocaram 
SA_T07_vabhdiku-996	atītādyaddhi dhātvarthamaṣṭamaṃ samudāhṛtam // Abhidh-d_503 //	atīta ādyat hi dhātvartham aṣṭamam samudāhṛtam 
SA_T07_vabhdiku-997	navamaṃ khalu rūpārthaṃ saṃskṛtālambyate param /	navamam khalu rūpa artham saṃskṛtā ālambyate param 
SA_T07_vabhdiku-998	dvyapekṣo balaśabdo 'yaṃ balaṃ tvapratighātataḥ // Abhidh-d_504 //	dvi apekṣaḥ bala śabdaḥ yam balam tu apratighātataḥ 
SA_T07_vabhdiku-999	sandhau sandhau ca buddhasya kāyenārāyaṇaṃ balam /	sandhau sandhau ca buddhasya kāyena ārāyaṇam balam 
SA_T07_vabhdiku-1000	spraṣṭavyamadhikaṃ tattu daśa hastyādisaptakāt // Abhidh-d_505 //	spraṣṭavyam adhikam tat tu daśa hasti ādi saptakāt 
SA_T07_vabhdiku-1001	svaparārthāntasamprāptervaiśāradyacatuṣṭayam /	sva para artha anta samprāpteḥ vaiśāradya catuṣṭayam 
SA_T07_vabhdiku-1002	ādyantabalarūpe dve dve karma pratipaddhiyoḥ // Abhidh-d_506 //	ādi anta bala rūpe dve dve karma pratipad dhiyoḥ 
SA_T07_vabhdiku-1003	śrotṛsampattrayāpekṣā trividhā smṛtyupasthitiḥ /	            
SA_T07_vabhdiku-1004	saṃsmārāhitasāmarthyasaṃprajanyasvalakṣaṇā // Abhidh-d_507 //	saṃsmāra āhita sāmarthya saṃprajanya sva lakṣaṇā 
SA_T07_vabhdiku-1005	saṃvṛtijñānarūpatvāddīrghakālānusārataḥ /	saṃvṛti jñāna rūpa tvāt dīrgha kāla anusārataḥ 
SA_T07_vabhdiku-1006	sarvatra samavṛttyāderbaddhasyaiva mahākṛpā // Abhidh-d_508 //	sarvatra sama vṛtti ādeḥ baddhasya eva mahā kṛpā 
SA_T07_vabhdiku-1007	araṇā praṇidhijñānaṃ catasraḥ pratisaṃvidaḥ /	araṇā praṇidhi jñānam catasraḥ pratisaṃvidaḥ 
SA_T07_vabhdiku-1008	arhatsāntānikā hyete pañca tu prāntakoṭikāḥ // Abhidh-d_509 //	arhat sāntānikāḥ hi ete pañca tu prānta koṭikāḥ 
SA_T07_vabhdiku-1009	itarairapi sāmānyā apramādādayo guṇāḥ /	itaraiḥ api sāmānyāḥ apramāda ādayaḥ guṇāḥ 
SA_T07_vabhdiku-1010	eṣāṃ yathopadiṣṭānāṃ śṛṇu vakṣyāmi lakṣaṇam // Abhidh-d_510 //	eṣām yathā upadiṣṭānām śṛṇu vakṣyāmi lakṣaṇam 
SA_T07_vabhdiku-1011	araṇā saṃvṛtijñānaṃ nṛjāntyadhyānaniśrayāt /	            
SA_T07_vabhdiku-1012	āryasantānikā jātā savastukamalekṣiṇī // Abhidh-d_511 //	ārya santānikā jātā sa vastu kamala īkṣiṇī 
SA_T07_vabhdiku-1013	praṇidhijñānamapyevaṃ sarvadharmāvalambi tu /	praṇidhi jñānam api evam sarva dharma avalambi tu 
SA_T07_vabhdiku-1014	akopyadharmaṇo khyāte tathaiva pratisaṃvidaḥ // Abhidh-d_512 //	a kopya dharmaṇaḥ khyāte tathā eva pratisaṃvidaḥ 
SA_T07_vabhdiku-1015	vivakṣitārthasambandhināmasaṃmohabhedinī /	           
SA_T07_vabhdiku-1016	ādyānyā tadabhivyaṅgyā jñeyā jñānavicāriṇī // Abhidh-d_513 //	ādyā anyā tad abhivyaṅgyā jñeyā jñāna vicāriṇī 
SA_T07_vabhdiku-1017	tṛtīyā śabdasaṃskārā jñānasaṃmohaghātinī /	tṛtīyā śabda saṃskārā jñāna saṃmoha ghātinī 
SA_T07_vabhdiku-1018	turīyā tu prabandhoktirdhyānādyutpādanonmukhī // Abhidh-d_514 //	turīyā tu prabandha uktiḥ dhyāna ādi utpādana unmukhī 
SA_T07_vabhdiku-1019	arthākhyā khalu sarvatra ṣaḍjñānānyathavā nava /	artha ākhyā khalu sarvatra ṣaḍ jñānāni athavā nava 
SA_T07_vabhdiku-1020	pratibhānāhvayāpyevaṃ daśajñānamayī tvasau // Abhidh-d_515 //	pratibhā anāhvayā api evam daśa jñāna mayī tu asau 
SA_T07_vabhdiku-1021	kāme dhyāneṣu dharmākhyā tadanyā tvādyakāmayoḥ /	kāme dhyāneṣu dharma ākhyā tad anyā tu ādya kāmayoḥ 
SA_T07_vabhdiku-1022	saṃvṛtijñānamayyau tu dve ete pratisaṃvidau // Abhidh-d_516 //	saṃvṛti jñāna mayyau tu dve ete pratisaṃvidau 
SA_T07_vabhdiku-1023	ṛddhau śrotre 'nyacitte prāgbhāve cyutyudaye kṣaye /	ṛddhau śrotre nyacitte prāgbhāve cyuti udaye kṣaye 
SA_T07_vabhdiku-1024	jñānasākṣātkriyābhijñā ṣaḍvā dhīḥ muktivartmani // Abhidh-d_517 //	jñāna sākṣātkriyā abhijñā ṣaṣ vā dhīḥ mukti vartmani 
SA_T07_vabhdiku-1025	catasraḥ saṃvṛtijñānaṃ pañca jñānāni cittadhīḥ /	catasraḥ saṃvṛti jñānam pañca jñānāni citta dhīḥ 
SA_T07_vabhdiku-1026	sarvāsravakṣayābhijñā ṣaḍjñānānyathavā daśa // Abhidh-d_518 //	sarva āsrava kṣaya abhijñā ṣaḍ jñānāni athavā daśa 
SA_T07_vabhdiku-1027	ṣaṣṭhī sarvatra pañcānyā maulīṣu dhyānabhūmiṣu /	ṣaṣṭhī sarvatra pañcā anyā maulīṣu dhyāna bhūmiṣu 
SA_T07_vabhdiku-1028	yatnavairāgyato labhyāḥ svabhūmyadharagocarāḥ // Abhidh-d_519 //	yatna vairāgyataḥ labhyāḥ sva bhūmi adhara gocarāḥ 
SA_T07_vabhdiku-1029	smṛtyupasthitayastistraścetaḥparyāyadhīrmatā /	smṛti upasthitayaḥ tistraḥ cetaḥ paryāya dhīḥ matā 
SA_T07_vabhdiku-1030	ṛddhiśrotrākṣyabhijñāsnu prathamā smṛtyupasthitiḥ // Abhidh-d_520 //	ṛddhi śrotra akṣi abhijñā asnu prathamā smṛti upasthitiḥ 
SA_T07_vabhdiku-1031	divyamavyākṛtaṃ śrotraṃ netraṃ cānyā śubhā matāḥ /	divyam avyākṛtam śrotram netram ca anyā śubhāḥ matāḥ 
SA_T07_vabhdiku-1032	abhijñāphalatābhijñā manovijñānaprajñayā // Abhidh-d_521 //	abhijñā phala tā abhijñā manaḥ vijñāna prajñayā 
SA_T07_vabhdiku-1033	tisro vidyā matāstryadhvasaṃmohādivyudastaye /	tisraḥ vidyāḥ matāḥ tri adhva saṃmoha ādi vyudastaye 
SA_T07_vabhdiku-1034	ekā svabhāvato 'śaikṣī dve tvaśaikṣāśrayodayāt // Abhidh-d_522 //	ekā śaikṣī dve tu aśaikṣa āśraya udayāt 
SA_T07_vabhdiku-1035	ṛddhicittakṣayābhijñā pratihāryatrayaṃ smṛtam /	ṛddhi citta kṣaya abhijñā pratihārya trayam smṛtam 
SA_T07_vabhdiku-1036	harato dve kuśāstṛbhyo mārebhyo harate param // Abhidh-d_523 //	harataḥ dve kuśa astṛbhyaḥ mārebhyaḥ harate param 
SA_T07_vabhdiku-1037	samādhī ṛddhirityuktā phalamaiśvaryaṣṭadhā /	samādhī ṛddhiḥ iti uktā phalam aiśvarya aṣṭadhā 
SA_T07_vabhdiku-1038	dvidhaitadgatinirmāṇe trividhā gatiriṣyate // Abhidh-d_524 //	dvidhā etat gati nirmāṇe trividhā gatiḥ iṣyate 
SA_T07_vabhdiku-1039	manomayī gatiḥ śāsturicchāmātrapravṛttitaḥ /	manaḥ mayī gatiḥ śāstuḥ icchā mātra pravṛttitaḥ 
SA_T07_vabhdiku-1040	adhimokṣakṛtānyeṣāṃ tato dehābhivāhinī // Abhidh-d_525 //	adhimokṣa kṛtāni eṣām tatas deha abhivāhinī 
SA_T07_vabhdiku-1041	rūpagandharasasparśāḥ kāme nirmāṇamiṣyate /	rūpa gandha rasa sparśāḥ kāme nirmāṇam iṣyate 
SA_T07_vabhdiku-1042	rūpasparśau matau rūpe sveśarīre 'tha vā bahiḥ // Abhidh-d_526 //	rūpa sparśau matau rūpe vā bahis 
SA_T07_vabhdiku-1043	abhijñāphalacittena tattāni tu caturdaśa /	abhijñā phala cittena tat tāni tu caturdaśa 
SA_T07_vabhdiku-1044	ādyadhyānaphalaṃ dve tairūrdhvabhūmyekavṛddhitaḥ // Abhidh-d_527 //	ādya dhyāna phalam dve taiḥ ūrdhva bhūmi eka vṛddhitaḥ 
SA_T07_vabhdiku-1045	tallābho dhyānavat jñeyaḥ śuddhakācca svataśca tat /	tad lābhaḥ dhyāna vat jñeyaḥ śuddhakāt ca svatas ca tat 
SA_T07_vabhdiku-1046	svabhūmenaiva nirmāṇamadhareṇāpi bhāṣaṇam // Abhidh-d_528 //	sva bhūmena eva nirmāṇam adhareṇa api bhāṣaṇam 
SA_T07_vabhdiku-1047	nirmātraiva sahaiteṣāṃ bhāṣaṇaṃ sugatādṛte /	nirmātrā eva saha eteṣām bhāṣaṇam sugatāt ṛte 
SA_T07_vabhdiku-1048	ekasya bruvataḥ sarve nirmitā bruvate samam // Abhidh-d_529 //	ekasya bruvataḥ sarve nirmitāḥ bruvate samam 
SA_T07_vabhdiku-1049	adhiṣṭhāya tu nirmāṇaṃ bhāṣante 'nyena cetasā /	adhiṣṭhāya tu nirmāṇam bhāṣante cetasā 
SA_T07_vabhdiku-1050	adhiṣṭhānaṃ mṛtasyāpi sthirasyaiva tu vastunaḥ // Abhidh-d_530 //	adhiṣṭhānam mṛtasya api sthirasya eva tu vastunaḥ 
SA_T07_vabhdiku-1051	ajayyekamanekena jayiṇastadviparyayaḥ /	ajayi ekam anekena jayiṇaḥ tad viparyayaḥ 
SA_T07_vabhdiku-1052	avyākṛtamabhijñotthaṃ upapattya tvayaṃ tridhā // Abhidh-d_531 //	avyākṛtam abhijñā uttham tu ayam tridhā 
SA_T07_vabhdiku-1053	arhatāṃ daśadhā tvetadaiśvaryamupapadyate /	arhatām daśadhā tu etat aiśvaryam upapadyate 
SA_T07_vabhdiku-1054	sarvāsravakṣayajñānavimuktidvayayogataḥ // Abhidh-d_532 //	sarva āsrava kṣaya jñāna vimukti dvaya yogataḥ 
SA_T07_vabhdiku-1055	aiśvaryapi samānesminyathokte śāstṛśiṣyayoḥ /	aiśvarī api samāne asmin yathā ukte śāstṛ śiṣyayoḥ 
SA_T07_vabhdiku-1056	antaraṃ sumahacchāsturyattatpūrvamudāhṛtam // Abhidh-d_533 //	antaram su mahat śāstuḥ yat tat pūrvam udāhṛtam 
SA_T07_vabhdiku-1057	sāṅgā cittasthitirdhyānaṃ taccaturdhāṅgabhedataḥ /	sa aṅgā citta sthitiḥ dhyānam tat caturdhā aṅga bhedataḥ 
SA_T07_vabhdiku-1058	dhyānoktirāñjasī tatra bhāktī tatsahabhūṣvapi // Abhidh-d_534 //	dhyāna uktiḥ āñjasī tatra bhāktī tad saha bhūṣu api 
SA_T07_vabhdiku-1059	saṃkṣepādiyamākhyātā dhyānajātiścaturvidhā /	saṃkṣepāt iyam ākhyātā dhyāna jātiḥ caturvidhā 
SA_T07_vabhdiku-1060	dravyabhedānahaṃ tasyāḥ pravakṣyāmi yathāgamam // Abhidh-d_535 //	dravya bhedān aham tasyāḥ pravakṣyāmi yathāgamam 
SA_T07_vabhdiku-1061	sahārūpyacatuṣṭvena samāpattirmatāṣṭadhā /	saha ārūpya catuṣṭvena samāpattiḥ matā aṣṭadhā 
SA_T07_vabhdiku-1062	catuḥ pañceṣu skandheṣu taduktervargavṛttitaḥ // Abhidh-d_536 //	catuḥ pañca iṣu skandheṣu tad ukteḥ varga vṛttitaḥ 
SA_T07_vabhdiku-1063	bhedena tu samāpattidravyāṇi daśa sapta ca /	bhedena tu samāpatti dravyāṇi daśa sapta ca 
SA_T07_vabhdiku-1064	sāmantakaiḥ sahāṣṭābhirdhyānāntarikayāpi ca // Abhidh-d_537 //	sāmantakaiḥ saha aṣṭābhiḥ dhyāna āntarikayā api ca 
SA_T07_vabhdiku-1065	tadbhedāḥ khalvime 'nyepi vakṣyante śāstracoditāḥ /	tad bhedāḥ khalu ime vakṣyante śāstra coditāḥ 
SA_T07_vabhdiku-1066	buddhabuddhestu te sarve tattvenāyānti gocaram // Abhidh-d_538 //	buddha buddheḥ tu te sarve tattvena āyānti gocaram 
SA_T07_vabhdiku-1067	tridhā dhyānāni maulāni sāsvādādiprabhedataḥ /	tridhā dhyānāni maulāni sa āsvāda ādi prabhedataḥ 
SA_T07_vabhdiku-1068	tathaiva traya ārūpyā bhavāgraṃ tu dvidhā matam // Abhidh-d_539 //	tathā eva trayaḥ ārūpyāḥ bhavāgram tu dvidhā matam 
SA_T07_vabhdiku-1069	sāmantāni dvidhā sapta prathamaṃ tu tridhā matam /	sāmantāni dvidhā sapta prathamam tu tridhā matam 
SA_T07_vabhdiku-1070	dhyānāntaraṃ tridhā tadvadakliṣṭaṃ tvadharāśrayam // Abhidh-d_540 //	dhyāna antaram tridhā tadvat akliṣṭam tu adhara āśrayam 
SA_T07_vabhdiku-1071	āsvādavatsatṛṣṇaṃ yacchaddhakaṃ laukikaṃ matam /	āsvāda vat sa tṛṣṇam yat chaddhakam laukikam matam 
SA_T07_vabhdiku-1072	ado(dho?)dhvastaṃ tadāsvādyamatilokamanāsravam // Abhidh-d_541 //	a dodhaḥ dhvastam tat āsvādyam ati lokam anāsravam 
SA_T07_vabhdiku-1073	aṅgānyādye śubhe pañca vitarkaścittasūkṣmatā /	aṅgāni ādye śubhe pañca vitarkaḥ citta sūkṣmatā 
SA_T07_vabhdiku-1074	prītiḥ sukhaṃ samādhānaṃ kliṣṭaṃ sukhavivarjitam // Abhidh-d_542 //	prītiḥ sukham samādhānam kliṣṭam sukha vivarjitam 
SA_T07_vabhdiku-1075	sādhyātmasaprasādāstu sukhaprītisamādhayaḥ /	sādhya ātma sa prasādāḥ tu sukha prīti samādhayaḥ 
SA_T07_vabhdiku-1076	dvitīye 'ṅgāni catvāri kliṣṭe śraddhā sukhādṛte // Abhidh-d_543 //	dvitīye ṅgāni catvāri kliṣṭe śraddhā sukhāt ṛte 
SA_T07_vabhdiku-1077	tṛtīye pañcame prajñā smṛtyupekṣā sukhaṃ sthitiḥ /	tṛtīye pañcame prajñā smṛti upekṣā sukham sthitiḥ 
SA_T07_vabhdiku-1078	kliṣṭe tvaṅgadvayaṃ jñeyaṃ samādhirvedanāsukham // Abhidh-d_544 //	kliṣṭe tu aṅga dvayam jñeyam samādhiḥ vedanā sukham 
SA_T07_vabhdiku-1079	antye catvāryupekṣe dve samādhiḥ smṛtireva ca /	antye catvāri upekṣe dve samādhiḥ smṛtiḥ eva ca 
SA_T07_vabhdiku-1080	kliṣṭe dhyāne caturthe tu dve aṅge vedanā sthitiḥ // Abhidh-d_545 //	kliṣṭe dhyāne caturthe tu dve aṅge vedanā sthitiḥ 
SA_T07_vabhdiku-1081	dravyātmanā daśaikaṃ ca nāmnā tvaṣṭau daśaiva ca /	dravya ātmanā daśa ekam ca nāmnā tu aṣṭau daśa eva ca 
SA_T07_vabhdiku-1082	aṅgānyetāni kathyante catuṣkoṭirataḥ smṛtaḥ // Abhidh-d_546 //	aṅgāni etāni kathyante catuṣkoṭiḥ atas smṛtaḥ 
SA_T07_vabhdiku-1083	śamathasya ca /	śamathasya ca 
SA_T07_vabhdiku-1084	dhyānasāmantakārūpyeṣvaṅgānāmavyavasthitiḥ // Abhidh-d_547 //	dhyāna sāmanta kārūpyeṣu aṅgānām avyavasthitiḥ 
SA_T07_vabhdiku-1085	vitarkacāravidhvaṃsātpraśvāsāśvāsasaṃkṣayāt /	vitarka cāra vidhvaṃsāt praśvāsa āśvāsa saṃkṣayāt 
SA_T07_vabhdiku-1086	upekṣāveditābhāvādantyamānejyamucyate // Abhidh-d_548 //	upekṣā vedita abhāvāt antyam ānejyam ucyate 
SA_T07_vabhdiku-1087	ādye prītisukhopekṣā dvitīye tu sukhādṛte /	ādye prīti sukha upekṣā dvitīye tu sukhāt ṛte 
SA_T07_vabhdiku-1088	sukhopekṣe tṛtīye 'ntye upekṣaiva vidiṣyate // Abhidh-d_549 //	sukha upekṣe tṛtīye ntye upekṣā eva vidiṣyate 
SA_T07_vabhdiku-1089	dṛkchrotrakāyavijñānaṃ vijñaptijanakaṃ tathā /	dṛś śrotra kāya vijñānam vijñapti janakam tathā 
SA_T07_vabhdiku-1090	yadbhūmāvavicārāyāmādyādavyākṛtaṃ tu tat // Abhidh-d_550 //	yat bhūmau avicārāyām ādyāt avyākṛtam tu tat 
SA_T07_vabhdiku-1091	khanimittodgrahākṛṣṭaḥ proktānantamanaskṛtiḥ /	                      
SA_T07_vabhdiku-1092	visarvarūpa ārūpya ākāśānantyasaṃjñakaḥ // Abhidh-d_551 //	visarvarūpaḥ ārūpyaḥ ākāśānantya saṃjñakaḥ 
SA_T07_vabhdiku-1093	tadvaccittavibhutvekṣī vijñānānantyalakṣaṇaḥ /	tadvat citta vibhu tva īkṣī vijñāna ānantya lakṣaṇaḥ 
SA_T07_vabhdiku-1094	vijñānānantyadveṣī ca akiñcanyāhvayaḥ punaḥ // Abhidh-d_552 //	vijñāna ānantya dveṣī ca akiñcanya āhvayaḥ punar 
SA_T07_vabhdiku-1095	tadvittūcchedaśaṅkī ca na saṃjñāsaṃjñasaṃjñakaḥ /	tad vittu uccheda śaṅkī ca na saṃjñā saṃjñā saṃjñakaḥ 
SA_T07_vabhdiku-1096	ādau tathā prayuktatvāt tatsaṃjñā vyapadiśyate // Abhidh-d_553 //	ādau tathā prayukta tvāt tad saṃjñā vyapadiśyate 
SA_T07_vabhdiku-1097	savitarkavicāraṃ yatsāpekṣaṃ sānuvartakam /	sa vitarka vicāram yat sa apekṣam sa anuvartakam 
SA_T07_vabhdiku-1098	cittamāryetarākāraṃ tadānāgamyamucyate // Abhidh-d_554 //	cittam ārya itara ākāram tadā anāgamyam ucyate 
SA_T07_vabhdiku-1099	catvāro dhyāyinaḥ proktāścaturdhyānavidarśanāt /	catvāraḥ dhyāyinaḥ proktāḥ catur dhyāna vidarśanāt 
SA_T07_vabhdiku-1100	sampadvipattisaṃjñāyā hānapakṣyādivedinaḥ // Abhidh-d_555 //	sampad vipatti saṃjñāyāḥ hāna pakṣi ādi vedinaḥ 
SA_T07_vabhdiku-1101	dhyātā proktastathā dhyeyaṃ dhyānaṃ dhyānaphalaṃ tathā /	dhyātā proktaḥ tathā dhyeyam dhyānam dhyāna phalam tathā 
SA_T07_vabhdiku-1102	asiddheruktadoṣatvānnāstyātmādicatuṣṭayam // Abhidh-d_556 //	asiddheḥ ukta doṣa tvāt na asti ātma ādi catuṣṭayam 
SA_T07_vabhdiku-1103	karmānuṣṭhānato mokṣo jñānānuṣṭhānatastathā /	karma anuṣṭhānataḥ mokṣaḥ jñāna anuṣṭhānataḥ tathā 
SA_T07_vabhdiku-1104	vyāpāre sati sadbhāvādyāthātmyāvagamepi ca // Abhidh-d_557 //	vyāpāre sati sadbhāvāt yāthātmya avagame pi ca 
SA_T07_vabhdiku-1105	karma tvatra dvidhā jñeyaṃ puṇyāpuṇyakriyākriye /	karma tu atra dvidhā jñeyam puṇya apuṇya kriyā akriye 
SA_T07_vabhdiku-1106	puṇyakriyā tridhā proktā viratistadvidhoditā // Abhidh-d_558 //	puṇya kriyā tridhā proktā viratiḥ tadvidhā uditā 
SA_T07_vabhdiku-1107	jñānaṃ tu naiṣṭhikaṃ jñeyaṃ yathāpūvaṃmudāhṛtam /	jñānam tu naiṣṭhikam jñeyam yathāpūvam udāhṛtam 
SA_T07_vabhdiku-1108	ato 'nyadbhajate yastu khalīnaṃ carvayatyasau // Abhidh-d_559 //	atas yaḥ tu khalīnam carvayati asau 
SA_T07_vabhdiku-1109	parapīḍāpravṛttatvādvadhalobhānṛtādayaḥ /	para pīḍā pravṛtta tvāt vadha lobha anṛta ādayaḥ 
SA_T07_vabhdiku-1110	apāyahetavo jñeyāḥ śreyodvāravibandhinaḥ // Abhidh-d_560 //	apāya hetavaḥ jñeyāḥ śreyaḥ dvāra vibandhinaḥ 
SA_T07_vabhdiku-1111	yuktārthacodanād duḥkhatrāṇāddoṣānuśāsanāt /	yukta artha codanāt duḥkha trāṇāt doṣa anuśāsanāt 
SA_T07_vabhdiku-1112	śāstramityucyate 'to 'nyajjñeyaṃ vātikabhāṣitam // Abhidh-d_561 //	śāstram iti ucyate vātika bhāṣitam 
SA_T07_vabhdiku-1113	pārasīkādimantrāṇāṃ viṣotsadabalaṃ kvacit /	pārasīka ādi mantrāṇām viṣotsada balam kvacid 
SA_T07_vabhdiku-1114	dṛśyate na tu sarvasminnariṣṭādyanivartanāt // Abhidh-d_562 //	dṛśyate na tu sarvasmin ariṣṭa ādi anivartanāt 
SA_T07_vabhdiku-1115	rāgādyairdūṣyate cittaṃ śraddhādyaiśca viśudhyate /	rāga ādyaiḥ dūṣyate cittam śraddhā ādyaiḥ ca viśudhyate 
SA_T07_vabhdiku-1116	viprasyāpi yatastasmād guṇavāneva mucyate // Abhidh-d_563 //	viprasya api yatas tasmāt guṇavān eva mucyate 
SA_T07_vabhdiku-1117	śuddhaṃ caturvidhaṃ hānabhāgīyādi yathākramam /	śuddham caturvidham hāna bhāgīya ādi yathākramam 
SA_T07_vabhdiku-1118	nyūnatulyabalotkṛṣṭanirmalānuguṇaṃ hi tat // Abhidh-d_564 //	nyūna tulya bala utkṛṣṭa nirmala anuguṇam hi tat 
SA_T07_vabhdiku-1119	kleśasvoparimasthānanīrajaskānuvarti vā /	kleśa sva uparima sthāna nīrajaska anuvarti vā 
SA_T07_vabhdiku-1120	dve trīṇi trīṇi ca dve vā hānapakṣyādyanantaram // Abhidh-d_565 //	dve trīṇi trīṇi ca dve vā hāna pakṣi ādi anantaram 
SA_T07_vabhdiku-1121	vyutkrāntakasamāpattirarhato 'kopyadharmaṇaḥ /	vyutkrāntaka samāpattiḥ arhataḥ kopya dharmaṇaḥ 
SA_T07_vabhdiku-1122	tatprayogo dvidhā bhūmirgatvāgamyajigīṣayā // Abhidh-d_566 //	tad prayogaḥ dvidhā bhūmiḥ gatvā agamya jigīṣayā 
SA_T07_vabhdiku-1123	dharmabhūmyutkrameṇāṣṭau śuddhakākhyādanāsravam /	dharmabhūmi utkrameṇa aṣṭau śuddhaka ākhyāt anāsravam 
SA_T07_vabhdiku-1124	śuddhakācca tṛtīyaṃ svaṃ niṣṭhā śuddhācca nirmalam // Abhidh-d_567 //	śuddhakāt ca tṛtīyam svam niṣṭhā śuddhāt ca nirmalam 
SA_T07_vabhdiku-1125	svordhvā evopajanyante dhyānārūpyabhavaḥ śubhāḥ /	sva ūrdhvāḥ eva upajanyante dhyāna ārūpya bhavaḥ śubhāḥ 
SA_T07_vabhdiku-1126	bhavāgrasthastvagatyādau nirmalāmavalambate // Abhidh-d_568 //	bhava agra sthaḥ tu agati ādau nirmalām avalambate 
SA_T07_vabhdiku-1127	bālādyadhyānasaṃprāptau laukikasyaiva bhāvanā /	bāla ādi adhyāna saṃprāptau laukikasya eva bhāvanā 
SA_T07_vabhdiku-1128	ūṣmādivarjye cālabdhe dhyānāntarasamudbhave // Abhidh-d_569 //	ūṣma ādi varjye ca alabdhe dhyāna antara samudbhave 
SA_T07_vabhdiku-1129	vītarāgasya cālabdhe pūrvasāmantake tathā /	vīta rāgasya ca alabdhe pūrva sāmantake tathā 
SA_T07_vabhdiku-1130	viraktasya tu pūrvasya nirmalasyaiva bhāvanā // Abhidh-d_570 //	viraktasya tu pūrvasya nirmalasya eva bhāvanā 
SA_T07_vabhdiku-1131	nyāmamārgānvayajñāne śaikṣasyākṣavivardhane /	nyāma mārga anvaya jñāne śaikṣasya akṣa vivardhane 
SA_T07_vabhdiku-1132	ānantaryāhvaye mārge dṛṅmārge dvādaśakṣaṇāḥ // Abhidh-d_571 //	ānantarya āhvaye mārge dṛś mārge dvādaśa kṣaṇāḥ 
SA_T07_vabhdiku-1133	bhavāgrasya ca vairāgye kṣayajñānavivarjite /	bhava agrasya ca vairāgye kṣaya jñāna vivarjite 
SA_T07_vabhdiku-1134	ākopyā ................................ // Abhidh-d_572 //	ākopyā 
SA_T07_vabhdiku-1135	āryasya kāmavairāgye carame muktivartmani /	āryasya kāma vairāgye carame mukti vartmani 
SA_T07_vabhdiku-1136	jñānatraye trayākhye ca nyāme 'nāgamyavarjite // Abhidh-d_573 //	jñāna traye traya ākhye ca nyāme na agamya varjite 
SA_T07_vabhdiku-1137	śaikṣasya rāgiṇaḥ pūrvatribhūmīndriyavardhane /	śaikṣasya rāgiṇaḥ pūrva tri bhūmi indriya vardhane 
SA_T07_vabhdiku-1138	prayogamuktimārgeṣu kāmādyadhyānajasya ca // Abhidh-d_574 //	prayoga mukti mārgeṣu kāma ādi adhyāna jasya ca 
SA_T07_vabhdiku-1139	dvividhārhatvasaṃprāptau muktivartmani paścime /	dvividha arha tva saṃprāptau mukti vartmani paścime 
SA_T07_vabhdiku-1140	viraktānāṃ ca śaikṣāṇāmavyagrānyatribhūjaye // Abhidh-d_575 //	viraktānām ca śaikṣāṇām avyagra anya tribhū jaye 
SA_T07_vabhdiku-1141	bhāvanā dvividhasyāpi nobhayasya tu bhāvanām /	bhāvanāḥ dvividhasya api na ubhayasya tu bhāvanām 
SA_T07_vabhdiku-1142	anāgamyāśraye nyāma tadbhāgīyodbhavādiṣu // Abhidh-d_576 //	anāgamya āśraye nyāma tad bhāgīya udbhava ādiṣu 
SA_T07_vabhdiku-1143	dvitīyādiṣvanenaiva vidhinābhyuhya yuktitaḥ /	dvitīya ādiṣu anena eva vidhinā abhyuhya yuktitaḥ 
SA_T07_vabhdiku-1144	abhidharmanayajñāne jñeyānāgatabhāvanā // Abhidh-d_577 //	abhidharma naya jñāne jñeya anāgata bhāvanā 
SA_T07_vabhdiku-1145	sāsvādaḥ svabhavālambaḥ śubhaṃ dhyānaṃ samantadṛk /	sa āsvādaḥ sva bhava ālambaḥ śubham dhyānam samanta dṛś 
SA_T07_vabhdiku-1146	ārupyāḥ kuśalā maulā nādholokāvalambinaḥ // Abhidh-d_578 //	ārupyāḥ kuśalāḥ maulāḥ na adhas loka avalambinaḥ 
SA_T07_vabhdiku-1147	dhyānārūpyaiḥ prahīyante nirmalairmānaso malāḥ /	dhyāna ārūpyaiḥ prahīyante nirmalaiḥ mānasaḥ malāḥ 
SA_T07_vabhdiku-1148	adhobhūmestu labhyante sāmantairapi śuddhakaiḥ // Abhidh-d_579 //	adhas bhūmeḥ tu labhyante sāmantaiḥ api śuddhakaiḥ 
SA_T07_vabhdiku-1149	savitarkavicārādyāstrayaḥ proktāḥ samādhayaḥ /	sa vitarka vicāra ādyāḥ trayaḥ proktāḥ samādhayaḥ 
SA_T07_vabhdiku-1150	dhyānāntare sa cārodhaḥ sadvayo 'nyatra nirdvayaḥ // Abhidh-d_580 //	dhyāna antare sa ca ārodhaḥ sa dvayaḥ nyatra nirdvayaḥ 
SA_T07_vabhdiku-1151	sāsravānāsravaścānya ekādaśabhuvastrayaḥ /	sa āsrava anāsravaḥ ca anye ekādaśa bhuvaḥ trayaḥ 
SA_T07_vabhdiku-1152	āryākāramatidyotāḥ śūnyatādyaḥ samādhayaḥ // Abhidh-d_581 //	ārya ākāra mati dyotāḥ śūnyatā ādyaḥ samādhayaḥ 
SA_T07_vabhdiku-1153	daśāpraṇihitākārāḥ śūnyatāyā dvayaṃ matam /	daśa apraṇihita ākārāḥ śūnyatāyāḥ dvayam matam 
SA_T07_vabhdiku-1154	animitto 'mṛtākāraiścaturbhiḥ saṃpravartate // Abhidh-d_582 //	animittaḥ mṛta ākāraiḥ caturbhiḥ saṃpravartate 
SA_T07_vabhdiku-1155	vimukterdviprakārāyāḥ prāptaye nirmalāḥ punaḥ /	vimukteḥ dvi prakārāyāḥ prāptaye nirmalāḥ punar 
SA_T07_vabhdiku-1156	vimokṣasu(mu ?)	vimokṣa sumu 
SA_T07_vabhdiku-1157	khaśabdena ta evāviṣkṛtāstrayaḥ // Abhidh-d_583 //	kha śabdena te eva āviṣkṛtāḥ trayaḥ 
SA_T07_vabhdiku-1158	trayo 'parasamādhyākhyā śūnyatāśūnyatādayaḥ /	            
SA_T07_vabhdiku-1159	dvayamālambate 'śaikṣaṃ śūnyato 'nityatastathā // Abhidh-d_584 //	dvayam ālambate śaikṣam śūnyatas nityatas tathā 
SA_T07_vabhdiku-1160	kṣayamapratisaṃkhyākhyamantyo gṛhṇāti śāntataḥ /	kṣayam apratisaṃkhyā ākhyam antyaḥ gṛhṇāti śāntataḥ 
SA_T07_vabhdiku-1161	ekādaśabhuvaḥ sarve sāsravā nṛṣvakopinaḥ // Abhidh-d_585 //	ekādaśa bhuvaḥ sarve sa āsravāḥ nṛṣu akopinaḥ 
SA_T07_vabhdiku-1162	samādhibhāvanādhyānaṃ sukhāya prathamaṃ śubham /	samādhi bhāvanā dhyānam sukhāya prathamam śubham 
SA_T07_vabhdiku-1163	darśanāyākṣyabhijñoktā prajñābhedāya yātnikāḥ // Abhidh-d_586 //	darśanāya akṣi abhijñā uktā prajñā bhedāya yātnikāḥ 
SA_T07_vabhdiku-1164	yo 'ntyo vajropame dhyāne sarvakleśakṣayāya sā /	yaḥ ntyaḥ vajra upame dhyāne sarva kleśa kṣayāya sā 
SA_T07_vabhdiku-1165	sūtraṃ caitatsamākhyātaṃ buddhenātmopanāyikam // Abhidh-d_587 //	sūtram ca etat samākhyātam buddhena ātma upanāyikam 
SA_T07_vabhdiku-1166	caturṇāmapramāṇānāṃ maitryadveṣastathā kṛpā /	caturṇām apramāṇānām maitrī a dveṣaḥ tathā kṛpā 
SA_T07_vabhdiku-1167	muditā prītirekeṣāmupekṣālobha iṣyate // Abhidh-d_588 //	muditā prītiḥ ekeṣām upekṣā lobhaḥ iṣyate 
SA_T07_vabhdiku-1168	vyāpādasya vihiṃsāyā aratestṛḍdviṣastathā /	vyāpādasya vihiṃsāyāḥ arateḥ tṛṣ dviṣaḥ tathā 
SA_T07_vabhdiku-1169	pratipakṣo 'yamākhyāto damanārthaṃ svacetasaḥ // Abhidh-d_589 //	pratipakṣaḥ yama ākhyātaḥ damana artham sva cetasaḥ 
SA_T07_vabhdiku-1170	sukhādhāne sukhā maitrī duḥkhanāśonmukhī kṛpā /	sukha ādhāne sukhā maitrī duḥkha nāśa unmukhī kṛpā 
SA_T07_vabhdiku-1171	muditā modanānimnā sattvā ebhyeva paścimā // Abhidh-d_590 //	muditāḥ sattvāḥ ebhyaḥ eva paścimā 
SA_T07_vabhdiku-1172	draṣṭavyā vṛttireteṣāṃ ākāraiḥ sukhitādi bhiḥ /	draṣṭavyā vṛttiḥ eteṣām ākāraiḥ sukhita ādi bhiḥ 
SA_T07_vabhdiku-1173	ebhyastvanyatamenāpi brahmasāyujyamaśnute // Abhidh-d_591 //	ebhyaḥ tu anyatamena api brahma sāyujyam aśnute 
SA_T07_vabhdiku-1174	nṛṣu kāmāvalambīni dhyānayormuditāhvayoḥ /	nṛṣu kāma avalambīni dhyānayoḥ muditā āhvayoḥ 
SA_T07_vabhdiku-1175	ṣaḍbhaumāni tadanyāni kecidicchanti saptasu // Abhidh-d_592 //	ṣaḍ bhaumāni tad anyāni kecid icchanti saptasu 
SA_T07_vabhdiku-1176	vimokṣāḥ kathitā aṣṭau teṣāṃ dvāvaśubhātmakau /	vimokṣāḥ kathitāḥ aṣṭau teṣām dvau aśubha ātmakau 
SA_T07_vabhdiku-1177	tāvādyadhyānayorantye tṛtīyo 'lobhalakṣaṇaḥ // Abhidh-d_593 //	tāvādya dhyānayoḥ antye tṛtīyaḥ lobha lakṣaṇaḥ 
SA_T07_vabhdiku-1178	catvāraḥ kuśalārūpā vimokṣākhyā samāhitāḥ /	catvāraḥ vimokṣa ākhyā samāhitāḥ 
SA_T07_vabhdiku-1179	nirodhākhyasamāpattirvimokṣaḥ kathito 'ṣṭamaḥ // Abhidh-d_594 //	nirodha ākhya samāpattiḥ vimokṣaḥ 
SA_T07_vabhdiku-1180	tasyāstu saṃmukhībhāvaḥ sūkṣmasūkṣmādanantaram /	tasyāḥ tu saṃmukhībhāvaḥ sūkṣma sūkṣmāt anantaram 
SA_T07_vabhdiku-1181	vyutthānacittamapyasyāḥ svaṃ śuddhaṃ nirmalaṃ tvadhaḥ // Abhidh-d_595 //	vyutthāna cittam api asyāḥ svam śuddham nirmalam tu adhas 
SA_T07_vabhdiku-1182	kāmāvacaradṛśyārthā vimokṣāḥ prathamāstrayaḥ /	kāmāvacara dṛśya arthāḥ vimokṣāḥ prathamāḥ trayaḥ 
SA_T07_vabhdiku-1183	anye tvanvayadhīpakṣasvordhvaduḥkhādyavekṣiṇāḥ // Abhidh-d_596 //	anye tu anvaya dhī pakṣa sva ūrdhva duḥkha ādi avekṣiṇāḥ 
SA_T07_vabhdiku-1184	sūtre 'bhibhavasaṃjñākhyaṃ proktamāyatanāṣṭakam /	sūtre bhi bhava saṃjñā ākhyam proktam āyatana aṣṭakam 
SA_T07_vabhdiku-1185	vimokṣādhikavṛttyetaccittaiśvaryapradarśakam // Abhidh-d_597 //	vimokṣa adhika vṛtti etat citta aiśvarya pradarśakam 
