segmentnr	original	analyzed
SA_XX_kukalpmu-0	Manuscript 1: KalpM :	manuscript kalpm 
SA_XX_kukalpmu-1	SHT 21 (ed. KalpM pp. 137-193; the fragments IDP SHT 21/	the fragments idp 
SA_XX_kukalpmu-2	113-274 are not yet edited)	are not yet edited 
SA_XX_kukalpmu-3	KalpM : IDP SHT 21/1	kalpm idp sht 
SA_XX_kukalpmu-4	6r1 /// _ _ _ _ ^ _ .yaṃti sarvasatvahitaiṣiṇaḥ 14 atha sa ///	R       yanti sarva sattva hita eṣiṇaḥ atha saḥ 
SA_XX_kukalpmu-5	2 /// + + .. ham api .. .. rvaṃ hi śāpānugraha .. ///	  api   hi   
SA_XX_kukalpmu-6	v2 /// + + dhyātvā tam upāsakaṃ sabahumānavi ///	            
SA_XX_kukalpmu-7	3 /// nā gāndhāraka ity avitathārthānīmāny akṣarāṇi ///	nā gāndhārakaḥ iti avitatha arthāni imāni akṣarāṇi 
SA_XX_kukalpmu-8	KalpM : IDP SHT 21/2	kalpm idp sht 
SA_XX_kukalpmu-9	7r1 /// sadbhiḥ proktā gāndhārakāḥ ///	R sadbhiḥ proktāḥ gāndhārakāḥ 
SA_XX_kukalpmu-10	2 /// hṛdayāny āviṣṭ. + + ///	hṛdayāni āviṣṭ 
SA_XX_kukalpmu-11	3 /// .. .. kiṃ tasyai + ///	ro tasyai 
SA_XX_kukalpmu-12	v1 /// _ _ ^ _ _ ^ ^ _ ^ _ _ m śamena śi _ ^ ^ _ ^ _ _ ///	di-di-di-       
SA_XX_kukalpmu-13	2 /// _ _ ^ _ _ ^ ^ _ ^ _ ti divi kṣitau vā sa ^ _ ^ _ _ ///	divi kṣitau vā 
SA_XX_kukalpmu-14	3 /// ṣau taṃ śaraṇaṃ ///	ṣau tam śaraṇam 
SA_XX_kukalpmu-15	KalpM : IDP SHT 21/3	kalpm idp sht 
SA_XX_kukalpmu-16	10r1 /// pratītyasamutpādapustakopalabdham e ///	       
SA_XX_kukalpmu-17	2 /// + + d evam asya kevalasya maha .. ///	ro evam asya kevalasya 
SA_XX_kukalpmu-18	3 /// + .. .i .o .. + + .. + .. + + + + ///	R 
SA_XX_kukalpmu-19	v1 /// + .. .. t.+ + + .r. + + + .. + + ///	di-2 ro-0 
SA_XX_kukalpmu-20	2 /// pūrvaṃ tu tīrthyamatavipralabdham ā //	pūrvam tu tīrthya mata vipralabdham 
SA_XX_kukalpmu-21	3 /// + + + + .ā .īmā .ā .. .o .. .. ///	R 
SA_XX_kukalpmu-22	KalpM : IDP SHT 21/4	kalpm idp sht 
SA_XX_kukalpmu-23	13r1 /// .. ch. t. + + ///	ro-0 fl-2
SA_XX_kukalpmu-24	2 /// .ād ghaṭeṣv i .. ///	ā t ghaṭeṣu i 
SA_XX_kukalpmu-25	3 /// kauśiko 'bravīt ///	kauśikaḥ bravīt 
SA_XX_kukalpmu-26	v1 /// + .. kathāmu .. ///	ro 
SA_XX_kukalpmu-27	2 /// kauśiko 'bravīt .āṃ ///	kauśikaḥ bravīt āṃ 
SA_XX_kukalpmu-28	KalpM : IDP SHT 21/5	kalpm idp sht 
SA_XX_kukalpmu-29	15r1 /// prakṛtir ity api yad vadaṃti sāṃkhya + + + + ha ..	prakṛtiḥ iti api yat vadanti sāṃkhyaiḥ      
SA_XX_kukalpmu-30	2 /// ḥ prāhus tat kim idānīṃ sāṃkhyajñānād api vi .. .. .. ..ṃ	prāhuḥ tat kim idānīm sāṃkhya jñānāt api 
SA_XX_kukalpmu-31	v2 /// sa eva mama prasādahetuḥ kutaḥ / /	saḥ eva mama prasāda hetuḥ kutas 
SA_XX_kukalpmu-32	ahaṃkāram ani	ahaṃkāram ani 
SA_XX_kukalpmu-33	3 /// mān utsahetāhaṃkāra .i + r.i + + + + + ..	mān utsaheta ahaṃkāraḥ 
SA_XX_kukalpmu-34	KalpM : IDP SHT 21/6	kalpm idp sht 
SA_XX_kukalpmu-35	17r1 + + naiṣa doṣo yat kadāci + .. + .. + + + ///	na eṣa doṣaḥ yat 
SA_XX_kukalpmu-36	2 _ syāt nirhetuke ca janmani śubhā ^ _ _ ^ _ _ _ ///	syāt nirhetuke ca janmani śubhā 
SA_XX_kukalpmu-37	3 + iva .id .ā + + + + .. brāhmaṇaḥ pratī ///	iva id ā      brāhmaṇaḥ 
SA_XX_kukalpmu-38	v1 + + śu .. .. .. + + + vijñānabījam ādau gabh. ///	vijñāna bījam ādau gabh 
SA_XX_kukalpmu-39	2 ^ karmabhiḥ kṣiptaṃ vijñānabījam anya ^ _ _ _ _ ^ _ _ _ 27 _ _ _ _ _ _ _ _ _ _ ^ _ ^ _ _ _ _ _ _ _ _ _ _ _ _	      
SA_XX_kukalpmu-40	3 _ ^ saṃbhavati 28 a + + + + + + + + ///	ro-0 
SA_XX_kukalpmu-41	KalpM : IDP SHT 21/7	kalpm idp sht 
SA_XX_kukalpmu-42	22r1 + + + + + + + + + + śrāmaṇerair uktaḥ kimarthaṃ vayaṃ na nīyāmaha iti / vai ///	śrāmaṇeraiḥ uktaḥ kimartham vayam na nīyāmahe iti vai 
SA_XX_kukalpmu-43	2 ^ _ ^ _ _ ye bhikṣavaḥ khalu jarābhihatā bhavanti _ _ ^ _ ^ ^ ^ _ ^ ^ _ ^ _ _ 1 ///	    khalu     
SA_XX_kukalpmu-44	3 + + + + + + + + + + + + + + utthāyāsanād abruvann apaṇḍitaḥ khalu ///	utthāya āsanāt abruvan apaṇḍitaḥ khalu 
SA_XX_kukalpmu-45	v1 + + + + + + + + + + + + + + sthaviro na tāvatā bhavati yāvatā palitaṃ śiraḥ paripakvaṃ vayas tasya moghajīrṇaḥ sa ucyate 2 yas tu puṇyaṃ ca pāpaṃ ca prahāya brahma	sthaviraḥ na tāvatā bhavati yāvatā palitam śiraḥ paripakvam vayaḥ tasya mogha jīrṇaḥ saḥ ucyate yaḥ tu puṇyam ca pāpam ca prahāya brahma 
SA_XX_kukalpmu-46	2 caryavān viśreṇayitvā carati sa vai sthavira ucyate 3 tan naitad asmā ///	caryavān viśreṇayitvā carati sa vai sthaviraḥ ucyate tat na etat asmai 
SA_XX_kukalpmu-47	3 _ _ ^ _ pravādo marṣayituṃ śakyam asmābhiḥ 4 tat sa ///	               
SA_XX_kukalpmu-48	KalpM : IDP SHT 21/8	kalpm idp sht 
SA_XX_kukalpmu-49	23r1 /// + .. śīghram ṛddhiprabhāvena jīrṇarūpāṇy abhinirmitāni /	    śīghram ṛddhi prabhāvena jīrṇa rūpāṇi abhinirmitāni 
SA_XX_kukalpmu-50	te sarve palitavidyotitaśirogaṇḍapārśvabhrulomabhir avaguṇṭhitākṣi ///	te sarve palita vidyotita śiraḥ gaṇḍa pārśva bhru lomabhiḥ avaguṇṭhita akṣi 
SA_XX_kukalpmu-51	2 /// dhanurvakrapṛṣṭhīvaṃśā yaṣṭiviṣaktapāṇayaḥ pavanabalapracalitā iva supuṣpitāḥ sindhuvāritagulmās tasya dānapateḥ	dhanuḥ vakra pṛṣṭhīvaṃśāḥ yaṣṭi viṣakta pāṇayaḥ pavana bala pracalitāḥ iva su puṣpitāḥ sindhu vārita gulmāḥ tasya dānapateḥ 
SA_XX_kukalpmu-52	3 /// dānapatinā satkṛtya praveśitā muhūrtopaviṣṭāś ca svarūpeṇāva .i + + + + + .. dā .. + + .. t. s. uvāca // tathā jī _ ^ _ _ _ _ _	dānapatinā satkṛtya praveśitāḥ muhūrta upaviṣṭāḥ ca 
SA_XX_kukalpmu-53	v1 _ _ ^ _ ^ _ rasāyanam iva prāśya punar bālatvam āgatāḥ 6 śrāmaṇerā + + + .. + .. na .. + vayam amānuṣāḥ kiṃ tu bhavā ///	    iva prāśya punar bāla tvam āgatāḥ          na     tu   
SA_XX_kukalpmu-54	2 /// kutaḥ //	kutas 
SA_XX_kukalpmu-55	apy eva gādhaṃ varuṇālayasya svatuṇḍasūcyā maśako labheta na tv eva lokaḥ sacarācaro 'yaṃ saṃghā ^ _ _ ^ ^ _ ^	api eva gādham varuṇālayasya sva tuṇḍa sūcyā maśakaḥ labheta na tu eva lokaḥ sa carācaraḥ yam saṃghāḥ 
SA_XX_kukalpmu-56	3 _ _ 7 /// ṇā prabhāvite 'smiñ cchāsane vayaḥ pramāṇīkartuṃ paśyatu bhavān* / / /	prabhāvite smin cchāsane vayaḥ pramāṇīkartum paśyatu bhavān   
SA_XX_kukalpmu-57	bālye vārdhakye vā pramāṇaṃ śarīraṃ buddhā vā _ _ _ ^ _ _ ^	bālye vārdhakye vā pramāṇam śarīram buddhāḥ vā 
SA_XX_kukalpmu-58	KalpM : IDP SHT 21/9	kalpm idp sht 
SA_XX_kukalpmu-59	24r1 tā vā śreyasy udyukto _ ^ _ ho 'py abālo jīrṇo 'py aśreyasy udyato bāla eva 8 + + + + + .āyuṣmatā aṃgulyagreṇeva mahārṇavaṃ saṃghārṇavam avagāhamānena /	vā śreyasi udyuktaḥ       ho pi abālaḥ aśreyasi udyataḥ bālaḥ eva        āyuṣmatā aṃguli agreṇa iva mahā arṇavam saṃgha arṇavam avagāhamānena 
SA_XX_kukalpmu-60	2 kim āyuṣmatā sa śrutapūrvaṃ yad uktaṃ bhagavatā catvāro daharā nāvajñeyā iti /	kim āyuṣmatā sa śruta pūrvam yat uktam bhagavatā catvāraḥ daharāḥ na avajñeyāḥ iti 
SA_XX_kukalpmu-61	catvāraś cāmropamāḥ pudgalā iti na tvayā vicāritaṃ /	catvāraḥ ca āmra upamāḥ pudgalāḥ iti na tvayā vicāritam 
SA_XX_kukalpmu-62	kṣaṇyane pudgalaḥ pudgalasya	kṣaṇyane pudgalaḥ pudgalasya 
SA_XX_kukalpmu-63	3 pramāṇam udgṛhṇann i + + + .. m ṛṣiṇā tad api te vismṛtaṃ /	pramāṇam udgṛhṇan ṛṣiṇā tat api te vismṛtam 
SA_XX_kukalpmu-64	.. .. r. .. .. .. .. .. .. .. .i .. ik. tam apratyāhāryam iti kṛtvā parityajyatāṃ .. + + + + + + + .i .. .. ..	r di di tam apratyāhāryam iti kṛtvā parityajyatām 
SA_XX_kukalpmu-65	v1 niścitā buddhir avasthāpy. + .. neryāpathena na kulena na ca śrutena na vidyayā na vayasā na ca vāgviśudhyā śakyaṃ pramātum iha kenacid āryasaṃghaḥ _ _ ^ _ guṇa .ṛ _ ^	niścitā buddhiḥ avasthāpya    na īryāpathena na kulena na ca śrutena na vidyayā na vayasā na ca vāc viśudhyā śakyam pramātum iha kenacid ārya saṃghaḥ             
SA_XX_kukalpmu-66	2 gaṇārṇavasya 9 yaṃ tuṣṭuve padaśataiḥ svayam eva buddho yatrālpam apy upakṛtaṃ bahutām upaiti ratnaṃ tṛtīyam iti yat prathitaṃ pṛthivyām arcyaḥ sa śākyamuniśiṣyaga	gaṇa arṇavasya yam tuṣṭuve pada śataiḥ svayam eva buddhaḥ yatra alpam api upakṛtam bahu tām upaiti ratnam tṛtīyam iti yat prathitam pṛthivyām arcyaḥ sa śākyamuni śiṣya ga 
SA_XX_kukalpmu-67	3 naḥ samagraḥ 10 bālo 'yam eṣa ca mahān ayam atra vidvān eṣo 'lpabuddhir iti na pra ^ _ ^ _ _ eraṇḍacaṇpakataruṣv avicārya buddhiṃ yadvad vanaṃ smarasi saṃgham ana	naḥ samagraḥ bālaḥ yam eṣa ca mahān ayam atra vidvān eṣaḥ lpabuddhiḥ iti na        eraṇḍa caṇpaka taruṣu a vicārya buddhim yadvat vanam smarasi saṃgham 
SA_XX_kukalpmu-68	KalpM : IDP SHT 21/10	kalpm idp sht 
SA_XX_kukalpmu-69	26r1 /// śrāmaṇerāḥ procuḥ nanu trī // /	śrāmaṇerāḥ procuḥ nanu trī 
SA_XX_kukalpmu-70	dānapatir uvāca / / /	dānapatiḥ uvāca 
SA_XX_kukalpmu-71	.. samāne 'pi ratnatve bhavaty eva ratnaviśeṣa ity ata	samāne pi ratna tve bhavati eva ratna viśeṣaḥ iti 
SA_XX_kukalpmu-72	2 /// yaḥ śrāmaṇerā // /	yaḥ śrāmaṇerā 
SA_XX_kukalpmu-73	.. ṇam ity ava / / /	ṇam iti ava 
SA_XX_kukalpmu-74	_ _ _ _ bharadvājo yāṃ dadau sarvadarśine a	         
SA_XX_kukalpmu-75	3 _ _ _ ^ _ _ _ trailokye sarva _ ^ _ ///	ro-0 
SA_XX_kukalpmu-76	.āyaya + /	āyaya 
SA_XX_kukalpmu-77	// + + + + + + + + .i .. + + + r.. .i + + + +	R         
SA_XX_kukalpmu-78	v1 /// m etad ihāprā + + // /	etat iha a prā 
SA_XX_kukalpmu-79	.. .. dāna .. / / /	ro-0 
SA_XX_kukalpmu-80	+ + + + + + + + + t. saṃghaḥ pratigrahītā ..	       
SA_XX_kukalpmu-81	2 /// bharadvājasya bho // /	bharadvājasya bho 
SA_XX_kukalpmu-82	procuḥ .aṃ / / /	procuḥ aṃ 
SA_XX_kukalpmu-83	+ + + + + + + tavān /	ro-0 
SA_XX_kukalpmu-84	yady udakagatasya tasya	yadi udaka gatasya tasya 
SA_XX_kukalpmu-85	3 /// dṛṣṭo 'bhaviṣyat ka ///	dṛṣṭaḥ bhaviṣyat ka 
SA_XX_kukalpmu-86	ṣyat /	ṣyat 
SA_XX_kukalpmu-87	eva / / /	eva 
SA_XX_kukalpmu-88	ṇe / / /	ṇe    
SA_XX_kukalpmu-89	buddhodyatam avāpyārthaṃ svasthaḥ khyātigato gaṇaḥ	buddha udyatam avāpya artham svasthaḥ khyāti gataḥ gaṇaḥ 
SA_XX_kukalpmu-90	KalpM : IDP SHT 21/11	kalpm idp sht 
SA_XX_kukalpmu-91	27r1 /// + .. .. bhaviṣyatīti dān. + ///	rocayiṣyati iti 
SA_XX_kukalpmu-92	2 /// .. .. gautamīsūtrādiṣu co + ///	  gautamīsūtra ādiṣu caḥ 
SA_XX_kukalpmu-93	3 /// .. ratnam urupramāṇam a .. ///	ratnam uru pramāṇam 
SA_XX_kukalpmu-94	v1 /// .. saṃsmaraṇe 23 tasmā ///	saṃsmaraṇe tasmai 
SA_XX_kukalpmu-95	2 /// .. ndho munīnāṃ sainyaṃ śūrā .. ///	  munīnām sainyam śūrā 
SA_XX_kukalpmu-96	3 /// + .. .ā .. .. .. .ā .i + ///	R     
SA_XX_kukalpmu-97	KalpM : IDP SHT 21/12	kalpm idp sht 
SA_XX_kukalpmu-98	30r1 /// + + + + + + + + // t. puruṣaṃ sakaruṇaṃ ni .. / ///	         puruṣam sa karuṇam ni 
SA_XX_kukalpmu-99	2 /// akāryaṃ kṛtaṃ sarvathā / / /	akāryam kṛtam sarvathā 
SA_XX_kukalpmu-100	latāvighātavi .. _ _ _ _ _ ^ _ ^ _ 4	     
SA_XX_kukalpmu-101	3 _ _ _ _ ^ _ ^ _ mohād atyaṃta .. _ _ _ _ _ _ ^ _ ^ _ 5 + kaścid amātyo rājño vākyaṃ + ///	             
SA_XX_kukalpmu-102	v1 _ _ ^ _ _ _ _ _ _ tva ^ _ s tv ayam _ _ _ _ ^ _ _ _ _ _ _ _ ^ _ ^ _ 6 puṣpam āropya ya _ _ _ _ _ _ ^ _ ^ _ _ _ _ _ ^ _ _ _	di- di-                                    
SA_XX_kukalpmu-103	2 _ _ _ _ ^ vāptavān* 7 stūpā ^ _ ^ ^ ^ _ ^ ^ _ ^ _ _ _ _ ^ _ ^ ^ ^ _ ṣu nimagnadehaḥ .. ///	          
SA_XX_kukalpmu-104	3 /// + + + + + + /// .. .i .i .. .. .. .. .. ///	R        
SA_XX_kukalpmu-105	KalpM : IDP SHT 21/13	kalpm idp sht 
SA_XX_kukalpmu-106	31r1 /// + . abhyuddhārāya tv asya prayatasva paśya / / / /	  tu   prayatasva paśya  /
SA_XX_kukalpmu-107	nāyam arho vadham a _ _ _ _	na ayam arhaḥ vadham 
SA_XX_kukalpmu-108	2 /// 9 _ _ _ _ ^ _ _ mi buddhaṃ yenārccayiṣyati na hy ṛte buddhapūjāyāḥ śānti _ _ ^ _	buddham yena arcayiṣyati na hi ṛte buddha pūjāyāḥ 
SA_XX_kukalpmu-109	3 ^ _ 10 .. .. .i .. matir ja .. .. .. tathāgataṃ punar abhipūjya .. .. + +	           tathāgatam punar abhipūjya 
SA_XX_kukalpmu-110	v1 /// buddhaśāsanābhivinītena rājñā vadhārham ātmānam avamuktam avekṣya .. .. .. ..	buddha śāsana abhivinītena rājñā vadha arham ātmānam avamuktam avekṣya 
SA_XX_kukalpmu-111	2 /// kāruṇika yat tvayā parinirvṛtenāpy aham adya prāṇair ācchāditaḥ .. .. .. .. .. .. ..	kāruṇika yat tvayā parinirvṛtena api aham adya prāṇaiḥ ācchāditaḥ 
SA_XX_kukalpmu-112	3 /// + duḥkhagharmābhitaptaṃ hi lokaṃ hlādayituṃ bhavān _ _ _ _ ^	            
SA_XX_kukalpmu-113	KalpM : IDP SHT 21/14	kalpm idp sht 
SA_XX_kukalpmu-114	35r1 /// + daṇḍānām iva pu .. ///	R daṇḍānām iva pu 
SA_XX_kukalpmu-115	2 /// .. ta sma svīkartuṃ jā + ///	sma svīkartum 
SA_XX_kukalpmu-116	3 /// .. vitum na śakno .i + ///	ro na śakno i 
SA_XX_kukalpmu-117	v1 /// pṛṣṭas tena coktaṃ + ///	pṛṣṭaḥ tena ca uktam 
SA_XX_kukalpmu-118	2 /// t kaścin māṃsam ānayet ///	t kaścid māṃsam ānayet 
SA_XX_kukalpmu-119	3 /// + kopakupitaḥ prāha ///	kopa kupitaḥ prāha 
SA_XX_kukalpmu-120	KalpM : IDP SHT 21/15	kalpm idp sht 
SA_XX_kukalpmu-121	36r1 /// yady ady. _ _ _ n necchasi hantuṃ ghṛṇā ^ _ _ tvā rājā _ _ _ _ _ _ _ _ ^ _ _ _ 3	yadi adi na icchasi hantum ghṛṇā    tvā rājā 
SA_XX_kukalpmu-122	2 _ _ _ _ _ _ _ _ _ _ ahany ahani hatvā sūtās tubhyaṃ dāsyanty upetya siṃhāsanagatāya 4 _ _ _ _ _ _ _ _ _	                                
SA_XX_kukalpmu-123	3 _ ^ _ ^ _ _ _ _ _ _ _ _ _ .y asakṛt saṃdhūkṣitakrodhaḥ 5 yadi tāvat .. _ _ _ _ _ _ ^ _ ^ _ _ _ _ _ _	asakṛt 
SA_XX_kukalpmu-124	v1 _ _ _ _ _ _ _ ^ _ _ _ 6 _ ^ m iva vadhyapānaṃ vanam iva kusumojjvalaṃ saśā _ _ _ _ _ _ _ _ _ _ _ _ ^ _ _ _ 7 _ _ ^ _ _	iva vadhya pānam vanam iva kusuma ujjvalam 
SA_XX_kukalpmu-125	2 ^ ^ _ ^ _ _ _ _ ^ _ _ ^ ^ _ ^ doṣān aiśvaryavahner avicārya doṣān guṇāṃ ^ _ paśyati bā ^ _ _ 8 _ _ ^ _ _ ^ ^ _ ^ _ _ _ _ ^ _ _	                
SA_XX_kukalpmu-126	3 ^ ^ _ ^ _ _ _ _ ^ _ _ ^ ^ _ diduḥ _ _ _ ^ _ yan maraṇena mālām 9 _ laṃbaci _ ^ ^ _ ^ _ _ _ _ ^ _ _ ^ ^ _ ^	diduḥ      yat maraṇena mālām 
SA_XX_kukalpmu-127	KalpM : IDP SHT 21/16	kalpm idp sht 
SA_XX_kukalpmu-128	37r1 - - - - rathāśvā ^ ^ _ ^ _ ṅgā bhārā ^ _ _ vyas. _ ^ _ _ 10 _ _ ^ _ _ ^ ^ _ ^ _ _ yad yac ca rājā ^ ^ _ ^ _ _ _ _ ^ _ _ ^ ^ _ ^ _ _ _ _	ratha aśvā                                           
SA_XX_kukalpmu-129	2 praviśyeva garapra _ nam 11 visraṃbhaśunye hṛdi _ ^ _ _ _ _ ^ _ _ ^ ^ _ ^ _ _ udvignabuddher viṣaye ^ _ _ _ _ ^ _ _ ^ ^ _ ^ _ _ 12	praviśya iva visraṃbha śunye hṛdi               udvigna buddheḥ viṣaye 
SA_XX_kukalpmu-130	3 baḍiśam ivāmiṣasahitan dhārām iva ca kṣurasya _ _ _ _ _ _ _ _ _ _ t sukham asukhānubandh. _ 13 _ _ _ _ _ _ ^	baḍiśam dhārām iva ca kṣurasya 
SA_XX_kukalpmu-131	v1 m ātmanaḥ paśyasi tvam akṛtātman tasmāc cyutasya parato na ^ _ _ _ ^ _ _ _ 14 ^ _ vahnijvālāśatanicita .. _ ^ ^ ^ _ ^ _ _ _ _ _ ^ ^ ^ ^ ^	ātmanaḥ paśyasi tvam akṛtātman tasmāt cyutasya paratas na 
SA_XX_kukalpmu-132	2 vatsyati bhavān tadā rājyaiśvaryaṃ tava kim anu _ _ ^ ^ ^ _ ^ _ _ _ _ _ ^ ^ ^ m apavarge kuru matim 15 + + + + + + + + + + + + + + + + +	vatsyati bhavān tadā rājya aiśvaryam tava kim anu 
SA_XX_kukalpmu-133	3 .i .. .. .. .i .. .. .. + + .. .. .inivṛ .. .i + .. .. .. .. + + + + + + + + + + + + + + + .ām avalokay. + + + + + + + + + + + + + + + + +	di di di di di di di di                             
SA_XX_kukalpmu-134	KalpM : IDP SHT 21/17	kalpm idp sht 
SA_XX_kukalpmu-135	39r2 /// tīrthyasaṃghānām bhūyaḥ śr. ///	tīrthya saṃghānām bhūyaḥ 
SA_XX_kukalpmu-136	3 /// rṣiṇā tu yat sa ..ṃ .. .. ///	ṛṣiṇā tu yat sa 
SA_XX_kukalpmu-137	v1 /// ^ _ śrameṇānaparādhi pīḍyate 8 ///	        
SA_XX_kukalpmu-138	KalpM : IDP SHT 21/18	kalpm idp sht 
SA_XX_kukalpmu-139	40r1 ^ _ n ujjhati 9 sa _ no mata eva śākyamuninā s. _ ^ _ _ ^ _ _ _ _ ^ ^ _ ^ _ ^ ^ ^ _ _ _ ^ _ _ ^ _ m kin taiḥ kāyapariśramair apaphalai	sa naḥ mataḥ eva śākyamuninā 
SA_XX_kukalpmu-140	2 r ugrais tapovistarair duṣputrā iva ye phalaṃ ^ ^ ^ _ _ _ ^ _ _ ^ _ 10 _ _ _ ^ ^ _ ^ _ ^ ^ ^ saḥ kaṇvādayas tāpasā hetus tatra da	R ugraiḥ tapas vistaraiḥ duṣputrāḥ iva ye phalam saḥ kaṇva ādayaḥ tāpasāḥ hetuḥ tatra da 
SA_XX_kukalpmu-141	3 _ ^ _ ^ ^ ^ _ _ _ ^ _ .oga _ _ _ _ ^ ^ _ ^ _ ^ ^ ^ _ _ _ ^ _ _ ^ _	ro-0 
SA_XX_kukalpmu-142	v1 _ _ _ ^ ^ _ ^ _ ^ ^ ^ _ c chete phal. _ .ch. _ 11 _ _ _ ^ ^ _ ^ _ ^ ^ ^ _ _ _ ^ _ _ ^ _ satyakṣāṃtiśamapradānaniyamajñānāni saṃ	di di c śete phal 
SA_XX_kukalpmu-143	2 sevate satyādes sa gaṇāt sukhāni labhate _ _ ^ _ _ ^ _ _ _ _ ^ ^ _ ^ _ ^ ^ ^ _ _ _ ^ _ _ ^ nam 12 yadā hiṃsro jantur bhaya	sevate satya ādeḥ sa gaṇāt sukhāni labhate 
SA_XX_kukalpmu-144	3 m iha pareṣāṃ janayati cyutāyāṃ hiṃsāyāṃ bhavati ^ ^ _ _ ^ ^ ^ _ ^ _ _ _ _ _ ^ ^ ^	iha pareṣām janayati cyutāyām hiṃsāyām bhavati 
SA_XX_kukalpmu-145	KalpM : IDP SHT 21/19	kalpm idp sht 
SA_XX_kukalpmu-146	41r1 ^ ^ _ _ ^ ^ ^ _ ^ _ _ ś cādrohe bhavati vidito dhārmika iti 13 rasair iṣṭais tṛpto ^ ^ ^ ^ ^ _ _ ^ ^ naro na taddhetoḥ k. _ j janayati	ca adrohe bhavati viditaḥ dhārmikaḥ iti rasaiḥ iṣṭaiḥ tṛptaḥ          naraḥ na tad hetoḥ k janayati 
SA_XX_kukalpmu-147	2 ^ _ _ ^ ^ ^ _ ^ _ _ kṣutkṣāmo bhavati na tad apy aṇv api sukhaṃ pareṣām ādhatte na bhavati tapo 'taḥ sukhaphalam 14 bhaved etan maitrām anusarati	    bhavati na   api   api   pareṣām ādhatte na bhavati                 anusarati 
SA_XX_kukalpmu-148	3 _ ^ ^ ^ _ ^ _ _ _ _ _ ^ ^ ^ phalam asyāsti vipulaṃ tapas tadvan na syāt parasukhakaraṃ syāc ca phalavan na caivaṃ	          na syāt                                   
SA_XX_kukalpmu-149	v1 _ _ _ ^ ^ ^ ^ ^ _ _ ^ ^ ^ _ 15 vākkāyayor aśubhakarmanidānam ugram evaṃ ca yaḥ pratigham āpatitaṃ jahāti tān kevalaśramakarair vviphalais	vāc kāyayoḥ aśubha karma nidānam ugram evam ca yaḥ pratigham āpatitam jahāti tān kevala śrama karaiḥ viphalaiḥ 
SA_XX_kukalpmu-150	2 _ _ ^ _ ^ ^ ^ _ ^ ^ _ m amūḍhaḥ 16 tūṣṇīṃ bhavantu khalu tīrthyagaṇā jino hi svaṃ vādam apratisamaṃ bhuvi nānadīti vyālambakesarasaṭas. .. .i _	amūḍhaḥ tūṣṇīm bhavantu khalu tīrthya gaṇāḥ jinaḥ hi svam vādam apratisamam bhuvi nānadī iti 
SA_XX_kukalpmu-151	3 ^ _ _ _ _ ^ _ ^ ^ ^ _ ^ ^ .ā nadantīti 17 // // -	ro-0 fl-2 fl-3 
SA_XX_kukalpmu-152	KalpM : IDP SHT 21/20	kalpm idp sht 
SA_XX_kukalpmu-153	42r1 + cittādhīnatv. ///	    
SA_XX_kukalpmu-154	ś cittadamam evopadiśanti prājñās tadyathānuśrūyate śākale kila paṃcatapās tapyate sma bhikṣuṇī ca taṃ deśam āgatā ///	citta damam eva upadiśanti prājñāḥ tat yathā anuśrūyate śākale kila paṃcatapāḥ tapyate sma bhikṣuṇī ca tam deśam āgatā 
SA_XX_kukalpmu-155	2 + svinnalalāṭaḥ ///	      
SA_XX_kukalpmu-156	kukṣivakṣaṇavakṣāḥ śuṣkakaṇṭhauṣṭhapṛṣṭhaniṣṭhīvaḥ kanakakapilābhir a.iṃ jvālābhir i .. + + + + + + .i .. .i .. ///	kukṣi vakṣaṇa vakṣāḥ śuṣka kaṇṭha oṣṭha pṛṣṭha niṣṭhīvaḥ kanaka kapilābhiḥ aim jvālābhiḥ 
SA_XX_kukalpmu-157	3 + + + + + + /// .. tapena .. .. .ā .. .i .. .. .. c. .ā .. kutapena prāvṛtaḥ kutapa + + + + + + + + + + + + + + + ///	ro                        
SA_XX_kukalpmu-158	v1 + + + + + + /// .itam anyasmiṃs tāpayitavye 'nyat tāpyata ity atha tena paṃcātapikena parama .r. + + + + + + + + + + + + + + + + + + +	anyasmin tāpayitavye tāpyate iti atha tena pañcātapikena 
SA_XX_kukalpmu-159	2 bhikṣuṇī kathayāmāsa //	bhikṣuṇī kathayāmāsa 
SA_XX_kukalpmu-160	yasya kṣobhād eṣa bhrukuṭīvikṣepadāruṇatarākṣaḥ māṃ vadasi duṣṭamuṇḍety etat saṃtāpyatāṃ cittam 1 asmiṃ hi so ^ _ _ _ _	yasya kṣobhāt eṣa bhrukuṭī vikṣepa dāruṇatara akṣaḥ mām vadasi duṣṭa muṇḍa iti etat saṃtāpyatām cittam asmin hi saḥ 
SA_XX_kukalpmu-161	3 _ te bhaviṣyati ^ _ _ dhūrye hi sārathir iha praharati na syandanaṃ tudati 2 yo hy apratāpya cittaṃ kāyaṃ tāpayati	te bhaviṣyati      dhūrye hi sārathiḥ iha praharati na syandanam tudati yaḥ hi a pratāpya cittam kāyam tāpayati 
SA_XX_kukalpmu-162	KalpM : IDP SHT 21/21	kalpm idp sht 
SA_XX_kukalpmu-163	43r1 _ ^ _ _ _ _ _ _ _ _ _ _ _ _ _ ^ _ _ _ 3 _ _ _ _ _ _ _ _ _ _ ^ _ . caturbhir iha paṭunā ca bh. ^ _ _ _ _	                
SA_XX_kukalpmu-164	2 tivi _ ^ _ _ _ 4 _ _ _ _ _ _ _ _ _ _ ^ _ ^ _ _ _ _ _ _ _ _ ddh. kliśnāsi parapraṇeyam imam 5 kṣeptā _ _ _ _	kliśnāsi para praṇeyam imam 
SA_XX_kukalpmu-165	3 va .. i ^ _ _ ^ _ ^ _ _ _ _ _ _ _ _ _ _ _ _ _ ^ _ _ _ 6 sthānāsanaprasaraṇādiśarīrakarma	                   
SA_XX_kukalpmu-166	v1 ya _ ^ _ ^ ^ ^ _ ^ ^ _ _ _ _ ^ _ ^ ^ ^ _ ^ ^ _ ^ _ _ _ _ ^ _ ^ ^ ^ kāṣṭhanibho hi kāyaḥ 7 puṇyaṃ bhaved yadi kaḍebara _ ^ _ _ _ _	kāṣṭha nibhaḥ hi kāyaḥ puṇyam bhavet yadi 
SA_XX_kukalpmu-167	2 bhave ^ ^ ^ _ ^ ^ _ ^ _ _ _ _ ^ _ ^ ^ ^ _ ^ ^ _ ^ _ _ _ _ ^ _ ^ ^ ^ _ h. kṛtaṃ phalaṃ syāt 8 svacchandata ^ ^ ^ _ ^ ^ _ ^ _ _	              
SA_XX_kukalpmu-168	3 .i _ .i _ ^ ^ ^ _ ^ ^ _ ^ _ _ _ _ ^ _ ^ ^ ^ _ ^ ^ _ lam asti	asti 
SA_XX_kukalpmu-169	KalpM : IDP SHT 21/22	kalpm idp sht 
SA_XX_kukalpmu-170	44r1 _ _ ^ _ ^ ^ ^ _ ^ ^ _ ^ _ _ 9 _ _ ^ _ ^ ^ nam ārabhate śarīraṃ saṃtāpana ^ ^ ^ _ ^ ^ _ ^ _ _ aṅgāvapāṭanasamarjanavṛtt. _ _ _ _ ^	ārabhate śarīram 
SA_XX_kukalpmu-171	2 _ ^ ^ ^ _ ^ ^ _ ^ _ _ 10 _ _ ^ _ ^ ^ iti praparīkṣya teṣāṃ neṣṭaṃ ^ _ ^ ^ ^ _ ^ ^ _ ^ _ _ na syāt phalaṃ sa hi tapa ^ ^ _ ^ _ _	iti praparīkṣya teṣām na iṣṭam               na syāt phalam sa hi tapa 
SA_XX_kukalpmu-172	3 _ _ ^ _ ^ ^ ^ _ ^ ^ _ ^ _ _ 11 _ _ ^ _ ^ ^ śarīrapari ^ _ _ _ _ ^ _ ^ ^ ^ _ ^ ^ _ ^ _ ktāḥ	                                         
SA_XX_kukalpmu-173	v1 _ _ ^ _ ^ ^ ^ _ ^ ^ _ ^ _ _ _ _ ^ _ ^ ^ ^ _ ^ rakasya _ h. 12 _ _ ^ _ ^ ^ ^ .y atha lobhajasya kiṃ _ ^ _ ^ ^ ^	di di di                                         
SA_XX_kukalpmu-174	2 _ ^ ^ _ ^ _ _ _ _ ^ _ ^ ^ ^ _ ^ ^ _ ^ jasya svargapriyasya na ^ _ ^ ^ _ ^ _ .t. 13 kiṃ brāhmaṇābhrama ^ _ ^ ^ _ ^	                     
SA_XX_kukalpmu-175	3 _ _ _ _ ^ _ ^ ^ ^ _ ^ ^ _ ^ _ _ _ _ ^ satyavacanādir udāhṛto 'nyas. _ _ ^ _ ^ ^ ^ _ ^ ^ _ ^ bodham 14 bhayā	                          
SA_XX_kukalpmu-176	KalpM : IDP SHT 21/23	kalpm idp sht 
SA_XX_kukalpmu-177	45r1 .i .. s. i .. ///	R s 
SA_XX_kukalpmu-178	2 nanu svā .. ///	nanu svā 
SA_XX_kukalpmu-179	3 manā .. .. .. ///	ro 
SA_XX_kukalpmu-180	v1 buddhaś. vy. ///	v buddhaḥ vi 
SA_XX_kukalpmu-181	2 śirasā pra ///	śirasā pra 
SA_XX_kukalpmu-182	3 vākyāmṛt. ///	vākyāmṛt 
SA_XX_kukalpmu-183	KalpM : IDP SHT 21/24	kalpm idp sht 
SA_XX_kukalpmu-184	46r1 _ _ ya iva k. ś. _ _ _ _ _ munir ayam ekapade vasāditaḥ 17 //	yaḥ iva       muniḥ ayam eka pade 
SA_XX_kukalpmu-185	// māṃsapeś. .. ///	māṃsapeś 
SA_XX_kukalpmu-186	2 suvastuni kila bhikṣuṇā jīrṇagṛhe kuḍyāntargato nidhir upalakṣitas tena sa ///	su vastuni kila bhikṣuṇā jīrṇa gṛhe kuḍya antargataḥ nidhiḥ upalakṣitaḥ tena sa 
SA_XX_kukalpmu-187	3 + + + .. .. .o .. .. iti / sa uvāca / ya .e .i ..+ .. + + .. .. + .i .. + + ///	iti taḥ uvāca 
SA_XX_kukalpmu-188	v1 + + + + + + .. ha / // cirāt pr. .ṛt. _ _ _ _ _ _ _ ^ _ ^ _ _ _ _ _ ^ _ _ _ _ _ _ _ ^ _ ^ _ 1 _ _ _ _ ^ _ _ _ _ _ _ _ ^	v       ha cirāt 
SA_XX_kukalpmu-189	2 _ ^ te anarthenārthasaṃjñena tena me kiṃ prayojanam 2 dhāryate pūtikāyo 'yaṃ _ _ _ _ ^ _ ^ _ _ _ _ _ ^ _ _ _ _ _ _ _ ^ _ ^	te anarthena artha saṃjñena tena me kim prayojanam dhāryate pūti kāyaḥ 
SA_XX_kukalpmu-190	3 _ 3 ditsus .. n. ^ .ā _ _ _ _ nukrośa eva vā alpecchatāyāṃ yatnena mān nigṛhya kim _ ^ _ 4 _ _ _ _ ^ _ _ _ _ _	                         
SA_XX_kukalpmu-191	KalpM : IDP SHT 21/25	kalpm idp sht 
SA_XX_kukalpmu-192	47r1 _ _ ^ _ ^ _ _ _ _ _ ^ _ _ _ labhate vyākulendriyaḥ 5 mahecchaḥ saṃkalpavra ^ ^ ^ ^ _ _ ^ ^ ^ _ ^ _ _ _ _ _ ^ ^ ^ ^ ^ _ _ ^ ^ ^ _	            
SA_XX_kukalpmu-193	2 ^ _ _ _ _ _ ^ ^ ^ ^ paśāntiṃ na labhate janas tv alpeccho yaḥ satatam iha tasyo ^ ^ ^ _ 6 ///	    na labhate   tu       
SA_XX_kukalpmu-194	3 /// + sādhu sādhu satpuruṣa tvaṃ hi liṅgagrahaṇam ṛte 'pi bhikṣur ya ///	sādhu sādhu sat puruṣa tvam hi liṅga grahaṇam ṛte bhikṣuḥ 
SA_XX_kukalpmu-195	v1 /// .. pratyādiṣṭo 'smi bhavatā yas tvaṃ lobhapadasthānam api gṛham an. ///	pratyādiṣṭaḥ smi bhavatā yaḥ tvam lobha pada sthānam api gṛham 
SA_XX_kukalpmu-196	2 /// .. tāvirahitasya liṅgamātrakena śramaṇabhāvaṃ pratijānīyā + ///	  liṅga mātrakeṇa śramaṇa bhāvam pratijānīyāḥ 
SA_XX_kukalpmu-197	3 /// + + + ca me bhaktena bhaktakāryam asti ca me piṇḍapāto + + ///	    ca mama bhaktena bhakta kāryam asti ca mama piṇḍapātaḥ 
SA_XX_kukalpmu-198	KalpM : IDP SHT 21/26; original under IDP SHT X 4181 frg. BH	kalpm idp sht original under idp sht x 
SA_XX_kukalpmu-199	48r1 /// .. pya taṃ rātriṃdivaṃ kisareṇā .i ///	tam rātriṃdivam 
SA_XX_kukalpmu-200	2 /// _ _ _ _ _ _ _ _ _ _ ^ nāvaśeṣam ṛṣeḥ āy. _ _ _ _ _ _ _ _ ^ _ _ _ ///	na avaśeṣam ṛṣeḥ 
SA_XX_kukalpmu-201	3 /// .. yate 'lpecchatā yogā + + ///	R yate lpa icchā tā 
SA_XX_kukalpmu-202	v1 /// pāṇir gṛhṇīṣv eti prasārito _ ^ _ ^ _ _ _ _ _ _ _ _ _ _ _ _ _ ^ _ _ _ 10	pāṇiḥ gṛhṇīṣu eti 
SA_XX_kukalpmu-203	2 _ _ _ _ _ _ _ _ _ _ ^ _ ^ _ _ _ _ nenaitad vacanaṃ jitaṃ bhavati _ ^ _ _ _ 11	         bhavati 
SA_XX_kukalpmu-204	3 /// _ _ _ ^ ^ _ ^ saṃstavatayā śīlādibhir vv. ^ _ _ _ _ ^ ^ _ ^ _ ^ ^ ^ _ _ _ ^ _ _ ^ _ _ _ _ ^ ^ _ ^	      
SA_XX_kukalpmu-205	KalpM : IDP SHT 21/27	kalpm idp sht 
SA_XX_kukalpmu-206	49r1 t khalu sukhaṃ tat sa ^ _ _ ^ _ _ _ _ ^ ^ _ ^ _ ^ ^ ^ _ _ _ ^ _ yāsyati 13 ni _ _ _ ^ _ _ ^ ^ ^ ^ ^ ^ _ _ ^ _ _ ^ _ _ _ _ _ _ ^ _ _ ^ ^	khalu sukham tat sa 
SA_XX_kukalpmu-207	2 ṇadhananidhicchāda _ _ ^ _ _ _ _ _ _ ^ _ _ ^ ^ .. jaṇamater gātraviśrāma _ _ _ _ _ _ ^ _ _ ^ ^ ^ ^ ^ ^ _ _ ^ _ _ ^ _ _ 14	           
SA_XX_kukalpmu-208	3 + + + + + + + + + + + + + + + + + + + + + + + + .. .i // // + + ///	R 
SA_XX_kukalpmu-209	v1 /// + + + + + + /// .. s. t. c. + + + ///	di-2 ro-0 cc-2 
SA_XX_kukalpmu-210	2 yadi santuṣṭiparamaṃ dhanaṃ ///	yadi santuṣṭi paramam dhanam 
SA_XX_kukalpmu-211	haṃ daridro 'bhimatas tava / .. ///	ham daridraḥ bhimataḥ tava  /
SA_XX_kukalpmu-212	3 daridraṃ paṇḍitā .. ///	daridram paṇḍitā 
SA_XX_kukalpmu-213	r api lokadaridr. + + + .. ///	R api      
SA_XX_kukalpmu-214	KalpM : IDP SHT 21/28; cf. Divy 384	kalpm idp sht cf divi 
SA_XX_kukalpmu-215	71r1 /// nyāyyam itaḥ ś. + ///	nyāyyam itaḥ ś 
SA_XX_kukalpmu-216	2 /// rāsāre .. ///	rāsāre 
SA_XX_kukalpmu-217	3 /// mbhe 'vabha ///	    
SA_XX_kukalpmu-218	4 /// + ty.ḥ kāya ..ṃ ///	ro kāya ṃ 
SA_XX_kukalpmu-219	v1 /// + + .. prati śr. .ṭh. ///	ro 
SA_XX_kukalpmu-220	2 /// paśyati 1 + ///	paśyati 
SA_XX_kukalpmu-221	3 /// d iman ni .i ///	R d iman ni 
SA_XX_kukalpmu-222	4 /// // sakleśā + + ///	ro 
SA_XX_kukalpmu-223	KalpM : IDP SHT 21/29	kalpm idp sht 
SA_XX_kukalpmu-224	80r1 /// m iva tārāṃ śriyā d. ///	iva tārām śriyā 
SA_XX_kukalpmu-225	2 /// gamya vigatāmarṣo 'py a ///	     
SA_XX_kukalpmu-226	3 /// kāmadhātvīśvaro 'pi māro ///	      
SA_XX_kukalpmu-227	4 /// pipīlikā mandare ///	pipīlikā mandare 
SA_XX_kukalpmu-228	v1 /// . tasy. gaṇikādārikā ///	tasi gaṇikā dārikā 
SA_XX_kukalpmu-229	2 /// // ehīti te na kathita ///	ehi iti te na kathita 
SA_XX_kukalpmu-230	3 /// 11 tatas tā gaṇikā ///	tatas tā gaṇikā 
SA_XX_kukalpmu-231	4 /// bisapratānasadṛś. ///	      
SA_XX_kukalpmu-232	KalpM : IDP SHT 21/30	kalpm idp sht 
SA_XX_kukalpmu-233	86r1 _ svam aparīkṣakaḥ 2 as .i _ _ ^ _ _ _ _ _ _ _ ^ _ ^ _ _ _ _ _ ^ _ _ _ _ _ _ _ ^ sīdati 3 tataḥ sa citrakaro 'śvārūḍho harṣeṇa kaṭakābhyāṃ	svam aparīkṣakaḥ sīdati tatas sa śva ārūḍhaḥ harṣeṇa kaṭakābhyām 
SA_XX_kukalpmu-234	2 laṃkṛtatanur gṛhaṃ gata + + // /	laṃkṛta tanuḥ gṛham gata 
SA_XX_kukalpmu-235	.. tā tatas tena bhartrā procyate dehi dvāram aham karṇa iti sā	tā tatas tena bhartrā procyate dehi dvāram aham karṇa iti sā 
SA_XX_kukalpmu-236	3 bravīt kutas tavāśvo 'yaṃ + + // /	bravīt kutas tava aśvaḥ yam 
SA_XX_kukalpmu-237	_ _ _ _ ^ _ _ _ _ _ _ _ ^ kīryate tasyāyam aṃkuro jātaḥ phalam anyad bhaviṣyati 4	             bhaviṣyati 
SA_XX_kukalpmu-238	4 .. .. kṣetre śa .au .. + + // /	R kṣetre śa au 
SA_XX_kukalpmu-239	+ + + + + .. + + _ _ _ ^ .. taṃ mahāphalam iti	         
SA_XX_kukalpmu-240	v1 _ ^ _ _ muniḥ .th. _ _ ^ ^ _ ^ _ ^ ^ ^ _ _ _ ^ _ _ ^ _ _ _ _ ^ ^ _ ^ _ ^ ^ ^ _ _ .. ^ .ṣ. _ .. _ .. _ _ ^ ^ _ ^ _ phalam api pretyānyad u	                                                                                                                        
SA_XX_kukalpmu-241	2 tpatsyata iti / // // // /	tpatsyate iti 
SA_XX_kukalpmu-242	+ prasādāya vyāyamitavyaṃ tadyathānuśrūyate tamasāvane kila	prasādāya vyāyamitavyam tat yathā anuśrūyate tamasā vane kila 
SA_XX_kukalpmu-243	3 paṃcavarṣike vartamāne // /	paṃca varṣike vartamāne 
SA_XX_kukalpmu-244	mahājanaṃ ca pradānābhimukham avekṣya jātaprasādā kim ahaṃ saṃ	mahājanam ca pradāna abhimukham avekṣya jāta prasādā kim aham sam 
SA_XX_kukalpmu-245	4 ghāya dāsyāmīty utpannai // /	ghāya dāsyāmi iti utpannaiḥ 
SA_XX_kukalpmu-246	taprasādā saṃgham abhigatā tatra ca saṃghasthaviraḥ +	tad prasādā saṃgham abhigatā tatra ca saṃgha sthaviraḥ 
SA_XX_kukalpmu-247	KalpM : IDP SHT 21/31; cf. Divy 432	kalpm idp sht cf divi 
SA_XX_kukalpmu-248	103r1 mama paścimam yathā saṃghagatā me 'dya vistīrṇā dakṣiṇā bhavet ///	mama paścimam yathā saṃgha gatā me dya vistīrṇā dakṣiṇā bhavet 
SA_XX_kukalpmu-249	2 ca bhikṣuṣu aśoko rājā .i ///	ca bhikṣuṣu aśokaḥ rājā i 
SA_XX_kukalpmu-250	3 sārya tad ardhāmalaka ///	sārya tat ardhāmalaka 
SA_XX_kukalpmu-251	4 bhāgyacchidram avekṣya ///	bhāgya chidram avekṣya 
SA_XX_kukalpmu-252	v1 dattam idam āmalakasyārdhaṃ ///	u dattam idam āmalakasya ardham 
SA_XX_kukalpmu-253	2 evam uktaṃ hy etad bhagavatā ///	evam uktam hi etat bhagavatā 
SA_XX_kukalpmu-254	3 jaṃbudvīpeśvaro bhūtvā ///	jaṃbudvīpa īśvaraḥ bhūtvā 
SA_XX_kukalpmu-255	4 tāni pratyādiśann iva manāṃsi pṛthagjanānām 13 atha te bhikṣavaḥ ///	tāni pratyādiśan iva manāṃsi pṛthagjanānām atha te bhikṣavaḥ 
SA_XX_kukalpmu-256	KalpM : IDP SHT 21/32	kalpm idp sht 
SA_XX_kukalpmu-257	104r1 /// sya paścimaṃ dānam iti /	paścimam dānam iti 
SA_XX_kukalpmu-258	kim idam upanītam evam. + //	kim idam upanītam evam 
SA_XX_kukalpmu-259	+ asārakebhyo bhogebhyaḥ sāram āde + + + + + + + / ///	asārakebhyaḥ bhogebhyaḥ sāram 
SA_XX_kukalpmu-260	2 /// .. dātā bhavatīti // //	rocate iti 
SA_XX_kukalpmu-261	utsiktajanāvadhīrito .. //	utsikta jana avadhīritaḥ 
SA_XX_kukalpmu-262	c. s. ślakṣṇaḥ pratyādeśa ity ucyate /	ślakṣṇaḥ pratyādeśaḥ iti ucyate 
SA_XX_kukalpmu-263	tadyathānuśrūyate / ///	tat yathā anuśrūyate 
SA_XX_kukalpmu-264	3 /// utsave nimaṃtritas tena mālā labdhā .. + ///	utsave nimaṃtritaḥ tena mālā labdhā  /
SA_XX_kukalpmu-265	.ā baddhavāṃs ta .. /	ā baddhavān te 
SA_XX_kukalpmu-266	+ + satā kathitaṃ .. + .. vān imāṃ mālāṃ .. / /// /	satā kathitam imām 
SA_XX_kukalpmu-267	4 /// + + + + + upāsakaḥ prāha + + + + ///	    upāsakaḥ prāha 
SA_XX_kukalpmu-268	.. māṃ mālāṃ .. + + + + + + + + + + / /// /	mām mālām 
SA_XX_kukalpmu-269	v1 ^ _ ^ _ _ _ _ _ ^ _ _ _ _ _ ṇa sukham . ^ _ 1 _ .y. śc. _ ^ _ _ _ _ _ _ _ ^ .īpsitam _ _ _ _ ^ _ _ _ _ _ _ _ ^ _ ^ _ 2 _ _ _ _	di di di na sukham                    
SA_XX_kukalpmu-270	2 ^ _ _ _ _ .y. .e .e ^ mām aham sudurlabho hi kr. _ _ s triṣu lokeṣu _ ^ _ 3 _ _ _ _ ^ k. so 'yam alpena bahu labhyate _ _ _ _ ^ _ _ _ _ _	     mām aham su durlabhaḥ hi triṣu lokeṣu           k saḥ yam alpena bahu labhyate           
SA_XX_kukalpmu-271	3 ^ _ ^ _ 4 mālāṃ viśuṣkīm iva rājalakṣmīm utsṛṣṭa _ _ ^ ^ _ ^ _ _ _ _ ^ _ _ grahitāṃ ca mālāṃ yo baddhavāṃś cetasi vi ^ _ _ 5 _ _ ^ _ _ ^ ^	    iva                            
SA_XX_kukalpmu-272	4 _ ^ _ _ stūpāya dāsyāmy abhigamya bhaktyā .e _ ^ .ā _ ^ ^ _ ^ _ _ _ _ ^ _ _ ^ ^ _ . daridraḥ 6 eṣa sa krayakaśre _ _ _ _ _ ^ _ ^ _ _ _ _ _	  dāsyāmi abhigamya                              
SA_XX_kukalpmu-273	KalpM : IDP SHT 21/33	kalpm idp sht 
SA_XX_kukalpmu-274	māyākāravikrīḍitavat skandhānāṃ kriyām upadhārya .. + + + + + + + + + + ///	māyākāra vikrīḍita vat skandhānām kriyām upadhārya 
SA_XX_kukalpmu-275	2 /// + + + + + + + + saṃghabhaktam akarot sa bh. .. + .u bhikṣuṣu śevālalatām ādāya + + + + + + + + + ///	saṃgha bhaktam akarot saḥ bh    bhikṣuṣu śevāla latām ādāya 
SA_XX_kukalpmu-276	3 /// saha prāka .. + + + cacāra /	saha        
SA_XX_kukalpmu-277	tatas te bhikṣavo vigarhanti sma ko 'yam ahrī .. + .i tatas tena māyākāreṇa ///	tatas te bhikṣavaḥ vigarhanti sma kaḥ yam tatas tena māyākāreṇa 
SA_XX_kukalpmu-278	4 /// nām / tatas te bhikṣavaḥ prāhuḥ śreyo 'smābhir viṣam upa + + + + + + + .. .. .īdṛśas. + + + + ///	nām tatas te bhikṣavaḥ prāhuḥ śreyaḥ smābhiḥ viṣam upa          īdṛśaḥ 
SA_XX_kukalpmu-279	v1 /// .ovāca / naiva + + + + yogena mattaḥ parituṣyanti na pratigh. .. //	v ovāca na eva yogena mattaḥ parituṣyanti na 
SA_XX_kukalpmu-280	kim idānīṃ karavāṇīti / ///	kim idānīm karavāṇi iti 
SA_XX_kukalpmu-281	2 /// + yāṃ pratisaṃ + + + + nataśirāḥ saṃghāya praṇipatya tāṃ śaivālalatām ādāyedam u //	yām pratisam nata śirāḥ saṃghāya praṇipatya tām śaivāla latām ādāya idam 
SA_XX_kukalpmu-282	+ + + + + d. .. / ///	ro-0 or-1
SA_XX_kukalpmu-283	3 /// + + + + + + + + + + rśitā paśyantu bhadantā .. .. t tad āyuṣmadbhir abhīkṣṇaṃ śru // + + + + + + + / ///	diś diś paśyantu bhadantāḥ tat āyuṣmadbhiḥ abhīkṣṇam śru 
SA_XX_kukalpmu-284	4 /// + + + + + + + + + + nirjīveṣu skandheṣu vijā + + + .. + + + + .. .. ty apy anta // + + + + + + + / ///	          
SA_XX_kukalpmu-285	KalpM : IDP SHT 21/34	kalpm idp sht 
SA_XX_kukalpmu-286	106r2 _ _ _ _ _ _ _ _ _ _ ^ _ ^ _ jñābhiḥ tāvad yāvan nedaṃ vastu praparīkṣyate vidhivat 2 _ _ _ _ _ _ _ _ _ _ ^ _ ^ _ _ _	                
SA_XX_kukalpmu-287	3 _ _ _ _ _ _ citram idam i _ ^ _ _ _ 3 nehāsti strī na pumān nirjīvāḥ sarva eva saṃskārāḥ _ _ _ _ _ _ _ _ _ _ ^ _ _ _ 4	                        
SA_XX_kukalpmu-288	4 _ _ _ sarvajño māye _ _ ^ _ ^ _ _ _ citrataram indrajālād idaṃ hi ^ ^ .a ^ _ _ _ 5 _ _ _ ^ ^ _ ^ _ ^ ^ ^ _ _ _ ^ _ _ ^ _	             
SA_XX_kukalpmu-289	v1 _ _ _ ^ ^ mapravṛttikara _ _ _ ^ _ _ ^ _ kurvat prekṣya kaḍebaraṃ bahurasaśliṣṭopacārākr. _ _ _ _ ^ ^ _ ^ _ ^ ^ ^ _ _ _ ^ _ _ ^ _ 6 ^ ^	di kurvat prekṣya kalevaram 
SA_XX_kukalpmu-290	2 ^ ^ ^ kaḍebaran nāma _ _ ^ _ _ ^ _ sthyādikānāṃ samūho gaṇaś caiṣa niścetanaḥ pava ///	           ca        
SA_XX_kukalpmu-291	3 + + + + + + + + + + + + + + + .i .ohā .. .. .ir.ā .. + + + .. + + + + .. + ceṣṭā .i ///	ro-0 di-1 ob-1 
SA_XX_kukalpmu-292	KalpM : IDP SHT 21/35; for additions see p. 191	kalpm idp sht for additions see p 
SA_XX_kukalpmu-293	107r2 /// tadyathānuśrūyate rājñ. + + + + + + pratilabdhāyāṃ śraddhāyām ahany ahani + + + gṛhe pari ///	tat yathā anuśrūyate rājñ       pratilabdhāyām śraddhāyām ahani ahani    gṛhe pari 
SA_XX_kukalpmu-294	3 /// + + + + + ś. ke viṣayārāmatām eva strīṇām avetya dānakathāṃ svargakathāṃ ca kurvanti sma /	ke viṣaya ārāma tām eva strīṇām avetya dāna kathām svarga kathām ca kurvanti sma 
SA_XX_kukalpmu-295	atha ka ///	atha ka 
SA_XX_kukalpmu-296	4 /// + + + + + + + + + + .i + + + + + dhārmakathikam uvāca + + + + + + + .. .e .. .. .. .. ///	ro-0 di-1 di-1 dhārmakathikam 
SA_XX_kukalpmu-297	v2 /// + + + + + + + + + + + + + .. + .. .. śāsan. + + + + + + + + .. m. .r. t. .. th. .. ///	di-3 di-3 ro-0 ns-3 
SA_XX_kukalpmu-298	3 /// .. gṛhītaṃ jīvitāt sāraṃ kṛtaṃ buddhasya śāsanam 1 yadīdānīn narapatir jīvite prahariṣyati ///	 gṛhītam jīvitāt sāram kṛtam buddhasya śāsanam yadi idānīm narapatiḥ jīvite prahariṣyati 
SA_XX_kukalpmu-299	4 /// kaṇṭhe baddhvā rājñaḥ pādayor nipatyovāca kṛtā + + + haṃ devas. + + + + adya tvadīy. ///	kaṇṭhe baddhvā rājñaḥ pādayoḥ nipatya uvāca kṛtā     ham devaḥ     adya tvadīy 
SA_XX_kukalpmu-300	KalpM : IDP SHT 21/36	kalpm idp sht 
SA_XX_kukalpmu-301	108r1 tājña vidhūya _ _ m yātāsmi _ ^ ^ ^ _ ^ ^ _ ^ _ _ _ _ ^ _ ^ ^ ^ _ ^ ^ _ ^ _ .y. m 3 auduṃbaraṃ nṛvara puṣpam iva pra _ _ _ _ ^ _ ^ ^ ti janma kathaṃcid. _ _	vidhūya   m yātāsmi 
SA_XX_kukalpmu-302	2 tasya trilokamahitasya ^ _ ^ _ _ _ _ ^ _ ^ ^ ^ _ ^ ^ _ ^ _ _ 4 _ kleśavadhyapaṭahaḥ suralokasetu _ _ ^ _ ^ ^ ^ _ cchrutivaṃcitānām	tasya triloka mahitasya                      kleśa vadhya paṭahaḥ sura loka setu 
SA_XX_kukalpmu-303	3 saṃsārabandhanapalā ^ ^ _ ^ _ _ _ _ ^ vas tad iha ko na bhajeta vidvān 5 janmāntare nanu subhāṣita _ ^ _ _ _ _ ^ _ ^ ^ ninā jagato .i _ _	saṃsāra bandhana palā           vaḥ tat iha kaḥ na bhajeta vidvān janmāntare nanu subhāṣita                                  
SA_XX_kukalpmu-304	4 _ ṣṭaṃ śarīram iha śaila ^ _ ^ _ _ _ _ ^ _ ^ ^ ^ taṃ .i ^ lo ^ _ _ 6 _ _ ^ piṇḍakadalītaru _ ^ _ _ _ _ ^ _ ^ ^ ^ _ ^ ^ _ ^ _ _	śarīram iha 
SA_XX_kukalpmu-305	v1 _ _ kṣaṇārtham iha pūtikaḍeba _ _ _ _ ^ _ ^ ^ ^ _ ^ ^ _ . mukhaḥ syāt 7 kṛtvā kuṃcanasaṃprasāraṇagatapravyāhṛtaprekṣitaṃ _ _ _ ^ ^ _ ^ _ ^ ^ .. .b. _ _ ^ _	kṣaṇa artham iha                       syāt kṛtvā kuñcana samprasāraṇa gata pravyāhṛta prekṣitam 
SA_XX_kukalpmu-306	2 ceṣṭitam kāyo 'yaṃ ^ ^ _ ^ _ ^ ^ ^ _ _ _ ṭanājarjaro dhārāklinnaviśīrṇapustaracanābiṃbākṛtiḥ svapsyati 8 // /	ceṣṭitam kāyaḥ yam          ṭanā jarjaraḥ dhārā klinna viśīrṇa pusta racanā bimba ākṛtiḥ svapsyati   
SA_XX_kukalpmu-307	h. tā īdṛśena vy. + ..	h tāḥ īdṛśena vi 
SA_XX_kukalpmu-308	3 na dharmaṃ śrutvā kas tvayā guṇ. // /	na dharmam śrutvā kaḥ tvayā guṇaḥ 
SA_XX_kukalpmu-309	_ _ _ _ _ _ _ _ _ _ nareśvara guṇānām śṛṇu cāva _ ^ _ _ vipulām utpādayan	               
SA_XX_kukalpmu-310	4 prītim 9 _ r. i ^ parapra _ _ _ _ _ _ ^ _ ^ _ _ _ _ _ _ _ dvāraṃ paryaṃtakṛtaś ca saṃsāraḥ 10 // /	                                                                       
SA_XX_kukalpmu-311	+ + yasmiṃs .irli	yasmin i r li 
SA_XX_kukalpmu-312	KalpM : IDP SHT 21/37	kalpm idp sht 
SA_XX_kukalpmu-313	109r1 /// .ṛ .. .j. + bandhanakalile ///	      
SA_XX_kukalpmu-314	2 /// kāyaḥ sarpakaraṇḍa i .. ^ ^ _ _ _ ^ _ _ ^ _ _ _ _ ^ ^ _ ^ _ ^ ^ ^ _ _ _ ^ _ _ ^ _ ///	  
SA_XX_kukalpmu-315	3 /// _ _ _ ^ ^ _ ^ _ ^ ^ ^ _ _ _ ^ ghātopamās tṛṣṇā cogra ^ _ ^ _ ^ ^ ^ _ _ _ ^ _ _ ^ _ ///	          
SA_XX_kukalpmu-316	4 /// + + + .i .i śās. .. + ///	ro i śās 
SA_XX_kukalpmu-317	v1 /// + + + + + + .. nirvṛtim. ///	nirvṛtim 
SA_XX_kukalpmu-318	2 /// + tvayā sastrībālavṛddhasya l. ///	tvad sa strī bāla vṛddhasya l 
SA_XX_kukalpmu-319	3 _ _ _ ^ ^ _ ^ _ ^ ^ ^ _ _ _ ^ _ _ ^ ti vākyaṃ te munipuṃgava ^ ^ ^ _ _ _ ^ _ _ ^ _ _ _ _ ^ ^ _ ^ _ ^ ^ ^ _ _ _ ^ _ _ ^ _	         
SA_XX_kukalpmu-320	4 /// .i + + i + svi na ca na ś. ///	 i i svi na ca na ś 
SA_XX_kukalpmu-321	KalpM : IDP SHT 21/38	kalpm idp sht 
SA_XX_kukalpmu-322	111r1 ^ _ ^ ^ ^ _ _ proktadharme tvayi ta _ _ ^ ^ ha prasanna ^ ^ _ _ _ ^ _ _ ^ _ 26 _ _ ^ bhṛtyavihatapraṇayāḥ pra _ _ _ _ ^ _	                       
SA_XX_kukalpmu-323	2 ^ ^ ^ _ ^ ^ _ ^ śākyāḥ yeṣāṃ subhāṣitarasāyanabṛṃhitāni strīṇāṃ mahī ^ ^ ^ _ ^ ^ _ ^ _ _ 27 tasmāt satatam eva gaṃbhīrak. + + + + +	                                   
SA_XX_kukalpmu-324	3 + + + + + + + ty adhigama iti .. //	di adhigamaḥ iti 
SA_XX_kukalpmu-325	saṃgrahaḥ //	saṃgrahaḥ 
SA_XX_kukalpmu-326	karṇaḥ kanyā yakṣo _ _ _ _ ^ _ ^ _ _ _ ardhāmalakaṃ mālā śaivāl. ^ _ ^ _ _ _ ity ā	karṇaḥ kanyā yakṣaḥ  /        ardha āmalakam mālā śaivāl        iti ā 
SA_XX_kukalpmu-327	4 ryakaumāralātāyāṃ .. kalpanāmaṇḍitikāyāṃ ///	kalpanāmaṇḍitikāyām 
SA_XX_kukalpmu-328	.. paṃktyāṃ tṛtīyā daśatī samāptā 3 // / /	paṃktyām tṛtīyā daśatī samāptā 
SA_XX_kukalpmu-329	pūjāsahiṣṇutvād api bh. + + + + + + + + + +	pūjā sahiṣṇu tvāt api 
SA_XX_kukalpmu-330	5 + + .. ma /// yate / tadyathānuśrūyate // /	ro tat yathā anuśrūyate 
SA_XX_kukalpmu-331	kulatilak. + + .. ṇi .e / / /	kula tilak 
SA_XX_kukalpmu-332	.. śrīvibhavaprabhāvaprat. + + + + + + + + + +	     
SA_XX_kukalpmu-333	v1 /// + tasthe /// kasmiṃścit pradeśe vāsopaga .. / / /	tasthe kasmiṃścid pradeśe vāsa upaga    
SA_XX_kukalpmu-334	+ + + + .. bhiḥ ka + + rātma / / /	rātma 
SA_XX_kukalpmu-335	dadarśa ca nātidūrastham urupra + + + + + + + + + +	dadarśa ca na ati dūra stham 
SA_XX_kukalpmu-336	2 /// .. pama .. /// + .. saṃkrāmya namas tathāgata // /	rocaya      saṃkrāmya namaḥ tathāgataiḥ 
SA_XX_kukalpmu-337	+ + + + + vimalaśubhapaṭṭālaṃ / / /	      
SA_XX_kukalpmu-338	+ praṇataś cābravīt // sarvā _ ^ ^ _ ^ _ ^ ^ ^ _	praṇataḥ ca abravīt 
SA_XX_kukalpmu-339	3 _ _ ^ _ _ ^ _ kṛtsnasyāsya carācarasya jagataḥ sādhāraṇo bāndhavaḥ _ _ _ ^ ^ _ ^ _ ^ ^ ^ to lokatrayān niḥsṛ _ _ dv. _ ^ ^ _ ^ _ ^	                     
SA_XX_kukalpmu-340	4 ^ ^ _ _ _ ^ _ tv. hite 1 atha buddha + + + ///	diś tu hite atha buddha 
SA_XX_kukalpmu-341	.. raṇāvarjitamanasi praṇate + / / /	raṇa āvarjita manasi praṇate 
SA_XX_kukalpmu-342	+ + + m iva kātarajanasainyam ekapa .e + + + + +	iva kātara jana sainyam 
SA_XX_kukalpmu-343	5 /// .. pavanabalabhi .. + + + + + // /	R 
SA_XX_kukalpmu-344	.. rāśim āga .. .o + + + + + + / / /	rāśim āga 
SA_XX_kukalpmu-345	+ + + + .. saṃbhramotphullacakṣuṣā + + + + + + +	ro             
SA_XX_kukalpmu-346	KalpM : IDP SHT 21/39	kalpm idp sht 
SA_XX_kukalpmu-347	113r1 nighātaninadair vvikrośatīva svayam 6 yac caitye bahuputrake ^ ^ ^ _ _ _ ^ _ _ ^ _ _ _ _ ^ ^ _ ^ ^ ^ _ _ _ ^ _ _ ^ _ _ _ _ ^ ^ _ ^ _	nighāta ninadaiḥ vikrośati iva svayam yat caitye bahu putrake 
SA_XX_kukalpmu-348	2 khalu śiro gacched itīdaṃ hi tat sarvajñasya subhāṣitaṃ svavagataś cai _ ^ _ _ ^ _ 7 ///	khalu śiraḥ gacchet iti idam hi tat sarvajñasya su bhāṣitam su avagataḥ 
SA_XX_kukalpmu-349	3 ttam avekṣya prasādajanitanetramukharāgā janaughās tatra saṃ ///	t tam avekṣya prasāda janita netra mukha rāgāḥ jana oghāḥ tatra sam 
SA_XX_kukalpmu-350	4 parapravādinaḥ śramaṇaiś ca brāhmaṇai .. .i yat pratij. ///	parapravādinaḥ śramaṇaiḥ ca brāhmaṇaiḥ i yat 
SA_XX_kukalpmu-351	5 + .i + + + + + + saṃjñinaś ca tathāgat. + + + + + + + ///	di-2 ro-0 ca 
SA_XX_kukalpmu-352	v1 tīrthy. + .ṛ + + + + + nārghaṃti prāg eva tatrabha + + + + + + + + _ _ _ ^ ^ _ ^ _ ^ ^ ^ _ _ _ ^ _ _ ^ _ _ _ _ ^ ^ _ ^ _ ^	tīrthī prāk eva 
SA_XX_kukalpmu-353	2 puruṣo nigraṃthako durmatiḥ stūpo mānuṣamātrakena khalu _ _ _ ^ _ _ ^ _ _ _ _ ^ ^ _ ^ _ ^ ^ ^ _ _ _ ^ _ _ ^ _ 8 _ _ _ _ ^ _ _ _	puruṣaḥ nigraṃthakaḥ durmatiḥ stūpaḥ mānuṣa mātrakena khalu 
SA_XX_kukalpmu-354	3 n nidāgha iti kathyate tathaiva niyatagranthaḥ sa nigranthaka _ ^ _ 9 _ _ _ _ ^ _ _ _ _ _ _ _ ^ _ ^ _ _ _ _ _ ^ _ _ _ _ _ _ _ ^	nidāghaḥ iti kathyate tathā eva niyata granthaḥ sa 
SA_XX_kukalpmu-355	4 bhaktibhiḥ 10 buddhasya hi prathitadhīdhṛtivaṃśakīrte stūpāḥ ^ _ ^ ^ ^ _ ^ ^ _ ^ _ _ _ _ ^ _ ^ ^ ^ _ ^ ^ _ ^ _ _ _ _ ^ _ ^ ^ ^ _ ^ ^	           
SA_XX_kukalpmu-356	5 vindhyapādā iti 11 tasmāt .ā .. .. .āṃ .. .. + + + + + ///	vindhya pādāḥ iti tasmāt ā         
SA_XX_kukalpmu-357	KalpM : IDP SHT 21/40	kalpm idp sht 
SA_XX_kukalpmu-358	114r1 /// bahuśruto bhikṣuḥ prativasati sma /	bahu śrutaḥ bhikṣuḥ prativasati sma 
SA_XX_kukalpmu-359	sa vidhavāyāṃ striyām ut. ///	sa vidhavāyām striyām u t 
SA_XX_kukalpmu-360	2 /// to bāḍham avapravrajatu ahaṃ bhavato bhāryā bhaviṣyāmīti ///	bāḍham avapravrajatu aham bhavataḥ bhāryā bhaviṣyāmi iti 
SA_XX_kukalpmu-361	3 /// .yutpannabuddhitvāt kin nu khalu kariṣyāmīti cintām āpede /	    nu khalu kariṣyāmi iti cintām āpede 
SA_XX_kukalpmu-362	tad. ///	tat 
SA_XX_kukalpmu-363	4 /// m etat karma kuryām iti /	 m etat karma kuryām iti 
SA_XX_kukalpmu-364	sa + + + + .. ra yathāpita ///	sa 
SA_XX_kukalpmu-365	5 /// sya pūrva + + + to bhikṣur yadṛcchayā taṃ deśam anuprā ///	sya bhikṣuḥ yadṛcchayā tam deśam 
SA_XX_kukalpmu-366	v1 /// vṛtaṃ yamarājopamam iva rudhirabindubhiḥ siktadeham / ///	vṛtam yamarāja upamam iva rudhira bindubhiḥ sikta deham 
SA_XX_kukalpmu-367	2 /// tā proktan nāham ekadharmam api samanupaśyāmy evaṃ laghu ///	proktat na aham eka dharmam api samanupaśyāmi evam laghu 
SA_XX_kukalpmu-368	3 /// śaṃkām apy asyākariṣyad imam. + + bhavān yāsyatīti ///	śaṃkām api asya akariṣyat imam bhavān yāsyati iti 
SA_XX_kukalpmu-369	4 /// ṇālupratigataṃ sa .ā + + bahu vikurute cittat. ///	saḥ ā   bahu vikurute cit tat 
SA_XX_kukalpmu-370	5 /// śramaṇā vā brāhmaṇā vā + + .. m āryasatyaṃ na jānaṃti ///	śramaṇāḥ vā brāhmaṇāḥ vā    m ārya satyam na jānaṃti 
SA_XX_kukalpmu-371	KalpM : IDP SHT 21/41; original missing	kalpm idp sht original missing 
SA_XX_kukalpmu-372	115r3 ............... m. sv. katām asya smāra ............	ro su ka tām asya smāra 
SA_XX_kukalpmu-373	4 ............ sutulitaṃ kuruṣveti /	su tulitam kuruṣva iti 
SA_XX_kukalpmu-374	........... bh. v. .. k. .u ....... śramaṇo na ca māṃsaṃ krī ........... ṣyati / //	śramaṇaḥ na ca māṃsam krī  syati 
SA_XX_kukalpmu-375	nikṣiptavya ^ _ ^ _	nikṣiptavya 
SA_XX_kukalpmu-376	5 ^ ^ ^ _ _ _ ti kiṃcit .a .i _ .ā ..ṃ ^ ^ _ ^ _ ^ ^ ^ _ _ _ ^ _ dātarāt ārya _ ^ ^ _ ^ _ ^ ^ ^ _ _ _ ^ _ _ ^ _ kāmānāṃ gurulāghavaṃ ^ ^ ^ _	                                                                                                   
SA_XX_kukalpmu-377	v1 _ _ ^ _ _ ṣamām 3 ............. ryām anusmṛtya duḥkha ............. sūtrāṇy anusmṛtya tāṃ tulām e .........	duḥkha sūtrāṇi anusmṛtya tām tulām 
SA_XX_kukalpmu-378	2 ........... bhikṣum uvāca bhadanta bhadanta _ _ _ _ _ _ _ _ cādīnavo .i .e .e _ ḥ hrīkakṣyāṃ buddhitulā _ _ _ _ ^ _ _ _ 4 ādīnavabhūya .........	bhikṣum uvāca bhadantaiḥ bhadantaiḥ        ca ādīnavaḥ hrī kakṣyām buddhi tulā 
SA_XX_kukalpmu-379	3 .............. taṃ me yad ahaṃ te .ai .......... .ī .......	tam me yat aham te 
SA_XX_kukalpmu-380	KalpM : IDP SHT 21/42; original missing	kalpm idp sht original missing 
SA_XX_kukalpmu-381	120r1 /// .y. m. ............ d rājñaḥ saciv. ///	rājñaḥ saciv 
SA_XX_kukalpmu-382	2 /// jñānaḥ krameṇa ....... mānamūrtiḥ k. ///	      
SA_XX_kukalpmu-383	3 /// māyamānauttari ...... yāmāsa /	yāmāsa 
SA_XX_kukalpmu-384	kim idānīṃ ///	kim idānīm 
SA_XX_kukalpmu-385	4 /// ..... r. ... .i ....... bhāgyāny aho yāva ///	R i bhāgyāni 
SA_XX_kukalpmu-386	5 /// t. .. pracchanne kilbiṣe vyava ///	t pracchanne kilbiṣe vyava 
SA_XX_kukalpmu-387	v1 /// vasaktanistriṅśaḥ śārdūlapota ///	vasakta nistriṅśaḥ śārdūla pota 
SA_XX_kukalpmu-388	2 /// ......... t. ........ ham ādāya prasthito ///	ādāya prasthitaḥ 
SA_XX_kukalpmu-389	3 /// .t. kṣuttarṣaś ca ha .......... ghrāya bhasmamayā ///	t kṣudh tarṣaḥ ca ha ghrāya bhasma mayā 
SA_XX_kukalpmu-390	4 /// .. īti / sa ........... va sthāne nikṣip. ///	ro iti sa va sthāne nikṣip 
SA_XX_kukalpmu-391	5 /// ........ .e ......... bdham akārya .i ///	ro 
SA_XX_kukalpmu-392	KalpM : IDP SHT 21/43	kalpm idp sht 
SA_XX_kukalpmu-393	123r1 kāmaṃ _ ^ ^ _ ^ _ ^ ^ ^ _ _ _ ^ _ _ ^ _ _ _ _ ^ ^ _ ^ _ ^ ^ ^ _ _ _ ^ _ _ ^ _ _ _ _ ^ ^ _ ^ puṣpava ^ _ mokṣaṃ ca śālūkavat. + ta	mokṣam ca śālūka vat 
SA_XX_kukalpmu-394	2 smāc chīlasahāyena mokṣ. _ _ ^ _ ^ _ _ _ _ _ ^ _ _ _ _ _ _ _ ^ _ ^ _ // /	smāt śīla sahāyena 
SA_XX_kukalpmu-395	m atikramāya prayatitavyam /	m atikramāya prayatitavyam 
SA_XX_kukalpmu-396	tadyathānuśrūya	tat yathā anuśrūya 
SA_XX_kukalpmu-397	3 te kenacid apaṇḍita .. + + // /	te kenacid apaṇḍita 
SA_XX_kukalpmu-398	+ + + + .i + t /	R se 
SA_XX_kukalpmu-399	tac ca taḷākam avatīrya suciraṃ	tat ca taḷākam avatīrya su ciram 
SA_XX_kukalpmu-400	4 + + + + + + + + + + + /// + + durlabhaṃ vinipatitasya mānuṣyatvam ekā ..	           
SA_XX_kukalpmu-401	5 + + + + + + + + + + + /// + + + + .. .. .. .. .. + .. .. tyu .. .. .. + .. .. .. .. +	R
SA_XX_kukalpmu-402	v1 + + + + + + + + + + + /// + + + + nātyarthadūragāmini kāṣṭhe salile ca _	na atyartha dūra gāmini kāṣṭhe salile ca 
SA_XX_kukalpmu-403	2 ^ _ _ _ _ _ _ _ _ _ _ _ _ _ ^ _ _ _ 1 _ _ _ _ _ _ _ _ _ _ ^ _ ^ _ _ _ _ _ _ _ grīvā saṃprāpsyati tadyugacchidram 2 atyartha	                            
SA_XX_kukalpmu-404	3 durlabho 'yaṃ vinipatit. _ ^ _ ^ _ _ _ _ _ _ _ _ _ _ _ _ _ ^ _ _ _ 3 _ _ _ _ _ _ _ _ _ _ virāgitā buddhāḥ yuktam idānī	durlabhaḥ yam 
SA_XX_kukalpmu-405	4 m ājñāṃ pratigrahītuṃ daśabalasya 4 _ _ _ _ _ _ _ _ _ _ ^ _ ^ _ _ _ _ _ _ _ _ _ _ ^ va vidvān na tat kuryāt 5 aṣṭākṣaṇapatitā _ _	ājñām pratigrahītum daśabalasya vidvān na tat kuryāt aṣṭa akṣaṇa patitā 
SA_XX_kukalpmu-406	5 su .i _ ^ ṇasamāgamā _ _ _ _ _ _ _ _ _ _ _ _ ^ _ _ _ 6 _ _ _ _ _ _ prasaraṃ bha ^ _ ^ _ t samāsādya _ _ _ _	su i ṇa sama āgamā 
SA_XX_kukalpmu-407	KalpM : IDP SHT 21/44	kalpm idp sht 
SA_XX_kukalpmu-408	125r1 /// + + dustyajaṃ tyajasi ca dravyaṃ .r. .. + + + + + + + + + + + + + + + + + + .. y. nm. .. + + + + + + ///	     ca   
SA_XX_kukalpmu-409	2 /// lasya doṣo 'pi guṇāvaho bhavatīti .. + + + bahulena bhavitavyam /	 guṇa āvahaḥ bhavati iti     bahulena bhavitavyam 
SA_XX_kukalpmu-410	tadyathānuśrūyate kaścit + + + + ///	tat yathā anuśrūyate kaścid 
SA_XX_kukalpmu-411	3 /// + m abhyāgatas tena ca bhikṣuṇā dvāraṃ baddhaṃ /	abhyāgataḥ tena ca bhikṣuṇā dvāram baddham 
SA_XX_kukalpmu-412	tatas tena coreṇa prayaccha me dvāram ity abhihitaḥ sa bhikṣur uvāca ///	tatas tena coreṇa prayaccha me dvāram iti abhihitaḥ sa bhikṣuḥ uvāca 
SA_XX_kukalpmu-413	4 /// taṃ praveśaya yad ihāsti tat te dāsyāmīti /	tam praveśaya yat iha asti tat te dāsyāmi iti 
SA_XX_kukalpmu-414	tena .. + + + praveśitaṃ tatas tena bhikṣuṇā tac corasya .. ///	tena     praveśitam tatas tena bhikṣuṇā tat corasya 
SA_XX_kukalpmu-415	5 /// laṃ kāṣṭham ādāya dvāram avamucya sa bhikṣus .a + + + + nān nirgamya tat kāṣṭh. + + + + pāṇibhyām atisa ///	kāṣṭham ādāya dvāram avamucya sa bhikṣuḥ nirgamya tat kāṣṭha 
SA_XX_kukalpmu-416	v1 /// .. / tataḥ sa cauraḥ prāṇaparityāgabhayabhīta .. + + + + .inā buddhaṃ śaraṇaṃ gacchāmīty uvāca tatas tena bhikṣuṇā ///	                                                                    
SA_XX_kukalpmu-417	2 /// dharmaṃ śaraṇaṃ gacchāmīti /	dharmam śaraṇam gacchāmi iti 
SA_XX_kukalpmu-418	tataḥ sa coraḥ prāha dharmaṃ śaraṇaṃ gacchāmīti + + + + bhikṣuṇā tṛtīyaṃ + + + tvābhihitaḥ kathay. ///	tatas sa coraḥ prāha dharmam śaraṇam gacchāmi iti      bhikṣuṇā tṛtīyam    tvā abhihitaḥ kathay 
SA_XX_kukalpmu-419	3 /// .. vat ko nu jānīte kati śaraṇagamanāny ayaṃ bhikṣur vvakṣyati .. kati ca mayā laguḷaprahārā .. ///	kaḥ nu jānīte kati śaraṇa gamanāni ayam bhikṣuḥ kati ca mayā laguḍa prahārā  /
SA_XX_kukalpmu-420	4 /// + śanaiḥ saṃghaṃ śaraṇaṃ gacchāmīty ukta + + + na bhikṣuṇā tasmād bandhanād vimucya gacchedānīṃ ///	śanais saṃgham śaraṇam gacchāmi iti ukta     na bhikṣuṇā tasmāt bandhanāt vimucya gaccha idānīm 
SA_XX_kukalpmu-421	5 /// + .. krameṇa svasthibhūto .. .. .. + + + + + + + + .. + + + + + .. ..ṃ .o + ///	        
SA_XX_kukalpmu-422	KalpM : IDP SHT 21/45	kalpm idp sht 
SA_XX_kukalpmu-423	126r4 /// prahāreṇa sa coro niṣprā .. ///	prahāreṇa sa coraḥ 
SA_XX_kukalpmu-424	5 _ _ _ _ _ _ _ _ _ _ ^ _ ^ _ ^ payā śaraṇāgamanaṃ ca ^ _ _ _ _ _ ^ _ _ _ 1 _ _ _ _ _ _ _ _ _ _ ^ _ ^	       ca 
SA_XX_kukalpmu-425	v1 _ _ _ _ _ _ _ _ _ _ _ _ _ samabhaviṣyam 2 etat tasya ^ _ ^ _ ^ ^ ^ _ _ _ ^ _ _ ^ _ _ _ _ ^ ^ _ ^ _ ^ ^ ^ _ _ _	di di di                    
SA_XX_kukalpmu-426	2 ^ _ _ ^ _ _ _ _ ^ ^ _ ^ _ ^ ^ ^ _ _ _ ^ bhaṃte munau sūkṣmaṃ hetum a _ ^ _ ^ ^ ^ _ _ _ ^ _ _ ^ _ 3 ///	           
SA_XX_kukalpmu-427	KalpM : IDP SHT 21/46	kalpm idp sht 
SA_XX_kukalpmu-428	127r1 /// .. śatrur bhadantena cīvar. + // + + + + + + + + / ///	ro 
SA_XX_kukalpmu-429	2 /// .. d aśanin nivārayati ghor. //	  nivārayati ghoḥ 
SA_XX_kukalpmu-430	+ + + .. suhṛt prā .. / ///	ro 
SA_XX_kukalpmu-431	3 /// .. haṃti nanu priyaṃ kurute + //	 hanti nanu priyam kurute 
SA_XX_kukalpmu-432	.. vihate sasyaṃ kṣetre / ///	vihate sasyam kṣetre 
SA_XX_kukalpmu-433	4 /// + so hi devadattasya + + //	ro hi devadattasya 
SA_XX_kukalpmu-434	+ .. laṃ na babhūvot. / ///	raṃ na 
SA_XX_kukalpmu-435	5 /// + lābhasatkāraḥ .. + //	  
SA_XX_kukalpmu-436	+ .. pi sa me .. + / ///	ro sa me    
SA_XX_kukalpmu-437	v1 /// + + + + t. yalomacchavi + + + //	di ya loman chavi   
SA_XX_kukalpmu-438	+ ś chinatti nṛṇām + + / ///	ś chinatti nṛṇām 
SA_XX_kukalpmu-439	2 /// + + + + k. padasthānaṃ saṃgaṇi + //	     
SA_XX_kukalpmu-440	+ darpapramādatṛṣṇā .. / ///	darpa pramāda tṛṣṇā 
SA_XX_kukalpmu-441	3 /// + + satkārasaṃjñitaṃ śatrum ā .. + + + //	ro satkāra saṃjñitam śatrum ad 
SA_XX_kukalpmu-442	r na syād ayam iha .i + / ///	R na syāt ayam iha i 
SA_XX_kukalpmu-443	4 /// + + + niramate śamatyaktaś cāy. + + //	       
SA_XX_kukalpmu-444	.. + + yatir iti .. / ///	ro iti 
SA_XX_kukalpmu-445	5 /// tadyathānuśrūyate sthaviramaudgalyāyan. // + + + + + + + + / ///	tat yathā anuśrūyate sthavira maudgalyāyan 
SA_XX_kukalpmu-446	KalpM : IDP SHT 21/47	kalpm idp sht 
SA_XX_kukalpmu-447	128r1 + + /// + sthaviramaudgalyāyane + + // /	ro-0 sthavira maudgalyāyane 
SA_XX_kukalpmu-448	+ .. d anayos ta .. + + + / / /	r anayoḥ ta 
SA_XX_kukalpmu-449	+ + + + + + + tata sthaviraśāradvatīputreṇānuyu	     tata 
SA_XX_kukalpmu-450	2 ktaḥ + /// + m ekasyānāpānasmṛtir aparasyāsthisaṃjñā mayopadiṣṭā + + / / /	ktaḥ                               
SA_XX_kukalpmu-451	+ + + + .. .. tataḥ sthaviraśāradvatīputreṇoktaḥ ko 'tra	tatas sthavira śāradvatī putreṇa uktaḥ kaḥ tra 
SA_XX_kukalpmu-452	3 kasmāt /// tataḥ sthaviramaudgalyāyanenoktaṃ yasyānāpānasmṛtir upadiṣṭā / / /	kasmāt tatas sthavira maudgalyāyanena uktam yasya ana apāna smṛtiḥ upadiṣṭā 
SA_XX_kukalpmu-453	+ + pravrajito yasya punar asthisaṃjñopadiṣṭā sa suvarṇa	pravrajitaḥ yasya punar asthi saṃjñā upadiṣṭā sa suvarṇa 
SA_XX_kukalpmu-454	4 kāraḥ /// śāradvatīputreṇābhihitaḥ / / /	kāraḥ śāradvatīputreṇa abhihitaḥ 
SA_XX_kukalpmu-455	+ + ya eṣa ānāpānasmṛtiṃ bhāvayati so 'sthisaṃjñāṃ bhāvayatu yaś cāsthisaṃjñāṃ bhāvayati	yaḥ eṣaḥ āna apāna smṛtim bhāvayati saḥ sthi saṃjñām bhāvayatu yaḥ ca asthi saṃjñām bhāvayati 
SA_XX_kukalpmu-456	5 + + /// + + + + + + + + + + .. + /// + + .. + + /// + + + .. .e + .e + + + + + + + + + + + +	R 
SA_XX_kukalpmu-457	v1 + + + + /// + + + + + + + + + + + /// + .. + + + ///.. .. .. + .dh. + + y. + + + + + + + + .. + .. .. .. ///	ro-0 di-1 di-1 di-1 di-1 
SA_XX_kukalpmu-458	2 + + + + /// ^ _ ^ _ _ _ _ upadeśo 'yaṃ śīghraṃ saphalasaṃ ^ _ 1 svagoare ^ _ _ _ _ _ bhāvayati kriyām agocare tu bhramati matsyaḥ sthalagato yathā 2	                                             
SA_XX_kukalpmu-459	3 śuklāni vastrāṇi ^ _ ^ _ _ _ _ taṭasthāny upalakṣitāni śai _ ^ _ _ ṇa ca me ^ _ _ _ _ ^ _ _ ^ ^ _ praviṣṭā 3 s. _ .i nāḍīpavanānusārāḍ ucchvāsa	śuklāni vastrāṇi        taṭa sthāni upalakṣitāni ca me           praviṣṭā 
SA_XX_kukalpmu-460	4 niśvāsa ^ _ ^ _ _ _ _ ^ _ _ ^ gato mahātmā sarvaḥ khalu .e ^ ^ _ balīyān 4 _ _ _ ^ ^ _ ^ _ ^ ^ ^ .. .o .o .. ..ṃ na svayaṃ dhārmyaṃ cakram	niśvāsa          gataḥ mahātmā sarvaḥ khalu e    balīyān             o o na svayam dhārmyam cakram 
SA_XX_kukalpmu-461	5 yati _ _ _ ^ _ _ ^ _ _ _ _ ^ hi yoganītividuṣo dharmasya senāpater vvākyaiḥ _ ^ ^ _ ^ _ ^ ^ ^ _ _ _ ^ _ _ ^ tāv iti 5 // /	                             
SA_XX_kukalpmu-462	KalpM : IDP SHT 21/48	kalpm idp sht 
SA_XX_kukalpmu-463	130r1 /// + + + + + kāṣāyaprāvaraṇaṃ raktacandan. .. + + + // /	      
SA_XX_kukalpmu-464	+ + .r. .. d. d. .. + .. ni /	R ro-0 di- ni 
SA_XX_kukalpmu-465	vakṣyate hi / // ^ _ ^ _ _ ^ ^ _ ^ _ ^ _ ^ _ ^	vakṣyate hi 
SA_XX_kukalpmu-466	2 ^ ^ _ ^ _ ^ _ ^ _ ^ _ _ bhravidaṣṭamaṇḍalaḥ śaśī prasannāṃśur ivodi _ ^ _ 3 // /	                  
SA_XX_kukalpmu-467	bhagavaṃtam ālokya pramuditamanā d. + + + .. .. + + + + + + + + + + +	bhagavaṃtam ālokya 
SA_XX_kukalpmu-468	3 /// ṇi prahlādayati kiṃ punar manuṣyabhūtānāṃ vakṣyate hi / / /	prahlādayati kim punar manuṣya bhūtānām vakṣyate hi 
SA_XX_kukalpmu-469	_ _ _ _ takāntan te bhājanaṃ śa ^ _ ^ _ _ _ pratiniviṣṭānāṃ prahlāda _ ^ _ ^ _ 4	ro te bhājanam                
SA_XX_kukalpmu-470	4 _ _ _ _ ^ _ _ _ _ _ paśyaṃti dehinaḥ tatra tatraiva sajjante harṣaniścalalocanāḥ 5 dīptaṃ dedīpyate bhūyo gātraṃ te varalakṣaṇaiḥ anupākruṣṭacāritra	                                                                                                     
SA_XX_kukalpmu-471	5 ^ _ ^ _ 6 /// + + + + na tam ābharaṇāny aśobhayaṃta vyapanīta ^ ^ _ ^ .. .. .āśe _ r. ^ _ r hi sa lakṣaṇābhidhānaiḥ sahajair ābharaṇai ^ _	na tam ābharaṇāni aśobhayanta vyapanīta       āśe  r hi saḥ lakṣaṇa abhidhānaiḥ sahajaiḥ 
SA_XX_kukalpmu-472	v1 ^ ^ _ ^ ^ _ ^ _ ^ .. _ ^ ^ phullai stabakair aśokavṛkṣaḥ bhuvi bhāti tathā ^ _ ^ _ s. sa mahātmā ^ ^ lakṣaṇair jvaladbhiḥ 8 yath. + + + //	           bhāti                       
SA_XX_kukalpmu-473	maṇibhir vv. + + +	maṇibhiḥ vu 
SA_XX_kukalpmu-474	2 /// ti sugata tava gātram idaṃ varalakṣaṇaiḥ kham iva ni + + + + 9 yathā cā .. / /	sugata tava gātram idam vara lakṣaṇaiḥ kham iva ni          
SA_XX_kukalpmu-475	lāvaṇṇapuṇṇapattaṃ jananayanarasāyanaṃ pa .. _ _	lāvaṇṇa puṇṇa pattam jana nayana rasāyanam 
SA_XX_kukalpmu-476	3 _ _ _ _ _ taṃ vinayasamuttejitasirīraṃ 10 ko nu katatthasa _ _ ^ .. jjhavijjhapitadosa _ _ _ ^ samāpaṇāṃkasobhā pa _ ^ _ _ ^	     nu          
SA_XX_kukalpmu-477	4 _ _ _ 11 /// + pam evāścāryasaṃmata + + tu samaṃtabhadra + + + + + vakṣyate hi / / /	tu samantabhadraiḥ       vakṣyate hi 
SA_XX_kukalpmu-478	.. + te kiṃcid vākyaṃ ya .i _ _ ^ ^ ^ ^ ^ _ _ ^ _ _ ^ _ _ _ _	te kiṃcid vākyam 
SA_XX_kukalpmu-479	5 _ _ ^ ^ ^ ^ ^ _ _ ^ _ _ ^ _ _ _ praspandas tanur api sa te _ ^ _ _ ^ _ _ _ _ _ _ ^ ^ ^ ^ ^ hānugraha _ ^ _ _ 12 _ _ _ _ ^ ^ ^ ^ ^ _	                    
SA_XX_kukalpmu-480	KalpM : IDP SHT 21/49	kalpm idp sht 
SA_XX_kukalpmu-481	131r1 _ ^ _ _ ^ _ _ _ _ _ _ ^ ^ ^ ^ ^ _ _ ^ _ _ ^ a _ _ _ cakṣuḥ paramanibhṛte _ ^ _ dhir na kiṃcit saṃ _ _ _ ^ ^ ^ ^ ^ _ _	                 
SA_XX_kukalpmu-482	2 ^ _ _ ^ _ _ 13 /// + + + . acalendriyair bhikṣubhir anuparivṛtam avekṣya prītamanā babhūva vakṣyate hi / /	acala indriyaiḥ bhikṣubhiḥ anuparivṛtam avekṣya prīta manāḥ babhūva vakṣyate hi 
SA_XX_kukalpmu-483	śāntendriy. ^ ^ ^ _ ^ ^ _ ^	ro 
SA_XX_kukalpmu-484	3 _ _ _ _ ^ _ ^ ^ ^ _ ^ ^ _ ^ _ _t bhāty eṣa śākyavṛṣabhaḥ kanakācalābhaḥ sāndhyair ghanaiḥ parivṛtaḥ śaradīva sūryaḥ 14 ///	bhāti eṣa śākya vṛṣabhaḥ kanaka acala ābhaḥ sāndhyaiḥ ghanaiḥ parivṛtaḥ śaradi iva sūryaḥ  /
SA_XX_kukalpmu-485	4 /// na me saṃsargayogyo bhagavān i + + .. .i + + thā prasthitas tasyedā .. + + + + + + + .igantum ayogyo 'smīty a .. ///	na me saṃsarga yogyaḥ bhagavān a    i   thā prasthitaḥ tasya idā a       a gantum ayogyaḥ smi iti 
SA_XX_kukalpmu-486	5 /// + + ṇyaḥ pūrvakarmabhir evaṃ .. + + + + + .. m anena nīcena ka + + + + + + + + + + sarvasatvābhigamanīya ///	pūrva karmabhiḥ evam        anena nīcena ka          sarva sattva abhigamanīya 
SA_XX_kukalpmu-487	v1 /// + + + .. dahyate me hṛdayam / + ///	v     dahyate mama hṛdayam 
SA_XX_kukalpmu-488	.y. ktaṃ lokaiḥ sāmaraki + + + + + + + + + /	y ktam lokaiḥ sa amaraki 
SA_XX_kukalpmu-489	.. prāpya yo 'ham evaṃ vim. / /// /	prāpya yaḥ ham evam vim 
SA_XX_kukalpmu-490	2 /// bhagavān buddhaḥ sarvasatvasamapraṣṭa + ///	bhagavān buddhaḥ sarva satva samapraṣṭa 
SA_XX_kukalpmu-491	+ .. + + + thas tenaivābhiprasthito + + + + + + t. y. + /	ro 
SA_XX_kukalpmu-492	.. kaṣṭam ita eva bhagavān . / /// /	kaṣṭam itas eva bhagavān 
SA_XX_kukalpmu-493	3 /// babhūva hā hato 'smi mandabhāgyaḥ pūrvaduścaritena tāvad iyam īdṛśī mamāvasthā yadi punar ni .. + // + + + + + + + + + / ///	babhūva hā hataḥ smi mandabhāgyaḥ pūrva duścaritena tāvat iyam īdṛśī mama avasthā yadi punar 
SA_XX_kukalpmu-494	4 /// + + + + .. divyaiś candanacūrṇapuṣpavik. _ .abhyarcyate daivatair bhūmi _ ^ ^ _ praveśasamaye _ _ ^ _ _ ^ _ _	                        
SA_XX_kukalpmu-495	5 _ _ ^ ^ _ ^ _ ^ ^ ^ _ _ _ ^ _ _ ^ _ _ _ _ ^ ^ _ ^ _ ṣa ^ ^ _ _ grāgrahastaḥ katham 16 tat kim idānīm /// + + + + + + + + + ///	                                
SA_XX_kukalpmu-496	KalpM : IDP SHT 21/50	kalpm idp sht 
SA_XX_kukalpmu-497	_ _ ^ _ ^ ^ ^ _ ^ ^ _ ^ _ _ _ _ ^ _ ^ ^ ^ _ ^ ^ _ ^ _ ..ḥ pauraiḥ kṛtāṃjalipuṭ. ^ ^	pauraiḥ kṛta añjali puṭ 
SA_XX_kukalpmu-498	2 _ ^ _ _ _ _ ^ _ ^ ^ ^ _ ^ ^ _ ^ _ _ 17 /// .. tsṛjyānyāṃ rathyāṃ yāsyāmīty atha y.	tsṛjya anyām rathyām yāsyāmi iti atha y
SA_XX_kukalpmu-499	3 /// yena nīthir gaccha + / / /	yena nīthiḥ gaccha 
SA_XX_kukalpmu-500	+ + + tatas tathāgatasaṃsargaṃ	tatas tathāgata saṃsargam 
SA_XX_kukalpmu-501	4 /// harataḥ sasaṃbhram. /	harataḥ sa saṃbhram 
SA_XX_kukalpmu-502	// + + + + + t. khalu yā .. + +	ro khalu yā 
SA_XX_kukalpmu-503	5 /// + lama + + + /// + + + + + + + + + + +	ro-0 
SA_XX_kukalpmu-504	v1 /// rathyāmukha .. .. / // + + + + + + + + + + +	ro-0 
SA_XX_kukalpmu-505	2 /// bhagavān asamāptabhikṣ. / / /	bhagavān asamāpta bhikṣ 
SA_XX_kukalpmu-506	_ _ _ _ ^ _ _ _ _ _ _ _ ^ _ ^ _ _ _ bhraṣṭam ivāmedhye _ _	          
SA_XX_kukalpmu-507	3 _ _ ^ _ nakaḥ 18 a _ _ _ ^ _ _ _ _ _ _ _ ^ _ ^ _ _ _ _ _ ^ _ _ _ _ _ _ _ ^ _ ^ _ 19 _ _ _ _ ^ _ _ _ _ ratāṃ ca parīkṣate viraca	ra tām ca parīkṣate viraca 
SA_XX_kukalpmu-508	4 _ ^ _ _ _ _ _ _ _ ^ _ ^ _ 20 /// atha saṃvṛtaṃ rathyāmukham ave .. .i	atha saṃvṛtam rathyā mukham i 
SA_XX_kukalpmu-509	5 + + + + + + + + + /// ḍavaśād bhūmim abhi + + + +	        
SA_XX_kukalpmu-510	KalpM : IDP SHT 21/51	kalpm idp sht 
SA_XX_kukalpmu-511	141r1 /// + + vāsukiprabhṛtīnāṃ nāgānāṃ viṣam aviṣaṃ syāt . //	              
SA_XX_kukalpmu-512	+ + + na gṛhāṇi kṣe + + + + + + + / ///	na gṛhāni 
SA_XX_kukalpmu-513	2 /// + + .. kutaḥ //	ro-0 kutas 
SA_XX_kukalpmu-514	bhindyād idaṃ jaladadurdinam unnataṃ ca mattadvipendrakalilaṃ dviṣatāṃ ca sainyam sarvajña _ ^ ^ ^ _ ^ ^ _ ^ _ _ _ _ ^ _ ^ ^ ^ _ ^ ^ _	bhindyāt idam jalada durdinam unnatam ca matta dvipa indra kalilam dviṣatām ca sainyam 
SA_XX_kukalpmu-515	3 ^ _ _ 8 cīnarājakumārasya tām ātmanaś cakṣur.i + ///	         
SA_XX_kukalpmu-516	.. pramuditamanasaḥ pūrvam eva ca sa + ///	pramudita manasaḥ pūrvam eva ca sa 
SA_XX_kukalpmu-517	4 /// cakṣur vviśuddhaṃ /	cakṣuḥ viśuddham 
SA_XX_kukalpmu-518	sedānīṃ māṃsacakṣuṣi prajñā + / / /	sā idānīm māṃsa cakṣuṣi prajñā 
SA_XX_kukalpmu-519	+ ddhe /	ddhe 
SA_XX_kukalpmu-520	buddhavacanamāhātmyavismitaḥ prāha _ _ _ _ _ ^ _ _ ^ _ _ _ _ _ _ _ ^ _ _ ^ _	buddha vacana māhātmya vismitaḥ prāha 
SA_XX_kukalpmu-521	5 /// .i .. śrotrābhyāṃ yan mayā sād. _ _ cakṣur vvai _ _ ^ _ _ ^ śuddham 9 _ _ _ _ ^ _ _ ^ _ _ _ _ _ _ _ ^ _ _ ^ _ _	i śrotrābhyām yat mayā sāt cakṣuḥ vai       
SA_XX_kukalpmu-522	v1 _ _ _ _ _ naratnāṃjanena svāsthyan nītaṃ hy adya cakṣurdvaya _ 10 _ _ śākyamunau janaḥ sahṛdayaḥ ko nāma moh. ^ _ _ _ _ ^ _ ^ _ ^ ^ ^ _ _	    nītam hi adya                 nāma 
SA_XX_kukalpmu-523	2 _ ^ ^ _ ^ tair mṛdupadair vvākyaiḥ kṛtānugrahaḥ m. _ _ ^ ^ _ ndriyaṃ kṛśamatir mleccho 'pi saṃbudhyata iti 11 ///	                         
SA_XX_kukalpmu-524	3 /// + .ī .. bhir avetya prasādāya prayatitavyam /	   avetya prasādāya prayatitavyam 
SA_XX_kukalpmu-525	tadyathānuśrūyate rājñā kila kaści .. ///	tat yathā anuśrūyate rājñā kila kaścid 
SA_XX_kukalpmu-526	4 /// + + s tad upagamya caṇḍālasyājñā dattā vadhy. //	tat upagamya caṇḍālasya ājñā dattā vadhi 
SA_XX_kukalpmu-527	puruṣa iti /	puruṣaḥ iti 
SA_XX_kukalpmu-528	sa ca + + + .. + .. + + + / ///	sa ca 
SA_XX_kukalpmu-529	5 /// + + .o rājaśāsanam atikramasīti coktaḥ //	rāja śāsanam atikramasi iti ca uktaḥ 
SA_XX_kukalpmu-530	+ + + .itāḥ khal. .. + + + + + + + + / ///	ro khal 
SA_XX_kukalpmu-531	KalpM : IDP SHT 21/52	kalpm idp sht 
SA_XX_kukalpmu-532	146r1 sarvajña iti viśrutaḥ _ _ _ _ ^ _ _ mi sarvasatvānukampakam 6 yeṣāṃ ca _ ^ ^ ^ _ ^ ^ _ ^ _ _ _ _ ^ _ ^ ^ ^ _ ^ m avaiti buddhaḥ _ _ ^	sarvajñaḥ iti viśrutaḥ        sarva satva anukampakam  yeṣām ca 
SA_XX_kukalpmu-533	2 r anavāptapūrvo yo _ ^ _ ^ ^ ^ _ ^ gato jinena 7 sa bhagavaṃtam upasaṃkrāmya dakṣiṇajānumaṇḍalaṃ pṛthivyāṃ + ///	R an avāpta pūrvaḥ yaḥ        gataḥ jinena saḥ bhagavantam upasaṃkrāmya dakṣiṇa jānu maṇḍalam pṛthivyām 
SA_XX_kukalpmu-534	puṭaḥ prāha / / /	puṭaḥ prāha 
SA_XX_kukalpmu-535	dīkṣā smṛtā yadi ^	dīkṣā smṛtā yadi 
SA_XX_kukalpmu-536	3 varṇacatuṣṭayasya _ _ ^ nirvṛtisukhaṃ yadi madvidho 'pi sādhu prajāhitasamudyatasarvabhāva pr. _ ^ _ ^ ^ ^ _ ^ ^ _ pamānaḥ 8 tataḥ paramakāru	varṇa catuṣṭayasya nirvṛti sukham yadi sādhu prajā hita samudyata sarva bhāva tatas 
SA_XX_kukalpmu-537	4 ṇiko bhagavān buddhaḥ śata ///	ṇikaḥ bhagavān buddhaḥ śata 
SA_XX_kukalpmu-538	+ kāśenojvalacakrabiṃbālaṃkṛtamadhyena tanutāmravimalajālāvaga + / / /	kāśena ujvala cakra biṃba alaṃkṛta madhyena 
SA_XX_kukalpmu-539	+ + + ṣu natam āśayaṃ bhadrak. + +	     
SA_XX_kukalpmu-540	5 viśeṣaṃ śi + .i + + .i + + ///	viśeṣam 
SA_XX_kukalpmu-541	+ + pravraja vatsa visrabdhan nāsti tathāgatasya dharmeṣv ācāryamuṣṭir na prāde .. / / /	pravraja vatsa na asti tathāgatasya dharmeṣu ācārya muṣṭiḥ na 
SA_XX_kukalpmu-542	+ + + + + + + khyaṃ na saṃba + + +	ro na 
SA_XX_kukalpmu-543	v1 .. sanaṃ na p. .. + + + /// + + + yogakṣemakaro hi mayādhigato mārgaḥ sarvapaṇyaś ca mayāyam a / / /	v sanam na         yogakṣema karaḥ hi mayā adhigataḥ mārgaḥ sarva paṇyaḥ ca mayā ayam 
SA_XX_kukalpmu-544	+ + + + + + + śāstraṃ jāti .. +	    
SA_XX_kukalpmu-545	2 .. tra vibhavān avekṣate ///	vibhavān avekṣate 
SA_XX_kukalpmu-546	+ .. hāsaraś caturṇāṃ varṇānāṃ viśuddhim āvahaty ayaṃ dharmavinayaḥ paśya .. / / /	hāsaraḥ caturṇām varṇānām viśuddhim āvahati ayam dharma vinayaḥ paśya 
SA_XX_kukalpmu-547	_ _ ^ _ ^ ^ ^ _ na tṛṣāṃ cchinatti keṣāṃ gṛhe	na tṛṣām chinatti kānām gṛhe 
SA_XX_kukalpmu-548	3 ṣu timiran na nihaṃti dīpaḥ sarvajñaśāsanam upetya ca ko manuṣyo nyāyapravṛttamatir arcchati nārthasiddhim 9 _ _ ^ _ ^ ^ ^ pittaharī dvijānāṃ śūdrāṃs tu pitta	na nihaṃti dīpaḥ sarvajña śāsanam upetya ca kaḥ manuṣyaḥ nyāya pravṛtta matiḥ arcchati na artha siddhim 
SA_XX_kukalpmu-549	4 vihatān na vimocyeta _ _ ^ _ kṣayakṛto 'pi bhaved viśeṣo dṛṣṭād adṛṣṭa ^ ^ .ā ^ ^ ha kṣamaṃ hi 10 yasmāt .. vātakapha	vihatāt na vimocyeta       bhavet viśeṣaḥ dṛṣṭāt adṛṣṭa   ā ha kṣamam hi yasmāt vāta kapha 
SA_XX_kukalpmu-550	5 pittavighātakṛ .i _ _ ^ _ ^ ^ ^ _ kriyate viśeṣaḥ rāgādidoṣam aśa _ ^ ^ _ ^ _ _ _ _ ^ _ ^ ^ ^ _ ^ ^ _ viśeṣaḥ 11 y. + + + + + +	pitta vighāta kṛ          kriyate viśeṣaḥ rāga ādi doṣam viśeṣaḥ 
SA_XX_kukalpmu-551	KalpM : IDP SHT 21/53; frg. 4 missing (in italics)	kalpm idp sht frg missing in italics 
SA_XX_kukalpmu-552	147r1 + + + + h. t. n. .. .. ṣ. + + + + + + + + + + + /// + + + + + + + + + + + .ṛ + + + + + + /// .......... jana .......	ro-0 di-1 ns-1                                 
SA_XX_kukalpmu-553	2 + + + pravrajiṣyasi v. + pravrajiṣyāmīty āha + + ///	rocayiṣyasi pravrajiṣyāmi iti āha  /
SA_XX_kukalpmu-554	+ + + + + + + .. sitajaladharavaragokalaviṃkaparabhṛtabhṛṅgarāja .. + / / /	                
SA_XX_kukalpmu-555	........ muravaduṃdubhibrahmasvaro .........	muravat undubhi brahma svaraḥ 
SA_XX_kukalpmu-556	3 + + + śrotramanasī samabhiprahlāday. // /	       
SA_XX_kukalpmu-557	+ + + + + + ehi bhikṣo cara brahmacaryam iti ehīti coktaḥ sa tathāgatena muṇḍaś ca kāṣāyaparītadehaḥ sadyaḥ pra	     ehi bhikṣo cara brahmacaryam iti ehi iti ca uktaḥ sa tathāgatena muṇḍaḥ ca kāṣāya parīta dehaḥ sadyas pra 
SA_XX_kukalpmu-558	4 śāntendriya eva tasthau nipacchito buddhamanorathena 13 atha khalv ehibhikṣukadharmiṇy upasaṃpanne tatrabhavaty upālini // /	śānta indriyaḥ eva tasthau nipacchitaḥ buddha manorathena atha khalu ehi bhikṣuka dharmiṇi upasaṃpanne tatrabhavati upālini  /
SA_XX_kukalpmu-559	..... bhadrikaprabhṛtayaḥ .......	bhadrika prabhṛtayaḥ 
SA_XX_kukalpmu-560	5 + + karmaṇopasaṃpadya bhagavaṃtam abhigatās tato bhagavatābhihitāḥ kriya + + + + ///	karmaṇā upasaṃpadya bhagavantam abhigatāḥ tatas bhagavantā abhihitāḥ 
SA_XX_kukalpmu-561	+ + ..ṃ pādavandanam iti / /	     
SA_XX_kukalpmu-562	// ............. ṣmāśvaji .........	ṣmā a śva ji 
SA_XX_kukalpmu-563	v1 /// .. ṣv āyuṣmati copālini pratyaṃtāvasthite /	āyuṣmati copālini 
SA_XX_kukalpmu-564	bhadrikaḥ śākyarājā vṛṣabha .. + + + + // /	bhadrikaḥ śākya rājā vṛṣabha 
SA_XX_kukalpmu-565	śākyaputrāṇām agrataḥ pray. / / /	śākyaputrāṇām agratas 
SA_XX_kukalpmu-566	....... śākyā bhikṣū ........	śākyā bhikṣū 
SA_XX_kukalpmu-567	2 /// + copāliparyāyam āgatās ta āyuṣmaṃtam upālinam āsādya malayagiri / / /	  copāli paryāyam āgatāḥ te āyuṣmantam upālinam āsādya malaya giri 
SA_XX_kukalpmu-568	+ saṃkaṭapratihatā iva sāgarormayaḥ pratinivṛttāḥ kathaṃ n. ..........	saṃkaṭa pratihatāḥ iva sāgara ūrmayaḥ pratinivṛttāḥ katham 
SA_XX_kukalpmu-569	3 /// + bhṛśavivṛddhayaśasīkṣvāku .. ///	       
SA_XX_kukalpmu-570	+ + + + + + yasaṃskārābhisaṃskṛtapū .. / / /	R     ya saṃskāra abhisaṃskṛta pū     
SA_XX_kukalpmu-571	svasya paricārakasya śūdra + / / /	svasya paricārakasya śūdra 
SA_XX_kukalpmu-572	....ijasya nāpitakulotpannasya ........	ijasya nāpita kula utpannasya 
SA_XX_kukalpmu-573	4 /// + ti / bhagavatābhihitāḥ kriy. .. + ///	     
SA_XX_kukalpmu-574	+ + + + + + śākyāḥ prāhur bhagavan . + / / /	    śākyāḥ prāhuḥ bhagavant 
SA_XX_kukalpmu-575	+ .. yam iti /	yam iti 
SA_XX_kukalpmu-576	bhagavān āha / / /	bhagavān āha 
SA_XX_kukalpmu-577	mānaprahāṇāyāyaṃ dharmaḥ ........	māna prahāṇāya ayam dharmaḥ 
SA_XX_kukalpmu-578	5 /// .. kyāḥ pā .. + + + + + + + + + /// + + + + + + + + + + + + + + + + + /// + + + + + + + + + + /// ............... .i ś. .....	ro 
SA_XX_kukalpmu-579	KalpM : IDP SHT 21/54	kalpm idp sht 
SA_XX_kukalpmu-580	153r1 /// .. vadhāraṇa + ///	ro 
SA_XX_kukalpmu-581	2 /// .. yāmi parvatān ///	 yāmi parvatān 
SA_XX_kukalpmu-582	3 /// .. yagrahī .. ///	R ya grahī 
SA_XX_kukalpmu-583	4 /// py uktam / // a .. ///	    
SA_XX_kukalpmu-584	5 /// r vviśīrṇaḥ 6 + ///	R viśīrṇaḥ 
SA_XX_kukalpmu-585	v1 /// .. viluḷitaṃ ci .. ///	viluḍitam ci 
SA_XX_kukalpmu-586	2 /// vahayoyaṃtra + ///	vahayoyantra 
SA_XX_kukalpmu-587	3 /// .. sūryavarmā + ///	ro 
SA_XX_kukalpmu-588	4 /// ś cittam utpādi + ///	cittam utpādi 
SA_XX_kukalpmu-589	5 /// .. vṛddhatara .. + ///	ro 
SA_XX_kukalpmu-590	KalpM : IDP SHT 21/55	kalpm idp sht 
SA_XX_kukalpmu-591	154r1 jayamitro ///	jaya mitraḥ 
SA_XX_kukalpmu-592	2 d bhaktatarpaṇ. ///	t bhakta tarpaṇ 
SA_XX_kukalpmu-593	.. tha vṛtte pariveṣe so 'māty. + + + ///	vṛtte pariveṣe saḥ 
SA_XX_kukalpmu-594	3 vṛttaḥ pari .. ///	vṛttaḥ pari 
SA_XX_kukalpmu-595	.. kuto 'tra prasādo ya eva teṣāṃ bhi ///	kutas tra prasādaḥ yaḥ eva teṣām bhi 
SA_XX_kukalpmu-596	4 stha .i + + /// + + + + .. pāṇibhyāṃ pidhāyovāca /// 5 + + + + + /// + + + + + + .. + .. + .. .. ///	ca                             
SA_XX_kukalpmu-597	v2 taca + + /// + + + + .. kalyāṇ. .. s. v. me ///	v me 
SA_XX_kukalpmu-598	3 vijñāyam. /// + .. + .. m ākhyātāḥ na ca śakya ///	vijñāyam     m ākhyātāḥ na ca śakya 
SA_XX_kukalpmu-599	4 satpuruṣo /// _ _ _ _ garbhāḥ pracchannā nopalakṣyante 4 ///	sat puruṣaḥ      garbhāḥ pracchannāḥ na upalakṣyante 
SA_XX_kukalpmu-600	5 ti ca saṃ .. /// .. s. y. .. .. .i .. .. + + + + ///	ti ca sam 
SA_XX_kukalpmu-601	KalpM : IDP SHT 21/56	kalpm idp sht 
SA_XX_kukalpmu-602	161r1 /// + + + samutpanno devatābhir api cāvadhyātās tadvṛttāntābhijñāiś ca puṣpair dhigdhigvādenāvakīrṇās teṣāṃ ///	    samutpannaḥ devatābhiḥ api ca avadhyātāḥ tad vṛttānta abhijñābhiḥ ca puṣpaiḥ dhik dhik vādena avakīrṇāḥ teṣām 
SA_XX_kukalpmu-603	2 /// .. kṛtāṃjalayaḥ praṇipatya vijñāpayema / /	 kṛtāñjalayaḥ praṇipatya vijñāpayema 
SA_XX_kukalpmu-604	tava vacanam atikrāmya tribhavaguro roṣarākṣasāviṣṭāḥ _ _ _ _ _ _ _ _ _ _ ^ _ _ _ 13	tava vacanam atikrāmya tri bhava guro roṣa rākṣasa āviṣṭāḥ 
SA_XX_kukalpmu-605	3 _ _ _ _ kṛtvā punar apy ājñāṃ prayaccha kāruṇika atyūrjitāṃ ca tāvac chṛṇu pratijñāṃ tva _ _ _ 14 _ _ _ _ _ _ _ _ _ _ ^ _ ^	              ca   śṛṇu      
SA_XX_kukalpmu-606	4 _ _ _ ājñāpayiṣyasi na te vacanāni vilomayiṣyāmaḥ 15 atha teṣāṃ bhikṣūṇāṃ ci + + + ///	ājñāpayiṣyasi na te vacanāni vilomayiṣyāmaḥ atha teṣām bhikṣūṇām 
SA_XX_kukalpmu-607	5 ^ ^ ^ _ _ _ r. i _ _ _ _ ^ ^ kārya eva satataṃ te .āṃ ^ _ nugrahaḥ _ _ _ ^ ^ _ ^ _ ^ ^ ^ _ _ _ ^ _ _ ^ _ _ _ _ ^ ^ _ ^ _	           
SA_XX_kukalpmu-608	v1 ^ ^ ^ _ _ _ t. _ trā ^ _ 16 + + + .. bhagavāns tṛṇasaṃstarād utthāya + + vārāmam. .. .. + + + ///	di di           bhagavān tṛṇa saṃstarāt utthāya         
SA_XX_kukalpmu-609	2 /// kṛtāṃjalayaḥ procuḥ / /	kṛtāñjalayaḥ procuḥ 
SA_XX_kukalpmu-610	aho 'tikaruṇātmako 'yam ṛṣipuṃgavo yaj janaiḥ pramādam a ^ _ ^ _ ^ ^ ^ _ ^ _ _ ^ _ ^ _ ^ ^ ^ _ ^ _ ^ ^ ^	aho ti karuṇā ātmakaḥ yam ṛṣi puṃgavaḥ yat janaiḥ 
SA_XX_kukalpmu-611	3 _ ^ _ _ dhanaḥ kadaśvam api sārathir damayatīti saṃcintayan 17 tato bhagavān kauśāṃbeyā .. + + ///	    api   damayati iti                                                                    
SA_XX_kukalpmu-612	4 /// + m upetya bhagavataḥ pādayor nipatya kṛtāṃjalayaḥ kathayitum ārabdhā vayaṃ hi kalahabhaṇḍanābhi ///	upetya bhagavataḥ pādayoḥ nipatya kṛtāñjalayaḥ kathayitum ārabdhāḥ vayam hi 
SA_XX_kukalpmu-613	5 /// + i saṃghabhedāya ca pratipannāḥ /	i saṃgha bhedāya ca pratipannāḥ 
SA_XX_kukalpmu-614	.. .ādh. . bhagavāṃs tān dharmān upadiśatu ye dharmāḥ priyakāriṇaś ca ///	ādh bhagavān tān dharmān upadiśatu ye dharmāḥ priya kāriṇaḥ ca 
SA_XX_kukalpmu-615	KalpM : IDP SHT 21/57	kalpm idp sht 
SA_XX_kukalpmu-616	163r1 /// t. bhavasi .. ///	ro bhavasi 
SA_XX_kukalpmu-617	r iti /	R iti 
SA_XX_kukalpmu-618	sa punar evaṃ vijñāpayitum ārabdhaḥ evam apy ahan na + /	sa punar evam vijñāpayitum ārabdhaḥ evam api ahan na 
SA_XX_kukalpmu-619	// rtum iti sū +	rtum iti sū 
SA_XX_kukalpmu-620	2 /// + bhojanasya ///	   
SA_XX_kukalpmu-621	+ + m /	R 
SA_XX_kukalpmu-622	āyuṣmāṃs tu bhaddālir bhagavataḥ sāṃtikād apakrāmya paraṃ vrīḍam āpanna / / /	āyuṣmān tu bhaddāliḥ bhagavataḥ sāṃtikāt apakrāmya param vrīḍam āpanna 
SA_XX_kukalpmu-623	yāmāsa // pr.	yāmāsa pra 
SA_XX_kukalpmu-624	3 _ _ _ _ _ _ _ _ _ ^ _ ^ _ _ me katham iva ca mayā _ taḥ sa bhūpradeśo 'dya na viśīrṇaḥ 3 rakṣāṃsi piśācāś ca _ ^ .i .ā .o ^	me katham iva ca mayā sa bhū pradeśaḥ na viśīrṇaḥ rakṣāṃsi piśācāḥ ca 
SA_XX_kukalpmu-625	4 _ ^ _ _ _ _ _ _ _ _ _ ^ haṃty ahaṃ tu pr. _ _ _ 4 ^ ^ ^ ^ ^ ^ _ _ _ ^ taṃ vābhaviṣyat krimibhir apahṛtaṃ vā pāṃsubhi _ ^ _ _ ^ ^ ^ ^ ^ ^ _	                       
SA_XX_kukalpmu-626	5 ^ _ _ ^ _ _ ^ ^ ^ ^ ^ ^ _ _ _ damātravyapa _ 5 + + + + + + + + + + + + + bhūtas tena traimāsena na śaśāka bhaga + ///	                    na śaśāka   
SA_XX_kukalpmu-627	v1 /// + yā dahyamāna .. // /	v yā dahyamāna 
SA_XX_kukalpmu-628	+ + + + + + prāhuḥ / /	     
SA_XX_kukalpmu-629	idaṃ cīvarakam ādaya kriyate loka _ ^ _ _ _	idam kriyate 
SA_XX_kukalpmu-630	2 _ _ ^ _ _ _ _ _ _ _ ^ _ ^ ca 6 tadada ^ ^ ^ _ ^ _ ^ ^ ^ ^ ^ ^ _ ^ _ ^ _ḥ gurujanaparitoṣakāṅkṣiṇaḥ śramama ^ ^ ^ _ ^ _ ^	di-2 di-2 ro-0 di-2 di-2 di-2 di-2 di-2 
SA_XX_kukalpmu-631	3 _ 7 /// ^ _ _ _ _ _ ^ ^ .. ṇamatitvān na gaṇitaṃ parityaktā lajjā sadasi vivṛtā me capalatā na dṛṣṭo dhik ch. _ ^ ^ ra iti nā _ ^ ^ ^ _ ^	    na                na            
SA_XX_kukalpmu-632	4 _ _ ko vivaditum. _ _ ^ ^ ^ _ 8 ///	kaḥ vivaditum 
SA_XX_kukalpmu-633	+ + + brahmacāribhir uktaḥ prasādaya bhagavantam iti sa uvāca //	                      
SA_XX_kukalpmu-634	mamāpi + //	mama api 
SA_XX_kukalpmu-635	autsukyaṃ prasā + / ///	autsukyam prasā   
SA_XX_kukalpmu-636	5 /// .. .. mas. a .i /// cuḥ vītasarvāsravasyopasarpataḥ kas tava viṣāda iti sa uvāca / / + + / ///	  cuḥ vīta sarva āsravasya upasarpataḥ kaḥ te viṣādaḥ iti saḥ uvāca       
SA_XX_kukalpmu-637	KalpM : IDP SHT 21/58	kalpm idp sht 
SA_XX_kukalpmu-638	164r1 /// sahāmi tena yad iha pr. .. + + ///	sahāmi tena yat iha 
SA_XX_kukalpmu-639	2 /// va niścaya iti so 'bravīt ///	niścayaḥ iti saḥ bravīt 
SA_XX_kukalpmu-640	3 /// + sa pariṣadgataṃ bhagavantaṃ ///	sa pariṣad gatam bhagavantam 
SA_XX_kukalpmu-641	4 /// .ṛśaṃ kṣāmākṣasya kṣudu .. + ///	ṛśam kṣāma akṣasya kṣudu 
SA_XX_kukalpmu-642	5 /// vihatam abhavi + + ///	vihatam abhavi 
SA_XX_kukalpmu-643	v1 /// bhaddāle iha syā .. + ///	v bhaddāle iha syā 
SA_XX_kukalpmu-644	2 /// d anyeṣāṃ bhikṣūṇām ā + ///	 d anyeṣām bhikṣūṇām ā 
SA_XX_kukalpmu-645	3 /// ti / evam āryasatya .. ///	 ti evam ārya satya 
SA_XX_kukalpmu-646	4 /// m mohapuruṣa tadā ceta ///	m moha puruṣa tadā 
SA_XX_kukalpmu-647	5 /// pratyayo jātaḥ mā .. ..///	pratyayaḥ jātaḥ mā 
SA_XX_kukalpmu-648	KalpM : IDP SHT 21/59	kalpm idp sht 
SA_XX_kukalpmu-649	165r1 sthaviraś ca bhikṣur yadi na kṣī .. ///	sthaviraḥ ca bhikṣuḥ yadi na kṣī 
SA_XX_kukalpmu-650	2 tasyāsravakṣayaṃ vadati .. ///	tasya āsrava kṣayam vadati 
SA_XX_kukalpmu-651	3 to nāpaśyata iti / + + ///	na apaśyata iti 
SA_XX_kukalpmu-652	4 naś ca nājānato nāpa + ///	naḥ ca na a jānataḥ na āpa 
SA_XX_kukalpmu-653	5 + .ān iti vipratipanna + ///	iti vipratipanna 
SA_XX_kukalpmu-654	v1 + prayatitavyam /	v prayatitavyam 
SA_XX_kukalpmu-655	tadyathānuśrūyate ///	tat yathā anuśrūyate 
SA_XX_kukalpmu-656	2 nuyātreṇānugatas tūrya + + + + + ///	nuyātreṇa anugataḥ tūrya 
SA_XX_kukalpmu-657	3 rāśir asthiro babhūva + + + + + + ///	rāśiḥ asthiraḥ babhūva 
SA_XX_kukalpmu-658	4 tphulladṛṣṭiḥ kaṣṭam ida + + + + + ///	kaṣṭam 
SA_XX_kukalpmu-659	5 .. tam iva diśaḥ kṣipamā + + + + + ///	tam iva diśaḥ 
SA_XX_kukalpmu-660	KalpM : IDP SHT 21/60	kalpm idp sht 
SA_XX_kukalpmu-661	166r1 + + + + + /// + + + + + canam anudhāvaṃti g. ///	anudhāvanti 
SA_XX_kukalpmu-662	+ + + + + + .. ravivaram anu .. / / /	ravi varam anu 
SA_XX_kukalpmu-663	pādapalatā .ai / / /	pādapa latā ai 
SA_XX_kukalpmu-664	.. ṅg.ḥ rājā vicārayituṃ pravṛttaḥ	rājā vicārayitum pravṛttaḥ 
SA_XX_kukalpmu-665	2 k. + + .. + /// .. gaṇayitvā .. kiṃ svit samīpa ///	di gaṇayitvā kim svid 
SA_XX_kukalpmu-666	+ + + + .. kūṭam āplutya vrajāmīti / / /	   kūṭam āplutya vrajāmi iti 
SA_XX_kukalpmu-667	topayā .. + + / / /	topayā 
SA_XX_kukalpmu-668	iṃ .āme kṛtvā sukṛtaṃ syād iti vi ..	iṃ āme kṛtvā su kṛtam syāt iti vi 
SA_XX_kukalpmu-669	3 bhūto 'bhavat. ///	bhūtaḥ bhavat 
SA_XX_kukalpmu-670	.. rśvaḥ pavano + + + .. .. + + // /	rūpaḥ 
SA_XX_kukalpmu-671	+ + + + ullikhyamānamastaka + / / /	R ullikhyamāna mastakaiḥ 
SA_XX_kukalpmu-672	+ + mya pradhāvita eva / tataḥ sa rā	pradhāvitaḥ eva tatas sa rā 
SA_XX_kukalpmu-673	4 jā kaṇṭhak. + /// + bhadrav. + + + + //	jā kaṇṭhak    
SA_XX_kukalpmu-674	+ ṣṭanaḥ parvatapāṣāṇodgha + + / ///	ṣ ṭanaḥ parvata pāṣāṇa udgha     
SA_XX_kukalpmu-675	5 /// hastipakam uvāca //	hastipakam uvāca 
SA_XX_kukalpmu-676	pra .. + + + ///	ad 
SA_XX_kukalpmu-677	v1 /// na vṛddhena śvāsenonnāmya + + + ///	na vṛddhena śvāsena unnāmya  /
SA_XX_kukalpmu-678	2 .. ṇ. r uvāca .. /// + dinaṃ mu .. + + + //	r uvāca    dinam 
SA_XX_kukalpmu-679	maṃtrān paramarṣibhāṣitāṃ ka .. / ///	maṃtrān parama ṛṣi bhāṣitām ka 
SA_XX_kukalpmu-680	3 r ivauṣadhībal. ///	R iva oṣadhī bal 
SA_XX_kukalpmu-681	aṃkuśanigrahe .. + + ///	aṃkuśa nigrahe 
SA_XX_kukalpmu-682	+ + + .. lam iti /	R laṃ iti 
SA_XX_kukalpmu-683	tataḥ samī + /	tatas samī 
SA_XX_kukalpmu-684	+ svāminn imāṃ latām ālaṃbasveti / / /// /	svāmin imām latām ālaṃbasva iti 
SA_XX_kukalpmu-685	4 rājahastipakau ///	rāja hastipakau 
SA_XX_kukalpmu-686	.. tāṃ vṛkṣaśākham ālambya sthitau /	tām vṛkṣa śākham ālambya sthitau 
SA_XX_kukalpmu-687	hastī tāṃ hastinīm abhi .. ///	hastī tām hastinīm abhi 
SA_XX_kukalpmu-688	+ taḥ .. .. + /	taḥ 
SA_XX_kukalpmu-689	.. prāṇaḥ śanakaiḥ skandhāvāram anuprāptaḥ / /// /	prāṇaḥ śanakais skandhāvāram anuprāptaḥ 
SA_XX_kukalpmu-690	5 + + + + + /// + + + + + + .. ca bahubhir a .i ///	         ca bahubhiḥ a i 
SA_XX_kukalpmu-691	+ + + + + m ādāyābhigat. //	ādāya abhigat 
SA_XX_kukalpmu-692	nmadhyagatasya / /	n madhya gatasya 
SA_XX_kukalpmu-693	+ .āmayāmāsa /	āmayāmāsa 
SA_XX_kukalpmu-694	rājñā ca kruddhena / /// /	rājñā ca kruddhena 
SA_XX_kukalpmu-695	KalpM : IDP SHT 21/61	kalpm idp sht 
SA_XX_kukalpmu-696	167r1 /// + + + + + + + + hastipakaḥ kṛtāṃjalir uvāca / + + + + + ///	         
SA_XX_kukalpmu-697	2 /// + + + + .. + + + + + gilemān ayoguḷān iti + + + .. + + ///	             
SA_XX_kukalpmu-698	3 /// + + evam abhivinīto 'yaṃ nāgas tathodbhrānta iti /	evam abhivinītaḥ yam nāgaḥ tathā udbhrāntaḥ iti 
SA_XX_kukalpmu-699	tac ca vacanam u .. ///	tat ca vacanam u 
SA_XX_kukalpmu-700	4 /// yenaiṣa doṣeṇa tām avasthān nītas tasya doṣasya na vayaṃ cikitsām. ///	yena eṣa doṣeṇa tām avasthāt nītaḥ tasya doṣasya na vayam cikitsām 
SA_XX_kukalpmu-701	5 /// .i .. mi yenāyam abhivinīto nāgo 'smākam avineyaḥ saṃvṛttaḥ .. ///	i yena ayam abhivinītaḥ nāgaḥ smākam avineyaḥ saṃvṛttaḥ 
SA_XX_kukalpmu-702	v1 /// .. cetasaḥ 4 rāgo hy eṣa ^ _ .. .y.ḥ katham apy upajāyate kayāpi _ ^ _ _ _ _ _ _ _ ^ _ ^ _ 5 ///	v cetasaḥ rāgaḥ hi eṣa    yaḥ katham api upajāyate kayā api 
SA_XX_kukalpmu-703	2 /// .. bhadra kim upekṣito 'yaṃ vyādhiviśeṣo lokena āho svit kaścid asya praśamā .. ///	bhadra kim upekṣitaḥ yam vyādhi viśeṣaḥ lokena āho svid kaścid asya 
SA_XX_kukalpmu-704	3 /// _ _ _ _ ^ _ _ _ _ _ _ _ ^ _ ^ _ gatiṃ tv asyānabhijñāya nirvartante hatodyamāḥ 6 tyajanti vi ^ _ _ _ _ _ _ _ ^ _ ^ _ _ _ _ _ ^	                   
SA_XX_kukalpmu-705	4 _ _ _ _ _ _ _ ^ _ ^ _ 7 _ _ _ _ ^ _ _ _ _ _ _ tatra _ ^ _ _ _ _ yanti mūlāni kāmarāga ^ _ ^ .iḥ 8 _ _ _ _ ^ _ _ ^ ^ ^ ^ ^ ^ _ _ ^	adhi inti mūlāni 
SA_XX_kukalpmu-706	5 _ _ ^ _ _ _ _ _ _ ^ _ _ ^ ^ ^ ^ ^ ^ _ _ ^ _ _ ^ _ _ _ _ _ _ ^ _ _ r bhavagatigahane 'smiṃś ca _ _ ^ _ _ _ _ _ _ ^ _ _ ^ ^ ^ ^	r bhava gati gahane 
SA_XX_kukalpmu-707	KalpM : IDP SHT 21/62; cf. Divy 361-362	kalpm idp sht cf divi 
SA_XX_kukalpmu-708	172r1 /// vyavasitenottaptahemaprabhaṃ bauddhaṃ rūpa / / /	vyavasitena uttapta hema prabham bauddham 
SA_XX_kukalpmu-709	+ + + + kṛtam kṛtvā rūpam ahaṃ tad eva nayanaprahlādikaṃ dehinām eṣyāmy arkka)mayūkha + + + + + +	        eva        eṣyāmi                                               
SA_XX_kukalpmu-710	2 /// atha // /	atha 
SA_XX_kukalpmu-711	kuṇapam apanīya tathāgatarūpadarśanotsuko 'vasthitaḥ māraś ca vanagahanam anupraviśya + + + + 3 /// + + + + + ///	kuṇapam apanīya tathāgata rūpa darśana utsukaḥ vasthitaḥ māraḥ ca vana gahanam anupraviśya 
SA_XX_kukalpmu-712	ārabdho niṣkramituṃ vakṣyate hi / / /	ārabdhaḥ niṣkramitum vakṣyate hi 
SA_XX_kukalpmu-713	tathāgataṃ vapur athottamalakṣaṇāḍhyam ādarśayan nayanaśāntikaraṃ 4 /// + + + + + // /	tathāgatam vapuḥ atha uttama lakṣaṇa āḍhyam ādarśayan nayana śānti karam 
SA_XX_kukalpmu-714	asau tad alaṃcakāra 27 atha vyāmaprabhāmaṇḍalamaṇḍitam asecanakadarśanaṃ bhagavato rūpa 5 /// + + + + + // /	asau tat alaṃcakāra atha vyāma prabhā maṇḍala maṇḍitam asecanaka darśanam bhagavataḥ 
SA_XX_kukalpmu-715	na pārśvena maudgalyāyanam āyuṣmantam ānaṃdaṃ buddhapātravyagrakaraṃ sthavirakāśyapānuruddhasubhūtiprabhṛtīnāṃ	na pārśvena maudgalyāyanam āyuṣmantam ānaṃdam buddha pātra vyagra karam sthavira kāśyapa anuruddha subhūti prabhṛtīnām 
SA_XX_kukalpmu-716	v1 /// + + + + + // /	ro-0 
SA_XX_kukalpmu-717	bhikṣuśatair ardhacandreṇānuparivṛtaṃ buddham ādarśayitvā māraḥ sthavirasyopaguptasyāntikam upagata 2 /// + + + + + ///	bhikṣu śataiḥ ardhacandreṇa anuparivṛtam buddham ādarśayitvā māraḥ sthavirasya upaguptasya antikam 
SA_XX_kukalpmu-718	.. pramuditamanās tvaritam āsanād utthāya nirīkṣamāṇa uvāca / /	pramudita manāḥ tvaritam āsanāt utthāya nirīkṣamāṇaḥ uvāca 
SA_XX_kukalpmu-719	dhig astu tān niṣkaruṇām anityatāṃ bhinatti rūpāṇi + 3 /// + + + + + // /	dhik astu tān niṣkaruṇām anitya tām bhinatti rūpāṇi 
SA_XX_kukalpmu-720	+ āgatam 28 sa tathāgatālaṃbanayā budhyā tathā vyāsaktamanāḥ saṃvṛtto yathā buddham evā + +	āgatam sa tathāgata ālaṃbanayā budhyā tathā vyāsakta manāḥ saṃvṛttaḥ yathā buddham 
SA_XX_kukalpmu-721	4 /// padmamukulapratimam. // /	       
SA_XX_kukalpmu-722	+ aho rūpaśobhā bhagavataḥ kiṃ bahunā / / /	aho rūpa śobhā bhagavataḥ kim bahunā 
SA_XX_kukalpmu-723	vaktrenābhibhavaty ayaṃ hi kamalan nīlotpalaṃ + + +	vaktrena abhibhavati ayam hi kamalan nīlotpalam 
SA_XX_kukalpmu-724	5 /// priyatayā candraṃ samāptadyutim . / / /	priya tayā candram samāpta dyutim 
SA_XX_kukalpmu-725	mahodadhiṃ sthiratayā meruṃ ravin tejasā gatyā .. .. .avekṣitena vṛṣabhaṃ varṇena + + + + +	mahā udadhim sthira tayā merum ravin tejasā gatyā   avekṣitena vṛṣabham varṇena      
SA_XX_kukalpmu-726	KalpM : IDP SHT 21/63	kalpm idp sht 
SA_XX_kukalpmu-727	179r1 /// + + kṣitan na cāsya kalpakoṭīsahasreṣv api kiṃci ///	na ca asya kalpa koṭi sahasreṣu api kiṃcid 
SA_XX_kukalpmu-728	2 /// + .. pratyākhyāto 'nyaṃ bhikṣum abhigataḥ pravrājaya mām iti ///	  pratyākhyātaḥ bhikṣum abhigataḥ pravrājaya mām iti 
SA_XX_kukalpmu-729	3 /// sthaviraśāradvatīputro na cāsmy anena pravrājita iti / + + ///	sthavira śāradvatī putraḥ na ca asmi anena pravrājitaḥ iti 
SA_XX_kukalpmu-730	4 /// ḥ / sa mahāvaidyapratyākhyāta ivāturo yena yena + + ///	sa mahā vaidya pratyākhyātaḥ iva āturaḥ yena yena 
SA_XX_kukalpmu-731	5 /// .. .. .. re .i .. .. .. .. .. .. .. .. .. .ī .. + + + + + ///	R ro-0 de-de-de-
SA_XX_kukalpmu-732	v1 /// yo 'ham evam adhanyo 'kṛtapuṇyaś ca mā tāvad bhoḥ // + + + ///	yaḥ ham evam kṛta puṇyaḥ ca mā tāvat bhoḥ      
SA_XX_kukalpmu-733	2 _ _ _ _ _ _ ^ _ _ ^ _ _ _ _ _ _ _ sya satvādhamasya 1 etasminn aṃtare vaineyavatsalo + + ///	sattva adhamasya sattva adhamasya 
SA_XX_kukalpmu-734	3 /// + gato vakṣyate hi / / /	rātaḥ vakṣyate hi 
SA_XX_kukalpmu-735	sarvajñasaṃtānanivāsinī hi _ _ ^ _ _ ^ ^ _ ^ _ _ _ _ ^ _ _ ^ ^	sarvajña saṃtāna nivāsinī hi 
SA_XX_kukalpmu-736	4 _ ^ _ _ _ _ ^ _ _ ^ ^ _ ^ _ _ 2 atha bhagavān amalakamalaprakāśam ujjvala ///	            
SA_XX_kukalpmu-737	KalpM : IDP SHT 21/64	kalpm idp sht 
SA_XX_kukalpmu-738	181r1 /// + + + śāradvatīputra ekāṃsam u .. //	    śāradvatīputraḥ eka aṃsam 
SA_XX_kukalpmu-739	+ + tathāgatamāhātmyavismayākṣ. + / ///	     
SA_XX_kukalpmu-740	2 /// + + brūhīdānīṃ jñeyanistīrṇapāra _ _ _ _ _ ^ _ _ ^ _ _ _ _ _ _ _ ^ _ _ ^ vṛkṣakṣiptaṃ bījaṃ yad vimokṣasya _ _ 9 ///	                           
SA_XX_kukalpmu-741	3 /// + .. vatsa / pratyekabuddhānām api .. //	   vatsa pratyekabuddhānām api 
SA_XX_kukalpmu-742	+ + sa kāṣṭhārtham araṇyam anuprāpta / ///	sa kāṣṭhā artham araṇyam anuprāpta 
SA_XX_kukalpmu-743	4 /// mayena bhagavān buddho 'nuprāpto + + + //	mayena bhagavān buddhaḥ nuprāptaḥ 
SA_XX_kukalpmu-744	.. n. guṇasaṃbhāvanāṃ kṛtvā sarvāśaye / ///	n guṇa saṃbhāvanām kṛtvā sarva āśaye 
SA_XX_kukalpmu-745	5 /// tan mokṣabījam aham asya ^ _ ^ _ _ _ _ ^ _ ^ ^ ^ _ ^ ^ _ ^ _ _ḥ adhyāśayena khalu buddhanama ^ _ _ _ _ ^	tat mokṣa bījam aham asya 
SA_XX_kukalpmu-746	v1 _ ^ ^ ^ _ ^ ^ _ sy. d. t. 10 tato bhagavatā + + + ///	di ro-0 fl tatas bhagavantā 
SA_XX_kukalpmu-747	.. kavairāgyam avāptavān /	kavairāgyam avāptavān 
SA_XX_kukalpmu-748	kim idam upanītam. ///	kim idam upanītam 
SA_XX_kukalpmu-749	2 /// kuśalamūlam amṛtaphalaṃ bhavati kim. + + + //	     bhavati   
SA_XX_kukalpmu-750	yata iti prāmodyam utpādaya /	yatas iti prāmodyam utpādaya 
SA_XX_kukalpmu-751	bhikṣū + + + / ///	ro-0 
SA_XX_kukalpmu-752	3 /// + + bhagavaṃtaṃ pravrajitam anupravrajitāḥ //	        
SA_XX_kukalpmu-753	+ tathāgatasya prabhāvam avekṣya yeṣāṃ + + + / ///	tathāgatasya prabhāvam avekṣya yeṣām 
SA_XX_kukalpmu-754	4 /// + + .. laṃ yena pratyekabuddhavi + //	     
SA_XX_kukalpmu-755	+ + + nvāgata iti 3 nagaropame va + + + + / ///	ro nu āgate iti nagara upame vā 
SA_XX_kukalpmu-756	5 /// + + + buddhir utpannā yadi bhagavān a + //	      
SA_XX_kukalpmu-757	+ + + yaṃti tad vayam api buddhatvāyo + + + + / ///	rocanti tat vayam api 
SA_XX_kukalpmu-758	KalpM : IDP SHT 21/65	kalpm idp sht 
SA_XX_kukalpmu-759	183r1 _ _ ^ _ ^ ^ ^ _ ^ ^ _ ^ _ _ _ _ ^ _ ^ kanakādrir ivāvasiktaḥ 7 aparo 'bravīt + + /// + .. + + pr. + + +	             
SA_XX_kukalpmu-760	2 /// + ūcur ayaṃ sa hīnapratijñaḥ śākyaputraḥ / / /	  ūcuḥ ayam sa hīna pratijñaḥ śākya putraḥ 
SA_XX_kukalpmu-761	tyajya tad atiduṣkar. ..	tyajya tat ati duṣkar 
SA_XX_kukalpmu-762	3 + + + + + + + + + bhovādy. _ ^ _ _ _ _ _ _ _ ^ _ ^ _ t sthitair eva tu vaktavya _ _ _ _ ^ _ ^ _ 9 // /	di-30 di-30 ns-30 ad-30 ac-tu 
SA_XX_kukalpmu-763	punar bhagavān upasasarpa	punar bhagavān upasasarpa 
SA_XX_kukalpmu-764	4 tathā tathā hi //	tathā tathā hi 
SA_XX_kukalpmu-765	uttasthus taṃ samālokya pūrṇacandrā ^ _ ^ _ _ _ _ _ m ivālokya sāgarasya ^ _ ^ _ 10 _ _ _ _ ^ _ _ _ _ _ _ buddhatejasā mahāra	uttasthuḥ tam samālokya pūrṇa candrā         iva ālokya sāgarasya               buddha tejasā mahā ra 
SA_XX_kukalpmu-766	5 jjubhir. _ _ dhvajo _ _ ^ _ ^ _ 11 ya _ _ _ ^ _ _ _ _ _ .e _ ^ _ ^ yā _ _ _ _ ^ _ _ _ _ _ _ _ ^ _ ^ _ 12 kalpeṣv anekeṣu	                              
SA_XX_kukalpmu-767	v1 nihatya mānaṃ _ .mā ^ _ _ praṇat. n. ru .y.ḥ buddha ^ _ _ ^ ^ _ ^ _ _ kaḥ śaknuyāt sthātum agauraveṇa 13 _ _ ^ _ _ ^ ^ _ ^ _ _ _ _ ^ śākyarṣabham	nihatya mānam mā    buddha          kaḥ śaknuyāt sthātum agauraveṇa                  śākya ṛṣabham 
SA_XX_kukalpmu-768	2 yadā natā connamate ca bhūmiḥ śailāś ca neme tṛṇava ^ _ _ 14 ///	yadā natā ca unnamate ca bhūmiḥ śailāḥ ca neme 
SA_XX_kukalpmu-769	paṃcakās tvaritam utthāya + + / / /	paṃcakāḥ tvaritam utthāya 
SA_XX_kukalpmu-770	jagrāha kaścit pātram apa	jagrāha kaścid pātram apa 
SA_XX_kukalpmu-771	3 + + + + + + + + + + + + pā .ā .. .. .ā .o + + + /// + + pādodakapratigraham upā .. / / /	                     
SA_XX_kukalpmu-772	_ _ ^ _ ^ ^ ^ m āpatitan nirīkṣya taṃ .e	nirīkṣya tam 
SA_XX_kukalpmu-773	4 ^ _ ^ ^ ^ _ ^ ^ _ ^ _ _ _ _ ^ _ ^ ^ ^ _ ^ ^ _ n nirīkṣya maunavratāsina iva .. ^ _ ^ _ _ 15 // /	nirīkṣya mauna vrata asinaḥ iva 
SA_XX_kukalpmu-774	rṣīc cyutā bateme .e +	rṣīt cyutāḥ bata ime e 
SA_XX_kukalpmu-775	5 /// + .. tasthur nāmavādena tu bhagavantaṃ /	       
SA_XX_kukalpmu-776	// + + + .. .i + + + +	R se 
SA_XX_kukalpmu-777	KalpM : IDP SHT 21/66	kalpm idp sht 
SA_XX_kukalpmu-778	184r1 van kāruṇyād uvāca //	van kāruṇyāt uvāca 
SA_XX_kukalpmu-779	mā kārṣur uddhṛtamale mayi pūrvavṛttim abhyarca _ ^ ^ ^ cāvagamaṃ labhaddhvam ni _ ^ _ ^ ^ ^ _ ^ ^ _ ^ _ _ _ _ ^ _ ^ ^ ^ _	mā kārṣuḥ uddhṛta male mayi pūrva vṛttim abhyarca      ca avagamam 
SA_XX_kukalpmu-780	2 ya namaṃti santaḥ 16 kāmaṃ stotrair nāsti prītir na ca paruṣavacanakathanair bhavaty aratir mama śro _ _ _ _ _ _ _ ^ ^ ^ ^ ^ ^ ^ ^ ^ ^ _ ^ _ .a	namanti santaḥ kāmam stotraiḥ na asti prītiḥ na ca paruṣa vacana kathanaiḥ bhavati aratiḥ mama 
SA_XX_kukalpmu-781	3 nukaṃpayā mohakrodhasnehādyeṣu vratavidhiṣu vidhivad i ^ _ ^ _ ṣv akhileṣu _ _ _ _ _ _ _ _ _ ^ ^ ^ ^ ^ ^ ^ ^ ^ ^ _ ^ _	nu kaṃpayā moha krodha sneha ādyeṣu vrata vidhiṣu vidhivat akhileṣu 
SA_XX_kukalpmu-782	4 svayam udyatam 17 evam uktāḥ paṃcakā bhagavato bodhim asaṃbhāvayaṃta ūcuḥ // sthite ^ ^ ^ _ ^ _ ^ ^ ^ _ ^ _ _ ^ _ ^ _ ^ ^ ^ _ ^	svayam udyatam evam uktāḥ paṃcakāḥ bhagavataḥ bodhim a saṃbhāvayantaḥ ūcuḥ sthite 
SA_XX_kukalpmu-783	v1 lagnahṛdayaḥ kathaṃ bhotsyase plavena mahatā na śakta iha yaḥ pratartun nadīṃ sa taṃ plavam apāsya parvataśi _ ^ _ _ ^ _ 18 ///	lagna hṛdayaḥ katham bhotsyase plavena mahatā na śaktaḥ iha yaḥ pratartum nadīm sa tam plavam apāsya 
SA_XX_kukalpmu-784	2 paṃcakā ity avetya antadvayavarjitāṃ madhyamāṃ pratipadam upadidikṣu .ai + + + + .. vekṣamāṇo 'bravīt _ _ _ _ ^ _ _ _ _ _ _ _ ^ _ ^ _ _ _	paṃcakāḥ iti avetya anta dvaya varjitām madhyamām pratipadam ai       vekṣamāṇaḥ bravīt 
SA_XX_kukalpmu-785	3 dhāraṇaṃ kāryaṃ jīvan hi jñānam ārcchati 19 prāyaś caivāśanādīnāṃ laṃbhā _ _ ^ tān vinā tasmād adhigama _ _ _ _ _ _ ^ _ ^ _ 20 _ _ _ _ ^ _	dhāraṇam kāryam jīvan hi jñānam ārcchati prāyas ca eva aśana ādīnām laṃbhā    tān vinā tasmāt 
SA_XX_kukalpmu-786	4 vaṃti śarīriṇām tathaiva bhinnaśīlānāṃ na bhavej jñānasaṃbhavaḥ 21 _ _ _ ṇāṃś. śīlaṃ _ _ _ .ā śīl. _ ^ _ _ _ _ _ ^ _ _ _ _ _ _ _ ^ _ ^ _ 22	śarīriṇām tathā eva bhinna śīlānām na bhavet jñāna saṃbhavaḥ 
SA_XX_kukalpmu-787	KalpM : IDP SHT 21/67	kalpm idp sht 
SA_XX_kukalpmu-788	185r1 _ _ _ _ ^ _ _ _ _ .ṇ. .ṛ .dh. c. s. ^ _ tya _ _ _ śatādīnāṃ mṛ. _ _ _ ^ eva ca 23 a _ _ _ ^ _ _ _ _ _ _ _ samāśritaḥ _ _ _ _ ^ _ _ _	di-2 r ṛ dh c s  tya    śata ādīnām mṛ      eva ca a ad ad 
SA_XX_kukalpmu-789	2 _ _ _ _ ^ _ ^ _ 24 parīkṣakānāṃ sa _ _ ubhayor ddoṣadarśanāt _ _ _ _ ^ _ _ _ _ _ _ _ ^ _ ^ yāḥ 25 kāmaṃ gedh. m. _ ^ _ ^ ^ ^ _ _ _	                             
SA_XX_kukalpmu-790	3 ^ _ _ ^ _ mārgasyāgninidāgha _ ^ ^ yutāv aṃtau prapanno ^ _ _ _ _ ^ ^ _ ^ _ ^ ^ ^ _ _ _ ^ _ _ ^ _ _ _ _ ^ ^	            
SA_XX_kukalpmu-791	4 _ ^ _ ^ ^ ^ _ _ _ ^ _ _ sthitaḥ 26 athāyuṣmataḥ kauṇḍinyasya jñānavadhya ///	              
SA_XX_kukalpmu-792	5 /// + na kṛto mokṣas ta ///	na kṛtaḥ mokṣaḥ 
SA_XX_kukalpmu-793	v1 /// + + cikitsak. // + .. cchaṃti tathā cittaci .. / ///	v    cikitsak   
SA_XX_kukalpmu-794	2 _ _ ^ _ ^ ^ ^ _ ^ mamadhyavāsaṃ cotsṛjya nā ^ ^ ^ roṣṇam ihopasevya _ _ ^ _ ^ ^ ^ _ ^ ^ _ ^ _ _ _ _ ^ _ ^ _ ^ ^ ^ _ ^ ^ _ ^ _ _ /// 3 ///	            
SA_XX_kukalpmu-795	pānaprāvaraṇāśanauṣadhavidhau śayyāsane cā ^ _ _ _ _ ^ ^ _ ^ _ ^ ^ ^ _ _ _ ^ _ _ ^ _ _ _ _ ^ ^ _ ^ _	pāna prāvaraṇa aśana auṣadha vidhau śayyā āsane 
SA_XX_kukalpmu-796	4 ^ ^ ^ _ _ _ ^ _ _ ^ _ prājño yuktivaśād ihāgni ^ ^ _ dāhakriyāṃ _ .i _ ///	            
SA_XX_kukalpmu-797	jñayābhivinītaś ca .. ///	jñayā abhivinītaḥ ca 
SA_XX_kukalpmu-798	5 /// .i + .. .. + bhagavaṃtam uvāca bhagavan na khalu + + + + ///	i    uvāca   na khalu 
SA_XX_kukalpmu-799	yad amārgo .. /	yat a mārgaḥ 
SA_XX_kukalpmu-800	+ iti kin tu /	iti kim tu 
SA_XX_kukalpmu-801	bhaga / /// /	bhaga 
SA_XX_kukalpmu-802	KalpM : IDP SHT 21/68	kalpm idp sht 
SA_XX_kukalpmu-803	187r1 /// .. sphātīkaraṇārthaṃ śiṣyāṇāṃ nānādeśaṃ preṣayati sma kimarthan nātmanā janapadacaryāṃ gacched iti /	sphātīkaraṇa artham śiṣyāṇām nānādeśam preṣayati sma kimartham na ātmanā janapada caryām gacchet iti 
SA_XX_kukalpmu-804	2 /// ti satvebhyo dharman deśayituṃ kim aṃga punaḥ svayan na deśayed ity ataḥ satvānugrahārthaṃ bhagavā	satvebhyaḥ dharman deśayitum kim aṃga punar svayam na deśayet iti atas satva anugraha artham bhagavān 
SA_XX_kukalpmu-805	3 /// + .. + .. myena phalan nānveṣṭavyaṃ /	      
SA_XX_kukalpmu-806	tadyathānuśrūyate kaścid alpaparicchadaḥ puruṣo dāridryābhi	tat yathā anuśrūyate kaścid alpa paricchadaḥ puruṣaḥ dāridrya abhi 
SA_XX_kukalpmu-807	4 /// + + + yāsyāmy ahaṃ bhagavaṃtaṃ devaṃ dāridryanāśāya prasā + + + + + + + + + + + + + +	             
SA_XX_kukalpmu-808	5 /// + + + vāraṇaṃ gatvā kṣetrāṇi darśayiṣyāmi / ye .. + + + + + + + + + + + + +	  gatvā     darśayiṣyāmi   
SA_XX_kukalpmu-809	v1 /// + + + .. kṣetrāṇi darśayitvā devakulaṃ praviśyopavāsam. .. + + + + + + + + + + + +	v     kṣetrāṇi darśayitvā devakulam praviśya upavāsam 
SA_XX_kukalpmu-810	2 /// + + + vaṃ dāsyāmīti /	dāsyāmi iti 
SA_XX_kukalpmu-811	upāyapūrvakaṃ punar evaṃ vārayi + + + + + + + + + + + + +	upāya pūrvakam punar evam 
SA_XX_kukalpmu-812	3 /// + + + + na ca puruṣeṇokto yadā tvaṃ mayā karmaṇi niyuktas tat kimartham āgato 'sīti + +	na ca puruṣeṇa uktaḥ yadā tvam mayā karmaṇi niyuktaḥ tat kimartham si iti 
SA_XX_kukalpmu-813	4 /// _ _ _ _ ^ _ _ _ _ _ _ _ ^ _ _ _ _ _ _ _ ^ dhānyāni tāny ayatnād bhaviṣyaṃti 1 tac ca vacanam upaśrutya sa puruṣaḥ paramakopakupitaru	dhānyāni tāni ayatnāt bhaviṣyanti tat ca vacanam upaśrutya saḥ puruṣaḥ parama kopa kupita ru 
SA_XX_kukalpmu-814	5 /// _ _ _ _ _ _ _ _ _ _ ^ _ ^ _ nāyām yad bījam aprakīrya kṣetrāt samavāpyate dhānyam 2 tataḥ sā tasya bhrātṛrūpa	                                            
SA_XX_kukalpmu-815	KalpM : IDP SHT 21/69	kalpm idp sht 
SA_XX_kukalpmu-816	188r1 /// .. suniścito bhavān yad bījābhāvāt phalābhāva iti /	             
SA_XX_kukalpmu-817	sa uvāca bāḍhaṃ suniścito 'smīti tataḥ sā devatā svarūpaṃ + + .. + uvāca / /	saḥ uvāca bāḍham su niścitaḥ smi iti tatas sā devatā sva rūpam          
SA_XX_kukalpmu-818	yadi svayam imaṃ	yadi svayam imam 
SA_XX_kukalpmu-819	2 _ _ _ _ _ _ ^ _ ^ yam ātmānam upavāsena kliśnāsi tvam apārthakam 3 yathā bījād ṛte nāsti dhānyānāṃ phalasaṃbhavaḥ karmabījād ṛte tadvan naivāsti	                                                                                                    
SA_XX_kukalpmu-820	3 vaḥ 4 _ _ _ _ kaḷatrāṇāṃ yadi vistaram icchasi kāyavākkṣetrayoḥ śuddhaṃ karmabījaṃ prakīryatām 5 śrīvṛddhī śaknuyuḥ kartuṃ devāḥ karma vinā yadi /	vaḥ      kaḷatrāṇām yadi vistaram icchasi kāya vāc kṣetrayoḥ śuddham karma bījam prakīryatām  śrī vṛddhī śaknuyuḥ kartum devāḥ karma vinā yadi 
SA_XX_kukalpmu-821	4 _ _ _ _ ^ _ _ _ m aviśiṣṭā bhavet prabhā 6 _ _ _ _ ^ _ _ _ _ _ _ _ śarīriṇām tasmāt karmātmakaḥ _ _ _ _ _ _ ^ _ ^ _ 7	ad-ad-aviśiṣṭā bhavet prabhā             śarīriṇām tasmāt karma ātmakaḥ 
SA_XX_kukalpmu-822	5 _ _ _ ^ ^ _ ^ _ ^ ^ ^ _ śīlāt surendrālayaṃ śī _ _ ^ ^ _ ^ _ ^ ^ ^ _ _ _ ^ .ān mucyate _ _ _ ^ ^ _ ^ _ ^ ^ ^ _ _ _ ^ _ _ ^ _ _ _	                                     
SA_XX_kukalpmu-823	v1 _ ^ ^ _ ^ _ ^ ^ sadā kiṃ māṃ vṛthā bādhase 8 + + + + + + + + + + + + + + + + labhya iti .. + + + + + + + + + + + + + + + + + + + + +	di di kim mām vṛthak bādhase  /                     
SA_XX_kukalpmu-824	2 /// + bhikṣuḥ praviṣṭaḥ sa ca dānapatiḥ + + + + + + + + + + + + + + + + .. tvā rocanābindum akārṣīd āda .. + + + + kh. + + y. + + + +	bhikṣuḥ praviṣṭaḥ sa ca dānapatiḥ                tvā rocanābindum akārṣīt 
SA_XX_kukalpmu-825	3 /// dānapatin tathā kautukamaṃgala .. + + + .. m avekṣyovāca /	dānapate tathā kautukamaṃgala       m avekṣya uvāca 
SA_XX_kukalpmu-826	dānapate kim idaṃ kriyata iti /	dānapate kim idam kriyate iti 
SA_XX_kukalpmu-827	dānapatir uvāca bhadaṃta maṅgalāni kriyaṃta i	dānapatiḥ uvāca bhadaṃta maṅgalāni kriyaṃte i 
SA_XX_kukalpmu-828	4 ti /// tra guṇa iti /	ti guṇaḥ iti 
SA_XX_kukalpmu-829	dānapatir āha /	dānapatiḥ āha 
SA_XX_kukalpmu-830	mahā + + + paśya bhadaṃta / /	mahā paśya bhadaṃta 
SA_XX_kukalpmu-831	vadhabandhanatāḍanajaṃ yad abhimukhībhavati dehināṃ vyasanam kṛtamaṃgalasya	vadha bandhana tāḍana jam yat abhimukhībhavati dehinām vyasanam kṛta maṃgalasya 
SA_XX_kukalpmu-832	5 _ _ _ _ _ _ ^ m upayāti 1 tataḥ sa bhikṣur īṣat smitaṃ kṛtvovāca /	upayāti  tatas sa bhikṣuḥ īṣat smitam kṛtvā uvāca 
SA_XX_kukalpmu-833	yady etad balaṃ maṃgalānāṃ sādhu tāvad ucyatāṃ kutaḥ khalv imāni maṃgalāny utpadyaṃta iti /	yadi etat balam maṃgalānām sādhu tāvat ucyatām kutas khalu imāni maṃgalāni utpadyaṃte iti 
SA_XX_kukalpmu-834	KalpM : IDP SHT 21/70	kalpm idp sht 
SA_XX_kukalpmu-835	192r1 .. tamadṛṣṭa + + + + .. tīty avetyārya + ///	tam adṛṣṭaiḥ avetya āryaiḥ 
SA_XX_kukalpmu-836	+ + + + + + + + + + .. yāṃ dṛṣṭi //	    
SA_XX_kukalpmu-837	+ ṣu ca sūtreṣūpaneya / ///	ṣu ca sūtreṣu upaneya 
SA_XX_kukalpmu-838	2 yuktāny a .e + + + // saṃgrahaḥ //	yuktāni a e      saṃgrahaḥ 
SA_XX_kukalpmu-839	kalaha ^ _ _ _ _ _ _ _ _ sugandhitā śakraḥ vyāghrabh. .. _ _ _ _ ^ daridro 'tha maṃgalikaḥ + /// ity ā	śakraḥ maṃgalikaḥ 
SA_XX_kukalpmu-840	3 ryakaumāralātāyāṃ kalpanālaṅkṛtikāyāṃ ///	kalpanālaṅkṛtikāyām 
SA_XX_kukalpmu-841	ṣaṣṭhī daśatī samāptā 6 // // .. // + + + + + + + + + / ///	ṣaṣṭhī daśatī samāptā 
SA_XX_kukalpmu-842	4 .. m ity avagamo bhavati prāg eva .. + + + + ///	  iti   bhavati   eva 
SA_XX_kukalpmu-843	.. pasaṃkramaṇaṃ mudā .. .. .i + + + + // + + + + + + + + + / ///	    
SA_XX_kukalpmu-844	5 + + + .. + + + + .. + + + + + + + /// bhagavantaṃ bhikṣ. ..ṃ + + + + + + + // + + + + + + + + + / ///	ro-0 fl-1 fl-2 
SA_XX_kukalpmu-845	v1 + + .. saha saṃsṛjyamānāḥ śrut. + + + + ///	v saha saṃsṛjyamānāḥ śrut 
SA_XX_kukalpmu-846	ṣu prakṛṣṭaśaktir .. + + + + + + + + + // + + + + + + + + + / ///	     
SA_XX_kukalpmu-847	2 sthānānāṃ nāmābhijñāḥ saṃvṛttāḥ a + + ///	sthānānām nāma abhijñāḥ saṃvṛttāḥ 
SA_XX_kukalpmu-848	+ + tyayena nirvṛttāyāṃ pravāraṇāyāṃ + + // + + + + + + + + + / ///	tyayena nirvṛttāyām pravāraṇāyām 
SA_XX_kukalpmu-849	3 gacchantu + .. + + + + sarvajñaṃ bhagavanta + ///	gacchantu      sarvajñam 
SA_XX_kukalpmu-850	+ + + .eti /	 eti 
SA_XX_kukalpmu-851	tatas teṣāṃ gopālakānāṃ // + .. + .. + + + + + / ///	tatas teṣām gopālakānām 
SA_XX_kukalpmu-852	4 t sarvajñaḥ .. + + + .. tram etat sarvajña .. ///	sarvajñaḥ      etat sarvajña 
SA_XX_kukalpmu-853	+ + + + + + + + sāḥ ārāma + + //	div 
SA_XX_kukalpmu-854	prabhābhiś ca vyāptam. / ///	prabhābhiḥ ca vyāptam 
SA_XX_kukalpmu-855	5 + + + + + + + + + + bhagavantam. + ///	ro-0 
SA_XX_kukalpmu-856	+ + + + + + + + .iṣiktavi .. //	ro-0 
SA_XX_kukalpmu-857	vṛddhabṛha .. + r.i .. / ///	vṛddha bṛha ri  
SA_XX_kukalpmu-858	KalpM : IDP SHT 21/71	kalpm idp sht 
SA_XX_kukalpmu-859	193r1 /// kanakacūrṇarāśim ivārāmamadhyotkīrṇam avekṣya vismay. //	kanaka cūrṇa rāśim iva ārāma madhya utkīrṇam avekṣya vismayaḥ 
SA_XX_kukalpmu-860	.. manasaḥ parasparam abhivīkṣamāṇāḥ / ///	manasaḥ parasparam abhivīkṣamāṇāḥ 
SA_XX_kukalpmu-861	2 /// .. kṣyate / / /	ro 
SA_XX_kukalpmu-862	kin nandanāt kanakavṛkṣa ihopanīto _ _ ^ _ ^ ^ l. āt patitaḥ pṛthivyām _ _ ^ ^ ^ _ ^ ^ _ ^ _ _	kim nandanāt kanaka vṛkṣaḥ iha upanītaḥ        patitaḥ pṛthivyām 
SA_XX_kukalpmu-863	3 _ _ ^ _ ^ ^ ^ _ ^ śaśī nilīnaḥ 1 sarpirniṣekabhṛśadīpta ^ _ ^ _ _ _ _ ^ _ ^ ^ ^ m ujjval. _ ^ _ _ _ _ ^ _ ^ ^ ^ _ ^ ^ _	                
SA_XX_kukalpmu-864	v3 /// vṛttam 6 bahuvistaraṃ kim uktvā samāsato hy a ^ ^ _ ^ _ _ _ _ _ śasaś ca rū _ _ _ _ _ ^ _ _ _ 7	vṛttam bahu vistaram kim uktvā samāsatas hi a ad ca 
SA_XX_kukalpmu-865	4 _ _ _ _ _ _ _ _ sas tejasā pradīptam iva pariveṣṭitam iva _ _ _ _ .y. nānuliptam iva 8 vyā _ _ _ _ _ _ _ _ _	                   
SA_XX_kukalpmu-866	5 ^ _ ^ _ _ _ _ _ _ grasatīva sthambhayatīvekṣaṇāni nṛṇām 9 yadi saṃbhavo 'sti _ _ sarvajñā _ ^ _ ^ _ _ _ _ _	                      
SA_XX_kukalpmu-867	KalpM : IDP SHT 21/72	kalpm idp sht 
SA_XX_kukalpmu-868	196r1 .. n. + + + + + /// teṣāṃ bhagavān uvāca /	        
SA_XX_kukalpmu-869	ekādaśabhir aṅgaiḥ samanvāgato māgadhako gopālakaḥ abhavyo gāḥ sphātīkartum abhavyo mahāṃtaṃ + + + + samya	ekādaśabhiḥ aṅgaiḥ samanvāgataḥ māgadhakaḥ gopālakaḥ abhavyaḥ gāḥ sphātīkartum abhavyaḥ mahāntam 
SA_XX_kukalpmu-870	2 k sukhena parihartu // /	k sukhena parihartu 
SA_XX_kukalpmu-871	+ + + + + r aṃgaiḥ iha gopālako rūpan na jānāti /	R aṅgaiḥ iha gopālakaḥ na jānāti 
SA_XX_kukalpmu-872	lakṣaṇan na jānāty āśātikā na śātayati /	lakṣaṇat na jānāti āśātikā na śātayati 
SA_XX_kukalpmu-873	vraṇaṃ na praticchādayati dhūmaṃ	vraṇam na praticchādayati dhūmam 
SA_XX_kukalpmu-874	3 na kartā bhavati /	na kartā bhavati 
SA_XX_kukalpmu-875	vīthiṃ na jānāti pīthaṃ na jānāti tīrthan na jānāti /	vīthim na jānāti pītham na jānāti tīrthat na jānāti 
SA_XX_kukalpmu-876	gocaraṃ na jānāti /	gocaram na jānāti 
SA_XX_kukalpmu-877	niravaśeṣadohī bhavati ye ca te ṛṣabhā gavāṃ .. +	niravaśeṣa dohī bhavati ye ca te ṛṣabhāḥ gavām 
SA_XX_kukalpmu-878	4 s tān na kāle .. + // /	tān na kāle 
SA_XX_kukalpmu-879	+ + + na parihartā bhavati /	na parihartā bhavati 
SA_XX_kukalpmu-880	atha teṣāṃ gopālakānām abhavad ye 'smākaṃ vṛddhatarakā gopālakās te 'py etāny ekādaśāṃgāni	atha teṣām gopālakānām abhavat ye smākam vṛddhatarakāḥ gopālakāḥ te pi etāni ekādaśa aṃgāni 
SA_XX_kukalpmu-881	5 jānaṃti .i + + + /// kaścid asmākam aṃgatrayaṃ jānāti kaścid aṃgapaṃcakam eṣa tu bhagavān gopālakajñānasya pāra + + + sarvajña evā	jānanti i kaścid asmākam aṃga trayam jānāti kaścid aṃga paṃcakam eṣa tu bhagavān gopālaka jñānasya sarvajñaḥ 
SA_XX_kukalpmu-882	v1 yam ity avetya + + + // /	u yam iti avetya  /
SA_XX_kukalpmu-883	+ + bhagavatā ca dhārmyā kathayā saṃharṣitāḥ śreyasā ca saṃyuktā iti /	bhagavatā ca dhārmyā kathayā saṃharṣitāḥ śreyasā ca saṃyuktāḥ iti 
SA_XX_kukalpmu-884	kim idam upanītam evaṃ bhagavato 'bhigamanaṃ gopā	kim idam upanītam evam bhagavataḥ bhigamanam gopā 
SA_XX_kukalpmu-885	2 lakānām apy u + + + ///	lakānām api u 
SA_XX_kukalpmu-886	kiṃ punar vvipakvabuddhīnām iti /	kim punar vvipakva buddhīnām iti 
SA_XX_kukalpmu-887	tasmān medhāvino bhagavaṃtam upasaṃkramaṃtīti / // / /	tasmāt medhāvinaḥ bhagavaṃtam upasaṃkramaṃti iti 
SA_XX_kukalpmu-888	lābhasatkāram anādṛtya pratipatti + +	lābha satkāram an ādṛtya 
SA_XX_kukalpmu-889	3 nurudhyante mahātmānaḥ tadyathā pūrṇikodāharaṇam udāharaṃti /	anurudhyante mahātmānaḥ tat yathā pūrṇikā udāharaṇam udāharaṃti 
SA_XX_kukalpmu-890	bhagavāñ śrāvastyāṃ yathābhipretam uṣitvā prakramitukāmo 'nāthapiṇḍadena vijñāpito + + +	bhagavān śrāvastyām yathā abhipretam uṣitvā prakramitu kāmaḥ nāthapiṇḍadena vijñāpitaḥ 
SA_XX_kukalpmu-891	4 bhagavān vasatv iti // /	bhagavān vasatu iti 
SA_XX_kukalpmu-892	+ .i .. vatsyāmīty atha mṛgāramātṛpramukhābhir anyābhiś copāsikābhir ṛṣidattapuraskṛtaiś cāmātyaiḥ kāle + + + + + + +	i vatsyāmi iti atha mṛgāra mātṛ pramukhābhiḥ anyābhiḥ ca upāsikābhiḥ ṛṣidatta puraskṛtaiḥ ca amātyaiḥ kāle 
SA_XX_kukalpmu-893	5 .. + + + + + + /// .. vijñāpito bhagavann ihaiva / / /	       vijñāpitaḥ bhagavan iha eva 
SA_XX_kukalpmu-894	+ + + + + + + + m iti /	ro-0 iti 
SA_XX_kukalpmu-895	na ca pratijānāti sma vatsyāmīti /	na ca pratijānāti sma vatsyāmi iti 
SA_XX_kukalpmu-896	tato buddhavinirbandhena nirāśo 'nāthapiṇḍadaḥ + + + +	tatas buddha vinirbandhena nirāśaḥ nāthapiṇḍadaḥ 
SA_XX_kukalpmu-897	KalpM : IDP SHT 21/73	kalpm idp sht 
SA_XX_kukalpmu-898	201r1 nn udvigno mahāmukhyo /// + + + + + + .. + + ///	udvignaḥ 
SA_XX_kukalpmu-899	2 krauṃcena gīrṇo na ca ///	krauṃcena gīrṇaḥ na ca 
SA_XX_kukalpmu-900	.. paraprāṇārtham aślāghya ///	para prāṇa artham a ślāghya 
SA_XX_kukalpmu-901	3 na + + + th. .u .. + /// + + .. taḥ 1 kaści ^ _ _ ^ ^ _ ^ _ _ _ _ ^ _ _ ^ ^ _ ^ _ syāt svaprāṇaheto ^ ^ _ ^ _ _ _ _	ad di di taḥ                                     
SA_XX_kukalpmu-902	4 .i _ na tv ṛṣir evam ā _ 2 _ _ ^ _ _ ^ ^ _ prasahya cchinda ^ _ _ ^ ^ _ ^ _ _ _ _ ^ _ _ ^ ^ _ ^ _ _ _ _ ^ _ _ ^ ^ _ ^ _ _ 3 vāṅ nāk. _ ^ ^	i na tu ṛṣiḥ evam ā adhi adhi prasahya chinda 
SA_XX_kukalpmu-903	5 tāṃ ca vāca _ _ ^ _ ^ ^ ^ _ ^ ^ _ ^ lapsye tāj jīvi _ ^ ^ ^ _ ^ ^ _ ^ _ _ _ _ ^ _ ^ ^ ^ _ ^ ^ _ ^ _ mi 4 _ _ ^ _ ^ ^ ^ _	tām ca vāca 
SA_XX_kukalpmu-904	v1 varam ūrjitena v. dh. ^ _ ^ ^ ^ _ ^ ^ _ ^ ṇaṃ me dhikchabda _ ^ ^ ^ _ ^ ^ _ ^ _ _ _ _ ^ _ ^ ^ ^ _ ^ ^ _ ^ _ _ 5 tasmā ///	varam ūrjitena me 
SA_XX_kukalpmu-905	2 va + + ā .. .. .. + /// + + krauñco yathā ^ ^ ^ _ ^ ^ _ ^ _ _ _ _ ^ _ ^ ^ ^ _ ^ ^ _ ^ toyam yatnāt tathā kuśala _ ^ ^ _ ^ _ _	                                             
SA_XX_kukalpmu-906	3 pāsyāmi dharmam ṛṣi _ ^ ^ _ ^ _ _ 6 ///	pāsyāmi dharmam ṛṣe 
SA_XX_kukalpmu-907	krauñcaḥ kṣīragataṃ va nimnaga ///	krauñcaḥ kṣīra gatam vai nimnaga 
SA_XX_kukalpmu-908	4 .. sukhī bhavatu pa /// + + + + + + + + + ///	  bhavatu 
SA_XX_kukalpmu-909	KalpM : IDP SHT 21/74	kalpm idp sht 
SA_XX_kukalpmu-910	204r1 nanu v. r. kṣ. y. _ pariśuddhaśīlānām 20 yady api jīvitanāś. _ _ _ _ ^ _ ^ _ nāṃ ca prajñ. _ _ _ _ _ _ _ _ ^ _ _ _ 21 ///	pariśuddha śīlānām yadi api ca 
SA_XX_kukalpmu-911	2 maṇikāram āha /	maṇikāram āha 
SA_XX_kukalpmu-912	alam alam atinirdayaṃ mām upakrāmasy atha .. ///	alam alam ati nirdayam mām upakrāmasi atha 
SA_XX_kukalpmu-913	+ .. ṇ.ḥ prāha / /	prāha 
SA_XX_kukalpmu-914	_ _ _ _ ^ _ ^ titīvraduḥkh. _ _ _ _ ^ _ ^	ro-0 
SA_XX_kukalpmu-915	3 m upaiti bhūyaḥ svārtho māṃ karkaśīkurute ^ _ _ _ _ _ _ ^ _ ^ ^ _ ^ _ _ 22 _ _ _ _ ^ maṃ caiva karmaṇā _ ^ _ ^ dṛḍhīkartuṃ tvaṃ nārhasi _ _ _ _ ^ _ ^ _ 23 bhi	upaiti bhūyas sva arthaḥ mām karkaśīkurute                     mam ca eva karmaṇā     dṛḍhīkartum tvam na arhasi               
SA_XX_kukalpmu-916	4 kṣur īṣat smitaṃ kṛtvovāca + asti mama lobho na ///	kṣuḥ īṣat smitam kṛtvā uvāca asti mama lobhaḥ na 
SA_XX_kukalpmu-917	+ .. paśyatu bhadramukhaḥ / /	paśyatu bhadra mukhaḥ 
SA_XX_kukalpmu-918	lobho 'sti me yaśasi sādhujanapraśaste _ _ ^ _ ^ ^	lobhaḥ u sti me yaśasi sādhu jana praśaste 
SA_XX_kukalpmu-919	5 ^ _ ^ ^ _ ^ _ _ _ _ ^ _ ^ ^ ^ _ ^ ^ _ ^ _ _ _ _ ^ _ ^ mama somya maṇau tvadīye 24 bhikṣāvṛttiḥ pāṃsukūlaṃ ca vastraṃ _ _ _ _ _ ^ _ _	mama somya maṇau tvadīye bhikṣā vṛttiḥ pāṃsukūlam ca vastram 
SA_XX_kukalpmu-920	v1 ^ _ _ _ _ _ _ _ ^ _ _ ^ _ _ _ _ _ _ _ ^ _ _ ^ _ _ 25 /// sa maṇikāro 'rthavaśād dharmam a .. //	sa maṇikāraḥ rtha vaśāt dharmam 
SA_XX_kukalpmu-921	.. māno na nirarthakena vyāpāreṇa / ///	mānaḥ na nirarthakena vyāpāreṇa 
SA_XX_kukalpmu-922	2 ca bhikṣor atyākraṃtasya locanābhyāṃ śrotrābhyāṃ nāsikābhyāṃ ca śoṇitam āgatam /	ca bhikṣoḥ atyākraṃtasya locanābhyām śrotrābhyām nāsikābhyām ca śoṇitam āgatam 
SA_XX_kukalpmu-923	sa ca krauñcaḥ śoṇitam a // /	sa ca krauñcaḥ śoṇitam a 
SA_XX_kukalpmu-924	+ satvaraḥ samupasṛptas tena ca maṇikāreṇa da	sa tvaraḥ samupasṛptaḥ tena ca maṇikāreṇa da 
SA_XX_kukalpmu-925	3 ṇḍenāhatya prāṇair vviyojitaḥ tataḥ sa + + + + ///	ṇḍena āhatya prāṇaiḥ viyojitaḥ tatas sa 
SA_XX_kukalpmu-926	bhadramukha jñāyatāṃ + //	bhadra mukha jñāyatām 
SA_XX_kukalpmu-927	+ + eṣa krauñco jīvatīti /	eṣa krauñcaḥ jīvati iti 
SA_XX_kukalpmu-928	sa prāha / ///	sa prāha 
SA_XX_kukalpmu-929	4 sa prāha etan tāvan mama vyāpāraṃ kuruṣveti /	sa prāha etat tāvat mama vyāpāram kuruṣva iti 
SA_XX_kukalpmu-930	tena parīkṣyoktaṃ ///	tena parīkṣya uktam 
SA_XX_kukalpmu-931	+ + + atha sa bhikṣu // /	rocate 
SA_XX_kukalpmu-932	+ + + + + + plutya sasaṃbhrama /	     plutya sa sambhramaiḥ 
SA_XX_kukalpmu-933	// ta	ta 
SA_XX_kukalpmu-934	5 sya krauñcasyāntikam upetyodgataprāṇo 'yam iti cājñāya .. ///	sya krauñcasya antikam upetya udgata prāṇaḥ yam iti ca ājñāya 
SA_XX_kukalpmu-935	+ + + + hā kaṣṭaṃ .. // + + + + + + .. .. + + + + + + / ///	ro-0 
SA_XX_kukalpmu-936	KalpM : IDP SHT 21/75	kalpm idp sht 
SA_XX_kukalpmu-937	205r2 sa maṇikāraḥ prāha bha + + + + + + + + + + /// + + + + .. + + .. + + ///	sa maṇikāraḥ prāha 
SA_XX_kukalpmu-938	3 maṇikāraḥ prāha / + + + + + + + + + // /	maṇikāraḥ prāha 
SA_XX_kukalpmu-939	.. kapotam uddiśya mahā ^ _ ^ _	kapotam uddiśya 
SA_XX_kukalpmu-940	4 kaḍebaraṃ tyaktam iti śrutaṃ mayā ^ _ ^ _ _ ^ ^ _ ^ _ ^ _ ^ _ ^ _ _ ^ ^ _ ^ _ ^ _ .. ^ _ ^ _ _ ^ ^ _ ^ mas tvayā vipādita _ ^	kaḍebaram tyaktam iti śrutam mayā tvayā vipādita 
SA_XX_kukalpmu-941	5 m imaṃ vihiṃsatā kathaṃ nv ihātmānam avekṣya vaṃ ^ _ ^ _ ^ _ _ ^ ^ _ ^ _ ^ _ ///	imam vihiṃsatā katham nu iha ātmānam avekṣya 
SA_XX_kukalpmu-942	v1 .. .. bhikṣur āha .. .r. .. .. + + patām idānīm a /// + + + + .. + + + + /	          
SA_XX_kukalpmu-943	// _ _ _ saṃka	ro-0
SA_XX_kukalpmu-944	2 ṭaṃ prāpya mayā śikṣānurakṣiṇā tathāpi pīḍyamā _ _ _ _ _ _ ^ _ ^ _ .. _ _ ^ _ ^ ^ ^ _ ^ ^ _ ^ _ _ _ _ ^ _ ^ ^ ^ _ ^ dayām akārṣīt taṃ _ ^	prāpya mayā śikṣā anurakṣiṇā tathā api dayām akārṣīt tam 
SA_XX_kukalpmu-945	3 gurum iha vyavadiśya _ _ _ _ ^ _ ^ ^ ^ _ ^ ^ _ ^ _ _ ///	gurum iha 
SA_XX_kukalpmu-946	upalabhya saṃvegam aga + ///	upalabhya saṃvegam aga 
SA_XX_kukalpmu-947	4 haṃ maṃdabhāgyo yo + + + + + + + + + + ///	haṃ maṃdabhāgyaḥ 
SA_XX_kukalpmu-948	5 .. r.ā .i .. .. .. + + + + + + + + + + + + ///	ro-0 
SA_XX_kukalpmu-949	KalpM : IDP SHT 21/76	kalpm idp sht 
SA_XX_kukalpmu-950	206r1 /// + nā dagdhas tan muhūrtaṃ tāvat tiṣṭha pṛthivyāṃ hy avaskhalitaḥ pṛthivīm evālambyottiṣṭhatīti /	nā dagdhaḥ tat muhūrtam tāvat tiṣṭha pṛthivyām hi avaskhalitaḥ pṛthivīm eva ālambya uttiṣṭhati iti 
SA_XX_kukalpmu-951	bh. /	bh 
SA_XX_kukalpmu-952	// + .. y. .. +	R y 
SA_XX_kukalpmu-953	2 /// namas te śubhacāritra namas te dṛḍhaniścayaḥ īdṛśaṃ saṃkaṭaṃ prāpya yas tvan naiva pa .i ^ _ 34 svastho ^	namaḥ te śubha cāritra namaḥ te dṛḍha niścayaḥ īdṛśam saṃkaṭam prāpya yaḥ tvat na eva 
SA_XX_kukalpmu-954	3 _ ^ ^ ^ _ ^ ^ _ ^ _ _ _ _ ^ _ ^ ^ . avismayanīyakarmā prāpyāpadaṃ bhavati yas tv avikaṃpyaśīlas tasmiṃs .i _ ^ ^ ^ vismayam eti	                                eti 
SA_XX_kukalpmu-955	4 _ _ 35 /// + + + + .. tavān iti / // //	ro-0 iti 
SA_XX_kukalpmu-956	paramakṛcchrādhigato 'yaṃ bhagavatā dharma i + + + + / / /	parama kṛcchra adhigataḥ yam bhagavatā dharmaḥ 
SA_XX_kukalpmu-957	vyas tadyathā	vyaḥ tat yathā 
SA_XX_kukalpmu-958	5 /// + + + + .i .ir anyatīrthyācāryair asarvajñaiḥ sarvajñapratijñair asakṛd an. + + + + / / /	anya tīrthya ācāryaiḥ asarvajñaiḥ sarvajña pratijñaiḥ asakṛt 
SA_XX_kukalpmu-959	nāsti samyaksaṃ	na asti samyak sam 
SA_XX_kukalpmu-960	v1 /// + + + aparyavasitasaṃkalpo vaicikitsī kathaṃkathī acarad dīrgham adhvānam _ _ _ _ tathāgatam 1 śramaṇ.	v    a paryavasita saṃkalpaḥ vaicikitsī kathaṃkathī acarat dīrgham adhvānam        tathāgatam śramaṇa 
SA_XX_kukalpmu-961	2 _ ^ _ _ _ _ _ _ _ ^ _ ^ _ _ _ _ _ ^ _ _ _ _ _ maṃ paryupāsitum iti vistaraḥ 2 atha śakrasya devendrasya viśvakarmaṇ. + + // /	                                                                             
SA_XX_kukalpmu-962	devendra viṣāda	deva indra viṣāda 
SA_XX_kukalpmu-963	3 /// + + + + + .. paramaduṣkarāṇi karmāṇi karoti yathā cainam anumānato 'numinvaṃti vi + + / / /	      karoti yathā ca enam           
SA_XX_kukalpmu-964	m asau samyaksaṃ	asau samyak sam 
SA_XX_kukalpmu-965	4 /// + + lavyavasāyaḥ syāt kutaḥ / /	ro la vyavasāyaḥ syāt kutas 
SA_XX_kukalpmu-966	matsyāṇḍāny amrapuṣpāṇi bodhisatvāni cānagha ba _ _ _ ^ naśyaṃti .i _	matsya aṇḍāni amra puṣpāṇi bodhisatvāni ca anagha 
SA_XX_kukalpmu-967	5 _ _ ^ _ ^ _ 1 _ _ _ _ ^ _ _ _ _ _ _ .nāvasīdati bodhisatva iti jñeyaḥ sthirasatvaḥ sa tādṛśaḥ 2 tad āgaccha gamiṣyāva /// + camave +	                                                                   
SA_XX_kukalpmu-968	KalpM : IDP SHT 21/77	kalpm idp sht 
SA_XX_kukalpmu-969	208r1 taṃ pārāvatam āśvāsay. + ///	tam pārāvatam āśvāsay 
SA_XX_kukalpmu-970	2 nāṃ samuddiśya vay. + + ///	nām samuddiśya vay  /
SA_XX_kukalpmu-971	3 mucyatām eṣa pārāvataḥ ///	mucyatām eṣa pārāvataḥ 
SA_XX_kukalpmu-972	v3 tat kim iha prāptakāl. ///	tat kim iha prāptakāl 
SA_XX_kukalpmu-973	4 atha bodhisatvaḥ śye + ///	atha bodhisatvaḥ śye 
SA_XX_kukalpmu-974	5 sa mamātulayitvā ///	sa mama atulayitvā 
SA_XX_kukalpmu-975	KalpM : IDP SHT 21/78	kalpm idp sht 
SA_XX_kukalpmu-976	212r1 /// yatām asya mahātmanaḥ sarvasatveṣv adhyā + + + + + + + + + + + + + + + + + + + + + + + + + + + + + +	        
SA_XX_kukalpmu-977	2 /// m. .i .. .e .. vyavasāyavaipulyārthaṃ .r. + .. + .. + .th. .. .. .. .. .r. + .. t. .y. + .. + .. .. m. .. m. n. yathā paurāṇa	vyavasāya vaipulya artham r ad ad                                    n yathā paurāṇa 
SA_XX_kukalpmu-978	3 /// bodhisatvam u .e // /	bodhisatvam 
SA_XX_kukalpmu-979	+ + + + + + + + + + ..ḥ pārthiva kapotārtham ātmānaṃ parityajato na te śoko 'bhūd iti /	pārthiva kapota artham ātmānam parityajataḥ na te śokaḥ bhūt iti 
SA_XX_kukalpmu-980	bodhisatvaḥ prāha /	bodhisatvaḥ prāha 
SA_XX_kukalpmu-981	// kāṣṭha	kāṣṭha 
SA_XX_kukalpmu-982	4 _ _ ^ _ _ _ _ _ _ _ ^ _ ^ _ _ _ _ vā hutā _ _ _ _ _ _ ^ _ ^ ti 22 tad gātraṃ prāpya yady asti pareṣāṃ hitam aṇv api kas tatra ma .i _ _ _	                                    
SA_XX_kukalpmu-983	5 _ _ _ _ ^ _ ^ _ ikṣukṣodavad ujjhito bhuvi yadā kāyo mama svapsyati pratyutthānanamaskriyāñjalipuṭaśleṣakriyāsv akṣamaḥ kāyenāha	                                                                                                                                                                                                                                                                                                                                                                                                                                                                                                                               
SA_XX_kukalpmu-984	v1 m anena kiṃ nu kuśalaṃ śakṣyāmi kartuṃ tadā tasmān nyāyyam itaḥ śmaśānanidhanāt sāraṅ grahītuṃ mayā 23 kṛtvā kuñcanasaṃprasāraṇagatapravyāhṛtaprekṣitaṃ	anena kim nu kuśalam śakṣyāmi kartum tadā tasmāt nyāyyam itas śmaśāna nidhanāt sāraṅ grahītum mayā kṛtvā kuñcana saṃprasāraṇa gata pravyāhṛta prekṣitam 
SA_XX_kukalpmu-985	2 _ ^ ^ _ ^ _ ^ ^ ^ _ _ _ ^ _ ceṣṭitam kāyo 'yaṃ h. ^ _ ^ _ ^ ^ ^ _ _ _ ṭanājarjaro dhārāklinnaviśīrṇapustaracanābiṃbākṛtiḥ svapsyati 24	                                
SA_XX_kukalpmu-986	3 /// .. ty atyadbhutaṃ + / / /	ro atyadbhutam 
SA_XX_kukalpmu-987	+ + + + + + + + + .. .. + + + ti /	ro-0 ns-  /
SA_XX_kukalpmu-988	bodhisatvaḥ prāha /	bodhisatvaḥ prāha 
SA_XX_kukalpmu-989	nanv aham eva tāvad avagacchāmy anye ca paracittavido maharṣayaḥ	nanu aham eva tāvat avagacchāmi anye ca para citta vidaḥ mahā ṛṣayaḥ 
SA_XX_kukalpmu-990	4 /// .. tāvad abhidhātuṃ /	tāvat abhidhātum 
SA_XX_kukalpmu-991	yena satyenātmānaṃ pa .. + + + + + + + + + + + + + + + + + + + + + + + + + + + +	yena satyena ātmānam 
SA_XX_kukalpmu-992	5 /// jarjaramāṃsam avekṣamāṇaḥ prāha /	jarjara māṃsam avekṣamāṇaḥ prāha 
SA_XX_kukalpmu-993	// ye + + + + + + + + + + + + + + + + + + + + + + + + + + + +	ro-0
SA_XX_kukalpmu-994	KalpM : IDP SHT 21/79	kalpm idp sht 
SA_XX_kukalpmu-995	213r1 /// + + + + + dhikuryāñ jaga .. / / /	dhikuryām jaga 
SA_XX_kukalpmu-996	+ + + + + + + + + + v. yathā paurāṇaśarī	yathā paurāṇaśarī 
SA_XX_kukalpmu-997	2 /// _ _ ^ _ _ ^ ^ _ ^ .. bhūr bhīteva _ _ ^ ^ _ cakampe khāt puṣpavarṣaṃ nipapāta divyam uccaiś ca vāditra	                                      
SA_XX_kukalpmu-998	3 ^ _ ^ _ _ 28 _ _ ^ _ _ ^ ^ _ ^ _ _ _ _ ^ _ _ paṭahapraṇādaiḥ dī _ ^ _ _ ^ ^ _ nninādair loko babhūva kṣubhitārṇavābhaḥ 29 _	                             
SA_XX_kukalpmu-999	4 _ ^ _ _ ^ ^ _ ^ _ _ _ _ ^ _ _ ^ ^ _ ^ _ _ _ _ ^ caṃ cārtavam eva c. _ _ _ ^ _ _ ^ ^ _ sya sādhoḥ 30 vṛkṣāṃtarebhyo vanadevatābhiḥ _ _	                                 
SA_XX_kukalpmu-1000	5 ^ _ _ ^ ^ _ ^ _ _ _ _ ^ _ _ ^ ^ _ ^ _ _ _ _ ^ _ _ ^ ^ _ ^ _ _ 31 _ _ ^ rāgāṇi ca hemabinduvidyoti _ _ ^ ^ _	rāgāṇi ca 
SA_XX_kukalpmu-1001	v1 ^ _ _ _ _ ^ _ _ ^ ^ _ ^ _ _ _ _ ^ _ _ ^ ^ _ ^ _ _ 32 _ _ ^ _ _ ^ ^ _ ^ _ _ _ _ ^ _ _ ś ca bhṛśaṃ praseduḥ śivāś ca vātāḥ pra ^ _ ^ _	ca bhṛśam praseduḥ śivāḥ ca vātāḥ 
SA_XX_kukalpmu-1002	2 _ _ _ ^ _ _ ^ ^ _ ^ _ _ 33 _ _ ^ _ _ ^ ^ _ ^ _ _ _ _ ^ _ guhyakasainyamukhyāḥ _ _ ^ _ _ ^ ^ _ hanādair udbhāvayaṃti sma manaḥpraharṣam 34	                                         
SA_XX_kukalpmu-1003	3 _ _ ^ _ _ ^ ^ _ ^ _ _ _ _ ^ _ _ ^ ^ _ ^ _ _ _ _ rur uccaiḥ stutayaś ca _ _ _ _ ^ _ _ ^ ditair nisṛṣṭāḥ 36 siddhiṃ laghu prāpnuhi gaccha c.	uccais stutayaḥ ca                                                     
SA_XX_kukalpmu-1004	4 _ _ ^ _ _ ^ ^ _ ^ _ _ _ _ ^ _ _ ^ ^ _ ^ _ _ _ _ ^ _ _ ^ ^ _ . papāta 37 /// .. hṛṣṭamanāḥ śakro viśvakarmā ca bodhisatvam abhyarcya	                                 
SA_XX_kukalpmu-1005	5 /// + + + + + cyata iti sa /	    cyate iti saḥ 
SA_XX_kukalpmu-1006	// + + + + + + + + + + + + + + .īṃ .. .. .. haraṃ .i	        
SA_XX_kukalpmu-1007	KalpM : IDP SHT 21/80	kalpm idp sht 
SA_XX_kukalpmu-1008	+ + + ntike pravrajitaḥ sa kadācit pradyota + + + m anuprāptaḥ / tatra	ntike pravrajitaḥ sa kadācid pradyota m anuprāptaḥ tatra 
SA_XX_kukalpmu-1009	2 vivikta udyāne + + /// + + + + + / / /	vivikte udyāne 
SA_XX_kukalpmu-1010	.. ca bhadantasāraṇo bhaikṣam aṭitvā kṛtāhāras tatraivodyānalatāgulmapra	ca bhadanta sāraṇaḥ bhaikṣam aṭitvā kṛta āhāraḥ tatra eva udyāna latā gulma pra 
SA_XX_kukalpmu-1011	3 viṣṭo dhyāyamānaḥ ///	viṣṭaḥ dhyāyamānaḥ 
SA_XX_kukalpmu-1012	lalobh. + + / / /	ro 
SA_XX_kukalpmu-1013	īryāpatham avekṣya cakṣuṣāṃ tañ ca rūpam aho buddhaśāsanaṃ yatredṛśo 'pi	īryāpatham avekṣya cakṣuṣām tam ca rūpam aho buddha śāsanam 
SA_XX_kukalpmu-1014	4 yauvanasaṃpanno ///	yauvana saṃpannaḥ 
SA_XX_kukalpmu-1015	caryaṃ caratīti / / /	caryam carati iti 
SA_XX_kukalpmu-1016	+ + tam avakāśam anuprāptaḥ sa taṃ bhadaṃtam avekṣya + + + + + +	tam avakāśam anuprāptaḥ sa tam bhadantam avekṣya       
SA_XX_kukalpmu-1017	5 hi / // na śukla _ ^ _ _ _ _ _ _ .. tareṇa vā _ _ _ _ ^ _ _ _ _ _ _ _ ^ _ ^ _ 1 ///	hi na 
SA_XX_kukalpmu-1018	v1 sa uvāca neti /	saḥ uvāca na iti 
SA_XX_kukalpmu-1019	kim a .. + ///	kim a 
SA_XX_kukalpmu-1020	+ masya dhyānasya la / / /	masya dhyānasya la  /
SA_XX_kukalpmu-1021	+ + + t. + + + + + .. + + + + .. + .. .. + + draṣṭavya + + + + + +	ro-0 di-                  
SA_XX_kukalpmu-1022	2 varṣavara nirmuṇḍa kāṃcuk. ///	     
SA_XX_kukalpmu-1023	gateṣu /	gateṣu 
SA_XX_kukalpmu-1024	gṛ + / / /	gṛ 
SA_XX_kukalpmu-1025	+ + + ya pratinivāsanamātraprāvaraṇaḥ kaṇṭakarkaś. + + + + + +	yaḥ pratinivāsana mātra prāvaraṇaḥ kaṇṭa karkaḥ 
SA_XX_kukalpmu-1026	3 s tāḷitas tatas tāḥ striyo rudaṃtyo rā .. + + // /	tāḍitaḥ tatas tāḥ striyaḥ rudaṃtyaḥ     
SA_XX_kukalpmu-1027	+ anaparāddhaḥ śramaṇas tāḍyata iti tataḥ pradyoto 'bhiniveśāt suṣṭhutaraṃ	anaparāddhaḥ śramaṇaḥ tāḍyate iti tatas pradyotaḥ bhiniveśāt suṣṭhutaram 
SA_XX_kukalpmu-1028	4 tāḷitavān . + + + + /// + + + + + + + // /	ro-0 
SA_XX_kukalpmu-1029	_ _ _ _ ^ _ _ _ _ _ _ _ ^ _ ^ _ _ _ _ _ ^ _ _ _ patitāḥ karkaśāḥ kaśāḥ 2 tatas sa mandaprāṇāvaśeṣo muktaḥ atha 5 + + + + + + + + + /// + + +	                                
SA_XX_kukalpmu-1030	utphullākṣaḥ samaṃtato 'valokya tā .i .ā + + .. hastenādāya	utphulla akṣaḥ samaṃtataḥ hastena ādāya 
SA_XX_kukalpmu-1031	KalpM : IDP SHT 21/81	kalpm idp sht 
SA_XX_kukalpmu-1032	222r1 bhagavantam abhisametya tasya samīpe divyagandhakalpaṃ gandham āghrāya vismayotphullanayanaḥ samaṃtaḥ prekṣitum ārabdhaḥ kasyāyaṃ gandha iti sa bhagavatābhihitaḥ	bhagavantam abhisametya tasya samīpe divya gandha kalpam gandham āghrāya vismaya utphulla nayanaḥ samaṃtaḥ prekṣitum ārabdhaḥ kasya ayam gandhaḥ iti sa bhagavatā abhihitaḥ 
SA_XX_kukalpmu-1033	2 kim icchati mahārājo 'sya gandhasya prabhavam upalabdhuṃ /	kim icchati mahā rājaḥ u sya gandhasya prabhavam upalabdhum 
SA_XX_kukalpmu-1034	paramam icchāmīty uvāca rājā /	paramam icchāmi iti uvāca rājā 
SA_XX_kukalpmu-1035	atha bhagavatā pāṇitalena dharaṇitalam abhihitam utpatitā cāsthiśaṃka	atha bhagavatā pāṇi talena dharaṇi talam abhihitam utpatitā ca asthi śaṃka 
SA_XX_kukalpmu-1036	3 lā raktacandanadatto + + + paṃcāṅgulā tato bhagavatābhihitam asyāḥ khalv asthiśaṃkalāyāḥ surabhir ayam abhivāti gandha iti tato rājñābhitaṃ	raktacandanadattā paṃca aṅgulā tatas bhagavatā abhihitam asyāḥ khalu asthiśaṃkalāyāḥ surabhiḥ ayam abhivāti gandhaḥ iti tatas rājñā abhitaḥ 
SA_XX_kukalpmu-1037	4 n kasyeyam asthiśaṃkalā ko vātra hetur yadīdṛśo 'syā gandha iti /	kasya iyam asthiśaṃkalā kaḥ vā atra hetuḥ gandhaḥ iti 
SA_XX_kukalpmu-1038	sa bhagavatābhihitaḥ + + + + + + + + + kāśyapo nāma bhagavān buddho babhūva	sa bhagavatā abhihitaḥ          kāśyapaḥ nāma bhagavān buddhaḥ babhūva 
SA_XX_kukalpmu-1039	v1 sa jagati dharmālokaṃ kṛtvā + pariṣekābhiṣikta + .. gn. nirvṛtim upajagāma // /	sa jagati dharma ālokam kṛtvā pariṣeka abhiṣikta nirvṛtim upajagāma 
SA_XX_kukalpmu-1040	nāṃ ratnānāṃ sa .. t. .. .. .. stūpaḥ	nām ratnānām sa t    stūpaḥ 
SA_XX_kukalpmu-1041	2 pratiṣṭhāpitaḥ sarvapuṣpasaṃgrahaś ca kṛtas tathāgatacaitye puṣpāropaṇaṃ kariṣyāmīti /	pratiṣṭhāpitaḥ sarva puṣpa saṃgrahaḥ ca kṛtaḥ tathāgata caitye puṣpa āropaṇam kariṣyāmi iti 
SA_XX_kukalpmu-1042	anyataraś ca gṛhapatiputro gaṇikāyām avabaddhacittas tayā	anyataraḥ ca gṛhapati putraḥ gaṇikāyām avabaddha cittaḥ tayā 
SA_XX_kukalpmu-1043	3 gaṇikayābhihito yadi matsamāgamam icchasi puṣpāṇy ānīyaṃtām iti /	gaṇikayā abhihitaḥ yadi mad samāgamam icchasi puṣpāṇi ānīyaṃtām iti 
SA_XX_kukalpmu-1044	tataḥ sarvapuṣpāṇi rājñājñayā parigṛhītānīty avetya sa gṛhapatiputraḥ	tatas sarva puṣpāṇi rājñā ājñayā parigṛhītāni iti avetya sa gṛhapati putraḥ 
SA_XX_kukalpmu-1045	4 stūpāt puṣpa + + + // /	stūpāt puṣpa 
SA_XX_kukalpmu-1046	ti vyavasita .. + .. .. r.. .ir abhavat naitan mama pratirūpaṃ syād yad aham upāsakakulaprasūto buddhaguṇānām upa	abhavat na etat mama pratirūpam syāt yat aham upāsaka kula prasūtaḥ buddha guṇānām upa 
SA_XX_kukalpmu-1047	KalpM : IDP SHT 21/82	kalpm idp sht 
SA_XX_kukalpmu-1048	2 /// + + + + + + n. m avekṣya jā ///	avekṣya jā 
SA_XX_kukalpmu-1049	3 /// + + + .. kulavinayavidhi ///	  
SA_XX_kukalpmu-1050	4 _ _ ^ _ _ ^ _ _ _ _ _ _ ^ _ _ ^ ^ ^ ^ ^ ^ _ _ ^ _ lokavādaḥ saṃkṣepād dharma _ _ ^ ^ ^ ^ ^ ^ _ _ ^ _ _ ^ _ _ _ _ _ _ ^ _	                                  
SA_XX_kukalpmu-1051	5 _ ^ ^ ^ ^ ^ ^ _ _ ^ _ _ ^ _ _ 1 _ _ _ _ ^ _ bhūmau mamāyaṃ dakṣiṇo bhujaḥ _ _ _ _ ^ _ _ _ _ _ _ _ ^ _ ^ _ 2 _ _ _ _ ^ _ _	                  
SA_XX_kukalpmu-1052	v1 _ _ _ _ _ ^ _ ^ _ _ _ _ _ ^ _ _ _ _ _ _ _ ^ .ātalam 3 hā kaṣṭarāgaśikhinā _ _ _ _ ^ _ _ _ _ _ ^ _ _ _ _ _ _ _ ^ _	             
SA_XX_kukalpmu-1053	2 ^ _ 4 _ _ _ _ ^ _ _ _ _ _ _ _ ^ _ ^ _ _ _ _ _ ^ _ kṣeṇa svena cittena vaṃci _ 5 ///	         
SA_XX_kukalpmu-1054	3 /// + + + + .. mānahṛdayaḥ pa + ///	    
SA_XX_kukalpmu-1055	4 /// + + + + + + + .. ri .. + /// 5 /// + + + + + + + + + + + ///	R de-2 ro-0 
SA_XX_kukalpmu-1056	KalpM : IDP SHT 21/83	kalpm idp sht 
SA_XX_kukalpmu-1057	226r1 /// + + + + + tasy. .. lasya sarvaśarīra ///	        
SA_XX_kukalpmu-1058	2 /// bhagavan kāśyapa samyaksaṃbuddha //	bhagavan kāśyapa samyaksaṃbuddha 
SA_XX_kukalpmu-1059	tvaṃ mātā ///	tvam mātā 
SA_XX_kukalpmu-1060	3 /// .. n mayā pa .. + lava ayaṃ .. .. + ///	ro mayā pa 
SA_XX_kukalpmu-1061	v2 /// + + + + + + + .r. + + + + + + + ///	ro-0 di-1 
SA_XX_kukalpmu-1062	3 /// nāma sthāpitam atha krameṇa jātas. .. ///	nāma sthāpitam atha krameṇa jātaḥ 
SA_XX_kukalpmu-1063	4 /// tuṃ parinirvṛtas tasyāṃgadasya pratyeka ///	parinirvṛtaḥ tasya aṅgadasya 
SA_XX_kukalpmu-1064	5 /// + + + .. .. + + .. dibhiḥ pūjaviśe + ///	     
SA_XX_kukalpmu-1065	KalpM : IDP SHT 21/84; originals under IDP SHT 4181 frgs. AS (italics), AW (bold), AX	kalpm idp sht originals under idp sht  frgs as italics ax bold ax 
SA_XX_kukalpmu-1066	227r1 /// + + .. t. .. + + + + // tadyathā śrīguptacaritam udāharaṃ / ///	di                 
SA_XX_kukalpmu-1067	2 /// ti śrīgupto + + + ///	ro 
SA_XX_kukalpmu-1068	jyotiṣkasya hi pit. /	jyotiṣkasya hi pit 
SA_XX_kukalpmu-1069	nigranthaśrāvakāya duhit. + / /// /	nigranthaśrāvakāya duhit 
SA_XX_kukalpmu-1070	3 /// ttā dhātuśo hi satva .. + //	     
SA_XX_kukalpmu-1071	+ ṣkajoti jyotiṣka / ///	ṣka joti jyotiṣka 
SA_XX_kukalpmu-1072	4 /// thānāṃ tato jyotiṣka .. ///	thānām tatas jyotiṣka 
SA_XX_kukalpmu-1073	5 /// tataḥ sarvajño .. .. ///	tatas sarvajñaḥ 
SA_XX_kukalpmu-1074	v1 /// .. kaṃ vaṃcay. + k. .. .. ///	v kaṃ k 
SA_XX_kukalpmu-1075	2 /// .. parān naivāṇv api pre .. ///	 parāt na eva aṇu api pre 
SA_XX_kukalpmu-1076	3 /// nāvartanyā māyayā //	na āvartanyā māyayā 
SA_XX_kukalpmu-1077	.. ṣe /	ṣe 
SA_XX_kukalpmu-1078	pūraṇasya / ///	pūraṇasya 
SA_XX_kukalpmu-1079	4 /// .. .. darśanaṃ pra + + + ///	ro 
SA_XX_kukalpmu-1080	.y. ti pūraṇasya + /	y ti pūraṇasya 
SA_XX_kukalpmu-1081	samīpam upasaṃkrāmya pūraṇaṃ śvo / /// /	samīpam upasaṃkrāmya pūraṇam śvas 
SA_XX_kukalpmu-1082	5 /// + + .. .op. + + + + + // + t. mayi prasannaḥ sarvathā + / ///	di di mayi prasannaḥ sarvathā 
SA_XX_kukalpmu-1083	KalpM : IDP SHT 21/85; originals under IDP SHT 4181 frgs. AR (italics)	idp sht originals under idp sht  frgs ar italics 
SA_XX_kukalpmu-1084	, AT (bold), AV (italics/	at bold av italics 
SA_XX_kukalpmu-1085	bold), AY (underlined)	bold ay underlined 
SA_XX_kukalpmu-1086	, AZ; missing frg. (italics/	a c missing frg italics 
SA_XX_kukalpmu-1087	underlined)	underlined 
SA_XX_kukalpmu-1088	231r1 /// buddhe samutpannapakṣapātā tasmāt saṃrakṣayi ///	buddhe samutpanna pakṣapātā tasmāt saṃrakṣayi 
SA_XX_kukalpmu-1089	2 /// tā / pūraṇa //	tā pūraṇa 
SA_XX_kukalpmu-1090	+ tāḥ āgacchaṃtu bhavaṃtaḥ śatruvadham ava / ///	tāḥ āgacchantu bhavantaḥ śatru vadham ava 
SA_XX_kukalpmu-1091	3 /// + tato jātyaṃjan. ///	tatas jāti aṃjan 
SA_XX_kukalpmu-1092	+ ṇaḥ paṃcatapassevanān nirdagdhamūrtibhi / / /	       
SA_XX_kukalpmu-1093	........ ḥ sudhāśvetatal.	ḥ sudhā śveta tal 
SA_XX_kukalpmu-1094	4 /// .. takuṭajataruviṭapataṭasth. // /	R 
SA_XX_kukalpmu-1095	+ gaṇaparivṛtaḥ kokilaḥ pramu + + + / / /	gaṇa parivṛtaḥ kokilaḥ 
SA_XX_kukalpmu-1096	....... taṃ hi śramaṇaṃ gautam.	tam hi śramaṇam gautam 
SA_XX_kukalpmu-1097	5 /// + + bhibhūtaṃ vā bhūmitale vi .o //	R vā bhūmi tale 
SA_XX_kukalpmu-1098	hasiṣyāma iti + + + + .. .. + + / ///	hasiṣyāmaḥ iti 
SA_XX_kukalpmu-1099	v1 /// + gacchedānīm iti /	v gaccha idānīm iti 
SA_XX_kukalpmu-1100	tataḥ śrīguptaḥ paricārakaṃ preṣayitvā ha + + + + + + + pūraṇ. + + ///	tatas śrī guptaḥ paricārakam preṣayitvā ha           
SA_XX_kukalpmu-1101	2 /// sam idam ārabhyate t trailokya ///	sam idam ārabhyate t trailokya 
SA_XX_kukalpmu-1102	+ ta iyam asatkriyā kriyate / + + + /	te iyam asatkriyā kriyate     
SA_XX_kukalpmu-1103	........ . tan nāsti kutaḥ / /// /	tat na asti kutas 
SA_XX_kukalpmu-1104	3 _ _ ^ _ ^ ^ ^ _ ^ ^ _ ^ _ _ ity etad utthita ^ .. hy ayaśo ^ _ _ tyakṣyāmi jīvitam idan na hi jīvitena dhikchabd. _ ^ ^ ^ _ mama kāryam asti	iti etat utthita hi ayaśaḥ    tyakṣyāmi jīvitam idam na hi jīvitena mama kāryam asti 
SA_XX_kukalpmu-1105	4 _ _ _ _ _ _ _ yanadāraḥ ^ _ ^ _ _ _ _ _ ^ kṛpāṅ kṛtvā tasya kathaṃ cintyate nidhanam 17 /// 5 /// + + + + + + + /// + + + + /	                  
SA_XX_kukalpmu-1106	.. ptaparicārako veṇuvanam upetya bhaga / /// /	veṇuvanam upetya bhaga 
SA_XX_kukalpmu-1107	KalpM : IDP SHT 21/86	kalpm idp sht 
SA_XX_kukalpmu-1108	232r1 /// bhagavān mahākaruṇāpari .. // /	     
SA_XX_kukalpmu-1109	+ + + + + + .. satvahitakāmatayā ca ha + + + + + + + + + + + + + / / /	ro-0 sattva hita kāma tayā ca ha 
SA_XX_kukalpmu-1110	+ + + y. + + caturṣv āryasatyeṣu draṣṭavy. .. + + + +	       
SA_XX_kukalpmu-1111	2 /// .. rāṇām upacitamokṣa + // /	rāṇām upacita mokṣaiḥ 
SA_XX_kukalpmu-1112	+ + bhārāṇāṃ ca vaineyānām iyaṃ vipratipattiḥ agnipūrṇ. n. .. + + + + + + / / /	bhārāṇām ca vaineyānām iyam vipratipattiḥ 
SA_XX_kukalpmu-1113	yitvā saviṣaṃ ca bhojanaṃ kṛtvā vayam āhvayitavyā .. +	yitvā sa viṣam ca bhojanam kṛtvā vayam āhvayitavyā 
SA_XX_kukalpmu-1114	3 /// + ṇam idam ārabdhaṃ mā tāvad bhoḥ / /	idam ārabdham mā tāvat bhoḥ 
SA_XX_kukalpmu-1115	yad ahaṃ duṣkaraiḥ śuṣkaḥ sarvasatvahitaṃ prati tasyāyam upakārasya pratikāro 'dya sajjitaḥ 19 dhig asty a	yat aham duṣkaraiḥ śuṣkaḥ sarva satva hitam prati tasya ayam upakārasya pratikāraḥ sajjitaḥ dhik asti a 
SA_XX_kukalpmu-1116	4 _ ^ _ _ _ _ _ .ān mayi dehibhiḥ mātṛbhyo vatsalatare 'py evaṃ drohaḥ prayujyate 20 tat kim i. ///	mayi dehibhiḥ mātṛbhyaḥ vatsalatare pi evam drohaḥ prayujyate tat kim 
SA_XX_kukalpmu-1117	+ + vā / / /	ro-0 
SA_XX_kukalpmu-1118	ucitaṃ lokanāthānāṃ vai	ucitam loka nāthānām vai 
SA_XX_kukalpmu-1119	5 _ _ _ ^ _ ^ _ _ _ _ _ ^ _ _ mi kāruṇyenābhipīḍitaḥ 21 bhūtagrahāveśavimūḍhacetā yo hy ā ^ _ _ ^ ^ _ ^ _ ti na tatra vaidyaḥ prakaroti	kāruṇyena abhipīḍitaḥ bhūta graha āveśa vimūḍha cetāḥ yaḥ hi ā di di na tatra vaidyaḥ prakaroti 
SA_XX_kukalpmu-1120	v1 _ _ _ _ ^ _ _ ^ ^ _ ^ _ _ 22 kleśagrahāveśavimūḍhacetās tathā jano 'yaṃ prakaroti pāpam tatrātma _ _ ^ ^ _ ^ pīḍāṃ kleśeṣu na kleśa ^ rāj. t. _	                                  
SA_XX_kukalpmu-1121	2 23 + . utthāyovāca / //	rocayitvā uvāca 
SA_XX_kukalpmu-1122	ānanda cīvarakam ānaya gaccha nanda pātraṃ gṛhāṇa mama rāhula _ ^ _ _ bhikṣūn iha tvaraya bhadrika kiṃ sthi	ānanda cīvarakam ānaya gaccha nanda pātram gṛhāṇa mama rāhula      bhikṣūn iha tvaraya bhadrika kim sthi 
SA_XX_kukalpmu-1123	3 _ _ _ _ ^ _ ^ ^ vilaṃbanadeśakālaḥ 24 vaineyānām avastheyaṃ yady asmin mayy api sthite _ _ _ ndhā ^ _ bhūyaḥ kāyasaṃjño mahān ariḥ 25	                                                                             
SA_XX_kukalpmu-1124	4 /// .. lābhravivarād iva divasakaraṃ veṇuvanān niṣkramaṃtaṃ bhagavaṃtam avekṣya veṇuvana + + + + + / / /	  iva             avekṣya 
SA_XX_kukalpmu-1125	devatā divyena cakṣuṣā taṃ śrīguptasya gṛhagataṃ .. + +	devatāḥ divyena cakṣuṣā tam śrīguptasya gṛha gatam 
SA_XX_kukalpmu-1126	5 /// kya buddhapremṇā savihvala // /	buddha premṇā sa vihvala 
SA_XX_kukalpmu-1127	+ s tvaritam upetya bhagavataḥ pādayor ni + + + + + + + + + + + / / /	tvaritam upetya bhagavataḥ pādayoḥ 
SA_XX_kukalpmu-1128	+ + + mā .. .. + + n udyaṃmya buddha .. .o .ī + + + + + +	ro-0 ad-buddha 
SA_XX_kukalpmu-1129	KalpM : IDP SHT 21/87	kalpm idp sht 
SA_XX_kukalpmu-1130	233r1 _ _ _ _ ^ _ _ _ _ _ _ _ ^ _ ^ _ prasādavinivartī ca _ _ _ _ ^ _ .y. _ 26 _ _ _ _ ^ tisnehād e .e _ _ ^ _ ^ _ _ _ _ _ ^ _ _ _ _ _ _	            
SA_XX_kukalpmu-1131	2 _ ^ _ ^ _ 27 anāthānāṃ hi tvan nātho bhītānāṃ _ ^ _ ^ _ viśrāmabhū ^ _ _ _ śaraṇaṃ śaraṇārthinām 28 /// _ _ _ _ ^ _ _ _	  hi                      
SA_XX_kukalpmu-1132	3 _ _ _ _ niveśanam sadevāsuragandharvaṃ _ _ _ _ ^ _ ^ _ 29 tato .. ///	             
SA_XX_kukalpmu-1133	bhagavān uvāca kim a + ///	bhagavān uvāca kim 
SA_XX_kukalpmu-1134	4 /// + .. .ir.. .e + + + /// + + + + + + /// + + + + /// + + + + + + + + + ///	ro-0
SA_XX_kukalpmu-1135	v3 /// tv. n nāśārtham anarthalu ///	tu n nāśa artham 
SA_XX_kukalpmu-1136	+ bhaktavi + + //	bhaktavi 
SA_XX_kukalpmu-1137	.. vivarja .. / /	vivarja 
SA_XX_kukalpmu-1138	4 /// + bhagavān uvāca / // ///	ro uvāca 
SA_XX_kukalpmu-1139	r n. vāsti bh. + + //	R n vā asti bh 
SA_XX_kukalpmu-1140	d api viṣā .. / /	d api viṣā 
SA_XX_kukalpmu-1141	mahāgadena hy anulipt. + / /// /	mahāgadena hi 
SA_XX_kukalpmu-1142	5 /// + + + + + + + + /// .. kin nāma bha .. //	ro-0 fl-2 fl-3
SA_XX_kukalpmu-1143	.. .. jinaṃ vi / /	ri 
SA_XX_kukalpmu-1144	atha bhagavān veṇuvan. / /// /	atha bhagavān veṇuvan 
SA_XX_kukalpmu-1145	KalpM : IDP SHT 21/88	kalpm idp sht 
SA_XX_kukalpmu-1146	235r1 kitāḥ parimokṣit. + + + /// + + + + + + + + + + ///	  
SA_XX_kukalpmu-1147	2 yāmi śrīguptan nā .. + + ///	yāmi 
SA_XX_kukalpmu-1148	+ .. nupraveṣṭuṃ te ca nirgranthā ///	nupraveṣṭum te ca nirgranthā 
SA_XX_kukalpmu-1149	3 ṇaḥ praviśaty atha śrīgupt. ///	ṇaḥ praviśati atha 
SA_XX_kukalpmu-1150	nāny upalabdhavṛttāntā .. + + ///	na ani upalabdha vṛttāntā 
SA_XX_kukalpmu-1151	4 gaṇayitvā pralapi ///	gaṇayitvā pralapi 
SA_XX_kukalpmu-1152	ḥ saṃprati dvitīyāṃ dvāram. + ///	saṃprati dvitīyām dvāram 
SA_XX_kukalpmu-1153	5 ri tṛṇāni prapatitāni / /// _ _ _ _ _ ^ _ _ ^ _ _ _ _ _ _ _ ^ _ _ _ _	ri tṛṇāni prapatitāni 
SA_XX_kukalpmu-1154	v1 nveṣī dhāvati vyākulo vā bhūmi _ _ _ ^ _ _ ^ _ _ .. ^ _ ^ _ _ ^ ^ _ ^ _ ^ _ ^ _ ^ _ _ ^ ^ _ ^ _ ^ _ ^ _ ^ _ _ ^ ^ _ ^ _ ^ _ ^	nveṣī dhāvati vyākulaḥ vā 
SA_XX_kukalpmu-1155	2 naikahaṃsā naḷinīva dahyate + ^ _ ^ _ _ ^ ^ _ ^ _ ^ _ ^ _ ^ _ _ ^ ^ _ ^ _ yanam sasaṃbhramā _ ^ ^ _ ^ _ ^ _ ^ _ ^ _ _ ^ ^ _ ^ _ ^ _ ..	na eka haṃsā naḷinī iva dahyate 
SA_XX_kukalpmu-1156	3 nirdhotakāṃcananibha ^ ^ _ ^ _ _ _ _ ^ _ ^ ^ ^ _ ^ ^ _ ^ _ _ saṃkocam eti niyataṃ tad ṛ. _ ^ _ _ _ _ ^ _ ^ ^ ^ _ ^ ^ _ ^ _ _ ..	              eti   
SA_XX_kukalpmu-1157	4 apy ardhadagdham api _ ^ ^ _ ^ _ _ _ _ ^ _ ^ ^ ^ _ ^ ^ _ ^ _ _ _ _ ^ _ ^ manasāṃ bhuvi tādṛśasya _ _ ^ _ ^ ^ ^ _ ^ ^ _ ^ _ _ .. ta	api ardha dagdham api manasām bhuvi tādṛśasya 
SA_XX_kukalpmu-1158	5 sminn aṃtare bhaga + + + + /// + + + + + + .. + + .. ///	smin antare 
SA_XX_kukalpmu-1159	KalpM : IDP SHT 21/89	kalpm idp sht 
SA_XX_kukalpmu-1160	240r2 /// + + + // .r. .. .c. .y. + .. yur utpa + + ///	ro-0 co- yus 
SA_XX_kukalpmu-1161	3 /// śrīgupta uvāca //	  uvāca 
SA_XX_kukalpmu-1162	bhagavann yadi te kaṃ + + ///	bhagavan yadi te kam 
SA_XX_kukalpmu-1163	4 /// + + preṣito dūta iti /	R preṣitaḥ dūtaḥ iti 
SA_XX_kukalpmu-1164	tataḥ śrīgupta ///	tatas śrīgupta 
SA_XX_kukalpmu-1165	v1 /// + + .. .. kṛta iti śrīgupta uvāca _ _ ^ _ ^ ^ ^ _ ^ ^ _ ^ _ _ _ _ ^ _ ^ ^ ^ _ ^ ^ _	           
SA_XX_kukalpmu-1166	2 ^ _ _ _ _ ^ _ ^ ^ ^ _ ^ ^ _ ^ _ _ _ _ ^ _ ^ ^ ^ . ātmavadhāya dattam 78 bhagavān ///	             
SA_XX_kukalpmu-1167	3 /// m iti bhagavān uvāca //	iti bhagavān uvāca 
SA_XX_kukalpmu-1168	ya .. ///	ya 
SA_XX_kukalpmu-1169	KalpM : IDP SHT 21/90	kalpm idp sht 
SA_XX_kukalpmu-1170	241r1 _ _ _ ^ ^ _ ^ _ ^ ^ ^ _ _ _ ^ _ _ ^ _ _ _ _ ^ ^ _ ^ vā mama vibho deh. ^ _ _ ^ _ ///	          deh 
SA_XX_kukalpmu-1171	tato bhagavatā bh. ///	tatas bhagavatā 
SA_XX_kukalpmu-1172	2 /// _ _ _ _ ^ _ _ _ _ _ _ _ ^ _ vacaḥ bhujyatāṃ _ ^ _ _ _ viṣaṃ vilayam eṣyati ///	                  
SA_XX_kukalpmu-1173	3 /// .. kṣitum āra .. // + + + .. davasā / ///	ro            
SA_XX_kukalpmu-1174	4 /// + .. bhyavah. .. /// + + + + + + + ///	ro-0 
SA_XX_kukalpmu-1175	v1 /// praśāṃto 'tha // + + + + + + + / ///	tha 
SA_XX_kukalpmu-1176	2 /// 82 andh. _ _ ^ _ _ k. m aham āśri ^ _ ^ _ _ _ _ _ ^ _ _ _ _ _ _ _	ro 
SA_XX_kukalpmu-1177	3 ^ _ ^ _ 83 _ _ _ _ ^ _ _ _ _ _ _ _ ^ _ ^ _ _ _ _ ktuṃ na śakto 'smi _ _ _ _ ^ _ ^ _ d.m 84 viṣapā ///	deva 
SA_XX_kukalpmu-1178	4 /// + + + + + // kim idam upanītaṃ / ///	      
SA_XX_kukalpmu-1179	KalpM : IDP SHT 21/91	kalpm idp sht 
SA_XX_kukalpmu-1180	283r1 /// + + + bahava .. + .y. + + + + ///	ro-0 cc-1 
SA_XX_kukalpmu-1181	2 /// + + .. kais tīrthyair ākīrṇā babhūva ///	   kaiḥ tīrthyaiḥ ākīrṇā babhūva 
SA_XX_kukalpmu-1182	3 /// .. praśna iti naiṣa dhārmakathik. ///	praśnaḥ iti na eṣa dhārma kathik 
SA_XX_kukalpmu-1183	4 /// + + + praśne parihāro .. + + ///	ro-0 ca 
SA_XX_kukalpmu-1184	v1 /// + + + syāsya vinirṇayam ///	vinirṇayam 
SA_XX_kukalpmu-1185	2 /// myata iti / rājovāca /	rājā uvāca 
SA_XX_kukalpmu-1186	ya ///	ya 
SA_XX_kukalpmu-1187	3 /// + + bhavanto darśitā ete + ///	R bhavantaḥ darśitāḥ ete 
SA_XX_kukalpmu-1188	4 /// + + .. te 2 + + + + + + ///	ro-0 di-1 
SA_XX_kukalpmu-1189	KalpM : IDP SHT 21/92	kalpm idp sht 
SA_XX_kukalpmu-1190	284r1 /// 3 _ _ _ _ ^ _ _ .y. _ _ hāryam idaṃ muneḥ ṣaṭtsa _ _ ^ _ _ _ yac chakyaṃ n. bh. v. .t. _ 4	             
SA_XX_kukalpmu-1191	2 _ _ _ _ ^ _ _ ^ ^ ^ ^ ^ ^ _ _ _ ^ ^ ^ _ _ _ _ _ ^ _ dhyaḥ katham iva yad ayaṃ siddho vidhiśataiḥ _ _ _ . agnitoyakṣitidharapata	                                                     
SA_XX_kukalpmu-1192	3 _ _ _ ^ ^ ^ _ _ _ _ _ ^ _ _ ^ ^ ^ ^ ^ ^ _ _ _ ^ navidhau 5 vikrīya lavaṇaṃ naṣṭas tīrth. _ _ ^ _ ^ _ḥ yac ceṣyate	                                      
SA_XX_kukalpmu-1193	v1 ^ _ _ _ _ _ _ _ ^ _ ^ _ 6 _ _ _ _ ^ _ _ _ _ _ _ _ ^ gāṃ dvijaḥ ṣaṭtriṃśadbhiḥ paṇaiḥ kṛtsnaṃ _ _ _ _ ^ _ ^ _ 7 mākṣīkāsvāda	                                                                             
SA_XX_kukalpmu-1194	2 _ _ _ _ _ _ _ ^ _ ^ _ _ _ _ _ ^ _ _ _ _ _ _ _ ^ _ ^ .ān 8 jīvo vaḥ paśavaḥ śālir abhipre _ ^ _ ^ _ḥ śarīrabhakṣaṇe do	jīvaḥ vaḥ paśavaḥ śāliḥ abhipre 
SA_XX_kukalpmu-1195	3 _ _ _ _ _ ^ _ ^ _ 9 _ _ _ _ ^ _ _ _ _ _ _ _ ^ _ ^ _ ātmaghātād adharmo .i _ _ _ _ ^ _ ṣaṇāt 10 ///	             
SA_XX_kukalpmu-1196	KalpM : IDP SHT 21/93	kalpm idp sht 
SA_XX_kukalpmu-1197	297r1 /// + .. tuśaḥ pra .. + ktam evaṃ kāmānām āsvādā	evam kāmānām 
SA_XX_kukalpmu-1198	2 /// .. prasāraṇam avaboddhavyam /	     
SA_XX_kukalpmu-1199	yathā tantunā	yathā tantunā 
SA_XX_kukalpmu-1200	3 /// śīlataṃtur utkṣipyate /	śīla tantuḥ utkṣipyate 
SA_XX_kukalpmu-1201	śīlataṃtunā ..	śīla taṃtunā 
SA_XX_kukalpmu-1202	v1 /// ādīnavānupaśyanā yogena gāḍham avaba	ādīnava anupaśyanā yogena gāḍham 
SA_XX_kukalpmu-1203	2 /// .. man yatnenāpi saṃvaradaśāṃ śamathaṃ tayā	           
SA_XX_kukalpmu-1204	3 /// rājakule nirdāyāde saṃvṛtte tapovanāt ku	rāja kule nirdāyāde saṃvṛtte tapaḥ vanāt ku 
SA_XX_kukalpmu-1205	KalpM : IDP SHT 21/94	kalpm idp sht 
SA_XX_kukalpmu-1206	298r1 māraḥ paurair ānīya pr. + + ///	māraḥ pauraiḥ ānīya pr 
SA_XX_kukalpmu-1207	śayanīyapālaiḥ śayana .u .. .. / / /	śayanīya pālaiḥ śayane 
SA_XX_kukalpmu-1208	dhiruhya tasmād eva śayanīyādhikṛtāt puruṣāt snā	adhiruhya tasmāt eva śayanīya adhikṛtāt puruṣāt snā 
SA_XX_kukalpmu-1209	2 naprāvaraṇapāna + ///	na prāvaraṇa pāna 
SA_XX_kukalpmu-1210	+ + .. viśeṣāt prārthayitum ā .. / / /	viśeṣāt prārthayitum ā 
SA_XX_kukalpmu-1211	+ + na puruṣeṇa vijñāpitaḥ pravibhaktādhikāro	na puruṣeṇa vijñāpitaḥ pravibhakta adhikāraḥ 
SA_XX_kukalpmu-1212	3 'yaṃ devasya bhṛtyajanaḥ ///	yam devasya bhṛtya janaḥ 
SA_XX_kukalpmu-1213	+ + + hi mamādhikāro na snāna + + / / /	ro hi mama adhikāraḥ na 
SA_XX_kukalpmu-1214	+ + + eṣa dṛṣṭāṃto 'yaṃ punar artho draṣṭavyaḥ	eṣa dṛṣṭāntaḥ yam punar arthaḥ draṣṭavyaḥ 
SA_XX_kukalpmu-1215	v1 yathā pravibhaktakarmāṇo rā ///	yathā pravibhakta karmāṇaḥ rā 
SA_XX_kukalpmu-1216	+ + + + pakulabhogayaśaḥpriy. + / / /	R       
SA_XX_kukalpmu-1217	+ + + tukāni anyad eva hy ārogyajanakaṃ karma + .. ..	          
SA_XX_kukalpmu-1218	2 rūpādijanakāni ya + + + ///	rūpa ādi janakāni ya 
SA_XX_kukalpmu-1219	+ + śayyāsanādhikṛtāḥ satpuruṣā + / / /	      
SA_XX_kukalpmu-1220	+ + .. uccakulīnasaṃvartanīyaṃ karma kṛtvā vibhavā	ucca kulīna saṃvartanīyam karma kṛtvā vibhavā 
SA_XX_kukalpmu-1221	3 disaṃvartanīyāni ca ka + + + ///	disaṃvartanīyāni ca ka  /
SA_XX_kukalpmu-1222	uccakulīnasaṃvartanīyāt karmaṇo .. / / /	ucca kulīna saṃvartanīyāt karmaṇaḥ 
SA_XX_kukalpmu-1223	+ + .. tam āpnoti arthalābhikayā acinaṃ tad uccakulī	tam āpnoti artha lābhikayā acinam tat uccakulī 
SA_XX_kukalpmu-1224	KalpM : IDP SHT 21/95; original of one fragm. under IDP SHT 4181 frg. AU (in italics)	idp sht original or one fragm under idp sht  frg au in italics 
SA_XX_kukalpmu-1225	301r1 yathā svadeśābhi + + + + ///	yathā 
SA_XX_kukalpmu-1226	+ + lokābhimukha + //	  
SA_XX_kukalpmu-1227	.. .i yathā vaidyasya / ///	i yathā vaidyasya 
SA_XX_kukalpmu-1228	2 + śrama iti evaṃ .. ///	  iti   
SA_XX_kukalpmu-1229	r iti /	R iti 
SA_XX_kukalpmu-1230	yathā ca grām. // + + + + + + + / ///	yathā ca 
SA_XX_kukalpmu-1231	3 .. le .. .. ti / evam ayaṃ + ///	ro  ti evam ayam 
SA_XX_kukalpmu-1232	+ + nti nimittāni // + + + + + + / ///	   
SA_XX_kukalpmu-1233	v1 .. s. .. .t. r iti / yathā vai .. ///	iti yathā vai 
SA_XX_kukalpmu-1234	.. + .. ni prasādama + // + + + + + + + / ///	ro-0 
SA_XX_kukalpmu-1235	2 + .ā dayate dāna ///	ā dayate 
SA_XX_kukalpmu-1236	ata eva caitad ucyate / // _ _ ^ _ ^ ^ ^ _ ^ ^ _ ^ _ _ _ _ ^ _ ^ ^ ^ _	atas eva ca etat ucyate 
SA_XX_kukalpmu-1237	3 śayituṃ pradātā _ _ ^ _ ^ ^ ^ _ ^ ^ _ ^ _ _ _ _ bhiṣak svabhavan. ^ ^ _ ^ _ _ ^ // ṛ //	śayitum pradātā                 bhiṣaj su abhavan 
SA_XX_kukalpmu-1238	dvābhyāṃ strībhyām. ///	dvābhyām strībhyām 
SA_XX_kukalpmu-1239	KalpM : IDP SHT 21/96	kalpm idp sht 
SA_XX_kukalpmu-1240	302r1 /// + + + tayā punar dvitīyayā striyā āmrā .. ///	     tayā punar dvitīyayā striyā āmrā 
SA_XX_kukalpmu-1241	2 /// + .. phalāḥ saṃvṛttāḥ sā punar āmraphalāni s. ///	ro saṃvṛttāḥ sā punar āmra phalāni 
SA_XX_kukalpmu-1242	3 /// .rāṇīti / tayā kathitam evaṃ mayā tāny ā + ///	rāṇi iti tayā kathitam evam mayā tāni 
SA_XX_kukalpmu-1243	v1 /// pi nāvaśeṣīkṛtāny eṣa dṛṣṭāntaḥ ayaṃ punar artho draṣṭavyaḥ ///	na avaśeṣīkṛtāni eṣa dṛṣṭāntaḥ ayam punar arthaḥ draṣṭavyaḥ 
SA_XX_kukalpmu-1244	2 /// + pūrvasukṛtaphalaṃ bhuktaṃ na tu bījam avaśeṣīkṛtam + + ///	             
SA_XX_kukalpmu-1245	3 /// + phalāny upabhuṃkte sa tena pūrvake .. + + + + + + ///	  upabhuṃkte      
SA_XX_kukalpmu-1246	KalpM : IDP SHT 21/97	kalpm idp sht 
SA_XX_kukalpmu-1247	303r2 kā ///	kā 
SA_XX_kukalpmu-1248	3 a ///	a 
SA_XX_kukalpmu-1249	v1 atha ///	u atha 
SA_XX_kukalpmu-1250	2 evaṃ dṛ ///	evam 
SA_XX_kukalpmu-1251	KalpM : IDP SHT 21/98	kalpm idp sht 
SA_XX_kukalpmu-1252	308r1 /// + + + + + + + + + + + + bhagavato buddhir utpannā ///	        
SA_XX_kukalpmu-1253	2 /// + nmaparivart. v. + .y. .. + r api satvair nābhāṣṭaḥ .. + ///	r api sattvaiḥ 
SA_XX_kukalpmu-1254	3 /// tvād ata eva caitad ucyate / / /	tvāt atas eva ca etat ucyate  /
SA_XX_kukalpmu-1255	dṛṣṭvā natān sura ^ _ ^ ^ _ ^ _ _ _ _ ^ _ ^ ^ ^ _ ^ ^ _ ^ _ _	dṛṣṭvā natān 
SA_XX_kukalpmu-1256	4 _ _ ^ _ ^ ^ ^ _ ^ ^ _ ^ _ _ _ _ ^ _ staraguṇān iva śaṃkhabhaṭṭaḥ // saṃgrahaḥ // _ _ _ _ _ _ _ _ _ _ ^ _ ^ _ _ _ _	            
SA_XX_kukalpmu-1257	v1 _ _ _ _ _ _ _ _ _ _ ^ _ _ sthā / // //	di-2 di-2 ro-0 
SA_XX_kukalpmu-1258	bhikṣos tākṣaśilakasya ārya + + + ///	bhikṣoḥ tākṣaśilakasya ārya 
SA_XX_kukalpmu-1259	2 /// samāpta 9 // samāptā ca kalpanāmaṇḍitikā dṛṣṭānta ///	        
SA_XX_kukalpmu-1260	3 /// + + lā ta mā .. .. .. .. .ī .ai + .. + + skandhādimātrakṛtabuddha ///	ro-0 co                
SA_XX_kukalpmu-1261	4 /// + + + + + + + + + + + + + .. māvagamāś. .. ///	ro-0 
SA_XX_kukalpmu-1262	KalpM : IDP SHT 21/99; original missing	kalpm idp sht original missing 
SA_XX_kukalpmu-1263	Anhang A (part of story 2)	anhang a part of story 
SA_XX_kukalpmu-1264	a2 /// tyaṃ tad arhasi ///	a tyam tat arhasi 
SA_XX_kukalpmu-1265	3 /// ṭitacchin. .. ///	ṭ it chin 
SA_XX_kukalpmu-1266	b1 /// ca kauśika kri ///	ca kauśika kri 
SA_XX_kukalpmu-1267	2 /// d. yeya ///	
SA_XX_kukalpmu-1268	KalpM : IDP SHT 21/100	kalpm idp sht 
SA_XX_kukalpmu-1269	Anhang B (part of story 46); cf. KalpM p. 219.19; 220.6,7)	anhang b part or 
SA_XX_kukalpmu-1270	a1 /// bhṛśam api paripīḍitāt .a ///	a bhṛśam api paripīḍitāt a 
SA_XX_kukalpmu-1271	2 /// + .. bandhuviyogā .i + ///	R bandhu viyogāḥ 
SA_XX_kukalpmu-1272	3 /// + + + .. .. .i + + + ///	R     
SA_XX_kukalpmu-1273	b4 /// + + + .v. viśeṣe va .l. + ///	ro viśeṣa va l 
SA_XX_kukalpmu-1274	5 /// . channakalyāṇaṃ bhasmaccha ///	channa kalyāṇam 
SA_XX_kukalpmu-1275	KalpM : IDP SHT 21/101	kalpm idp sht 
SA_XX_kukalpmu-1276	Anhang C (part of story 67)	anhang c part of stori 
SA_XX_kukalpmu-1277	a1 /// ḥ. pūraṇaḥ ///	a ḥ pūraṇaḥ 
SA_XX_kukalpmu-1278	b5 /// tīti yad a .e ///	t iti yat a e 
SA_XX_kukalpmu-1279	KalpM : IDP SHT 21/102; original missing	kalpm idp sht original missing 
SA_XX_kukalpmu-1280	Anhang D (part of story 67)	anhang d part of stori 
SA_XX_kukalpmu-1281	a5 /// thā pūraṇo ///	a thā pūraṇaḥ 
SA_XX_kukalpmu-1282	b1 /// yugaḷeno ///	yugaḷena 
SA_XX_kukalpmu-1283	KalpM : IDP SHT 21/103	kalpm idp sht 
SA_XX_kukalpmu-1284	Anhang E	anhank e 
SA_XX_kukalpmu-1285	a1 /// bhiktiśya ///	a bhiktiśya 
SA_XX_kukalpmu-1286	2 /// .a .. .e .ā ///	R a e ā 
SA_XX_kukalpmu-1287	b4 /// .. .r. t. t. .. ///	ro-0 fl-2 
SA_XX_kukalpmu-1288	5 /// cīvaraṃ va + ///	cīvaram 
SA_XX_kukalpmu-1289	KalpM : IDP SHT 21/104	kalpm idp sht 
SA_XX_kukalpmu-1290	Anhang F	anhang f 
SA_XX_kukalpmu-1291	a3 /// .um. h. .. + ///	a um h 
SA_XX_kukalpmu-1292	4 /// .bhiktiḥ paṃca ///	bhiktiḥ paṃca 
SA_XX_kukalpmu-1293	b2 /// mi caturth. .. ///	caturth 
SA_XX_kukalpmu-1294	3 /// hitena vya .e ///	hitena vyaḥ e 
SA_XX_kukalpmu-1295	KalpM : IDP SHT 21/105; original missing	kalpm idp sht original missing 
SA_XX_kukalpmu-1296	Anhang G	anhang g 
SA_XX_kukalpmu-1297	a1 /// hi ye mauṣṭikāś ca nanu ///	a hi ye mauṣṭikāḥ ca nanu 
SA_XX_kukalpmu-1298	2 /// tena divyāṃ śriyaṃ ///	tena divyām śriyam 
SA_XX_kukalpmu-1299	b3 /// janitasya ///	b janitasya 
SA_XX_kukalpmu-1300	4 /// tridaśālayasya mā ///	tridaśālayasya mā 
SA_XX_kukalpmu-1301	5 /// bhād vāyur i .. ///	ro vāyuḥ i 
SA_XX_kukalpmu-1302	KalpM : IDP SHT 21/106; original under IDP SHT 810 frg. 36	kalpm idp sht original under idp sht 
SA_XX_kukalpmu-1303	Anhang H	anhank h 
SA_XX_kukalpmu-1304	a1 /// asako brāhma ///	a asakaḥ brāhma 
SA_XX_kukalpmu-1305	2 /// bhi .. + + ///	ro-0 
SA_XX_kukalpmu-1306	b1 /// .. .. + + ///	ro-0 
SA_XX_kukalpmu-1307	2 /// .. cchāsa .. paro ///	ro 
SA_XX_kukalpmu-1308	KalpM : IDP SHT 21/107; original missing	kalpm idp sht original missing 
SA_XX_kukalpmu-1309	Anhang I	anhank i 
SA_XX_kukalpmu-1310	a3 /// v. prāṇa .ṛ ///	a u prāṇa ṛ 
SA_XX_kukalpmu-1311	4 /// .u devaḥ // ca ///	 u devaḥ ca 
SA_XX_kukalpmu-1312	5 /// āścārya ///	āścārya 
SA_XX_kukalpmu-1313	b1 /// mānuṣyakatha ///	mānuṣyakatha 
SA_XX_kukalpmu-1314	2 /// .ānām alpa ///	ā nām alpa 
SA_XX_kukalpmu-1315	3 /// s. ton.. ///	r ton 
SA_XX_kukalpmu-1316	KalpM : IDP SHT 21/108	kalpm idp sht 
SA_XX_kukalpmu-1317	Anhang K	anhang k 
SA_XX_kukalpmu-1318	a1 /// + caraṇapraha .. ///	a caraṇapraha 
SA_XX_kukalpmu-1319	2 /// vati niyamo ///	vati niyamaḥ 
SA_XX_kukalpmu-1320	3 /// + rma vākkā ///	rma vākkā 
SA_XX_kukalpmu-1321	4 /// ..ḥ samuttiṣṭha + ///	ḥ samuttiṣṭha 
SA_XX_kukalpmu-1322	5 /// ghārāme ke .. .i ///	gha ārāme ke 
SA_XX_kukalpmu-1323	b1 /// + sādhu sādhu .. .. ///	ro sādhu 
SA_XX_kukalpmu-1324	2 /// + .y. vam uktaś ca .. ///	ro vam uktaḥ ca 
SA_XX_kukalpmu-1325	3 /// + .. pari ///	ro-0
SA_XX_kukalpmu-1326	4 /// krāmya ca sa .. .. ///	krāmya ca sa 
SA_XX_kukalpmu-1327	5 /// .. .ā .. .i .. .. ///	ro-0 
SA_XX_kukalpmu-1328	KalpM : IDP SHT 21/109	kalpm idp sht 
SA_XX_kukalpmu-1329	Anhang L; fol. 100///	anhang l fol 
SA_XX_kukalpmu-1330	r1 + + + + + + + + .. .. .. .. ///	R 
SA_XX_kukalpmu-1331	2 ptakālam athavā proktam etad bhagavatā ///	athavā proktam etat bhagavatā 
SA_XX_kukalpmu-1332	3 dharmadarśanam āhu + + + + + + ///	dharma darśanam āhuḥ 
SA_XX_kukalpmu-1333	4 + + + .i .. + .e + + + + + + ///	R se-2 fl-2 
SA_XX_kukalpmu-1334	v2 paśyāmi tasmād vi + + + ///	paśyāmi tasmāt vi 
SA_XX_kukalpmu-1335	3 radbhir asakṛt kāryaṃ kṛtvā gṛhṇā ///	radbhiḥ asakṛt kāryam kṛtvā gṛhṇa 
SA_XX_kukalpmu-1336	4 + + + + + + + + āhaṃ .. ///	    
SA_XX_kukalpmu-1337	KalpM : IDP SHT 21/110	kalpm idp sht 
SA_XX_kukalpmu-1338	Anhang M	anhank m 
SA_XX_kukalpmu-1339	a1 /// .. śarīravṛkṣaṃ vaṭavṛkṣam ivāṇu vaṭabīja ///	a śarīra vṛkṣam vaṭa vṛkṣam iva aṇu vaṭa bīja 
SA_XX_kukalpmu-1340	2 /// tasmāc ca pūrvakarmabhir ākṣiptan navam ihotpa + ///	tasmāt ca pūrva karmabhiḥ navam 
SA_XX_kukalpmu-1341	3 /// .. nīmāni .. .. .. + + + + .. .i e .āṃ .. ///	ro-0 ns-1 
SA_XX_kukalpmu-1342	b1 /// + tu k. .. .. .. + + + + .. .. .. + ///	ro-0 ns-1 
SA_XX_kukalpmu-1343	2 /// karma janitaṃ janmādy akarmajaṃ tv aparimita ///	               
SA_XX_kukalpmu-1344	3 /// .or.. .. .. .. .. .. vismitaḥ prāha / + ///	ro         
SA_XX_kukalpmu-1345	KalpM : IDP SHT 21/111; original under IDP SHT X 4318	kalpm idp sht original under idp sht 
SA_XX_kukalpmu-1346	Anhang N	anhank n 
SA_XX_kukalpmu-1347	a4 /// ete hy advayavādino bhagavataḥ ///	a ete hi advaya vādinaḥ bhagavataḥ 
SA_XX_kukalpmu-1348	5 /// .. pareṣu tṛṇavad bhasmīkṛte + + + ///	pareṣu tṛṇa vat bhasmīkṛte     
SA_XX_kukalpmu-1349	b1 /// pyam āryatvam avekṣya dṛṣṭasatyā .. ///	ārya tvam avekṣya dṛṣṭa satyā 
SA_XX_kukalpmu-1350	2 /// // .ā .o .. ..ṃ cittam a + ///	ro cittam 
SA_XX_kukalpmu-1351	KalpM : IDP SHT 21/112	kalpm idp sht 
SA_XX_kukalpmu-1352	Anhang O	anhang o 
SA_XX_kukalpmu-1353	a1 /// + + + + + .. .. + + .. .r. n. darśanam. ///	ad-n darśanam 
SA_XX_kukalpmu-1354	2 /// .. tan na śāsvatam ato nocchinnam apy aṅku ///	  na   atas na ucchinnam api   
SA_XX_kukalpmu-1355	3 /// + + + + + .. rāhi ..ḥ prītisu .. ///	rāhi ḥ prītisu 
SA_XX_kukalpmu-1356	b3 /// + + .y. + satyātman. ko 'yaṃ mucyat. ///	r satya ātman kaḥ yam mucyat 
SA_XX_kukalpmu-1357	4 /// .. .e .itt. nāṃ prasaraḥ sarāga .i /// @--------------------------	       
SA_XX_kukalpmu-1358	Manuscript 2: KalpM : SHT 638 (ed. KalpM pp. 200-208)	manuscript 
SA_XX_kukalpmu-1359	KalpM : IDP SHT 638s I	kalpm idp sht 
SA_XX_kukalpmu-1360	r1 ^ ne nṛpatibhiḥ prāptāny upa _ ^ _ _ _ _ ^ ^ _ ^ _ ^ ^ ^ _ _ _ ^ _ _ ^ _ _ _ _ _ _ _ _ _ _ _	R nṛpatibhiḥ prāptāni 
SA_XX_kukalpmu-1361	2 r mudā pradāsyāmi evam ahaṃ _ _ _ _ _ _ _ ^ _ _ _ ^ _ _ _ _ _ ^ ^ ^ ^ ^ _ _ ^ ^ ^ _ ^ _ _ _	R mudā pradāsyāmi evam aham 
SA_XX_kukalpmu-1362	3 _ _ padam api hi nānuvrajati saḥ ^ _ _ _ _ _ ^ ^ ^ ^ ^ _ _ ^ ^ ^ _ ^ _ _ _ _ _ ^ ^ ^ ^ ^ _ _ ^ ^	  api hi na anuvrajati   
SA_XX_kukalpmu-1363	4 ^ _ tataḥ sa rājā maṇiratnam ādāya ///	tatas saḥ rājā maṇi ratnam ādāya 
SA_XX_kukalpmu-1364	5 + .. rūpam iva bhrājate sma sūryoda ///	rūpam iva bhrājate sma sūrya uda 
SA_XX_kukalpmu-1365	6 + ..ḥ s. .. .. .. .ād avataran patita ///	avataran patita 
SA_XX_kukalpmu-1366	v1 + .. .. + + + + + .. + t. sma tataḥ ki .i ///	di di sma tatas ki 
SA_XX_kukalpmu-1367	2 + + kṣitaṃ tac ca rudhiram anusaradbhiḥ kad. ///	 kṣitam tat ca rudhiram anusaradbhiḥ kim 
SA_XX_kukalpmu-1368	3 + + tāṃ tāvat kaścit sa maṇir anena pu ///	tām tāvat kaścid sa maṇiḥ anena 
SA_XX_kukalpmu-1369	4 + .. martham iha sa kāryam īdṛśaṃ kṛtam i ///	 martham iha sa kāryam īdṛśam kṛtam 
SA_XX_kukalpmu-1370	5 d itivac ca vacanam upaśrutya sa rājā + + ///	ā itivat ca vacanam upaśrutya sa rājā  /
SA_XX_kukalpmu-1371	6 nā mohād atyantadāridra + + + + + ///	nā mohāt atyanta dāridra 
SA_XX_kukalpmu-1372	KalpM : IDP SHT 638t, Bl. 294 II	kalpm 
SA_XX_kukalpmu-1373	r1 śākyamuneḥ ko laṃghayet sahṛdayo jīvitahetor naravyāghra yatnaparirakṣitam api kṣayāntam eveha jīvitaṃ puṃsāṃ sa	R śākyamuneḥ kaḥ laṅghayet sahṛdayaḥ jīvita hetoḥ nara vyāghraiḥ yatna parirakṣitam api kṣaya antam eva iha jīvitam puṃsām saḥ 
SA_XX_kukalpmu-1374	2 ti ca kṣaye nanu varaṃ kṣayo 'stu pariśuddhaśīlānāṃ yady api jīvitanāśaḥ samo guṇavatānāṃ ca nirguṇānāṃ ca /	ca kṣaye nanu varam stu pariśuddha śīlānām yadi api jīvita nāśaḥ samaḥ guṇavatānām ca nirguṇānām ca 
SA_XX_kukalpmu-1375	prajñājīvi	prajñājīvi 
SA_XX_kukalpmu-1376	3 talaṃbhe yaśasi ca sumahān viśeṣo 'sthi /	yaśasi ca 
SA_XX_kukalpmu-1377	śīlaṃ hy āśramavāsināṃ bhuvi mataṃ kṣetraṃ guṇānāṃ mahat sopānaṃ tridaśā	śīlam hi āśrama vāsinām bhuvi matam kṣetram guṇānām mahat sopānam tridaśā 
SA_XX_kukalpmu-1378	4 layasya yaśasāṃ bījaṃ sukhasyākaraḥ śīlaṃ tīrtham ihāryadharmasarasaḥ śīlaṃ mukhaṃ śreyasām icched bhadraghaṭopama	layasya yaśasām bījam sukhasya ākaraḥ śīlam tīrtham iha ārya dharma sarasaḥ śīlam mukham śreyasām icchet bhadra ghaṭa upama 
SA_XX_kukalpmu-1379	5 sya khalu kaḥ śīlasya tasya kṣayam iti //	sya khalu kaḥ śīlasya tasya kṣayam iti 
SA_XX_kukalpmu-1380	athāvarjitamanā sa rājā svayam evākuśavandhanān muṃca	atha āvarjita manāḥ sa rājā svayam eva akuśa vandhanāt muṃca 
SA_XX_kukalpmu-1381	6 nn uvāca / aho suvihitaṃ tasya śāsanaṃ śākyasiṃhasya prāṇān api parityajya yad evaṃ rakṣyate śiṣyaiḥ aham api tam udā	uvāca aho su vihitam tasya śāsanam śākyasiṃhasya prāṇān api parityajya yat evam rakṣyate śiṣyaiḥ aham api tam udā 
SA_XX_kukalpmu-1382	v1 raśāsanaṃ śaraṇam upaimi gatajvaraṃ jinaṃ śaraṇam anagham abhyupetya yan na bhavati śīlaviparyayo nṛṇām //	raśāsanam śaraṇam upaimi gata jvaram jinam śaraṇam anagham abhyupetya yat na bhavati śīla viparyayaḥ nṛṇām 
SA_XX_kukalpmu-1383	2 // eko 'py āśayabhadrako mahājanasya kṣemam āvahatīty āśayabhadrakeṇa bhavitavyaṃ tadyathānuśrūyate sārthena sārdhaṃ	ekaḥ pi āśaya bhadrakaḥ mahājanasya kṣemam āvahati iti āśaya bhadrakeṇa bhavitavyam tat yathā anuśrūyate sārthena sārdham 
SA_XX_kukalpmu-1384	3 bhikṣavaḥ samudram avatīrṇāḥ sa ca poto vyāpannas tatra vṛddho bhikṣuḥ plavavirahitaḥ paramabhayam arṇavam ananta	bhikṣavaḥ samudram avatīrṇāḥ sa ca potaḥ vyāpannaḥ tatra vṛddhaḥ bhikṣuḥ plava virahitaḥ parama bhayam arṇavam ananta 
SA_XX_kukalpmu-1385	4 pāram avekṣya viklavamukhaḥ proplūyate sma navataraś ca bhikṣuḥ plavam ādāya prataritum ārabdhaḥ sa tena vṛ	pāram avekṣya viklava mukhaḥ proplūyate sma navataraḥ ca bhikṣuḥ plavam ādāya prataritum ārabdhaḥ sa tena vṛ 
SA_XX_kukalpmu-1386	5 ddhatareṇa bhikṣuṇābhihitaḥ āyuṣman nanu yathāvṛddhikayā lābha ity uktaṃ bhagavatā tad ānīyatām eṣa plava iti / a	ddhatareṇa bhikṣuṇā abhihitaḥ āyuṣmat nanu yathā vṛddhikayā lābhaḥ iti uktam bhagavatā tat ānīyatām eṣa plavaḥ iti a 
SA_XX_kukalpmu-1387	6 tha tasya taruṇasya bhikṣoḥ pratirūpeyaṃ vicāraṇājātir bhaved bhagavatā hi yathāvṛddhikayā lābho 'nujñāta ity ayaṃ	tasya taruṇasya bhikṣoḥ pratirūpā iyam vicāraṇā jātiḥ bhavet bhagavatā hi yathā vṛddhikayā lābhaḥ nujñātaḥ iti ayam 
SA_XX_kukalpmu-1388	KalpM : IDP SHT 638u, Bl. 297 III	kalpm 
SA_XX_kukalpmu-1389	r1 ṇam ivānayanānāṃ śreyase na bhavatīti viditvā satyadarśanam ihāśu ^ _ _ siṃhavat sadasi ye ninadantaḥ saṃśa	R iva anayanānām śreyase na bhavati iti viditvā satya darśanam iha āśu siṃha vat sadasi ye ninadantaḥ 
SA_XX_kukalpmu-1390	2 yān bahujanasya vinīya yānti durgatim adṛṣṭapadatvāt te bhavaṃti vidu _ ^ ^ hāsyāḥ uktvāpi kramasaṃvidhānama	yān bahu janasya vinīya yānti durgatim adṛṣṭa pada tvāt te bhavanti hāsyāḥ uktvā api 
SA_XX_kukalpmu-1391	3 dhuraṃ saṃskāradīptākṣaraṃ /	dhuram saṃskāra dīpta akṣaram 
SA_XX_kukalpmu-1392	vākyaṃ sajjanacetasām upakaraṃ hetūpamālaṃkṛtaṃ /	vākyam sat jana cetasām upakaram hetu upamā alaṃkṛtam 
SA_XX_kukalpmu-1393	yady ātmānam api pramokṣya naraka	yadi ātmānam api pramokṣya naraka 
SA_XX_kukalpmu-1394	4 pretādikād vandhanād astaṃyāti tato 'sya tena kathitenāviṣkṛtenāpi kiṃ tad etad aniyatatvaṃ pṛthagjanānām a	preta ādikāt vandhanāt astam yāti tena kathitena āviṣkṛtena api kim tat etat aniyata tvam pṛthagjanānām 
SA_XX_kukalpmu-1395	5 vetya pratibodhāya vyāyamitavyaṃ yad api bhaven mama yaśaḥ khyātaṃ bhaviṣyaty amuko nāma bhikṣur bahuśruto dṛṣṭāntā	vetya pratibodhāya vyāyamitavyam yat api bhavet mama yaśaḥ khyātam bhaviṣyati amukaḥ nāma bhikṣuḥ bahu śrutaḥ dṛṣṭāntā 
SA_XX_kukalpmu-1396	6 bhidhyāyī veti tad apy akāraṇaṃ sarvathā adhyātmam eva cintaya parān sukathitaiḥ samārirādhayiṣu tūṣṇīṃ bhava saṃprati hi	abhidhyāyī vā iti tat api akāraṇam sarvathā adhyātmam eva cintaya parān su kathitaiḥ tūṣṇīm bhava saṃprati hi 
SA_XX_kukalpmu-1397	v1 praviralatidvajjano lokaḥ yatnād api vasuvipulaṃ yaśo 'pi nirviṣṭam eṣyati vināśaṃ sarvaṃ hi saṃskṛtam anitya	lokaḥ yatnāt api vasu vipulam yaśaḥ nirviṣṭam eṣyati vināśam sarvam hi saṃskṛtam anitya 
SA_XX_kukalpmu-1398	2 m ity abhihitaṃ daśabalena traividyās trimalaprahīṇamanasas traikālyanidhyāyino gaṃgātīravikīrṇasūkṣmasikatā	iti abhihitam daśabalena traividyāḥ tri mala prahīṇa manasaḥ traikālya nidhyāyinaḥ gaṃgā tīra vikīrṇa sūkṣma sikatā 
SA_XX_kukalpmu-1399	3 saṃkhyā bṛhatkīrtayaḥ buddhās tāvad anityatāsvabhihatā naṣṭāḥ svayaṃ nāmabhiḥ śreyasy eva ghaṭasya niścitamanās tya	saṃkhyā bṛhat kīrtayaḥ buddhāḥ tāvat anitya tāsu abhihatāḥ naṣṭāḥ svayam nāmabhiḥ śreyasi eva ghaṭasya 
SA_XX_kukalpmu-1400	4 ktvā yaśaḥprārthanāṃ /	ktvā yaśaḥ prārthanām 
SA_XX_kukalpmu-1401	tataḥ sa śrutābhirato bhikṣur uvāca eṣa eva vyāyamiṣyāmīty athācirāt prāṇoparo	tatas sa śruta abhirataḥ bhikṣuḥ uvāca eṣaḥ eva vyāyamiṣyāmi iti atha acirāt prāṇa uparaḥ 
SA_XX_kukalpmu-1402	5 dhinā mahatā rogeṇākrāntaḥ /	dhinā mahatā rogeṇa ākrāntaḥ 
SA_XX_kukalpmu-1403	maraṇabhayasantrāsitaś cāha hā kaṣṭaṃ kim idānīṃ mayā svākhyāte dharmavinaye pravra	maraṇa bhaya santrāsitaḥ ca āha hā kaṣṭam kim idānīm mayā su ākhyāte dharma vinaye pravraj 
SA_XX_kukalpmu-1404	6 jitvā kṛtaṃ tat śīlaśrutayuktasyāpy anadhigatatvād ihāryasatyānāṃ sva ^ _ _ na bhaviṣyati mama ca śunāṃ ca prativiśeṣaḥ	jitvā kṛtam tat śīla śruta yuktasya api anadhigata tvāt iha ārya satyānām na bhaviṣyati mama ca śunām ca prativiśeṣaḥ 
SA_XX_kukalpmu-1405	KalpM : IDP SHT 638v IV	kalpm idp sht iv 
SA_XX_kukalpmu-1406	r1 /// + + + + + + + + + + + + + _ _ _ ^ ^ _ tha _ ^ ^ ^ _ _ _ ^ _ _ ^ _ _ _ _ ^ ^ _ ^	ro-0 di-1 di-1 di-1 di-1 
SA_XX_kukalpmu-1407	2 _ ^ ^ ^ _ _ _ ^ _ _ ^ _ _ _ _ nn iva vāndhavā karuṇayā dṛṣṭyā di _ _ ^ _ _ _ _ ^ ^ _ ^ _ ^ ^ ^ _	iva vāndhavā karuṇayā 
SA_XX_kukalpmu-1408	3 _ _ ^ _ _ ^ _ _ _ _ ^ ^ bhiḥ karais sakaruṇaṃ dīnair naraiḥ saṃjñi _ _ _ _ ^ ^ _ ^ _ ^ ^ ^ _ _ _ ^ _ _	          
SA_XX_kukalpmu-1409	4 ^ _ _ _ _ ^ ^ t. ś cito 'pi vibhavair yukto 'pi tasmin kṣaṇe /	vibhavaiḥ 
SA_XX_kukalpmu-1410	śaktaḥ pathya ^ _ ^ _ ^ ^ ^ _ _ _ ^ _ _ ^ _ _ _	  
SA_XX_kukalpmu-1411	5 _ ^ ^ _ ^ _ ^ ^ ^ _ syākṣipyamāṇāyuṣo dīpasyeva niśāvasānasamaye _ _ ^ _ _ ^ _ _ _ _ ^ ^ _ ^ _	               
SA_XX_kukalpmu-1412	6 ^ ^ ^ _ _ _ ^ _ _ ^ ve tasmād yāvad anāgatas sa samayas tāvat pradānakṣaṇaḥ .. ///	tasmāt yāvat anāgataḥ sa samayaḥ tāvat pradāna kṣaṇaḥ 
SA_XX_kukalpmu-1413	v1 /// + .āyo 'stīti pradānam abhyasyanti pretya vighātabhīravaḥ ta .. ///	āyoḥ sti iti pradānam abhyasyanti pretya vighāta bhīravaḥ 
SA_XX_kukalpmu-1414	2 /// + rthaṃ saṃkrāmayiṣyāmīti sa na kasyacid ātmābhiprāyam a + + ///	rtham saṃkrāmayiṣyāmi iti sa na kasyacid ātma abhiprāyam 
SA_XX_kukalpmu-1415	3 /// m eva veśe sthāpitavān yadi kaścid dhanam ādāya gacchati + + + ///	eva veśe sthāpitavān yadi kaścid dhanam ādāya gacchati     
SA_XX_kukalpmu-1416	4 /// + .. .. jagāma vidhavāyaś ca striyā ekaputrakaḥ sa .. + + + ///	   jagāma vidhavāyaḥ ca striyāḥ eka putrakaḥ sa 
SA_XX_kukalpmu-1417	5 /// + + + n* sa mātrābhihitaḥ kuta idānīṃ .. + + + ///	ro sa mātrā abhihitaḥ kutas idānīm 
SA_XX_kukalpmu-1418	6 /// + + + .. .īṃ .. + + + + gṛhyatām i + + + + + ///	ro-0 di- di- di- 
SA_XX_kukalpmu-1419	KalpM : IDP SHT 638w V	kalpm idp sht 
SA_XX_kukalpmu-1420	r1 _ _ _ _ _ _ pṛthagjanatvaṃ te kim idānīm iha bhūyaḥ sva ^ _ _ _ ^ rān hasasi _ _ _ _ _ _ _	R      pṛthagjana tvam te kim idānīm iha bhūyas sva     rān hasasi        
SA_XX_kukalpmu-1421	2 _ _ _ ^ _ ^ _ _ smān ko jānīte bhikṣo kā nu bhaviṣyaty avasthā te tiṣṭhatsu hṛdi kleśeṣv agni _ _ ^ _ ^ _ _	    jānīte     nu bhaviṣyati            
SA_XX_kukalpmu-1422	3 _ _ _ _ _ _ rṣaṃ hrīmān asmīti kaḥ kuryāt hrīmān sa yaḥ praviśatīha na dṛṣṭijālaṃ hrīmān. _ ^	    asmi iti kaḥ kuryāt   sa yaḥ praviśati iha na dṛṣṭi jālam hrīmān  /
SA_XX_kukalpmu-1423	4 ^ ^ _ ^ ^ _ ^ _ .ān ācchādito 'pi vahubhir vasanaiḥ sadoṣo hrīmān iti vrajati naiva tu _ ^ _ _	vahuṣu vasanaiḥ sa doṣaḥ hrīmān iti vrajati na eva tu 
SA_XX_kukalpmu-1424	5 /// + + + + + + + lomaṃ vacanam upaśrutyānyataro bhikṣur uvāca /	      lomam vacanam upaśrutya anyataraḥ bhikṣuḥ uvāca 
SA_XX_kukalpmu-1425	samyag āhātrabhavān. + +	samyak āha atrabhavān 
SA_XX_kukalpmu-1426	6 /// + + + + + + + gacchati /	      gacchati 
SA_XX_kukalpmu-1427	na liṃgagrahaṇamātreṇa kutaḥ kleśaprahāṇavirahād ya ^ _ ^	na liṃga grahaṇa mātreṇa kutas kleśa prahāṇa virahāt 
SA_XX_kukalpmu-1428	v1 _ _ _ _ ^ _ ^ ^ ^ _ ^ ^ _ ^ _ _ śakyaṃ naṭair api hi veṣaviśeṣa eva kartuṃ na tena tu kṛtena bhave ^ _ _ ///	                                
SA_XX_kukalpmu-1429	2 /// + + + + + + + + labhā tena caturāryasatyapratibodhāya prayatitavyaṃ evaṃ hy āha ///	                   hi āha 
SA_XX_kukalpmu-1430	3 /// .. .. + + + ..ḥ pudgala ito bahirdhānyaṃ śāstāraṃ paryeṣeti // //	pudgalaḥ itas bahis dhānyam śāstāram paryeṣa iti 
SA_XX_kukalpmu-1431	alpam a ///	alpam a 
SA_XX_kukalpmu-1432	4 /// + tra vairāgyapadasthāma bhūtam iti na manojñadarśanād viṣīditavyaṃ tadyathāsthi ///	vairāgya pada sthāma bhūtam iti na manojña darśanāt viṣīditavyam tat yathā asthi 
SA_XX_kukalpmu-1433	5 /// + svakalpanālaṅkṛto 'smābhir evam abhidhīyamānaḥ śobheta /	sva kalpanā alaṅkṛtaḥ smābhiḥ evam abhidhīyamānaḥ śobheta 
SA_XX_kukalpmu-1434	tadyathānuśrūyate / .. ///	tat yathā anuśrūyate 
SA_XX_kukalpmu-1435	6 /// bhijño yuktamuktapratibhānaḥ svasamayaparasamayajñaḥ praśnapratipraśna + + + + ///	            
SA_XX_kukalpmu-1436	KalpM : IDP SHT 638x VI	kalpm idp sht vi 
SA_XX_kukalpmu-1437	r1 /// + + + + + + + .. vāsthiśaṅkalākuṭikāṃ pralambahṛdayaklomakāṃ rajjukhaṇḍāvavaddhava + ///	R         pralamba hṛdaya klomakām 
SA_XX_kukalpmu-1438	2 /// + + + + .. riṇīm iva varccaḥkuṭim avekṣya /	  iva   avekṣya 
SA_XX_kukalpmu-1439	vaktāraṃ cāsādya prāha mā tāvad bhoḥ śūnyā _ _	vaktāram ca āsādya prāha mā tāvat bhoḥ śūnyā 
SA_XX_kukalpmu-1440	3 _ _ _ _ _ _ ^ _ ^ _ śabdaḥ naḍavanavimathana _ _ pravṛtta iva vāyunirghoṣaḥ neyaṃ strī nātra strī	        iva                              
SA_XX_kukalpmu-1441	4 _ ^ _ _ _ _ _ _ d. katham api kim api samutthāpitaṃ kapaṭaṃ /	  api   api     
SA_XX_kukalpmu-1442	unnamati namati tiṣṭhaty ākuṃca ^ _ ^	unnamati namati tiṣṭhati ākuṃca  /
SA_XX_kukalpmu-1443	5 _ ^ _ _ _ _ _ _ _ kathayati / na cātra kartāsti kaścid api /	              
SA_XX_kukalpmu-1444	māyeyaṃ yantram idaṃ cittabhramajo mamaiṣa sa ^ _ _ _	māyā iyam yantram idam citta bhrama jaḥ mama eṣa sa 
SA_XX_kukalpmu-1445	6 _ _ _ _ _ _ _ _ _ sya kiṃ caitat praviralaśithilāsthisnāyunaddhaṃ karaṅkaṃ naḍamayam iva yantraṃ naikasūtr. ^ _ _ ^ ^	                                  
SA_XX_kukalpmu-1446	v1 ^ ^ ^ ^ _ _ _ ^ _ _ tvam etat jvalitam iva suvarṇaṃ vāriṇā sicyamānaṃ /	tvam etat jvalitam iva suvarṇam vāriṇā sicyamānam 
SA_XX_kukalpmu-1447	tataḥ sthaviraḥ saṃve .i + + ///	tatas sthaviraḥ 
SA_XX_kukalpmu-1448	2 /// dārikām uvāca /	dārikām uvāca 
SA_XX_kukalpmu-1449	brūhi putrake kas te manorathaḥ kiṃ kriyatām iti sā prāha /	brūhi putrake kaḥ te manorathaḥ kim kriyatām iti sā prāha 
SA_XX_kukalpmu-1450	bhadanta im. /// 3 /// + .. //	bhadanta im 
SA_XX_kukalpmu-1451	sthūlaśirasaḥ kila purā śāpād vaḍavatvaṃ āgatā rambhā śāpānubandhaha ^ _ _ _	sthūlaśirasaḥ kila purā śāpāt vaḍava tvam āgatā rambhā śāpa anubandha ha 
SA_XX_kukalpmu-1452	4 _ _ ^ _ _ _ _ _ _ _ _ ga prasīda kuru mayi dayām udāramate lokeṣv adṛṣṭapūrvaḥ śāpaḥ saṃ _ ^ _	prasīda kuru mayi dayām udāra mate lokeṣu a dṛṣṭa pūrvaḥ śāpaḥ 
SA_XX_kukalpmu-1453	5 _ _ /// + + + + + uttiṣṭha bhadre nirmanyu me me hṛdayaṃ sadā ayaṃ ca veṣaḥ śāpaś ca viruddha iti _ ^ _	uttiṣṭha bhadre nirmanyu mama mama hṛdayam sadā ayam ca veṣaḥ śāpaḥ ca viruddhaḥ iti 
SA_XX_kukalpmu-1454	6 _ _ _ _ ^ _ _ _ _ _ _ _ ^ _ .. te kāryākāryavimūḍhas tu tataḥ śāpaṃ prayacchati /	                      
SA_XX_kukalpmu-1455	vītarāgā jitakrodhāḥ .i _ _ _ ^	vīta rāgāḥ jita krodhāḥ 
SA_XX_kukalpmu-1456	KalpM : IDP SHT 638y VII	kalpm idp sht vii 
SA_XX_kukalpmu-1457	r1 /// + + + + + + + + + + .. ..	R 
SA_XX_kukalpmu-1458	2 /// + + + + .. samyakcchrutipratibandho	R 
SA_XX_kukalpmu-1459	3 /// + takṣaśilāyāṃ rājā kaścid vidvatpu	takṣaśilāyām rājā kaścid 
SA_XX_kukalpmu-1460	4 /// + + saṃkrāntisūtraṃ bhāṣitaṃ / bālo	ro saṃkrānti sūtram bhāṣitam 
SA_XX_kukalpmu-1461	5 /// + va yathābhūtaṃ na prajānātīti vista	yathābhūtam na prajānāti iti 
SA_XX_kukalpmu-1462	6 /// baddha eva jāyate baddho mriyate va	baddhaḥ eva jāyate baddhaḥ mriyate 
SA_XX_kukalpmu-1463	v1 /// rājñā bandhanamokṣaḥ samājñāptas tasya su	rājñā bandhana mokṣaḥ samājñāptaḥ tasya su 
SA_XX_kukalpmu-1464	2 /// + kā me vṛddhir na mukto 'haṃ baddha eva tu kha	kā mama vṛddhiḥ na muktaḥ ham baddhaḥ eva tu 
SA_XX_kukalpmu-1465	3 ^ _ _ _ _ _ ^ _ _ _ _ _ _ _ ^ _ ^ _ _ _ _ _ ^ _ _ _ r badhvā sarve pṛthagjanāḥ baddhā eva ca	r badhvā sarve pṛthagjanāḥ baddhāḥ eva ca 
SA_XX_kukalpmu-1466	4 _ _ _ _ _ _ _ ^ _ ^ _ _ _ _ _ ^ _ _ _ _ _ _ _ ^ _ ^ _ _ p. śrotre nipatitaṃ sarvajñasya su	śrotre nipatitam sarvajñasya su 
SA_XX_kukalpmu-1467	5 _ ^ _ _ _ _ ^ ^ _ ^ _ ^ ^ ^ _ _ _ ^ _ _ ^ _ _ _ _ ^ ^ _ ^ _ ^ ^ ^ _ _ _ ^ _ tāni ca / asmād bandhanavipra	tāni ca asmāt bandhana vipra 
SA_XX_kukalpmu-1468	6 _ ^ ^ ^ _ _ _ ^ _ _ ^ _ _ _ _ ^ ^ _ ^ _ ^ ^ ^ _ _ _ ^ ^ ^ _ _ _ ^ _ _ ^ _ /// + + + + + + + + + .. .. padhāyā	ro-0 
SA_XX_kukalpmu-1469	KalpM : IDP SHT 638z VIII	kalpm idp sht viii 
SA_XX_kukalpmu-1470	r1 /// bhagavān uvāca _ _ r naivāsti bhayaṃ trailokyasamāśritād api viṣānnāt karuṇāmahāgadena hy anulipt. me tṛ	R bhagavant uvāca    R na eva asti bhayam trailokya samāśritāt api viṣa annāt karuṇā mahā gadena hi mama tṛṣ 
SA_XX_kukalpmu-1471	2 _ _ _ _ _ _ _ _ _ _ _ _ mūlam uddhṛtaṃ yena kiṃ nāma bha _ _ _ _ _ _ _ jinaṃ vi ^ _ atha bhagavān veṇuvanān ni	                          
SA_XX_kukalpmu-1472	3 /// ś ca devatāḥ .e + + / / /	 ś ca devatāḥ 
SA_XX_kukalpmu-1473	bhagavān veṇuva	bhagavān 
SA_XX_kukalpmu-1474	v4 /// rveṇa bhagavā .. /	bhagavān 
SA_XX_kukalpmu-1475	// .. sinīva	sinīva 
SA_XX_kukalpmu-1476	5 /// hā kaṣṭam ayaṃ sa bhagavā .. /	hā kaṣṭam ayam sa bhagavān 
SA_XX_kukalpmu-1477	// .. yāḥ mā	yāḥ mā 
SA_XX_kukalpmu-1478	6 /// .. taḥ pādayor nipatya prāha /	pādayoḥ nipatya prāha 
SA_XX_kukalpmu-1479	// + .. ṇi	  ṇi 
SA_XX_kukalpmu-1480	KalpM : IDP SHT 638aa IX	kalpm idp sht 
SA_XX_kukalpmu-1481	r1 /// ..ḥ praruditās tāś cāśru .. + + + ///	r praruditāḥ tāḥ ca aśru     
SA_XX_kukalpmu-1482	2 /// + m upasaṃkrāntāḥ mahāprajāpatī ///	upasaṃkrāntāḥ mahāprajāpatī 
SA_XX_kukalpmu-1483	3 /// + + + bhikṣuṇyapāśrayativ. + ///	R    /
SA_XX_kukalpmu-1484	4 /// + mahāprajāpatyā saha niṣkrā .. ///	mahāprajāpatyā saha 
SA_XX_kukalpmu-1485	5 /// + + + + + + m apahāya duḥkhi + ///	     
SA_XX_kukalpmu-1486	6 /// + + mahāprajāpatī gautamī .i ///	    
SA_XX_kukalpmu-1487	v1 /// + + + + + + + ..bhikṣuṇyapāśraya ///	v        bhikṣuṇi apāśraya 
SA_XX_kukalpmu-1488	2 /// + + + + + + ha paścimam idaṃ me + ///	       
SA_XX_kukalpmu-1489	3 /// + + + + mi nirvāṇam iti // .. + ///	ro nirvāṇam iti 
SA_XX_kukalpmu-1490	4 /// + + + + ṇanaśūnyatvam āga .. + ///	      
SA_XX_kukalpmu-1491	5 /// ..ḥ paṃcabhir vrajaty āryaḥ .. .. + ///	pañcabhiḥ vrajati āryaḥ 
SA_XX_kukalpmu-1492	6 /// upāsikānāṃ śatāny abhi + + + ///	upāsikānām śatāni abhi 
SA_XX_kukalpmu-1493	KalpM : IDP SHT 638bb X	kalpm idp sht 
SA_XX_kukalpmu-1494	r5 /// + + + .. + himādrer iva	r      himādreḥ iva 
SA_XX_kukalpmu-1495	6 /// .. ty ucchrite mahati pāṇḍa	ri ucchrite mahati pāṇḍa 
SA_XX_kukalpmu-1496	v1 /// .. r avacchāditaśaradhanur la	R avacchādita śara dhanuḥ la 
SA_XX_kukalpmu-1497	2 /// + + + to yāsyāva puru	    yāsyāva puru 
SA_XX_kukalpmu-1498	KalpM : IDP SHT 638cc, Bl. 419 XI	kalpm idp sht bl xi 
SA_XX_kukalpmu-1499	r1 ^ _ samavāpya _ _ _ _ ^ _ ^ ^ ^ _ parimocayeyam i + ///	R samavāpya         parimocayeyam i 
SA_XX_kukalpmu-1500	2 + .. hi jaga .i + + /// + cittam anekeṣu ja ///	hi cittam anekeṣu 
SA_XX_kukalpmu-1501	3 .. + sāphalyā .. .. + /// + .. nārtham āha / + ///	ro a            
SA_XX_kukalpmu-1502	4 dānādhikāre vaktavyaṃ .. ///	dāna adhikāre vaktavyam 
SA_XX_kukalpmu-1503	+ h. .. + + + ///	ro-0 di-1
SA_XX_kukalpmu-1504	5 kārikeṣu ca sūtreṣū + /// + + + + + + + + ///	kārikeṣu ca 
SA_XX_kukalpmu-1505	6 tmāno vo .. + + + + /// + + + + + + + + ///	ro-0 
SA_XX_kukalpmu-1506	v1 n bodhisatvo + + + /// + + + + + + + + + + ///	n 
SA_XX_kukalpmu-1507	2 m eva mṛgaśatānām u /// + + + + + + + + + + ///	m eva mṛga śatānām 
SA_XX_kukalpmu-1508	3 nagaryāṃ brahmadatto ///	nagaryām brahmadattaḥ 
SA_XX_kukalpmu-1509	4 .. mṛgayūthapatīn i ///	mṛga yūtha patīn i 
SA_XX_kukalpmu-1510	+ + .. vaḥ pradeśaḥ + + ///	ro pradeśaḥ 
SA_XX_kukalpmu-1511	5 + .. s sarāṇ. + + + /// bodhisatvasya matir utpannā ///	                  
SA_XX_kukalpmu-1512	6 + .ā yogakṣem. + /// + + m eva taṃ rājānam u .. ///	ā eva tam rājānam 
SA_XX_kukalpmu-1513	KalpM : IDP SHT 638dd, Bl. 421 XII	kalpm idp sht  bl 
SA_XX_kukalpmu-1514	r1 bhūteṣu vatsalatām upadarśayantīti /	R bhūteṣu vatsala tām upadarśayanti iti 
SA_XX_kukalpmu-1515	tato yena bodhisatvaḥ tenopetya ubhe jānumaṇḍale śiraś ca .. + .. .. .. + + +	tatas yena bodhisatvaḥ tena upetya ubhe jānu maṇḍale śiraḥ ca 
SA_XX_kukalpmu-1516	2 anāthāyā hi me nātho bhava tvaṃ mṛgapuṅgava /	anāthāyāḥ hi me nāthaḥ bhava tvam mṛga puṅgava 
SA_XX_kukalpmu-1517	suvistīrṇo 'pi loko 'yaṃ bhayāt saṃkucatīva me /	su vistīrṇaḥ pi lokaḥ yam bhayāt saṃkucati iva me 
SA_XX_kukalpmu-1518	prasīda vyasana _ _ _ _	prasīda vyasana 
SA_XX_kukalpmu-1519	3 janam ihoddhara āśā me tvayi nānyatra tvaṃ hi bhūtahite rataḥ tvatprasādān na tatrādya gaccheyaṃ gurviṇī satī / antarga	janam iha uddhara āśā me tvayi na anyatra tvam hi bhūta hite rataḥ tvad prasādāt na tatra adya gaccheyam gurviṇī satī antargata 
SA_XX_kukalpmu-1520	4 rbhapraviṣṭo 'yaṃ rakṣyatāṃ śaraṇāgataḥ atha bodhisatvas tāṃ mṛgīm uvāca kiṃ niveditas tvayāyaṃ vṛttāntaḥ svasya yūthapa	rbha praviṣṭaḥ yam rakṣyatām śaraṇa āgataḥ atha bodhisatvaḥ tām mṛgīm uvāca kim niveditaḥ tvayā ayam vṛttāntaḥ svasya yūthapa 
SA_XX_kukalpmu-1521	5 ter iti / sā prāha nivedita iti /	teḥ iti sā prāha niveditaḥ iti 
SA_XX_kukalpmu-1522	bodhisatvaḥ prāha kim āha tatrabhavān iti mṛgī prāha /	bodhisatvaḥ prāha kim āha tatrabhavān iti mṛgī prāha 
SA_XX_kukalpmu-1523	nirbhartsitāsmi khalu tena dayā	nirbhartsitā asmi khalu tena dayā 
SA_XX_kukalpmu-1524	6 m apāsya gacchatvam eva laghu ceti visarjitāsmi /	apāsya gacchatvam eva laghu ca iti visarjitā asmi 
SA_XX_kukalpmu-1525	sāhaṃ bhavantam abhayapradam abhyupetā tasmāt tathā kuru yathā ^ ^ _	sā aham bhavantam abhaya pradam abhyupetā tasmāt tathā kuru yathā 
SA_XX_kukalpmu-1526	v1 ^ _ ḥ syāt / bodhisatvaḥ prāha yady evam alaṃ bhayena gaccha tvam aham atra prāptakālam anuṣṭhāsyāmīti /	syāt bodhisatvaḥ prāha yadi evam alam bhayena gaccha tvam aham atra prāpta kālam anuṣṭhāsyāmi iti 
SA_XX_kukalpmu-1527	atha sā mṛgī + + +	atha sā mṛgī 
SA_XX_kukalpmu-1528	2 kīrṇamukhī svaṃ yūtham abhigatā gatāyāṃ ca tasyāṃ mṛgyāṃ bodhisatvaś cintayāmāsa kam idānīm ahaṃ vakṣyāmi gaccha tvam. .. + +	kīrṇa mukhī svam yūtham abhigatā gatāyām ca tasyām mṛgyām bodhisatvaḥ cintayāmāsa kam idānīm aham vakṣyāmi gaccha tvam  /
SA_XX_kukalpmu-1529	3 kāla iti / athavā svayam eva pravekṣyāmi tasya rājño mahānasam //	kālaḥ iti athavā svayam eva pravekṣyāmi tasya rājñaḥ mahānasam 
SA_XX_kukalpmu-1530	kṛtsnaṃ hi jagad uddiśya bodhau me praṇidhiḥ kṛtaḥ	kṛtsnam hi jagat uddiśya bodhau me praṇidhiḥ kṛtaḥ 
SA_XX_kukalpmu-1531	4 majjīvitena yadi kuntapipīlako 'pi prāṇāṃ labheta mahati vyasane nimagnaḥ svaṃ jīvitaṃ tṛṇavad e	mad jīvitena yadi kunta pipīlakaḥ labheta mahati vyasane nimagnaḥ svam jīvitam tṛṇa vat 
SA_XX_kukalpmu-1532	5 kapade tyajeyam icchāmi jīvitam ahaṃ hi jagaddhitārthaṃ /	kapade tyajeyam icchāmi jīvitam aham hi jagat hita artham 
SA_XX_kukalpmu-1533	atha bodhisatvaḥ svaṃ mṛgayūtham upetyāha yad asmābhir aparāddhaṃ	atha bodhisatvaḥ svam mṛga yūtham upetya āha yat asmābhiḥ aparāddham 
SA_XX_kukalpmu-1534	6 syāt tat kṣantavyaṃ yāsyāmy aham anyasya janasya prāṇāvekṣayā rājño mahānasaṃ pravekṣyāīti tatas te mṛgāḥ sodvi	syāt tat kṣantavyam yāsyāmi aham anyasya janasya prāṇa avekṣayā rājñaḥ mahānasam tatas te mṛgāḥ 
SA_XX_kukalpmu-1535	KalpM : IDP SHT 638ee, Bl. 422; original missing XIII	kalpm  idp sht  bl  original miss xiii 
SA_XX_kukalpmu-1536	r1 huḥ tiṣṭha tvam. ///	R huḥ tiṣṭha tvam 
SA_XX_kukalpmu-1537	2 na cātra mama vi ///	na ca atra mama vi 
SA_XX_kukalpmu-1538	3 ddhir dhruvaṃ rna kṣayaḥ ///	ddhiḥ dhruvam r na kṣayaḥ 
SA_XX_kukalpmu-1539	4 jaṃ viṣādaṃ katham a ///	viṣādam katham 
SA_XX_kukalpmu-1540	5 sarva eva bodhisatv. ///	sarvaḥ eva bodhisatu 
SA_XX_kukalpmu-1541	6 ...... nubaddhāḥ a ///	nubaddhāḥ a 
SA_XX_kukalpmu-1542	v1 .. mahānasaṃ pravi ///	u mahānasam pravi 
SA_XX_kukalpmu-1543	2 prāha kim etad ava ///	prāha kim etat ava 
SA_XX_kukalpmu-1544	3 mṛgakulam api ///	mṛga kulam api 
SA_XX_kukalpmu-1545	4 kṣitavya iti ///	kṣitavyaḥ iti 
SA_XX_kukalpmu-1546	5 rasya śakto ///	rasya śakto 
SA_XX_kukalpmu-1547	6 me vinaṣṭā .i /// @--------------------------	me vinaṣṭā i 
SA_XX_kukalpmu-1548	Manuscript 3: SHT 1015	manuscript 
SA_XX_kukalpmu-1549	A1 /// t. c(e)tasi na kleśak. ///	a t cetasi na kleśak 
SA_XX_kukalpmu-1550	2 /// hy ayaṃ vatsa 6 ///	 hi ayam vatsa 
SA_XX_kukalpmu-1551	3 /// yayor aślā(gh). ///	yayoḥ aślāgh 
SA_XX_kukalpmu-1552	4 /// tīti 8 // // ///	ro 
SA_XX_kukalpmu-1553	5 /// (pṛ)thivīśvare ///	    
SA_XX_kukalpmu-1554	2 /// saṃghasthaviraḥ pro(kt). ///	      
SA_XX_kukalpmu-1555	3 /// mitaṃ caitat pra ///	mitam ca etat pra 
SA_XX_kukalpmu-1556	4 /// rmam avidyāndhaḥ pṛthi(vīśvare) ///	avidyā andhaḥ pṛthivīśvare 
SA_XX_kukalpmu-1557	5 /// .. .. śīlena s. /// @--------------------------	ro-0 
SA_XX_kukalpmu-1558	Manuscript 4: ed. Hori 2011	manuscript 
SA_XX_kukalpmu-1559	4.1. SI 2Kr/9.4	si 
SA_XX_kukalpmu-1560	r1 ṇa nagaram āgatāḥ anyatamaś ceśvaraḥ śrīsobhāgyavibhavarūpakāntidyutiranvito mahājanakrtā .. ///	R na nagaram āgatāḥ anyatamaḥ ca īśvaraḥ śrī sobhāgya vibhava rūpa kānti dyutiḥ anvitaḥ mahājana krtā  /
SA_XX_kukalpmu-1561	2 kāntena veṣeṇā ti sma atha yas teṣāṃ grāmavāsināṃ vidvatsammataḥ puruṣaḥ sa tam īśvaram avekṣ. + ///	kāntena veṣeṇa sma atha yaḥ teṣām grāma vāsinām vidvas sammataḥ puruṣaḥ sa tam īśvaram 
SA_XX_kukalpmu-1562	3 hāyair anuyuktaḥ kim atrabhavato na sādhv iti sa prāha na khalu mayātrabhavato 'bhihitaṃ + + ///	hāyaiḥ anuyuktaḥ kim atrabhavataḥ na sādhu iti sa prāha na khalu mayā atrabhavataḥ bhihitam 
SA_XX_kukalpmu-1563	4 nuṣyatvam āgato na cānena vidhināgata ity ataḥ sa pumṣaḥ prāha tyaktapram. + + + ///	āgataḥ na ca anena vidhinā āgataḥ iti atas sa prāha 
SA_XX_kukalpmu-1564	5 sādhv iti kathaṃ nv avadhūya lajjām* ātmanam eva tu na sādhv iti codayāmi yan nāgato 'smi .. + + ///	sādhu iti katham nu avadhūya lajjām ātmanam eva tu na sādhu iti codayāmi yat smi    
SA_XX_kukalpmu-1565	6 tad ahaṃ nirīkṣya kṛpaṇaṃ pūrvapramādakṣataṃ tat kārtāsmi śamapradānaniyamair adya prabhṛty udyat. + + ///	tat aham nirīkṣya kṛpaṇam pūrva pramāda kṣatam tat śama pradāna niyamaiḥ adya prabhṛti udyat  /
SA_XX_kukalpmu-1566	v1 punar jātasya vā me ṣato rūpārogyakulapubhāpavibhavabhraṃśo na nirbhetsyati / āhāśa .. + ///	punar jātasya vā me ṣataḥ rūpa ārogya kula pubhā pavi bhava bhraṃśaḥ na nirbhetsyati āha āśa  
SA_XX_kukalpmu-1567	2 vanānyaḥ pumān pāpe karmavidhau sthitaś ca hi naro naṣṭaṃ ca sarvaṃ śubhaṃ śreyasy udyatacet. + ///	pumān pāpe karma vidhau sthitaḥ ca hi naraḥ naṣṭam ca sarvam śubham śreyasi 
SA_XX_kukalpmu-1568	3 śubhaiḥ saty evaṃ nanu bhoḥ śubhāśubham iha prāpnoti lokaḥ svataḥ yadi prā + + ///	śubhaiḥ satī evam nanu bhoḥ śubha aśubham iha prāpnoti lokaḥ svatas yadi 
SA_XX_kukalpmu-1569	4 dṛḍhā prāyāsyāmi kṣemāṃ diśam ṛṣivaroktena vidhinā viśālaśrīlubdhā + + + ///	dṛḍhā prāyāsyāmi kṣemām diśam ṛṣi vara uktena vidhinā viśāla śrī lubdhā 
SA_XX_kukalpmu-1570	5 syārthe śubham iha kariṣye bahuvidhaṃ ālekhya doṣayuktaṃ puruṣa iha yathā kṛtvā madava + ///	śubham iha kariṣye bahuvidham ālekhya doṣa yuktam puruṣaḥ iha yathā kṛtvā 
SA_XX_kukalpmu-1571	6 yati ca śubhaṃ citraṃ gatamadaḥ mohakṣībena tadvad yadi dahanasukṛtaṃ dehe khalu mayā tat sa ///	yati ca śubham citram gata madaḥ moha kṣībena tadvat yadi dahana su kṛtam dehe khalu mayā tat sa 
SA_XX_kukalpmu-1572	r1 /// + .. .ūtātmano līnaḥ sarpa ivātr. ///	R   ūta ātmanaḥ līnaḥ sarpaḥ 
SA_XX_kukalpmu-1573	2 /// m apavargasukhaṃ cāhavatīti mokṣaṇ. ///	apavarga sukham ca āhavati iti 
SA_XX_kukalpmu-1574	3 /// + m atha saṃghasthaviraḥ kena cit* bhikṣuṇ. ///	atha saṃgha sthaviraḥ kena cid 
SA_XX_kukalpmu-1575	4 /// + + + .. sādhu sādhu dānapate + + ///	      
SA_XX_kukalpmu-1576	v3 /// + + + + .. .r. h.+ + .ādv.+ + + ///	di-di-di- 
SA_XX_kukalpmu-1577	4 /// + kṣāya praṇe dhānena duḥkha + + ///	rodha 
SA_XX_kukalpmu-1578	5 /// .. labhate śālūkam ante ca tat* tacc. ///	labhate śālūkam ante ca tat tat 
SA_XX_kukalpmu-1579	6 /// śālūkavad iti tasmāc chīlasah. /// @--------------------------	śālūka vat iti tasmāt śīla sah 
SA_XX_kukalpmu-1580	Manuscript 5: all three fragments belong to one manuscript	manuscript all three fragments belong to one manuscript 
SA_XX_kukalpmu-1581	5.1: Or.15010/130; ed. Karashima 2009	ā id karashima 
SA_XX_kukalpmu-1582	ru /// + + + + + + + + + + + + + .. 9 + ///	ro-0 
SA_XX_kukalpmu-1583	v /// + + + + .. bhikṣus tena maṇikārena pīḍya ///	          
SA_XX_kukalpmu-1584	w /// + + + ś ca taṃ bhikṣum uvāca /	ca tam bhikṣum uvāca 
SA_XX_kukalpmu-1585	aham api tav. ///	aham api te 
SA_XX_kukalpmu-1586	x /// + + .. ñ caiva karmeṇa :	  ca eva   
SA_XX_kukalpmu-1587	pāpāt* lobhaṃ hi dṛ .. ///	pāpāt lobham hi 
SA_XX_kukalpmu-1588	y /// tu bhadramukhaḥ 21 lobho 'sti me yaśasi sādhujana praśa .. e ///	tu bhadra mukhaḥ lobhaḥ sti me yaśasi sādhu jana 
SA_XX_kukalpmu-1589	z /// .. ma saumya maṇau tvadīye 23 bhaikṣavṛttiḥ pānsukūlaṃ ///	saumya maṇau tvadīye bhaikṣa vṛttiḥ 
SA_XX_kukalpmu-1590	v1 /// t* 24 atha sa maṇikāro 'rthavaśād dharma .. ///	atha sa maṇikāraḥ ṛtha vaśāt 
SA_XX_kukalpmu-1591	2 /// s. kāyāś ca śoṇitam āgataṃ sa ca krauñca śoṇita + dyanya .. ///	kāyāḥ ca śoṇitam āgatam sa ca krauñca śoṇita 
SA_XX_kukalpmu-1592	3 /// bhikṣus taṃ maṇikāram uvāca bhadramukha jñ. ///	bhikṣuḥ tam maṇikāram uvāca bhadra mukha 
SA_XX_kukalpmu-1593	4 /// + + tena parīkṣyoktam uparataprāṇo 'yam i + ///	  parīkṣya uktam uparata prāṇaḥ   
SA_XX_kukalpmu-1594	5 + + .. .ā .. y aśruparyākulekṣaṇaḥ ///	        
SA_XX_kukalpmu-1595	6 /// + + + + + + + + + + + + + .. mi + ///	ro-0 di-1 ns-1 
SA_XX_kukalpmu-1596	5.2: IOL San 761; ed. Wille 2005, fragment 68	iol san e t 
SA_XX_kukalpmu-1597	r1 /// + .. r. .. .. cā mā bhu .. + + yā tā mi + 5 sth. n. c. pare kṣa .. + ///	r di r mā bhu    yā tā mi  sthā c pare 
SA_XX_kukalpmu-1598	2 /// .. kī puṇyavivṛddhi ne ś. .. .. + .. naimittik. n tarhi maraṇonmukho + ///	ro 
SA_XX_kukalpmu-1599	3 /// + .. .i .. ..ṃ m. .. .. svastho vā sṛjati niyataṃ vindati phalam* a ///	svasthaḥ vā sṛjati niyatam vindati phalam 
SA_XX_kukalpmu-1600	4 /// + + + + + + + .. .. kālātītaśmaśrur ākulavilambaveṣṭanaḥ sneha ///	           
SA_XX_kukalpmu-1601	5 /// + + + + + + + + + + + d. ś. .. rdinavadanaḥ śvāsapradhvā pr. .. ///	       
SA_XX_kukalpmu-1602	6 /// + + + + + + + + + + + + + + + .āyād asārādita .. + + ///	     
SA_XX_kukalpmu-1603	vu /// + + + + + + + + + + + + .. yādya prayacchāmy e + + ///	di di adya prayacchāmi 
SA_XX_kukalpmu-1604	v /// + + + + + + + + + .. l. .. bhaktimahato yady asti ten. ///	      
SA_XX_kukalpmu-1605	w /// + + + + + + .. .y. d. yitvā samīpasaṃsthaṃ puruṣam āhūya prati ///	d y y samīpa saṃstham puruṣam āhūya prati 
SA_XX_kukalpmu-1606	x /// .. .. y. m. .. ścima vyāpāraḥ gaccha kukūṭārāmaṃ gatvā madvaca .. ///	vyāpāraḥ gaccha kukūṭa ārāmam gatvā 
SA_XX_kukalpmu-1607	y /// rasyāśokasya rajña .. .. + .. ma vibhavaḥ //	y               
SA_XX_kukalpmu-1608	tathā niyujyat. ///	tathā niyujyat 
SA_XX_kukalpmu-1609	z /// .. ṣās. .eva rājñaḥ pratiśrutvā tad ardhāmalakam ādāya ku .. ///	eva rājñaḥ pratiśrutvā tat ardha āmalakam ādāya 
SA_XX_kukalpmu-1610	5.3 IOL San 1242; not yet edited (transliteration K. Wille)	iol san not yet edited transliteration k 
SA_XX_kukalpmu-1611	rx /// .. bhadra pūrvvaguṇā /	ro 
SA_XX_kukalpmu-1612	//; cf. Divy 431.17f.	cf divi 
SA_XX_kukalpmu-1613	y /// kam idaṃ dīyataṃ .. ///	y kam idam dīyatam 
SA_XX_kukalpmu-1614	z /// yathā saṃghagatā me /	yathā saṃgha gatāḥ mama 
SA_XX_kukalpmu-1615	//; cf. KalpM 103r1 = Divy 432.2	divi 
SA_XX_kukalpmu-1616	v1 /// hāmut. ca tvaṃ hi .. .. ///	v hāmut ca tvam hi 
SA_XX_kukalpmu-1617	2 /// .. nti na vyadhitasya .. ///	R n ti na vyadhitasya 
SA_XX_kukalpmu-1618	3 /// .. viṣṇu ta bhavati ca .. .. ///	rocate ca 
