segmentnr	original	analyzed
SA_XX_byogalbu-0	YL 115V1 /// .uvana evā ///	ro 
SA_XX_byogalbu-1	2 /// .y. māne kṛtsnaṃ jagat. ///	      
SA_XX_byogalbu-2	3 /// tā dṛśyante parittāḥ ///	tāḥ dṛśyante parittāḥ 
SA_XX_byogalbu-3	4 /// śmaśānam iva paśyati /	śmaśānam iva paśyati 
SA_XX_byogalbu-4	tā ///	tā 
SA_XX_byogalbu-5	5 /// saṃcayāpacayau bahuśo gatvā ni ///	saṃcaya apacayau bahuśas gatvā 
SA_XX_byogalbu-6	6 /// nāsāgrāc cāsya vaiḍūryadhvajo nirgataḥ ///	nāsā agrāt ca asya vaiḍūrya dhvajaḥ nirgataḥ 
SA_XX_byogalbu-7	R2 /// duścaritacāriṇāṃ pūrv. ///	R duścarita cāriṇām pūrvam 
SA_XX_byogalbu-8	3 /// vyāmiśrā dṛśyante / ///	vyāmiśrāḥ dṛśyante 
SA_XX_byogalbu-9	4 /// uddhatāni ca marmāny ā ///	uddhatāni ca marmāni ā 
SA_XX_byogalbu-10	5 /// jīvite cāsya pa ///	jīvite ca asya pa 
SA_XX_byogalbu-11	6 /// kapṛthagjana ///	kapṛthagjana 
SA_XX_byogalbu-12	YL 116V3 /// yāvat samudraparyantāṃ mahāpṛthivīṃ ///	yāvat samudra paryantām mahā pṛthivīm 
SA_XX_byogalbu-13	4 /// samudraparyantāyāṃ sarvasatvāṃ ///	samudra paryantāyām sarva satvām 
SA_XX_byogalbu-14	5 /// uruḥ vipītakam /	     
SA_XX_byogalbu-15	dvitīyāv. / / /	dvitīyau 
SA_XX_byogalbu-16	{lies: ūrur vipītakam}	lieḥ ūruḥ vipītakam 
SA_XX_byogalbu-17	6 /// / yathātmānaṃ + + sarvasatvā ///	       
SA_XX_byogalbu-18	R1 /// bakair iva citaṃ sphuṭitadā ///	R bakaiḥ iva citam sphuṭita dā 
SA_XX_byogalbu-19	2 /// satvānāṃ ca pṛthivyāṃ tannimagnāṃ ///	sattvānām ca pṛthivyām tad nimagnām 
SA_XX_byogalbu-20	3 /// paripavanavac chidrīkṛtaṃ svam āśrayaṃ paśyati / ///	paripavana vat chidrīkṛtam svam āśrayam paśyati 
SA_XX_byogalbu-21	4 /// yā cūrṇīkṛtaṃ bhasma ///	yā cūrṇīkṛtam bhasma 
SA_XX_byogalbu-22	5 /// la + .e .ī ///	R la e ī 
SA_XX_byogalbu-23	YL 117V3 /// pṛthivīṃ bhitvāṣṭau mahānarakān avabhāsya ///	pṛthivīm bhitvā aṣṭau mahā narakān avabhāsya 
SA_XX_byogalbu-24	4 /// mūrdhnā niṣkrāmya yāvad aghaniṣṭhāṃ gatvā ///	mūrdhnā niṣkrāmya yāvat agha niṣṭhām gatvā 
SA_XX_byogalbu-25	5 /// gataṃ vinivartya nāsti hi rūpā ///	gatam vinivartya na asti hi 
SA_XX_byogalbu-26	6 /// yati ca / tato lalāṭāt pravāho nirgatya ///	yati ca tatas lalāṭāt pravāhaḥ nirgatya 
SA_XX_byogalbu-27	R1 /// sthitim āpūrayati /	R sthitim āpūrayati 
SA_XX_byogalbu-28	tataḥ paripākān nābhyāṃ .i ///	tatas paripākāt nābhyām i 
SA_XX_byogalbu-29	2 /// / catvāraś ca mahābhūtāśiviṣā ///	catvāraḥ ca mahābhūta āśiviṣā 
SA_XX_byogalbu-30	3 /// aṃgāraśalākāsadṛśa tejodhātoḥ /	tejaḥ dhātoḥ 
SA_XX_byogalbu-31	// {Cf. Yamabe 9.1.vd}	cf yamabe 
SA_XX_byogalbu-32	4 /// tat saptottaraṃ marmaśataṃ saṃnirodhayitvā /	tat sapta uttaram marma śatam saṃnirodhayitvā 
SA_XX_byogalbu-33	// {Cf. Yamabe 9.1.vd}	cf yamabe 
SA_XX_byogalbu-34	YL 118V1 /// tiṣṭhati /	y   sthāti 
SA_XX_byogalbu-35	hrasvatāyāṃ /	hrasva tāyām 
SA_XX_byogalbu-36	+ + + + + + + + + + + + + + + + + + + + dīrghatāyāṃ /	dīrgha tāyām 
SA_XX_byogalbu-37	tathaiva parivṛttam antargataṃ ca kāye /	tathā eva parivṛttam antargatam ca kāye 
SA_XX_byogalbu-38	hrasvatāyāṃ tīryan mahācakravāḍagataṃ	hrasva tāyām tīryan mahā cakravāḍa gatam 
SA_XX_byogalbu-39	2 dīrghatāyāṃ tathaiva parivṛttaṃ kāye 'ntargatam /	dīrgha tāyām tathā eva parivṛttam kāye ntargatam 
SA_XX_byogalbu-40	hrasvatāyām /	hrasva tāyām 
SA_XX_byogalbu-41	+ + + + + + + + + + + + tivat pūrṇam āśrayaṃ vāyubhiḥ paśyati /	        paśyati 
SA_XX_byogalbu-42	sarvasrotobhir vāyūn praviśato + + +	sarva srotobhiḥ vāyūn praviśataḥ 
SA_XX_byogalbu-43	3 + + + si sarvaṃ vā si + + + + + + + + + + + + + + + + + + tailahradanimagnaṃ cātmānaṃ sarvasrotobhis tailena praviśata iti sarvakāyapratisaṃvedanāyām	                                                                                  
SA_XX_byogalbu-44	4 + + + + + + + + + + + + + + + + + + + + + + pravartamānaṃ paśyati /	       paśyati 
SA_XX_byogalbu-45	tailahradanimagnaṃ cākāśāvaṣṭabdham upari tailadhārābhiḥ siṃcyamānaṃ	taila hrada nimagnam ca ākāśa avaṣṭabdham upari taila dhārābhiḥ siṃcyamānam 
SA_XX_byogalbu-46	5 prasrabdhakāyāsaṃskāratāyām / //	prasrabdha kāya a saṃskāra tāyām 
SA_XX_byogalbu-47	+ + + + + + + + + + + + + + + + + + + + + + + + dhā nirgatā prītisaṃvedanāyāṃ //	          
SA_XX_byogalbu-48	candramaṇḍalarecita + + +ṃ + + +	       
SA_XX_byogalbu-49	6 sukhapratisaṃvedanāyām / //	sukha pratisaṃvedanāyām 
SA_XX_byogalbu-50	+ + + + + + + + + + + + + + + + + + + + + cittasaṃskārapratisaṃvedanāyāṃ //	          
SA_XX_byogalbu-51	cittapaṭutvam atra cittasaṃ + + + + + + + +	       
SA_XX_byogalbu-52	YL 118R1 + + + ta evādityaraśmayaḥ prasrabdhacittasaṃskāratāyām / //	ro te eva āditya raśmayaḥ prasrabdha citta saṃskāra tā 
SA_XX_byogalbu-53	+ + + + + + + + + + + + + + + .ān avaṣṭabhya tiṭḥati cittapratisaṃvedanāyāṃ //	    avaṣṭabhya     
SA_XX_byogalbu-54	hṛdaye nīlapītalohitāvadātaṃ	hṛdaye nīla pīta lohita avadātam 
SA_XX_byogalbu-55	2 raśmikalāpanirgataṃ + + + + + + + + + cittābhipramodanāyām / //	raśmi kalāpa nirgatam  /       citta abhipramodanāyām 
SA_XX_byogalbu-56	+ + + + + + + paśyati /	diśyati 
SA_XX_byogalbu-57	āśvāsapraśvāsasahīyaṃ cātra bāladārakaṃ cittanimitaṃ nimajjamānam /	āśvāsapraśvāsasahīyam ca atra bāla dārakam citta nimitam nimajjamānam 
SA_XX_byogalbu-58	3 cittasamādhānatāyām / //	citta samādhāna tāyām 
SA_XX_byogalbu-59	tato hṛdaye puṣkiriṇī + + + + + + + + + + taṃnimagnaṃ bāladārakaṃ samādhisukhasaktaṃ paśyati aṅgārābhatārakacitaḥ	tatas hṛdaye puṣkiriṇī            tam nimagnam bāla dārakam samādhi sukha saktam paśyati aṅgāra ābha tāraka citaḥ 
SA_XX_byogalbu-60	4 puruṣaś ca tasyāṃ eva puṣkiriṇyāṃ bāladārakaṃ gṛhyoddharati /	puruṣaḥ ca tasyām eva puṣkiriṇyām bāla dārakam gṛhya uddharati 
SA_XX_byogalbu-61	tataḥ puṣkiriṇī jvalati /	tatas puṣkiriṇī jvalati 
SA_XX_byogalbu-62	cittavimocanatāyām / //	citta vimocana tāyām 
SA_XX_byogalbu-63	durbalībhūtaṃ duḥkhitaṃ	durbalībhūtam duḥkhitam 
SA_XX_byogalbu-64	5 jīrṇaṃ svam āśrayaṃ paśyati /	jīrṇam svam āśrayam paśyati 
SA_XX_byogalbu-65	āśvāsapraśvāsa + + + + + + + + + + + + + + + + + lokaḥ śīryate anityānudarśanāyāṃ āśvāsapraśvāsāṃ jvalitāṃ paśyati /	lokaḥ śīryate anitya anudarśanāyām āśvāsa praśvāsām jvalitām paśyati 
SA_XX_byogalbu-66	tathaiva ca kṛtsnaṃ lokaṃ	tathā eva ca kṛtsnam lokam 
SA_XX_byogalbu-67	6 jvālayanti prahāṇānudarśanāyām / //	jvālayanti prahāṇa anudarśanāyām 
SA_XX_byogalbu-68	+ + + + + + + + + + + + + + + + + + la phenapiṇḍākulaṃ svam āśrayaṃ paśyati /	phena piṇḍa ākulam svam āśrayam paśyati 
SA_XX_byogalbu-69	tadvad āśvāsapraśvāsāṃ kṛtsnaṃ ca lokaṃ	tadvat āśvāsa praśvāsām kṛtsnam ca lokam 
SA_XX_byogalbu-70	YL 119V1 virāgānudarśanāyām / //	virāgānudarśanā 
SA_XX_byogalbu-71	+ + + + + + + + + + + + + + + + + + + + + + + + + + + + + + + + + + + nirodhānudarśanāyām / // + + + + + + + + + + + +	ro-0 di-1  /
SA_XX_byogalbu-72	2 + + niḥsṛtāni muktipuṣpāni + + + + + + + + + + + + + + + + + + + + + + + + + + + + + + + + + + + + + + + + + + + + + + + + +	    
SA_XX_byogalbu-73	3 sya hṛdayāt kleśopakleśa + + + + + + + + + + + + + + + + + + (gap 119V4 to R2 ca. 330 Akṣaras)	s yaḥ hṛdayāt kleśa upakleśa                  gap  taḥ r ca 
SA_XX_byogalbu-74	YL 119R3 ṇ. ś. l. t. nimittam / + + + + + + + + + + + + + + + + + + + + + + + + + + + + + + + + + + + + + + + + + + + + + + + + + + + + + +	y ṇ ś l t nimittam 
SA_XX_byogalbu-75	4 na hastena vaiḍūryaguhā ra + + + + + + + + + + + + + + + + + + + + (gap 119R5 to 120V2 ca. 270 Akṣaras)	na hastena vaiḍūrya guhā ra                    gap taḥ ca 
SA_XX_byogalbu-76	YL 120V3 niḥsṛtāḥ kṛtsnaṃ pṛthivīṃ spharitvā tiṣṭhanti / + + + + + + + + + + + + + + + + + + + + + + + + + + + + + + + + + + + + + + +	niḥsṛ kṛtsna pṛthivīm sphar tiṣṭhanti 
SA_XX_byogalbu-77	4 aṅkureṣu nīlābhāni paṭṭacchatrāṇi + + + + + + + + + + + + + + (gap 120V5 to 120R2 ca. 270 Akṣaras)	aṅkureṣu nīla ābhāni paṭṭa chatrāṇi 
SA_XX_byogalbu-78	YL 120R3 ṣām upari pāṇḍarāṇy eva + + + + + + + + + + + + + + + + + + + + + + + + + + + + + + + + + + + + + + + + + + + + + + + + + +	upari pāṇḍarāṇi eva 
SA_XX_byogalbu-79	4 vati / kāye cāsya parā prasrabdhiḥ + + + + + + + + + + + + + + + (gap 120R5 to 121V1 ca. 170 Akṣaras)	vati kāye ca asya parā prasrabdhiḥ 
SA_XX_byogalbu-80	YL 121V1 + + + + + + + + + indradhvaja utpadyate /	      utpad 
SA_XX_byogalbu-81	niṣṭhānimittaṃ + + + + + + + + + + + + + + + + + + + + +	    
SA_XX_byogalbu-82	2 + + + + + + + + + + + + + + + + + + + + + smṛtinimittāni idam aparaṃ niṣṭhānimittaṃ + + + + + + + + + + + + + samaṃtataḥ cchidra + + +	                                    
SA_XX_byogalbu-83	3 + + + + + + + + + + + + + + + + + + mukhābhiḥ suvarṇaśalākābhir ūrdhvamukhābhiḥ ratnacitābhiḥ + + + + + + + + rūpyaśalākābhyo nīlavarṇā +	                                                              
SA_XX_byogalbu-84	4 + + + + + + + + + + + + + + + + śalākābhiḥ pāṇḍarāḥ paṭṭā niḥsṛtāḥ kṛtsnaṃ + + + + + + + + + + + rūpyaśālākābhyaḥ aṅkurā niḥsṛtāḥ	                            
SA_XX_byogalbu-85	5 + + + + + + + + + + + + + + + + + + + + + + + + + nīlābhāḥ paṭṭāḥ ye cākāśe pāṇḍarās te + + + + + + + + + dh. te /	nīla ābhāḥ paṭṭāḥ ye ca ākāśe pāṇḍarāḥ te 
SA_XX_byogalbu-86	tadantargataḥ yog. + + +ṃ + +	tad antargataḥ yog    
SA_XX_byogalbu-87	6 + + + + + + + + + + + + + + + + + + + + + adhipatirūpāraṃbhaḥ āśvāsānām adhipatirūpaṃ /	               
SA_XX_byogalbu-88	+ + + + + + pānām /	ro-0 
SA_XX_byogalbu-89	antarmukha + + + + + + + + + +	ro-0 
SA_XX_byogalbu-90	YL 121R1 + + + + + + + + + + + + + + + + + + + + + + + sphaṭikamayaṃ sopānaṃ + + + + + + + + + + avadātacandramaṇḍalacita + + + + + + + + +	di-2 di-2 ro-0  /                                                                         
SA_XX_byogalbu-91	2 + + + + + + + + + + + + + + + + + + + + + + + + // punar āśvāsapraśvāsasthānāntararaṃ citta + + + + tatrasthaṃ cittaṃ śāntaṃ dṛḍhaṃ cirakālaṃ sth. + s. +	                             
SA_XX_byogalbu-92	3 + + + + + + + + + + + + + + + + + + nirgataś ca nīlābhair aṃkuraiḥ kṛtsnā pṛthivī ciyate /	nirgataḥ ca nīla ābhaiḥ aṃkuraiḥ kṛtsnā pṛthivī 
SA_XX_byogalbu-93	vajrāsanāni codgacchanti /	vajrāsanāni ca udgacchanti 
SA_XX_byogalbu-94	teṣu niṣaṇṇā buddhāḥ ratnamayā	teṣu niṣaṇṇāḥ buddhāḥ ratna mayā 
SA_XX_byogalbu-95	4 + + + + + + + + + vaiḍūryastaṃbhoparacitāḥ kūṭāgārā yāvat tṛtīyaṃ dhyānam evaṃ sphuṭaṃ paśyati /	                          
SA_XX_byogalbu-96	tato 'sya mūrdhataḥ vajraṃ nirgacchati /	tatas sya mūrdhataḥ vajram nirgacchati 
SA_XX_byogalbu-97	tatra niṣaṇṇo bhagavāṃ +	tatra niṣaṇṇaḥ bhagavān 
SA_XX_byogalbu-98	5 + + + + + + + + + + + + + + + nīlābhāni paṭṭacchatrāṇi mahānti sarvaṃ caitad indranīlābhātirekābhi + + te buddhāś ca śabdam udīrayanti śāntaṃ śāntam iti + + +	nīla ābhāni paṭṭa chatrāṇi mahānti sarvam ca etat indranīla ābha atireka abhi te buddhāḥ ca śabdam udīrayanti śāntam śāntam iti  /
SA_XX_byogalbu-99	6 + + + + + + + + + + + ante sarvaṃ yogācārāśraye praviśati /	                
SA_XX_byogalbu-100	āśvāsapraśvāsaniṣpattir eva āśvāsapraśvāsa + + + + + + + + + + + + + + + + + + + + +	         
SA_XX_byogalbu-101	YL 122V1 - 61 Akṣaras -	ro 
SA_XX_byogalbu-102	2 + + + + + + + + + + + + + + + + + + + + + + + + + + + + + cch. + + + + + + + + + + + + + +	R                             
SA_XX_byogalbu-103	3 + + + + + + + + + + + + + + + + + + + + + + + + + + + + + + + + + + + + + + + + pravisati / praśvasatas tatra tiṣṭhati /	                                                
SA_XX_byogalbu-104	evaṃ paunaḥpuṇyena /	evam paunaḥpuṇyena 
SA_XX_byogalbu-105	4 + + + + + + + + + + + + + + + + + + + + + + + + + + + + + + + + + + + + sarvasrotobhyaś ca tadvarṇā buddhāśrayā + + + .e + +	                    
SA_XX_byogalbu-106	5 + + + + + + + + + + + + + + + + + + + + (gap 122V6 to R3 ca. 250 Akṣaras)	       ca   
SA_XX_byogalbu-107	YL 122R3 + + + + + + + + + + + + + + pūrṇaḥ samudra utpadyate /	       utpad 
SA_XX_byogalbu-108	tatparyanta + + +	tad paryanta 
SA_XX_byogalbu-109	4 + + + + + + + + + + + + + + + + + + + + + + + + + + + + + + + + + + + + + + + + m āśvāsakānāṃ + + + sarvakāyapratisaṃvedanāyām / //	āśvāsakānām sarva kāya pratisaṃvedanāyām 
SA_XX_byogalbu-110	5 + + + + + + + + + + + + + (gap 122R6 to 123V1 ca. 150 Akṣaras)	    ca   
SA_XX_byogalbu-111	YL 123V1 + + + + + + + + + + yaṃ saṃkṣipya āśrayāt pravāho	yad saṃkṣip āśrayāt pravāho 
SA_XX_byogalbu-112	2 niḥsṛtaḥ {eher:	niḥsṛtaḥ eheḥ 
SA_XX_byogalbu-113	nirgataḥ; cf. SWTF} + + + + + + + + + + + + + + + + + + + + + + + + + + + + + + + + + + + + + + + + + + + + + + + + + +prasrabdhakāyasaṃskāratayām	nirgataḥ 
SA_XX_byogalbu-114	3 + + + + + + + + + + + + + + + + + + + + + + + + + + + + + + + + + + + + + + + + + + + prītisaṃvedanāyām / //	ro-0 
SA_XX_byogalbu-115	4 + + + + + + + + + + + + + + + + + + + + + + + + + + + + + + + + + + + + + + + + + + + sukhapratisaṃvedanāyām /	ro-0 di-1 di-1 di-1 di-1 
SA_XX_byogalbu-116	5 + + + + + + + + + + + + + + + + + + + + + + + + + + + + + + + + + + + + + + + + + + + + + + + + + + + + + + + + +ḥ kāyaṃ padmacitaṃ	                                                                                                                     
SA_XX_byogalbu-117	6 + + + + + + + + + + + + + + + + + + + + + + + + + + + + + + + + + + + + + + + + + + + + + + + + + + + + + bhi dhārābhiḥ yogācārāśrayaṃ	dhārābhiḥ yoga ācāra āśrayam 
SA_XX_byogalbu-118	YL 123R1 + + + + + + + + + + + + + + + + + + + + + + + + + + + + + + + + + + + + + + + + + + + + + + + + + + + + + + + + nam utpadyate /	utpadyate 
SA_XX_byogalbu-119	2 + + + + + + + + + + + + + + + + + + + + + + + + + + + + + + + + + + + + + + + + + + + + + + + + + + + + + + + + + + + muktāpuṣpa	ro-0 
SA_XX_byogalbu-120	3 + + + + + + + + + + + + + + + + + + + + + + + + + + + + + + + + + + + + + + + + + + + + + + + + + + + + bhir abhrakūṭaiḥ	                                                                                        
SA_XX_byogalbu-121	4 + + + + + + + + + + + + + + + + + + + + + + + + + + + + + + + + + + + + + + + + nirodhānudarśanāyāṃ /	           
SA_XX_byogalbu-122	punar āśvāsapraśvāsa	punar āśvāsa praśvāsa 
SA_XX_byogalbu-123	5 + + + + + + + + + + + + + + + + + + + + + + + + + + + + + + + + + + + + + + + + + + + + + + + + + + + d. nimittaṃ samudracandraṃ	nimittam samudra candram 
SA_XX_byogalbu-124	6 + + + + + + + + + + + + + + + + + + + + + + + + + + + + + + + + + + + + + + + + + + + + + + + + + + + + uparīmam upacīyate + + +	                       
SA_XX_byogalbu-125	YL 124V1 + + + + + + + + + + + + + + + + + + + + + + + + + + + + + + + + sarvakāyapratisaṃvedanāvahitacetasaḥ ratnaśalākā iva ratnacitādityamaṇḍalāni	sarva kāya pratisaṃvedana avahita cetasaḥ ratna śalākāḥ iva ratna cita āditya maṇḍalāni 
SA_XX_byogalbu-126	2 + + + + + + + + + + + + + + + + + + + + + + + + + + + + + + + + + + + + + + + + śādityamaṇḍalopacaritāḥ evaṃ kṛtsnaṃ lokaṃ sphuṭaṃ paśyati	                                                                               
SA_XX_byogalbu-127	3 + + + + + + + + + + + + + + + + + + + + + + + + + + + + + + + + + + suvarṇabhājanaparyanteṣu ca ratnacitādityamaṇḍalāni + .r. + +	                     
SA_XX_byogalbu-128	4 + + + + + + + + + + + + + + + + + + + + + + + + + + + + + + + + + niḥsṛtābhiḥ suvarṇavarṇābhiḥ snigdhābhir dhārābhir āśrayā + + + +	niḥsṛtābhiḥ suvarṇa varṇābhiḥ snigdhābhiḥ dhārābhiḥ 
SA_XX_byogalbu-129	5 + + + + + + + + + + + + + + + + + + + + + + + + + + + + + + + + + + + + + + + + + + naṃ bhājane ca pūryamāṇe bhājanaparyanta + + + + + + +	bhājane ca pūryamāṇe 
SA_XX_byogalbu-130	6 + + + + + + + + + + + + + + + + + + + + + + + + + + + + + + + + + + + + + + + + + / sukhapratisaṃvedī āśvāsāt sukhapratisaṃved. + + + + +	                  
SA_XX_byogalbu-131	YL 124R1 + + + + + + + + + + + + + + + + + + + + + + + + + + + + + + + + + + + āśvāsapraśvāsā pravartante tadvad yogācārāśrayaḥ pra + + + +	āśvāsa praśvāsa pravartante tadvat yoga ācāra āśrayaḥ 
SA_XX_byogalbu-132	2 + + + + + + + + + + + + prītisaṃvedanāyām /	      
SA_XX_byogalbu-133	sābhogaṃ sābhisaṃskāraṃ ca tasmiṃ samaye cittaṃ bhavati teṣāṃ ca ratnānām ālokaḥ ś. + + + + + +	sa ābhogam sa abhisaṃskāram ca tasmin samaye cittam bhavati teṣām ca ratnānām ālokaḥ 
SA_XX_byogalbu-134	3 + + + + + + + + + + + + + + + + + + + + + + + + + + + + + sukhapratisaṃvedanāvahitacetasa-āśrayam anantaparyanta + + +	            
SA_XX_byogalbu-135	4 + + + + + + + + + + + + + + + + + + + + + + + + + + + + + + + + + + lasūryamaṇḍalāni nimagnāni dṛśyante / hṛdaye pī + + + +	                   
SA_XX_byogalbu-136	5 + + + + + + + + + + + + + + + + + + + + + + + + + + + + + + + + + + + + + + + + + + + śalākābhiḥ dīpavad vyutkarṣaṇayogena pradī + + + +	                                
SA_XX_byogalbu-137	6 + + + + + + + + + + + + + + + + + + + + + + + + + + sukhapratisaṃvedanāyāṃ sābhogaṃ sābhisaṃskāraṃ ca tasmiṃ samaye cittaṃ bhavati /	                             bhavati 
SA_XX_byogalbu-138	YL 125V1 + + + + + + + + + + + + + + + + + + + + + + + + + + + + + + + + + + + + + + + + + + + + / etāny adhipatirūpāṇi punar āśvāsapraśvāsā n. v. +	etad adhipati rūpa punar āśvāsa praśvāsa 
SA_XX_byogalbu-139	2 + + + + + + + + + + + + + + + + + + + + + + + + + + + + + + + + + + + + + + + maṇḍalaiḥ sragdāmabhir iva vyāmiśrāḥ adho yāvad vāyumaṇḍalaṃ	                                                                                         
SA_XX_byogalbu-140	3 + + + + + + + + + + + + + + + + + + + + + + + + + + + + + + + cittasaṃskārapratisaṃvedanāyām /	             
SA_XX_byogalbu-141	sābhogaṃ ca sābhisaṃskāraṃ tasmiṃ	sa ābhogam ca sa abhisaṃskāram tasmin 
SA_XX_byogalbu-142	4 samaye cittaṃ bhavati /	samaye cittam bhavati 
SA_XX_byogalbu-143	+ + + + + + + + + + + + + + + prasrabdhacittasaṃskāratāyām /	         
SA_XX_byogalbu-144	anābhogam anabhisaṃskāraṃ śāntaṃ tasmiṃ samaye cittaṃ bhavati	an ābhogam an abhisaṃskāram śāntam tasmin samaye cittam bhavati 
SA_XX_byogalbu-145	5 + + + + + + + + + + + + + + + + + + + + + + + + + + + + + + + + + + + + + + + + ca bāladārakaṃ ṣaḍdantaḥ śveto gajaḥ agraha + + + +	ca bāla dārakam ṣaṣ dantaḥ śvetaḥ gajaḥ agraha 
SA_XX_byogalbu-146	6 + + + + + + + + + + + + + + + + + + + + + cittapratisaṃvedanāyām /	         
SA_XX_byogalbu-147	+ + + + + + + + paśyati bhramantaṃ taṃniviṣṭadṛṣṭiṃ ca pramudit. + + + + +	     paśyati bhramantam tam niviṣṭa dṛṣṭim ca      
SA_XX_byogalbu-148	YL 125R1 + + + + + + + + + + + + + + + + + + + + + + + + + + + + + + + + + + + + + + + + + tāś ca bāladārakaḥ praśvasataḥ ratna + + + + + +	ro-0 di-1 di-1 di-1  /                                              
SA_XX_byogalbu-149	2 + + + + + + + + + + + + + + + + + + + + + + + + + + + + + + + + + + + + + + + cittābhipramodanāyām /	citta abhipramodanāyām 
SA_XX_byogalbu-150	sāntarbahiś ca tailapūrṇaṃ samudraṃ paśyati	sa antar bahis ca taila pūrṇam samudram paśyati 
SA_XX_byogalbu-151	3 + + + + + + + + + + + + + + + + + + + + + + + + + + + + bāladārakam āśvāsaparigṛhītam antarnimajjanmānaṃ paśyati /	bāla dārakam āśvāsa parigṛhītam antar nimajjanmānam paśyati 
SA_XX_byogalbu-152	cittasamādhānatāyām /	citta samādhāna tāyām 
SA_XX_byogalbu-153	4 + + + + + + + + + + + + + + + + + + + + + + + bāladārakaṃ tārakoparacitena ca puruṣeṇoddhriyamānaṃ pśyati / + + +	                      
SA_XX_byogalbu-154	5 + + + + + + + + + + + + + + + + + + + + + + + + + + + + + + + + + + + + + + + + + laṃ kūṭāgārāvaṣṭabdhaṃ svam āśrayaṃ paśyati cittaṃ cānuddhata	                                                                                                  
SA_XX_byogalbu-155	6 + + + cittavimocanatāyām /	R citta vimocana tāyām 
SA_XX_byogalbu-156	+ + + + + + + + + + + + + + + + + + + + + + + + + + + + + + saṃvartanyām iva kṛtsnaṃ lokaṃ viśīryantaṃ paśyati /	saṃvartanyām iva kṛtsnam lokam viśīryantam paśyati 
SA_XX_byogalbu-157	YL 126V1 anityānudarśanāyām /	anitya anudarśanāyām 
SA_XX_byogalbu-158	+ + + + + + + + + + + + + + + + + + + + + + + + + + + + + + + + prahāṇānudarśanāyām /	          
SA_XX_byogalbu-159	siṃham ādityamaṇḍalopacitaṃ ratnopacitair a +	siṃham āditya maṇḍala upacitam ratna upacitaiḥ 
SA_XX_byogalbu-160	2 + + + + + + virāgānudarśanāyām /	      
SA_XX_byogalbu-161	+ + + + + + + + + + + + nirodhānudarśanāyām /	      
SA_XX_byogalbu-162	utthānakāle anantaparyantaṃ prāsāda utpadyate /	utthāna kāle ananta paryantam prāsādaḥ utpadyate 
SA_XX_byogalbu-163	vaiḍūryastaṃbhadhāritaṃ /	vaiḍūrya staṃbha dhāritam 
SA_XX_byogalbu-164	tatra siṃhāsanādhirūḍho	tatra siṃhāsana adhirūḍhaḥ 
SA_XX_byogalbu-165	3 bhagavāṃ prādurbhavati + + + + + + + + + + + + + + + + + + + niḥsṛtaiḥ ratnapuṣpavarṣaiḥ sa saṃgho vyavakīryate // puna + + +	prādurbhavati                   niḥsṛtaiḥ ratna puṣpa varṣaiḥ sa saṃghaḥ vyavakīryate 
SA_XX_byogalbu-166	4 + + + + + + + + + + + + + + + + + + + + + + + + + + + + + + + + + pṛthivīm avaṣṭabhya tiṣṭhati /	                             
SA_XX_byogalbu-167	dvitīya ākāśam / catvāra + + + +	dvitīye ākāśam 
SA_XX_byogalbu-168	5 + + + + + + + + + + + + + + + + + + + + + + + + + + + + + + + + + + + + + pair ādityamaṇḍalam /	                    
SA_XX_byogalbu-169	pratibaddhā dṛśyante / b. + + + + + +	pratibaddhāḥ dṛś 
SA_XX_byogalbu-170	6 + + + + + + + + + + + + + + + + + + + + + + + + + + + + + + + + + + + + + + + + + ritam avikampyam ātmānaṃ paśyati / nābhyāṃ + + + + + + +	                 
SA_XX_byogalbu-171	YL 126R1 + + + + + + + + + + + + + + + + + + + + + + + + + + + + + + + + + + + + + + + nāsāgre dvicchidro bhavati tābhyām āśvāsapraśvāsa + +	nāsā agra dvi chidraḥ bhavati tābhyām 
SA_XX_byogalbu-172	2 + + + + + + + + + + + + + + + + + + + + + + + + + + + + + + + + + + + + + + + + + / tato bhagavāṃ yathoktasmṛtinimittāni + + + + + +	ro-0  /                                                
SA_XX_byogalbu-173	3 + + + + + + + + + + + + + + + + + + + + + + + + + + + + + + + + + bāladāraka iva + .r. + + āntargataś cittanimittaṃ dṛśyate / + +	                          
SA_XX_byogalbu-174	4 + + + + + + + + + + + + + + + + + + + + + + + + + + + + + + + + sukhasamjñāyām /	     /
SA_XX_byogalbu-175	jvalanti duḥkhasaṃjñāyām /	jvalanti duḥkha saṃjñāyām 
SA_XX_byogalbu-176	antaḥsuṣiraḥ + +	antar suṣiraḥ 
SA_XX_byogalbu-177	5 + + + + + + + + + + + + + + + + + + + + + + + + + + + + + + + + + + + + + + + + + + neñjane / adhyātmavāyupathapariśodhanāt /	                                              
SA_XX_byogalbu-178	sthitakāyo	sthita kāyaḥ 
SA_XX_byogalbu-179	6 bhavati + + + + + + + + + + + + + + + + + + + + + + + + + + + + + + + + + + + + + + + + .ākṛtā vitarkavicāroparamāt /	bhavati 
SA_XX_byogalbu-180	sthitacitto bhavati samādhipratilābhāt /	sthita cittaḥ bhavati samādhi pratilābhāt 
SA_XX_byogalbu-181	YL 127V1 ṛjubhāva + + + + + + + + + + + + t. samyaksuprahīṇānāṃ bhavati abhipretakāryāvāhakatvāt / //	samyak su prahā bhū abhipre kārya āvāhaka tva 
SA_XX_byogalbu-182	punar āśvāsapraśvāsād vāhayataḥ sphaṭikamayo	punar āśvāsa praśvāsāt vāhayataḥ sphaṭikamayo 
SA_XX_byogalbu-183	2 lokaḥ āśrayaś ca dṛṣyante /	lokaḥ āśrayaḥ ca dṛṣyante 
SA_XX_byogalbu-184	tato mūrdhnaḥ ratnamayo vṛkṣaḥ anantāṃ lokadhātūṃ spharitvā tiṣṭhati /	tatas mūrdhnaḥ ratna mayaḥ vṛkṣaḥ anantām lokadhātūm spharitvā tiṣṭhati 
SA_XX_byogalbu-185	tasmiṃ vṛkṣe ghanapatraśākhāsu buddhā dṛśyante dharmaṃ deśayantaḥ taṃmukhaniḥsṛtai ratnapuṣpapadmavarṣair	tasmin vṛkṣe ghana patra śākhāsu buddhāḥ dṛśyante dharmam deśayantaḥ tad mukha niḥsṛtaiḥ ratna puṣpa padma varṣaiḥ 
SA_XX_byogalbu-186	3 nānāvarṇair loko vyavakīryate /	nānā varṇaiḥ lokaḥ vyavakīryate 
SA_XX_byogalbu-187	vṛkṣamūlāni ca vaiḍūryābhāny antaḥsuṣirāṇi + ca yogācārapādatalaiḥ kāṃcanacakre pratiṣṭhitāni dṛśyante / tataḥ	vṛkṣa mūlāni ca vaiḍūrya ābhāni antar suṣirāṇi ca yoga ācāra pāda talaiḥ kāṃcana cakre pratiṣṭhitāni dṛśyante tatas 
SA_XX_byogalbu-188	4 āśvāsataḥ nīlābhāḥ paṭṭāḥ tadadhirūḍhāni yathoktasmṛtinimittāni /	āśvāsataḥ nīla ābhāḥ paṭṭāḥ tad adhirūḍhāni yathā ukta smṛti nimittāni 
SA_XX_byogalbu-189	bāladārakaś ca vaiḍūryamūlādibhiḥ kāṃcanacakram avatarati praśvasataḥ avadātābhāḥ paṭṭāḥ	bāla dārakaḥ ca vaiḍūrya mūla ādibhiḥ kāṃcana cakram avatarati praśvasataḥ avadāta ābhāḥ paṭṭāḥ 
SA_XX_byogalbu-190	5 tadadhirūḍhāni smṛtinimittāni bāladārakaś ca sarvaśākhābhir niḥsṛtaḥ sarvabuddhānām upari paṭṭacchatraṃ kṛtvā tiṣṭhati /	tad adhirūḍhāni smṛti nimittāni bāla dārakaḥ ca sarva śākhābhiḥ niḥsṛtaḥ sarva buddhānām upari paṭṭa chatram kṛtvā tiṣṭhati 
SA_XX_byogalbu-191	evaṃ paunaḥpuṇyena /	evam paunaḥpuṇyena 
SA_XX_byogalbu-192	punar āśvasataḥ nīlābhamuktāhārādhirūḍhāḥ	punar āśvasataḥ nīla ābha muktā hāra adhirūḍhāḥ 
SA_XX_byogalbu-193	6 eta evāvataranti /	ete eva avataranti 
SA_XX_byogalbu-194	praśvasataḥ avadātamuktāhārādhirūḍhāḥ sarvaśākhāsu sarvabuddhānāṃ muktāhāraṃ chatraṃ kṛtvā tiṣṭhati tadvad ādityaraśmibhiḥ tataḥ sarvaṃ jñeyaṃ	praśvasataḥ avadāta muktā hāra adhirūḍhāḥ sarva śākhāsu sarva buddhānām muktā hāram chatram kṛtvā tiṣṭhati tadvat āditya raśmibhiḥ tatas sarvam jñeyam 
SA_XX_byogalbu-195	YL 127R1 'ntardhīyate cittābhipramodanāyām /	antardhīyate citta abhipramodanāyām 
SA_XX_byogalbu-196	tataḥ yogācārāśrayaḥ candramaṇḍalasaṃkāśaḥ dṛśyate /	tatas yoga ācāra āśrayaḥ candra maṇḍala saṃkāśaḥ dṛśyate 
SA_XX_byogalbu-197	antaḥsamudra utpadyate /	antar samudre utpadyate 
SA_XX_byogalbu-198	dvitīyaṃ bahiḥ āśvāsaparigṛhītaṃ cittaṃ bāladārakarūpī antaḥsamudre	dvitīyam bahis āśvāsa parigṛhītam cittam bāla dāraka rūpī antar samudre 
SA_XX_byogalbu-199	2 nimajjati āśvasataḥ praśvāsaparigṛhītam evaṃ bahiḥsamudre praśvasataḥ cittasamādānāyām / //	nimajjati āśvasataḥ praśvāsa parigṛhītam evam bahis samudre praśvasataḥ citta samādānāyām 
SA_XX_byogalbu-200	ante cāntaḥsamudre nimagnaṃ samādhisukhasaktaṃ paśyati /	ante ca antar samudre nimagnam samādhi sukha saktam paśyati 
SA_XX_byogalbu-201	ulkāsahasrāṇi cāntaḥsamudre	ulkā sahasrāṇi ca antar samudre 
SA_XX_byogalbu-202	3 nipatanti naijvalanti kvathanti evaṃ bāhyasamudre /	nipatanti kvathanti evam bāhya samudre 
SA_XX_byogalbu-203	āśvāsaparigṛhītaḥ sa bāladārakaḥ antaḥsamudre nimajjati praśvāsaparigṛhītaś ca bahiḥ ante ca sphaṭikamayaiḥ	āśvāsa parigṛhītaḥ sa bāla dārakaḥ antar samudre nimajjati praśvāsa parigṛhītaḥ ca bahis ante ca sphaṭika mayaiḥ 
SA_XX_byogalbu-204	4 kūṭāgāraiḥ + + + +ṃ paśyati /	kūṭāgāraiḥ paśyati 
SA_XX_byogalbu-205	anekaśataparivāraṃ muktācitaṃ tataḥ smṛtisahīyo bhagavān utpadya paṭtaṃ badhnāti pāṇḍaraṃ samantataś ca śiraso muktāhārā	aneka śata parivāram muktā ācitam tatas smṛti sahīyaḥ bhagavān utpadya paṭtam badhnāti pāṇḍaram samantataḥ ca śirasaḥ muktā hārā 
SA_XX_byogalbu-206	5 nirgacchanti paṭṭena muktāhāraiś ca + + + + + + + ti /	nirgacchanti paṭṭena muktā hāraiḥ ca 
SA_XX_byogalbu-207	evam anantā lokadhātavaḥ sphaṭikamayaiḥ kūṭāgāraiḥ paripūrṇā dṛśyante /	evam anantāḥ lokadhātavaḥ sphaṭika mayaiḥ kūṭāgāraiḥ paripūrṇāḥ dṛśyante 
SA_XX_byogalbu-208	tadantargatāś ca buddhā bhagavantaḥ anekaśataparivārāḥ	tad antargatāḥ ca buddhāḥ bhagavantaḥ aneka śata parivārāḥ 
SA_XX_byogalbu-209	6 tathaiva + + + + + + + + + + + + + + + + + + parivāram upaguhya tiṣṭhanti /	tathā eva                 parivāram upaguhya tiṣṭhanti 
SA_XX_byogalbu-210	vimuktipratisaṃvedanāyāṃ /	vimukti pratisaṃvedanāyām 
SA_XX_byogalbu-211	tataḥ āśvāsapraśvāsā vajracitāḥ pravartante /	tatas āśvāsa praśvāsāḥ vajra citāḥ pravartante 
SA_XX_byogalbu-212	YL 128V1 lokaṃ cūrṇaṃ viśīryate /	lokam cūrṇam viśīryate 
SA_XX_byogalbu-213	anityānupaśyanāyām / //	anitya anupaśyanāyām 
SA_XX_byogalbu-214	tatas tṛtīy. + + + + kṛtsnaṃ lokaṃ jvālayanti prahāṇānupaśyanāyām / //	tatas tṛtīy kṛtsnam lokam jvālayanti prahāṇa anupaśyanāyām 
SA_XX_byogalbu-215	tair eva jvalitaiḥ kvathamānāṃ jagat kṛtsnaṃ phenarāśir iva davati	taiḥ eva jvalitaiḥ kvathamānām jagat kṛtsnam phena rāśiḥ iva davati 
SA_XX_byogalbu-216	2 virāgānupaśyanāyām / //	virāga anupaśyanāyām 
SA_XX_byogalbu-217	+ + + + + + .ā yogācārāśrayaṃ + + + + śītalajalapariṣiktam iva uparamantaṃ paśyati nirodhānupaśyanāyām / //	             iva uparamantam paśyati nirodha anupaśyanāyām 
SA_XX_byogalbu-218	utthānakāle muktācitaḥ prāsāda utpadya	utthāna kāle muktā ācitaḥ prāsādaḥ utpadya 
SA_XX_byogalbu-219	3 tatrāntaḥ muktācita evāśrayaḥ + bhagavāṃś cāsya śirasi paṭṭaṃ badhnāti /	tatra antar muktā citaḥ eva āśrayaḥ bhagavān ca asya śirasi paṭṭam badhnāti 
SA_XX_byogalbu-220	kathayati caivam ānāpānasmṛtir bhāvayitavyā evaṃ caiṣā bhāvitā suparipūrṇā bhavati	kathayati ca evam āna apāna smṛtiḥ bhāvayitavyā evam ca eṣā bhāvitā su paripūrṇā bhavati 
SA_XX_byogalbu-221	4 devāś ca kṛtsnaṃ gaganaṃ pūryamāṇaḥ puṣparatnavarṣam utsṛjanti iyaṃ pratyutpannānāpānasmṛtibhāvanā /	devāḥ ca kṛtsnam gaganam pūryamāṇaḥ puṣpa ratna varṣam utsṛjanti iyam pratyutpanna an apāna smṛti bhāvanā 
SA_XX_byogalbu-222	anāgatabhāvanāyām /	anāgata bhāvanāyām 
SA_XX_byogalbu-223	nimnaṃ pradeśaṃ paśyati muktācitaṃ tadupari	nimnam pradeśam paśyati muktā ācitam tad upari 
SA_XX_byogalbu-224	5 urupramāṇā bhāsurā manayaḥ ādityamaṇḍaloparisthāḥ tadadhirūḍho yogācāraḥ ātmānaṃ paśyati /	uru pramāṇāḥ bhāsurāḥ manayaḥ āditya maṇḍala upari sthāḥ tad adhirūḍhaḥ yoga ācāraḥ ātmānam paśyati 
SA_XX_byogalbu-225	abhisaṃbuddhaṃ cāryamaitreyam anekaśrāvakasahasraparivāraṃ te ca bhikṣavaḥ kecid	abhisaṃbuddham ca ārya maitreyam aneka śrāvaka sahasra parivāram te ca bhikṣavaḥ kecid 
SA_XX_byogalbu-226	6 dīrghatāsamāpannā dṛśyante kecid yāvan nirodhānupaśyanāyāṃ samāpannā dṛśyante iyatā anāgatabhāvanāyām /	dīrgha tā samāpannāḥ dṛśyante kecid yāvat nirodha anupaśyanāyām samāpannāḥ dṛśyante iyatā anāgata bhāvanāyām 
SA_XX_byogalbu-227	yatrānena bhāvayitavyā me tatkuśalamūlaṃ bhaviṣyati /	yatra anena bhāvayitavyā me tat kuśala mūlam bhaviṣyati 
SA_XX_byogalbu-228	atītabhāvanāyāṃ /	atīta bhāvanāyām 
SA_XX_byogalbu-229	YL 128R1 pratilomaṃ kāśyapādivipaśyiparyantāṃ buddhāṃ saparivārāṃ paśyati tatra cātmānam iva kuśalamūlaṃ bhāvayantaṃ paśyati /	pratiloma kāśyapa ādi vipaśyi paryantām buddhām sa parivāra paś tatra ca ātmānam iva kuśala mūlam bhāvayantam paś 
SA_XX_byogalbu-230	te ca bhagavantaḥ uparyupari dṛśyante //	te ca bhagavantaḥ upari upari dṛśyante 
SA_XX_byogalbu-231	evam iyam ānāpānasmṛtiḥ	evam iyam āna apāna smṛtiḥ 
SA_XX_byogalbu-232	2 saparikarmā saviśeṣā niṣpannā vaktavyā /	sa parikarmā sa viśeṣā niṣpannā vaktavyā 
SA_XX_byogalbu-233	tasmād etac chrutvā yogācāryaiḥ yogācāraiś ca upadeśe bhāvanāyāṃ ca na viṣādaḥ kartavya iti /	tasmāt etat śrutvā yoga ācāryaiḥ yoga ācāraiḥ ca upadeśe bhāvanāyām ca na viṣādaḥ kartavyaḥ iti 
SA_XX_byogalbu-234	ataḥ param anirākṛtadhyāyināṃ smṛtyupasthānanirvedhabhāgīyaśrāmaṇyaphalāni	atas param anirākṛta dhyāyinām smṛti upasthāna nirvedha bhāgīya śrāmaṇya phalāni 
SA_XX_byogalbu-235	3 sasaṃbhārālaṃkārāṇy utpadyante //	sa saṃbhāra alaṃkārāṇi utpadyante 
SA_XX_byogalbu-236	ato 'nantaraṃ dhātuyogaḥ yogaśāstropadiṣṭo 'nusartavyaḥ iha tu prayogamātraṃ darśayiṣyāmaḥ tathaiva	atas nantaram dhātu yogaḥ yoga śāstra upadiṣṭaḥ nusartavyaḥ iha tu prayoga mātram darśayiṣyāmaḥ tathā eva 
SA_XX_byogalbu-237	4 śīlādikṛtaparikarmaṇaḥ pādāṅguṣṭhanakhavivare cittopanibaddhaḥ kāryaḥ tato nakhavivaraṃ makaramukham iva lakṣyate tena cittaṃ praveśayati / yadā	śīla ādi kṛta parikarmaṇaḥ pādāṅguṣṭha nakha vivare citta upanibaddhaḥ kāryaḥ tatas nakha vivaram makara mukham iva lakṣyate tena cittam praveśayati yadā 
SA_XX_byogalbu-238	5 mūrdhānam ūrdhva + + + + + + + + + + + + + + + avasthāpayati /	mūrdhānam ūrdhva 
SA_XX_byogalbu-239	tadupari cittopanibandhaṃ karoti /	tad upari citta upanibandham karoti 
SA_XX_byogalbu-240	tato mūtoḍīvat paripūrṇaṃ nānāprakārair aśucibhiḥ svam āśrayaṃ paśyati /	tatas mūtoḍī vat paripūrṇam nānā prakāraiḥ aśucibhiḥ svam āśrayam paśyati 
SA_XX_byogalbu-241	6 tatra catvāri mahābhūtāni + + + + + + + + + + + + raṃ paśyati /	tatra catvāri mahābhūtāni 
SA_XX_byogalbu-242	ākāśadhātuḥ cakṣuḥsauṣīryādīnāṃ /	ākāśa dhātuḥ cakṣuḥ sauṣīrya ādīnām 
SA_XX_byogalbu-243	vijñānadhātuḥ markaṭabāladārakabinducitolkādīṃ + +	vijñānadhātuḥ markaṭa bāla dāraka binducita ulkā ādīm 
SA_XX_byogalbu-244	YL 129V1 .i / tadvat sarvasatvāśrayeṣu asatvākhyeṣu ca kṛtsnaṃ lokaṃ + + + + + + + nakhavivaramakaraṃ tadaikasmiṃ keśapravāhā nirgacchanti /	i tadvat sarva sattva āśrayeṣu asattva ākhyeṣu ca kṛtsnam lokam         nakha vivara makara tadā eka keśa pravāhāḥ nirgacchanti 
SA_XX_byogalbu-245	samudraparyantāṃ mahāpṛthivīm āpūrya dvitīyapādāṅguṣṭhe	samudra paryantām mahā pṛthivīm āpūrya dvitīya pādāṅguṣṭhe 
SA_XX_byogalbu-246	2 nakhavivaramakarāmukhe nirudhyante .i .i + + + + .r. + + pravāhaspharaṇanirodhau /	nirudhyante i i     r  pravāha spharaṇa nirodhau 
SA_XX_byogalbu-247	evaṃ keśādipuruṣapravāhāḥ spharaṇanirodhau ca /	evam keśa ādi puruṣa pravāhāḥ spharaṇa nirodhau ca 
SA_XX_byogalbu-248	tadvan nānādhātupuruṣapravāhā	tadvat nānā dhātu puruṣa pravāhā 
SA_XX_byogalbu-249	3 spharaṇanirodhau /	spharaṇa nirodhau 
SA_XX_byogalbu-250	ihāśrayaṃ samantaṃ cchidraṃ praṇāḍikāyo + śunyaṃ paśyaty evaṃ sarvasatvāsatvākhyam /	iha āśrayam samantam chidram śunyam paśyati evam sarva sattva asattva ākhyam 
SA_XX_byogalbu-251	tadva + + + bhinnaṃ rajaḥsaṃ + + + paśyati /	tat vai bhinnam rajaḥsam    paśyati 
SA_XX_byogalbu-252	tataḥ sarvaṃ viśīrṇaṃ cūrṇībhūtaṃ	tatas sarvam viśīrṇam cūrṇībhūtam 
SA_XX_byogalbu-253	4 vāyumaṇḍalaparyantam adhaḥ cordhvaṃ yāvad aghaniṣṭhaparyantaṃ paśyati /	vāyu maṇḍala paryantam adhas ca ūrdhvam yāvat agha niṣṭha paryantam paśyati 
SA_XX_byogalbu-254	tāni ca rājāṃsi antaḥśunyāni paśyati śunyatānukūlatvād asya manasikārasya punaḥ kalalāvasthaṃ	tāni ca rājāṃsi antar śunyāni paśyati śunya tā anukūla tvāt asya manasikārasya punar kalala avastham 
SA_XX_byogalbu-255	5 dhātuṣaṭkaṃ paśyati tatra ca āśīviṣā + + + dhātuvarṇāḥ tanmadhye śaṃkham ākāśadhātunimittam /	dhātu ṣaṭkam paśyati tatra ca āśīviṣā dhātu varṇāḥ tad madhye śaṃkham ākāśa dhātu nimittam 
SA_XX_byogalbu-256	tadantargataṃ ca bāladārakamukhaṃ paśyati vijñānadhātunimittam* jīvitatantunānubaddhaṃ	tad antargatam ca bāla dāraka mukham paśyati vijñāna dhātu nimittam jīvita tantunā anubaddham 
SA_XX_byogalbu-257	6 tac ca mātuḥ kukṣāv arbudapeśīghanapraśākhānukrameṇa vardhamānaṃ paśyati jāyamānaṃ bālakaumārayauvamadhyavṛddhā + + jīrṇaṃ vyādhitaṃ mahallakaṃ mrīyamānaṃ cūrṇībhūtaṃ	tat ca mātuḥ kukṣau arbuda peśī ghana praśākhā anukrameṇa vardhamānam paśyati jāyamānam bāla kaumāra yauva madhya vṛddhā jīrṇam vyādhitam mahallakam mrīyamānam cūrṇībhūtam 
SA_XX_byogalbu-258	YL 129R1 tadvat sarvasatvānāṃ yathāsaṃbhava eṣa eva v. .r. + yathoktaḥ cūrṇapuruṣaka utpadyate /	tadvat sarva sattvānām yathā sambhava eṣa eva r yathā uktaḥ cūrṇapuruṣakaḥ utpadyate 
SA_XX_byogalbu-259	tadantaram abhiṣekenāśrayaṃ prīṇayan tato bhrumadhye cittopanibandhaḥ tasmāt pravāho nirgataḥ	tad antaram abhiṣekena āśrayam prīṇayan tatas bhru madhye citta upanibandhaḥ tasmāt pravāhaḥ nirgataḥ 
SA_XX_byogalbu-260	2 pṛthivīmaṇḍalaṃ bhitvā narakāṃ pretāṃś cāvabhāsya kāṃcanacakraṃ bhitvā āpmaṇḍalaṃ	pṛthivī maṇḍalam bhitvā narakām pretān ca avabhāsya kāṃcana cakram bhitvā āp maṇḍalam 
SA_XX_byogalbu-261	vāyumaṇḍalam ākāśadhātum avabhāsya parivartya nābhyāṃ praviśya mūrdhnā nirgatyāvyucchinnaṃ	vāyu maṇḍalam ākāśa dhātum avabhāsya parivartya nābhyām praviśya mūrdhnā nirgatya avyucchinnam 
SA_XX_byogalbu-262	yāvad aghaniṣṭhāṃ devān	yāvat agha niṣṭhām devān 
SA_XX_byogalbu-263	3 avabhāsya caturdhyānarasam ādāya mūrdhnā punaḥ praviśati /	avabhāsya catur dhyāna rasam ādāya mūrdhnā punar praviśati 
SA_XX_byogalbu-264	punar bhrumadhyād ekaḥ pravāho nirgacchati dvitīyo nābhyā miśrībhūtaṃ pṛthivīṃ spharitvā tiṣṭhati /	punar bhru madhyāt ekaḥ pravāhaḥ nirgacchati dvitīyaḥ nābhyā miśrībhūtam pṛthivīm spharitvā tiṣṭhati 
SA_XX_byogalbu-265	pūrvaṃ bhrumadhyād vicchidyte /	pūrvam bhru madhyāt vicchidyate 
SA_XX_byogalbu-266	4 tato nābhyāḥ tato nābhiparyantanimagnaṃ svam āśrayaṃ paśyati sthitiś ca vṛkṣaparipūrṇā dṛśyate tanmūlaniṣaṇṇā bhikṣavo dhātuprayogaṃ bhāvayanti tannakhavivaraniḥsṛtāś ca dhātavaḥ	tatas nābhyāḥ tatas nābhi paryanta nimagnam svam āśrayam paśyati sthitiḥ ca vṛkṣa paripūrṇā dṛśyate tad mūla niṣaṇṇāḥ bhikṣavaḥ dhātu prayogam bhāvayanti tad nakha vivara niḥsṛtāḥ ca dhātavaḥ 
SA_XX_byogalbu-267	5 kṛtsnaṃ lokaṃ spharitvā parasparamakaramukheṣu teṣv eva nirudhyante /	kṛtsnam lokam spharitvā paraspara makara mukheṣu teṣu eva nirudhyante 
SA_XX_byogalbu-268	evaṃ ṣaḍdhātumayaiḥ puruṣaiḥ pṛthivīṃ pūrṇāṃ paśyati /	evam ṣaṣ dhātu mayaiḥ puruṣaiḥ pṛthivīm pūrṇām paśyati 
SA_XX_byogalbu-269	kadācid dhātūṃ vyastāṃ paśyati kadācit samastān /	kadācid dhātūm vyastām paśyati kadācid samastān 
SA_XX_byogalbu-270	ante sarvaṃ nābhyāṃ	ante sarvam nābhyām 
SA_XX_byogalbu-271	6 nirudhyate /	nirudhyate 
SA_XX_byogalbu-272	+ + + + manasikāra + + + + + + + + + + + + + + + + + utpadyate mūrdhata e + + ūrdhvamukhas tiṣṭhati /	                
SA_XX_byogalbu-273	+ .r. + + + lakacitā tārakā praveśaniṣkramaṃ karoti cchidra	R   laka citā tārakā praveśa niṣkramam karoti chidraiḥ 
SA_XX_byogalbu-274	YL 130V1 + + + sa vā lot. k. + + + + + + + + + + taḥ sarvāṇy aśucidravyāṇi ṣaḍdhātumaṇḍalāni ca paśyati /	ro tad vā sarva aśuci dravyāṇi ṣaṣ dhātu maṇḍalāni ca paś 
SA_XX_byogalbu-275	tadvat kṛtsnaṃ lokaṃ satvāsatvākhyaṃ chidrī krīyamāṇaṃ paśyati nābhisthānāntare	tadvat kṛtsnam lokam satva asatva ākhyam chidrī krīyamāṇam paśyati nābhi sthāna antare 
SA_XX_byogalbu-276	2 ca ratnamayaṃ siṃhamukham utpadyate + + + lokaḥ śabdaṃ kurvāṇo nirudhyate /	ca ratna mayam siṃhamukham utpadyate    lokaḥ śabdam kurvāṇaḥ nirudhyate 
SA_XX_byogalbu-277	yogācārāśrayaś ca tasmiṃ niruddhe garuḍamukham utpadyate /	yoga ācāra āśrayaḥ ca tasmin niruddhe garuḍa mukham utpadyate 
SA_XX_byogalbu-278	tadantargataṃ khadyotakrimim iva spandamānaṃ	tad antargatam khadyota krimim iva spandamānam 
SA_XX_byogalbu-279	3 jvalitaṃ vijñānanimittaṃ paśyati r. + + + + + garuḍamukhaṃ parivārya tiṣṭhaṃ tato garuḍamukhāc chabdo nirgacchati layanaṃ ca viśīryate /	jvalitam vijñāna nimittam paśyati        garuḍa mukham parivārya tiṣṭham tatas garuḍa mukhāt śabdaḥ nirgacchati layanam ca viśīryate 
SA_XX_byogalbu-280	ākāśībhūtaṃ ca kṛtsnaṃ lokaṃ paśyati /	ākāśībhūtam ca kṛtsnam lokam paśyati 
SA_XX_byogalbu-281	4 cirakālam upaśamasukham anubhūya vyutthānakāle ratnacitaṃ paṭṭabaddham āśrayam utpadyate /	cira kālam upaśama sukham anubhūya vyutthāna kāle ratna citam paṭṭa baddham āśrayam utpadyate 
SA_XX_byogalbu-282	mūrdhataś ca niḥsṛtaṃ ratnamayaṃ chatram anantāṃ lokadhātūṃ spharitvā tiṣṭhati /	mūrdhataḥ ca niḥsṛtam ratna mayam chatram anantām lokadhātūm spharitvā tiṣṭhati 
SA_XX_byogalbu-283	5 chatradaṇḍaṃ ca kāṃcanacakre pratiṣṭhitaṃ paśyati /	chatra daṇḍam ca kāṃcana cakre pratiṣṭhitam paśyati 
SA_XX_byogalbu-284	sarvasrotobhyaś cāsyākāśanibhāḥ paṭṭā niḥsṛtya kṛtsnaṃ satvasamudram upaguhya tiṣṭhanti /	sarva srotobhyaḥ ca asya ākāśa nibhāḥ paṭṭāḥ niḥsṛtya kṛtsnam satva samudram upaguhya tiṣṭhanti 
SA_XX_byogalbu-285	punaḥ kṛtaparikarmaṇo 'vasthitasamādheḥ	punar kṛta parikarmaṇaḥ vasthita samādheḥ 
SA_XX_byogalbu-286	6 saśastraḥ puruṣa utpadyate + + + + + + + + + + + + + + + + + kṛtsnaṃ lokaṃ + .yā saṃskāragataṃ + + + cchidraṃ śunyam ātmātmīyavirahitaṃ paśyati	sa śastraḥ puruṣaḥ utpadyate                 kṛtsnam lokam yā saṃskāra gatam    chidram śunyam ātma ātmīya virahitam paśyati 
SA_XX_byogalbu-287	sarvasaṃskāragataṃ	sarva saṃskāra gatam 
SA_XX_byogalbu-288	YL 130R1 viśīryantaṃ nirudhyamānaṃ ca paśyati /	viśṛ nirudh ca paś 
SA_XX_byogalbu-289	s. + + + + + + + + + + + + + .y. + .ṛ + + + + + + nirmalena rasena upari cāsya nīlapītalohitāvadātarasaparipūrṇāt	nirmaleṇa raseṇa upari ca asya nīla pīta lohita avadāta rasa paripūrṇāt 
SA_XX_byogalbu-290	2 parvatā dṛśyante ādarśe ca parvatapratibiṃba + + + + + + + + + + + + + + nānāvarṇena rasena āśrayaṃ pūrayati /	parvatāḥ dṛśyante ādarśe ca parvata pratibimba                 nānā varṇena rasena āśrayam pūrayati 
SA_XX_byogalbu-291	ratnabhājanam iva nirmalarasaparipūrṇam āśrayaṃ paśyati /	ratna bhājanam iva nirmala rasa paripūrṇam āśrayam paśyati 
SA_XX_byogalbu-292	3 sthityāṃ ca sarvarasaparipūrṇaṃ parvataṃ + + + + tiṣṭhati /	sthityām ca sarva rasa paripūrṇam parvatam          
SA_XX_byogalbu-293	tasmāt puṣparasanadyaḥ kṣīraghṛtanavanītanadyaḥ nānāvarṇaratnanakṣatracandramaṇḍalanadyaḥ pravilīnā	tasmāt puṣpa rasa nadyaḥ kṣīra ghṛta navanīta nadyaḥ nānā varṇa ratna nakṣatra candra maṇḍala nadyaḥ pravilīnā 
SA_XX_byogalbu-294	4 yogācārāśrayaṃ pūrayanti /	yoga ācāra āśrayam pūrayanti 
SA_XX_byogalbu-295	punaḥ + + + muktasya kṛtaparikarmaṇaḥ avasthitasamādheḥ dvidhāśrayam avatiṣṭhate /	punar    muktasya kṛta parikarmaṇaḥ avasthita samādheḥ dvidhā āśrayam avatiṣṭhate 
SA_XX_byogalbu-296	tatra kakṣyāpuṭa iva nānāśucidravyāṇi /	tatra kakṣyā puṭe iva nānā aśuci dravyāṇi 
SA_XX_byogalbu-297	5 atha kṣu + + + + + + + + + + + + + + caturṣu ca pārśveṣu samudracatuṣṭayaṃ sarvāśuciparipūrṇaṃ paśyati /	atha caturṣu ca pārśveṣu samudra catuṣṭayam sarva aśuci paripūrṇam paśyati 
SA_XX_byogalbu-298	taddarśanasaṃvignasya ca yoginaḥ nirvidabhisūcakaṃ jvalitaṃ	tad darśana saṃvignasya ca yoginaḥ nirvid abhisūcakam jvalitam 
SA_XX_byogalbu-299	6 + + + + + + + + + + + + + + + + + + + + va ante sarvaṃ nirudhyate /	         nirudhyate 
SA_XX_byogalbu-300	ākāśī bhavati ca lokaḥ tata upaśamasukham anubhavati āśrayo lakṣaṇānuvyaṃjanavirājita utpadyate /	ākāśī bhavati ca lokaḥ tatas upaśama sukham anubhavati āśrayaḥ lakṣaṇa anuvyaṃjana virājitaḥ utpadyate 
SA_XX_byogalbu-301	YL 131V1 caturṣu ca pārśveṣu + + + + + + + + nīlapītalohitāvadātāṃ paśyati /	catur ca pārśva          nīla pīta lohita avadāta paś 
SA_XX_byogalbu-302	teṣu kramaśaḥ praviṣṭasya tadvarṇarasenāśrayaḥ pūryate /	teṣu kramaśas praviṣṭasya tad varṇa rasena āśrayaḥ pūryate 
SA_XX_byogalbu-303	padmāni cāpanīyante /	padmāni ca apanīyante 
SA_XX_byogalbu-304	nīlādyābhiś ca svāśrayaprabhābhiḥ	nīla ādyābhiḥ ca sva āśraya prabhābhiḥ 
SA_XX_byogalbu-305	2 kṛtsnaṃ lokam āpūrayati /	kṛtsnam lokam āpūrayati 
SA_XX_byogalbu-306	caturbhyaś ca samudrebhya uttarati /	caturbhyaḥ ca samudrebhyaḥ uttarati 
SA_XX_byogalbu-307	nābhyāś cāsya puṣpapravāho niḥsṛtaḥ caturdhā gacchati /	nābhyāḥ ca asya puṣpa pravāhaḥ niḥsṛtaḥ caturdhā gacchati 
SA_XX_byogalbu-308	samudreṣu caturṣu patati /	samudreṣu caturṣu patati 
SA_XX_byogalbu-309	tataḥ samudrā rasaiḥ pūryante /	tatas samudrāḥ rasaiḥ pūryante 
SA_XX_byogalbu-310	3 padmāni copanīyante /	padmāni ca upanīyante 
SA_XX_byogalbu-311	tato bhrumadhyān nānāratnamayaḥ buddhapravāho nirgataḥ padmeṣu niṣaṇṇo dṛśyate /	tatas bhru madhyāt nānā ratna mayaḥ buddha pravāhaḥ nirgataḥ padmeṣu niṣaṇṇaḥ dṛśyate 
SA_XX_byogalbu-312	pṛthivīdhātuṃ samāpadyamānaḥ tataś ca ghanaḥ pravāhān	pṛthivī dhātum samāpadyamānaḥ tatas ca ghanaḥ pravāhān 
SA_XX_byogalbu-313	4 niḥsṛtaḥ + + + + + + + + + r.ṃ .i + lokaḥ kṛtsna ekaghano dṛśyate /	niḥsṛtaḥ         lokaḥ kṛtsnaḥ eka ghanaḥ dṛśyate 
SA_XX_byogalbu-314	nitāntalohitavarṇaḥ tato 'bdhātuṃ samāpadyate ta eva buddhāḥ tebhya udakapravāhebhyaḥ	nitānta lohita varṇaḥ tatas bdhātum samāpadyate te eva buddhāḥ tebhyaḥ udaka pravāhebhyaḥ 
SA_XX_byogalbu-315	5 + + + + + + + + + + + + + + + + + + + + + + + + + yāḥ iva ca loko lakṣyate /	     iva ca   lakṣyate 
SA_XX_byogalbu-316	tatas tejodhātuṃ samāpadyate /	tatas tejaḥ dhātum samāpadyate 
SA_XX_byogalbu-317	tebhyo nānāvarṇāny arcīṃsi niḥsṛtya ta	tebhyaḥ nānā varṇāni arcīṃsi niḥsṛtya te 
SA_XX_byogalbu-318	6 + + + + + + + + + + + + + + + + + + + + + tato vāyudhātuṃ samāpadyante tebhyo nānāvarṇā vāyukalāpā niḥsṛtya yogācārāśrayaṃ chidrī kurvanti / himābhra	                                                          
SA_XX_byogalbu-319	YL 131R1 iva kṛtsnaṃ lokaṃ paśyati /	yadā iva kṛtsnam lokam paśyati 
SA_XX_byogalbu-320	tata ākāśadhātuṃ samāpadyate /	tatas ākāśa dhātum samāpadyate 
SA_XX_byogalbu-321	+ + + + + + + + .ṛ + + cch. ākāśadhātuvarṇāḥ pravāhā āgacchanti yogācārāśrayaṃ + + + + + hi jīrṇaṃ	ākāśa dhātu varṇāḥ pravāhāḥ āgacchanti yoga ācāra āśrayam       hi jīrṇam 
SA_XX_byogalbu-322	2 kṛtsnaṃ lokaṃ /	kṛtsnam lokam 
SA_XX_byogalbu-323	vaiḍūrya + + + + + + + + + + + + + + + + + buddhā dṛśyante /	vaiḍūrya 
SA_XX_byogalbu-324	pariśuddhabinducitagātrāḥ tatsadṛśāś ca pravāhā āgatā yogācārāśrayaṃ kṛtsnaṃ ca traidhātukaṃ	pariśuddha bindu cita gātrāḥ tad sadṛśāḥ ca pravāhāḥ āgatāḥ yoga ācāra āśrayam kṛtsnam ca traidhātukam 
SA_XX_byogalbu-325	3 spharitvā tiṣṭhanti /	spharitvā tiṣṭhanti 
SA_XX_byogalbu-326	tataḥ kṛtsnaṃ traidhātukaṃ buddhāśrayāṃś ca sūkṣmān avaśyāyabindūn iva spandamānāṃ paśyati /	tatas kṛtsnam traidhātukam buddha āśrayān ca sūkṣmān avaśyāya bindūn iva spandamānām paśyati 
SA_XX_byogalbu-327	punaḥ saṃkṣiptena gṛhītapadmā buddhāḥ yogācārāśrayaṃ padmair vyavakiranti	punar saṃkṣiptena gṛhīta padmāḥ buddhāḥ yoga ācāra āśrayam padmaiḥ vyavakiranti 
SA_XX_byogalbu-328	4 aghaniṣṭhaparyantaṃ lokaṃ padmacitaṃ tadadhirūdhāṃś ca buddhān paśyati yugapat ṣaḍdhātusamāpannān /	agha niṣṭha paryantam lokam padma citam tad adhirūdhān ca buddhān paśyati yugapad ṣaṣ dhātu samāpannān 
SA_XX_byogalbu-329	tanniḥsṛtaiḥ pravāhaiḥ padmapravāhaiś cānekavarṣadhārābhir	tad niḥsṛtaiḥ pravāhaiḥ padma pravāhaiḥ ca aneka varṣa dhārābhiḥ 
SA_XX_byogalbu-330	5 iva svam āśrayaṃ pūryate /	iva svam āśrayam pūryate 
SA_XX_byogalbu-331	+ + + + + + + + + + te /	ro-0 di-1 
SA_XX_byogalbu-332	tata upaśamasukham anubhūya vyutthānakāle ratnacitaṃ ratnavṛkṣādhar niṣaṇṇaṃ cātmānaṃ paśyati /	tatas upaśama sukham anubhūya vyutthāna kāle ratna citam ratna vṛkṣa adhas niṣaṇṇam ca ātmānam paśyati 
SA_XX_byogalbu-333	sa ca ratnavṛkṣaḥ anantaṃ lokaṃ	sa ca ratna vṛkṣaḥ anantam lokam 
SA_XX_byogalbu-334	6 spharitvā tiṣṭhati tataḥ + + + + + + + + ratnavṛkṣād ratnavarṣeṇa kṛtsnaṃ satvasamudram upagūḍhaṃ paśyati /	spharitvā tiṣṭhati tatas         ratna vṛkṣāt ratna varṣeṇa kṛtsnam sattva samudram upagūḍham paśyati 
SA_XX_byogalbu-335	tataḥ samuccālabhedāṃś ca sauṣīryādīṃ paśyati /	tatas samuccāla bhedān ca sauṣīrya ādīm paśyati 
SA_XX_byogalbu-336	dhātuśabdaś ca sarvatra bu	dhātu śabdaḥ ca sarvatra bu 
SA_XX_byogalbu-337	YL 132V1 + + + + + + + + + + + + + + + + pratipakṣasamanantaram ātmadṛṣṭipratipakṣārthaṃ skandhaparīkṣārabhyate /	                                               
SA_XX_byogalbu-338	tatparikarmādau sādhāraṇaṃ maitrāśayādiṃ pūrvoktaṃ / ayaṃ	tad parikarma ādau sādhāraṇam maitrāśaya ādim pūrva uktam ayam 
SA_XX_byogalbu-339	2 + + + + + + + + + + + + + + + pṛthivīṃ sasyarāśipūrṇāṃ paśyati /	              
SA_XX_byogalbu-340	tathā nā + + + + + + + + + + + + bāhyaṃ parikarma ādhyātmikaṃ tu parikarma śarīraṃ paṃcavibhāga	tathā nā           bāhyam parikarma ādhyātmikam tu parikarma śarīram 
SA_XX_byogalbu-341	3 + + + + + + + + + + + ni cāśu + + kūṭāgāraiḥ sphutāṃ pṛthivīṃ paśyati paśyataś cāsya phenapiṇḍam utpadyate /	ca āśu kūṭāgāraiḥ sphutām pṛthivīm paśyati paśyataḥ ca asya phena piṇḍam utpadyate 
SA_XX_byogalbu-342	etad rūpaskandhaparikarma /	etat rūpa skandha parikarma 
SA_XX_byogalbu-343	kṣudrair aśucidravyaiḥ	kṣudraiḥ aśuci dravyaiḥ 
SA_XX_byogalbu-344	4 pṛthivīṃ citāṃ paśyati /	pṛthivīm citām paśyati 
SA_XX_byogalbu-345	tato budbudā utpadyante /	tatas budbudāḥ utpadyante 
SA_XX_byogalbu-346	vedanāskandhaparikarma tataḥ + + + + + + ryaiś ca karanthaiḥ pṛthivīṃ citāṃ paśyati /	vedanā skandha parikarma tatas ca karanthaiḥ pṛthivīm citām paśyati 
SA_XX_byogalbu-347	paśyataś cāsya marīcikalāpā	paśyataḥ ca asya marīci kalāpā 
SA_XX_byogalbu-348	5 utpadyante /	utpadyante 
SA_XX_byogalbu-349	saṃjñāskandhaparikarma /	saṃjñā skandha parikarma 
SA_XX_byogalbu-350	+ + + + + nirhṛtair anyakoṣṭhāgāraiś ca pṛthivīṃ pūrṇāṃ paśyati /	nirhṛtaiḥ anya koṣṭhāgāraiḥ ca pṛthivīm pūrṇām paśyati 
SA_XX_byogalbu-351	+ + + + + kadalīpatravat puṭāpuṭayogenāvatiṣṭhanti /	        avatiṣṭhanti 
SA_XX_byogalbu-352	saṃskāraskandhaparikarma	saṃskāra skandha parikarma 
SA_XX_byogalbu-353	6 + + + + + + + + + + + + + + + + mayaskṛtotpadyante /	        
SA_XX_byogalbu-354	tena spandamānāṃ pṛthivīṃ paśyati vijñānaskandhaparikarma rūpaskandhasya mūlasthānāntarāṇi /	tena spandamānām pṛthivīm paśyati vijñāna skandha parikarma rūpa skandhasya mūlasthāna antarāṇi 
SA_XX_byogalbu-355	kaḍamaṃ lalāṭaṃ mūrdhā	kaḍamam lalāṭam mūrdhā 
SA_XX_byogalbu-356	YL 132R1 + + + + + + + + + + + + + + + + + + + + + + + + + + + + + + + + + + + + + + + + + adhyātmabāhyāni satvāsatvākhyāni śīryamāṇāni paśyati / śīrṇe ca sa	adhyātma bāhya sattva asattva ākhyā śīryamāṇāni paśyati śṛ ca tad 
SA_XX_byogalbu-357	2 + + + + + + + + + + + + + + + + + + svam āśrayaṃ phenapiṇḍamayam utpadyate /	                  
SA_XX_byogalbu-358	tato bhrumadhyāt phenapiṇḍapravāho nirgacchati /	tatas bhru madhyāt phena piṇḍa pravāhaḥ nirgacchati 
SA_XX_byogalbu-359	aghaniṣṭhaparyantāṃ kṛtsnāṃ pṛthivīṃ spharati tato	agha niṣṭha paryantām kṛtsnām pṛthivīm spharati 
SA_XX_byogalbu-360	3 nābhyāṃ nirudhyate /	nābhyām nirudhyate 
SA_XX_byogalbu-361	tataḥ + + + khanibhānāṃ buddhānāṃ pravāha utpadyate /	tatas kha nibhānām buddhānām pravāhaḥ utpadyate 
SA_XX_byogalbu-362	aghaniṣṭhaparyantāṃ kṛtsnāṃ pṛthivīṃ spharati /	agha niṣṭha paryantām kṛtsnām pṛthivīm spharati 
SA_XX_byogalbu-363	punaś ca tatraiva nirudhyate vedanāskandhaparīkṣādhimutiḥ /	punar ca tatra eva nirudhyate vedanā skandha parīkṣā adhimutiḥ 
SA_XX_byogalbu-364	4 svam āśrayam udakabudbudacitāṃ paśyati kāyika + + + + + + + + + + + + + + evaṃ sarvasatvānāṃ tato vāmād aṃsād budbudapravāho niḥsṛtaḥ	svam āśrayam udaka budbuda citām paśyati kāyika              evam sarva satvānām tatas vāmāt aṃsāt budbuda pravāhaḥ niḥsṛtaḥ 
SA_XX_byogalbu-365	5 traidhātukaṃ spharitvā tiṣṭhati /	traidhātukam spharitvā tiṣṭhati 
SA_XX_byogalbu-366	+ + + budbudā udakavarṇāḥ duḥkāyāṃ jvalitā + + + + + + + + + sukhāyāṃ budbudeṣu strīmukhāni dṛśyante /	                           
SA_XX_byogalbu-367	rāgasyādhipatirūpaṃ / jvalite	rāgasya adhipati rūpam jvalite 
SA_XX_byogalbu-368	6 + + + + + + + + + + + + + + + + + + + + + tasmiṃn eva pradeśe tatraiva nirudhyate /	  eva              
SA_XX_byogalbu-369	tataḥ + + + + + + nīlābhānāṃ budbudacitānāṃ buddhānāṃ pravāho nirgacchati /	tatas       nīla ābhānām budbuda citānām buddhānām pravāhaḥ nirgacchati 
SA_XX_byogalbu-370	traidhātukaṃ	traidhātukam 
SA_XX_byogalbu-371	YL 133V1 spharitvā tiṣṭhati /	spharitvā tiṣṭhati 
SA_XX_byogalbu-372	tatraiva ca nirudhyate /	tatra eva ca nirudhyate 
SA_XX_byogalbu-373	saṃjñāskandhaparīkṣādhimuktiḥ + + + + + + + + + + + + spandamānaṃ tato dakṣiṇād aṃsād asya marīcipravāho nirgacchati /	saṃjñā skandha parīkṣā adhimuktiḥ             spandamānam tatas dakṣiṇāt aṃsāt asya marīci pravāhaḥ nirgacchati 
SA_XX_byogalbu-374	2 kṛtsnāṃ pṛthivīṃ spharati /	kṛtsnām pṛthivīm spharati 
SA_XX_byogalbu-375	tataḥ pṛthivīṃ suvarṇavālukācitām iva paśyati /	tatas pṛthivīm suvarṇa vālukā citām iva paśyati 
SA_XX_byogalbu-376	tatraiva ca nirudhyate /	tatra eva ca nirudhyate 
SA_XX_byogalbu-377	tataḥ + + + + + suvarṇābhānāṃ buddhānāṃ pravāho nirgataḥ traidhātukaṃ spharitvā tiṣṭhati /	tatas      suvarṇa ābhānām buddhānām pravāhaḥ nirgataḥ traidhātukam spharitvā tiṣṭhati 
SA_XX_byogalbu-378	3 tatraiva ca nirudhyate /	tatra eva ca nirudhyate 
SA_XX_byogalbu-379	tato + + gaṇḍād vicitrapuṭāpuṭacitaḥ puruṣapravāho nirgataḥ traidhātukaṃ spharitvā kadalīpatrapuṭāpuṭanirbhūjanayogena ca vicitraṃ saṃskāragataṃ	tatas gaṇḍāt vicitra puṭa apuṭa citaḥ puruṣa pravāhaḥ nirgataḥ traidhātukam spharitvā kadalī patra puṭa apuṭa nirbhūjana yogena ca vicitram saṃskāra gatam 
SA_XX_byogalbu-380	4 + + + + + + + nābhyāṃ nirudhyate /	  nirudhyate 
SA_XX_byogalbu-381	tasyā eva nābhyā ākāśanibhānāṃ buddhānāṃ pravāho nirgataḥ /	tasyāḥ eva nābhyāḥ ākāśa nibhānām buddhānām pravāhaḥ nirgataḥ 
SA_XX_byogalbu-382	traidhātukaṃ spharitvā tiṣṭhati /	traidhātukam spharitvā tiṣṭhati 
SA_XX_byogalbu-383	tatraiva nirudhyate vijñānaskandhaparīkṣādhimuktiḥ /	tatra eva nirudhyate vijñāna skandha parīkṣā adhimuktiḥ 
SA_XX_byogalbu-384	5 + + + + + + + + + + + + + + + + + lapravṛttisthānāntarāṇāṃ + ry. t. + + + mā + sā + + + + nām iva pravāho nirgataḥ traidhātukaṃ spharitvā tiṣṭhati /	                                        
SA_XX_byogalbu-385	tadantargatā	tad antargatā 
SA_XX_byogalbu-386	6 + + + + + + + + + + + + + + + + + + + nābhyāṃ nirudhyate /	        
SA_XX_byogalbu-387	tatah1,89] + + + + + + + + + + buddhānāṃ pravāho nirgataḥ traidhātukaṃ spharitvā tiṣṭhati /	        buddhānām pravāhaḥ nirgataḥ traidhātukam spharitvā tiṣṭhati 
SA_XX_byogalbu-388	tatraiva ca nirudhyate /	tatra eva ca nirudhyate 
SA_XX_byogalbu-389	YL 133R1 tadanantaram abhiṣekenāśrayaṃ prīṇayan tato bhrumadhyādhastāt pravāho nirgatya	tad anantaram abhiṣeka āśraya prīṇay tatas bhrū madhya adhastāt pravāha nirgam 
SA_XX_byogalbu-390	yāvad vāyumaṇḍalaṃ bhitvā ākāśāt parivṛtya nābhyāṃ punaḥ praviśya mūrdhnā nirgatya	yāvat vāyu maṇḍalam bhitvā ākāśāt parivṛtya nābhyām punar praviśya mūrdhnā nirgatya 
SA_XX_byogalbu-391	yāvad aghaniṣṭhān avabhāsya	yāvat agha niṣṭhān avabhāsya 
SA_XX_byogalbu-392	2 mūrdhnā punaḥ praviśati /	mūrdhnā punar praviśati 
SA_XX_byogalbu-393	+ + + + + + + + + + + + + + + + + + + + + + + + + + + + + + ti /	ro-0 
SA_XX_byogalbu-394	teṣu vyucchinneṣu tebhyaḥ sthānāntarebhyo yathoktalakṣaṇā buddhā	teṣu vyucchinneṣu tebhyaḥ sthāna antarebhyaḥ yathā ukta lakṣaṇā buddhā 
SA_XX_byogalbu-395	3 niḥsṛtāḥ + + + + + + + + + + + + + .dh. + + + t. + + + + + + + + + + + nirudhyate /	niḥsṛtāḥ 
SA_XX_byogalbu-396	tato niṣṭhānimittam ādityamaṇḍaladvaye 'ntargataṃ paṃcaraṃga	tatas niṣṭhā nimittam āditya maṇḍala dvaye ntargatam 
SA_XX_byogalbu-397	4 + + + + + + + + + + + + t. / tataḥ nīlapītalohitāvadātāḥ pravāhāḥ + + + + + + + gatā āśrayaṃ prīṇayanti krameṇaiva ca nirgatāḥ sthitim āpūrayanti	tatas nīla pīta lohita avadātāḥ pravāhāḥ         gatāḥ āśrayam prīṇayanti krameṇa eva ca nirgatāḥ sthitim āpūrayanti 
SA_XX_byogalbu-398	5 + + + + + + + + + + + + + + + + + + madhye cābhyunnate pradeśe + + + + + + + + + + + + + + + nirmalojjvalaśastracitaṃ pratyavekṣaṇānimittam utpadyate / śa	  ca                                     
SA_XX_byogalbu-399	6 + + + + + + + + + + + + + + + + + + + + ṇāni skandhanimittāni /	        
SA_XX_byogalbu-400	+ + + + + + + + + + + + + tatrāṣṭabhir ākāraiḥ parāmṛśati /	      parāmṛśati 
SA_XX_byogalbu-401	tatra rogataḥ parāmṛśan /	tatra rogataḥ parāmṛśan 
SA_XX_byogalbu-402	YL 134V1 + + + + + + + + + + + + + + + + + + + + + + + + + gaṇḍataḥ parāmṛśan sravata + + + paśyati /	gaṇḍa parāmṛś sravata     paśyati 
SA_XX_byogalbu-403	śalyataḥ parāmṛśan /	śalyataḥ parāmṛśan 
SA_XX_byogalbu-404	rūpaskandhaṃ jarādibhiḥ śalyair viddhaṃ	rūpa skandham jarā ādibhiḥ śalyaiḥ viddham 
SA_XX_byogalbu-405	2 paśyati / aghataḥ parāmṛśan /	paśyati aghataḥ parāmṛśan 
SA_XX_byogalbu-406	rūpaskandhaṃ + + + + + + + + + + rgair upahanyamānaṃ paśyati sūnāsikāṣṭha iva cchidyamānaṃ /	rūpa skandham            rgaiḥ upahanyamānam paśyati sūnā asi kāṣṭhe iva chidyamānam 
SA_XX_byogalbu-407	arūpiṇaḥ skandhāṃ parasparopaghātaiḥ upahanyamānāṃ paśyati /	arūpiṇaḥ paraspara upaghātaiḥ upahanyamānām paśyati 
SA_XX_byogalbu-408	3 anityataḥ parāmṛśan / + + + + + + + + + + + + + /	anityataḥ parāmṛśan 
SA_XX_byogalbu-409	duḥkataḥ parāmṛśan /	duḥkataḥ parāmṛśan 
SA_XX_byogalbu-410	jvalitān ayaspiṇḍasaṃnibhāṃ paśyati /	jvalitān ayaḥ piṇḍa saṃnibhām paśyati 
SA_XX_byogalbu-411	śunyataḥ parāmṛśan /	śunyataḥ parāmṛśan 
SA_XX_byogalbu-412	4 + + + + + + + + + + + + + + + anātmataḥ parāmṛśan /	         
SA_XX_byogalbu-413	+ + + + + svatantrāṃś ca paśyati /	    svatantrān ca paśyati 
SA_XX_byogalbu-414	tato niruddhe sarvasmiṃ jñeye muktācitakūṭāgāre 'ntargataṃ muktācitam eva	tatas niruddhe sarvasmin jñeye muktā ācita kūṭāgāre ntargatam muktā ācitam eva 
SA_XX_byogalbu-415	5 ātmānaṃ paśyati /	ātmānam paśyati 
SA_XX_byogalbu-416	+ + + + + + + + + + + + + + + + + + + + + + + + + + ca medinyāṃ buddhāṃ padmapaṅktim ivāvasthitāṃ paśyati sarvabuddhānāṃ nābhiṣu cādityamaṇḍalāni	ca medinyām buddhām padma paṅktim iva avasthitām paśyati sarva buddhānām nābhiṣu ca āditya maṇḍalāni 
SA_XX_byogalbu-417	6 + + + + + + + + + + + + + + + + + + + + + + + + + + + + + + + m. yaniyāmāvakrāntiphalaprāptivairāgyāsravakṣayadṛṣṭadharmasu	                                        
SA_XX_byogalbu-418	YL 134R1 + + + + + + + + + + + + + + + ātmadṛṣṭipratipakṣārthaṃ ātmadṛṣṭipratipakṣasamanantaraṃ + + + + m. nārthaṃ cāyatanaparīkṣārabhyate /	ātma dṛṣṭi pratipakṣa artha ātma dṛṣṭi pratipakṣa samanantara        na artha ca āyatana parīkṣā ārabhyate 
SA_XX_byogalbu-419	tathaiva śīlādikṛtaparikarmaṇaḥ	tathā eva śīla ādi kṛta parikarmaṇaḥ 
SA_XX_byogalbu-420	2 + + + + + + + + + + + + + + + + + + + + + + + + + + + + + / tata āyatanasthānāntarāṇy āyatanāni ca klinnajvalitaśunyāni paśyati / ta	tatas āyatana sthāna antarāṇi āyatanāni ca klinna jvalita śunyāni paśyati 
SA_XX_byogalbu-421	3 + + + + + + + + + + + + + + + + + + + + + + + + + + bhiś citaṃ kāyaṃ paśyati /	         paśyati 
SA_XX_byogalbu-422	tadvat kṛtsnaṃ lokaṃ paṃcagati .ai + bhiś citaṃ paśyati /	tadvat kṛtsnam lokam paṃcagati ai bhiḥ citam paśyati 
SA_XX_byogalbu-423	narake cakṣu	narake cakṣu 
SA_XX_byogalbu-424	4 + + + + + + + + + + + + + + + + + + + + + + + + + + + sarvaṃ jñeyaṃ grasati /	          grasati 
SA_XX_byogalbu-425	tadvac chrotaghrāṇajihvākāyamanorūpaśabdagandharasaspṛṣṭavyadharmā	tadvat śrota ghrāṇa jihvā kāya manaḥ rūpa śabda gandha rasa spṛṣṭavya dharmā 
SA_XX_byogalbu-426	5 + + + + + + + + + + + + + + + + + + + ādityamaṇḍalaraśmibhir bhinnāṃ paśyati /	          paśyati 
SA_XX_byogalbu-427	evam āyatanacitāṃ dhvajāṃ ādityamaṇḍalāvyatimiśrād ādityamaṇḍalaraśmibhir bhinnāṃ	evam āyatana citām dhvajām āditya maṇḍala a vyatimiśrāt āditya maṇḍala raśmibhiḥ bhinnām 
SA_XX_byogalbu-428	6 paśyati / tataḥ + + + + + + + + + + + + + + + + + + + + + ṇi dṛśyante /	paśyati tatas 
SA_XX_byogalbu-429	tato 'bhiṣekaḥ + + + + le + + + kaḥ prīṇitāśrayasya bhrumadhyādhastāt pravāhaḥ dvādaśāyatana	tatas bhiṣekaḥ             prīṇita āśrayasya bhru madhya adhastāt pravāhaḥ dvādaśa āyatana 
SA_XX_byogalbu-430	YL 135V1 + + + laiva nirgato yāvad vāyumaṇḍalaṃ bhitvākāśāt parivṛtya nābhyāṃ praviśya	nirgam yāvat vāyu maṇḍalam bhid ākāśa parivṛt nābhi praviś 
SA_XX_byogalbu-431	mūrdhnā nirgatya yāvad aghaniṣṭhāṃ devāṃ gatvā punar mūrdhnā praviśya bhrumadhyādhastād	mūrdhnā nirgatya yāvat aghaniṣṭhām devām gatvā punar mūrdhnā praviśya bhru madhya adhastāt 
SA_XX_byogalbu-432	eva nirgatya nābhyāś ca	eva nirgatya nābhyāḥ ca 
SA_XX_byogalbu-433	2 tataḥ sthitir anantaparyantā āyatanaparipūrṇā dṛśyate sthityupari ca parvatā vicitrāyatanacitā dṛśyante /	tatas sthitiḥ ananta paryantā āyatana paripūrṇā dṛśyate sthiti upari ca parvatāḥ vicitra āyatana citāḥ dṛśyante 
SA_XX_byogalbu-434	ante ca sarvaṃ nābhyāṃ nirudhyate /	ante ca sarvam nābhyām nirudhyate 
SA_XX_byogalbu-435	punar āyatanaparīkṣāvahitacetasaḥ pa	punar āyatana parīkṣā avahita cetasaḥ 
SA_XX_byogalbu-436	3 + + + + + + + + dṛśyante / śiraś ca mahāpramāṇaṃ + + tam āyatanāni ca jvalitāgninimagnāni dṛśyante /	dṛśyante śiraḥ ca mahā pramāṇam tam āyatanāni ca jvalita agni nimagnāni dṛśyante 
SA_XX_byogalbu-437	tadvat sarvasatvāḥ tatra bāhyāyatanāni praviśyanti /	tadvat sarva satvāḥ tatra bāhya āyatanāni praviśyanti 
SA_XX_byogalbu-438	4 + + + + + + + + + + + + + + + + .ā .ai + + + .e pṛthivī parvatamahā + .ā + + + jāni tiṣṭhanti /	                     
SA_XX_byogalbu-439	ante ca vi + + + ramā ca tasmiṃ samaye nirvi	ante ca vi      ca tasmin samaye nirvi 
SA_XX_byogalbu-440	5 + + + + + + + + + + + + + + + + + + + + + + + + + + + + + + + + + + + + cakṣuḥ śrotraṃ ghrāṇaṃ jihvā kāyānāṃ yathāsvaviṣayaṃ nipatanti manas tu pradīpa	                                                                
SA_XX_byogalbu-441	6 ivopaśamaṃ gacchati + + + + + + + + + + + + + + + + + tataś cakṣurbhyāṃ pūyarudhirāśrupravāhā nirgacchanti /	iva upaśamam gacchati                 tatas cakṣurbhyām pūya rudhira aśru pravāhāḥ nirgacchanti 
SA_XX_byogalbu-442	śrotrābhyāṃ pūyarudhirakarṇamalapravāhāḥ ghrāṇābhyāṃ pūyarudhirasiṃghāṇakapravāhāḥ	śrotrābhyām pūya rudhira karṇa mala pravāhāḥ ghrāṇābhyām pūya rudhira siṃghāṇaka pravāhāḥ 
SA_XX_byogalbu-443	YL 135R1 jihvāyāḥ pūyarudhiralasikāpravāhāḥ kāyāt pūyarudhirasvedapravāhāḥ stanābhyāṃ kṣīrapravāhāḥ prasrāvapravāhāḥ sarvasrotobhyaḥ pūya	jihvā pūya rudhira lasikā pravāha kāya pūya rudhira sveda pravāha stana kṣīra pravāha prasrāva pravāha sarva srotas pūya 
SA_XX_byogalbu-444	2 + + + + + + + + + + + + + + + + + + + + + + + + + + + + + + + + + + + + + + + + yogācārāśrayaṃ pūrayanti /	                     
SA_XX_byogalbu-445	sa ca satatasamitaṃ sarvasrotobhyaḥ pa	sa ca satata samitam sarva srotobhyaḥ 
SA_XX_byogalbu-446	3 + + + + + + + tato yogācāraniḥsṛtābhir aśucidhārābhiḥ pravāhaḥ s. + + + yāvad vāyumaṇḍalaṃ bhitvā ākāśāt parivartya nābhyāṃ praviśya mūrdhnā	                                                
SA_XX_byogalbu-447	4 kāmāvacarāṃ devāṃ vimānodyānopabhogāṃ rūpāvacarāṃś ca savimānāṃ sarvāśucidhārābhir vikledayan dūṣayaṃś ca gacchaty āgacchati ca mūrdhnā ca	kāmāvacarām devām vimāna udyāna upabhogām rūpāvacarān ca sa vimānām sarva aśuci dhārābhiḥ vikledayan dūṣayan ca gacchati āgacchati ca mūrdhnā ca 
SA_XX_byogalbu-448	5 punas tata eva sthānāṃ niḥsṛtaḥ sthitim āpūrayati /	punar tatas eva sthānām niḥsṛtaḥ sthitim āpūrayati 
SA_XX_byogalbu-449	tasyāṃ sarvasatvā nimagnāḥ sravanto dṛśyante /	tasyām sarva satvāḥ nimagnāḥ sravantaḥ dṛśyante 
SA_XX_byogalbu-450	ante ca sarvaṃ jñeyaṃ nirudhyate /	ante ca sarvam jñeyam nirudhyate 
SA_XX_byogalbu-451	niṣṭhitaḥ prayogaḥ //	niṣṭhitaḥ prayogaḥ 
SA_XX_byogalbu-452	āytanaparīkṣābhiratasya mūrdhni	āytana parīkṣā abhiratasya mūrdhni 
SA_XX_byogalbu-453	6 + + + + + tatrasthaṃ cirakālaṃ śāntā + .irataṃ ca cittaṃ tiṣthati /	              
SA_XX_byogalbu-454	tataḥ ṣaḍāyatananimittam utpadyate + + + āyatanāni yugapad utpannāny ādhāryamāṇāni pravilīyante / tebhyaś	tatas ṣaṣ āyatana nimittam utpadyate    āyatanāni yugapad utpannāni ādhāryamāṇāni pravilīyante tebhyaḥ 
SA_XX_byogalbu-455	YL 136V1 cāyatanarasapuruṣa utpadyate /	ca āyatana rasa puruṣaḥ utpadyate 
SA_XX_byogalbu-456	tasya pārśvebhyo dvāracatuṣṭayam apāvṛtaṃ saṃbhavati /	tasya pārśvebhyaḥ dvāra catuṣṭayam apāvṛtam saṃbhavati 
SA_XX_byogalbu-457	dārebhyaś catasraḥ āyatanacitāḥ śaṃkalāḥ pradīpatantukalāpobhayahastā nirgacchanti /	dārebhyaḥ catasraḥ āyatana citāḥ śaṃkalāḥ pradīpa tantu kalāpa ubhaya hastāḥ nirgacchanti 
SA_XX_byogalbu-458	2 tantukalāpaiś cākṛṣṭāḥ śaṃkalā āyatacitā nirgacchanti /	tantu kalāpaiḥ ca ākṛṣṭāḥ śaṃkalāḥ āyata citāḥ nirgacchanti 
SA_XX_byogalbu-459	diśodiśaḥ ūrdhvaṃ cādhaś ca spharitvā tiṣṭhanti /	diśaḥ diśaḥ ūrdhvam ca adhas ca spharitvā tiṣṭhanti 
SA_XX_byogalbu-460	sa cāyatanarasapuruṣaḥ pravilīyann āyatanarasaparipūrṇā puṣkiriṇī mūrdhnaḥ	sa ca āyatana rasa puruṣaḥ pravilīyan āyatana rasa paripūrṇā puṣkiriṇī mūrdhnaḥ 
SA_XX_byogalbu-461	3 saṃbhavati /	saṃbhavati 
SA_XX_byogalbu-462	tasyāś coṭakākṣād iva pradīpā nirgatya sarvāṇy āyatanāni sarvāś ca śaṃkalāḥ paripavanavac chidrī kurvanti /	tasyāḥ coṭaka akṣāt iva pradīpāḥ nirgatya sarvāṇi āyatanāni sarvāḥ ca śaṃkalāḥ paripavana vat chidrī kurvanti 
SA_XX_byogalbu-463	taiś ca chidrair varṣadhārābhir iva daśabhyo digbhyaḥ	taiḥ ca chidraiḥ varṣa dhārābhiḥ iva daśabhyaḥ digbhyaḥ 
SA_XX_byogalbu-464	4 yogācārāśrayaṃ pūryate /	yoga ācāra āśrayam pūryate 
SA_XX_byogalbu-465	tata āyatanarasasamudram antaḥ paśyati /	tatas āyatana rasa samudram antar paśyati 
SA_XX_byogalbu-466	pradīpāś ca kṛtsnaṃ lokaṃ paripavanavac chidrī kṛtvā yogācārāśraye patitās tadvat taṃ chidrī kurvanti /	pradīpāḥ ca kṛtsnam lokam paripavana vat chidrī kṛtvā yoga ācāra āśraye patitāḥ tadvat tam chidrī kurvanti 
SA_XX_byogalbu-467	5 samantataḥ chidraṃ durbalaṃ srutasāraṃ ca sarvajagat paśyati /	samantataḥ chidram durbalam sruta sāram ca sarva jagat paśyati 
SA_XX_byogalbu-468	eṣā śunyatānukūlā parīkṣā /	eṣā śunyatā anukūlā parīkṣā 
SA_XX_byogalbu-469	tataḥ brahmabhiḥ ratnapuṣpamuktānakṣatrāyatanacitaiḥ kṛtsnaṃ gaganaṃ pūrnaṃ paśyati /	tatas brahmabhiḥ ratna puṣpa muktā nakṣatra āyatana citaiḥ kṛtsnam gaganam pūrnam paśyati 
SA_XX_byogalbu-470	6 tebhyaś cāyatanebhyaḥ rasadhārāḥ patitāḥ sarvaṃ śaṃkalāsu tadāśraye ca nipatitāḥ yathoktaśubhanimittāyatanacitaṃ jagad avasthāpayanti /	tebhyaḥ ca āyatanebhyaḥ rasa dhārāḥ patitāḥ sarvam śaṃkalāsu tad āśraye ca nipatitāḥ yathā ukta śubha nimitta āyatana citam jagat avasthāpayanti 
SA_XX_byogalbu-471	tato ghṛtapiṇḍavat pravilīnaṃ jñeyaṃ	tatas ghṛta piṇḍa vat pravilīnam jñeyam 
SA_XX_byogalbu-472	YL 136R1 sarvaṃ tadāśraye praviśati /	sarvam tad āśraye praviśati 
SA_XX_byogalbu-473	eṣā upaśamānukūlāvasthā tataḥ sarvasrotobhyaḥ buddhapratyekabuddhaśrāvakāḥ padmādhirūḍhā yathoktalakṣaṇāyatanacitāḥ sarvadigvidiśaḥ ūrdhvam adhaś ca	eṣā upaśama anukūlā avasthā tatas sarva srotobhyaḥ buddha pratyekabuddha śrāvakāḥ padma adhirūḍhāḥ yathā ukta lakṣaṇa āyatana citāḥ sarva diś vidiśaḥ ūrdhvam adhas ca 
SA_XX_byogalbu-474	2 spharitvā tiṣthanti /	spharitvā tiṣthanti 
SA_XX_byogalbu-475	ante ca tadāśraye anityam anityam iti śabdam udīrayantaḥ praviśanti /	ante ca tad āśraye anityam anityam iti śabdam udīrayantaḥ praviśanti 
SA_XX_byogalbu-476	āyatanaprayoganiṣpattiḥ //	āyatana prayoga niṣpattiḥ 
SA_XX_byogalbu-477	bhavabhogatṛṣṇāpratipakṣānantaraṃ /	bhava bhoga tṛṣṇā pratipakṣa anantaram 
SA_XX_byogalbu-478	mohapratipakṣārthaṃ pratītyasamutpādaparīkṣārabhyate /	moha pratipakṣa artham pratītyasamutpāda parīkṣā ārabhyate 
SA_XX_byogalbu-479	3 sa ca dvividhaḥ bāhyaḥ ādhyātmakaś ca satvāsatvākhyaś ca bāhyo dvividhaḥ pratiṣṭhitotpattikramabhedāt /	sa ca dvividhaḥ bāhyaḥ ādhyātmakaḥ ca satva asatva ākhyaḥ ca bāhyaḥ dvividhaḥ pratiṣṭhita utpatti krama bhedāt 
SA_XX_byogalbu-480	ā + + + + ttr. dhānusartavyaḥ tatra hi ṣaḍ.	ā ttr dha anusartavyaḥ tatra hi ṣaṣ 
SA_XX_byogalbu-481	4 + + .o niśrayo deśitaḥ ādhārakaḥ saṃdhārakaḥ utpattiḥ pratiṣṭhā prajñaptiḥ spṛhaniśrayaś ca tatrādhārako niśrayaḥ brāhmaṇakā mantrāḥ pudgalaṃ niḥśṛtāḥ saṃdhārakaḥ	niśrayaḥ deśitaḥ ādhārakaḥ saṃdhārakaḥ utpattiḥ pratiṣṭhā prajñaptiḥ spṛhā niśrayaḥ ca tatra ādhārakaḥ niśrayaḥ brāhmaṇakāḥ mantrāḥ pudgalam niḥśṛtāḥ saṃdhārakaḥ 
SA_XX_byogalbu-482	5 pudgalā vrīhīyavāṃ niḥśṛtāḥ utpattiḥ vrīhiyavāḥ pṛthivīṃ niḥśṛtāḥ pratiṣṭhā /	pudgalāḥ vrīhī yavām niḥśṛtāḥ utpattiḥ vrīhi yavāḥ pṛthivīm niḥśṛtāḥ pratiṣṭhā 
SA_XX_byogalbu-483	pṛthivy āpsu pratiṣṭhitā /	pṛthivī ā apsu pratiṣṭhitā 
SA_XX_byogalbu-484	āpaḥ vāyau vāyur ākāśe prajñaptiḥ āloke saty ākāśaṃ prajñāyate prajñaptiniḥśrayaḥ	āpaḥ vāyau vāyuḥ ākāśe prajñaptiḥ āloke sati ākāśam prajñāyate prajñapti niḥśrayaḥ 
SA_XX_byogalbu-485	6 spṛhaniśrayaḥ + + + ry.ḥ caturmahārājike + + yo va + + + + + + + + + + + + + mitam iti /	caturmahārājike 
SA_XX_byogalbu-486	tatparīkṣā parikarma /	tad parīkṣā parikarma 
SA_XX_byogalbu-487	pādāṃguṣṭhe gomayapiṇḍaṃ tadantargatāni	pādāṃguṣṭhe gomaya piṇḍam tad antargatāni 
SA_XX_byogalbu-488	YL 137V1 + + + + + + + + + + + + + + + + + + + + + + + + + + + + padmajam ity eva kukkuṭyāṇḍavad anādipr. + + + + + + + + + + + + + + + + +	                          
SA_XX_byogalbu-489	2 + + + + + + + + + + + + + + + + + + + + + + + + + + + + sa evaṃ bāhye pratītyasamutpāde kṛtakauśalaḥ ādhyātmapratītyasamutpāde 'vatarati /	            evam                            
SA_XX_byogalbu-490	3 + + + + + + + + + + + + + + + + + + + + + + pratiṣṭhitaṃ yāvac chīrṣakapālaṃ grīvāsthipratiṣṭhitaṃ paśyati /	                paśyati 
SA_XX_byogalbu-491	evaṃ sarvarūpāṇāṃ satvānāṃ tatra kṛtakauśalaḥ	evam sarva rūpāṇām satvānām tatra kṛta kauśalaḥ 
SA_XX_byogalbu-492	4 + + + + + + + + + + + + + + + + + + + + + + + krameṇa yāvaj jarāmaraṇa + + + + + + + + + + + + + + + + .o + .i	            
SA_XX_byogalbu-493	5 + + + + + + + + + + + + + + + + + + + + + + + + + + + + + + + + + + + raḥ pratyekabuddhajñā + + + + + + + + + + + + + + + + +	raḥ pratyekabuddha jñā 
SA_XX_byogalbu-494	6 + + + + + + + + + + + + + + + + + + + + + + + + + + + + + + + + + + + yam atītam avidyās. + + + + + + + + + + + + + + + + + + + + +	ro-0 
SA_XX_byogalbu-495	YL 137R1 + + + + + + + + + + + + + + + + + + + + + + + + + + + + + + + + + + + + ptopādānāni kleśāvasth. + + + + + + + + + + + + + + + + + +	di-30 di-30  /                                                     
SA_XX_byogalbu-496	2 + + + + + + + + + + + + + + + + + + + + + + + + + + + + + + + + + + + + + spharitvā tiṣṭhati + + + + + + + + + + + + + + + + + + + +	ro-0 
SA_XX_byogalbu-497	3 + + + + + + + + + + + + + + + + + + + + + + + + + + + saṃskārādhipatirūpam /	            
SA_XX_byogalbu-498	puruṣa + + + + + + + + + + + + + .k. c. t. karma karoti /	puruṣa 
SA_XX_byogalbu-499	4 + + + + + + + + + + + + + + + + + + + + + + + + agnijvālāntargatam agnitilakaṃ cetanāyā adhipatirūpam /	                       
SA_XX_byogalbu-500	punas trividhāḥ saṃskārāḥ puṇyāḥ apuṇyāḥ āniñjyāḥ	punar trividhāḥ saṃskārāḥ puṇyāḥ apuṇyāḥ āniñjyāḥ 
SA_XX_byogalbu-501	5 + + + + + + + + + + + + + + + + + + + + + + + + ḥ tridhyānopagāś ca puṇyānāṃ saṃskārāṇāṃ / ja + + + + + .i + + + + +ṃ + r.. + + + + +	tri dhyāna upagāḥ ca puṇyānām saṃskārāṇām 
SA_XX_byogalbu-502	6 + + + + + + + + + + + + + + + + + + + + + + + + + + nīlavarṇāṃkuracitaḥ parvataḥ tadantargatā + + + + + + + + + + + + + + + + + + + +	                      
SA_XX_byogalbu-503	YL 138V1 + + + + + (gap 138V2 to V5; ca. 200 Akṣaras)	y       gap to ca 
SA_XX_byogalbu-504	5 + + + + + + + + + + rāmukhā vijñānāvasthā jātiḥ nāmarūpa +	         
SA_XX_byogalbu-505	6 + + + + + + + + + + + + + + + + + + + + + + + + + + + + + + + + + + + + + + + + + + + + sarvasatvānāṃ yathāsaṃbhavataḥ paśyati / tataḥ	sarva sattvānām yathā sambhavāt paśyati tatas 
SA_XX_byogalbu-506	YL 138R1 + + + + + + + + + + + + + + + + + + + + + + + + + + + + + + + + + + + + + + + + + + + + + + + + + pratītyasamutpādasūtram vistareṇa	ro-0 di-1 di-1 di-1  /                            pratītyasamutpāda sūtra vistareṇa 
SA_XX_byogalbu-507	2 + + + + + + + + + + + + + + + + + + + + + + + + + + + + + + + + + + + + + + + + + + + + + + .icakre nipatanti / evam + + + .i .ā +	               
SA_XX_byogalbu-508	3 + + + + + + + + + + + + + + + + + + + + (gap 138R4 to 139V2; ca. 290 Akṣaras)	     ca   
SA_XX_byogalbu-509	YL 139V2 + + + + + + + māraparivāraṃ nirjitya prati + + + + + + + + + + + + + + + + + .y. d. ty. + + + + +	di      māra parivāra nirji 
SA_XX_byogalbu-510	3 + + + + + + + + + + + + + + + + + + lā niḥsṛtāḥ avidyādhipatirūpāṇi pūrayanti vicakrī bhavati ca dvādaśāṃgaṃ pratītyasamutpādacakraṃ	niḥsṛtāḥ avidyā adhipati rūpāṇi pūrayanti vicakrī bhavati ca dvādaśa aṅgam pratītyasamutpāda cakram 
SA_XX_byogalbu-511	4 tato m. + + + + + + + + + + + + + + + + + + + + lokam avabhāsya bodhisatvamūrdhani pariśāntaṃ paśyati abhisaṃbuddhaṃ bodhiṃ + + + + + +	diś diś                                                  
SA_XX_byogalbu-512	5 mahākaruṇāveṇikasmṛtyupasthāna + + + + + + + + + + + + + + + + + + + + + + + go bhaviṣyati + + + + + + + + + + + + + + + + + + + +	bhaviṣyati 
SA_XX_byogalbu-513	6 tamānāṃ paśyati mahākaruṇa + + + + + + + + + + + + + + + + + + + + + + + + + + + + + + + + + + + + + + + + + + + + + + + saṃskārasāṃtānikaṃ	paśyati mahā karuṇa 
SA_XX_byogalbu-514	YL 139R1 dvādaśāṃgaṃ pratītyasamutpādacakraṃ + + + + + + + + + + + + + + + + + + + + + + + + + + + + + +	dvādaśan aṅga pratītyasamutpāda cakra 
SA_XX_byogalbu-515	2 dṛśyante / teṣāṃ vi + + + + + + + + + + + + + + + + + + + + + + + + + + + + + + krameṇāt. n + + + + + + + + + + + + + + + + + + bhagavataḥ	dṛśyante teṣām vi 
SA_XX_byogalbu-516	3 śrāvakaparivāra + + + + + + + + + + + + + + + + + + + sthitir ante ca sarvaṃ yogācārasya nābhyāṃ nirudhyata iti vyutthānam / + + + +	                             
SA_XX_byogalbu-517	4 + + + + + + + + + + + + + + + + + + + + + + + puṇyena vicārayataḥ a .i .e + r.. + + bhavatīti //	              r bhavati iti 
SA_XX_byogalbu-518	ajñānapratipakṣānantaraṃ krodhapratipakārthaṃ	ajñāna pratipakṣa anantaram krodha pratipaka artham 
SA_XX_byogalbu-519	5 + + + + + + + + + + + + + + + + + + + + + + + + + + + + + + +ṃ + saṃvṛtyanukra + + + + + + + + + + + + + + + + + + + +ṃ + + .i + +	ro-0 
SA_XX_byogalbu-520	6 + + + + + + + atha kiṃsvabhāvā maitrī tad ucyate /	       ucyate 
SA_XX_byogalbu-521	adveṣeti sā svabhāvā /	a dveṣā iti sā svabhāvā 
SA_XX_byogalbu-522	sā tu sapratipakṣā sānuparivartā sasaṃprayogā parigṛhyamānā /	sā tu sa pratipakṣā sa anuparivartā sa saṃprayogā parigṛhyamānā 
SA_XX_byogalbu-523	kāmāvacarā catuḥskandhasvabhāvā /	kāma avacarā catur skandha svabhāvā 
SA_XX_byogalbu-524	rūpāvacarā	rūpa avacarā 
SA_XX_byogalbu-525	YL 140V1 paṃcaskandhasvabhāvā /	pañca skandha svabhāvā 
SA_XX_byogalbu-526	āśraye kāmadhātvāśrayā /	āśraye kāmadhātu āśrayā 
SA_XX_byogalbu-527	ālaṃbane kāmadhātvālaṃbanā bhūmibhedena saptabhaumā kāmadhātur anāgamyaś catvāri dhyānāni dhyānāntaraṃ ca hitasukhopasaṃhāra	ālaṃbane kāmadhātu ālaṃbanā bhūmi bhedena sapta bhaumā kāmadhātuḥ anāgamyaḥ catvāri dhyānāni dhyāna antaram ca hita sukha upasaṃhāra 
SA_XX_byogalbu-528	2 + + + + + + + + + + tatprayogaḥ + + + + + + + + + + adhimātrādhimātre mitre mṛduni evam udāsīne /	                              
SA_XX_byogalbu-529	tathā amitre mṛduni madhya adhimātre yadā yadṛśam a	tathā amitre mṛduni madhya adhimātre yadā yadṛśam a 
SA_XX_byogalbu-530	3 + + + + + + + + + + + + + + + + + + + + sarvasatvahitasukhādhyāśayapravṛttā tadā + + + + + + + + + + + satvānāṃ hitat. + + + +	                         
SA_XX_byogalbu-531	4 + + + + + + + + + + + + + + + + + + + + + + + + + + + + + + + + + + + + + + + + + + + + + mam ivātmānaṃ mahā + +	mam iva ātmānam mahā 
SA_XX_byogalbu-532	5 + + + + + + + + + + + + + + + + + + + + + + + + + + + + + + + + + + + + + + + + + + + .ākāraṃ vidhimantaṃ paśyati + + .o .āyo + + + +	ākāram vidhimantam paśyati 
SA_XX_byogalbu-533	6 + + + + + + + + + + + + + + + + + + + + + + + + + + + + + + + + + + + + + + + + + + + satvānāṃ lakṣaṇānuvyaṃjanavirājitā buddhā + + +	ro-0 
SA_XX_byogalbu-534	YL 140R1 + + + + + + + + + + + + + + + + + + + + + + + + + + + + + + + + + + + + + + + + + + + + d. ca yathābhilaṣita utpadyate + + + + + +	ca yathā abhilaṣ utpad 
SA_XX_byogalbu-535	2 + + + + + + + + + + + + + + + + + + + + + + + + + + + + + + + + + + + + + + + + + + + hṛdayaṃ tatra cittopanibandhaṃ + + + + + + + + 3 + +	                     
SA_XX_byogalbu-536	4 + + + + + + + + + + + + + + + + + + + + + + + + + + + + + + + n. va krameṇa sarvasatvān mātṛ + + + + + + + + + + + + + + + + + + + +	            
SA_XX_byogalbu-537	5 + + + + + + + + + + + + + + + + + + + + + + + + + + + + + + punaḥ sarvathā viṣaṃcayataḥ nābhūt sa + + + + + + + + + + + + + + + + + v. sa	                        
SA_XX_byogalbu-538	6 + + + + + + + + + + + + + + + + + + + + + + + + + + + + + opasaṃharati ayaṃ dvitīya avadāra + + + + + + + + + + + + + + + + satvānām a	                     
SA_XX_byogalbu-539	YL 141V1 + + + + + + + + + + + + + + + + + + + + + + + + + + + + + + + + + + + + + + + + + + + rāṇi hitasukhopasaṃhāraḥ sthānāntaram / hitasukhā	rāṇi hita sukha upasaṃhāraḥ sthāna antara 
SA_XX_byogalbu-540	2 + + + + + + + + + + + + + + + + + + + + + + + + + + + + + + + + + + + + + + + + + + + s. .o + hanāsthānāntaraṃ ca hitasukhopasaṃhārasthā	                                                                
SA_XX_byogalbu-541	3 + + + + + + + + + + + + + + + + + + + + + + + + + + + + + + + + + + + + + + + + + + + saṃhṛtāni sa tān satvāṃ paśyati dṛṣṭvā cāsya	saṃhṛtāni sa tān paśyati dṛṣṭvā ca asya 
SA_XX_byogalbu-542	4 + + + + + + + + + + + + + + + + + + + + + + + + + + + + + + + + + + + + + + + + + + + yanti ca kṣīrasamudre ca nimagnāḥ	yanti ca kṣīra samudre ca nimagnāḥ 
SA_XX_byogalbu-543	5 + + + + + + + + + + + + + + + + + + + + + + + + + + + + + + + + + + + + + + + + + + + + + + + + + + + + + + +ṃ .ī n. la .epanāmaya	di-di-di-di-di-di-di-di-di-di-
SA_XX_byogalbu-544	6 + + + + + + + + + + + + + + + + + + + + + + + + + + + + + + + + + + + + + + + + + + + + + + + + + + + + senāpatir bhavati / umāpatiḥ	              bhū   
SA_XX_byogalbu-545	YL 141R1 + + + + + + + + + + + + + + + + + + + + + + + + + + + + + + + + + + + + + + + + + + + + + + + + + + + + + + + + + + + + + + + + + + + + + v. .y. .t. satvān.	ro
SA_XX_byogalbu-546	2 + + + + + + + + + + + + + + + + + + + + + + + + + + + + + + + + + + + + + + + + + + + + + + + + cittopanibandhaṃ kṛtvā cintayati dīrgharātraṃ	                                                                                         
SA_XX_byogalbu-547	3 + + + + + + + + + + + + + + + + + + + + + + + + + + + + + + + + + + + + + + + + + + + + lā deśāḥ sasatvā dagdhāḥ taṃma	deśāḥ sa sattvā dagdhāḥ 
SA_XX_byogalbu-548	4 + + + + + + + + + + + + + + + + + + + + + + + + + + + + + + + + + + + + + + maitrāśayasya satveṣu hṛdayadvāram apāvriyate /	                       
SA_XX_byogalbu-549	5 + + + + + + + + + + + + + + + + + + + + + + + + + + + + + + + + + + + + + + + + + + sarvasatvānāṃ duḥkhāny upaśamayanti te ca ta eva nadyo	sarva satvānām duḥkhāni upaśamayanti te ca te eva 
SA_XX_byogalbu-550	6 + + + + + + + + + + + + + + + + + + + + + + + + + + + + + + + + + + + + + + + + + ḥ antarāśrayapraviṣṭāḥ rājabhir eva brahmabhiḥ ṣaḍdantair	antar āśraya praviṣṭāḥ rājabhiḥ eva brahmabhiḥ ṣaṣ dantaiḥ 
SA_XX_byogalbu-551	2 hṛdaye suvarṇā + + + + + + + + + + + + + + + + + + + + + + + + + + + + + + + + + + + + + + + + + + yām ucitānucitāyāṃ y. + + + +	hṛdaye suvarṇā 
SA_XX_byogalbu-552	3 + + + + + + + + + + + + + + + + + + + + + + + + + upadeśasthānāntaraṃ jihvāgra + + + + cittopanibandhaṃ kṛtvā dhyāti dīrgharātraṃ + + + +	                               
SA_XX_byogalbu-553	4 + + + + + + + + + + + + + + + + + + + + + + + + + priyahitasukhopadeśe + + + + satvān anugṛhṇīyām /	                       
SA_XX_byogalbu-554	tasyaivaṃ cittas. + + + +	tasya evam cittaḥ 
SA_XX_byogalbu-555	5 + + + + + + + + + + + + + + + + + + + + + + + (gap 142V6 to R2; ca. 185 Akṣaras)	      ca   
SA_XX_byogalbu-556	YL 142R2 + + + + + + + + + + maitrāśayasaha + + + + + + + + + + paśyeyām iti / tasyaivam. + + + +	di-di- di-iti  tasya evam   /
SA_XX_byogalbu-557	3 + + + + + + + + + + + + + + + + + + + + + + + + + niḥsṛtāḥ aṃjalibhiḥ satvāṃ pi + + + + + t. paśyati evaṃ candramaṇḍalasaṃkāśābhir nadībhiḥ	niḥsṛtāḥ añjalibhiḥ sattvām pi diśati evam candra maṇḍala saṃkāśābhiḥ nadībhiḥ 
SA_XX_byogalbu-558	4 c. t. + + + + + + + + + + + + + + + + + + + + + + + + + + + + + + + + + + + + mukhadvāre dakṣiṇāyāṃ daṃṣṭrāyāṃ cittopanibandhaṃ	                                                                     
SA_XX_byogalbu-559	5 kṛtvā paśyati /	kṛtvā paśyati 
SA_XX_byogalbu-560	+ + + + + + + + + + + + + + + + + + + + + + + + + + + + + + + + + + + + + + + + + + maitrāśayasya kalyāṇā + + + + +	ro-0 
SA_XX_byogalbu-561	6 + + + + + + + + + + + + + + + + + + + + + + + + kramaḥ tasyaivaṃ bhavati /	                            
SA_XX_byogalbu-562	+ + + + + + + + + + + + + + + + + + + + + + kṣīravṛkṣo + + + +	ro-0 
SA_XX_byogalbu-563	YL 143V1 lam āśrayaṃ pūrayati pūrṇe cāśraye mūrdhataḥ kṣīrastambhaḥ iva nirgataḥ	āśraya pūray pṛ ca āśraya mūrdhan kṣīra stambha iva nirgam 
SA_XX_byogalbu-564	abhrakūṭa iva gaganam āpūrya kṣīravarṣaṃ muñcati yena sthitir āpūryate tatra prāsādā	abhra kūṭaḥ iva gaganam āpūrya kṣīra varṣam muñcati yena sthitiḥ āpūryate tatra prāsādāḥ 
SA_XX_byogalbu-565	urupramāṇā utpadyante	uru pramāṇāḥ utpadyante 
SA_XX_byogalbu-566	2 tadantargatānāṃ sarvasatvānāṃ sapta pariṣatsaṃpadām upasaṃharati ājñādhipatyasaṃpad yathā cakravartināṃ /	tad antargatānām sarva satvānām sapta pariṣad saṃpadām upasaṃharati ājñā ādhipatya saṃpad yathā cakravartinām 
SA_XX_byogalbu-567	ārakṣādhipatyasaṃpad yathā caturṇāṃ mahārājānām /	ārakṣa ādhipatya saṃpad yathā caturṇām mahārājānām 
SA_XX_byogalbu-568	viṣayaparibhogādhipatyasaṃpad	viṣaya paribhoga ādhipatya saṃpad 
SA_XX_byogalbu-569	3 yathā trayastriṃśatām /	yathā trayastriṃśatām 
SA_XX_byogalbu-570	kāmādhipatyasaṃpad yathā mārāṇāṃ /	kāma ādhipatya saṃpad yathā mārāṇām 
SA_XX_byogalbu-571	+ + .ādhipatyasaṃpad yathā brahmaṇāṃ svayamavabodhādhipatyasaṃpad yathā pratyekajinānām /	ādhipatya saṃpad yathā brahmaṇām svayam avabodha ādhipatya saṃpad yathā pratyeka jinānām 
SA_XX_byogalbu-572	4 dharmacakrapravartanādhipatyasaṃpad yathā samyaksaṃbuddhānām /	dharma cakra pravartana ādhipatya saṃpad yathā samyaksaṃbuddhānām 
SA_XX_byogalbu-573	+ + + + + + + krameṇa varṇasaṃsthāno + + + bhāvopetān sarvasatvāṃ paśyati sarvadante +	          paśyati sarva   
SA_XX_byogalbu-574	5 + + + + + + + + + + + + + + + + + + + + + + + + + + + + + + + + d. dāḥ saṃbhavanti /	           
SA_XX_byogalbu-575	tadantargatāṃś ca satvāṃ paśyati /	tad antargatān ca satvām paśyati 
SA_XX_byogalbu-576	tata āloka +ṃ + +	tatas ālokaḥ 
SA_XX_byogalbu-577	6 + + + + + + + + + + + + + + + + + + + + + + + + + + + + + + + + + + + + + + + + + + + + vaiḍūryamayī strī saṃprajanya + + + + + + +	ro-0 
SA_XX_byogalbu-578	YL 143R1 + + + + + + + + + + + + + + + + + + + + + + + + + + + + + + + + + + + + + + + + + + + + + + + + + + + + + + + + + + + + + + + guṇenānāgate 'dhvani + +	ro-0 di-1 di-1 di-1  /                                                     guṇa anāgata dhvani 
SA_XX_byogalbu-579	2 + + + + + + + + + + + + + + + + + + + + + + + + + + + + + + + + + + + + + maṇḍalenātikra + + + + + + + + + + + + .i + y. pratipakṣe + + +	ro-0                                                              
SA_XX_byogalbu-580	3 + + + + + + + + + + + + + + + + + + + + + + + + + + + + + kṣeṇa iti yatraivā + + + + + + + + ā + + rakṣāsthānāntaram ity ucyate /	                          iti ucyate 
SA_XX_byogalbu-581	4 satvodvahana + + + + + + + r. + + + + + + + + + + + + .v. maitrāśayasya ratnamayaḥ + .ā + śirasy utpadyate /	                 
SA_XX_byogalbu-582	anantaparyantaṃ svāstīrṇaparyaṃkas tadadhirūḍhān	ananta paryantam su āstīrṇa paryaṃkaḥ tad adhirūḍhān 
SA_XX_byogalbu-583	5 satvān udvahati /	satvān udvahati 
SA_XX_byogalbu-584	punas tasyaivaṃ bhavati mayā sarvasatvāḥ bhārai + + + pīḍitā mātṛbhūtāś cāntaḥkukṣigatā + ṇ. + .āraṃ pīḍitāḥ kathaṃ + + .e + satvān udvaheyam iti tasyaivaṃ	punar tasya evam bhavati mayā sarva satvāḥ bhāraiḥ pīḍitāḥ mātṛ bhūtāḥ ca antar kukṣi gatāḥ pīḍitāḥ katham satvān udvaheyam iti tasya evam 
SA_XX_byogalbu-585	6 maitrāśayasya hṛdayadvāram apāvriyante /	maitrāśayasya hṛdaya dvāram apāvriyante 
SA_XX_byogalbu-586	tebhyaḥ kṣīrapravāhā nirgatāḥ /	tebhyaḥ kṣīra pravāhāḥ nirgatāḥ 
SA_XX_byogalbu-587	teṣu sarvasatvā nimagnās tadanusāreṇaivāśrayaṃ	teṣu sarva satvāḥ nimagnāḥ tad anusāreṇa eva āśrayam 
SA_XX_byogalbu-588	YL 144V1 praviśanti /	praviśanti 
SA_XX_byogalbu-589	tadāśraye + + tāsu vaiḍūryadaṇḍāni padmāni /	tad āśraye tāsu vaiḍūrya daṇḍāni padmāni 
SA_XX_byogalbu-590	tatkarṇikāsu ca kṣīrapuṣkiriṇyaḥ padmadaṇḍānusāreṇādhiruhya sarvasatvāś ca kṣīrapuṣkiriṇīṣu nimagnāḥ sāṃkucitapattrādhirūḍhā	tad karṇikāsu ca kṣīra puṣkiriṇyaḥ padma daṇḍa anusāreṇa adhiruhya sarva satvāḥ ca kṣīra puṣkiriṇīṣu nimagnāḥ sāṃkucita pattra adhirūḍhā 
SA_XX_byogalbu-591	2 dṛṣyante / mūrdhnaś cāsya padmaṃ saṃbhavati tanniṣaṇṇo bhagavāṃ dharmaṃ deśayati /	dṛṣyante mūrdhnaḥ ca asya padmam saṃbhavati tad niṣaṇṇaḥ bhagavān dharmam deśayati 
SA_XX_byogalbu-592	tac chrutvā vikasitebhyaḥ padmebhyas tulyāṃ prītim anubhavanti sarvasatvāḥ teṣu ca padmanāḍeṣu padmapaṃktayo	tat śrutvā vikasitebhyaḥ padmebhyaḥ tulyām prītim anubhavanti sarva satvāḥ teṣu ca padma nāḍeṣu padma paṃktayaḥ 
SA_XX_byogalbu-593	3 'nantaparyantāḥ saṃbhavanti /	nanta paryantāḥ saṃbhavanti 
SA_XX_byogalbu-594	tadadhirūḍhā brahmarūpiṇaḥ satvā dṛśyante /	tad adhirūḍhāḥ brahma rūpiṇaḥ satvāḥ dṛśyante 
SA_XX_byogalbu-595	evaṃ suvarṇeṣu nīlalohitāvadātavarṇeṣu ca sarvasatvāṃ sarvagātraiḥ samudvahaṃ parāṃ prītiṃ	evam suvarṇeṣu nīla lohita avadāta varṇeṣu ca sarva satvām sarva gātraiḥ samudvaham parām prītim 
SA_XX_byogalbu-596	4 samanubhavati /	samanubhavati 
SA_XX_byogalbu-597	caṃkramaniṣadyābhyāṃ sarveryāpatheṣu codvahato 'sya satvāṃ parā prītir utpadyate /	caṃkrama niṣadyābhyām sarva īryāpatheṣu ca udvahataḥ sya satvām parā prītiḥ utpadyate 
SA_XX_byogalbu-598	punar maitrīprayukta + + + + kramati na viṣaṃ na śastraṃ kāye /	punar kramati na viṣam na śastram kāye 
SA_XX_byogalbu-599	vaiḍūryamayīṃ	vaiḍūrya mayīm 
SA_XX_byogalbu-600	5 pṛthivīṃ vaiḍūryamayavajrāsanaracitāṃ tanmadhye vajrāmayaḥ āśrayo vajrāsanādhirūḍhaḥ yogina utpadyate /	pṛthivīm vaiḍūrya maya vajrāsana racitām tad madhye vajra āmayaḥ āśrayaḥ vajrāsana adhirūḍhaḥ yoginaḥ utpadyate 
SA_XX_byogalbu-601	tadupari sarvasatvāḥ sarvapraharaṇāni kṣipanti tāni puṣpabhūtāni tatra	tad upari sarva satvāḥ sarva praharaṇāni kṣipanti tāni puṣpa bhūtāni tatra 
SA_XX_byogalbu-602	6 nipatanti / tad eva vajrāsanaṃ teṣām aviṣayī bhavati teṣu cānyeṣu vajrāsaneṣu buddhā uṣṇīṣapūrvadarśanāt krameṇodgacchanto dṛśyante /	nipatanti tat eva vajrāsanam teṣām aviṣayī bhavati teṣu ca anyeṣu vajrāsaneṣu buddhāḥ uṣṇīṣa pūrva darśanāt krameṇa udgacchantaḥ dṛśyante 
SA_XX_byogalbu-603	teṣām uṣṇīṣaprabhayā kṛtsnaṃ jagad indranīlābhaṃ dṛśyate /	teṣām uṣṇīṣa prabhayā kṛtsnam jagat indranīla ābham dṛśyate 
SA_XX_byogalbu-604	YL 144R1 ūrṇāprabhayā candrāvadātaṃ gātraprabhayā kanakaprabhaṃ /	ūrṇā prabhayā candra avadātam gātra prabhā kanaka prabham 
SA_XX_byogalbu-605	aṣṭanakhaprabhābhiḥ padmarāgābhaṃ te bhagavantaḥ mūrdhata ekaikaṃ + + + + yogācārāśrayaṃ veṣṭayanti /	aṣṭa nakha prabhābhiḥ padmarāga ābham te bhagavantaḥ mūrdhataḥ ekaikam yoga ācāra āśrayam veṣṭayanti 
SA_XX_byogalbu-606	vajrācalakūṭaprakhyo	vajra acala kūṭa prakhyo 
SA_XX_byogalbu-607	2 'vatiṣṭhati /	avatiṣṭhati 
SA_XX_byogalbu-608	punar api ca sarvasatvāḥ sarvapraharaṇāgniviṣādīṃś cādāya siṃhavyāghrādayaś ca tam abhidravante tasya maitrāśayasya mūrdhnā nadī kṣīramayābhrakūṭavaṃ nirgatya sarvaṃ gaganam	punar api ca sarva satvāḥ sarva praharaṇa agni viṣa ādīn ca ādāya siṃha vyāghra ādayaḥ ca tam abhidravante tasya maitrāśayasya mūrdhnā nadī kṣīra mayā abhra kūṭavam nirgatya sarvam gaganam 
SA_XX_byogalbu-609	3 āpūrya prākāravat sarvasatvān upaguhya tiṣṭhati /	āpūrya prākāra vat sarva satvān upaguhya tiṣṭhati 
SA_XX_byogalbu-610	te ca satvā muktasaṃraṃbhapraharaṇās tam eva praṇamantīti /	te ca satvāḥ mukta saṃraṃbha praharaṇāḥ tam eva praṇamanti iti 
SA_XX_byogalbu-611	punar maitrāśayasyaivāyam anyo viśeṣa utpadyate svam āśrayaṃ	punar maitra āśayasya eva ayam anyaḥ viśeṣaḥ utpadyate svam āśrayam 
SA_XX_byogalbu-612	4 sarvamaraṇapratyayaiḥ parivṛtaṃ paśyati /	sarva maraṇa pratyayaiḥ parivṛtam paśyati 
SA_XX_byogalbu-613	āśrayāc cāsya brahmāṇo nirgatya tāṃ maraṇapratyayān udvīkṣate tataḥ sarvamaraṇapratyayanirmuktaṃ candramaṇḍalādhirūḍhaṃ	āśrayāt ca asya brahmāṇaḥ nirgatya tām maraṇa pratyayān udvīkṣate tatas sarva maraṇa pratyaya nirmuktam candra maṇḍala adhirūḍham 
SA_XX_byogalbu-614	5 candrasaṃkāśaṃ cātmānaṃ paśyati /	candra saṃkāśam ca ātmānam paśyati 
SA_XX_byogalbu-615	tadvat sarvasatvānāṃ maraṇapratyayāṃ maraṇāpanayanaṃ paśyati /	tadvat sarva satvānām maraṇa pratyayām maraṇa apanayanam paśyati 
SA_XX_byogalbu-616	te ca satvāḥ candramaṇḍalaraśmyā ūrdhvaṃ + + + .āśrayaṃ praviśanti /	te ca satvāḥ candra maṇḍala raśmyāḥ ūrdhvam āśrayam praviśanti 
SA_XX_byogalbu-617	sa ca cakravartyāśrayaṃ	sa ca cakravarti āśrayam 
SA_XX_byogalbu-618	6 sa ca brahmāśrayaṃ sa ca buddhāśrayaṃ buddhāśraye brahmāśrayo dṛśyate yāvad yoginaḥ āśraye sarvasatvāśrayāḥ tatra bhagavāṃ su + + + + + + + + + +ṃ pṛthivyāṃ caṃkramati nikṣipte	sa ca brahma āśrayam sa ca buddha āśrayam buddha āśraye brahma āśrayaḥ dṛśyate yāvat yoginaḥ āśraye sarva satva āśrayāḥ tatra bhagavān su 
SA_XX_byogalbu-619	YL 145V1 + + + + + + + + + nirgataḥ tadrasapūrṇaṃ siṃcati utkṣipte paryaṃkena niṣaṇṇasya kṣīravṛkṣo mūrdhanirgato 'nantaṃ lokadhātuṃ spharitvā tiṣṭhati / + + + + + + + + + + + +	nirgam tad rasa pṛ sic utkṣip paryaṅka niṣad kṣīravṛkṣaḥ mūrdha nirgam nantam lokadhātum spharitvā sthā 
SA_XX_byogalbu-620	2 + + + + + + + + + satvā niḥsṛtābhiḥ kṣīradhārābhiḥ siktamātrā eva muktasaṃraṃbhapraharaṇā maitrāvihāriṇaṃ praṇamanti /	                              
SA_XX_byogalbu-621	evaṃ maitrāśayasya + + + + + + + + + + +	evam maitrāśayasya 
SA_XX_byogalbu-622	3 + + + + + + + + + kuta eva bhagavato buddhasyeti //	       kutas eva bhagavataḥ buddhasya iti 
SA_XX_byogalbu-623	punaḥ maitrāśayasyānantaṃ paryantaṃ satvasamudram abhimukhī bhavati / + + + + + + + + + + + + +	punar maitrāśayasya anantam paryantam sattva samudram abhimukhī bhavati 
SA_XX_byogalbu-624	4 + + + + + + + + + + abhiṣekaiḥ siṃcyamāno dṛśyate /	         
SA_XX_byogalbu-625	evaṃ suvarṇanīlapītalohitāvadātarasābhiṣekaiḥ + + + + + sadṛśaḥ dṛśyate / + + + + +	evam suvarṇa nīla pīta lohita avadāta rasa abhiṣekaiḥ      sadṛśaḥ dṛśyate      
SA_XX_byogalbu-626	5 + + + + + + + + + + niḥsṛtābhir dhārābhiḥ siktāḥ satvāḥ tatsadṛśā eva dṛśyante /	           eva dṛśyante 
SA_XX_byogalbu-627	tataḥ sauvarṇaṃ padmaṃ daśadiśaḥ spharitvā sarvasatvān upaguhya tiṣṭhati /	tatas sauvarṇam padmam daśa diśaḥ spharitvā sarva satvān upaguhya tiṣṭhati 
SA_XX_byogalbu-628	samaṃ ca tato + +	samam ca tatas 
SA_XX_byogalbu-629	6 + + + + + + + + + + + satvānāṃ viśeṣaṃ paśyati /	     paśyati 
SA_XX_byogalbu-630	sarvasatvahitādhyāśayapravṛttaḥ ity eṣā apramāṇo maitrīvihāraḥ āśrayāpramāṇatayā apramāṇā ālaṃbanāpramāṇatayā	sarva satva hita adhyāśaya pravṛttaḥ iti eṣā apramāṇaḥ maitrīvihāraḥ āśraya apramāṇa tayā apramāṇā ālaṃbana apramāṇa tayā 
SA_XX_byogalbu-631	YL 145R1 + + + .āpramāṇatayā puṇyaprasavāpraṃāṇatayāpramāṇeti kṛtaparikarmaṇo maitrāśayasya apramāṇapradānasthānāntarā+ + + + .upanibaddhacetasaś cirakālaṃ śāntaṃ	ro āpramāṇa tā kṛ parikarman maitra āśaya apramāṇa pradāna sthāna antarā     upanibaddha cetasaḥ cira kālam śāntam 
SA_XX_byogalbu-632	2 + + + + sarvasatvahitādhyāśayapravṛttaṃ cittam anuvartate tadā dhāraṇāc ca cchatrapradeśe	        anuvartate     ca     
SA_XX_byogalbu-633	nīlavarṇo nīlāṃkuraparivāro maṇiḥ utpadyate tadvat sarvasrotobhyaḥ nīlavarṇānīlāṃkuraparivārā	nīla varṇaḥ nīla aṃkura parivāraḥ maṇiḥ utpadyate tadvat sarva srotobhyaḥ nīla varṇā a nīla aṃkura parivārā 
SA_XX_byogalbu-634	3 maṇaya utpadyante tadvarṇaniḥsṛtānekarasadhārāsahasrāṇi satveṣu nipatanti /	maṇayaḥ utpadyante tad varṇa niḥsṛta aneka rasa dhārā sahasrāṇi satveṣu nipatanti 
SA_XX_byogalbu-635	satvāś ca pibanto dṛśyante tato maṇayo 'bhivṛddhamaitrāśayasya + + + + + + +	satvāḥ ca pibantaḥ dṛśyante tatas maṇayaḥ 
SA_XX_byogalbu-636	4 + + + + + + + + + adhastān nirgatāḥ satvāḥ parigṛhya prīyaikaputrakavat staneṣu śleṣayanti tato 'bhivṛddhamaitrāśayasya + + + + + + + + +	adhastāt nirgatāḥ sattvāḥ parigṛhya prīya eka putraka vat staneṣu śleṣayanti tatas 
SA_XX_byogalbu-637	5 + + + + + + kṛtsnaṃ lokaṃ spharitvā tiṣṭhati /	            
SA_XX_byogalbu-638	tato 'ṣṭau mahānarakān ṣoḍaśotsadamahāparivārāṃ saha śītanarakais tīryakpretamanuṣyāṃś ca apanītas. + + + + + + + + + + + +	ṣṭau mahānarakān ṣoḍaśa utsada mahā parivārām saha śīta narakaiḥ tīryak preta manuṣyān ca 
SA_XX_byogalbu-639	6 + + + + + yogācārāśrayāṃ pariṣaṇḍādhirūḍhāṃ paśyati /	                  
SA_XX_byogalbu-640	tadupari ṣaṭ kāmāvacarāṃ devāṃ rūpāvacarāṃś ca caturdhyānopapannāṃ sthānāntarapari + + + + + + + + + + + +	tad upari ṣaṭ kāmāvacarām devām rūpāvacarān ca catur dhyāna upapannām 
SA_XX_byogalbu-641	YL 146V1 ti / sarvapariṣaṇḍāni sauvarṇakūṭāgāraparivāritāni tadantargatāṃś ca buddhāṃ bhagavataḥ tejodhātusamāpannāṃ paśyati uparīmāṃś ca pariṣaṇḍāṃ snigdhā + + + + + + + + + + +	ti sarva pariṣaṇḍāni sauvarṇa kūṭāgāra parivāritāni tad antargatān ca buddhām bhagavataḥ tejaḥ dhātu samāpannām paśyati upari imān ca pariṣaṇḍām 
SA_XX_byogalbu-642	2 sarvatra .ā .ī + + + + + + pūrayitvā kāṃcanacakre nipatitā yāvad aghaniṣṭhāṃ sthānāntaram āpūrya tiṣṭhanti snigdhasuvarṇarasaṃ samudranimagna	sarvatra ā ī      pūrayitvā kāṃcana cakre nipatitāḥ yāvat agha niṣṭhām sthāna antaram āpūrya tiṣṭhanti snigdha suvarṇa rasam samudra nimagna 
SA_XX_byogalbu-643	3 ya pariṣaṇḍāṃ ku + + + + tair buddhavapurdhāribhiḥ abhisaṃkṣipte cāsmiṃ nīlalohitāvadātaṃ samāpadyābhinirharati /	taiḥ buddha vapuḥ dhāribhiḥ abhisaṃkṣipte ca asmin nīla lohita avadātam samāpadya abhinirharati 
SA_XX_byogalbu-644	+ + + + + + + + + + + vītarāgāṇāṃ	       
SA_XX_byogalbu-645	4 tribhiḥ rūpaiḥ pravartate adhipativibhāganiṣyandarūpaiḥ avītarāgāṇām ekena adhipatirūpeṇaiva tataḥ kūṭāgāra + + + + + + + + + + + + + + +	tribhiḥ rūpaiḥ pravartate adhipati vibhāga nisyanda rūpaiḥ avīta rāgāṇām ekena adhipati rūpeṇa eva tatas 
SA_XX_byogalbu-646	5 yogācārāśrayeṣu yogācārāśrayo 'bhisaṃkṣiptaḥ yathāpaurāṇo 'vastiṣṭhate ity eṣo 'paraḥ apramāṇo maitrīvihāraḥ āśrayāpramāṇatayālaṃbanāpramāṇatayā + + + āpramāṇatayā	yoga ācāra āśrayeṣu yoga ācāra āśrayaḥ abhisaṃkṣiptaḥ yathā paurāṇaḥ vaḥ tiṣṭhate iti eṣa u paraḥ apramāṇaḥ maitrīvihāraḥ āśraya apramāṇa tayā ālaṃbana apramāṇa tayā  / āpramāṇa tayā 
SA_XX_byogalbu-647	6 puṇyaprasavāpramāṇatayāpramāṇeti vyutthitasyāpi niṣyandam anuvartate āśrayam anantaraparyantāṃ sauvarṇaguhāṃ + + + + + + + + + + + + + + +	puṇya prasava apramāṇa tayā apramāṇā iti vyutthitasya api nisyandam anuvartate āśrayam anantara paryantām sauvarṇa guhām 
SA_XX_byogalbu-648	YL 146R1 pannam adhaḥ kāṃcanacakre pratiṣṭhitaṃ nānāratnacitaiḥ padmair niṣaṇṇair	pannam adhas kāṃcana cakre pratiṣṭhitam nānā ratna citaiḥ padmaiḥ niṣaṇṇaiḥ 
SA_XX_byogalbu-649	ūrdhvād aghaniṣṭhaparyantaṃ tiryakto 'nantaparyantaḥ sauvarṇā guhā pari + + + + + + + + + + + + + + + + +	ūrdhvāt agha niṣṭha paryantam tiryaktas nanta paryantaḥ sauvarṇā guhā 
SA_XX_byogalbu-650	2 padmeṣu satvā niṣaṇṇās tejodhātusamāpannā buddhavapurdhāriṇo dṛśyante madhye cānantabhāsuraṃ nānāratnacitaṃ sahasrāracakraṃ tadvat sa + +	padmeṣu satvāḥ niṣaṇṇāḥ tejaḥ dhātu samāpannāḥ buddha vapuḥ dhāriṇaḥ dṛśyante madhye ca ananta bhāsuram nānā ratna citam sahasra āra cakram tadvat sa 
SA_XX_byogalbu-651	3 m indranīlapadmarāgasphaṭikavarṇe sarvāḥ eṣa eva kramaḥ tato yugapac caturvarṇābhiṣekaḥ caturvarṇapadmā gu + + + + + + + + + + + + + + + +	indranīla padmarāga sphaṭika varṇe sarvāḥ eṣaḥ eva kramaḥ tatas yugapad catur varṇa abhiṣekaḥ catur varṇa padmā 
SA_XX_byogalbu-652	4 ś caturvarṇapadmāḥ /	ś catur varṇa padmāḥ 
SA_XX_byogalbu-653	tadadhirūḍhāś caturvarṇā buddhā bhagavantaḥ prabhābhir lokam avabhāsya tiṣṭhantīty etāvan maitrābhiṣeka + + + + + + + adhaś ca lokam āpūrya	tad adhirūḍhāḥ catur varṇāḥ buddhāḥ bhagavantaḥ prabhābhiḥ lokam avabhāsya tiṣṭhanti iti etāvat maitrābhiṣeka         adhas ca lokam āpūrya 
SA_XX_byogalbu-654	5 ūrdhvaṃ ca / suvarṇavarṇacaturvarṇamaitrābhiśekaś ca /	ūrdhvam ca suvarṇa varṇa catur varṇa maitra abhiśekaḥ ca 
SA_XX_byogalbu-655	tadrasaparipūrṇaḥ parvataḥ tasmāc catvāraḥ pravāhāḥ kācapārībhiḥ śarīraṃ pūrayanti suvarṇa + + + + + + + + + + + + svam	tad rasa paripūrṇaḥ parvataḥ tasmāt catvāraḥ pravāhāḥ kāca pārībhiḥ śarīram pūrayanti suvarṇa                
SA_XX_byogalbu-656	6 āśrayaṃ lakṣyate /	āśrayam lakṣyate 
SA_XX_byogalbu-657	tato bhrumadhyādhar nimnapradeśāt kṣīrapravāho nirgatya pṛthivīmaṇḍalaṃ bhitvā apāyagatānāṃ satvānāṃ sarvaduḥkhopaśamaṃ kṛtvā yāvad vāyumaṇḍalaṃ bhitvā parivartya nābhyāṃ	tatas bhru madhya adhas nimna pradeśāt kṣīra pravāhaḥ nirgatya pṛthivī maṇḍalam bhitvā apāya gatānām satvānām sarva duḥkha upaśamam kṛtvā yāvat vāyu maṇḍalam bhitvā parivartya nābhyām 
SA_XX_byogalbu-658	YL 147V1 praviśya mūrdhnā nirgatya yāvad aghaniṣṭhāṃ gatvā parivartya kāmārūpārūpyāvacaradevaparivṛto mūrdhnā praviśati /	praviś mūrdhan nirgam yāvat agha niṣṭhā gam parivartay kāma ārūpa ārūpya avacara deva parivṛ mūrdhan praviśati 
SA_XX_byogalbu-659	punas tata eva sthānāṃ niḥsṛto nābhyāś ca sthitim āpūrayati /	punar tatas eva sthānām niḥsṛtaḥ nābhyāḥ ca sthitim āpūrayati 
SA_XX_byogalbu-660	ādau gulakād	ādau gulakāt 
SA_XX_byogalbu-661	2 vicchidyate /	vicchidyate 
SA_XX_byogalbu-662	tato nābhyāḥ /	tatas nābhyāḥ 
SA_XX_byogalbu-663	nābhiparyantanimagnaṃ cātmānaṃ paśyati nābhiniḥsṛtāś ca devāḥ sthitim āpūrya tiṣṭhanti hṛdaye ca kṣīrapuṣkiriṇī taṃnimagnaṃ nakṣatraṃ maitrāśayaparigṛhītasya adhipatirūpam /	nābhi paryanta nimagnam ca ātmānam paśyati nābhi niḥsṛtāḥ ca devāḥ sthitim āpūrya tiṣṭhanti hṛdaye ca kṣīrapuṣkiriṇī taṃ nimagnam nakṣatram maitra āśaya parigṛhītasya adhipati rūpam 
SA_XX_byogalbu-664	3 taṃnirjātam amṛtarasam ivendrāyudhavarṇā strī nirmalena bhājanena gṛhītvā daśadiśaḥ ākṣipya ca sarvān satvāṃ pareṇa sukhena saṃyojayati	tat nirjātam amṛta rasam iva indrāyudha varṇā strī nirmalena bhājanena gṛhītvā daśa diśaḥ ākṣipya ca sarvān satvām pareṇa sukhena saṃyojayati 
SA_XX_byogalbu-665	4 maitrī sthitim āpūrayati tato nirudhyata iti vyutthānam / //	maitrī sthitim āpūrayati tatas nirudhyate iti vyutthānam 
SA_XX_byogalbu-666	yogavinyāsā yogālaṃkārā uktāś ca viśeṣās ta eva śa + + + + .ai + + + + + nirākaraṇīyo + sarvavyāpādā	yoga vinyāsāḥ yoga alaṃkārāḥ uktāḥ ca viśeṣāḥ te eva sarva vyāpādā 
SA_XX_byogalbu-667	5 + + + .ānuśaṃsāś cotpadyante /	     ca utpadyante 
SA_XX_byogalbu-668	yad uta sukhaṃ svapiti sukhaṃ pratibudhyate suptaṃ enaṃ devatā rakṣanti /	yat uta sukham svapiti sukham pratibudhyate suptam enam devatāḥ rakṣanti 
SA_XX_byogalbu-669	na ca pāpakaṃ svapnaṃ paśyati kramati na viṣaṃ na śastraṃ kāye +	na ca pāpakam svapnam paśyati kramati na viṣam na śastram kāye 
SA_XX_byogalbu-670	6 + + + + + + + + + + + + + ḥ priyo devamanuṣyāṇāṃ brahmaṇā ca praśaṃsitāḥ anāgāmiphalaṃ prāpnoty uttare cāpratividhya brahmalokasya svabhāvatāyām upagacchati //	                                            
SA_XX_byogalbu-671	krodhapratipakṣānantaram / {zu V4-6 cf. SHT 620 und SHT IV p. 339}	krodha pratipakṣa anantaram 
SA_XX_byogalbu-672	YL 147R1 parasukhahitāpanayanakāraṇāviṣkaraṇārtham /	para sukha hita apanayana kāraṇa āviṣkaraṇa artha 
SA_XX_byogalbu-673	vyāpādapratipakṣānantaraṃ vyāpādaniṣyanda vihiṃsāviṣkaraṇārtham / + + + + + + + + +	             
SA_XX_byogalbu-674	2 pratipakṣānantaraṃ + + + + ḍakāraṇapratipakṣāviṣkaraṇārtham /	              
SA_XX_byogalbu-675	karuṇāprayoganirdeśaḥ kriyate /	karuṇā prayoga nirdeśaḥ kriyate 
SA_XX_byogalbu-676	atha kiṃsvabhāvā karuṇā tad ucyate / + + + + + + + + +	atha kiṃsvabhāvā karuṇā tat ucyate 
SA_XX_byogalbu-677	3 sapratipakṣeti /	sa pratipakṣā iti 
SA_XX_byogalbu-678	sā tu sānuparivartā sasaṃprayogā parigṛhyamānā kāmāvacarā catuḥskandhasvabhāvā /	sā tu sa anuparivartā sa saṃprayogā parigṛhyamānā kāma avacarā catur skandha svabhāvā 
SA_XX_byogalbu-679	rūpāvacarā paṃcaskandhasvabhāvā / āśraye	rūpa avacarā paṃca skandha svabhāvā āśraye 
SA_XX_byogalbu-680	4 kāmāśrayā / ālaṃbane kāmadhātvālaṃbanā /	kāma āśrayā ālaṃbane kāmadhātu ālaṃbanā 
SA_XX_byogalbu-681	bhūmitaḥ saptabhaumā /	bhūmitaḥ sapta bhaumā 
SA_XX_byogalbu-682	kāmadhātau anāgamye caturṣu dhyāneṣu dhyānāntare ca /	kāmadhātau anāgamye caturṣu dhyāneṣu dhyāna antare ca 
SA_XX_byogalbu-683	+ + .ityādi //	ityādi 
SA_XX_byogalbu-684	tatprayogaḥ adhimātrādhimātraṃ	tad prayogaḥ adhimātra adhimātram 
SA_XX_byogalbu-685	5 mitraṃ + + + .aśubhamalinavasanaṃ kṛpaṇaṃ kṛṣṇam anuprāptaṃ vivṛtaviniguhyadveśabhayaśokaviṣādāratimātsaryerṣyāpa + .t.ḥ cāsya dṛṣṭvā paraṃ kāruṇyam utpadyate	mitram aśubha malina vasanam kṛpaṇam kṛṣṇam anuprāptam ca asya dṛṣṭvā param kāruṇyam utpadyate 
SA_XX_byogalbu-686	6 evaṃ madhyaṃ mrduṃ tadvad udāsīnaṃ mṛdumadhyādhimātraṃ cāmitraṃ kramaśaḥ tad anekaśārīramānasaiḥ duḥkhair upahataṃ dṛṣṭvā kāruṇyam utpadyate	evam madhyam mrdum tadvat udāsīnam mṛdu madhya adhimātram ca amitram kramaśas tat aneka śārīra mānasaiḥ duḥkhaiḥ upahatam dṛṣṭvā kāruṇyam utpadyate 
SA_XX_byogalbu-687	tato 'sya karuṇārtasya	karuṇā ārtasya 
SA_XX_byogalbu-688	YL 148V1 bhruvor madhye kṛṣṇataptaṃ piṭakam utpadyate /	bhruvoḥ madhya kṛṣṇa tap piṭakam utpad 
SA_XX_byogalbu-689	+ + + + + + + + + + + + + + mūrdhno niḥsṛtā strī kṣīradhārābhiḥ śarīram avasiṃcati yāvad vedanopaśāmyati tasmāc charīrāt	             avasiṃcati yāvat vedanā upaśāmyati tasmāt śarīrāt 
SA_XX_byogalbu-690	2 kṣīradhārābhiḥ sarvasatvasamudraḥ plāvyate /	kṣīra dhārābhiḥ sarva satva samudraḥ plāvyate 
SA_XX_byogalbu-691	tato naśyamānāṃ sarvasatvānāṃ śārīramānasaduḥkhāṃ paśyati /	tatas naśyamānām sarva satvānām śārīra mānasa duḥkhām paśyati 
SA_XX_byogalbu-692	punas tathaiva karuṇā + + + + rāvahitacetasaḥ śārīramānasai	punar tathā eva karuṇā 
SA_XX_byogalbu-693	3 rogair upahatāḥ sarvasatvāḥ āvir bhavanti /	rogaiḥ upahatāḥ sarva satvāḥ āvis bhavanti 
SA_XX_byogalbu-694	śāriraiś caturuttaraiś caturbhiḥ rogaśataiḥ mānasaiś cāṣṭottaraiḥ 'ṣṭābhiḥ rogaśataiḥ dṛṣṭvā cāsya karuṇā bhavati /	śāriraiḥ catur uttaraiḥ caturbhiḥ roga śataiḥ mānasaiḥ ca aṣṭa uttaraiḥ ṣṭābhiḥ roga śataiḥ dṛṣṭvā ca asya karuṇā bhavati 
SA_XX_byogalbu-695	tadadhipatirūpam /	tad adhipati rūpam 
SA_XX_byogalbu-696	4 hṛdaye strī suvarṇābhā avadātavastraprāvṛtā utpadyate /	hṛdaye strī suvarṇa ābhā avadāta vastra prāvṛtā utpadyate 
SA_XX_byogalbu-697	utpannā yoginaṃ protsāhayati /	utpannā yoginam protsāhayati 
SA_XX_byogalbu-698	+ + + + kāryaḥ ahaṃ te sarvaparahitakaraṇe	           
SA_XX_byogalbu-699	5 sarvānukūlaṃ sāhāyyaṃ kariṣyāmīti tataḥ karuṇādhipatirūpaṃ hṛdayān nirgataḥ aghaniṣṭhāṃ kṛtsnaṃ gaganam abhrakūṭa iva spharitvā sarvaśarīraduḥkhapratipakṣabha	sarva anukūlam sāhāyyam kariṣyāmi iti tatas karuṇā adhipati rūpam hṛdayāt nirgataḥ agha niṣṭhām kṛtsnam gaganam abhra kūṭe iva spharitvā sarva śarīra duḥkha pratipakṣa bhaya 
SA_XX_byogalbu-700	6 + sarvopakaraṇavṛṣṭiṃ muṃcati mānasānāṃ rogānāṃ + + + + + + + + + + + + + + + + + + + + + gāṃ viṣkaṃbhayati /	sarva upakaraṇa vṛṣṭim muṃcati mānasānām rogānām 
SA_XX_byogalbu-701	ubhayahastāṅguliniḥsṛtābhiḥ aṣṭāṃgopetābhiḥ	ubhaya hasta aṅguli niḥsṛtābhiḥ aṣṭa aṅga upetābhiḥ 
SA_XX_byogalbu-702	YL 148R1 saliladhārābhir avaśeṣaṃ mānasaṃ duḥkham ah. + + + + + + + + + + .e + + + + + + + + + .r. + medhya sā g. r. + + + m. mukh. + ti /	salila dhārābhiḥ avaśeṣa mānasam duḥkham 
SA_XX_byogalbu-703	tathaiva ca hṛdayasthā karuṇā	tathā eva ca hṛdaya sthā karuṇā 
SA_XX_byogalbu-704	2 protsāhayaty uddhara snāpaya caināṃ satvān iti /	protsāhayati uddhara snāpaya ca enām satvān iti 
SA_XX_byogalbu-705	sa tāṃ satvān uddharati snāpayati ca + + + + + . vasyādhastān nirgatya satvāṃ s. + + + + + brahmaiś ca gaganam āpūrṇaṃ karakahastaiḥ	sa tām satvān uddharati snāpayati ca       vasyā adhastāt nirgatya satvām       brahmaiḥ ca gaganam āpūrṇam karaka hastaiḥ 
SA_XX_byogalbu-706	3 nānāvarṇarasasekaiḥ satvāṃ siṃcyamānaiḥ paśyati /	nānā varṇa rasa sekaiḥ satvām siṃcyamānaiḥ paśyati 
SA_XX_byogalbu-707	sa ca tāṃ snāpayati /	sa ca tām snāpayati 
SA_XX_byogalbu-708	devānāṃ ca padmaiḥ pṛthivī pūryate /	devānām ca padmaiḥ pṛthivī pūryate 
SA_XX_byogalbu-709	tadadhirūḍhāṃ satvāṃ paśyati /	tad adhirūḍhām satvām paśyati 
SA_XX_byogalbu-710	brahmahastāṃgulibhyaś	brahma hasta aṃgulibhyaḥ 
SA_XX_byogalbu-711	4 ca varṣaṃ patati /	ca varṣam patati 
SA_XX_byogalbu-712	tatas te satvāḥ prāmodyaprāpiṇo bhavanti tasyaivaṃ bhavati mayaite mahāvyasanapaṃkād uddhṛtā ity adhimātraṃ teṣu karuṇām avakrāmati /	tatas te satvāḥ prāmodya prāpiṇaḥ bhavanti tasya evam bhavati mayā ete mahā vyasana paṃkāt uddhṛtāḥ iti adhimātram teṣu karuṇām avakrāmati 
SA_XX_byogalbu-713	sarvasrotobhyaś	sarva srotobhyaḥ 
SA_XX_byogalbu-714	5 cāsyākāśanibhāḥ paṭṭā niḥsṛtāḥ sarvasatvān upaguhya tiṣṭhanti /	ca asya ākāśa nibhāḥ paṭṭāḥ niḥsṛtāḥ sarva satvān upaguhya tiṣṭhanti 
SA_XX_byogalbu-715	punaḥ karuṇāvarjitacetasaḥ aṣṭau mahānarakāḥ ṣoḍaśotsadaparivārāḥ saha śītanarakair āmukhī bhavanti /	punar karuṇā varjita cetasaḥ aṣṭau mahānarakāḥ ṣoḍaśa utsada parivārāḥ saha śīta narakaiḥ bhavanti 
SA_XX_byogalbu-716	6 tatkāraṇāś cemāḥ śaktyasipadahastā + + + + + saṃjīve + + + + + + ś cārasūtrakrakacacchidān kālasūtre tu /	tad kāraṇāḥ ca imāḥ śakti asi pada hastā                    cārasūtra krakaca chidān kālasūtre tu 
SA_XX_byogalbu-717	aśma + + + + yantrāyoghanagajānavdāryāyodroṇyaḥ	aśma 
SA_XX_byogalbu-718	YL 149V1 saṃghāte ś. ṇ. ṇaśastrair gṛhīta + + + rauravayoḥ /	saṃghāta ṇ ṇa śastra grah rauravayoḥ 
SA_XX_byogalbu-719	+ + + + + + + + tapane /	      tapane 
SA_XX_byogalbu-720	pratāpane narake bhṛṣṭodbharjanapiṭarapraveśam avīcau narake tu ṣaṭsparśāyatanāgnipravarṣaṇarathāṅgakīlaśaṃkvacalā /	pratāpane narake bhṛṣṭa udbharjana piṭara praveśam avīcau narake tu ṣaṣ sparśa āyatana agni pravarṣaṇa rathāṅga kīla śaṃku acalā 
SA_XX_byogalbu-721	2 dṛśyante + + + + + + + + + + + + + + + + + + kāraṇāpanayanāyaivaṃ cittasya yā eṣāṃ satvānāṃ kāraṇās tā ahaṃ praticchadeyaṃ iti	dṛśyante                 kāraṇa apanayanāya evam cittasya yāḥ eṣām satvānām kāraṇāḥ tāḥ aham praticchadeyam iti 
SA_XX_byogalbu-722	3 tasyaivāpramāṇāśayasya mahāṃ āśrayaḥ + + + + + + + + + + + + + + + .o + + + sahasrair aṣṭāṃgopetaṃ pānīyaṃ niścarati tena sarvāḥ kāraṇāḥ	tasya eva apramāṇa āśayasya mahān āśrayaḥ                        sahasraiḥ aṣṭāṅga upetam pānīyam niścarati tena sarvāḥ kāraṇāḥ 
SA_XX_byogalbu-723	4 śāmyante / tato bhagavāṃ vajrāsanādhirūḍhaḥ + + + + + + + + + + + + + + + + + + + + + + + + + + + + dhīragaṃbhīrodāreṇa ca svareṇa dharmaṃ deśayati /	śāmyante tatas bhagavān vajrāsana adhirūḍhaḥ                                                                                                                                                                                                                                                                                                                                                                                                                                                                          
SA_XX_byogalbu-724	5 tac chrutvā satvās tasmāc cyutāḥ sugatāv upapadyante /	tat śrutvā satvāḥ tasmāt cyutāḥ sugatau upapadyante 
SA_XX_byogalbu-725	+ + + + + + + + + + + + + + + + + + + + + + + + + + apasarpa māriṣāpasarpa parvataṃ pātayāmīti	apasarpa māriṣaiḥ apasarpa parvatam pātayāmi iti 
SA_XX_byogalbu-726	6 na cā + + + + ṣatayām apasarpati /	na ca ā   / apasarpati 
SA_XX_byogalbu-727	.e + + + + + + + + + + + + + + + + + + + + + + + + + + + sukhasaṃsparśo mahāṃś cāśrayo mahānarakān sarvān	                          
SA_XX_byogalbu-728	YL 149R1 avaṣṭabhya + + + + + kāraṇāś ca vinaśyanti /	avaṣṭambh      kāraṇāḥ ca vinaśyanti 
SA_XX_byogalbu-729	+ + + + + + + + + + + + + + + + + + + + + + + + + + + + + + + + + sarvaduḥkhavinirmuktāḥ sukhaṃ tiṣṭhanti /	                        
SA_XX_byogalbu-730	punaḥ sa puruṣa + + + t. mūrdhany utsṛjati sa tasya karuṇā + + + + + + + + + + + + + + + + + + + + + + + + + + + sarvāṃś ca satvāṃ nārakāṃ paśyati	punar sa puruṣa mūrdhani utsṛjati sa tasya karuṇā sarvān ca satvām nārakām paśyati 
SA_XX_byogalbu-731	puṣparasadhārābhiḥ	puṣpa rasa dhārābhiḥ 
SA_XX_byogalbu-732	3 siṃcyamānān /	siṃcyamānān 
SA_XX_byogalbu-733	evaṃ tiryāṃ pretāṃ manuṣyāṃś ca /	evam tiryām pretām manuṣyān ca 
SA_XX_byogalbu-734	+ + + + + + + + + + + + + + + + + + + + + + .tropanimittaṃ paṃca ca cyavananimittaiḥ duḥkhitāṃ	       ca      
SA_XX_byogalbu-735	4 paśyati cchāyāṃ svāśrayasya paśyati /	paśyati chāyām sva āśrayasya paśyati 
SA_XX_byogalbu-736	+ + + + + + + + + + + + + + + + + + + + + d. v. gātre tiṣṭhati /	div gātre sthāti 
SA_XX_byogalbu-737	ekaviṣayālaṃbanasamarthaṃ cāsya cittaṃ bhavati	eka viṣaya ālaṃbana samartham ca asya cittam bhavati 
SA_XX_byogalbu-738	5 na bhūyaḥ alātacakravat /	na bhūyas alāta cakra vat 
SA_XX_byogalbu-739	sarvaviṣayā + hi da + + + + + + + + + + + + + + nimittāni paṃcarajo gṛhṇanti vāsāṃ + + + .iva srajo gātrasvedo jāyate daurgandhyaṃ kāyam	sarva viṣayāḥ hi da di di di nimittāni paṃca rajaḥ gṛhṇanti vāsām      iva srajaḥ gātra svedaḥ jāyate daurgandhyam kāyam 
SA_XX_byogalbu-740	6 avakrāmati sve āsane devo dhṛtiṃ na labhate + + + + + + + + + + + + + + y. nodyatabhāvasya bhagavāṃ siṃhāsanādhirūḍha utpadyate dharmaṃ ca deśayati te ca saṃvignāḥ	avakrāmati sve āsane devaḥ dhṛtim na labhate              y na udyata bhāvasya bhagavān siṃhāsana adhirūḍhaḥ utpadyate dharmam ca deśayati te ca saṃvignāḥ 
SA_XX_byogalbu-741	YL 150V1 + + + v. ta iti śabdaṃ niścārayanti bhagavataḥ pādayoḥ patanti /	ro iti śabda niścāray bhagavant pāda pat 
SA_XX_byogalbu-742	t. + + + + + + + + + t /	ro-0 di-1 di-1 
SA_XX_byogalbu-743	t. + + + + + + + + + + + + + + deveṣūpapadyante /	deveṣu upapadyante 
SA_XX_byogalbu-744	evaṃ yāvat paranirmitavaśavartino	evam yāvat 
SA_XX_byogalbu-745	2 devāṃ paśyati /	devām paśyati 
SA_XX_byogalbu-746	punaḥ karuṇāśaya evaṃ paṃcagatikaṃ cakraṃ + + + bhramyamāṇaṃ paśyati dṛṣṭvā cāsya kāruṇyam utpadyate /	punar karuṇā āśayaḥ evam paṃca gatikam cakram bhramyamāṇam paśyati dṛṣṭvā ca asya kāruṇyam utpadyate 
SA_XX_byogalbu-747	ātrāsanārthaṃ kleśaparvataḥ nānāvarṇai	ātrāsana artham kleśa parvataḥ 
SA_XX_byogalbu-748	3 rāgadveṣamohamānavicikitsādṛṣṭi + + + + + + + + + + + + + + + + + + + + gacchati /	rāga dveṣa moha māna vicikitsā dṛṣṭi 
SA_XX_byogalbu-749	sa cāsaṃbhrāntas tiṣṭhati /	sa ca asaṃbhrāntaḥ tiṣṭhati 
SA_XX_byogalbu-750	atha sa puruṣas taṃ saṃsāracakram ādāya	atha sa puruṣaḥ tam saṃsāra cakram ādāya 
SA_XX_byogalbu-751	4 tasmiṃ kleśaparvate praviśati /	tasmin kleśa parvate praviśati 
SA_XX_byogalbu-752	+ + + + + + + + + + + + + + + + + + + + veśakaṇṭakāṃ + + mānāṃ paśyati dṛṣṭvā cāsyādhikataraṃ saṃjātakāruṇyasya	         paśyati dṛṣṭvā ca asya adhikataram saṃjāta kāruṇyasya 
SA_XX_byogalbu-753	5 haste vajra utpadyate tena taṃ kleśaparvataṃ + + + + + + + + + + + + + + + + + + + + + siṃhāsanādhirūḍhāḥ bhagavanto dharmaṃ deśayanti brahmā ca bhṛṃgāram	haste vajraḥ utpadyate tena tam kleśa parvatam                     siṃhāsana adhirūḍhāḥ bhagavantaḥ dharmam deśayanti brahmā ca bhṛṃgāram 
SA_XX_byogalbu-754	6 ādāyāgrataḥ sthito bodhisatvaṃ kathayati nya + + + + + + + + + + + + + + + + + + + + + + + + + + + jayati /	ādāya agratas sthitaḥ bodhisatvam kathayati 
SA_XX_byogalbu-755	bodhau ca praṇidhānaṃ karoti /	bodhau ca praṇidhānam karoti 
SA_XX_byogalbu-756	tac codakaṃ	tat ca udakam 
SA_XX_byogalbu-757	YL 150r1 vāyunā kṣiptam ananteṣu lokadhātuṣu satvān siṃcati /	vāyunā kṣip ananteṣu lokadhātuṣu satvān sicati 
SA_XX_byogalbu-758	+ + + + + + mūrdhnā praticchaṃna + + + + + + bhagavāṃś cāsya śirasi paṭṭaṃ badhnāti kathayati ca namo 'nāgate 'dhvani bhaviṣyajjagatkarṇadhārāya	             badhnāti kathayati ca namaḥ na āgate dhvani bhaviṣyat jagat karṇadhārāya 
SA_XX_byogalbu-759	2 devāś ca kṛtsnaṃ gaganam āpūrya n. + + + + + + + + .ā bhūtvā nipatanti /	devāḥ ca kṛtsnam gaganam āpūrya n         ā bhūtvā nipatanti 
SA_XX_byogalbu-760	+ + + + + + + + + .v. + + + . utsṛjanti tasya prītiprāmodyasaṃjātasya krameṇa	            
SA_XX_byogalbu-761	3 lakṣaṇānuvyaṃjanavirājita āśraya + + yati candramaṇḍalasaṃkāśo + + + + + satvāṃś ca vinayati /	lakṣaṇa anuvyaṃjana virājitaḥ 
SA_XX_byogalbu-762	vyutthitasya cāsya bodhāya dṛḍham adhyāśayam	vyutthitasya ca asya bodhāya dṛḍham adhyāśayam 
SA_XX_byogalbu-763	4 utpadyate / āśā cāsya saṃtiṣṭhate karmakleśā + + + + + + + punar bandhanabaddhaṃ + + .abhimukhī bhavati tad asya dṛṣṭvā adhimātraṃ kāruṇyam utpadyate /	utpadyate āśā ca asya saṃtiṣṭhate karma kleśā           punar bandhana baddham   abhimukhī bhavati tat asya dṛṣṭvā adhimātram kāruṇyam utpadyate 
SA_XX_byogalbu-764	saṃjātakāruṇyasya	saṃjāta kāruṇyasya 
SA_XX_byogalbu-765	5 ca dakṣiṇe haste tīkṣṇam ākāśavarṇaṃ śastram utpadyate /	ca dakṣiṇe haste tīkṣṇam ākāśa varṇam śastram utpadyate 
SA_XX_byogalbu-766	tena + + + + + + + bandhanāṃ cchedayati /	tena      bandhanām chedayati 
SA_XX_byogalbu-767	cchatraṃ ca anantaṃ lokaṃ spharitvā sarvasatvān upaguhya tiṣṭhati /	chatram ca anantam lokam spharitvā sarva satvān upaguhya tiṣṭhati 
SA_XX_byogalbu-768	6 tata indranīlavarṇo 'bhiṣekaḥ pūrvavat /	tatas indranīla varṇaḥ bhiṣekaḥ pūrvavat 
SA_XX_byogalbu-769	adhaś cordhvaṃ ca gatvā + + + + + + + + + + + + + + + s. + + + + + + + + + + + tato haṃsarathādhirūḍhaḥ brahmā ta	adhas ca ūrdhvam ca gatvā 
SA_XX_byogalbu-770	YL 151V1 + + + + + + + + + + + + + + + + + + + + + + + + + + + + + + + + + + + bhagavāṃś cāsya + + + + + + + + + + + āryamaitreyaś ca tatparivārāś ca bodhisatv.	ro-0 di-1 di-1 di-1  /                   bhagavant ca asya 
SA_XX_byogalbu-771	2 + + + + + + + + + + + + + + + + + + + + + + + + + + + + + + + + gate + + + + + + + + + + + + + + + anumodayati /	di-2 di-2 di-2 ac-2 ad-2 ad-2 ro-0
SA_XX_byogalbu-772	brahmā kathayaty āśvasatu	brahmā kathayati āśvasatu 
SA_XX_byogalbu-773	3 + + + + + + + + + + + + + + + + + + + kathayati + + + + tvam iti karuṇāsthitiḥ /	                     
SA_XX_byogalbu-774	punar abhiṣekapravāhānantaram /	punar abhiṣeka pravāha anantaram 
SA_XX_byogalbu-775	sthitiḥ kuṭṭimasau	sthitiḥ kuṭṭima asau 
SA_XX_byogalbu-776	4 + + anantāparyantā bhavati /	      
SA_XX_byogalbu-777	tato ratnamayo vṛkṣa udgataḥ kṛtsnaṃ lokaṃ spharitvā tiṣṭhati /	tatas ratna mayaḥ vṛkṣaḥ udgataḥ kṛtsnam lokam spharitvā tiṣṭhati 
SA_XX_byogalbu-778	vṛkṣamūlāni ca kāṃcanacakre pratiṣṭhitāni sauvarṇāni kṣīraparipūrṇāni dṛśyante /	vṛkṣa mūlāni ca kāṃcana cakre pratiṣṭhitāni sauvarṇāni kṣīra paripūrṇāni dṛśyante 
SA_XX_byogalbu-779	5 vṛkṣādhastāt. + + + + + + + + + + + yajñavāṭā yatra bodhisatvaḥ sarvaṃ sarvatra sarvadā prayacchan no + + + + + + + + + + + puruṣaḥ kathayati	vṛkṣa adhastāt           yajñavāṭāḥ yatra bodhisatvaḥ sarvam sarvatra sarvadā prayacchan no             puruṣaḥ kathayati 
SA_XX_byogalbu-780	asmiṃ sthāne bodhisatvaḥ	asmin sthāne bodhisatvaḥ 
SA_XX_byogalbu-781	6 sarvasatvānāṃ sarvamanoratha + + + kṛtvābhisaṃbuddho bodhim asaṃkhyasatvaparivāraḥ	sarva satvānām sarva manoratha    kṛtvā abhisaṃbuddhaḥ bodhim asaṃkhya satva parivāraḥ 
SA_XX_byogalbu-782	nirupadhiśeṣe nirvāṇadhātau praviśatīti tato 'sya hṛdaye strī samutpadyate suvarṇavarṇāvadātavastraprāvṛtā /	nirupadhi śeṣe nirvāṇa dhātau praviśati iti tatas sya hṛdaye strī samutpadyate suvarṇa varṇa avadāta vastra prāvṛtā 
SA_XX_byogalbu-783	YL 151R1 sapaṭṭasuvarṇamālāvabaddhā sainaṃ protsāhayati /	sa paṭṭa suvarṇa mālā avabaddhā tad enam protsāhayati 
SA_XX_byogalbu-784	tvam api tāvat. + r. + + tataḥ sāv ātmānāṃ praṇamya bodhāya praṇidhānaṃ karoti vyutthitasya cāsya praṇidhāna	tvam api tāvat r tatas saḥ ātmānām praṇamya bodhāya praṇidhānam karoti vyutthitasya ca asya praṇidhāna 
SA_XX_byogalbu-785	2 + + + + + + + + + +ḥ sarvasatvopari patati /	         
SA_XX_byogalbu-786	tac ca dṛṣṭvā saṃjātaprītiprāmodya + + + + + + + + + + + + nirgatya kṛtsnaṃ satvasamudram upaguhya tiṣṭhanti /	tat ca dṛṣṭvā saṃjāta prīti prāmodya              nirgatya kṛtsnam satva samudram upaguhya tiṣṭhanti 
SA_XX_byogalbu-787	3 krameṇa + + + + + + + + + buddhān anekasahasraparivārān nirupadhiśeṣe nirvāṇadhātau praviśataḥ paśyati iyam aparā karuṇāsthitiḥ // punaḥ	krameṇa        buddhān aneka sahasra parivārān nirupadhi śeṣe nirvāṇa dhātau praviśataḥ paśyati iyam aparā karuṇā sthitiḥ punar 
SA_XX_byogalbu-788	4 karuṇāśayasya bhrūvivara upanibaddhacetasaś chidram utpadyate /	karuṇā āśayasya bhrū vivare upanibaddha cetasaḥ chidram utpadyate 
SA_XX_byogalbu-789	tatra bhagavantaṃ + + + + + + paśyati /	tatra bhagavantam       paśyati 
SA_XX_byogalbu-790	taṃniḥsṛtair ālokair lokam avabhāsitaṃ paśyati /	tad niḥsṛtaiḥ ālokaiḥ lokam avabhāsitam paśyati 
SA_XX_byogalbu-791	5 + + + + + + + + + samudrāṃ sa + + + + + + + + + + + + + + + + + kāṃcanacakre + + + + + + + + + + + + + + + nagarabhavanodyānāni paśyati tāṃ	                                            
SA_XX_byogalbu-792	6 + + + + + + + + + + + + + + + + + + + + + + + + + + + brahmā gṛhītasuvarṇabhājana + + + + + + + + + niḥsṛtā candramaṇḍalasaṃkāśā nadī	                                   
SA_XX_byogalbu-793	YL 152V1 āśrayaṃ pūrayati /	āśrayam pūrayati 
SA_XX_byogalbu-794	+ + + + + + + + eva pravāhaḥ adho yāvad vāyumaṇḍalaṃ ūrdhvaṃ yāvac caturthaṃ dhyānam iti tadvarṇam evāvasthāpya punar mūrdhnā praviśya bhruvivarāṃ nirgato dvitīyaś ca	                                                        ca 
SA_XX_byogalbu-795	2 nābhyāḥ sthitim āpūrayati + + + + + racitaiś ca buddhāśrayaiḥ sthitiḥ pūrṇā dṛśyate /	nābhyāḥ sthitim āpūrayati       racitaiḥ ca buddha āśrayaiḥ sthitiḥ pūrṇā dṛśyate 
SA_XX_byogalbu-796	tato haṃsarathādhirūḍhaḥ brahmā prādurbhavati /	tatas haṃsa ratha adhirūḍhaḥ brahmā prādurbhavati 
SA_XX_byogalbu-797	dakṣiṇe cāsya pārśve sauvarṇena padmaṃ vāme nīlābhaṃ /	dakṣiṇe ca asya pārśve sauvarṇena padmam vāme nīla ābham 
SA_XX_byogalbu-798	3 tato bhagavāṃ cchuddhāvāsadevaparivṛto dakṣiṇe padmakarṇikāyāṃ niṣīdati śuddhāvāśāś ca devāḥ patreṣu āryamaitreyaḥ bodhisatvagaṇaparivṛtaḥ vāme pārśve	tatas bhagavān śuddhāvāsa deva parivṛtaḥ dakṣiṇe padma karṇikāyām niṣīdati śuddhāvāśāḥ ca devāḥ patreṣu ārya maitreyaḥ bodhisatva gaṇa parivṛtaḥ vāme pārśve 
SA_XX_byogalbu-799	4 padmakarṇikāyāṃ niṣīdati bodhisatvā patreṣu /	padma karṇikāyām niṣīdati bodhisatvā patreṣu 
SA_XX_byogalbu-800	tataḥ karuṇāvihāriṇaḥ saṃjātaprasādasya pādamūle padmam utpadyate /	tatas karuṇā vihāriṇaḥ saṃjāta prasādasya pāda mūle padmam utpadyate 
SA_XX_byogalbu-801	sa bhagavatpādayoḥ praṇamya kathayati /	sa bhagavat pādayoḥ praṇamya kathayati 
SA_XX_byogalbu-802	5 bhagavaṃ syām aham anāgate 'dhvani sarvasatvapariṇāyake /	syām aham anāgate dhvani sarva satva pariṇāyake 
SA_XX_byogalbu-803	sarvasatvavyādhīnām apahartā samyaksaṃbuddha iti tato 'sya bhagavāṃ pāṇinā mūrdhānaṃ parāmṛśati /	sarva satva vyādhīnām apahartā samyaksaṃbuddhaḥ iti pāṇinā mūrdhānam parāmṛśati 
SA_XX_byogalbu-804	kathayati ca putraka	kathayati ca putraka 
SA_XX_byogalbu-805	6 bhaviṣyasi tvam anāgate 'dhvani sarvasatvyavyādhīnām apahartā samyaksaṃbuddha iti /	bhaviṣyasi tvam anāgate dhvani sarva satvya vyādhīnām apahartā samyaksaṃbuddhaḥ iti 
SA_XX_byogalbu-806	tato devā hṛṣṭāḥ kṛtsnaṃ gaganaṃ spharitvā + + + + puṣparatnavarṣam utsṛjanti /	tatas devāḥ hṛṣṭāḥ kṛtsnam gaganam spharitvā     puṣpa ratna varṣam utsṛjanti 
SA_XX_byogalbu-807	sthityupari niṣaṇṇānāṃ	sthiti upari niṣaṇṇānām 
SA_XX_byogalbu-808	YL 152 R1 ca buddhānāṃ sarvasrotobhyo ratnavṛkṣāḥ nirgacchanti /	R ca buddha sarva srotas ratna vṛkṣa nirgam 
SA_XX_byogalbu-809	tadadhirūḍhāḥ samyaksaṃbuddhāś candra maṇḍalacitā yāvad aghaniṣṭhāṃ devān iti taṃnābhiniḥsṛtābhiś candramaṇḍalasaṃkāśābhir nadībhir	tad adhirūḍhāḥ samyaksaṃbuddhāḥ candra maṇḍala citāḥ yāvat agha niṣṭhām devān iti taṃnābhi niḥsṛtābhiḥ candra maṇḍala saṃkāśābhiḥ nadībhiḥ 
SA_XX_byogalbu-810	2 yogācārāśrayam āpūryate /	yoga ācāra āśrayam āpūryate 
SA_XX_byogalbu-811	tato bhagavāṃ cchuddhāvāsadevaparivṛta āryamaitreyo bodhisatvagaṇaparivṛtaḥ ūrdhvaṃ yathāgatā abhiruhanti sa ca prasādajātaḥ ratnāni puṣpāṇi ca kṣiptāni	tatas bhagavān śuddhāvāsa deva parivṛtaḥ ārya maitreyaḥ bodhisatva gaṇa parivṛtaḥ ūrdhvam yathāgatāḥ abhiruhanti sa ca prasāda jātaḥ ratnāni puṣpāṇi ca kṣiptāni 
SA_XX_byogalbu-812	3 devaiḥ parigaveṣate /	devaiḥ parigaveṣate 
SA_XX_byogalbu-813	iyam aparā karuṇāsthitiḥ ante ca sarvaṃ nābhyāṃ jñeyaṃ nirudhyate /	iyam aparā karuṇā sthitiḥ ante ca sarvam nābhyām jñeyam nirudhyate 
SA_XX_byogalbu-814	buddhāś ca padmādhirūḍhāḥ kāye 'ntargatā dṛśyanta iti vyutthānam / evam	buddhāḥ ca padma adhirūḍhāḥ kāye ntargatāḥ dṛśyante iti vyutthānam evam 
SA_XX_byogalbu-815	4 asya saparikarmā saviśeṣā karuṇā niṣpannā vaktavyā /	asya sa parikarmā sa viśeṣā karuṇā niṣpannā vaktavyā 
SA_XX_byogalbu-816	ataḥ param idānīm aparopatāpibhavaḥ kṣāntisauratyamārdavamṛdutve parakāryavyasanitvaṃ sauhṛdam aṃgāni	atas param idānīm apara upatāpi bhavaḥ kṣānti sauratya mārdava mṛdu tve para kārya vyasani tvam sauhṛdam aṃgāni 
SA_XX_byogalbu-817	5 karuṇāyāḥ ebhi + + + + gṛhītā karuṇā punaḥpunar ārabhyamānā mahākaruṇāvāhikā bhavatīti //	karuṇāyāḥ ebhiḥ    gṛhītā karuṇā punar punar ārabhyamānā mahā karuṇā vāhikā bhavati iti 
SA_XX_byogalbu-818	karuṇānantaraṃ muditā nirdiṣṭā bhagavatā /	karuṇā anantaram muditā nirdiṣṭā bhagavatā 
SA_XX_byogalbu-819	atas tatsāmarthyaṃ	atas tad sāmarthyam 
SA_XX_byogalbu-820	6 + .e + + + + + + + + + + kimarthaṃ punaḥ karuṇānantaraṃ muditānirdeśas tad ucyate vihiṃsāpratipakṣānantaram īrṣyāratipratipakṣāviṣkaraṇārthaṃ	          ucyate                    
SA_XX_byogalbu-821	paraduḥkhaprītipratipakṣānantaraṃ	para duḥkha prīti pratipakṣa anantaram 
SA_XX_byogalbu-822	YL 153V1 vā parasukhāprītipratipakṣāviṣkaraṇārtham /	vā para sukha aprīti pratipakṣa āviṣkaraṇa artham 
SA_XX_byogalbu-823	nirvidākāramanasikārānantaraṃ vā prāmodyākārānukūlamanasikāradyotanārtham /	nirvid ākāra manasikāra anantaram vā prāmodya ākāra anukūla manasikāra dyotana artham 
SA_XX_byogalbu-824	duḥkhitāpanayanāśayamanasikārānantaraṃ	duḥkhita apanayana āśaya manasikāra anantaram 
SA_XX_byogalbu-825	2 vā hitasukhānumodanāśayamanasikāradyotanārtham /	vā hita sukha anumodana āśaya manasikāra dyotana artham 
SA_XX_byogalbu-826	atha kiṃsvabhāvā muditā tad ucyate /	atha kiṃsvabhāvā muditā tat ucyate 
SA_XX_byogalbu-827	saumanasyeti sā svabhāvā sā tu sānuparivartā sasaṃprayogā	saumanasyā iti sā svabhāvā sā tu sa anuparivartā sa saṃprayogā 
SA_XX_byogalbu-828	3 parigṛhyamānā /	parigṛhyamānā 
SA_XX_byogalbu-829	kāmāvacarā catuḥskandhasvabhāvā /	kāma avacarā catur skandha svabhāvā 
SA_XX_byogalbu-830	rupāvacarā paṃcaskandhasvabhāvā /	paṃca skandha svabhāvā 
SA_XX_byogalbu-831	āśraye kāmadhātvāśrayā /	āśraye kāmadhātu āśrayā 
SA_XX_byogalbu-832	alaṃbane kāmadhātvālaṃbanā / bhūmitaḥ	alaṃbane kāmadhātu ālaṃbanāḥ bhūmitaḥ 
SA_XX_byogalbu-833	4 kāmadhātau dhyānadvaye ca tatra saumanasyaṃ dvayasadbhāvaṃ //	kāmadhātau dhyāna dvaye ca tatra saumanasyam dvaya sadbhāvam 
SA_XX_byogalbu-834	tatprayogaḥ adhimātrādhimātrasya mitrasya sukhena prīto bhavati evaṃ madhyasya mṛdunaḥ udāsīnasya evam	tad prayogaḥ adhimātra adhimātrasya mitrasya sukhena prītaḥ bhavati evam madhyasya mṛdunaḥ udāsīnasya evam 
SA_XX_byogalbu-835	5 adhimātrasyāmitrasya sukhena prīto bhavati tato muditopanibaddhacetasaḥ ebhiḥ prakāraiḥ satvān adhimucyamānasya hṛdaye padminī prādurbhavati	adhimātrasya amitrasya sukhena prītaḥ bhavati tatas mudita upanibaddha cetasaḥ ebhiḥ prakāraiḥ satvān adhimucyamānasya hṛdaye padminī prādurbhavati 
SA_XX_byogalbu-836	suvarṇavālukāstīrnā	suvarṇa vālukā āstīrnā 
SA_XX_byogalbu-837	6 suvarṇapadmaiḥ vaiḍūryanāḍaiḥ ratnacitaiḥ pūrṇā tadadhirūḍhāṃ satvān sarvālaṃkāravibhūṣitāṃ pramuditāṃ paśyati /	suvarṇa padmaiḥ vaiḍūrya nāḍaiḥ ratna citaiḥ pūrṇā tad adhirūḍhām satvān sarva alaṃkāra vibhūṣitām pramuditām paśyati 
SA_XX_byogalbu-838	tadvat kṛtsnāyāṃ pṛthivyāṃ dṛṣṭvā cāsya prītir utpadyate /	tadvat kṛtsnāyām pṛthivyām dṛṣṭvā ca asya prītiḥ utpadyate 
SA_XX_byogalbu-839	anumodanākāraś	anumodanā ākāraḥ 
SA_XX_byogalbu-840	YL 153R1 ca modantu bata satvā iti /	ca mudantu bata satvāḥ iti 
SA_XX_byogalbu-841	punar muditāprayogāvahitacetaso nānāsukhasamarpitaḥ satvasamudraḥ abhimukhī bhavati /	punar muditā prayoga avahita cetasaḥ nānā sukha samarpitaḥ satva samudraḥ abhimukhī bhavati 
SA_XX_byogalbu-842	cakravartisadṛśābhir vibhūṣitābhiḥ	cakravarti sadṛśābhiḥ vibhūṣitābhiḥ 
SA_XX_byogalbu-843	2 + + + dṛśyante hṛdayāc cāsya sauvarṇo dhvaja utpadyate + + + + + + + + nā sa ca mūrdhnā nirgataḥ kṛtsnaṃ lokaṃ spharitvā sarvopakaraṇavarṣam ante ca ratnavarṣaṃ muñcati / tena ca	   dṛśyante hṛdayāt ca asya sauvarṇaḥ dhvajaḥ utpadyate          nā sa ca mūrdhnā nirgataḥ kṛtsnam lokam spharitvā sarva upakaraṇa varṣam ante ca ratna varṣam muñcati tena ca 
SA_XX_byogalbu-844	3 satvā buddhadharmasaṃgheṣu kāraṃ kurvanti hṛdaye 'sya suvarṇābhā strī pramuditotpadyate muditādhipatirūpaṃ sainaṃ samutkarṣayati sādhu sādhu śobhanam idam ārabdhaṃ /	satvāḥ buddha dharma saṃgheṣu kāram kurvanti hṛdaye suvarṇa ābhā strī pramuditā utpadyate mudita adhipati rūpam sā enam samutkarṣayati sādhu sādhu śobhanam idam ārabdham 
SA_XX_byogalbu-845	4 evam iva satvā ihaloke paraloke sukhenānugṛhītāḥ /	evam iva satvāḥ ihaloke paraloke sukhena anugṛhītāḥ 
SA_XX_byogalbu-846	yāvat paranirmitavaśavartidevāṃ sukhena sukhitāṃ dṛṣṭvā prītir utpadyate /	yāvat paranirmitavaśavartidevām sukhena sukhitām dṛṣṭvā prītiḥ utpadyate 
SA_XX_byogalbu-847	anumodanākāraś ca	anumodanā ākāraḥ ca 
SA_XX_byogalbu-848	5 modantu bata satvā iti /	modantu bata satvāḥ iti 
SA_XX_byogalbu-849	tatsamantaraṃ anāgatena sukhena sukhitāṃ satvāṃ paśyati /	tad samantaram anāgatena sukhena sukhitām satvām paśyati 
SA_XX_byogalbu-850	tato 'sya brahmasadṛśam āśrayam utpadyate /	tatas sya brahma sadṛśam āśrayam utpadyate 
SA_XX_byogalbu-851	sarvasrotobhyaś ca suvarṇābhāni candramaṇḍalāni	sarva srotobhyaḥ ca suvarṇa ābhāni candra maṇḍalāni 
SA_XX_byogalbu-852	6 nānāratnacitāni nirgacchanti tatrādhirūḍhāṃ satvāṃ tatsadṛśavarṇān ratnakūṭāgārair ivopagūḍhāṃ paśyati /	nānā ratna citāni nirgacchanti tatra adhirūḍhām satvām tad sadṛśa varṇān ratna kūṭāgāraiḥ iva upagūḍhām paśyati 
SA_XX_byogalbu-853	tadvad anantaṃ lokaṃ dvitīye dhyāne /	tadvat anantam lokam dvitīye dhyāne 
SA_XX_byogalbu-854	evam eva nīlavarṇo dhātuḥ sarveṣāṃ / tac ca	evam eva nīla varṇaḥ dhātuḥ sarveṣām tat ca 
SA_XX_byogalbu-855	YL 154V1 + + + + + .utpadyate / anu + + + + + + + + + + dyānānubhavadarśanaṃ vītarāgāṇām adhipativibhāganiṣyandarūpair veditavyam / + + + +	ad                                                            
SA_XX_byogalbu-856	2 + + + + + nubhāvena eva naya + + + + + + manasikāraprayuktasyaikasmiṃ bhāge manuṣyalokaṃ devāṃś ca paśyati dvitīye bhāge + + + + + + + + +	    eva naya                  ca paśyati     
SA_XX_byogalbu-857	3 + + + + + + saṃparameṇa cittadamopaśamena samanvāgataṃ candrādityasamābhāsaṃ agnividyut. + + + + + + ya pa + + + buddhatejo viśiṣyate śrāvakagaṇaṃ	                                                            
SA_XX_byogalbu-858	4 + + + + + + paripūrṇasantānaṃ bhagavataś ca dharmaśarīraṃ tasya vistareṇa buddhānusmṛtau viv. + + + + + + + + + pakṣadvayaṃ dṛṣṭvā ime 'trapacayaḥ	                                       
SA_XX_byogalbu-859	5 + + + + amī + + + + + vaḥ ime saṃvṛtyupapattidevā amī viśuddhidevāḥ /	                
SA_XX_byogalbu-860	ime abhyudayikena sukhena sukhinaḥ amī niśrayas .ī + ime mahārhaprāsādavimānādhirūḍhā	ime abhyudayikena sukhena sukhinaḥ amī niśrayas ī ime mahārha prāsāda vimāna adhirūḍhā 
SA_XX_byogalbu-861	6 amī + + + + + + + + + + ime mahārhālaṃkārālaṃkṛtā amī śramaṇālaṃkārālaṃkṛtāḥ ime īśvarajanag. + + + amī + + + + + + + + + ime + + +	amī          ime mahārha alaṃkāra alaṃkṛtāḥ amī śramaṇa alaṃkāra alaṃkṛtāḥ ime            ime 
SA_XX_byogalbu-862	YL 154 R1 + + + + + amī + + + + + + + ime mahābhūtasamatayopetāḥ amī cittasamatayopetāḥ /	r ad ad-ad-        ime mahābhūta samatayā upetāḥ adas citta samatā upeta 
SA_XX_byogalbu-863	tato bhagavataḥ śarīrāt pravāho nirgataḥ + + + + + + + + + + + +	tatas bhagavataḥ śarīrāt pravāhaḥ nirgataḥ 
SA_XX_byogalbu-864	2 + + + + + + + + ratnapuṣpavarṣam ākāśāt patati /	         patati 
SA_XX_byogalbu-865	te ca satvā bhagavantaṃ dṛṣṭvā samantataḥ pradhāvanti bhagavataḥ pādayoḥ praṇamya + + + nāṃ bhagavāṃ dharmaṃ deśayati te ca satvāḥ	te ca satvāḥ bhagavantam dṛṣṭvā samantataḥ pradhāvanti bhagavataḥ pādayoḥ praṇamya    nām bhagavān dharmam deśayati te ca satvāḥ 
SA_XX_byogalbu-866	3 + + + + + pāramārthikaṃ śāsanāṃ sāṃketikaṃ cāvataranti śrāvakaguṇopetāṃś ca dṛṣṭvā prītir utpadyate /	        ca avataranti       ca dṛṣṭvā   utpadyate 
SA_XX_byogalbu-867	anumodanākāraś ca modantu bata satvā iti /	anumodanā ākāraḥ ca modantu bata satvāḥ iti 
SA_XX_byogalbu-868	tato 'bhiṣekaḥ ratnapravāhaḥ	tatas bhiṣekaḥ ratna pravāhaḥ 
SA_XX_byogalbu-869	4 pravilīya mūrdhnā praviśyāśrayaṃ pūrayati prīṇayati ca hṛdayāc cāsya pravāho nirgatya vicchidyate adhaś cordhvaṃ ca gatvā ratnaprabhābhir lokam avabhāsyā	pravilīya mūrdhnā praviśya āśrayam pūrayati prīṇayati ca hṛdayāt ca asya pravāhaḥ nirgatya vicchidyate adhas ca ūrdhvam ca gatvā ratna prabhābhiḥ lokam avabhāsyā 
SA_XX_byogalbu-870	5 + + + + + krameṇa sthitim āpūrayati /	        
SA_XX_byogalbu-871	tataḥ siṃhāsanādhirūḍhāḥ anantaparyantā bhagavanto buddhāḥ prādurbhavanti śrāvakagaṇaparivṛtāḥ taṃniḥsṛtaiś ca ratnapuṣpavarṣaiḥ loko vyavakīryate	tatas siṃhāsana adhirūḍhāḥ ananta paryantāḥ bhagavantaḥ buddhāḥ prādurbhavanti śrāvaka gaṇa parivṛtāḥ tad niḥsṛtaiḥ ca ratna puṣpa varṣaiḥ lokaḥ vyavakīryate 
SA_XX_byogalbu-872	6 + .aṅgulibhis tebhya eva + + + + + + + kūṭāgārāntargatā buddhā dṛśyante /	aṅgulibhiḥ tebhyaḥ eva       kūṭāgāra antargatāḥ buddhāḥ dṛśyante 
SA_XX_byogalbu-873	satvāś ca ratnaprāsādāntargatāḥ tadubhayeṣu vai + + + + + + + + + + + + + + + +	satvāḥ ca ratna prāsāda antargatāḥ tad ubhayeṣu vai 
SA_XX_byogalbu-874	YL 155V1 + + + + + + + + + + + + + + + + + + + + lokaiś ca buddhaguṇaprabhābhiś cāvabhāsito loko buddhāśraye + + + + + + + + + + + + + + + +	diś diś   /               ca buddha guṇa prabhābhiḥ ca avabhāsitaḥ lokaḥ buddha āśraye 
SA_XX_byogalbu-875	2 + + + + + + + + + + ante sarvaṃ jñeyaṃ nābhyāṃ nirudhyata iti vyutthānam / //	                  
SA_XX_byogalbu-876	muditāsamanantaram upekṣā nirdiṣtā bhagavatā / + + + + + + + m. v. + + + + + + +	muditā samanantaram upekṣā nirdiṣṭā bhagavatā 
SA_XX_byogalbu-877	3 + + + + + + + + + + + + + + t tad ucyate īrṣyāratipratipakṣānantaraṃ kāmarāgavyāpādapratipakṣāviṣkaraṇārtham /	                          
SA_XX_byogalbu-878	v. bh. g. manasikārānantaraṃ +	v bh g manasikāra anantaram 
SA_XX_byogalbu-879	4 + + + + + + + + + + + + + yavidhuraudbilyānukūlamanasikārānantaraṃ + + + + + + + + + + + + + dyotanārtham /	                           
SA_XX_byogalbu-880	tatprayoga ādita evo +	tad prayogaḥ āditas 
SA_XX_byogalbu-881	5 + + + + + + + + + + + + + + + + ca mitrapakṣaṃ mṛduṃ madhyam adhimātraṃ cāmitraṃ + + + + + + + + + + + + sty ajatvāt /	ca mitra pakṣam mṛdum madhyam adhimātram ca amitram            sti aja tvāt 
SA_XX_byogalbu-882	yadāsya taci +ṃ samaṃ + +	yadā asya ta ci ṃ samam 
SA_XX_byogalbu-883	6 + + + + + + + + + + + + + + + + + + .upekṣā niṣpannā bhavati /	          bhavati 
SA_XX_byogalbu-884	atha kiṃsvabhāvā upekṣā tad ucyate /	atha kiṃsvabhāvā upekṣā tat ucyate 
SA_XX_byogalbu-885	alobhasvabhāvā sā tu sānuparivartā sasaṃprayogā parigṛhyamānā /	alobha svabhāvā sā tu sa anuparivartā sa saṃprayogā parigṛhyamānā 
SA_XX_byogalbu-886	YL 155R1 + + + + + + + + + + āśraye kāmadhātvāśrayā ālaṃbane kāmadhātvālaṃbanā bhūmitaḥ saptabhaumā /	āśraye kāmadhātu āśrayāḥ ālambane kāmadhātu ālambanāḥ bhūmyāḥ sapta bhaumā 
SA_XX_byogalbu-887	kāmadhātau anāgamye caturṣu dhyāneṣu dhyānāntare ca / + + + + +	kāmadhātau anāgamye caturṣu dhyāneṣu dhyāna antare ca 
SA_XX_byogalbu-888	2 + + + + + + + + + + + + + + + + + + + pṛṣṭhataḥ upanibaddhacetasaḥ yathokte + + + + + + + + + + + + dvāraṃ prādurbhavati /	                            
SA_XX_byogalbu-889	tatra padmopaga + + + + +	tatra 
SA_XX_byogalbu-890	3 + + + + + + + + + purata upanibaddhacetasaḥ tatraiva dvāraṃ prādurbhavati tatra + + + + + + + + + + + + + + + m. kūṭaprakhyā buddhavapurdhāriṇa	                                                    
SA_XX_byogalbu-891	4 + + + + + + + + + + + + + tā cātra navanītavarṇasaṃsparśā strī utpadyate /	           utpadyate 
SA_XX_byogalbu-892	+ + + + + + + + + + + + + .upaguhya tiṣṭhati / + + +	         upaguhya tiṣṭhati 
SA_XX_byogalbu-893	5 + + + + + + + + + + + + + + + + + + + + + paṭṭair anantaparyantaiḥ satvāś chādyante paṭṭa + + + + + + + + + + + + + + + + + + + + + + + +	               
SA_XX_byogalbu-894	6 + + + + + + + + + + + + + + + + + ṣu satvāṃ parasparopekṣakiṃ snigdharasap. + + + + + + + + + + + + + + + + + + + + + + + + + +	          
SA_XX_byogalbu-895	YL 156V1 + + + + + + + + + + + + + + + + + + + + + + .āmānāṃs tanniḥsṛtaiś ca navanītavarṇasa + + + + + + + + + + + + + + + + + + + + + + +	                 
SA_XX_byogalbu-896	2 + + + + + + + + / karuṇāyā duḥkhāhita + + + + + muditāyās tadubhayānumodanena yuktaḥ pu + + + + + + + + + + + + + + + + + + + + + + + +	                
SA_XX_byogalbu-897	3 + + + + + + + + + + tyāgī / + + + + tāṃ parebhyas tadapekṣadoṣanāśāya / ato vi + + + + + + + + + + + + + + + + + + + + + + +	                
SA_XX_byogalbu-898	4 + + + + + + + viṣayopekṣā /	      
SA_XX_byogalbu-899	vedayitopekṣā /	vedayitā upekṣā 
SA_XX_byogalbu-900	bālacaritaratyupekṣā /	        
SA_XX_byogalbu-901	bhavāṃgopekṣā /	bhava aṃga upekṣā 
SA_XX_byogalbu-902	ātmaparikalpopekṣā / + + + + + + + + + + + +	    
SA_XX_byogalbu-903	5 + + + + + + + + + + .apramāṇopekṣāyāṃ yathoktasthānāntareṣv anyatarānyatara upanibaddhacetasaḥ + + + + + + + + + + + + + + + + + + + + + +	                       
SA_XX_byogalbu-904	6 + + + + + + + + + + + + + yam utpadyate /	       
SA_XX_byogalbu-905	duścaritacāriṣv abahumānāt pratighaḥ + + + + + + + + + + + + + + + + + + + + + + + + + + + + +	duścarita cāriṣu a bahu mānāt pratighaḥ 
SA_XX_byogalbu-906	YL 156R1 + + + + + + + + + + + + + .y. ti cetaḥ duścaritacāriṇām atītānāgatāṃ paśyati / + + + + + + + + + + + + + + + + + + + + + + + + + +	cetaḥ duścarita cāriṇām atīta anāgata 
SA_XX_byogalbu-907	2 + + + + + + + + + + + + + satvāṃ paśyati evaṃ suvarṇadurvarṇānām /	    paśyati evam      
SA_XX_byogalbu-908	sadhanān adhanān / + + + + + + + + + + + + + + + + + + + + + + + + + +	sadhanān adhanān 
SA_XX_byogalbu-909	3 + + + + + + + + + vītarāgān / bālān avītarāgān /	           
SA_XX_byogalbu-910	sakleśāṃ niṣkleśān / ac. + + + + + + + + + + + + + + + + + + + + + + + + + +	sa kleśām niṣkleśān 
SA_XX_byogalbu-911	4 + + + + + + + + + + samī + + + +ḥ sarvasatvā niṣkleśā dṛśyante /	            
SA_XX_byogalbu-912	kūṭāgārāś ca + + + + + + + + + + + + + + + + + + + + + + +	kūṭāgārāḥ ca 
SA_XX_byogalbu-913	5 + + + + + + + + + + + + + + + + + + + + + + + .ā utpadyante /	      
SA_XX_byogalbu-914	tatra ca praviṣṭān sarvasatvāṃ + + + + + + + + + + + + + + + + + + + + + +	tatra ca praviṣṭān 
SA_XX_byogalbu-915	6 + + + + + + + + + + + + + + + + + + + + + te / viṣayopekṣā triprakārā ki + .ā + + + + + + + + + + + + + + + + + + + + + + + + + + +	              
SA_XX_byogalbu-916	YL 157V1 + + + + + + + + + + + + + + + + + + + sta utpadyate madhyasthāṃ viṣayāṃ d. y. + + + + + + + + + + + + + + + + + + pratighaś ca dūrī bhavati mo + + +	diś diś utpad madhyasthām 
SA_XX_byogalbu-917	2 + + + + + + + + + + + + + + + + + + + kṣīraparipūrṇā candramaṇḍalahasto + + + + + + + + + + + + + + + + + + + ti /	              
SA_XX_byogalbu-918	pratikūlālāṃbanābhā	pratikūla alāṃbana ābhā 
SA_XX_byogalbu-919	3 + + + + + + + + + + + + + + .āśīviṣāṃ nirdhāvyamānāṃ paśyati / tata + + + + + + + + + + + + + + + + + + .i. + .ā + + +	             
SA_XX_byogalbu-920	4 + + + + + + + + + + + + + + .y. rūpanadyaḥ snehamiśrāḥ pravi + + + + + + + + rūpāṇāṃ cakṣurdvāreṇa śabdānāṃ śrotradvāreṇa gandhānāṃ ghrāṇadvāreṇa	rūpa nadyaḥ sneha miśrāḥ pravi         rūpāṇām cakṣus dvāreṇa śabdānām śrotra dvāreṇa gandhānām ghrāṇa dvāreṇa 
SA_XX_byogalbu-921	5 rasānāṃ jihvādvāreṇa spṛṣṭavyānāṃ kāyadvāraiḥ dharmāṇāṃ manodvāraiḥ tāni ca nakṣatrāṇi iṣṭaviṣayādhipatirūpāṇi + + + + + + + + + + + + + +	rasānām jihvā dvāreṇa spṛṣṭavyānām kāya dvāraiḥ dharmāṇām manaḥ dvāraiḥ tāni ca nakṣatrāṇi iṣṭa viṣaya adhipati rūpāṇi 
SA_XX_byogalbu-922	6 + + + + + + + + + + + + + + + raśmibhir visphuliṃgābhiḥ iṣṭaviṣayān upahanti cakṣurdvāreṇa + + + + + + + + + + + + + + + + + + + + + + + +	                
SA_XX_byogalbu-923	YL 157R1 śrotradvāreṇa + + + ghrāṇadvāreṇa + + + + + jīhvādvāreṇa kṣurāṇām /	śrotra dvāra    ghrāṇa dvāra       jīhvā dvāra kṣura 
SA_XX_byogalbu-924	kāyadvāreṇa śaktinām / nadya + + + + + + + + + + + + + + + + + + + + + + + + +	kāyadvāreṇa śaktinām 
SA_XX_byogalbu-925	2 + + + + + + + + + + + + + + + + + + + pi + utpadyate tanniḥsṛtābhiḥ raśmibhiḥ indriyāṇi + + + + + + + + + + + + + + + + + + + + + + +	               
SA_XX_byogalbu-926	3 + + + + + + + + + + + + raśmikālāpaṃ gṛhītvā smṛtinimittaṃ + + + + + + + + + + + + + + + + + + + + + + + + + + + +	           
SA_XX_byogalbu-927	4 + + + + + + + + + + + + + .yābhimukhī bhavanti āyatanadvārāṇy a + + + + + + + + + + + + + + + + anunayaś ca dūrī bhavati /	    bhavanti                 ca   
SA_XX_byogalbu-928	5 + + + + + + + + + + + + + + + + + + + + masya triprakārasya viṣayeṣūpekṣā + + + + + + + + + + + + + + + + + + bhavati /	                      
SA_XX_byogalbu-929	tato 'sya viṣayasā	tatas sya viṣayasā 
SA_XX_byogalbu-930	6 + + + + + + + + + + + + + + + + + nām aniṣṭeṣu dviṣyamānāṃ tadubhaya .i + + + + + + + + + + + + + + + + + + + + + viṣayopekṣām upasaṃharati	                                                                                                
SA_XX_byogalbu-931	YL 158V1 tadapekṣadoṣanāśāya tataḥ strī anantaparyantam ādarśaṃ gṛhītvaikaikasya satvasyāgrataḥ tiṣṭhati /	tad apekṣa doṣa nāśa tatas strī ananta paryanta ādarśa grah ekaika sattva agratas sthā 
SA_XX_byogalbu-932	+ + + + + + + + + + + + + viṣayebhyaḥ upekṣāṃ pratilabhante / yathā	            
SA_XX_byogalbu-933	2 suparivāritaṃ caikaikaṃ satvaṃ paryaṃkena niṣaṇṇaṃ paśyati /	su parivāritam ca ekaikam satvam paryaṃkena niṣaṇṇam paśyati 
SA_XX_byogalbu-934	iti viṣayopekṣā /	iti viṣaya upekṣā 
SA_XX_byogalbu-935	vedayitopekṣā katarā /	vedayitā upekṣā katarā 
SA_XX_byogalbu-936	+ + + + + + triprakārāyāḥ vedanāyāḥ adhipatirūpam utpadyate /	       utpadyate 
SA_XX_byogalbu-937	3 yathoktaṃ vedanāskandhaparīkṣāyāṃ tatra duḥkhasukhāyāṃ vedanāyām udakavarṇaṃ budbudam u + + + + + .utpadyate paśyataś cāsya upekṣā saṃtiṣṭhate	yathā uktam vedanā skandha parīkṣāyām tatra duḥkha sukhāyām vedanāyām udaka varṇam budbudam         utpadyate paśyataḥ ca asya upekṣā saṃtiṣṭhate 
SA_XX_byogalbu-938	4 pīḍyamānasya dveṣam utpadyate tatrāsyātītā janmaparaṃparābhimukhī bhavati tatrānena + + + + duḥkhaiḥ pīḍitāḥ ghātitāś ca anāgatā ca janmaparaṃparābhimukhī bhavati /	pīḍyamānasya dveṣam utpadyate tatra asya atītā janma paraṃparā abhimukhī bhavati tatra anena   / duḥkhaiḥ pīḍitāḥ ghātitāḥ ca anāgatā ca janma paraṃparā abhimukhī bhavati 
SA_XX_byogalbu-939	5 dveṣasamudācāradoṣadarśanāt kṣiptāśīviṣādiṣu dṛṣṭvā cāsya + + + + + + + + + + + + + + + .āparāddhaḥ anāgata .ā .aṃ doṣaḥ iti duḥkhāyāṃ	dveṣa samudācāra doṣa darśanāt kṣipta āśīviṣa ādiṣu dṛṣṭvā ca asya  / doṣaḥ iti duḥkhāyām 
SA_XX_byogalbu-940	6 vedanāyām upekṣā saṃtiṣṭhate pratighaś ca dūrī bhavati /	vedanāyām upekṣā saṃtiṣṭhate pratighaḥ ca dūrī bhavati 
SA_XX_byogalbu-941	tatkṛtaś ca doṣḥ vyāvartate sukhāyāṃ vedanāyāṃ sukhitasya rāga utpadyate /	tad kṛtaḥ ca doṣḥ vyāvartate sukhāyām vedanāyām sukhitasya rāgaḥ utpadyate 
SA_XX_byogalbu-942	tatrātītāṃ janmaparaṃparām abhimukhī karoti	tatra atītām janma paraṃparām abhimukhī karoti 
SA_XX_byogalbu-943	YL 158R1 tatrānena sukhavedanāsvādavaśād duścaritaṃ samutthāpitam apāyeṣu duḥkham anubhūtam /	tatra idam sukha vedanā āsvāda vaśa duścarita samutthāpita apāyeṣu duḥkham anubhū 
SA_XX_byogalbu-944	+ + + + + + + + + + + + + pravartamānāṃ c. d. + kṣaṇam ūrdhvam anavasthāyinīṃ	            
SA_XX_byogalbu-945	2 paśyati dṛṣṭvā cāsya sukhāyāṃ vedanāyām upekṣā saṃtiṣṭhati niṣparid. + + + + + + + + + + + + + + + + + + + + .y. satvasamudram abhimukhī bhavati	paśyati dṛṣṭvā ca asya sukhāyām vedanāyām upekṣā saṃtiṣṭhati satva samudram abhimukhī bhavati 
SA_XX_byogalbu-946	3 sa teṣāṃ vedayitopekṣām upasaṃharati /	sa teṣām vedayitā upekṣām upasaṃharati 
SA_XX_byogalbu-947	tadapekṣadoṣanāśāya tato vaiḍūryastaṃbhamahāprāsāda utpadyate yatra te satvā triprakārasya vedayitādhyavasānasyādīnavaṃ	tad apekṣa doṣa nāśāya tatas vaiḍūrya staṃbha mahā prāsādaḥ utpadyate yatra te satvā tri prakārasya vedayitā adhyavasānasya ādīnavam 
SA_XX_byogalbu-948	4 dṛṣṭvā kramaśaḥ upekṣāṃ pratilabhante tata eva sa vaiḍūryastaṃbhaniḥsṛtaiḥ paṭṭais tadvarṇaiś ca kūṭāgārair avacchāditā dṛśyante /	dṛṣṭvā kramaśas upekṣām pratilabhante tatas eva sa vaiḍūrya staṃbha niḥsṛtaiḥ paṭṭaiḥ tad varṇaiḥ ca kūṭāgāraiḥ avacchāditāḥ dṛśyante 
SA_XX_byogalbu-949	ratnaprāsādāntargataṃ	ratna prāsāda antargatam 
SA_XX_byogalbu-950	5 vedayitaṃ triprakāraṃ parīkṣamāṇā dṛśyante iti vedayitopekṣā / //	vedayitam tri prakāram parīkṣamāṇāḥ dṛśyante iti vedayita upekṣā 
SA_XX_byogalbu-951	bālacaritaratyupekṣā katarā /	bāla carita rati upekṣā katarā 
SA_XX_byogalbu-952	tatrāsyātītajanmaparaṃparābhimukhī bhavati /	tatra asya atīta janma paraṃparā abhimukhī bhavati 
SA_XX_byogalbu-953	ihajānmikam anyajānmikaṃ	ihajānmikam anyajānmikam 
SA_XX_byogalbu-954	6 ca caritaṃ paśyati /	ca caritam paśyati 
SA_XX_byogalbu-955	ihajanmani maithunayuddhakaraṇanirīkṣaṇābhirataḥ anyajanmani ca + + + + + + + + + + + + + + + + + + + l. + nas vaiśvābhūtena rāgadveṣamohavaśād	iha janman maithuna yuddha karaṇa nirīkṣaṇa abhiram anya janman ca 
SA_XX_byogalbu-956	YL 159V1 duścaritaṃ samutthāpitam apāyeṣu ca duḥkham anubhūtam evam anantaparyantāṃ	duścaritam samutthāpay apāyeṣu ca duḥkham anubhū evam ananta paryanta 
SA_XX_byogalbu-957	janmaparaṃparām apāyeṣv ākṣiptāṃ paśyati tato hryavatrāpyādhipatirūpam utpadyate	janma paraṃparām apāyeṣu ākṣiptām paśyati tatas utpadyate 
SA_XX_byogalbu-958	avadātavastraprāvṛtā	avadāta vastra prāvṛtā 
SA_XX_byogalbu-959	2 strī puruṣaś ca hrīḥ kleśebhyo lajjati avatrāpyaṃ duścaritebhyaḥ hrīr duścaritebhyaḥ avatrāpyaṃ duścaritaphalāt /	strī puruṣaḥ ca hrīḥ kleśebhyaḥ lajjati avatrāpyam duścaritebhyaḥ hrīḥ duścaritebhyaḥ avatrāpyam duścarita phalāt 
SA_XX_byogalbu-960	dṛṣṭvā cāsya parā hrīr utpadyate /	dṛṣṭvā ca asya parā hrīḥ utpadyate 
SA_XX_byogalbu-961	bālacaritaratibhyaś	bāla carita ratibhyaḥ 
SA_XX_byogalbu-962	3 copekṣā saṃtiṣṭhate /	ca upekṣā saṃtiṣṭhate 
SA_XX_byogalbu-963	tato 'sya bālacaritakrīḍa + + satvasamudram abhimukhī bhavati /	satva samudram abhimukhī bhavati 
SA_XX_byogalbu-964	sa teṣāṃ bālacaritaratyupekṣām upasaṃharati tadapekṣadoṣanāśaya	sa teṣām bāla carita rati upekṣām upasaṃharati tad apekṣa doṣa nāśaya 
SA_XX_byogalbu-965	4 tato bhagavān utpadyate taṃniḥsṛtaiś cālokaiḥ satvā avabhāsitāḥ .ṛ .v. + + + + + + + + + upekṣāṃ pratilabhante sarvasatvāḥ saṃvignāś ca bhagavato	tatas bhagavān utpadyate tad niḥsṛtaiḥ ca ālokaiḥ satvāḥ avabhāsitāḥ upekṣām pratilabhante sarva satvāḥ saṃvignāḥ ca 
SA_XX_byogalbu-966	5 'ntike gacchanti pravrajyām api yācante /	ntike gacchanti pravrajyām api yācante 
SA_XX_byogalbu-967	bhagavāṃś caihibkikṣukayā pravrājayati te pravrajitā niṣkleśā + + + + + + + + vṛkṣamūleṣu kuṭikā māpitāḥ te punaḥ	bhagavān ca aihibkikṣukayā pravrājayati te pravrajitāḥ niṣkleśā          vṛkṣa mūleṣu kuṭikāḥ māpitāḥ te punar 
SA_XX_byogalbu-968	6 satvāḥ paryaṃkena niṣaṇṇā upekṣakās tiṣṭhanti /	satvāḥ paryaṃkena niṣaṇṇāḥ upekṣakāḥ tiṣṭhanti 
SA_XX_byogalbu-969	bālacaritaratyupekṣā //	        
SA_XX_byogalbu-970	bhavāṃgopekṣā katarā /	bhava aṃga upekṣā katarā 
SA_XX_byogalbu-971	pratītyasamutpādaṃ parīkṣamāṇasya dvādaśāmgaṃ pratītyasamutpādacakraṃ	pratītyasamutpādam parīkṣamāṇasya dvādaśa amgam pratītyasamutpāda cakram 
SA_XX_byogalbu-972	YL 159R1 saṃskārasāṃtānikaṃ traidhātukaṃ karmakleśāvabaddhaṃ bhramantam abhimukhī bhavati dṛṣṭvā cāsya vaimukhyam utpadyate /	saṃskāra sāṃtānikam traidhātukam karma kleśa avabaddham bhramantam abhimukhī bhavati dṛṣṭvā ca idam vaimukhyam utpadyate 
SA_XX_byogalbu-973	tataḥ siṃhāsanādhirūḍhā aṣṭau buddhapratimāḥ āryāṣṭāṃgasya mārgasyādhipatirūpam	tatas siṃhāsana adhirūḍhāḥ aṣṭau buddha pratimāḥ ārya aṣṭāṃgasya mārgasya adhipati rūpam 
SA_XX_byogalbu-974	2 utpadyante /	utpadyante 
SA_XX_byogalbu-975	taṃmukhaniḥsṛtair indrāyudhair avidyādhipatirūpam abhyāhataṃ nirudhyate vicakrī bhavati ca dvādaśāṃgaṃ pratītyasamutpādacakram ākāśanibhaiḥ	tad mukha niḥsṛtaiḥ indrāyudhaiḥ avidyā adhipati rūpam abhyāhatam nirudhyate vicakrī bhavati ca dvādaśa aṃgam pratītyasamutpāda cakram ākāśa nibhaiḥ 
SA_XX_byogalbu-976	3 kūṭāgārair avaṣṭabhyante yogācārāśraya upar. + + + + + .ī + .e + + + + + + + + + + + + + haṃ cāsya tasmiṃ samaye cittaṃ bhavati tato	kūṭāgāraiḥ avaṣṭabhyante yoga ācāra āśraye haṃ ca asya tasmin samaye cittam bhavati 
SA_XX_byogalbu-977	4 'sya dvādaśāṃgapratītyasamutpādacakrakṛtaṃ parasparakarmakleśāvabaddhaṃ satvasamudram abhimukhī bhavati /	dvādaśa aṃga pratītyasamutpāda cakra kṛtam paraspara karma kleśa avabaddham satva samudram abhimukhī bhavati 
SA_XX_byogalbu-978	sa teṣāṃ bhavāṃgopekṣām upasaṃharati tadapekṣadoṣanāśāya /	sa teṣām bhava aṃga upekṣām upasaṃharati tad apekṣa doṣa nāśāya 
SA_XX_byogalbu-979	5 tato bhagavān utpadyate /	tatas bhagavān utpadyate 
SA_XX_byogalbu-980	gṛhītacandramaṇḍalaḥ tatraikaikaśsḥ satvānām eṣa eva parīkṣā kramaśaḥ + + + + + + + .e .ām utpadyate /	gṛhīta candra maṇḍalaḥ satvānām eṣaḥ eva parīkṣā kramaśas        utpadyate 
SA_XX_byogalbu-981	tato bhagavaṃmukhaniḥsṛtair indrāyudhair vajrākāraiḥ sarvāvidyādhipatirūpāṇi parāhatāni nirudhyante /	tatas bhagavaṃmukha niḥsṛtaiḥ indrāyudhaiḥ vajra ākāraiḥ sarva avidyā adhipati rūpāṇi parāhatāni nirudhyante 
SA_XX_byogalbu-982	vicakrī bhavanti /	vicakrī bhavanti 
SA_XX_byogalbu-983	sarvasatvānāṃ dvādaśāṃgāḥ pratītyasamutpādacakrāḥ tathaiva cākāśanibhaiḥ	sarva satvānām dvādaśa aṃgāḥ pratītyasamutpāda cakrāḥ tathā eva ca ākāśa nibhaiḥ 
SA_XX_byogalbu-984	YL 160V1 kūṭāgārair avaṣṭabhyante /	kūṭāgāraiḥ avaṣṭambh 
SA_XX_byogalbu-985	iti bhavāṃgopekṣā /	iti bhava aṃga upekṣā 
SA_XX_byogalbu-986	ātmaparikalpopekṣā katamā /	ātma parikalpa upekṣā katamā 
SA_XX_byogalbu-987	ihāsya ṣaḍdhātuparīkṣānukūlārthaṃ goghātakaḥ gṛhītaśastra utpadyate /	iha asya ṣaṣ dhātu parīkṣā anukūla artham go ghātakaḥ gṛhīta śastraḥ utpadyate 
SA_XX_byogalbu-988	sa gāṃ vadhayitvā	sa gām vadhayitvā 
SA_XX_byogalbu-989	2 taccarmaṇi ṣaḍ bilāṃ bhāgaśaḥ pratyavekṣate /	tad carmaṇi ṣaṣ bilām bhāgaśas pratyavekṣate 
SA_XX_byogalbu-990	tato yogino nābhyāḥ śastraṃ nirgacchati /	tatas yoginaḥ nābhyāḥ śastram nirgacchati 
SA_XX_byogalbu-991	yoginaś cāśrayaṃ ṣaḍ bilāṃ bhāgaśaḥ taccarmaṇy avasthāpayati /	yoginaḥ ca āśrayam ṣaṣ bilām bhāgaśas tad carmaṇi avasthāpayati 
SA_XX_byogalbu-992	dakṣiṇaṃ + + + + pṛthivīdhātuḥ	dakṣiṇam pṛthivī dhātuḥ 
SA_XX_byogalbu-993	3 sthirataratvāt /	sthiratara tvāt 
SA_XX_byogalbu-994	vāmam abdhātuḥ durbalataratvāt /	vāmam ap dhātuḥ durbalatara tvāt 
SA_XX_byogalbu-995	dakṣiṇo bāhuḥ vāyudhātuḥ sthirataratvāt /	dakṣiṇaḥ bāhuḥ vāyu dhātuḥ sthiratara tvāt 
SA_XX_byogalbu-996	vāmas tejodhātuḥ + + + + + + + + + + + .āt / tenaiva	vāmaḥ tejaḥ dhātuḥ            ā t tena eva 
SA_XX_byogalbu-997	4 ca kāraṇena vāmapārśvaśayināṃ śīghrataraṃ jīryate madhyamaṃ gaṇḍam ākāśadhātuḥ suṣirataratvāt /	ca kāraṇena vāma pārśva śayinām śīghrataram jīryate madhyamam gaṇḍam ākāśa dhātuḥ suṣiratara tvāt 
SA_XX_byogalbu-998	sakalaṃ mukhaṃ vijñānadhātoḥ + + + + + + + + +	sakalam mukham vijñāna dhātoḥ 
SA_XX_byogalbu-999	5 yapravṛtteḥ tato yogācārāśrayaniḥsṛtāni śastrāṇi tadvad eva ṣaḍdhātuvibhāgena kṛtsnaṃ satvasamudram avasthāpayanti asatvākhyaṃ ca paṃcadhātuvibhāgena hastābhyām ekaikaśas	tatas yoga ācāra āśraya niḥsṛtāni śastrāṇi tadvat eva ṣaṣ dhātu vibhāgena kṛtsnam satva samudram avasthāpayanti asatva ākhyam ca paṃca dhātu vibhāgena hastābhyām ekaikaśas 
SA_XX_byogalbu-1000	6 tāṃ dhātūṃ tulayati /	tām dhātūm tulayati 
SA_XX_byogalbu-1001	te samaṃ tulyante tataḥ kathayati /	te samam tulyante tatas kathayati 
SA_XX_byogalbu-1002	ayam api pṛthivīdhātur ayam api pṛthivīdhātuḥ ayam apy abdhātur evaṃ yāvad vijñānadhātuḥ /	ayam api pṛthivī dhātuḥ ayam api pṛthivī dhātuḥ ayam api ap dhātuḥ evam yāvat vijñāna dhātuḥ 
SA_XX_byogalbu-1003	ayam apy ātmātmīyavirahitaḥ	ayam api ātmā ātmīya virahitaḥ 
SA_XX_byogalbu-1004	YL 160R1 ayam apy ātmātmīyavirahitaḥ tato + + + ya ṣaḍdhātu ṣaḍbilāni nirvidāgninā jvalanti tadanye ca satvā + + + + + + + + + + + + + +	idam api ātma ātmīya virahitaḥ 
SA_XX_byogalbu-1005	2 sarvasatvāsatvākhyāni ṣaḍdhātumaṇḍalāny avaśiṣyante tato bhāgaśo hastābhyāṃ satvākhyāṃś cāsatvākhyāṃś ca tulayati /	sarva sattva asattva ākhyāni ṣaṣ dhātu maṇḍalāni avaśiṣyante tatas bhāgaśas hastābhyām sattva ākhyān ca a sattva ākhyān ca tulayati 
SA_XX_byogalbu-1006	ayam api pṛthivīdhātur ity evamādi pūrvavat /	ayam api pṛthivī dhātuḥ iti evamādi pūrvavat 
SA_XX_byogalbu-1007	tataḥ ṣaḍdhātumaṇḍalaiḥ	tatas ṣaṣ dhātu maṇḍalaiḥ 
SA_XX_byogalbu-1008	3 lokaṃ pūrṇaṃ paśyati ākāśāc ca tailahārāḥ patitāḥ sarvāṇi maṇḍalāni kaṃpayanti abhisaṃkṣipyante ca tāni yā + + .i + + + + + + + +	lokam pūrṇam paśyati ākāśāt ca taila hārāḥ patitāḥ sarvāṇi maṇḍalāni kaṃpayanti abhisaṃkṣipyante ca tāni yā 
SA_XX_byogalbu-1009	4 yamuktā naśyamānā dṛśyante /	yamuktāḥ naśyamānāḥ dṛśyante 
SA_XX_byogalbu-1010	tato bindubhyaḥ ṣaḍdhātumayam āśrayaṃ nirvartate pradīpahastā ca strī prajñādhipatirūpaṃ praṇāśitam āśrayaṃ śunyam ātmātmīyavirahitaṃ	tatas bindubhyaḥ ṣaṣ dhātu mayam āśrayam nirvartate pradīpa hastā ca strī prajñā adhipati rūpam praṇāśitam āśrayam śunyam ātma ātmīya virahitam 
SA_XX_byogalbu-1011	5 dhātumātrakam idam iti prakāśayati /	dhātu mātrakam idam iti prakāśayati 
SA_XX_byogalbu-1012	tatra cāntā rāśiyogenāśīti krimikulasahasrāṇi dṛśyante /	tatra ca antāḥ rāśi yogena aśīti krimi kula sahasrāṇi dṛśyante 
SA_XX_byogalbu-1013	evaṃ caturuttaraṃ rogaśataṃ mahābhūtāśīviṣaparipūrṇa + + + + + +	evam catur uttaram roga śatam mahābhūta āśīviṣa paripūrṇa        
SA_XX_byogalbu-1014	6 rṇāṃ dvāre dvāre ca skandhapaṃcakaṃ pravartamānaṃ payati tadadhipatirūpāṇi skandhaprayoge vibhaktāni evaṃ sarvasatvāṃ prakāśayati tataḥ sarvasatvāsatvākhyaṃ lokaṃ + + + +	dvāre dvāre ca skandha paṃcakam pravartamānam tad adhipati rūpāṇi skandha prayoge vibhaktāni evam sarva satvām prakāśayati tatas sarva sattva asattva ākhyam lokam 
SA_XX_byogalbu-1015	YL 161V1 muktaṃ paśyati /	yl muktam paśyati 
SA_XX_byogalbu-1016	sa evaṃ vicitrasaṃskāragataṃ hetupratyayādhīnam ātmātmīyavirahitaṃ gatipaṃcake bhramantaṃ suśikṣitanaṭam iva vicitrāṃ veṣaviśeṣāṃ kurvantaṃ paśyati dṛṣṭvā cāsya saṃskāreṣūpekṣā	saḥ evam vicitra saṃskāra gatam hetu pratyaya adhīnam ātma ātmīya virahitam gati paṃcake bhramantam su śikṣita naṭam iva vicitrām veṣa viśeṣām kurvantam paśyati dṛṣṭvā ca asya saṃskāreṣu upekṣā 
SA_XX_byogalbu-1017	2 utpadyate tato 'sya sphaṭikamayair abhrakūṭaiḥ kāyam avaṣṭabhyate /	utpadyate sphaṭika mayaiḥ abhra kūṭaiḥ kāyam avaṣṭabhyate 
SA_XX_byogalbu-1018	muhūrtāc ca sphaṭikakūṭāgārāntargatam ātmānaṃ paśyati tato hṛdaye strī avadātavarṇā avadātavastraprāvṛtā	muhūrtāt ca sphaṭika kūṭāgāra antargatam ātmānam paśyati tatas hṛdaye strī avadāta varṇā avadāta vastra prāvṛtā 
SA_XX_byogalbu-1019	3 paryaṃkena niṣaṇṇānābhogāvasthitā upekṣādhipatirūpaṃ saṃbhavati /	paryaṃkena niṣaṇṇa anābhoga avasthitā upekṣā adhipati rūpam saṃbhavati 
SA_XX_byogalbu-1020	tato 'syānābhogāvasthitasya + + + + + + + + + + + + .ī +	     
SA_XX_byogalbu-1021	4 evam udakasamkṣobhaḥ agnisaṃkṣobhaḥ vāyusaṃkṣobhaḥ yathāsaṃvartanīṣu evaṃ svajanmavināśam ante + + + + + + + + + + + + + + + + + + + +	evam udaka samkṣobhaḥ agni saṃkṣobhaḥ vāyu saṃkṣobhaḥ yathā saṃvartanīṣu evam sva janma vināśam ante 
SA_XX_byogalbu-1022	5 m. maitrānusāreṇa upekṣā saṃtiṣṭhate /	maitra anusāreṇa upekṣā saṃtiṣṭhate 
SA_XX_byogalbu-1023	na nairghṛṇyadoṣāt /	na nairghṛṇya doṣāt 
SA_XX_byogalbu-1024	evaṃ cāsyopekṣakasya viharataḥ sā + + + satvasamudram abhimukhī bhavati sa teṣām ātmaparikalpopekṣām upasaṃharati /	evam ca asya upekṣakasya viharataḥ sā satva samudram abhimukhī bhavati sa teṣām ātma parikalpa upekṣām upasaṃharati 
SA_XX_byogalbu-1025	6 tadapekṣadoṣanāśāya /	tad apekṣa doṣa nāśāya 
SA_XX_byogalbu-1026	tadupasaṃhārahetoś ca bhagavān utpadya svaśarīraniḥsṛtaiḥ + + + + + + + + + + + + + + + + + + + + + + + +	tad upasaṃhāra hetoḥ ca bhagavān utpadya sva śarīra niḥsṛtaiḥ 
SA_XX_byogalbu-1027	YL 161R1 teṣāṃ tathaivopekṣā saṃtiṣṭhate sphaṭikasamayaiś ca abhrakūṭair avaṣṭabhyante /	teṣām tathā eva upekṣā saṃtiṣṭhate sphaṭika samayaiḥ ca abhra kūṭaiḥ avaṣṭabhyante 
SA_XX_byogalbu-1028	tathaiva sphaṭikamayakūtāgārāntargatāṃ satvāṃ paśyati /	tathā eva sphaṭika maya kūta āgāra antargatām satvām paśyati 
SA_XX_byogalbu-1029	apramāṇopekṣā katarā + + + + + + +	apramāṇa upekṣā katarā 
SA_XX_byogalbu-1030	2 .ai +ṃ + + + + bhagavatparinirvāṇam abhimukhī bhavati vajraśailam iva vanakaṃpane dharmānusāri + + + + + + + + + + + + + + + + + + + + + + + + nirvāṇapurasthaṃ	ai ṃ    bhagavat parinirvāṇam abhimukhā bhavati vajra śailam iva vana kampane dharma anusāri 
SA_XX_byogalbu-1031	3 ca bhagavantaṃ dhārmyāṃ gaṇḍikām ākoṭayantaṃ paśyati sa śabdaḥ anantāṃ lokadhātūn āpūrayati s. + + + + + + + + + + + + + + + + + + + + +	ca bhagavantam dhārmyām gaṇḍikām ākoṭayantam paśyati sa śabdaḥ anantām lokadhātūn āpūrayati 
SA_XX_byogalbu-1032	4 m iti ghoṣayati śrāvakāṇāṃ nirvāṇapurapraveśakālaṃ sūcayati /	iti ghoṣayati śrāvakāṇām nirvāṇa pura praveśa kālam sūcayati 
SA_XX_byogalbu-1033	tato yāvat tasya bhagavataḥ parivāraḥ tābhyaḥ t. + + + + + + + + + + + + daśadiśo	tatas yāvat tasya bhagavataḥ parivāraḥ tābhyaḥ daśa diśaḥ 
SA_XX_byogalbu-1034	5 'nantaparyantaḥ puṣparatnamayaḥ prādurbhavati yatrādhirūḍhā dṛśyante /	nanta paryantaḥ puṣpa ratna mayaḥ prādurbhavati yatra adhirūḍhāḥ dṛśyante 
SA_XX_byogalbu-1035	tato nirvāṇapuraṃ praviśatā vaiḍūryābhaḥ dauvārikaḥ puruṣo v. + + + + + + + kathayati / iha nagare	tatas nirvāṇa puram praviśatā vaiḍūrya ābhaḥ dauvārikaḥ puruṣaḥ        kathayati iha nagare 
SA_XX_byogalbu-1036	6 yaḥ praviṣṭo na bhūyo nirgacchatīti /	yaḥ praviṣṭaḥ na bhūyas nirgacchati iti 
SA_XX_byogalbu-1037	te ca praviṣṭāḥ ākāśamayair ivābhrakūṭair avaṣṭabdhāḥ pradīpā iva śāmyante śī + + + + + + + + tata āśraye balavaiśāradyāveṇikasmṛtyupasthānamahākaruṇādhipatirūpāṇi	te ca praviṣṭāḥ ākāśa mayaiḥ iva abhra kūṭaiḥ avaṣṭabdhāḥ pradīpāḥ iva śāmyante         tatas āśraye bala vaiśāradya āveṇika smṛti upasthāna mahā karuṇā adhipati rūpāṇi 
SA_XX_byogalbu-1038	YL 162V1 dṛśyante tatra balānāṃ ravimaṇḍalacitā daśa hastinaḥ tadvarṇās tadadhirūḍhā ravimaṇḍalacitāḥ eva daśa buddhapratimāḥ yathāsvabalagocaram	dṛś tatra bala ravi maṇḍala ci daśan hastin tad varṇa tad adhiruh ravi maṇḍala ci eva daśan buddha pratimā yathāsva bala gocara 
SA_XX_byogalbu-1039	2 ālokenāvaṣṭabhya tiṣṭhanti vaiśāradyānāṃ catvāro buddhapratimāḥ siṃhāsanādhirūḍhāḥ svaṃ svaṃ gocaram ālokenāvabhāsya tiṣṭhanti /	ālokena avaṣṭabhya tiṣṭhanti vaiśāradyānām catvāraḥ buddha pratimāḥ siṃhāsana adhirūḍhāḥ svam svam gocaram ālokena avabhāsya tiṣṭhanti 
SA_XX_byogalbu-1040	trayāṇām āveṇikānāṃ smṛtyupasthānānāṃ	trayāṇām āveṇikānām smṛti upasthānānām 
SA_XX_byogalbu-1041	3 gṛhītatailapātrāyudhās trayaḥ puruṣāḥ /	gṛhīta taila pātra āyudhāḥ trayaḥ puruṣāḥ 
SA_XX_byogalbu-1042	mahākaruṇāyāḥ ākāśavarṇā hṛdaye strī suvarṇābhā nīlavastraprāvṛtā + + + + + + + + + + ratnapuṣpavarṣaiḥ	mahākaruṇāyāḥ ākāśa varṇā hṛdaye strī suvarṇa ābhā nīla vastra prāvṛtā             ratna puṣpa varṣaiḥ 
SA_XX_byogalbu-1043	4 lokam āpūrayati tato mahākaruṇā guṇā anantaparyantā bhagavadāśraye dṛśyante /	lokam āpūrayati tatas mahā karuṇāḥ guṇāḥ ananta paryantāḥ bhagavat āśraye dṛśyante 
SA_XX_byogalbu-1044	śravakān ādityamaṇḍalādhirūḍhāṃ ā + + + + + + +	śravakān āditya maṇḍala adhirūḍhām as 
SA_XX_byogalbu-1045	5 puruṣā antargatā dṛśyante /	puruṣāḥ antargatāḥ dṛśyante 
SA_XX_byogalbu-1046	aśaikṣadharmādhipatirūpaṃ + + + + + + guṇānām adhipatirūpam aśubhādīnāṃ dṛśyante /	aśaikṣa dharma adhipati rūpam       guṇānām adhipati rūpam aśubha ādīnām dṛśyante 
SA_XX_byogalbu-1047	tato bhagavataḥ hṛdaye ratnamayaḥ siṃha utpadyate	tatas bhagavataḥ hṛdaye ratna mayaḥ siṃhaḥ utpadyate 
SA_XX_byogalbu-1048	6 + + nayena sacarācaro lokaḥ kṣobhyamānaḥ + + + + + + + raśmayo niḥsṛtāḥ satvāṃ vicayaṃ kṛtvā tatraiva ca praviśanti avadātavarṇā ca strī avadātavastrā	nayena sacarācaraḥ lokaḥ kṣobhyamānaḥ  /     raśmayaḥ niḥsṛtāḥ vicayam kṛtvā tatra eva ca praviśanti avadāta varṇā ca strī avadāta vastrā 
SA_XX_byogalbu-1049	YL 162R1 bhagavadāśraye dṛśyate /	bhagavat āśraya dṛś 
SA_XX_byogalbu-1050	kathayati ca /	kathayati ca 
SA_XX_byogalbu-1051	siddhaṃ kāryaṃ nistīrṇā pratijñā /	siddham kāryam nistīrṇā pratijñā 
SA_XX_byogalbu-1052	parisamāptā vaineyāḥ śāntaṃ nirvāṇam iti tato bhagavāṃ gāthāṃ bhāṣate /	parisamāptāḥ vaineyāḥ śāntam nirvāṇam iti tatas bhagavān gāthām bhāṣate 
SA_XX_byogalbu-1053	2 anityā bata saṃskārā utpādavyayadharmiṇaḥ utpadya hi nirudhyante teṣāṃ vyupaśamaḥ sukhaṃ /	anityāḥ bata saṃskārāḥ utpāda vyaya dharmiṇaḥ utpadya hi nirudhyante teṣām vyupaśamaḥ sukham 
SA_XX_byogalbu-1054	ity uktvā nirvāṇanagare praviśyākāśanibhair abhrakūṭair ivopagūḍhāyāṃ sthityām anabhilāṣī	iti uktvā nirvāṇa nagare praviśya ākāśa nibhaiḥ abhra kūṭaiḥ iva upagūḍhāyām sthityām anabhilāṣī 
SA_XX_byogalbu-1055	3 pradīpa ivopaśamaṃ gacchati /	pradīpaḥ iva upaśamam gacchati 
SA_XX_byogalbu-1056	bhagavataś ca śrāvakāḥ paścāt parinirvāṇakāle nirvāṇapuraṃ praviṣṭās tathaivopaśamaṃ gacchanti / + + + + + + +	bhagavataḥ ca śrāvakāḥ paścāt parinirvāṇa kāle nirvāṇa puram praviṣṭāḥ tathā eva upaśamam gacchanti  /
SA_XX_byogalbu-1057	4 dauvārikena pratiṣidhyate /	dauvārikena pratiṣidhyate 
SA_XX_byogalbu-1058	yadā tvaṃ + + + + + + + + + + + + + tadā tvam apy atra pravekṣyasīti /	yadā tvam             tadā tvam api atra pravekṣyasi iti 
SA_XX_byogalbu-1059	kṛtsnaṃ satvasamudraṃ + + + + + + + + + drśyate /	kṛtsnam sattva samudram          drśyate 
SA_XX_byogalbu-1060	5 evam apāyasthānā bandhanabaddhā nānāduḥkhapīḍitāḥ + + + + + + + kathayanti na paritrāyasva kāruṇikāsmāṃ nārhasi parinirvāṇanagaraṃ gantum	evam apāya sthānāḥ bandhana baddhāḥ nānā duḥkha pīḍitāḥ         kathayanti na paritrāyasva kāruṇikā asmām na arhasi parinirvāṇa nagaram gantum 
SA_XX_byogalbu-1061	mahākaruṇādhipatirūpaṃ	          
SA_XX_byogalbu-1062	6 cāsya yathoktaṃ hṛdaya utpadyate /	ca asya yathoktam hṛdaye utpadyate 
SA_XX_byogalbu-1063	hastābhyāṃ ca tam anugṛhya kathayati /	hastābhyām ca tam anugṛhya kathayati 
SA_XX_byogalbu-1064	utsṛjya duḥkhitāṃ kva gantuṃ icchasīti /	utsṛjya duḥkhitām kva gantum icchasi iti 
SA_XX_byogalbu-1065	tasyopekṣā dūrī bhavati /	tasya upekṣā dūrī bhavati 
SA_XX_byogalbu-1066	karuṇāvakramati /	karuṇā avakramati 
SA_XX_byogalbu-1067	sa bāhubhyāṃ	sa bāhubhyām 
SA_XX_byogalbu-1068	YL 163V1 kṛtsnaṃ satvasamudraṃ svajann am. + + + + + + + + + + + + + + + + + + + + + + + + + + + + + + + + duḥkhās tejasvinaḥ sarva + + + +	kṛtsna sattva samudram svaj 
SA_XX_byogalbu-1069	2 + lakṣaṇānuvyaṃjanavirājita + + + + + + + + + + (gap V3 to 6; ca. 250 Akṣaras)	      ca   
SA_XX_byogalbu-1070	YL 163R1 + + + + + + + + + + + + + + miśrībhūtaḥ yāvad vāyumaṇḍalaṃ bhitvādhaś cordhvaṃ	                 
SA_XX_byogalbu-1071	ca gatvā + + + + + + + + + + + + + + + + + + + + + + + + + + + + + + + + + + + + + + + + + + +	ca gatvā 
SA_XX_byogalbu-1072	2 brahmahṛdayeṣu cāvadātavarṇā strī + + + + + + + + + + + + + + (gap R3 to 6; ca. 210 Akṣaras)	brahma hṛdayeṣu ca avadāta varṇā strī             ca 
SA_XX_byogalbu-1073	+ + + + + + + + + + + + + + manasikāro + + + + + ihāryaśrāvakas tathāgatam ākārataḥ samanusmarati /	            samanusmarati 
SA_XX_byogalbu-1074	YL 164V1 iti hi sa bhagavāṃs tathāgato 'rhaṃ samyaksaṃbuddho vidyācaraṇasaṃpannaḥ sugato lokavid anuttaraḥ puruṣadamyasārathiḥ śāstā devamanuṣyāṇāṃ buddho bhagavān /	iti hi tad bhagavant tathāgata rha samyaksaṃbuddha vidyā caraṇa saṃpad sugata loka vid anuttaraḥ puruṣa damya sārathi śāstā deva manuṣyāṇām buddhaḥ bhagavant 
SA_XX_byogalbu-1075	tasyaivaṃ tathāgatam	tasya evam tathāgatam 
SA_XX_byogalbu-1076	2 ākārataḥ samanusmarataḥ + + + + + + + + + + + + + + + + + + + + + + + + + + + + + + + + + + + + + + + + + + + + + + + + + 3 + + + + + + +	ākārāt samanusmarataḥ 
SA_XX_byogalbu-1077	4 + + + + + + + + + + + + taḥ suvarnarūpyavaiḍūryasphaṭikamusāragalvāśmagarbha + + + tadvarṇair buddhāśrayai + + + + + + + + + + + + + +	                                     
SA_XX_byogalbu-1078	5 + + + + + + + + + + + + + pṛthivīm āpūrayanti /	         
SA_XX_byogalbu-1079	vajrāsanaṃ ca tata eva + + + + + + + + + bhagavān yāvad aghaniṣṭhāṃ + + + + + + + + + + + + + +	vajrāsanam ca tatas eva       bhagavān yāvat 
SA_XX_byogalbu-1080	6 + + + + + + + + + + + + + + + + + bodhisatvam ādau bodhipraṇidhānaṃ + + + + + + + + anuttaraṃ dānaśīlavīryaprajñā + + + + + + + + + + + +	                       
SA_XX_byogalbu-1081	YL 164R1 + + + + + + + + + + + + + + + + vati yāvat tuṣitabhavanāc cyavam. + + + + + mātuḥ kukṣisaṃprajānaniṣkramaṇaṃ duṣkaracaryāṃ + + + +	di di di yāvat tuṣita bhavana cyava       mātṛ kukṣi saṃprajāna niṣkramaṇam duṣkara caryā       
SA_XX_byogalbu-1082	2 + + + + + + + + + + + paṃcakabhikṣuvinayanaṃ biṃbasāravinayanam upatiṣyakolitavinayanaṃ pitṛvinayanaṃ mahāprātihāryaṃ mahā + + + + + + + +	                       
SA_XX_byogalbu-1083	3 + + + + + + + + + + + + ti / yāvat parinirvāṇakāle sthaviram ānandam āmantrayati /	         ti yāvat parinirvāṇa kāle sthaviram ānandam āmantrayati 
SA_XX_byogalbu-1084	prajñāpayānanda yamakasālayor antareṇottarāśīrṣaṃ maṃcam	prajñāpaya ānanda yamaka sālayoḥ antareṇa uttarāśīrṣam maṃcam 
SA_XX_byogalbu-1085	4 adya tathāgatasya rātryāḥ madhyame yāme nirupadhiśeṣe nirvāṇadhātau parinirvāṇaṃ bhaviṣyatīti / + + + + + + + + + + + + + + +	adya tathāgatasya rātryāḥ madhyame yāme nirupadhi śeṣe nirvāṇa dhātau parinirvāṇam bhaviṣyati iti 
SA_XX_byogalbu-1086	5 + + + + + + parivṛtaṃ yāvan mallā + + + + + + + + + + + + ayodroṇyaḥ citāṃ bh. + + + + + + + + + + + + + + + + + + + + + + + + + + +	              
SA_XX_byogalbu-1087	6 + + + + + ratnamayaiḥ kumbhaiḥ devagaṇā + + + + + + + + + + + + + + + + devās tejo + + + + + + + + + + + + + + + + + + + + + + + + + + +	ratna mayaiḥ kumbhaiḥ deva gaṇāḥ 
SA_XX_byogalbu-1088	YL 165V1 + + + + + + + + + + + + + + manuṣyāṇāṃ yogācārasya ca hānārtha + + + + + + caturdiśa āpūryante /	di di                                                                           
SA_XX_byogalbu-1089	+ + + + v. + .y. + suvarṇasarṣapa + + + + + +	ro-0 fl-2 fl-3 
SA_XX_byogalbu-1090	2 + + + + + + + + + + + + + + ghaiś ca pṛthivī purṇeti /	          
SA_XX_byogalbu-1091	punar buddhānusmṛtipūrvaṃ mūrdhnopanibaddhacittasya vaiḍūryamayī strī snehaparipūrṇavaiḍūryabhājanacitotpadyate /	punar buddha anusmṛti pūrvam mūrdhnā upanibaddha cittasya vaiḍūrya mayī strī sneha paripūrṇa vaiḍūrya bhājana citā utpadyate 
SA_XX_byogalbu-1092	3 bhājaneṣu vajrāsanāni vajrāsaneṣv ādityamaṇḍalāni /	bhājaneṣu vajra āsanāni vajra āsaneṣu āditya maṇḍalāni 
SA_XX_byogalbu-1093	teṣu buddhā bhagavantaḥ lakṣaṇānuvyaṃjanavirājitāśrayāḥ dha + + + + + + + + + + +	teṣu buddhāḥ bhagavantaḥ lakṣaṇa anuvyaṃjana virājita āśrayāḥ 
SA_XX_byogalbu-1094	4 dakṣiṇe bāhupradeśe paṃca śvetā gajā ādityamaṇḍalacitāśrayāḥ tadhirūḍhāḥ paṃca buddhā tadvarṇā ādityamaṇḍalacitā eva paṃcānāṃ balānām adhipatirūpam	dakṣiṇe bāhu pradeśe paṃca śvetāḥ gajāḥ āditya maṇḍala cita āśrayāḥ tadhirūḍhāḥ paṃca buddhā tad varṇāḥ āditya maṇḍala citāḥ eva paṃcānām balānām adhipati rūpam 
SA_XX_byogalbu-1095	5 cibuke ca catvāri ratnamaṇḍalāni /	cibuke ca catvāri ratna maṇḍalāni 
SA_XX_byogalbu-1096	tadantargatāḥ siṃhāsanādhirūḍhā buddhāḥ satvebhyo dharmaṃ deśayanti vaiśāradyānām adhipatirūpam /	tad antargatāḥ siṃhāsana adhirūḍhāḥ buddhāḥ satvebhyaḥ dharmam deśayanti vaiśāradyānām adhipati rūpam 
SA_XX_byogalbu-1097	āveṇikānāṃ smṛtyupasthānānāṃ	āveṇikānām smṛti upasthānānām 
SA_XX_byogalbu-1098	6 trayaḥ puruṣā gṛhītāyudhās tailabhājanahastā dṛśyante /	trayaḥ puruṣāḥ gṛhīta āyudhāḥ taila bhājana hastāḥ dṛśyante 
SA_XX_byogalbu-1099	mahākaruṇāyā ākāśavarṇā strī hṛdaye + + + + + + + + + + + + + anugraheṇai + + + + + +	mahākaruṇāyāḥ ākāśa varṇā strī hṛdaye                         
SA_XX_byogalbu-1100	YL 165R1 + + + buddhāśrayeṣu dharmaśarīraṃ dṛśyate /	    buddha āśrayeṣu dharma śarīra dṛś 
SA_XX_byogalbu-1101	tajjanmadharmaśarīraniḥsṛtābhiḥ prabhābhir lokaṃ spharitvā tiṣṭhanti /	tad janma dharma śarīra niḥsṛtābhiḥ prabhābhiḥ lokam spharitvā tiṣṭhanti 
SA_XX_byogalbu-1102	tato buddhā bhagavanta ādityamaṇḍaleṣu praviśanti /	tatas buddhāḥ bhagavantaḥ āditya maṇḍaleṣu praviśanti 
SA_XX_byogalbu-1103	tāni vajrāsaneṣu	tāni vajrāsaneṣu 
SA_XX_byogalbu-1104	2 tāni bhājaneṣu tāni smṛtinimitteṣu smṛtinimittaṃ yogācāramūrdhani /	tāni bhājaneṣu tāni smṛti nimitteṣu smṛti nimittam yoga ācāra mūrdhani 
SA_XX_byogalbu-1105	abhiṣekakāle te + + + + pravāhaḥ + + spharitvā tiṣṭhati sa ca pravilīnaḥ tadāśrayaṃ	abhiṣeka kāle te   pravāhaḥ  spharitvā tiṣṭhati sa ca pravilīnaḥ tad āśrayam 
SA_XX_byogalbu-1106	3 mūrdhnaś cchidreṇa pūrayati tata eva ca niḥsṛtai ratnapravāhaḥ darśanaṃ datvā lalāṭā + + + + + + + + + + + + + + krameṇa yāvat saha nābhiniḥsṛtena	mūrdhnaḥ chidreṇa pūrayati tatas eva ca niḥsṛtaiḥ ratna pravāhaḥ darśanam da tvā lalāṭā 
SA_XX_byogalbu-1107	4 pravāhena miśrībhūtaḥ sthitim āpūrayati ratnamayī ca sthitir dṛśyate buddhā + + + + + + + + ḥ ratnakūṭāgārai + + + + + + + + + + + + + +	pravāhena miśrībhūtaḥ sthitim āpūrayati ratna mayī ca sthitiḥ dṛśyate buddhā 
SA_XX_byogalbu-1108	5 + + + + + + + + + + + + ante nābhyāṃ nirudhyate jñeyam iti vyutthānam / //	             
SA_XX_byogalbu-1109	dharmānusmṛtiḥ katarā /	dharma anusmṛtiḥ katarā 
SA_XX_byogalbu-1110	ihāryaśrāvako dharmam ākārataḥ samanusmarati /	iha ārya śrāvakaḥ dharmam ākārataḥ samanusmarati 
SA_XX_byogalbu-1111	svākhyāto bhagavato	su ākhyātaḥ bhagavataḥ 
SA_XX_byogalbu-1112	6 dharmaḥ sāṃdṛṣṭiko nirjvara ākālikaḥ aupanāyikaḥ ehipaśyikaḥ pratyātmavedanīyo vijñaiḥ tasyaivaṃ dharmam ākārataḥ samanusmarataḥ + + + + +	dharmaḥ sāṃdṛṣṭikaḥ nirjvaraḥ ākālikaḥ aupanāyikaḥ ehipaśyikaḥ pratyātma vedanīyaḥ vijñaiḥ tasya evam dharmam ākārataḥ samanusmarataḥ  /     
SA_XX_byogalbu-1113	YL 166V1 saḥ kṛtsno lokaḥ tīrthyaśāstrāṇi paṭhaṃs tadvad vācayaṃ cchṛṇvaṃś ca dṛśyate /	saḥ kṛtsnaḥ lokaḥ tīrthya śāstrāṇi paṭhan tadvat vācayan śṛṇvan ca dṛśyate 
SA_XX_byogalbu-1114	tadvacanānu + + + satvā yadbhūyasāpāyeṣūpapadyante /	tat vacanā anu satvāḥ yat bhūyasā apāyeṣu upapadyante 
SA_XX_byogalbu-1115	tato bhagavān utpadya dharmaṃ	tatas bhagavān utpadya dharmam 
SA_XX_byogalbu-1116	2 deśayati tato lokaḥ sāṃketikena śasanena + + + + + sūtravinayābhidharmaṃ paṭhaṃ vācayaṃ cchṛṇvaṃś ca tadanantaraṃ pāramārthikasaddharma +	deśayati tatas lokaḥ sāṃketikena śasanena        sūtra vinaya abhidharmam paṭham vācayan śṛṇvan ca tad anantaram pāramārthika saddharma 
SA_XX_byogalbu-1117	3 aśubhādiprayogeṇa praviṣṭasya smṛtyupasthānādīnāṃ bodhipakṣyāṇāṃ darśanam utpadyate /	aśubha ādi prayogeṇa praviṣṭasya smṛti upasthāna ādīnām bodhi pakṣyāṇām darśanam utpadyate 
SA_XX_byogalbu-1118	tatra caturṇāṃ smṛtyupasthānānāṃ catvāraḥ siṃhāḥ + + + + + + +	tatra caturṇām smṛti upasthānānām catvāraḥ siṃhāḥ       
SA_XX_byogalbu-1119	4 na pītavarṇās tatsadṛśāś catvāro buddhāḥ siṃhanādena kṛtsnaṃ lokam āpūrayanti /	na pīta varṇāḥ tad sadṛśāḥ catvāraḥ buddhāḥ siṃhanādena kṛtsnam lokam āpūrayanti 
SA_XX_byogalbu-1120	caturṇāṃ samyakprahāṇānāṃ + + + + + + + + + + + +	caturṇām samyakprahāṇānām 
SA_XX_byogalbu-1121	5 tadadhirūḍhāḥ catvāraḥ + + + + + + + + caturṇām ṛddhipādānāṃ catvāri vaiḍūryasopānāni + + + + + .āni /	tad adhirūḍhāḥ catvāraḥ       caturṇām ṛddhipādānām catvāri vaiḍūrya sopānāni 
SA_XX_byogalbu-1122	paṃcānām indriyāṇāṃ paṃca + + + + + paṃcānāṃ balānāṃ	paṃcānām indriyāṇām paṃca     paṃcānām balānām 
SA_XX_byogalbu-1123	6 paṃca vajramayā hastinaḥ saptānāṃ bodhyaṃgānāṃ sapta + + + + + buddhāḥ taṃmūrdhasu saptādityamaṇḍalāni /	paṃca vajra mayāḥ hastinaḥ saptānām bodhyaṃgānām sapta                     
SA_XX_byogalbu-1124	saptādityamaṇḍalādhirūḍhā + + + + + + + + +	sapta āditya maṇḍala adhirūḍhā 
SA_XX_byogalbu-1125	YL 166R1 ni / aṣṭāṃgasya mārgasya + + + + + + + + + + + + + + + .ṭ. cādharottaravibhāgena dharmarājika ivāvasthitāḥ loka + + + + + + + + + +	aṣṭan aṅga mārga ca adhara uttara vibhāga dharmarājike iva avasthitāḥ 
SA_XX_byogalbu-1126	2 taḥ sāṃketikapāramārthikaṃ śāsanaṃ + + + + + + + + yadbhūyasā sugatiṃ nirvāṇa + + + + y. ta /	sāṃketika pāramārthikam śāsanam          yat bhūyasā sugatim 
SA_XX_byogalbu-1127	punar dharmānusmṛtipūrvaṃ hṛdayopanibaddhacetaso vaiḍūryamayī	punar dharma anusmṛti pūrvam hṛdaya upanibaddha cetasaḥ vaiḍūrya mayī 
SA_XX_byogalbu-1128	3 strī tadbhājanaṃ snehaparipūrṇāś cotpadyate /	strī tad bhājanam sneha paripūrṇāḥ ca utpadyate 
SA_XX_byogalbu-1129	teṣu vajrāsanāni teṣu ādityamaṇḍalāni teṣu buddhāśrayāḥ + + + + + + + + + + + +	teṣu vajra āsanāni teṣu āditya maṇḍalāni teṣu buddha āśrayāḥ 
SA_XX_byogalbu-1130	4 kṛtsnaṃ saṃsāraṃ prakāśya nirvāṇa + + + + .ādityamaṇḍaleṣu nirudhyante tāni vajrāsaneṣu vajrāsnāni bhājaneṣu bhājanāni smṛtinimitteṣu smṛtinimittaṃ nābhyām /	kṛtsnam saṃsāram prakāśya nirvāṇa      āditya maṇḍaleṣu nirudhyante tāni vajrāsaneṣu vajrāsnāni bhājaneṣu bhājanāni smṛti nimitteṣu smṛti nimittam nābhyām 
SA_XX_byogalbu-1131	5 abhiṣekapravāhāḥ sthitim āpūrayanti /	abhiṣeka pravāhāḥ sthitim āpūrayanti 
SA_XX_byogalbu-1132	dharmāṃ cādityamaṇḍalacitāṃ saṃskṛtāsaṃskṛtān avabhāsya tiṣṭhanti ante ca sarvaṃ jñeyaṃ nābhyāṃ nirudhyate iti	ca āditya maṇḍala citām saṃskṛta a saṃskṛtān avabhāsya tiṣṭhanti ante ca sarvam jñeyam nābhyām nirudhyate iti 
SA_XX_byogalbu-1133	6 vyutthānam / //	vyutthānam 
SA_XX_byogalbu-1134	saṃghānusmṛtiḥ katarā /	saṃgha anusmṛtiḥ katarā 
SA_XX_byogalbu-1135	ihāryaśrāvakaḥ saṃgham ākārataḥ samanusmarati /	iha ārya śrāvakaḥ saṃgham ākārataḥ samanusmarati 
SA_XX_byogalbu-1136	supratipanno bhagavataḥ śrāvakasaṃgha iti + + + + + + + +	su pratipannaḥ bhagavataḥ śrāvaka saṃghaḥ iti 
SA_XX_byogalbu-1137	YL 167V1 + + + + + + + + + + + + + + + + + + + + + + + + + + + + + + + hārā vairdi + + + + + + + + + + + + + + + + + + + + + + + +	ro-0 
SA_XX_byogalbu-1138	2 apāyeṣūpapadyante / + + + + + + + + + + + + + + + + + + + + + + + + + + + + + + + + + + + + + + + + + + + + + + + + + + + + + + + +	apāyeṣu upapadyante 
SA_XX_byogalbu-1139	3 ādityamaṇḍala + + + + + + + + + ṣṭ. bhikṣu + + + + + + + + + + + + + + + + + + + + + + + + + + + + + + + + + + + + + + + + + + + +	ro-0 
SA_XX_byogalbu-1140	4 te / punar hṛdayopanibaddhacetasaḥ vaiḍūryamayī strī snehaparipūrṇavaiḍūryabhājanacitā utpadyate snehabhājaneṣu vajrāsanāni teṣv ādityamaṇḍalāni	te punar hṛdaya upanibaddha cetasaḥ vaiḍūrya mayī strī sneha paripūrṇa vaiḍūrya bhājana citā utpadyate sneha bhājaneṣu vajra āsanāni teṣu āditya maṇḍalāni 
SA_XX_byogalbu-1141	5 teṣu + + + + + + + + + + + + .e tāni ratnāntargatāni cādarś. + + + + + + saṃpannimittam /	teṣu 
SA_XX_byogalbu-1142	nābhipradeśe ratnamayāni + + + + + + + + + + + + + + +	nābhi pradeśe ratna mayāni 
SA_XX_byogalbu-1143	6 + + + + + + + + + + + + + kṣī jvalanirmalaśastracita + + + + + + + + + + grīvā muktācitaṃ + + .e saṃpannimittam / + + + + + + + + + + + +	                       
SA_XX_byogalbu-1144	YL 167R1 + + + + + + + + + + + + + + + + + + + + + + tīrthyagaṇān abhibhūyāvabhāsya lokaṃ pātrī kṛtvādityamaṇḍaleṣu praviśati tāni vajrāsaneṣu tāni ca bhājaneṣu	tīrthya gaṇa abhibhū avabhāsay lokam pātrī kṛ āditya maṇḍala praviś tad vajrāsana tad ca bhājana 
SA_XX_byogalbu-1145	2 tāni smṛtinimitteṣu smṛtinimittaṃ nābhyāṃ /	tāni smṛti nimitteṣu smṛti nimittam na ābhyām 
SA_XX_byogalbu-1146	+ + + ṇ.ḥ sthitiś ca yathā dharmānusmṛtiḥ ayaṃ tu viśeṣaḥ hṛdayāt pravāhaḥ sthitiś cāryasaṃghākīrṇā dṛśyate ante nābhyāṃ	sthitiḥ ca yathā dharma anusmṛtiḥ ayam tu viśeṣaḥ hṛdayāt pravāhaḥ sthitiḥ ca ārya saṃgha ākīrṇā dṛśyate ante nābhau 
SA_XX_byogalbu-1147	3 sarvaṃ jñeyaṃ nirudhyate iti vyutthānam /	sarvam jñeyam nirudhyate iti vyutthānam 
SA_XX_byogalbu-1148	saṃghānusmṛtiḥ //	saṃgha anusmṛtiḥ 
SA_XX_byogalbu-1149	śīlānusmṭiḥ katarā ihāryaśrāvakaḥ śīlam ākārataḥ samanusmarati itīmāni śīlāny	śīla anusmṭiḥ katarā iha ārya śrāvakaḥ śīlam ākārataḥ samanusmarati iti imāni śīlāni 
SA_XX_byogalbu-1150	4 akhaṇḍāny acchidrāṇy aśabalāni iti śīlānusmṛtipūrvaṃ hṛdayopanibaddhacetasaḥ devā .ī + .i + + + + + + + + + + + + + + + + + +	akhaṇḍāni acchidrāṇi a śabalāni iti śīla anusmṛti pūrvam hṛdaya upanibaddha cetasaḥ 
SA_XX_byogalbu-1151	5 .abhimukhī bhavanti /	abhimukhī bhavanti 
SA_XX_byogalbu-1152	tato + + + + + + + tiṃ bhitvābhyudgataḥ sa + + + + + + + + bhagavāṃs tasyāṃ velāyāṃ gāthāṃ bhāṣate /	ad tim bhitvā abhyudgataḥ sa        bhagavān tasyām velāyām gāthām bhāṣate 
SA_XX_byogalbu-1153	bahavaḥ śaraṇaṃ yānti parvatāni vanāni ca /	bahavaḥ śaraṇam yānti parvatāni vanāni ca 
SA_XX_byogalbu-1154	ārāmāṃ vṛkṣacaityāṃś ca manuṣyā bhayatarjitāḥ /	ārāmām vṛkṣa caityān ca manuṣyāḥ bhaya tarjitāḥ 
SA_XX_byogalbu-1155	6 na hy etac charaṇaṃ śreṣṭhaṃ naitac charaṇam uttamaṃ naitac charaṇam āgamya sarvaduḥkhāt pramucyate /	na hi etat śaraṇam śreṣṭham na etat śaraṇam uttamam na etat śaraṇam āgamya sarva duḥkhāt pramucyate 
SA_XX_byogalbu-1156	yas tu buddhaṃca dharmaṃ ca saṃghaṃ ca śaraṇaṃ gataḥ	yaḥ tu buddham ca dharmam ca saṃgham ca śaraṇam gataḥ 
SA_XX_byogalbu-1157	YL 168V1 catvāri cāryasatyāni prajñayā paśyati yadā /	catvāri ca ārya satyāni prajñayā paśyati yadā 
SA_XX_byogalbu-1158	etad dhi śaraṇaṃ śreṣṭhaṃ etac charaṇam uttamaṃ /	etat hi śaraṇam śreṣṭham etat śaraṇam uttamam 
SA_XX_byogalbu-1159	etac charaṇam āgamya sarvaduḥkhāt pramucyate /	etat śaraṇam āgamya sarva duḥkhāt pramucyate 
SA_XX_byogalbu-1160	2 + + + + + + + + + + + + + + + + + + + + + + + + + + + + + + + + + + + + + + + + + + + + + + .ādhipatirūpaṃ /	                   
SA_XX_byogalbu-1161	muktāmayī strī +	muktā mayī strī 
SA_XX_byogalbu-1162	3 + + + + + + + + + + + + + + + + + + + + + + + + + + + + + + + + + + + + + + + tiṣṭhanti / sā ca strī ratnapuṣpāṃ + + + + +	tiṣṭhanti sā ca strī 
SA_XX_byogalbu-1163	4 + + + + + + + + + + + + + + + + + + + + + + + + + + + + + + + + + + + + + + + + + kṣīraparipūrṇam utpadyate + + + + +	                 
SA_XX_byogalbu-1164	5 + + + + + + + + + + + + + + + + + + + + + + + + + + + + + + + + + + + + + + + + + + + + + + + + m / tāni cāṃkurāṇi + + + + + +	tāni ca aṅkurāṇi 
SA_XX_byogalbu-1165	6 + + + + + + + + + + + + + + + + + + + + + + + + + + + + + + + + + + + + + + + + + + + + + + + + .e + + + + + .e + + + + + + + + +	R 
SA_XX_byogalbu-1166	YL 168R1 + + + + + + + + + + + + + + + + + + + + + + + + + + + + + + + + + + + + + + + + + + + + + + utpadyate / daśāṃkura + + + + + + + +	ro-0 di-1  /
SA_XX_byogalbu-1167	2 + + + + + + + + + + + + + + + + + + + + + + + + + + + + + + + + + + + + + + + + + + + + + + + + nadyaḥ sauvarṇaratnacitā + + + + +	ro-0  /
SA_XX_byogalbu-1168	3 + + + + + + + + + + + + + + + + + + + + + + + + + + + + + + + + + + + + + + + + + + + niṣaṇṇā dṛyante / upasaṃpa + + + + +	niṣaṇṇāḥ dṛyante 
SA_XX_byogalbu-1169	4 + + + + + + + + + + + + + + + + + + + + + + + + + + + + + + + + + + + + + + + + + lalāteṣu nīlābhāni candramaṇḍala +	                                
SA_XX_byogalbu-1170	5 + + + + + + + + + + + + + + + + + + + + + + + + + + + + + + + + + + + + + + + + + + + + + + + + + + + puṣpakalāpā niḥsṛtāḥ pravāhāḥ	                                                                                                                 
SA_XX_byogalbu-1171	6 + + + + + + + + + + + + + + + + + + + + + + + + + + + + + + + + + + + + + + + + + + + + + + + + + + tiṣṭhati / tadā smṛtisaṃprajanyasaṃpaddvayaṃ	                                                                                
SA_XX_byogalbu-1172	YL 169V1 pratilabhate /	pratilabhate 
SA_XX_byogalbu-1173	tadadhipatirūpaṃ /	tad adhipati rūpam 
SA_XX_byogalbu-1174	vaiḍūryamayī strī sarvasatvāsatvākhya + + .v. + + n. smṛtyāḥ saṃprajanyasya ca puruṣaḥ + + + .olkāhastaḥ hṛdaye cāsyādityamaṇḍalam /	vaiḍūrya mayī strī sarva sattva asattva ākhya smṛtyāḥ saṃprajanyasya ca puruṣaḥ      ā ulkā hastaḥ hṛdaye ca asya āditya maṇḍalam 
SA_XX_byogalbu-1175	2 tadavabhāsitaṃ satvāsatvākhyam eva sarvaṃ vastu yato 'sau saṃvaraṃ pratilabhate satvāsatvākhyebhyś ca gandharatnapuṣpa + + + .y.ḥ saṃtāne 'sya sarveryāpatheṣu	tat avabhāsitam satva asatva ākhyam eva sarvam vastu yatas sau saṃvaram pratilabhate satva asatva ākhyebhyaḥ ca saṃtāne sarva īryāpatheṣu 
SA_XX_byogalbu-1176	3 sarvakālaṃ pravartate /	sarvakālam pravartate 
SA_XX_byogalbu-1177	prātimokṣasaṃvaravijñaptipuṇyasrotasaḥ adhipatirūpaṃ /	prātimokṣa saṃvara vijñapti puṇya srotasaḥ adhipati rūpam 
SA_XX_byogalbu-1178	sauvarṇaratnacitarathādhirūḍhaṃ brahmāṇaṃ paśyati ratnacchatreṇa .ī + +	sauvarṇa ratna cita ratha adhirūḍham brahmāṇam paśyati ratna chatreṇa 
SA_XX_byogalbu-1179	4 nīlabhaṃ candramaṇḍalacitaṃ ca paṭṭaṃ śirasi baddhaṃ paśyati /	nīla bham candra maṇḍala citam ca paṭṭam śirasi baddham paśyati 
SA_XX_byogalbu-1180	etac cārhatvaviśeṣabījam /	etat ca arhatva viśeṣa bījam 
SA_XX_byogalbu-1181	sarvopasaṃpannānām eva + + + + sya ca pūrvapratilabdhānāṃ + + + + +	sarva upasaṃpannānām eva     ca pūrva pratilabdhānām 
SA_XX_byogalbu-1182	5 kṛtāntapratyavekṣaṇāyogenaitad darśanam utpadyate pūrvapratilabdhamanasikārāṇāṃ tu syād ekakrameṇeti /	kṛtānta pratyavekṣaṇa ayogena etat darśanam utpadyate pūrva pratilabdha manasikārāṇām tu syāt eka krameṇa iti 
SA_XX_byogalbu-1183	punaḥ śīlānusmṛtipūrvaṃ hṛdayopanibaddhacetasaḥ adhastād	punar śīla anusmṛti pūrvam hṛdaya upanibaddha cetasaḥ adhastāt 
SA_XX_byogalbu-1184	6 yāvad vāyumaṇḍalam adharottaravibhāgena nīlābhā + pravāhāḥ + + + paripūrṇaiḥ tiryag anantaṃ hṛdayāc cordhvaṃ yāvad aghaniṣṭhāty adharottaravibhāgena	yāvat vāyu maṇḍalam adhara uttara vibhāgena nīla ābhā pravāhāḥ paripūrṇaiḥ tiryak anantam hṛdayāt ca ūrdhvam yāvat agha niṣṭhā ati adhara uttara vibhāgena 
SA_XX_byogalbu-1185	YL 169R1 laiḥ skandhadhātvāyatanapratītyasamutpādāryasatyādinimittaiḥ + + + + + + + + ryataiḥ paripūrṇaṃ paśyati /	paripṛ paś 
SA_XX_byogalbu-1186	mūrdhani cāsya maṇir utpadyate / tatra + + + + + + + +	mūrdhani ca asya maṇiḥ utpadyate tatra 
SA_XX_byogalbu-1187	2 paśyati maṇiniḥsṛtaiś ca raśmibhir adhaurdhvasthaṃ jñeyam ākṛṣṭaṃ svāśrayāntargataṃ paśyati maṇiratnāc ca ratnavarṣaḥ ante patita + + + + maṇḍalāntargatāny āpurayati /	paśyati maṇi niḥsṛtaiḥ ca raśmibhiḥ adhas aurdhva stham jñeyam ākṛṣṭam sva āśraya antargatam paśyati maṇi ratnāt ca ratna varṣaḥ ante patita maṇḍala antargatāni āpurayati 
SA_XX_byogalbu-1188	punaḥ śilānusmṛtipūrvaṃ	punar śilā anusmṛti pūrvam 
SA_XX_byogalbu-1189	3 hṛdayopanibaddhacetasaḥ vaiḍūryamayī strī snehaparipūrṇavaiḍūryabhājanacitotpadyate /	hṛdaya upanibaddha cetasaḥ vaiḍūrya mayī strī sneha paripūrṇa vaiḍūrya bhājana citā utpadyate 
SA_XX_byogalbu-1190	bhājaneṣu vajrāsanāni teṣv ādityamaṇḍalāni	bhājaneṣu vajra āsanāni teṣu āditya maṇḍalāni 
SA_XX_byogalbu-1191	4 tadantargatā bāladārakāḥ teṣāṃ divyārāmodyānavimānāny apsarogaṇakalilāny abhimukhī bhavanti /	tad antargatāḥ bāla dārakāḥ teṣām divya ārāma udyāna vimānāni apsaraḥ gaṇa kalilāni abhimukhī bhavanti 
SA_XX_byogalbu-1192	tatpra + + + + + + nti tadā ratnama + + + +	tad pra 
SA_XX_byogalbu-1193	5 ratnajālāvṛtaṃ sarvāṃgapratyaṃgabaddham ātmānāṃ paśyati /	ratna jāla āvṛtam sarva aṃga pratyaṃga baddham ātmānām paśyati 
SA_XX_byogalbu-1194	puruṣaś caiṣām apāyāṃ darśayati /	puruṣaḥ ca eṣām apāyām darśayati 
SA_XX_byogalbu-1195	kathayati ca /	kathayati ca 
SA_XX_byogalbu-1196	etat pramādaphalam iti /	etat pramāda phalam iti 
SA_XX_byogalbu-1197	tatas te viṣayebhyo vimukhībhavanti / ratnarasa + + +	tatas te viṣayebhyaḥ vimukhībhavanti 
SA_XX_byogalbu-1198	6 ca nimagnā dṛśyante /	ca nimagnāḥ dṛśyante 
SA_XX_byogalbu-1199	dhyānasaṃvarasya nābhyupari nīlapītalohitāvadātā candramaṇḍala + + + + + + bāladāraka + + + + + + + + vati + + + + +	dhyāna saṃvarasya nābhi upari candra maṇḍala  /                        
SA_XX_byogalbu-1200	YL 170V1 + + + + + + + + + + + + vimukhībhūtāś ca muktāṃ paśyanti /	di-2 di-2 ro-0 ca muktām paś 
SA_XX_byogalbu-1201	nīlādirasanimagnaṃ hṛdaye + + + + + + + + + + + + + + + + + + + /	         
SA_XX_byogalbu-1202	tadadirūḍhāḥ bāladārakāḥ	tad adirūḍhāḥ bāla dārakāḥ 
SA_XX_byogalbu-1203	2 + + + + + + + + + + + + + tadā muktācitair jālair baddham ātmānaṃ paśyati /	          paśyati 
SA_XX_byogalbu-1204	vimukhībhūtā + + + + + + + + + + + + + + evaṃ sarvaromakūpe + .e ca buddhā	vimukhībhūtā               evam sarva romakūpe ca buddhā 
SA_XX_byogalbu-1205	3 + + + duścaritacāriṇaḥ sarvān abhibhūya ādityamaṇḍaleṣu praviśanti /	      abhibhūya      praviśanti 
SA_XX_byogalbu-1206	tāni vajrāsaneṣu tāni bhājaneṣu tāni smṛtinimitteṣu smṛtinimittaṃ nābhyāṃ /	tāni vajrāsaneṣu tāni bhājaneṣu tāni smṛti nimitteṣu smṛti nimittam nābhyām 
SA_XX_byogalbu-1207	4 + + + + + + + + + romakūpadarśanavidhiḥ buddhadharmasaṃghānusmṛti + + + + + + + + + + + + + + + + + + + + + + + + + + + + +	         
SA_XX_byogalbu-1208	5 + + + + + + + + + + abhiṣekapravāhāḥ niḥsṛtāḥ yāvad vāyumaṇḍalaṃ bhitvā + + + + + + + + + + + + + + + + + + + + + + + + + + + + + + + +	            
SA_XX_byogalbu-1209	6 + + + + + + + + + + + + + + + + + + + taṃ ratnapuṣpavarṣaiḥ gośīrṣacandana + + + + + + + + + devatānusmṛtiḥ katarā / + + + + + + + + + +	                                       
SA_XX_byogalbu-1210	YL 170R1 + + + + + + + + + + + + + + + + .upanibaddhacetasaḥ ṣaṭ kāmāvacārā devā + + + + + + + + + + + + + + + + + + + + + + + + + + + + + +	deva 
SA_XX_byogalbu-1211	2 + + + + + + + + + + + + + + + + + ddh. manuṣyāśrayaṃ paśyati /	manuṣya āśrayam paśyati 
SA_XX_byogalbu-1212	punar devatānusmṛtipūrvaṃ hṛdayopanibaddhacetasaḥ + + + + + + + + + + + + + + +	punar devatā anusmṛti pūrvam hṛdaya upanibaddha cetasaḥ 
SA_XX_byogalbu-1213	3 + + + + + + + hāḥ praviṣṭāḥ smṛtinimittam /	          
SA_XX_byogalbu-1214	snehaparipūrṇavaiḍūryabhājanacitā strī + + + + + + + + + + + + + + + + + + + + + + + +	sneha paripūrṇa vaiḍūrya bhājana citā strī 
SA_XX_byogalbu-1215	4 + + + + + + + dṛśyante / teṣām adharimo bhāgaḥ ādarśamaṇḍalacitaḥ + + + + + + + + + + + + + + + + + + + + + + + + + + + + + + + +	               
SA_XX_byogalbu-1216	5 + + + + + + + + + + + + + + + + nimittam / hasteṣu gṛhītaratnopakaraṇāḥ puruṣāḥ sa + + + + + + + + + + + + + + + + + + + + + + + + + + +	              
SA_XX_byogalbu-1217	6 + + + + + + + + + + + + + + sv evaṃjātīyaṃ darśanaṃ bhavati /	       bhavati 
SA_XX_byogalbu-1218	ante ca devāḥ puṣparatnavarṣam utsṛjanti / + + + + + + + + + + + + + + + + + + + + +	ante ca devāḥ puṣpa ratna varṣam utsṛjanti 
SA_XX_byogalbu-1219	Additions based on Jens-Uwe Hartmann:	additions based on jensuwe hartmann 
SA_XX_byogalbu-1220	“Neue Fragmente aus dem 'Yogalehrbuch'“,	neue fragmente aus dem yoga lehrbuch 
SA_XX_byogalbu-1221	in: Festschrift Dieter Schlingloff zur Vollendung des 65. Lebensjahres	in festschrift dieter schlingloff zur vollendung des 
SA_XX_byogalbu-1222	dargebracht von Schülern,	dargebracht von schlern 
SA_XX_byogalbu-1223	Freunden und Kollegen,	freunden und kollegen 
SA_XX_byogalbu-1224	hg. Friedrich Wilhelm, Reinbek 1996, pp. 127-135;	hg friedrich wilhelm reinbek 
SA_XX_byogalbu-1225	[Reprinted with corrections in:	reprinted with corrections in
SA_XX_byogalbu-1226	D. Schlingloff,	d schlingloff 
SA_XX_byogalbu-1227	Ein buddhistisches Yogalehrbuch.	ein buddhistisches yoga lehrbuch 
SA_XX_byogalbu-1228	Unveränderter Nachdruck der Ausgabe von 1964 unter Beigabe aller seither bekannt	unvernderter nachdruck der ausgabe von untr beigabe aller seither bekannt 
SA_XX_byogalbu-1229	gewordenen Fragmente,	gewordnen fragmente 
SA_XX_byogalbu-1230	hg. J.-U. Hartmann und H.-J. Röllicke. München 2006	hg ju hartmann und hj rllicke 
SA_XX_byogalbu-1231	(Buddhismus-Studien, 5).]	buddhismusstudien 
SA_XX_byogalbu-1232	1. Hoernle 149.add unnumbered (Or.15009/374) = YL 127R2 - 128V5	unnumber 
SA_XX_byogalbu-1233	r1 /// yogācārāśrayaś candramaṇḍala .. .. ///	R yoga ācāra āśrayaḥ candra maṇḍalaiḥ 
SA_XX_byogalbu-1234	2 /// nimajjaty āśvāsataḥ praśvāsaparigṛhītaṃ ///	nimajjati āśvāsataḥ praśvāsa parigṛhītam 
SA_XX_byogalbu-1235	3 /// .. ulkāsahasrāṇi cāntaḥsamudre .. ///	ulkā sahasrāṇi ca antar samudre 
SA_XX_byogalbu-1236	4 /// praśvāsaparigṛhītaś ca bahiḥ ante ca .. ///	praśvāsa parigṛhītaḥ ca bahis ante ca 
SA_XX_byogalbu-1237	5 /// utpadyate paṭṭaṃ badhnāti pāṇḍaraṃ samantataś ca ///	utpadyate paṭṭam badhnāti pāṇḍaram samantataḥ ca 
SA_XX_byogalbu-1238	6 /// kūṭāgāraiḥ paripūrṇā dṛśyante tadantargatāś ///	kūṭāgāraiḥ paripūrṇāḥ dṛśyante tad antargatāḥ 
SA_XX_byogalbu-1239	v1 /// .uhy. tiṣṭhanti vimuktipratisaṃvedanāyāṃ ///	uhi tiṣṭhanti vimukti pratisaṃvedanāyām 
SA_XX_byogalbu-1240	2 /// k. jvālayante /	 k jvālayante 
SA_XX_byogalbu-1241	prahāṇānupaśyanāyām ///	prahāṇa anupaśyanāyām 
SA_XX_byogalbu-1242	3 /// .. paryantam eva taṃ pheṇarāśiṃ śītalajalapariṣiktam iva ///	paryantam eva tam pheṇa rāśim śītala jala pariṣiktam iva 
SA_XX_byogalbu-1243	4 /// .. tatrāntaḥ muktācito yogācārāśrayaḥ ///	            
SA_XX_byogalbu-1244	5 /// .. bhavati / devāś ca kṛtsnaṃ gaganaṃ ///	rocate devāḥ ca kṛtsnam gaganam 
SA_XX_byogalbu-1245	6 /// pradeśaṃ paśyati muktācitaṃ tadupary ///	pradeśam paśyati muktā ācitam tad upari 
SA_XX_byogalbu-1246	2. Hoernle 149add. unnumbered (Or.15009/485) = YL 144R6 - 146R6	unnumber 
SA_XX_byogalbu-1247	ra /// sarvasatvāśrayāḥ + + ///	sarva sattva āśrayāḥ 
SA_XX_byogalbu-1248	b /// siṃcati utkṣipte ///	siṃcati utkṣipte 
SA_XX_byogalbu-1249	c /// satvāḥ sannaddhāśṛ ///	c satvāḥ sannaddhāśṛ 
SA_XX_byogalbu-1250	d /// praṇamanti /	d praṇamanti 
SA_XX_byogalbu-1251	evaṃ ///	evam 
SA_XX_byogalbu-1252	e /// maitrāśayasyānantaṃ paryantaṃ ///	e maitra āśayasya anantam paryantam 
SA_XX_byogalbu-1253	f /// siṃcyamāno dṛśyate .. .. + ///	siṃcyamānaḥ dṛśyate    
SA_XX_byogalbu-1254	va /// t.n niḥsṛtābhiḥ + ///	va t niḥsṛtābhiḥ 
SA_XX_byogalbu-1255	b /// samaye cittaṃ bhavati ///	samaye cittam bhavati 
SA_XX_byogalbu-1256	c /// āśrayāpramāṇa ///	c 
SA_XX_byogalbu-1257	d /// maitrābhiṣekaś ca as. ///	maitra abhiṣekaḥ ca as 
SA_XX_byogalbu-1258	e /// catvāraḥ pravāhāḥ kācapārībhiḥ ///	e catvāraḥ pravāhāḥ kāca pārībhiḥ 
SA_XX_byogalbu-1259	f /// kṣīrapravāho nirgatya ///	kṣīra pravāhaḥ nirgatya 
SA_XX_byogalbu-1260	Additions based on Jens-Uwe Hartmann:	additions based on jensuwe hartmann 
SA_XX_byogalbu-1261	“Drei weitere Fragmente aus dem Yogalehrbuch“,	drei weitere fragmente aus dem yoga lehrbuch 
SA_XX_byogalbu-1262	in: D. Schlingloff,	in d schlingloff 
SA_XX_byogalbu-1263	Ein buddhistisches Yogalehrbuch. Unveränderter Nachdruck der Ausgabe von 1964	ein buddhistisches yoga lehrbuch unvernderter nachdruck der ausgabe 
SA_XX_byogalbu-1264	unter Beigabe aller seither bekannt gewordenen Fragmente,	unter beigabe aller seither bekannt gewordnen fragmente 
SA_XX_byogalbu-1265	hg. J.-U. Hartmann und H.-J. Röllicke.	hg ju hartman und hj 
SA_XX_byogalbu-1266	München 2006 (Buddhismus-Studien, 5), pp. 319-324	mnchen 
SA_XX_byogalbu-1267	1. H. 150/84 (Or.15002/28): 4,3 x 9,9; Yogalehrbuch,	di xc yoga lehrbuch 
SA_XX_byogalbu-1268	1. Kapitel (Übung der Häßlichkeiten,	kapitel bung der hlichkeiten 
SA_XX_byogalbu-1269	aśubhaprayoga); dazu H. 150/76	aśubha prayoga 
SA_XX_byogalbu-1270	V1 prahāya sa ca vitarkarahito vrajati saddham* parivartya ca ta .. + +	prahāya sa ca vitarka rahitaḥ vrajati parivartya ca 
SA_XX_byogalbu-1271	2 caturdhyānarasam ādāya svamāśraye praveśayati &ordm; .ri + +	catur dhyāna rasam ādāya svam āśraye praveśayati 
SA_XX_byogalbu-1272	3 tiṃ ca tato lalāṭāt pravāho ḥnirgacchatiḥ dvītīyo nābhyāḥ miśritvā sthitim	tim ca tatas lalāṭāt pravāhaḥ dvītīyaḥ nābhyāḥ miśritvā sthitim 
SA_XX_byogalbu-1273	4 āpūrayati &ordm;	āpūrayati ordhva 
SA_XX_byogalbu-1274	lalāṭāt pūrvaṃ vicchidyate tato nābhyāḥ &ordm;	lalāṭāt pūrvam vicchidyate tatas nābhyāḥ 
SA_XX_byogalbu-1275	samudraparyantaṃ	samudra paryantam 
SA_XX_byogalbu-1276	R(29)1 pṛthivīṃ spharitvā ānābheś ca sthitinimagnām āśrayaṃ + + +	pṛthivīm spharitvā ā nābheḥ ca sthiti nimagnām āśrayam 
SA_XX_byogalbu-1277	2 ni &ordm; tataḥ paripakāntād yā sthiti praveśayati &ordm; etad	ni ordm tatas paripaka antāt yā sthiti praveśayati ordm etat 
SA_XX_byogalbu-1278	3 utpādasthitivyutthānakauśalam* sthityupari cittasaṃvegārthaṃ	utpāda sthiti vyutthāna kauśalam sthiti upari citta saṃvega artham 
SA_XX_byogalbu-1279	4 maraṇasaṃjñābhāvanā aṃgārārāśinimagnaṃ kṛtsnaṃ sasurāsuralokaṃ paśyati	maraṇa saṃjñā bhāvanā aṃgārā rāśi nimagnam kṛtsnam sa sura asura lokam paśyati 
SA_XX_byogalbu-1280	recto	re c taḥ 
SA_XX_byogalbu-1281	1 /// avāśyāyabindun iva spandamānaṃ paśyati /	avāśyāya bindun iva spandamānam paśyati 
SA_XX_byogalbu-1282	2 /// tadadhirūḍhāṃś ca buddhāṃ paśyati /	tad adhirūḍhān ca buddhām paśyati 
SA_XX_byogalbu-1283	3 /// + .. paśyati a .. /// {Lücke in YL}	ro-0 ad io-yl
SA_XX_byogalbu-1284	4 /// + sa ca ratnavṛkṣaḥ /	  sa ca ratna vṛkṣaḥ 
SA_XX_byogalbu-1285	5 /// + + .. ta .. + + ///	ro-0 ns-1
SA_XX_byogalbu-1286	verso	verso 
SA_XX_byogalbu-1287	v /// + + bhāgen. + + ///	ro-0 
SA_XX_byogalbu-1288	w /// + .. parikarmā .. /	ro-0 
SA_XX_byogalbu-1289	// {cf. YL 132V1ff.}	cf y 
SA_XX_byogalbu-1290	x /// + .. karaṃthaiḥ pṛthivīṃ /	ranthaiḥ pṛthivīm 
SA_XX_byogalbu-1291	y /// pṛthivī pūrṇāṃ paśyati paśyataś c. /	y pṛthivī pūrṇām paśyati paśyataḥ c 
SA_XX_byogalbu-1292	z /// sya kṛmayasṛ + /	sya kṛmaya sṛ 
SA_XX_byogalbu-1293	// {Lücke vor YL 132V6}	lcke voḥ y 
SA_XX_byogalbu-1294	Additions based on Yamabe,	additions based on yamabe 
SA_XX_byogalbu-1295	N.: “New Fragments of the “Yogalehrbuch““,	new fragments of the yogalehrbuch 
SA_XX_byogalbu-1296	Kyūshū Ryūkoku Tankidaigaku Kīyḥ 43 (1997), pp. 11-39.	kyūshū ryūkoku tankidaigaku kīyḥ    
SA_XX_byogalbu-1297	Cf. Yamabe, Nobuyoshi:	cf
SA_XX_byogalbu-1298	“Fragments of the “Yogalehrbuch” in the Pelliot Collection“,	fragments of the pelliot collaction 
SA_XX_byogalbu-1299	in: D. Schlingloff,	in d schlingloff 
SA_XX_byogalbu-1300	Ein buddhistisches Yogalehrbuch. Unveränderter Nachdruck der Ausgabe von 1964 unter Beigabe aller seither bekannt gewordenen Fragmente,	ein buddhistisches yoga lehrbuch unvernderter nachdruck der ausgabe von unter beigabe aller seither bekannt gewordenen fragmente 
SA_XX_byogalbu-1301	hg. J.-U. Hartmann und H.-J. Röllicke. München 2006 (Buddhismus-Studien, 5), pp. 325-347.	hg ju hartmann und hj rllicke 
SA_XX_byogalbu-1302	[slightly revised version of “New Fragments of the “Yogalehrbuch““]	slightly revised vesion of new fragments of the yogalehrbuch 
SA_XX_byogalbu-1303	1) Pell.Skt. rouge 9.1 (r3-va ~ YL 129V6-R3, vc,	rouge         
SA_XX_byogalbu-1304	d,f : YL 1 17R2, 4)	ro-0 fl-
SA_XX_byogalbu-1305	r1 paśyati / sakuṇḍā antaḥkoṣṭhāgarbhāṃ strīṃ nānāśuciparipūrṇāṃ kaṇṭhanāḍyāṃ laṃbamānāṃ paśyati /	R paśyati sa kuṇḍā striyam nānā aśuci paripūrṇām kaṇṭha nāḍyām laṃbamānām paśyati 
SA_XX_byogalbu-1306	evaṃ // /	evam 
SA_XX_byogalbu-1307	svam āśrayaṃ tadvat sarvasatvān samudraparyantāyāḥ pṛthivyāḥ paśyati durbalasaṃjñā g. hīt. b. +	svam āśrayam tadvat sarva satvān samudra paryanta pṛthivyāḥ paśyati durbala saṃjñā 
SA_XX_byogalbu-1308	2 .. saṃskāragataṃ patantam iva paśyati cūrṇasaṃjñāyāṃ cūrṇīkṛtaṃ bhasmarāśivad avasthitaṃ svam āśrayaṃ // /	saṃskāra gatam patantam iva paśyati cūrṇa saṃjñāyām cūrṇīkṛtam bhasma rāśi vat avasthitam svam āśrayam 
SA_XX_byogalbu-1309	samudraparyantāyāṃ pṛthivyām* tataḥ mātṛpitṛsaṃyogāc chukraśoṇitaṃ paśyati tadabhirataṃ ca vijñānaṃ tataḥ kalalārbudapeśīghanapraśākhānukrameṇābhinirvartamānaṃ paśyati /	samudra paryantāyām pṛthivyām tatas mātṛ pitṛ saṃyogāt śukra śoṇitam paśyati tad abhiratam ca vijñānam tatas kalala arbuda peśī ghana praśākhā anukrameṇa abhinirvartamānam paśyati 
SA_XX_byogalbu-1310	3 jātasya ca bālakumāra // /	jātasya ca bāla kumāra 
SA_XX_byogalbu-1311	paśyati /	paśyati 
SA_XX_byogalbu-1312	evaṃ nānārogopahataṃ mriyamāṇaṃ mṛtaṃ nirhriyamāṇaṃ śmaśānasthaṃ vinīlakādi yāvac cūrṇitaṃ	evam nānā roga upahatam mriyamāṇam mṛtam nirhriyamāṇam śmaśāna stham vinīlaka ādi yāvat cūrṇitam 
SA_XX_byogalbu-1313	4 kṛtsnaṃ jagat paśyati /	kṛtsnam jagat paśyati 
SA_XX_byogalbu-1314	svaṃ cāśrayaṃ tataś cūrṇapuruṣaka utpadyate + // /	svam ca āśrayam tatas cūrṇapuruṣakaḥ utpadyate 
SA_XX_byogalbu-1315	tato 'bhiṣekaḥ caturbhyaḥ samudrebhyaḥ puruṣā jalakuṃbhān ādāya yogācāraṃ snāpayanti / evaṃ	tatas bhiṣekaḥ caturbhyaḥ samudrebhyaḥ puruṣāḥ jala kuṃbhān ādāya yoga ācāram snāpayanti evam 
SA_XX_byogalbu-1316	5 + + + +ḥ mūrdhacchidreṇa ca sarpistailābhyāṃ pūrayanti /	    ca     pūrayanti 
SA_XX_byogalbu-1317	tata upari pūrṇ.ṃ // /	tatas upari 
SA_XX_byogalbu-1318	.. acchaṃ cāśrayaṃ suvarṇaśalākāsadṛśaṃ snigdhaṃ suvarṇaṃ saṃparipūrṇaṃ dṛśyate tato lalāṭe ..	accham ca āśrayam suvarṇa śalākā sadṛśam snigdham suvarṇam saṃparipūrṇam dṛśyate tatas lalāṭe 
SA_XX_byogalbu-1319	6 + + + + + + + + + + śalākāsadṛśaḥ pravāho nirgacchati sa pṛthivīṃ bhitvā + + + + // /	        śalākā sadṛśaḥ pravāhaḥ nirgacchati sa pṛthivīm bhitvā 
SA_XX_byogalbu-1320	+ + + .tvā tataḥ kāṃcanamaṇḍalaṃ abmaṇḍalaṃ vāyumaṇḍalaṃ ca bhitvā parivartya nābhyāṃ ..	tvā tatas kāṃcana maṇḍalam ap maṇḍalam vāyu maṇḍalam ca bhitvā parivartya nābhyām 
SA_XX_byogalbu-1321	7 /// + + + + + .. .e + .. .h. m. khāniḥ .. .. .ā + + .. .. .. ..ṃ .i .i + r..ṃ .i .i .. .. .. + +	ro-0 di-1 ns-1 
SA_XX_byogalbu-1322	va /// + + + + + + + + pravāho dvitīyo nābhyāḥ + .r. .ṛtv. sth. t. .. + .. t. .. .. .. + + + +	         
SA_XX_byogalbu-1323	b + + + + + + + + + + + .. tā .ṛ + + spharitvā ānābheś ca sthitinimagnam āśrayaṃ /// + + + + + /	di-41 di-41 ns-41 ca sthiti nimagnam āśrayam 
SA_XX_byogalbu-1324	etad utpādasthitivyutthānakauśalam* / /	etat utpāda sthiti vyutthāna kauśalam 
SA_XX_byogalbu-1325	sthityupari cittasaṃvegārthaṃ maraṇasaṃjñābhāvanā	sthiti upari citta saṃvega artham maraṇa saṃjñā bhāvanā 
SA_XX_byogalbu-1326	c aṃgārārāśinimagnaṃ kṛtsnaṃ sasurāsuraṃ lokaṃ paśyati c. .. // /	aṃgāra rāśi nimagnam kṛtsnam sa sura asuram lokam paśyati c 
SA_XX_byogalbu-1327	.āt sva āśraye paśyati /	ā t sve āśraye paśyati 
SA_XX_byogalbu-1328	āpāṇḍulohitamṛttikāsadṛśa āśīviṣaḥ pṛthivīdhātoḥ tūlaśalākāsadṛśaḥ	āpāṇḍu lohita mṛttikā sadṛśaḥ āśīviṣaḥ pṛthivī dhātoḥ tūla śalākā sadṛśaḥ 
SA_XX_byogalbu-1329	d abdhātoḥ aṃgāraśalākāsadṛśaḥ tejodhātoḥ abhraśalākāsadṛśo vāyudhātoḥ // /	ap dhātoḥ aṃgāra śalākā sadṛśaḥ tejaḥ dhātoḥ abhra śalākā sadṛśaḥ vāyu dhātoḥ 
SA_XX_byogalbu-1330	th.m utsadībhūte saptottaraṃ āśīviṣaśataṃ saṃbhavanti /	utsadībhūte sapta uttaram āśīviṣa śatam saṃbhavanti 
SA_XX_byogalbu-1331	tat saptottaraṃ marmaśataṃ saṃnirodhayitvā	tat sapta uttaram marma śatam saṃnirodhayitvā 
SA_XX_byogalbu-1332	e tiṣṭhanti mṛtpravāhaś ca mūrdhnā praviśya sarvasrotāṃsi badhvā tiṣṭhanti + // /	ā i tiṣṭhanti mṛd pravāhaḥ ca mūrdhnā praviśya sarva srotāṃsi badhvā tiṣṭhanti  /
SA_XX_byogalbu-1333	lokam abdhātau kupite saptottaram āśīviṣaśataṃ abdhātvāśīviṣāṇāṃ nirgatya saptottaraṃ marmaśataṃ	lokam ap dhātau kupite sapta uttaram āśīviṣa śatam ap dhātu āśīviṣāṇām nirgatya sapta uttaram marma śatam 
SA_XX_byogalbu-1334	f snāyūṃ kledayanti teṣu klinneṣu s.ṃ .. yā viśliṣyante niśceṣṭaṃ svam āśrayaṃ lokaṃ ca + // /	snāyūm kledayanti teṣu klinneṣu sṃ  yāḥ viśliṣyante niśceṣṭam svam āśrayam lokam ca  /
SA_XX_byogalbu-1335	.ās tāvanta evāśīviṣās tāvatsv eva marmasu .. t. e snāyūṃ dahyanti niśceṣṭaṃ svam āśrayaṃ sarvasatvāṃś	āḥ tāvantaḥ eva āśīviṣāḥ tāvatsu eva marmasu t e snāyūm dahyanti niśceṣṭam svam āśrayam sarva satvān 
SA_XX_byogalbu-1336	g ca pṛthivīṃ patantam iva paśyati snāyu .. e .. pi te .. .. śalākāvarṇas tāvanta eva // /	ca pṛthivīm patantam iva paśyati snāyu    pi te   śalākā varṇaḥ tāvantaḥ eva 
SA_XX_byogalbu-1337	khavinigatair asibhiḥ .. .ṛ cchindanti /	kha vinigataiḥ asibhiḥ ṛ chindanti 
SA_XX_byogalbu-1338	niśceṣṭam āśrayaṃ lokaṃ ca paśyati gale ca vibā .. +	niśceṣṭam āśrayam lokam ca paśyati gale ca vibā 
SA_XX_byogalbu-1339	2) Pell.Skt. rouge 9.2 (ra-d = YL 118R2-5, vc-d = YL 121R4-5)	rouge 
SA_XX_byogalbu-1340	r1 /// .o tebhyaś ca cittābhipramodanāyām ///	R o tebhyaḥ ca citta abhipramodanāyām 
SA_XX_byogalbu-1341	2 /// bāladārakaṃ samādhisukhasaktaṃ paśyati a ///	bāla dārakam samādhi sukha saktam paśyati 
SA_XX_byogalbu-1342	3 /// jīrṇaṃ svam āśrayaṃ paśyati āśvāsapraśvāsā ///	jīrṇam svam āśrayam paśyati āśvāsa praśvāsā 
SA_XX_byogalbu-1343	4 /// āśvāsapraśvāsasaṃ /// 5 /// .. .. ///	ro-0 
SA_XX_byogalbu-1344	va /// .. .. ///	ro-0 
SA_XX_byogalbu-1345	b /// ṣṭha utpadyate ///	utpadyate 
SA_XX_byogalbu-1346	c /// vat tṛtīyadhyānaṃ evaṃ sphuṭaṃ paśyati ///	c vat tṛtīya dhyānam evam sphuṭam paśyati 
SA_XX_byogalbu-1347	d /// śāṃ te buddhāś ca śabdam udīrayanti śāntaṃ śāntaṃ ///	śām te buddhāḥ ca śabdam udīrayanti śāntam śāntam 
SA_XX_byogalbu-1348	e /// .. .. dayaṃ utpadyate evaṃ ///	      
SA_XX_byogalbu-1349	3) Pell.Skt. rouge 9.3 (YL; vd ~ YL 118V5)	rouge 
SA_XX_byogalbu-1350	r1 /// ddhāy.ḥ yogācāra .o ///	R yogācāraḥ 
SA_XX_byogalbu-1351	2 /// .. mapr. v. sānāṃ sūryamaṇḍalaṃ candramaṇḍalam ///	r ma p r u sānām sūrya maṇḍalam candra maṇḍalam 
SA_XX_byogalbu-1352	3 /// naḍakalāpayogena pārasparye ///	naḍa kalāpa yogena pārasparye 
SA_XX_byogalbu-1353	4 /// āpādīnā. m ā /// 5 /// .. .. ///	āpa ādīnām ā     
SA_XX_byogalbu-1354	va /// .. .. ///	ro-0 
SA_XX_byogalbu-1355	b /// paśyati sarvaṃ ///	paśyati sarvam 
SA_XX_byogalbu-1356	c /// ekaikena srotasā sūkṣmaṃ vāyuṃ ///	ekaikena srotasā sūkṣmam vāyum 
SA_XX_byogalbu-1357	d /// .. y. .. nirgatā prītisaṃvedanāyāṃ ///	d y nirgatā prīti saṃvedanāyām 
SA_XX_byogalbu-1358	e /// .. antarmukhaṃ snā .. .. kh. /	ro antar mukham snā 
SA_XX_byogalbu-1359	// {oder: .. .. ..}	o deḥ  /
SA_XX_byogalbu-1360	4) Pell.Skt. rouge 9.4 (YL)	rouge yl 
SA_XX_byogalbu-1361	r1 /// .. .. tvā .. s tiṣṭhati vāyu .. + .. ///	r  tvā s tiṣṭhati vāyu    
SA_XX_byogalbu-1362	2 /// caturthadhyānaṃ muktvā eṣā dīrghatā tato vāyu tantu .. ///	caturtha dhyānam muktvā eṣā dīrgha tā tatas vāyu tantu 
SA_XX_byogalbu-1363	3 /// .āśvāsā bhūmisthā 2 sarve satvā ā ///	sarve satvāḥ 
SA_XX_byogalbu-1364	4 /// t. r. nābhyaṃ maṇḍala ///	r nābhyam maṇḍalaiḥ 
SA_XX_byogalbu-1365	va /// tāyā vāyu ā ///	va 
SA_XX_byogalbu-1366	b /// bhadrebhyo niḥsṛtyādhaḥ vāyumaṇḍala ///	bhadrebhyaḥ niḥsṛtya adhas 
SA_XX_byogalbu-1367	c /// .. smṛtiṃ pratismṛtīnāṃ tailapūrṇabhājana .r. ///	c smṛtim pratismṛtīnām taila pūrṇa bhājanaiḥ 
SA_XX_byogalbu-1368	d /// parigṛhītāni paśyanti .. + .e .. ///	parigṛhītāni paśyanti 
SA_XX_byogalbu-1369	5) Pell.Skt. rouge 9.5 (YL)	rouge yl 
SA_XX_byogalbu-1370	ra /// .. .. ///	ra 
SA_XX_byogalbu-1371	b /// . yaṃ sṛtvā ///	ro yam sṛtvā 
SA_XX_byogalbu-1372	c /// darśanānuśu ///	c 
SA_XX_byogalbu-1373	d /// .. yā sopekṣaḥ ///	d sa upekṣaḥ 
SA_XX_byogalbu-1374	e /// .. + .ī .ī ///	ro 
SA_XX_byogalbu-1375	va /// .i .. .y. .. g. ///	ro 
SA_XX_byogalbu-1376	b /// d. .. tasam. pa ///	di tasam pa 
SA_XX_byogalbu-1377	c /// .. .aiva daś. ///	c ā eva daḥ 
SA_XX_byogalbu-1378	d /// .. satvā ///	d satvā 
SA_XX_byogalbu-1379	e /// .. .. ///	ro-0
SA_XX_byogalbu-1380	6) Pell.Skt. rouge 9.6 (YL)	rouge yl 
SA_XX_byogalbu-1381	ra /// .. .. .. .. ///	ro-0 
SA_XX_byogalbu-1382	b /// vācaṃ marmābhighaṭṭi ///	vācam marma abhighaṭṭi 
SA_XX_byogalbu-1383	c /// svayaṃ dātum icchati ///	c svayam dātum icchati 
SA_XX_byogalbu-1384	va /// .. bhūto yāvat t. ///	ro 
SA_XX_byogalbu-1385	b /// ā .. ratāgandhamāly. ///	ratā gandha mālī 
SA_XX_byogalbu-1386	c /// yā .. .. bhikā ///	c yā 
